NODE_1_length_25698_cov_36.651041	315	395	6	80	80	1.0000000
NODE_1_length_25698_cov_36.651041	368	403	3	2	35	0.0571429
NODE_1_length_25698_cov_36.651041	368	403	6	33	35	0.9428571
NODE_1_length_25698_cov_36.651041	24448	24494	0	46	46	1.0000000
NODE_2_length_24307_cov_15.119712	2613	2689	11	13	76	0.1710526
NODE_2_length_24307_cov_15.119712	2613	2689	12	63	76	0.8289474
NODE_2_length_24307_cov_15.119712	2662	2716	2	4	54	0.0740741
NODE_2_length_24307_cov_15.119712	2662	2716	8	6	54	0.1111111
NODE_2_length_24307_cov_15.119712	2662	2716	10	1	54	0.0185185
NODE_2_length_24307_cov_15.119712	2662	2716	11	25	54	0.4629630
NODE_2_length_24307_cov_15.119712	2662	2716	12	18	54	0.3333333
NODE_2_length_24307_cov_15.119712	11257	11320	0	63	63	1.0000000
NODE_2_length_24307_cov_15.119712	20621	20701	8	2	80	0.0250000
NODE_2_length_24307_cov_15.119712	20621	20701	9	1	80	0.0125000
NODE_2_length_24307_cov_15.119712	20621	20701	10	16	80	0.2000000
NODE_2_length_24307_cov_15.119712	20621	20701	11	1	80	0.0125000
NODE_2_length_24307_cov_15.119712	20621	20701	15	38	80	0.4750000
NODE_2_length_24307_cov_15.119712	20621	20701	16	22	80	0.2750000
NODE_2_length_24307_cov_15.119712	20674	20754	8	6	80	0.0750000
NODE_2_length_24307_cov_15.119712	20674	20754	9	7	80	0.0875000
NODE_2_length_24307_cov_15.119712	20674	20754	10	6	80	0.0750000
NODE_2_length_24307_cov_15.119712	20674	20754	11	5	80	0.0625000
NODE_2_length_24307_cov_15.119712	20674	20754	13	13	80	0.1625000
NODE_2_length_24307_cov_15.119712	20674	20754	14	13	80	0.1625000
NODE_2_length_24307_cov_15.119712	20674	20754	15	29	80	0.3625000
NODE_2_length_24307_cov_15.119712	20674	20754	16	1	80	0.0125000
NODE_7_length_12349_cov_28.144571	12251	12310	10	12	59	0.2033898
NODE_7_length_12349_cov_28.144571	12251	12310	13	7	59	0.1186441
NODE_7_length_12349_cov_28.144571	12251	12310	14	3	59	0.0508475
NODE_7_length_12349_cov_28.144571	12251	12310	15	1	59	0.0169492
NODE_7_length_12349_cov_28.144571	12251	12310	19	6	59	0.1016949
NODE_7_length_12349_cov_28.144571	12251	12310	20	5	59	0.0847458
NODE_7_length_12349_cov_28.144571	12251	12310	21	1	59	0.0169492
NODE_7_length_12349_cov_28.144571	12251	12310	22	24	59	0.4067796
NODE_7_length_12349_cov_28.144571	12284	12310	10	12	26	0.4615385
NODE_7_length_12349_cov_28.144571	12284	12310	13	7	26	0.2692308
NODE_7_length_12349_cov_28.144571	12284	12310	14	3	26	0.1153846
NODE_7_length_12349_cov_28.144571	12284	12310	15	1	26	0.0384615
NODE_7_length_12349_cov_28.144571	12284	12310	19	3	26	0.1153846
NODE_10_length_11096_cov_14.154679	6455	6535	4	80	80	1.0000000
NODE_10_length_11096_cov_14.154679	6508	6588	0	24	80	0.3000000
NODE_10_length_11096_cov_14.154679	6508	6588	1	1	80	0.0125000
NODE_10_length_11096_cov_14.154679	6508	6588	4	55	80	0.6875000
NODE_10_length_11096_cov_14.154679	6584	6664	4	80	80	1.0000000
NODE_10_length_11096_cov_14.154679	6637	6717	4	80	80	1.0000000
NODE_10_length_11096_cov_14.154679	7182	7229	14	1	47	0.0212766
NODE_10_length_11096_cov_14.154679	7182	7229	15	26	47	0.5531915
NODE_10_length_11096_cov_14.154679	7182	7229	16	20	47	0.4255319
NODE_10_length_11096_cov_14.154679	7218	7282	12	8	64	0.1250000
NODE_10_length_11096_cov_14.154679	7218	7282	13	15	64	0.2343750
NODE_10_length_11096_cov_14.154679	7218	7282	14	12	64	0.1875000
NODE_10_length_11096_cov_14.154679	7218	7282	15	18	64	0.2812500
NODE_10_length_11096_cov_14.154679	7218	7282	17	7	64	0.1093750
NODE_10_length_11096_cov_14.154679	7218	7282	18	4	64	0.0625000
NODE_13_length_10749_cov_34.330235	3589	3669	24	7	80	0.0875000
NODE_13_length_10749_cov_34.330235	3589	3669	28	10	80	0.1250000
NODE_13_length_10749_cov_34.330235	3589	3669	30	5	80	0.0625000
NODE_13_length_10749_cov_34.330235	3589	3669	32	5	80	0.0625000
NODE_13_length_10749_cov_34.330235	3589	3669	34	14	80	0.1750000
NODE_13_length_10749_cov_34.330235	3589	3669	35	4	80	0.0500000
NODE_13_length_10749_cov_34.330235	3589	3669	36	35	80	0.4375000
NODE_13_length_10749_cov_34.330235	3642	3722	30	1	80	0.0125000
NODE_13_length_10749_cov_34.330235	3642	3722	31	2	80	0.0250000
NODE_13_length_10749_cov_34.330235	3642	3722	32	5	80	0.0625000
NODE_13_length_10749_cov_34.330235	3642	3722	33	7	80	0.0875000
NODE_13_length_10749_cov_34.330235	3642	3722	34	15	80	0.1875000
NODE_13_length_10749_cov_34.330235	3642	3722	35	4	80	0.0500000
NODE_13_length_10749_cov_34.330235	3642	3722	36	35	80	0.4375000
NODE_13_length_10749_cov_34.330235	3642	3722	37	7	80	0.0875000
NODE_13_length_10749_cov_34.330235	3642	3722	38	4	80	0.0500000
NODE_13_length_10749_cov_34.330235	3718	3798	11	7	80	0.0875000
NODE_13_length_10749_cov_34.330235	3718	3798	13	21	80	0.2625000
NODE_13_length_10749_cov_34.330235	3718	3798	14	4	80	0.0500000
NODE_13_length_10749_cov_34.330235	3718	3798	17	5	80	0.0625000
NODE_13_length_10749_cov_34.330235	3718	3798	18	9	80	0.1125000
NODE_13_length_10749_cov_34.330235	3718	3798	19	1	80	0.0125000
NODE_13_length_10749_cov_34.330235	3718	3798	20	5	80	0.0625000
NODE_13_length_10749_cov_34.330235	3718	3798	22	2	80	0.0250000
NODE_13_length_10749_cov_34.330235	3718	3798	23	11	80	0.1375000
NODE_13_length_10749_cov_34.330235	3718	3798	24	6	80	0.0750000
NODE_13_length_10749_cov_34.330235	3718	3798	27	1	80	0.0125000
NODE_13_length_10749_cov_34.330235	3718	3798	30	1	80	0.0125000
NODE_13_length_10749_cov_34.330235	3718	3798	31	6	80	0.0750000
NODE_13_length_10749_cov_34.330235	3718	3798	32	1	80	0.0125000
NODE_13_length_10749_cov_34.330235	3771	3851	10	11	80	0.1375000
NODE_13_length_10749_cov_34.330235	3771	3851	11	13	80	0.1625000
NODE_13_length_10749_cov_34.330235	3771	3851	12	17	80	0.2125000
NODE_13_length_10749_cov_34.330235	3771	3851	13	20	80	0.2500000
NODE_13_length_10749_cov_34.330235	3771	3851	14	19	80	0.2375000
NODE_14_length_10557_cov_50.055938	423	503	1	8	80	0.1000000
NODE_14_length_10557_cov_50.055938	423	503	2	16	80	0.2000000
NODE_14_length_10557_cov_50.055938	423	503	4	2	80	0.0250000
NODE_14_length_10557_cov_50.055938	423	503	7	21	80	0.2625000
NODE_14_length_10557_cov_50.055938	423	503	8	33	80	0.4125000
NODE_14_length_10557_cov_50.055938	476	556	8	80	80	1.0000000
NODE_14_length_10557_cov_50.055938	1625	1696	14	22	71	0.3098592
NODE_14_length_10557_cov_50.055938	1625	1696	15	23	71	0.3239437
NODE_14_length_10557_cov_50.055938	1625	1696	16	21	71	0.2957746
NODE_14_length_10557_cov_50.055938	1625	1696	17	1	71	0.0140845
NODE_14_length_10557_cov_50.055938	1625	1696	29	4	71	0.0563380
NODE_14_length_10557_cov_50.055938	1678	1733	14	41	55	0.7454545
NODE_14_length_10557_cov_50.055938	1678	1733	15	8	55	0.1454545
NODE_14_length_10557_cov_50.055938	1678	1733	16	6	55	0.1090909
NODE_14_length_10557_cov_50.055938	2428	2488	8	11	60	0.1833333
NODE_14_length_10557_cov_50.055938	2428	2488	9	8	60	0.1333333
NODE_14_length_10557_cov_50.055938	2428	2488	10	15	60	0.2500000
NODE_14_length_10557_cov_50.055938	2428	2488	11	4	60	0.0666667
NODE_14_length_10557_cov_50.055938	2428	2488	12	22	60	0.3666667
NODE_17_length_10101_cov_12.236253	923	966	0	43	43	1.0000000
NODE_17_length_10101_cov_12.236253	943	1007	0	64	64	1.0000000
NODE_17_length_10101_cov_12.236253	1715	1795	1	5	80	0.0625000
NODE_17_length_10101_cov_12.236253	1715	1795	2	75	80	0.9375000
NODE_17_length_10101_cov_12.236253	1768	1820	1	29	52	0.5576923
NODE_17_length_10101_cov_12.236253	1768	1820	2	22	52	0.4230769
NODE_17_length_10101_cov_12.236253	1768	1820	3	1	52	0.0192308
NODE_20_length_9442_cov_109.961147	2108	2188	160	1	80	0.0125000
NODE_20_length_9442_cov_109.961147	2108	2188	163	1	80	0.0125000
NODE_20_length_9442_cov_109.961147	2108	2188	164	1	80	0.0125000
NODE_20_length_9442_cov_109.961147	2108	2188	165	1	80	0.0125000
NODE_20_length_9442_cov_109.961147	2108	2188	166	6	80	0.0750000
NODE_20_length_9442_cov_109.961147	2108	2188	167	6	80	0.0750000
NODE_20_length_9442_cov_109.961147	2108	2188	168	1	80	0.0125000
NODE_20_length_9442_cov_109.961147	2108	2188	173	1	80	0.0125000
NODE_20_length_9442_cov_109.961147	2108	2188	175	3	80	0.0375000
NODE_20_length_9442_cov_109.961147	2108	2188	177	1	80	0.0125000
NODE_20_length_9442_cov_109.961147	2108	2188	180	2	80	0.0250000
NODE_20_length_9442_cov_109.961147	2108	2188	182	1	80	0.0125000
NODE_20_length_9442_cov_109.961147	2108	2188	183	1	80	0.0125000
NODE_20_length_9442_cov_109.961147	2108	2188	185	1	80	0.0125000
NODE_20_length_9442_cov_109.961147	2108	2188	186	7	80	0.0875000
NODE_20_length_9442_cov_109.961147	2108	2188	187	9	80	0.1125000
NODE_20_length_9442_cov_109.961147	2108	2188	188	7	80	0.0875000
NODE_20_length_9442_cov_109.961147	2108	2188	189	5	80	0.0625000
NODE_20_length_9442_cov_109.961147	2108	2188	190	9	80	0.1125000
NODE_20_length_9442_cov_109.961147	2108	2188	191	4	80	0.0500000
NODE_20_length_9442_cov_109.961147	2108	2188	192	7	80	0.0875000
NODE_20_length_9442_cov_109.961147	2108	2188	194	1	80	0.0125000
NODE_20_length_9442_cov_109.961147	2108	2188	195	1	80	0.0125000
NODE_20_length_9442_cov_109.961147	2108	2188	196	3	80	0.0375000
NODE_20_length_9442_cov_109.961147	2161	2241	143	1	80	0.0125000
NODE_20_length_9442_cov_109.961147	2161	2241	144	4	80	0.0500000
NODE_20_length_9442_cov_109.961147	2161	2241	145	1	80	0.0125000
NODE_20_length_9442_cov_109.961147	2161	2241	148	3	80	0.0375000
NODE_20_length_9442_cov_109.961147	2161	2241	149	1	80	0.0125000
NODE_20_length_9442_cov_109.961147	2161	2241	151	5	80	0.0625000
NODE_20_length_9442_cov_109.961147	2161	2241	152	2	80	0.0250000
NODE_20_length_9442_cov_109.961147	2161	2241	153	1	80	0.0125000
NODE_20_length_9442_cov_109.961147	2161	2241	154	6	80	0.0750000
NODE_20_length_9442_cov_109.961147	2161	2241	156	1	80	0.0125000
NODE_20_length_9442_cov_109.961147	2161	2241	157	1	80	0.0125000
NODE_20_length_9442_cov_109.961147	2161	2241	159	1	80	0.0125000
NODE_20_length_9442_cov_109.961147	2161	2241	163	1	80	0.0125000
NODE_20_length_9442_cov_109.961147	2161	2241	165	1	80	0.0125000
NODE_20_length_9442_cov_109.961147	2161	2241	169	1	80	0.0125000
NODE_20_length_9442_cov_109.961147	2161	2241	175	2	80	0.0250000
NODE_20_length_9442_cov_109.961147	2161	2241	176	1	80	0.0125000
NODE_20_length_9442_cov_109.961147	2161	2241	177	4	80	0.0500000
NODE_20_length_9442_cov_109.961147	2161	2241	178	4	80	0.0500000
NODE_20_length_9442_cov_109.961147	2161	2241	179	1	80	0.0125000
NODE_20_length_9442_cov_109.961147	2161	2241	180	1	80	0.0125000
NODE_20_length_9442_cov_109.961147	2161	2241	181	2	80	0.0250000
NODE_20_length_9442_cov_109.961147	2161	2241	183	2	80	0.0250000
NODE_20_length_9442_cov_109.961147	2161	2241	185	4	80	0.0500000
NODE_20_length_9442_cov_109.961147	2161	2241	186	7	80	0.0875000
NODE_20_length_9442_cov_109.961147	2161	2241	187	7	80	0.0875000
NODE_20_length_9442_cov_109.961147	2161	2241	188	7	80	0.0875000
NODE_20_length_9442_cov_109.961147	2161	2241	189	3	80	0.0375000
NODE_20_length_9442_cov_109.961147	2161	2241	190	3	80	0.0375000
NODE_20_length_9442_cov_109.961147	2161	2241	192	2	80	0.0250000
NODE_21_length_9414_cov_34.165217	2363	2443	54	3	80	0.0375000
NODE_21_length_9414_cov_34.165217	2363	2443	64	2	80	0.0250000
NODE_21_length_9414_cov_34.165217	2363	2443	65	10	80	0.1250000
NODE_21_length_9414_cov_34.165217	2363	2443	66	4	80	0.0500000
NODE_21_length_9414_cov_34.165217	2363	2443	69	2	80	0.0250000
NODE_21_length_9414_cov_34.165217	2363	2443	73	3	80	0.0375000
NODE_21_length_9414_cov_34.165217	2363	2443	76	4	80	0.0500000
NODE_21_length_9414_cov_34.165217	2363	2443	78	1	80	0.0125000
NODE_21_length_9414_cov_34.165217	2363	2443	80	2	80	0.0250000
NODE_21_length_9414_cov_34.165217	2363	2443	81	5	80	0.0625000
NODE_21_length_9414_cov_34.165217	2363	2443	83	5	80	0.0625000
NODE_21_length_9414_cov_34.165217	2363	2443	84	5	80	0.0625000
NODE_21_length_9414_cov_34.165217	2363	2443	85	7	80	0.0875000
NODE_21_length_9414_cov_34.165217	2363	2443	87	4	80	0.0500000
NODE_21_length_9414_cov_34.165217	2363	2443	89	6	80	0.0750000
NODE_21_length_9414_cov_34.165217	2363	2443	90	2	80	0.0250000
NODE_21_length_9414_cov_34.165217	2363	2443	91	9	80	0.1125000
NODE_21_length_9414_cov_34.165217	2363	2443	93	2	80	0.0250000
NODE_21_length_9414_cov_34.165217	2363	2443	96	4	80	0.0500000
NODE_21_length_9414_cov_34.165217	2416	2484	23	7	68	0.1029412
NODE_21_length_9414_cov_34.165217	2416	2484	24	2	68	0.0294118
NODE_21_length_9414_cov_34.165217	2416	2484	25	1	68	0.0147059
NODE_21_length_9414_cov_34.165217	2416	2484	32	2	68	0.0294118
NODE_21_length_9414_cov_34.165217	2416	2484	34	2	68	0.0294118
NODE_21_length_9414_cov_34.165217	2416	2484	36	4	68	0.0588235
NODE_21_length_9414_cov_34.165217	2416	2484	38	1	68	0.0147059
NODE_21_length_9414_cov_34.165217	2416	2484	43	1	68	0.0147059
NODE_21_length_9414_cov_34.165217	2416	2484	47	2	68	0.0294118
NODE_21_length_9414_cov_34.165217	2416	2484	48	4	68	0.0588235
NODE_21_length_9414_cov_34.165217	2416	2484	49	3	68	0.0441176
NODE_21_length_9414_cov_34.165217	2416	2484	53	12	68	0.1764706
NODE_21_length_9414_cov_34.165217	2416	2484	54	3	68	0.0441176
NODE_21_length_9414_cov_34.165217	2416	2484	64	2	68	0.0294118
NODE_21_length_9414_cov_34.165217	2416	2484	65	10	68	0.1470588
NODE_21_length_9414_cov_34.165217	2416	2484	66	4	68	0.0588235
NODE_21_length_9414_cov_34.165217	2416	2484	69	2	68	0.0294118
NODE_21_length_9414_cov_34.165217	2416	2484	73	3	68	0.0441176
NODE_21_length_9414_cov_34.165217	2416	2484	76	3	68	0.0441176
NODE_21_length_9414_cov_34.165217	5899	5975	1	76	76	1.0000000
NODE_24_length_9168_cov_47.407542	470	550	101	3	80	0.0375000
NODE_24_length_9168_cov_47.407542	470	550	110	1	80	0.0125000
NODE_24_length_9168_cov_47.407542	470	550	111	3	80	0.0375000
NODE_24_length_9168_cov_47.407542	470	550	113	1	80	0.0125000
NODE_24_length_9168_cov_47.407542	470	550	115	1	80	0.0125000
NODE_24_length_9168_cov_47.407542	470	550	116	2	80	0.0250000
NODE_24_length_9168_cov_47.407542	470	550	121	2	80	0.0250000
NODE_24_length_9168_cov_47.407542	470	550	123	3	80	0.0375000
NODE_24_length_9168_cov_47.407542	470	550	124	1	80	0.0125000
NODE_24_length_9168_cov_47.407542	470	550	125	1	80	0.0125000
NODE_24_length_9168_cov_47.407542	470	550	126	5	80	0.0625000
NODE_24_length_9168_cov_47.407542	470	550	127	2	80	0.0250000
NODE_24_length_9168_cov_47.407542	470	550	128	1	80	0.0125000
NODE_24_length_9168_cov_47.407542	470	550	129	2	80	0.0250000
NODE_24_length_9168_cov_47.407542	470	550	131	3	80	0.0375000
NODE_24_length_9168_cov_47.407542	470	550	132	4	80	0.0500000
NODE_24_length_9168_cov_47.407542	470	550	133	1	80	0.0125000
NODE_24_length_9168_cov_47.407542	470	550	134	2	80	0.0250000
NODE_24_length_9168_cov_47.407542	470	550	135	4	80	0.0500000
NODE_24_length_9168_cov_47.407542	470	550	136	3	80	0.0375000
NODE_24_length_9168_cov_47.407542	470	550	137	1	80	0.0125000
NODE_24_length_9168_cov_47.407542	470	550	143	1	80	0.0125000
NODE_24_length_9168_cov_47.407542	470	550	144	2	80	0.0250000
NODE_24_length_9168_cov_47.407542	470	550	145	1	80	0.0125000
NODE_24_length_9168_cov_47.407542	470	550	146	3	80	0.0375000
NODE_24_length_9168_cov_47.407542	470	550	147	1	80	0.0125000
NODE_24_length_9168_cov_47.407542	470	550	153	1	80	0.0125000
NODE_24_length_9168_cov_47.407542	470	550	154	1	80	0.0125000
NODE_24_length_9168_cov_47.407542	470	550	156	1	80	0.0125000
NODE_24_length_9168_cov_47.407542	470	550	159	4	80	0.0500000
NODE_24_length_9168_cov_47.407542	470	550	161	5	80	0.0625000
NODE_24_length_9168_cov_47.407542	470	550	162	4	80	0.0500000
NODE_24_length_9168_cov_47.407542	470	550	163	2	80	0.0250000
NODE_24_length_9168_cov_47.407542	470	550	166	1	80	0.0125000
NODE_24_length_9168_cov_47.407542	470	550	167	1	80	0.0125000
NODE_24_length_9168_cov_47.407542	470	550	168	3	80	0.0375000
NODE_24_length_9168_cov_47.407542	470	550	171	1	80	0.0125000
NODE_24_length_9168_cov_47.407542	470	550	173	2	80	0.0250000
NODE_24_length_9168_cov_47.407542	523	603	136	1	80	0.0125000
NODE_24_length_9168_cov_47.407542	523	603	138	2	80	0.0250000
NODE_24_length_9168_cov_47.407542	523	603	139	2	80	0.0250000
NODE_24_length_9168_cov_47.407542	523	603	143	1	80	0.0125000
NODE_24_length_9168_cov_47.407542	523	603	144	2	80	0.0250000
NODE_24_length_9168_cov_47.407542	523	603	145	4	80	0.0500000
NODE_24_length_9168_cov_47.407542	523	603	146	3	80	0.0375000
NODE_24_length_9168_cov_47.407542	523	603	147	3	80	0.0375000
NODE_24_length_9168_cov_47.407542	523	603	148	1	80	0.0125000
NODE_24_length_9168_cov_47.407542	523	603	149	1	80	0.0125000
NODE_24_length_9168_cov_47.407542	523	603	150	2	80	0.0250000
NODE_24_length_9168_cov_47.407542	523	603	152	3	80	0.0375000
NODE_24_length_9168_cov_47.407542	523	603	153	1	80	0.0125000
NODE_24_length_9168_cov_47.407542	523	603	154	1	80	0.0125000
NODE_24_length_9168_cov_47.407542	523	603	155	1	80	0.0125000
NODE_24_length_9168_cov_47.407542	523	603	156	4	80	0.0500000
NODE_24_length_9168_cov_47.407542	523	603	157	1	80	0.0125000
NODE_24_length_9168_cov_47.407542	523	603	159	5	80	0.0625000
NODE_24_length_9168_cov_47.407542	523	603	161	6	80	0.0750000
NODE_24_length_9168_cov_47.407542	523	603	162	4	80	0.0500000
NODE_24_length_9168_cov_47.407542	523	603	163	2	80	0.0250000
NODE_24_length_9168_cov_47.407542	523	603	164	1	80	0.0125000
NODE_24_length_9168_cov_47.407542	523	603	166	1	80	0.0125000
NODE_24_length_9168_cov_47.407542	523	603	167	1	80	0.0125000
NODE_24_length_9168_cov_47.407542	523	603	168	3	80	0.0375000
NODE_24_length_9168_cov_47.407542	523	603	169	1	80	0.0125000
NODE_24_length_9168_cov_47.407542	523	603	170	1	80	0.0125000
NODE_24_length_9168_cov_47.407542	523	603	171	4	80	0.0500000
NODE_24_length_9168_cov_47.407542	523	603	172	3	80	0.0375000
NODE_24_length_9168_cov_47.407542	523	603	173	7	80	0.0875000
NODE_24_length_9168_cov_47.407542	523	603	174	1	80	0.0125000
NODE_24_length_9168_cov_47.407542	523	603	175	7	80	0.0875000
NODE_27_length_9108_cov_47.430347	4786	4866	61	1	80	0.0125000
NODE_27_length_9108_cov_47.430347	4786	4866	62	1	80	0.0125000
NODE_27_length_9108_cov_47.430347	4786	4866	63	5	80	0.0625000
NODE_27_length_9108_cov_47.430347	4786	4866	64	3	80	0.0375000
NODE_27_length_9108_cov_47.430347	4786	4866	65	8	80	0.1000000
NODE_27_length_9108_cov_47.430347	4786	4866	66	4	80	0.0500000
NODE_27_length_9108_cov_47.430347	4786	4866	67	5	80	0.0625000
NODE_27_length_9108_cov_47.430347	4786	4866	68	14	80	0.1750000
NODE_27_length_9108_cov_47.430347	4786	4866	69	9	80	0.1125000
NODE_27_length_9108_cov_47.430347	4786	4866	70	8	80	0.1000000
NODE_27_length_9108_cov_47.430347	4786	4866	71	6	80	0.0750000
NODE_27_length_9108_cov_47.430347	4786	4866	72	13	80	0.1625000
NODE_27_length_9108_cov_47.430347	4786	4866	73	2	80	0.0250000
NODE_27_length_9108_cov_47.430347	4786	4866	74	1	80	0.0125000
NODE_27_length_9108_cov_47.430347	4839	4902	62	2	63	0.0317460
NODE_27_length_9108_cov_47.430347	4839	4902	63	1	63	0.0158730
NODE_27_length_9108_cov_47.430347	4839	4902	64	2	63	0.0317460
NODE_27_length_9108_cov_47.430347	4839	4902	65	5	63	0.0793651
NODE_27_length_9108_cov_47.430347	4839	4902	66	16	63	0.2539683
NODE_27_length_9108_cov_47.430347	4839	4902	67	6	63	0.0952381
NODE_27_length_9108_cov_47.430347	4839	4902	68	2	63	0.0317460
NODE_27_length_9108_cov_47.430347	4839	4902	69	9	63	0.1428571
NODE_27_length_9108_cov_47.430347	4839	4902	70	1	63	0.0158730
NODE_27_length_9108_cov_47.430347	4839	4902	71	4	63	0.0634921
NODE_27_length_9108_cov_47.430347	4839	4902	72	12	63	0.1904762
NODE_27_length_9108_cov_47.430347	4839	4902	73	3	63	0.0476190
NODE_27_length_9108_cov_47.430347	4895	4963	31	6	68	0.0882353
NODE_27_length_9108_cov_47.430347	4895	4963	32	8	68	0.1176471
NODE_27_length_9108_cov_47.430347	4895	4963	39	6	68	0.0882353
NODE_27_length_9108_cov_47.430347	4895	4963	40	2	68	0.0294118
NODE_27_length_9108_cov_47.430347	4895	4963	41	1	68	0.0147059
NODE_27_length_9108_cov_47.430347	4895	4963	42	8	68	0.1176471
NODE_27_length_9108_cov_47.430347	4895	4963	44	2	68	0.0294118
NODE_27_length_9108_cov_47.430347	4895	4963	45	2	68	0.0294118
NODE_27_length_9108_cov_47.430347	4895	4963	46	1	68	0.0147059
NODE_27_length_9108_cov_47.430347	4895	4963	47	1	68	0.0147059
NODE_27_length_9108_cov_47.430347	4895	4963	48	6	68	0.0882353
NODE_27_length_9108_cov_47.430347	4895	4963	49	5	68	0.0735294
NODE_27_length_9108_cov_47.430347	4895	4963	53	3	68	0.0441176
NODE_27_length_9108_cov_47.430347	4895	4963	54	1	68	0.0147059
NODE_27_length_9108_cov_47.430347	4895	4963	55	1	68	0.0147059
NODE_27_length_9108_cov_47.430347	4895	4963	57	1	68	0.0147059
NODE_27_length_9108_cov_47.430347	4895	4963	58	2	68	0.0294118
NODE_27_length_9108_cov_47.430347	4895	4963	59	2	68	0.0294118
NODE_27_length_9108_cov_47.430347	4895	4963	60	3	68	0.0441176
NODE_27_length_9108_cov_47.430347	4895	4963	62	2	68	0.0294118
NODE_27_length_9108_cov_47.430347	4895	4963	63	1	68	0.0147059
NODE_27_length_9108_cov_47.430347	4895	4963	64	2	68	0.0294118
NODE_27_length_9108_cov_47.430347	4895	4963	66	2	68	0.0294118
NODE_27_length_9108_cov_47.430347	4936	5016	17	4	80	0.0500000
NODE_27_length_9108_cov_47.430347	4936	5016	18	1	80	0.0125000
NODE_27_length_9108_cov_47.430347	4936	5016	19	20	80	0.2500000
NODE_27_length_9108_cov_47.430347	4936	5016	20	3	80	0.0375000
NODE_27_length_9108_cov_47.430347	4936	5016	22	9	80	0.1125000
NODE_27_length_9108_cov_47.430347	4936	5016	23	4	80	0.0500000
NODE_27_length_9108_cov_47.430347	4936	5016	25	4	80	0.0500000
NODE_27_length_9108_cov_47.430347	4936	5016	26	2	80	0.0250000
NODE_27_length_9108_cov_47.430347	4936	5016	28	6	80	0.0750000
NODE_27_length_9108_cov_47.430347	4936	5016	31	6	80	0.0750000
NODE_27_length_9108_cov_47.430347	4936	5016	32	8	80	0.1000000
NODE_27_length_9108_cov_47.430347	4936	5016	39	6	80	0.0750000
NODE_27_length_9108_cov_47.430347	4936	5016	40	2	80	0.0250000
NODE_27_length_9108_cov_47.430347	4936	5016	41	1	80	0.0125000
NODE_27_length_9108_cov_47.430347	4936	5016	42	4	80	0.0500000
NODE_28_length_9108_cov_26.469974	44	120	1	76	76	1.0000000
NODE_28_length_9108_cov_26.469974	7711	7791	2	1	80	0.0125000
NODE_28_length_9108_cov_26.469974	7711	7791	8	3	80	0.0375000
NODE_28_length_9108_cov_26.469974	7711	7791	9	1	80	0.0125000
NODE_28_length_9108_cov_26.469974	7711	7791	10	1	80	0.0125000
NODE_28_length_9108_cov_26.469974	7711	7791	11	1	80	0.0125000
NODE_28_length_9108_cov_26.469974	7711	7791	12	1	80	0.0125000
NODE_28_length_9108_cov_26.469974	7711	7791	13	3	80	0.0375000
NODE_28_length_9108_cov_26.469974	7711	7791	14	5	80	0.0625000
NODE_28_length_9108_cov_26.469974	7711	7791	15	3	80	0.0375000
NODE_28_length_9108_cov_26.469974	7711	7791	16	2	80	0.0250000
NODE_28_length_9108_cov_26.469974	7711	7791	17	2	80	0.0250000
NODE_28_length_9108_cov_26.469974	7711	7791	18	3	80	0.0375000
NODE_28_length_9108_cov_26.469974	7711	7791	19	2	80	0.0250000
NODE_28_length_9108_cov_26.469974	7711	7791	20	7	80	0.0875000
NODE_28_length_9108_cov_26.469974	7711	7791	21	2	80	0.0250000
NODE_28_length_9108_cov_26.469974	7711	7791	24	4	80	0.0500000
NODE_28_length_9108_cov_26.469974	7711	7791	26	9	80	0.1125000
NODE_28_length_9108_cov_26.469974	7711	7791	27	3	80	0.0375000
NODE_28_length_9108_cov_26.469974	7711	7791	28	12	80	0.1500000
NODE_28_length_9108_cov_26.469974	7711	7791	29	4	80	0.0500000
NODE_28_length_9108_cov_26.469974	7711	7791	32	6	80	0.0750000
NODE_28_length_9108_cov_26.469974	7711	7791	33	4	80	0.0500000
NODE_28_length_9108_cov_26.469974	7711	7791	34	1	80	0.0125000
NODE_28_length_9108_cov_26.469974	8144	8224	2	1	80	0.0125000
NODE_28_length_9108_cov_26.469974	8144	8224	15	4	80	0.0500000
NODE_28_length_9108_cov_26.469974	8144	8224	16	3	80	0.0375000
NODE_28_length_9108_cov_26.469974	8144	8224	17	2	80	0.0250000
NODE_28_length_9108_cov_26.469974	8144	8224	18	1	80	0.0125000
NODE_28_length_9108_cov_26.469974	8144	8224	20	22	80	0.2750000
NODE_28_length_9108_cov_26.469974	8144	8224	21	6	80	0.0750000
NODE_28_length_9108_cov_26.469974	8144	8224	22	6	80	0.0750000
NODE_28_length_9108_cov_26.469974	8144	8224	23	4	80	0.0500000
NODE_28_length_9108_cov_26.469974	8144	8224	24	4	80	0.0500000
NODE_28_length_9108_cov_26.469974	8144	8224	25	4	80	0.0500000
NODE_28_length_9108_cov_26.469974	8144	8224	26	4	80	0.0500000
NODE_28_length_9108_cov_26.469974	8144	8224	27	12	80	0.1500000
NODE_28_length_9108_cov_26.469974	8144	8224	29	1	80	0.0125000
NODE_28_length_9108_cov_26.469974	8144	8224	30	1	80	0.0125000
NODE_28_length_9108_cov_26.469974	8144	8224	34	2	80	0.0250000
NODE_28_length_9108_cov_26.469974	8144	8224	35	3	80	0.0375000
NODE_28_length_9108_cov_26.469974	8568	8648	2	13	80	0.1625000
NODE_28_length_9108_cov_26.469974	8568	8648	3	29	80	0.3625000
NODE_28_length_9108_cov_26.469974	8568	8648	4	38	80	0.4750000
NODE_28_length_9108_cov_26.469974	8621	8701	2	19	80	0.2375000
NODE_28_length_9108_cov_26.469974	8621	8701	3	10	80	0.1250000
NODE_28_length_9108_cov_26.469974	8621	8701	4	51	80	0.6375000
NODE_30_length_8743_cov_14.172721	7849	7929	3	16	80	0.2000000
NODE_30_length_8743_cov_14.172721	7849	7929	4	1	80	0.0125000
NODE_30_length_8743_cov_14.172721	7849	7929	5	63	80	0.7875000
NODE_30_length_8743_cov_14.172721	7902	7964	1	5	62	0.0806452
NODE_30_length_8743_cov_14.172721	7902	7964	2	13	62	0.2096774
NODE_30_length_8743_cov_14.172721	7902	7964	3	33	62	0.5322581
NODE_30_length_8743_cov_14.172721	7902	7964	5	11	62	0.1774193
NODE_32_length_8707_cov_6.353044	8541	8621	0	80	80	1.0000000
NODE_32_length_8707_cov_6.353044	8541	8621	0	80	80	1.0000000
NODE_32_length_8707_cov_6.353044	8541	8621	0	80	80	1.0000000
NODE_32_length_8707_cov_6.353044	8594	8674	0	80	80	1.0000000
NODE_32_length_8707_cov_6.353044	8594	8674	0	80	80	1.0000000
NODE_32_length_8707_cov_6.353044	8594	8673	0	79	79	1.0000000
NODE_32_length_8707_cov_6.353044	8599	8674	0	75	75	1.0000000
NODE_38_length_8281_cov_13.025177	7108	7188	3	4	80	0.0500000
NODE_38_length_8281_cov_13.025177	7108	7188	4	43	80	0.5375000
NODE_38_length_8281_cov_13.025177	7108	7188	5	29	80	0.3625000
NODE_38_length_8281_cov_13.025177	7108	7188	6	4	80	0.0500000
NODE_38_length_8281_cov_13.025177	7161	7199	3	4	38	0.1052632
NODE_38_length_8281_cov_13.025177	7161	7199	4	15	38	0.3947369
NODE_38_length_8281_cov_13.025177	7161	7199	5	4	38	0.1052632
NODE_38_length_8281_cov_13.025177	7161	7199	6	15	38	0.3947369
NODE_38_length_8281_cov_13.025177	7175	7255	4	9	80	0.1125000
NODE_38_length_8281_cov_13.025177	7175	7255	6	21	80	0.2625000
NODE_38_length_8281_cov_13.025177	7175	7255	7	7	80	0.0875000
NODE_38_length_8281_cov_13.025177	7175	7255	8	25	80	0.3125000
NODE_38_length_8281_cov_13.025177	7175	7255	10	18	80	0.2250000
NODE_38_length_8281_cov_13.025177	7228	7308	7	24	80	0.3000000
NODE_38_length_8281_cov_13.025177	7228	7308	8	54	80	0.6750000
NODE_38_length_8281_cov_13.025177	7228	7308	10	2	80	0.0250000
NODE_38_length_8281_cov_13.025177	7749	7829	4	10	80	0.1250000
NODE_38_length_8281_cov_13.025177	7749	7829	5	7	80	0.0875000
NODE_38_length_8281_cov_13.025177	7749	7829	6	8	80	0.1000000
NODE_38_length_8281_cov_13.025177	7749	7829	8	35	80	0.4375000
NODE_38_length_8281_cov_13.025177	7749	7829	9	8	80	0.1000000
NODE_38_length_8281_cov_13.025177	7749	7829	10	9	80	0.1125000
NODE_38_length_8281_cov_13.025177	7749	7829	11	3	80	0.0375000
NODE_38_length_8281_cov_13.025177	7802	7882	8	7	80	0.0875000
NODE_38_length_8281_cov_13.025177	7802	7882	9	8	80	0.1000000
NODE_38_length_8281_cov_13.025177	7802	7882	10	9	80	0.1125000
NODE_38_length_8281_cov_13.025177	7802	7882	11	4	80	0.0500000
NODE_38_length_8281_cov_13.025177	7802	7882	12	1	80	0.0125000
NODE_38_length_8281_cov_13.025177	7802	7882	13	10	80	0.1250000
NODE_38_length_8281_cov_13.025177	7802	7882	14	17	80	0.2125000
NODE_38_length_8281_cov_13.025177	7802	7882	15	2	80	0.0250000
NODE_38_length_8281_cov_13.025177	7802	7882	16	22	80	0.2750000
NODE_38_length_8281_cov_13.025177	7878	7958	10	34	80	0.4250000
NODE_38_length_8281_cov_13.025177	7878	7958	12	9	80	0.1125000
NODE_38_length_8281_cov_13.025177	7878	7958	13	6	80	0.0750000
NODE_38_length_8281_cov_13.025177	7878	7958	14	17	80	0.2125000
NODE_38_length_8281_cov_13.025177	7878	7958	15	11	80	0.1375000
NODE_38_length_8281_cov_13.025177	7878	7958	16	3	80	0.0375000
NODE_38_length_8281_cov_13.025177	7931	8011	0	4	80	0.0500000
NODE_38_length_8281_cov_13.025177	7931	8011	2	14	80	0.1750000
NODE_38_length_8281_cov_13.025177	7931	8011	3	11	80	0.1375000
NODE_38_length_8281_cov_13.025177	7931	8011	4	2	80	0.0250000
NODE_38_length_8281_cov_13.025177	7931	8011	5	5	80	0.0625000
NODE_38_length_8281_cov_13.025177	7931	8011	6	9	80	0.1125000
NODE_38_length_8281_cov_13.025177	7931	8011	7	7	80	0.0875000
NODE_38_length_8281_cov_13.025177	7931	8011	10	28	80	0.3500000
NODE_39_length_8259_cov_60.011152	1424	1504	70	1	80	0.0125000
NODE_39_length_8259_cov_60.011152	1424	1504	71	2	80	0.0250000
NODE_39_length_8259_cov_60.011152	1424	1504	72	1	80	0.0125000
NODE_39_length_8259_cov_60.011152	1424	1504	73	1	80	0.0125000
NODE_39_length_8259_cov_60.011152	1424	1504	74	3	80	0.0375000
NODE_39_length_8259_cov_60.011152	1424	1504	75	1	80	0.0125000
NODE_39_length_8259_cov_60.011152	1424	1504	76	2	80	0.0250000
NODE_39_length_8259_cov_60.011152	1424	1504	77	1	80	0.0125000
NODE_39_length_8259_cov_60.011152	1424	1504	78	1	80	0.0125000
NODE_39_length_8259_cov_60.011152	1424	1504	79	2	80	0.0250000
NODE_39_length_8259_cov_60.011152	1424	1504	80	1	80	0.0125000
NODE_39_length_8259_cov_60.011152	1424	1504	81	1	80	0.0125000
NODE_39_length_8259_cov_60.011152	1424	1504	82	3	80	0.0375000
NODE_39_length_8259_cov_60.011152	1424	1504	91	10	80	0.1250000
NODE_39_length_8259_cov_60.011152	1424	1504	92	7	80	0.0875000
NODE_39_length_8259_cov_60.011152	1424	1504	93	9	80	0.1125000
NODE_39_length_8259_cov_60.011152	1424	1504	94	2	80	0.0250000
NODE_39_length_8259_cov_60.011152	1424	1504	95	1	80	0.0125000
NODE_39_length_8259_cov_60.011152	1424	1504	96	1	80	0.0125000
NODE_39_length_8259_cov_60.011152	1424	1504	97	4	80	0.0500000
NODE_39_length_8259_cov_60.011152	1424	1504	98	1	80	0.0125000
NODE_39_length_8259_cov_60.011152	1424	1504	100	4	80	0.0500000
NODE_39_length_8259_cov_60.011152	1424	1504	101	7	80	0.0875000
NODE_39_length_8259_cov_60.011152	1424	1504	102	6	80	0.0750000
NODE_39_length_8259_cov_60.011152	1424	1504	103	3	80	0.0375000
NODE_39_length_8259_cov_60.011152	1424	1504	104	2	80	0.0250000
NODE_39_length_8259_cov_60.011152	1424	1504	105	3	80	0.0375000
NODE_39_length_8259_cov_60.011152	1477	1549	84	3	72	0.0416667
NODE_39_length_8259_cov_60.011152	1477	1549	88	2	72	0.0277778
NODE_39_length_8259_cov_60.011152	1477	1549	89	6	72	0.0833333
NODE_39_length_8259_cov_60.011152	1477	1549	90	9	72	0.1250000
NODE_39_length_8259_cov_60.011152	1477	1549	91	10	72	0.1388889
NODE_39_length_8259_cov_60.011152	1477	1549	92	2	72	0.0277778
NODE_39_length_8259_cov_60.011152	1477	1549	93	13	72	0.1805556
NODE_39_length_8259_cov_60.011152	1477	1549	94	7	72	0.0972222
NODE_39_length_8259_cov_60.011152	1477	1549	95	1	72	0.0138889
NODE_39_length_8259_cov_60.011152	1477	1549	96	3	72	0.0416667
NODE_39_length_8259_cov_60.011152	1477	1549	97	5	72	0.0694444
NODE_39_length_8259_cov_60.011152	1477	1549	98	1	72	0.0138889
NODE_39_length_8259_cov_60.011152	1477	1549	100	4	72	0.0555556
NODE_39_length_8259_cov_60.011152	1477	1549	101	1	72	0.0138889
NODE_39_length_8259_cov_60.011152	1477	1549	102	4	72	0.0555556
NODE_39_length_8259_cov_60.011152	1477	1549	103	1	72	0.0138889
NODE_40_length_8228_cov_17.079592	314	394	1	72	80	0.9000000
NODE_40_length_8228_cov_17.079592	314	394	2	8	80	0.1000000
NODE_40_length_8228_cov_17.079592	367	447	1	80	80	1.0000000
NODE_40_length_8228_cov_17.079592	443	523	1	31	80	0.3875000
NODE_40_length_8228_cov_17.079592	443	523	2	24	80	0.3000000
NODE_40_length_8228_cov_17.079592	443	523	3	13	80	0.1625000
NODE_40_length_8228_cov_17.079592	443	523	4	12	80	0.1500000
NODE_40_length_8228_cov_17.079592	496	576	2	9	80	0.1125000
NODE_40_length_8228_cov_17.079592	496	576	3	6	80	0.0750000
NODE_40_length_8228_cov_17.079592	496	576	4	65	80	0.8125000
NODE_40_length_8228_cov_17.079592	3154	3217	0	63	63	1.0000000
NODE_43_length_8100_cov_32.115236	501	581	2	37	80	0.4625000
NODE_43_length_8100_cov_32.115236	501	581	4	9	80	0.1125000
NODE_43_length_8100_cov_32.115236	501	581	5	5	80	0.0625000
NODE_43_length_8100_cov_32.115236	501	581	7	4	80	0.0500000
NODE_43_length_8100_cov_32.115236	501	581	8	25	80	0.3125000
NODE_43_length_8100_cov_32.115236	554	634	7	2	80	0.0250000
NODE_43_length_8100_cov_32.115236	554	634	8	37	80	0.4625000
NODE_43_length_8100_cov_32.115236	554	634	9	22	80	0.2750000
NODE_43_length_8100_cov_32.115236	554	634	10	19	80	0.2375000
NODE_43_length_8100_cov_32.115236	1383	1463	0	80	80	1.0000000
NODE_43_length_8100_cov_32.115236	1436	1516	0	80	80	1.0000000
NODE_43_length_8100_cov_32.115236	3391	3462	70	1	71	0.0140845
NODE_43_length_8100_cov_32.115236	3391	3462	72	3	71	0.0422535
NODE_43_length_8100_cov_32.115236	3391	3462	73	11	71	0.1549296
NODE_43_length_8100_cov_32.115236	3391	3462	74	13	71	0.1830986
NODE_43_length_8100_cov_32.115236	3391	3462	75	1	71	0.0140845
NODE_43_length_8100_cov_32.115236	3391	3462	76	1	71	0.0140845
NODE_43_length_8100_cov_32.115236	3391	3462	78	11	71	0.1549296
NODE_43_length_8100_cov_32.115236	3391	3462	79	3	71	0.0422535
NODE_43_length_8100_cov_32.115236	3391	3462	81	4	71	0.0563380
NODE_43_length_8100_cov_32.115236	3391	3462	82	2	71	0.0281690
NODE_43_length_8100_cov_32.115236	3391	3462	83	3	71	0.0422535
NODE_43_length_8100_cov_32.115236	3391	3462	85	11	71	0.1549296
NODE_43_length_8100_cov_32.115236	3391	3462	86	5	71	0.0704225
NODE_43_length_8100_cov_32.115236	3391	3462	87	2	71	0.0281690
NODE_43_length_8100_cov_32.115236	3435	3483	54	5	48	0.1041667
NODE_43_length_8100_cov_32.115236	3435	3483	55	1	48	0.0208333
NODE_43_length_8100_cov_32.115236	3435	3483	56	1	48	0.0208333
NODE_43_length_8100_cov_32.115236	3435	3483	57	1	48	0.0208333
NODE_43_length_8100_cov_32.115236	3435	3483	58	1	48	0.0208333
NODE_43_length_8100_cov_32.115236	3435	3483	61	2	48	0.0416667
NODE_43_length_8100_cov_32.115236	3435	3483	63	4	48	0.0833333
NODE_43_length_8100_cov_32.115236	3435	3483	64	1	48	0.0208333
NODE_43_length_8100_cov_32.115236	3435	3483	66	2	48	0.0416667
NODE_43_length_8100_cov_32.115236	3435	3483	67	1	48	0.0208333
NODE_43_length_8100_cov_32.115236	3435	3483	70	3	48	0.0625000
NODE_43_length_8100_cov_32.115236	3435	3483	72	3	48	0.0625000
NODE_43_length_8100_cov_32.115236	3435	3483	73	10	48	0.2083333
NODE_43_length_8100_cov_32.115236	3435	3483	74	13	48	0.2708333
NODE_46_length_7962_cov_31.622790	6281	6363	14	1	82	0.0121951
NODE_46_length_7962_cov_31.622790	6281	6363	15	16	82	0.1951219
NODE_46_length_7962_cov_31.622790	6281	6363	16	3	82	0.0365854
NODE_46_length_7962_cov_31.622790	6281	6363	17	11	82	0.1341463
NODE_46_length_7962_cov_31.622790	6281	6363	19	9	82	0.1097561
NODE_46_length_7962_cov_31.622790	6281	6363	20	12	82	0.1463415
NODE_46_length_7962_cov_31.622790	6281	6363	21	22	82	0.2682927
NODE_46_length_7962_cov_31.622790	6281	6363	22	2	82	0.0243902
NODE_46_length_7962_cov_31.622790	6281	6363	23	4	82	0.0487805
NODE_46_length_7962_cov_31.622790	6281	6363	24	2	82	0.0243902
NODE_47_length_7944_cov_12.238496	348	419	5	17	71	0.2394366
NODE_47_length_7944_cov_12.238496	348	419	7	54	71	0.7605634
NODE_48_length_7919_cov_14.554859	2380	2460	3	6	80	0.0750000
NODE_48_length_7919_cov_14.554859	2380	2460	4	74	80	0.9250000
NODE_50_length_7830_cov_4.211098	0	52	0	39	52	0.7500000
NODE_50_length_7830_cov_4.211098	0	52	2	13	52	0.2500000
NODE_50_length_7830_cov_4.211098	30	105	0	9	75	0.1200000
NODE_50_length_7830_cov_4.211098	30	105	2	66	75	0.8800000
NODE_52_length_7779_cov_20.230859	7691	7771	0	80	80	1.0000000
NODE_52_length_7779_cov_20.230859	7691	7771	0	80	80	1.0000000
NODE_52_length_7779_cov_20.230859	7691	7761	0	70	70	1.0000000
NODE_52_length_7779_cov_20.230859	7744	7779	0	35	35	1.0000000
NODE_53_length_7765_cov_18.871119	254	322	1	1	68	0.0147059
NODE_53_length_7765_cov_18.871119	254	322	2	28	68	0.4117647
NODE_53_length_7765_cov_18.871119	254	322	3	39	68	0.5735294
NODE_53_length_7765_cov_18.871119	353	433	3	24	80	0.3000000
NODE_53_length_7765_cov_18.871119	353	433	4	33	80	0.4125000
NODE_53_length_7765_cov_18.871119	353	433	5	23	80	0.2875000
NODE_61_length_7411_cov_74.967314	2283	2347	3	46	64	0.7187500
NODE_61_length_7411_cov_74.967314	2283	2347	4	15	64	0.2343750
NODE_61_length_7411_cov_74.967314	2283	2347	5	3	64	0.0468750
NODE_61_length_7411_cov_74.967314	4725	4789	0	64	64	1.0000000
NODE_64_length_7305_cov_3.696087	971	1019	0	48	48	1.0000000
NODE_64_length_7305_cov_3.696087	7142	7190	0	47	48	0.9791667
NODE_64_length_7305_cov_3.696087	7142	7190	1	1	48	0.0208333
NODE_66_length_7261_cov_12.433398	2313	2395	90	7	82	0.0853659
NODE_66_length_7261_cov_12.433398	2313	2395	91	1	82	0.0121951
NODE_66_length_7261_cov_12.433398	2313	2395	92	2	82	0.0243902
NODE_66_length_7261_cov_12.433398	2313	2395	93	6	82	0.0731707
NODE_66_length_7261_cov_12.433398	2313	2395	94	3	82	0.0365854
NODE_66_length_7261_cov_12.433398	2313	2395	95	1	82	0.0121951
NODE_66_length_7261_cov_12.433398	2313	2395	97	1	82	0.0121951
NODE_66_length_7261_cov_12.433398	2313	2395	98	1	82	0.0121951
NODE_66_length_7261_cov_12.433398	2313	2395	99	2	82	0.0243902
NODE_66_length_7261_cov_12.433398	2313	2395	100	1	82	0.0121951
NODE_66_length_7261_cov_12.433398	2313	2395	102	1	82	0.0121951
NODE_66_length_7261_cov_12.433398	2313	2395	103	4	82	0.0487805
NODE_66_length_7261_cov_12.433398	2313	2395	104	1	82	0.0121951
NODE_66_length_7261_cov_12.433398	2313	2395	105	6	82	0.0731707
NODE_66_length_7261_cov_12.433398	2313	2395	106	5	82	0.0609756
NODE_66_length_7261_cov_12.433398	2313	2395	111	4	82	0.0487805
NODE_66_length_7261_cov_12.433398	2313	2395	113	3	82	0.0365854
NODE_66_length_7261_cov_12.433398	2313	2395	114	2	82	0.0243902
NODE_66_length_7261_cov_12.433398	2313	2395	115	2	82	0.0243902
NODE_66_length_7261_cov_12.433398	2313	2395	116	3	82	0.0365854
NODE_66_length_7261_cov_12.433398	2313	2395	117	4	82	0.0487805
NODE_66_length_7261_cov_12.433398	2313	2395	125	1	82	0.0121951
NODE_66_length_7261_cov_12.433398	2313	2395	126	2	82	0.0243902
NODE_66_length_7261_cov_12.433398	2313	2395	127	2	82	0.0243902
NODE_66_length_7261_cov_12.433398	2313	2395	128	5	82	0.0609756
NODE_66_length_7261_cov_12.433398	2313	2395	129	2	82	0.0243902
NODE_66_length_7261_cov_12.433398	2313	2395	130	2	82	0.0243902
NODE_66_length_7261_cov_12.433398	2313	2395	131	1	82	0.0121951
NODE_66_length_7261_cov_12.433398	2313	2395	136	1	82	0.0121951
NODE_66_length_7261_cov_12.433398	2313	2395	137	4	82	0.0487805
NODE_66_length_7261_cov_12.433398	2313	2395	138	1	82	0.0121951
NODE_66_length_7261_cov_12.433398	2313	2395	142	1	82	0.0121951
NODE_73_length_7036_cov_65.961943	4375	4455	1	7	80	0.0875000
NODE_73_length_7036_cov_65.961943	4375	4455	2	73	80	0.9125000
NODE_73_length_7036_cov_65.961943	5538	5618	44	2	80	0.0250000
NODE_73_length_7036_cov_65.961943	5538	5618	45	1	80	0.0125000
NODE_73_length_7036_cov_65.961943	5538	5618	46	6	80	0.0750000
NODE_73_length_7036_cov_65.961943	5538	5618	47	5	80	0.0625000
NODE_73_length_7036_cov_65.961943	5538	5618	49	1	80	0.0125000
NODE_73_length_7036_cov_65.961943	5538	5618	52	2	80	0.0250000
NODE_73_length_7036_cov_65.961943	5538	5618	56	1	80	0.0125000
NODE_73_length_7036_cov_65.961943	5538	5618	57	3	80	0.0375000
NODE_73_length_7036_cov_65.961943	5538	5618	59	2	80	0.0250000
NODE_73_length_7036_cov_65.961943	5538	5618	61	1	80	0.0125000
NODE_73_length_7036_cov_65.961943	5538	5618	63	4	80	0.0500000
NODE_73_length_7036_cov_65.961943	5538	5618	65	2	80	0.0250000
NODE_73_length_7036_cov_65.961943	5538	5618	67	1	80	0.0125000
NODE_73_length_7036_cov_65.961943	5538	5618	68	2	80	0.0250000
NODE_73_length_7036_cov_65.961943	5538	5618	69	2	80	0.0250000
NODE_73_length_7036_cov_65.961943	5538	5618	79	1	80	0.0125000
NODE_73_length_7036_cov_65.961943	5538	5618	81	3	80	0.0375000
NODE_73_length_7036_cov_65.961943	5538	5618	83	1	80	0.0125000
NODE_73_length_7036_cov_65.961943	5538	5618	84	1	80	0.0125000
NODE_73_length_7036_cov_65.961943	5538	5618	86	2	80	0.0250000
NODE_73_length_7036_cov_65.961943	5538	5618	87	1	80	0.0125000
NODE_73_length_7036_cov_65.961943	5538	5618	89	2	80	0.0250000
NODE_73_length_7036_cov_65.961943	5538	5618	91	1	80	0.0125000
NODE_73_length_7036_cov_65.961943	5538	5618	92	2	80	0.0250000
NODE_73_length_7036_cov_65.961943	5538	5618	93	2	80	0.0250000
NODE_73_length_7036_cov_65.961943	5538	5618	95	1	80	0.0125000
NODE_73_length_7036_cov_65.961943	5538	5618	96	3	80	0.0375000
NODE_73_length_7036_cov_65.961943	5538	5618	98	1	80	0.0125000
NODE_73_length_7036_cov_65.961943	5538	5618	99	1	80	0.0125000
NODE_73_length_7036_cov_65.961943	5538	5618	101	2	80	0.0250000
NODE_73_length_7036_cov_65.961943	5538	5618	103	3	80	0.0375000
NODE_73_length_7036_cov_65.961943	5538	5618	108	2	80	0.0250000
NODE_73_length_7036_cov_65.961943	5538	5618	111	1	80	0.0125000
NODE_73_length_7036_cov_65.961943	5538	5618	112	1	80	0.0125000
NODE_73_length_7036_cov_65.961943	5538	5618	114	6	80	0.0750000
NODE_73_length_7036_cov_65.961943	5538	5618	118	1	80	0.0125000
NODE_73_length_7036_cov_65.961943	5538	5618	119	1	80	0.0125000
NODE_73_length_7036_cov_65.961943	5538	5618	120	1	80	0.0125000
NODE_73_length_7036_cov_65.961943	5538	5618	121	1	80	0.0125000
NODE_73_length_7036_cov_65.961943	5538	5618	122	3	80	0.0375000
NODE_73_length_7036_cov_65.961943	5538	5618	123	1	80	0.0125000
NODE_73_length_7036_cov_65.961943	5591	5666	96	2	75	0.0266667
NODE_73_length_7036_cov_65.961943	5591	5666	98	1	75	0.0133333
NODE_73_length_7036_cov_65.961943	5591	5666	99	1	75	0.0133333
NODE_73_length_7036_cov_65.961943	5591	5666	101	2	75	0.0266667
NODE_73_length_7036_cov_65.961943	5591	5666	103	3	75	0.0400000
NODE_73_length_7036_cov_65.961943	5591	5666	108	2	75	0.0266667
NODE_73_length_7036_cov_65.961943	5591	5666	111	1	75	0.0133333
NODE_73_length_7036_cov_65.961943	5591	5666	112	1	75	0.0133333
NODE_73_length_7036_cov_65.961943	5591	5666	114	6	75	0.0800000
NODE_73_length_7036_cov_65.961943	5591	5666	118	1	75	0.0133333
NODE_73_length_7036_cov_65.961943	5591	5666	119	8	75	0.1066667
NODE_73_length_7036_cov_65.961943	5591	5666	120	2	75	0.0266667
NODE_73_length_7036_cov_65.961943	5591	5666	121	8	75	0.1066667
NODE_73_length_7036_cov_65.961943	5591	5666	122	7	75	0.0933333
NODE_73_length_7036_cov_65.961943	5591	5666	123	2	75	0.0266667
NODE_73_length_7036_cov_65.961943	5591	5666	124	5	75	0.0666667
NODE_73_length_7036_cov_65.961943	5591	5666	125	2	75	0.0266667
NODE_73_length_7036_cov_65.961943	5591	5666	126	1	75	0.0133333
NODE_73_length_7036_cov_65.961943	5591	5666	127	2	75	0.0266667
NODE_73_length_7036_cov_65.961943	5591	5666	130	4	75	0.0533333
NODE_73_length_7036_cov_65.961943	5591	5666	131	1	75	0.0133333
NODE_73_length_7036_cov_65.961943	5591	5666	132	3	75	0.0400000
NODE_73_length_7036_cov_65.961943	5591	5666	133	1	75	0.0133333
NODE_73_length_7036_cov_65.961943	5591	5666	134	1	75	0.0133333
NODE_73_length_7036_cov_65.961943	5591	5666	135	1	75	0.0133333
NODE_73_length_7036_cov_65.961943	5591	5666	137	3	75	0.0400000
NODE_73_length_7036_cov_65.961943	5591	5666	138	4	75	0.0533333
NODE_73_length_7036_cov_65.961943	5690	5746	111	1	56	0.0178571
NODE_73_length_7036_cov_65.961943	5690	5746	113	1	56	0.0178571
NODE_73_length_7036_cov_65.961943	5690	5746	116	1	56	0.0178571
NODE_73_length_7036_cov_65.961943	5690	5746	120	2	56	0.0357143
NODE_73_length_7036_cov_65.961943	5690	5746	121	4	56	0.0714286
NODE_73_length_7036_cov_65.961943	5690	5746	122	2	56	0.0357143
NODE_73_length_7036_cov_65.961943	5690	5746	123	1	56	0.0178571
NODE_73_length_7036_cov_65.961943	5690	5746	124	1	56	0.0178571
NODE_73_length_7036_cov_65.961943	5690	5746	125	1	56	0.0178571
NODE_73_length_7036_cov_65.961943	5690	5746	127	4	56	0.0714286
NODE_73_length_7036_cov_65.961943	5690	5746	130	1	56	0.0178571
NODE_73_length_7036_cov_65.961943	5690	5746	131	1	56	0.0178571
NODE_73_length_7036_cov_65.961943	5690	5746	132	4	56	0.0714286
NODE_73_length_7036_cov_65.961943	5690	5746	134	2	56	0.0357143
NODE_73_length_7036_cov_65.961943	5690	5746	135	1	56	0.0178571
NODE_73_length_7036_cov_65.961943	5690	5746	136	4	56	0.0714286
NODE_73_length_7036_cov_65.961943	5690	5746	137	3	56	0.0535714
NODE_73_length_7036_cov_65.961943	5690	5746	138	3	56	0.0535714
NODE_73_length_7036_cov_65.961943	5690	5746	139	4	56	0.0714286
NODE_73_length_7036_cov_65.961943	5690	5746	140	7	56	0.1250000
NODE_73_length_7036_cov_65.961943	5690	5746	141	3	56	0.0535714
NODE_73_length_7036_cov_65.961943	5690	5746	142	5	56	0.0892857
NODE_73_length_7036_cov_65.961943	6373	6453	6	18	80	0.2250000
NODE_73_length_7036_cov_65.961943	6373	6453	7	6	80	0.0750000
NODE_73_length_7036_cov_65.961943	6373	6453	8	5	80	0.0625000
NODE_73_length_7036_cov_65.961943	6373	6453	9	27	80	0.3375000
NODE_73_length_7036_cov_65.961943	6373	6453	10	24	80	0.3000000
NODE_73_length_7036_cov_65.961943	6426	6506	5	5	80	0.0625000
NODE_73_length_7036_cov_65.961943	6426	6506	7	4	80	0.0500000
NODE_73_length_7036_cov_65.961943	6426	6506	8	4	80	0.0500000
NODE_73_length_7036_cov_65.961943	6426	6506	9	49	80	0.6125000
NODE_73_length_7036_cov_65.961943	6426	6506	10	18	80	0.2250000
NODE_74_length_6974_cov_16.058327	976	1056	13	8	80	0.1000000
NODE_74_length_6974_cov_16.058327	976	1056	14	5	80	0.0625000
NODE_74_length_6974_cov_16.058327	976	1056	15	1	80	0.0125000
NODE_74_length_6974_cov_16.058327	976	1056	16	5	80	0.0625000
NODE_74_length_6974_cov_16.058327	976	1056	17	2	80	0.0250000
NODE_74_length_6974_cov_16.058327	976	1056	19	9	80	0.1125000
NODE_74_length_6974_cov_16.058327	976	1056	20	10	80	0.1250000
NODE_74_length_6974_cov_16.058327	976	1056	21	28	80	0.3500000
NODE_74_length_6974_cov_16.058327	976	1056	22	4	80	0.0500000
NODE_74_length_6974_cov_16.058327	976	1056	23	8	80	0.1000000
NODE_74_length_6974_cov_16.058327	1029	1109	20	8	80	0.1000000
NODE_74_length_6974_cov_16.058327	1029	1109	21	7	80	0.0875000
NODE_74_length_6974_cov_16.058327	1029	1109	22	4	80	0.0500000
NODE_74_length_6974_cov_16.058327	1029	1109	23	10	80	0.1250000
NODE_74_length_6974_cov_16.058327	1029	1109	24	29	80	0.3625000
NODE_74_length_6974_cov_16.058327	1029	1109	25	13	80	0.1625000
NODE_74_length_6974_cov_16.058327	1029	1109	26	6	80	0.0750000
NODE_74_length_6974_cov_16.058327	1029	1109	27	3	80	0.0375000
NODE_80_length_6826_cov_10.483574	4462	4542	0	14	80	0.1750000
NODE_80_length_6826_cov_10.483574	4462	4542	2	8	80	0.1000000
NODE_80_length_6826_cov_10.483574	4462	4542	3	22	80	0.2750000
NODE_80_length_6826_cov_10.483574	4462	4542	5	36	80	0.4500000
NODE_80_length_6826_cov_10.483574	4515	4595	5	27	80	0.3375000
NODE_80_length_6826_cov_10.483574	4515	4595	6	35	80	0.4375000
NODE_80_length_6826_cov_10.483574	4515	4595	7	13	80	0.1625000
NODE_80_length_6826_cov_10.483574	4515	4595	9	5	80	0.0625000
NODE_81_length_6816_cov_2.820753	6726	6801	0	75	75	1.0000000
NODE_81_length_6816_cov_2.820753	6774	6816	0	42	42	1.0000000
NODE_84_length_6744_cov_6.222272	5	85	1	32	80	0.4000000
NODE_84_length_6744_cov_6.222272	5	85	3	14	80	0.1750000
NODE_84_length_6744_cov_6.222272	5	85	4	34	80	0.4250000
NODE_84_length_6744_cov_6.222272	58	138	4	33	80	0.4125000
NODE_84_length_6744_cov_6.222272	58	138	6	38	80	0.4750000
NODE_84_length_6744_cov_6.222272	58	138	7	9	80	0.1125000
NODE_84_length_6744_cov_6.222272	6650	6730	0	9	80	0.1125000
NODE_84_length_6744_cov_6.222272	6650	6730	1	23	80	0.2875000
NODE_84_length_6744_cov_6.222272	6650	6730	2	48	80	0.6000000
NODE_84_length_6744_cov_6.222272	6703	6744	0	23	41	0.5609756
NODE_84_length_6744_cov_6.222272	6703	6744	1	18	41	0.4390244
NODE_86_length_6733_cov_88.965029	3141	3221	0	6	80	0.0750000
NODE_86_length_6733_cov_88.965029	3141	3221	1	74	80	0.9250000
NODE_86_length_6733_cov_88.965029	3194	3274	1	80	80	1.0000000
NODE_86_length_6733_cov_88.965029	3270	3350	1	5	80	0.0625000
NODE_86_length_6733_cov_88.965029	3270	3350	2	10	80	0.1250000
NODE_86_length_6733_cov_88.965029	3270	3350	3	34	80	0.4250000
NODE_86_length_6733_cov_88.965029	3270	3350	4	31	80	0.3875000
NODE_86_length_6733_cov_88.965029	3323	3403	2	63	80	0.7875000
NODE_86_length_6733_cov_88.965029	3323	3403	3	12	80	0.1500000
NODE_86_length_6733_cov_88.965029	3323	3403	4	5	80	0.0625000
NODE_90_length_6627_cov_9.440564	350	430	6	68	80	0.8500000
NODE_90_length_6627_cov_9.440564	350	430	9	12	80	0.1500000
NODE_90_length_6627_cov_9.440564	403	483	4	13	80	0.1625000
NODE_90_length_6627_cov_9.440564	403	483	5	7	80	0.0875000
NODE_90_length_6627_cov_9.440564	403	483	6	41	80	0.5125000
NODE_90_length_6627_cov_9.440564	403	483	9	19	80	0.2375000
NODE_95_length_6507_cov_95.786049	171	247	0	4	76	0.0526316
NODE_95_length_6507_cov_95.786049	171	247	3	72	76	0.9473684
NODE_96_length_6497_cov_2.677399	366	436	2	67	70	0.9571428
NODE_96_length_6497_cov_2.677399	366	436	3	3	70	0.0428571
NODE_96_length_6497_cov_2.677399	409	444	2	35	35	1.0000000
NODE_97_length_6450_cov_26.108172	5024	5104	1	7	80	0.0875000
NODE_97_length_6450_cov_26.108172	5024	5104	2	36	80	0.4500000
NODE_97_length_6450_cov_26.108172	5024	5104	3	12	80	0.1500000
NODE_97_length_6450_cov_26.108172	5024	5104	4	16	80	0.2000000
NODE_97_length_6450_cov_26.108172	5024	5104	5	9	80	0.1125000
NODE_109_length_6171_cov_36.061100	3743	3813	0	5	70	0.0714286
NODE_109_length_6171_cov_36.061100	3743	3813	1	15	70	0.2142857
NODE_109_length_6171_cov_36.061100	3743	3813	3	20	70	0.2857143
NODE_109_length_6171_cov_36.061100	3743	3813	4	30	70	0.4285714
NODE_109_length_6171_cov_36.061100	3798	3851	2	1	53	0.0188679
NODE_109_length_6171_cov_36.061100	3798	3851	3	1	53	0.0188679
NODE_109_length_6171_cov_36.061100	3798	3851	4	43	53	0.8113208
NODE_109_length_6171_cov_36.061100	3798	3851	5	1	53	0.0188679
NODE_109_length_6171_cov_36.061100	3798	3851	8	5	53	0.0943396
NODE_109_length_6171_cov_36.061100	3798	3851	10	2	53	0.0377358
NODE_109_length_6171_cov_36.061100	4552	4596	75	2	44	0.0454545
NODE_109_length_6171_cov_36.061100	4552	4596	76	2	44	0.0454545
NODE_109_length_6171_cov_36.061100	4552	4596	77	4	44	0.0909091
NODE_109_length_6171_cov_36.061100	4552	4596	78	2	44	0.0454545
NODE_109_length_6171_cov_36.061100	4552	4596	82	3	44	0.0681818
NODE_109_length_6171_cov_36.061100	4552	4596	84	3	44	0.0681818
NODE_109_length_6171_cov_36.061100	4552	4596	85	2	44	0.0454545
NODE_109_length_6171_cov_36.061100	4552	4596	88	3	44	0.0681818
NODE_109_length_6171_cov_36.061100	4552	4596	90	4	44	0.0909091
NODE_109_length_6171_cov_36.061100	4552	4596	91	2	44	0.0454545
NODE_109_length_6171_cov_36.061100	4552	4596	93	6	44	0.1363636
NODE_109_length_6171_cov_36.061100	4552	4596	94	3	44	0.0681818
NODE_109_length_6171_cov_36.061100	4552	4596	95	8	44	0.1818182
NODE_109_length_6171_cov_36.061100	4569	4649	67	4	80	0.0500000
NODE_109_length_6171_cov_36.061100	4569	4649	68	2	80	0.0250000
NODE_109_length_6171_cov_36.061100	4569	4649	69	6	80	0.0750000
NODE_109_length_6171_cov_36.061100	4569	4649	70	6	80	0.0750000
NODE_109_length_6171_cov_36.061100	4569	4649	71	1	80	0.0125000
NODE_109_length_6171_cov_36.061100	4569	4649	72	4	80	0.0500000
NODE_109_length_6171_cov_36.061100	4569	4649	73	2	80	0.0250000
NODE_109_length_6171_cov_36.061100	4569	4649	74	9	80	0.1125000
NODE_109_length_6171_cov_36.061100	4569	4649	75	6	80	0.0750000
NODE_109_length_6171_cov_36.061100	4569	4649	77	1	80	0.0125000
NODE_109_length_6171_cov_36.061100	4569	4649	78	7	80	0.0875000
NODE_109_length_6171_cov_36.061100	4569	4649	84	3	80	0.0375000
NODE_109_length_6171_cov_36.061100	4569	4649	85	1	80	0.0125000
NODE_109_length_6171_cov_36.061100	4569	4649	86	1	80	0.0125000
NODE_109_length_6171_cov_36.061100	4569	4649	88	4	80	0.0500000
NODE_109_length_6171_cov_36.061100	4569	4649	90	4	80	0.0500000
NODE_109_length_6171_cov_36.061100	4569	4649	91	2	80	0.0250000
NODE_109_length_6171_cov_36.061100	4569	4649	93	6	80	0.0750000
NODE_109_length_6171_cov_36.061100	4569	4649	94	3	80	0.0375000
NODE_109_length_6171_cov_36.061100	4569	4649	95	8	80	0.1000000
NODE_109_length_6171_cov_36.061100	5742	5788	5	44	46	0.9565217
NODE_109_length_6171_cov_36.061100	5742	5788	7	1	46	0.0217391
NODE_109_length_6171_cov_36.061100	5742	5788	8	1	46	0.0217391
NODE_109_length_6171_cov_36.061100	5761	5841	5	25	80	0.3125000
NODE_109_length_6171_cov_36.061100	5761	5841	6	4	80	0.0500000
NODE_109_length_6171_cov_36.061100	5761	5841	7	1	80	0.0125000
NODE_109_length_6171_cov_36.061100	5761	5841	8	50	80	0.6250000
NODE_110_length_6148_cov_58.915358	5602	5682	16	4	80	0.0500000
NODE_110_length_6148_cov_58.915358	5602	5682	17	6	80	0.0750000
NODE_110_length_6148_cov_58.915358	5602	5682	21	4	80	0.0500000
NODE_110_length_6148_cov_58.915358	5602	5682	22	1	80	0.0125000
NODE_110_length_6148_cov_58.915358	5602	5682	23	7	80	0.0875000
NODE_110_length_6148_cov_58.915358	5602	5682	24	6	80	0.0750000
NODE_110_length_6148_cov_58.915358	5602	5682	25	11	80	0.1375000
NODE_110_length_6148_cov_58.915358	5602	5682	26	10	80	0.1250000
NODE_110_length_6148_cov_58.915358	5602	5682	27	21	80	0.2625000
NODE_110_length_6148_cov_58.915358	5602	5682	28	8	80	0.1000000
NODE_110_length_6148_cov_58.915358	5602	5682	29	2	80	0.0250000
NODE_110_length_6148_cov_58.915358	5655	5735	12	13	80	0.1625000
NODE_110_length_6148_cov_58.915358	5655	5735	14	18	80	0.2250000
NODE_110_length_6148_cov_58.915358	5655	5735	15	4	80	0.0500000
NODE_110_length_6148_cov_58.915358	5655	5735	16	22	80	0.2750000
NODE_110_length_6148_cov_58.915358	5655	5735	17	6	80	0.0750000
NODE_110_length_6148_cov_58.915358	5655	5735	21	4	80	0.0500000
NODE_110_length_6148_cov_58.915358	5655	5735	22	1	80	0.0125000
NODE_110_length_6148_cov_58.915358	5655	5735	25	11	80	0.1375000
NODE_110_length_6148_cov_58.915358	5655	5735	26	1	80	0.0125000
NODE_112_length_6026_cov_17.775772	4124	4204	26	7	80	0.0875000
NODE_112_length_6026_cov_17.775772	4124	4204	28	2	80	0.0250000
NODE_112_length_6026_cov_17.775772	4124	4204	29	1	80	0.0125000
NODE_112_length_6026_cov_17.775772	4124	4204	30	13	80	0.1625000
NODE_112_length_6026_cov_17.775772	4124	4204	31	1	80	0.0125000
NODE_112_length_6026_cov_17.775772	4124	4204	32	15	80	0.1875000
NODE_112_length_6026_cov_17.775772	4124	4204	35	4	80	0.0500000
NODE_112_length_6026_cov_17.775772	4124	4204	36	7	80	0.0875000
NODE_112_length_6026_cov_17.775772	4124	4204	37	11	80	0.1375000
NODE_112_length_6026_cov_17.775772	4124	4204	38	3	80	0.0375000
NODE_112_length_6026_cov_17.775772	4124	4204	39	14	80	0.1750000
NODE_112_length_6026_cov_17.775772	4124	4204	41	2	80	0.0250000
NODE_112_length_6026_cov_17.775772	4177	4257	32	3	80	0.0375000
NODE_112_length_6026_cov_17.775772	4177	4257	33	1	80	0.0125000
NODE_112_length_6026_cov_17.775772	4177	4257	34	10	80	0.1250000
NODE_112_length_6026_cov_17.775772	4177	4257	35	3	80	0.0375000
NODE_112_length_6026_cov_17.775772	4177	4257	36	4	80	0.0500000
NODE_112_length_6026_cov_17.775772	4177	4257	37	12	80	0.1500000
NODE_112_length_6026_cov_17.775772	4177	4257	38	7	80	0.0875000
NODE_112_length_6026_cov_17.775772	4177	4257	39	30	80	0.3750000
NODE_112_length_6026_cov_17.775772	4177	4257	41	8	80	0.1000000
NODE_112_length_6026_cov_17.775772	4177	4257	42	2	80	0.0250000
NODE_112_length_6026_cov_17.775772	4253	4333	41	9	80	0.1125000
NODE_112_length_6026_cov_17.775772	4253	4333	42	4	80	0.0500000
NODE_112_length_6026_cov_17.775772	4253	4333	43	2	80	0.0250000
NODE_112_length_6026_cov_17.775772	4253	4333	44	4	80	0.0500000
NODE_112_length_6026_cov_17.775772	4253	4333	45	7	80	0.0875000
NODE_112_length_6026_cov_17.775772	4253	4333	46	9	80	0.1125000
NODE_112_length_6026_cov_17.775772	4253	4333	47	3	80	0.0375000
NODE_112_length_6026_cov_17.775772	4253	4333	48	8	80	0.1000000
NODE_112_length_6026_cov_17.775772	4253	4333	49	13	80	0.1625000
NODE_112_length_6026_cov_17.775772	4253	4333	50	7	80	0.0875000
NODE_112_length_6026_cov_17.775772	4253	4333	51	6	80	0.0750000
NODE_112_length_6026_cov_17.775772	4253	4333	52	8	80	0.1000000
NODE_112_length_6026_cov_17.775772	4306	4386	45	4	80	0.0500000
NODE_112_length_6026_cov_17.775772	4306	4386	46	1	80	0.0125000
NODE_112_length_6026_cov_17.775772	4306	4386	47	4	80	0.0500000
NODE_112_length_6026_cov_17.775772	4306	4386	48	3	80	0.0375000
NODE_112_length_6026_cov_17.775772	4306	4386	49	10	80	0.1250000
NODE_112_length_6026_cov_17.775772	4306	4386	50	12	80	0.1500000
NODE_112_length_6026_cov_17.775772	4306	4386	51	26	80	0.3250000
NODE_112_length_6026_cov_17.775772	4306	4386	52	4	80	0.0500000
NODE_112_length_6026_cov_17.775772	4306	4386	53	5	80	0.0625000
NODE_112_length_6026_cov_17.775772	4306	4386	54	10	80	0.1250000
NODE_112_length_6026_cov_17.775772	4306	4386	55	1	80	0.0125000
NODE_124_length_5810_cov_24.750657	2064	2144	3	11	80	0.1375000
NODE_124_length_5810_cov_24.750657	2064	2144	5	3	80	0.0375000
NODE_124_length_5810_cov_24.750657	2064	2144	6	4	80	0.0500000
NODE_124_length_5810_cov_24.750657	2064	2144	7	3	80	0.0375000
NODE_124_length_5810_cov_24.750657	2064	2144	8	2	80	0.0250000
NODE_124_length_5810_cov_24.750657	2064	2144	9	3	80	0.0375000
NODE_124_length_5810_cov_24.750657	2064	2144	11	9	80	0.1125000
NODE_124_length_5810_cov_24.750657	2064	2144	12	3	80	0.0375000
NODE_124_length_5810_cov_24.750657	2064	2144	13	10	80	0.1250000
NODE_124_length_5810_cov_24.750657	2064	2144	15	2	80	0.0250000
NODE_124_length_5810_cov_24.750657	2064	2144	16	15	80	0.1875000
NODE_124_length_5810_cov_24.750657	2064	2144	18	15	80	0.1875000
NODE_124_length_5810_cov_24.750657	2117	2194	0	30	77	0.3896104
NODE_124_length_5810_cov_24.750657	2117	2194	2	18	77	0.2337662
NODE_124_length_5810_cov_24.750657	2117	2194	3	13	77	0.1688312
NODE_124_length_5810_cov_24.750657	2117	2194	5	3	77	0.0389610
NODE_124_length_5810_cov_24.750657	2117	2194	6	4	77	0.0519481
NODE_124_length_5810_cov_24.750657	2117	2194	7	3	77	0.0389610
NODE_124_length_5810_cov_24.750657	2117	2194	8	2	77	0.0259740
NODE_124_length_5810_cov_24.750657	2117	2194	9	3	77	0.0389610
NODE_124_length_5810_cov_24.750657	2117	2194	11	1	77	0.0129870
NODE_127_length_5771_cov_10.854549	2814	2883	0	38	69	0.5507246
NODE_127_length_5771_cov_10.854549	2814	2883	1	17	69	0.2463768
NODE_127_length_5771_cov_10.854549	2814	2883	2	14	69	0.2028985
NODE_128_length_5769_cov_6.878483	5701	5731	0	29	30	0.9666666
NODE_128_length_5769_cov_6.878483	5701	5731	1	1	30	0.0333333
NODE_133_length_5728_cov_16.351039	63	134	0	71	71	1.0000000
NODE_133_length_5728_cov_16.351039	2960	3040	2	79	80	0.9875000
NODE_133_length_5728_cov_16.351039	2960	3040	4	1	80	0.0125000
NODE_133_length_5728_cov_16.351039	5106	5172	11	6	66	0.0909091
NODE_133_length_5728_cov_16.351039	5106	5172	13	9	66	0.1363636
NODE_133_length_5728_cov_16.351039	5106	5172	15	12	66	0.1818182
NODE_133_length_5728_cov_16.351039	5106	5172	16	5	66	0.0757576
NODE_133_length_5728_cov_16.351039	5106	5172	18	7	66	0.1060606
NODE_133_length_5728_cov_16.351039	5106	5172	19	5	66	0.0757576
NODE_133_length_5728_cov_16.351039	5106	5172	20	14	66	0.2121212
NODE_133_length_5728_cov_16.351039	5106	5172	21	8	66	0.1212121
NODE_133_length_5728_cov_16.351039	5145	5225	14	6	80	0.0750000
NODE_133_length_5728_cov_16.351039	5145	5225	16	10	80	0.1250000
NODE_133_length_5728_cov_16.351039	5145	5225	17	12	80	0.1500000
NODE_133_length_5728_cov_16.351039	5145	5225	18	12	80	0.1500000
NODE_133_length_5728_cov_16.351039	5145	5225	19	18	80	0.2250000
NODE_133_length_5728_cov_16.351039	5145	5225	20	14	80	0.1750000
NODE_133_length_5728_cov_16.351039	5145	5225	21	8	80	0.1000000
NODE_137_length_5696_cov_20.656244	179	258	2	29	79	0.3670886
NODE_137_length_5696_cov_20.656244	179	258	3	27	79	0.3417721
NODE_137_length_5696_cov_20.656244	179	258	6	7	79	0.0886076
NODE_137_length_5696_cov_20.656244	179	258	7	16	79	0.2025317
NODE_137_length_5696_cov_20.656244	231	311	3	4	80	0.0500000
NODE_137_length_5696_cov_20.656244	231	311	5	11	80	0.1375000
NODE_137_length_5696_cov_20.656244	231	311	6	7	80	0.0875000
NODE_137_length_5696_cov_20.656244	231	311	7	43	80	0.5375000
NODE_137_length_5696_cov_20.656244	231	311	10	15	80	0.1875000
NODE_137_length_5696_cov_20.656244	307	387	10	4	80	0.0500000
NODE_137_length_5696_cov_20.656244	307	387	11	25	80	0.3125000
NODE_137_length_5696_cov_20.656244	307	387	12	47	80	0.5875000
NODE_137_length_5696_cov_20.656244	307	387	14	4	80	0.0500000
NODE_137_length_5696_cov_20.656244	360	440	8	9	80	0.1125000
NODE_137_length_5696_cov_20.656244	360	440	10	39	80	0.4875000
NODE_137_length_5696_cov_20.656244	360	440	11	28	80	0.3500000
NODE_137_length_5696_cov_20.656244	360	440	14	4	80	0.0500000
NODE_137_length_5696_cov_20.656244	5100	5180	7	10	80	0.1250000
NODE_137_length_5696_cov_20.656244	5100	5180	8	6	80	0.0750000
NODE_137_length_5696_cov_20.656244	5100	5180	9	9	80	0.1125000
NODE_137_length_5696_cov_20.656244	5100	5180	10	16	80	0.2000000
NODE_137_length_5696_cov_20.656244	5100	5180	11	34	80	0.4250000
NODE_137_length_5696_cov_20.656244	5100	5180	12	5	80	0.0625000
NODE_137_length_5696_cov_20.656244	5153	5233	9	25	80	0.3125000
NODE_137_length_5696_cov_20.656244	5153	5233	10	22	80	0.2750000
NODE_137_length_5696_cov_20.656244	5153	5233	11	12	80	0.1500000
NODE_137_length_5696_cov_20.656244	5153	5233	12	1	80	0.0125000
NODE_137_length_5696_cov_20.656244	5153	5233	14	18	80	0.2250000
NODE_137_length_5696_cov_20.656244	5153	5233	16	1	80	0.0125000
NODE_137_length_5696_cov_20.656244	5153	5233	17	1	80	0.0125000
NODE_137_length_5696_cov_20.656244	5280	5360	11	18	80	0.2250000
NODE_137_length_5696_cov_20.656244	5280	5360	12	35	80	0.4375000
NODE_137_length_5696_cov_20.656244	5280	5360	13	27	80	0.3375000
NODE_137_length_5696_cov_20.656244	5333	5413	4	27	80	0.3375000
NODE_137_length_5696_cov_20.656244	5333	5413	5	4	80	0.0500000
NODE_137_length_5696_cov_20.656244	5333	5413	6	9	80	0.1125000
NODE_137_length_5696_cov_20.656244	5333	5413	8	10	80	0.1250000
NODE_137_length_5696_cov_20.656244	5333	5413	10	1	80	0.0125000
NODE_137_length_5696_cov_20.656244	5333	5413	12	1	80	0.0125000
NODE_137_length_5696_cov_20.656244	5333	5413	13	28	80	0.3500000
NODE_139_length_5681_cov_68.065030	253	333	0	80	80	1.0000000
NODE_139_length_5681_cov_68.065030	306	386	0	80	80	1.0000000
NODE_139_length_5681_cov_68.065030	4762	4842	36	4	80	0.0500000
NODE_139_length_5681_cov_68.065030	4762	4842	37	1	80	0.0125000
NODE_139_length_5681_cov_68.065030	4762	4842	38	16	80	0.2000000
NODE_139_length_5681_cov_68.065030	4762	4842	39	5	80	0.0625000
NODE_139_length_5681_cov_68.065030	4762	4842	41	14	80	0.1750000
NODE_139_length_5681_cov_68.065030	4762	4842	42	5	80	0.0625000
NODE_139_length_5681_cov_68.065030	4762	4842	43	14	80	0.1750000
NODE_139_length_5681_cov_68.065030	4762	4842	44	2	80	0.0250000
NODE_139_length_5681_cov_68.065030	4762	4842	45	18	80	0.2250000
NODE_139_length_5681_cov_68.065030	4762	4842	46	1	80	0.0125000
NODE_139_length_5681_cov_68.065030	4762	4842	36	4	80	0.0500000
NODE_139_length_5681_cov_68.065030	4762	4842	37	1	80	0.0125000
NODE_139_length_5681_cov_68.065030	4762	4842	38	16	80	0.2000000
NODE_139_length_5681_cov_68.065030	4762	4842	39	5	80	0.0625000
NODE_139_length_5681_cov_68.065030	4762	4842	41	14	80	0.1750000
NODE_139_length_5681_cov_68.065030	4762	4842	42	5	80	0.0625000
NODE_139_length_5681_cov_68.065030	4762	4842	43	14	80	0.1750000
NODE_139_length_5681_cov_68.065030	4762	4842	44	2	80	0.0250000
NODE_139_length_5681_cov_68.065030	4762	4842	45	18	80	0.2250000
NODE_139_length_5681_cov_68.065030	4762	4842	46	1	80	0.0125000
NODE_139_length_5681_cov_68.065030	4762	4842	36	4	80	0.0500000
NODE_139_length_5681_cov_68.065030	4762	4842	37	1	80	0.0125000
NODE_139_length_5681_cov_68.065030	4762	4842	38	16	80	0.2000000
NODE_139_length_5681_cov_68.065030	4762	4842	39	5	80	0.0625000
NODE_139_length_5681_cov_68.065030	4762	4842	41	14	80	0.1750000
NODE_139_length_5681_cov_68.065030	4762	4842	42	5	80	0.0625000
NODE_139_length_5681_cov_68.065030	4762	4842	43	14	80	0.1750000
NODE_139_length_5681_cov_68.065030	4762	4842	44	2	80	0.0250000
NODE_139_length_5681_cov_68.065030	4762	4842	45	18	80	0.2250000
NODE_139_length_5681_cov_68.065030	4762	4842	46	1	80	0.0125000
NODE_139_length_5681_cov_68.065030	4762	4842	36	4	80	0.0500000
NODE_139_length_5681_cov_68.065030	4762	4842	37	1	80	0.0125000
NODE_139_length_5681_cov_68.065030	4762	4842	38	16	80	0.2000000
NODE_139_length_5681_cov_68.065030	4762	4842	39	5	80	0.0625000
NODE_139_length_5681_cov_68.065030	4762	4842	41	14	80	0.1750000
NODE_139_length_5681_cov_68.065030	4762	4842	42	5	80	0.0625000
NODE_139_length_5681_cov_68.065030	4762	4842	43	14	80	0.1750000
NODE_139_length_5681_cov_68.065030	4762	4842	44	2	80	0.0250000
NODE_139_length_5681_cov_68.065030	4762	4842	45	18	80	0.2250000
NODE_139_length_5681_cov_68.065030	4762	4842	46	1	80	0.0125000
NODE_139_length_5681_cov_68.065030	4762	4842	36	4	80	0.0500000
NODE_139_length_5681_cov_68.065030	4762	4842	37	1	80	0.0125000
NODE_139_length_5681_cov_68.065030	4762	4842	38	16	80	0.2000000
NODE_139_length_5681_cov_68.065030	4762	4842	39	5	80	0.0625000
NODE_139_length_5681_cov_68.065030	4762	4842	41	14	80	0.1750000
NODE_139_length_5681_cov_68.065030	4762	4842	42	5	80	0.0625000
NODE_139_length_5681_cov_68.065030	4762	4842	43	14	80	0.1750000
NODE_139_length_5681_cov_68.065030	4762	4842	44	2	80	0.0250000
NODE_139_length_5681_cov_68.065030	4762	4842	45	18	80	0.2250000
NODE_139_length_5681_cov_68.065030	4762	4842	46	1	80	0.0125000
NODE_139_length_5681_cov_68.065030	4762	4842	36	4	80	0.0500000
NODE_139_length_5681_cov_68.065030	4762	4842	37	1	80	0.0125000
NODE_139_length_5681_cov_68.065030	4762	4842	38	16	80	0.2000000
NODE_139_length_5681_cov_68.065030	4762	4842	39	5	80	0.0625000
NODE_139_length_5681_cov_68.065030	4762	4842	41	14	80	0.1750000
NODE_139_length_5681_cov_68.065030	4762	4842	42	5	80	0.0625000
NODE_139_length_5681_cov_68.065030	4762	4842	43	14	80	0.1750000
NODE_139_length_5681_cov_68.065030	4762	4842	44	2	80	0.0250000
NODE_139_length_5681_cov_68.065030	4762	4842	45	18	80	0.2250000
NODE_139_length_5681_cov_68.065030	4762	4842	46	1	80	0.0125000
NODE_139_length_5681_cov_68.065030	4769	4839	38	16	70	0.2285714
NODE_139_length_5681_cov_68.065030	4769	4839	39	3	70	0.0428571
NODE_139_length_5681_cov_68.065030	4769	4839	41	14	70	0.2000000
NODE_139_length_5681_cov_68.065030	4769	4839	42	5	70	0.0714286
NODE_139_length_5681_cov_68.065030	4769	4839	43	11	70	0.1571429
NODE_139_length_5681_cov_68.065030	4769	4839	44	2	70	0.0285714
NODE_139_length_5681_cov_68.065030	4769	4839	45	18	70	0.2571429
NODE_139_length_5681_cov_68.065030	4769	4839	46	1	70	0.0142857
NODE_139_length_5681_cov_68.065030	4771	4842	38	16	71	0.2253521
NODE_139_length_5681_cov_68.065030	4771	4842	39	1	71	0.0140845
NODE_139_length_5681_cov_68.065030	4771	4842	41	14	71	0.1971831
NODE_139_length_5681_cov_68.065030	4771	4842	42	5	71	0.0704225
NODE_139_length_5681_cov_68.065030	4771	4842	43	14	71	0.1971831
NODE_139_length_5681_cov_68.065030	4771	4842	44	2	71	0.0281690
NODE_139_length_5681_cov_68.065030	4771	4842	45	18	71	0.2535211
NODE_139_length_5681_cov_68.065030	4771	4842	46	1	71	0.0140845
NODE_139_length_5681_cov_68.065030	4815	4895	34	3	80	0.0375000
NODE_139_length_5681_cov_68.065030	4815	4895	35	5	80	0.0625000
NODE_139_length_5681_cov_68.065030	4815	4895	36	4	80	0.0500000
NODE_139_length_5681_cov_68.065030	4815	4895	37	5	80	0.0625000
NODE_139_length_5681_cov_68.065030	4815	4895	38	2	80	0.0250000
NODE_139_length_5681_cov_68.065030	4815	4895	39	13	80	0.1625000
NODE_139_length_5681_cov_68.065030	4815	4895	40	6	80	0.0750000
NODE_139_length_5681_cov_68.065030	4815	4895	41	1	80	0.0125000
NODE_139_length_5681_cov_68.065030	4815	4895	42	5	80	0.0625000
NODE_139_length_5681_cov_68.065030	4815	4895	43	19	80	0.2375000
NODE_139_length_5681_cov_68.065030	4815	4895	44	4	80	0.0500000
NODE_139_length_5681_cov_68.065030	4815	4895	45	12	80	0.1500000
NODE_139_length_5681_cov_68.065030	4815	4895	46	1	80	0.0125000
NODE_139_length_5681_cov_68.065030	4815	4895	34	3	80	0.0375000
NODE_139_length_5681_cov_68.065030	4815	4895	35	5	80	0.0625000
NODE_139_length_5681_cov_68.065030	4815	4895	36	4	80	0.0500000
NODE_139_length_5681_cov_68.065030	4815	4895	37	5	80	0.0625000
NODE_139_length_5681_cov_68.065030	4815	4895	38	2	80	0.0250000
NODE_139_length_5681_cov_68.065030	4815	4895	39	13	80	0.1625000
NODE_139_length_5681_cov_68.065030	4815	4895	40	6	80	0.0750000
NODE_139_length_5681_cov_68.065030	4815	4895	41	1	80	0.0125000
NODE_139_length_5681_cov_68.065030	4815	4895	42	5	80	0.0625000
NODE_139_length_5681_cov_68.065030	4815	4895	43	19	80	0.2375000
NODE_139_length_5681_cov_68.065030	4815	4895	44	4	80	0.0500000
NODE_139_length_5681_cov_68.065030	4815	4895	45	12	80	0.1500000
NODE_139_length_5681_cov_68.065030	4815	4895	46	1	80	0.0125000
NODE_139_length_5681_cov_68.065030	4815	4895	34	3	80	0.0375000
NODE_139_length_5681_cov_68.065030	4815	4895	35	5	80	0.0625000
NODE_139_length_5681_cov_68.065030	4815	4895	36	4	80	0.0500000
NODE_139_length_5681_cov_68.065030	4815	4895	37	5	80	0.0625000
NODE_139_length_5681_cov_68.065030	4815	4895	38	2	80	0.0250000
NODE_139_length_5681_cov_68.065030	4815	4895	39	13	80	0.1625000
NODE_139_length_5681_cov_68.065030	4815	4895	40	6	80	0.0750000
NODE_139_length_5681_cov_68.065030	4815	4895	41	1	80	0.0125000
NODE_139_length_5681_cov_68.065030	4815	4895	42	5	80	0.0625000
NODE_139_length_5681_cov_68.065030	4815	4895	43	19	80	0.2375000
NODE_139_length_5681_cov_68.065030	4815	4895	44	4	80	0.0500000
NODE_139_length_5681_cov_68.065030	4815	4895	45	12	80	0.1500000
NODE_139_length_5681_cov_68.065030	4815	4895	46	1	80	0.0125000
NODE_139_length_5681_cov_68.065030	4815	4895	34	3	80	0.0375000
NODE_139_length_5681_cov_68.065030	4815	4895	35	5	80	0.0625000
NODE_139_length_5681_cov_68.065030	4815	4895	36	4	80	0.0500000
NODE_139_length_5681_cov_68.065030	4815	4895	37	5	80	0.0625000
NODE_139_length_5681_cov_68.065030	4815	4895	38	2	80	0.0250000
NODE_139_length_5681_cov_68.065030	4815	4895	39	13	80	0.1625000
NODE_139_length_5681_cov_68.065030	4815	4895	40	6	80	0.0750000
NODE_139_length_5681_cov_68.065030	4815	4895	41	1	80	0.0125000
NODE_139_length_5681_cov_68.065030	4815	4895	42	5	80	0.0625000
NODE_139_length_5681_cov_68.065030	4815	4895	43	19	80	0.2375000
NODE_139_length_5681_cov_68.065030	4815	4895	44	4	80	0.0500000
NODE_139_length_5681_cov_68.065030	4815	4895	45	12	80	0.1500000
NODE_139_length_5681_cov_68.065030	4815	4895	46	1	80	0.0125000
NODE_139_length_5681_cov_68.065030	4815	4895	34	3	80	0.0375000
NODE_139_length_5681_cov_68.065030	4815	4895	35	5	80	0.0625000
NODE_139_length_5681_cov_68.065030	4815	4895	36	4	80	0.0500000
NODE_139_length_5681_cov_68.065030	4815	4895	37	5	80	0.0625000
NODE_139_length_5681_cov_68.065030	4815	4895	38	2	80	0.0250000
NODE_139_length_5681_cov_68.065030	4815	4895	39	13	80	0.1625000
NODE_139_length_5681_cov_68.065030	4815	4895	40	6	80	0.0750000
NODE_139_length_5681_cov_68.065030	4815	4895	41	1	80	0.0125000
NODE_139_length_5681_cov_68.065030	4815	4895	42	5	80	0.0625000
NODE_139_length_5681_cov_68.065030	4815	4895	43	19	80	0.2375000
NODE_139_length_5681_cov_68.065030	4815	4895	44	4	80	0.0500000
NODE_139_length_5681_cov_68.065030	4815	4895	45	12	80	0.1500000
NODE_139_length_5681_cov_68.065030	4815	4895	46	1	80	0.0125000
NODE_139_length_5681_cov_68.065030	4815	4895	34	3	80	0.0375000
NODE_139_length_5681_cov_68.065030	4815	4895	35	5	80	0.0625000
NODE_139_length_5681_cov_68.065030	4815	4895	36	4	80	0.0500000
NODE_139_length_5681_cov_68.065030	4815	4895	37	5	80	0.0625000
NODE_139_length_5681_cov_68.065030	4815	4895	38	2	80	0.0250000
NODE_139_length_5681_cov_68.065030	4815	4895	39	13	80	0.1625000
NODE_139_length_5681_cov_68.065030	4815	4895	40	6	80	0.0750000
NODE_139_length_5681_cov_68.065030	4815	4895	41	1	80	0.0125000
NODE_139_length_5681_cov_68.065030	4815	4895	42	5	80	0.0625000
NODE_139_length_5681_cov_68.065030	4815	4895	43	19	80	0.2375000
NODE_139_length_5681_cov_68.065030	4815	4895	44	4	80	0.0500000
NODE_139_length_5681_cov_68.065030	4815	4895	45	12	80	0.1500000
NODE_139_length_5681_cov_68.065030	4815	4895	46	1	80	0.0125000
NODE_139_length_5681_cov_68.065030	4891	4971	14	3	80	0.0375000
NODE_139_length_5681_cov_68.065030	4891	4971	17	5	80	0.0625000
NODE_139_length_5681_cov_68.065030	4891	4971	18	8	80	0.1000000
NODE_139_length_5681_cov_68.065030	4891	4971	21	2	80	0.0250000
NODE_139_length_5681_cov_68.065030	4891	4971	22	5	80	0.0625000
NODE_139_length_5681_cov_68.065030	4891	4971	23	36	80	0.4500000
NODE_139_length_5681_cov_68.065030	4891	4971	31	2	80	0.0250000
NODE_139_length_5681_cov_68.065030	4891	4971	32	4	80	0.0500000
NODE_139_length_5681_cov_68.065030	4891	4971	36	5	80	0.0625000
NODE_139_length_5681_cov_68.065030	4891	4971	37	10	80	0.1250000
NODE_139_length_5681_cov_68.065030	4944	5007	12	7	63	0.1111111
NODE_139_length_5681_cov_68.065030	4944	5007	14	29	63	0.4603175
NODE_139_length_5681_cov_68.065030	4944	5007	15	3	63	0.0476190
NODE_139_length_5681_cov_68.065030	4944	5007	17	5	63	0.0793651
NODE_139_length_5681_cov_68.065030	4944	5007	18	8	63	0.1269841
NODE_139_length_5681_cov_68.065030	4944	5007	21	2	63	0.0317460
NODE_139_length_5681_cov_68.065030	4944	5007	23	9	63	0.1428571
NODE_139_length_5681_cov_68.065030	4944	5024	6	4	80	0.0500000
NODE_139_length_5681_cov_68.065030	4944	5024	7	4	80	0.0500000
NODE_139_length_5681_cov_68.065030	4944	5024	8	4	80	0.0500000
NODE_139_length_5681_cov_68.065030	4944	5024	10	5	80	0.0625000
NODE_139_length_5681_cov_68.065030	4944	5024	12	7	80	0.0875000
NODE_139_length_5681_cov_68.065030	4944	5024	14	29	80	0.3625000
NODE_139_length_5681_cov_68.065030	4944	5024	15	3	80	0.0375000
NODE_139_length_5681_cov_68.065030	4944	5024	17	5	80	0.0625000
NODE_139_length_5681_cov_68.065030	4944	5024	18	8	80	0.1000000
NODE_139_length_5681_cov_68.065030	4944	5024	21	2	80	0.0250000
NODE_139_length_5681_cov_68.065030	4944	5024	23	9	80	0.1125000
NODE_140_length_5677_cov_21.613482	1792	1863	10	8	71	0.1126761
NODE_140_length_5677_cov_21.613482	1792	1863	11	16	71	0.2253521
NODE_140_length_5677_cov_21.613482	1792	1863	12	12	71	0.1690141
NODE_140_length_5677_cov_21.613482	1792	1863	13	3	71	0.0422535
NODE_140_length_5677_cov_21.613482	1792	1863	14	32	71	0.4507042
NODE_140_length_5677_cov_21.613482	1845	1916	13	14	71	0.1971831
NODE_140_length_5677_cov_21.613482	1845	1916	14	48	71	0.6760563
NODE_140_length_5677_cov_21.613482	1845	1916	16	2	71	0.0281690
NODE_140_length_5677_cov_21.613482	1845	1916	17	5	71	0.0704225
NODE_140_length_5677_cov_21.613482	1845	1916	19	2	71	0.0281690
NODE_142_length_5631_cov_25.927332	96	176	47	4	80	0.0500000
NODE_142_length_5631_cov_25.927332	96	176	49	5	80	0.0625000
NODE_142_length_5631_cov_25.927332	96	176	50	6	80	0.0750000
NODE_142_length_5631_cov_25.927332	96	176	51	6	80	0.0750000
NODE_142_length_5631_cov_25.927332	96	176	52	3	80	0.0375000
NODE_142_length_5631_cov_25.927332	96	176	53	2	80	0.0250000
NODE_142_length_5631_cov_25.927332	96	176	54	2	80	0.0250000
NODE_142_length_5631_cov_25.927332	96	176	55	2	80	0.0250000
NODE_142_length_5631_cov_25.927332	96	176	56	3	80	0.0375000
NODE_142_length_5631_cov_25.927332	96	176	57	19	80	0.2375000
NODE_142_length_5631_cov_25.927332	96	176	58	12	80	0.1500000
NODE_142_length_5631_cov_25.927332	96	176	59	8	80	0.1000000
NODE_142_length_5631_cov_25.927332	96	176	60	3	80	0.0375000
NODE_142_length_5631_cov_25.927332	96	176	61	3	80	0.0375000
NODE_142_length_5631_cov_25.927332	96	176	62	2	80	0.0250000
NODE_142_length_5631_cov_25.927332	149	229	31	1	80	0.0125000
NODE_142_length_5631_cov_25.927332	149	229	32	2	80	0.0250000
NODE_142_length_5631_cov_25.927332	149	229	33	2	80	0.0250000
NODE_142_length_5631_cov_25.927332	149	229	34	2	80	0.0250000
NODE_142_length_5631_cov_25.927332	149	229	35	8	80	0.1000000
NODE_142_length_5631_cov_25.927332	149	229	36	6	80	0.0750000
NODE_142_length_5631_cov_25.927332	149	229	37	4	80	0.0500000
NODE_142_length_5631_cov_25.927332	149	229	38	14	80	0.1750000
NODE_142_length_5631_cov_25.927332	149	229	39	3	80	0.0375000
NODE_142_length_5631_cov_25.927332	149	229	41	3	80	0.0375000
NODE_142_length_5631_cov_25.927332	149	229	43	4	80	0.0500000
NODE_142_length_5631_cov_25.927332	149	229	44	1	80	0.0125000
NODE_142_length_5631_cov_25.927332	149	229	45	1	80	0.0125000
NODE_142_length_5631_cov_25.927332	149	229	46	1	80	0.0125000
NODE_142_length_5631_cov_25.927332	149	229	47	5	80	0.0625000
NODE_142_length_5631_cov_25.927332	149	229	49	4	80	0.0500000
NODE_142_length_5631_cov_25.927332	149	229	50	6	80	0.0750000
NODE_142_length_5631_cov_25.927332	149	229	51	6	80	0.0750000
NODE_142_length_5631_cov_25.927332	149	229	54	1	80	0.0125000
NODE_142_length_5631_cov_25.927332	149	229	57	1	80	0.0125000
NODE_142_length_5631_cov_25.927332	149	229	58	3	80	0.0375000
NODE_142_length_5631_cov_25.927332	149	229	60	2	80	0.0250000
NODE_146_length_5588_cov_40.961377	2793	2873	41	1	80	0.0125000
NODE_146_length_5588_cov_40.961377	2793	2873	44	4	80	0.0500000
NODE_146_length_5588_cov_40.961377	2793	2873	45	13	80	0.1625000
NODE_146_length_5588_cov_40.961377	2793	2873	46	4	80	0.0500000
NODE_146_length_5588_cov_40.961377	2793	2873	47	1	80	0.0125000
NODE_146_length_5588_cov_40.961377	2793	2873	48	1	80	0.0125000
NODE_146_length_5588_cov_40.961377	2793	2873	49	4	80	0.0500000
NODE_146_length_5588_cov_40.961377	2793	2873	50	6	80	0.0750000
NODE_146_length_5588_cov_40.961377	2793	2873	51	1	80	0.0125000
NODE_146_length_5588_cov_40.961377	2793	2873	52	10	80	0.1250000
NODE_146_length_5588_cov_40.961377	2793	2873	53	8	80	0.1000000
NODE_146_length_5588_cov_40.961377	2793	2873	54	8	80	0.1000000
NODE_146_length_5588_cov_40.961377	2793	2873	55	6	80	0.0750000
NODE_146_length_5588_cov_40.961377	2793	2873	60	5	80	0.0625000
NODE_146_length_5588_cov_40.961377	2793	2873	62	4	80	0.0500000
NODE_146_length_5588_cov_40.961377	2793	2873	63	2	80	0.0250000
NODE_146_length_5588_cov_40.961377	2793	2873	64	2	80	0.0250000
NODE_146_length_5588_cov_40.961377	2846	2926	52	1	80	0.0125000
NODE_146_length_5588_cov_40.961377	2846	2926	53	3	80	0.0375000
NODE_146_length_5588_cov_40.961377	2846	2926	54	4	80	0.0500000
NODE_146_length_5588_cov_40.961377	2846	2926	55	6	80	0.0750000
NODE_146_length_5588_cov_40.961377	2846	2926	60	5	80	0.0625000
NODE_146_length_5588_cov_40.961377	2846	2926	62	4	80	0.0500000
NODE_146_length_5588_cov_40.961377	2846	2926	63	3	80	0.0375000
NODE_146_length_5588_cov_40.961377	2846	2926	64	6	80	0.0750000
NODE_146_length_5588_cov_40.961377	2846	2926	65	2	80	0.0250000
NODE_146_length_5588_cov_40.961377	2846	2926	66	6	80	0.0750000
NODE_146_length_5588_cov_40.961377	2846	2926	67	3	80	0.0375000
NODE_146_length_5588_cov_40.961377	2846	2926	68	2	80	0.0250000
NODE_146_length_5588_cov_40.961377	2846	2926	70	1	80	0.0125000
NODE_146_length_5588_cov_40.961377	2846	2926	71	1	80	0.0125000
NODE_146_length_5588_cov_40.961377	2846	2926	73	2	80	0.0250000
NODE_146_length_5588_cov_40.961377	2846	2926	74	3	80	0.0375000
NODE_146_length_5588_cov_40.961377	2846	2926	78	1	80	0.0125000
NODE_146_length_5588_cov_40.961377	2846	2926	79	3	80	0.0375000
NODE_146_length_5588_cov_40.961377	2846	2926	80	4	80	0.0500000
NODE_146_length_5588_cov_40.961377	2846	2926	81	1	80	0.0125000
NODE_146_length_5588_cov_40.961377	2846	2926	82	4	80	0.0500000
NODE_146_length_5588_cov_40.961377	2846	2926	85	1	80	0.0125000
NODE_146_length_5588_cov_40.961377	2846	2926	87	2	80	0.0250000
NODE_146_length_5588_cov_40.961377	2846	2926	88	4	80	0.0500000
NODE_146_length_5588_cov_40.961377	2846	2926	89	1	80	0.0125000
NODE_146_length_5588_cov_40.961377	2846	2926	90	1	80	0.0125000
NODE_146_length_5588_cov_40.961377	2846	2926	91	6	80	0.0750000
NODE_146_length_5588_cov_40.961377	2922	3002	91	8	80	0.1000000
NODE_146_length_5588_cov_40.961377	2922	3002	92	2	80	0.0250000
NODE_146_length_5588_cov_40.961377	2922	3002	93	2	80	0.0250000
NODE_146_length_5588_cov_40.961377	2922	3002	94	1	80	0.0125000
NODE_146_length_5588_cov_40.961377	2922	3002	95	13	80	0.1625000
NODE_146_length_5588_cov_40.961377	2922	3002	96	12	80	0.1500000
NODE_146_length_5588_cov_40.961377	2922	3002	97	11	80	0.1375000
NODE_146_length_5588_cov_40.961377	2922	3002	98	1	80	0.0125000
NODE_146_length_5588_cov_40.961377	2922	3002	100	3	80	0.0375000
NODE_146_length_5588_cov_40.961377	2922	3002	101	3	80	0.0375000
NODE_146_length_5588_cov_40.961377	2922	3002	102	2	80	0.0250000
NODE_146_length_5588_cov_40.961377	2922	3002	103	1	80	0.0125000
NODE_146_length_5588_cov_40.961377	2922	3002	104	8	80	0.1000000
NODE_146_length_5588_cov_40.961377	2922	3002	105	1	80	0.0125000
NODE_146_length_5588_cov_40.961377	2922	3002	106	3	80	0.0375000
NODE_146_length_5588_cov_40.961377	2922	3002	107	5	80	0.0625000
NODE_146_length_5588_cov_40.961377	2922	3002	108	2	80	0.0250000
NODE_146_length_5588_cov_40.961377	2922	3002	109	2	80	0.0250000
NODE_146_length_5588_cov_40.961377	2975	3055	79	2	80	0.0250000
NODE_146_length_5588_cov_40.961377	2975	3055	80	2	80	0.0250000
NODE_146_length_5588_cov_40.961377	2975	3055	83	3	80	0.0375000
NODE_146_length_5588_cov_40.961377	2975	3055	87	4	80	0.0500000
NODE_146_length_5588_cov_40.961377	2975	3055	88	1	80	0.0125000
NODE_146_length_5588_cov_40.961377	2975	3055	90	1	80	0.0125000
NODE_146_length_5588_cov_40.961377	2975	3055	91	1	80	0.0125000
NODE_146_length_5588_cov_40.961377	2975	3055	93	1	80	0.0125000
NODE_146_length_5588_cov_40.961377	2975	3055	94	2	80	0.0250000
NODE_146_length_5588_cov_40.961377	2975	3055	98	7	80	0.0875000
NODE_146_length_5588_cov_40.961377	2975	3055	100	2	80	0.0250000
NODE_146_length_5588_cov_40.961377	2975	3055	101	5	80	0.0625000
NODE_146_length_5588_cov_40.961377	2975	3055	102	12	80	0.1500000
NODE_146_length_5588_cov_40.961377	2975	3055	103	2	80	0.0250000
NODE_146_length_5588_cov_40.961377	2975	3055	104	13	80	0.1625000
NODE_146_length_5588_cov_40.961377	2975	3055	105	2	80	0.0250000
NODE_146_length_5588_cov_40.961377	2975	3055	106	3	80	0.0375000
NODE_146_length_5588_cov_40.961377	2975	3055	107	6	80	0.0750000
NODE_146_length_5588_cov_40.961377	2975	3055	108	3	80	0.0375000
NODE_146_length_5588_cov_40.961377	2975	3055	109	2	80	0.0250000
NODE_146_length_5588_cov_40.961377	2975	3055	110	3	80	0.0375000
NODE_146_length_5588_cov_40.961377	2975	3055	111	3	80	0.0375000
NODE_149_length_5578_cov_5.173389	331	411	0	80	80	1.0000000
NODE_149_length_5578_cov_5.173389	388	464	0	28	76	0.3684210
NODE_149_length_5578_cov_5.173389	388	464	2	48	76	0.6315789
NODE_150_length_5572_cov_79.124246	1555	1627	66	1	72	0.0138889
NODE_150_length_5572_cov_79.124246	1555	1627	72	2	72	0.0277778
NODE_150_length_5572_cov_79.124246	1555	1627	74	1	72	0.0138889
NODE_150_length_5572_cov_79.124246	1555	1627	76	1	72	0.0138889
NODE_150_length_5572_cov_79.124246	1555	1627	78	5	72	0.0694444
NODE_150_length_5572_cov_79.124246	1555	1627	80	4	72	0.0555556
NODE_150_length_5572_cov_79.124246	1555	1627	82	1	72	0.0138889
NODE_150_length_5572_cov_79.124246	1555	1627	84	3	72	0.0416667
NODE_150_length_5572_cov_79.124246	1555	1627	85	1	72	0.0138889
NODE_150_length_5572_cov_79.124246	1555	1627	88	1	72	0.0138889
NODE_150_length_5572_cov_79.124246	1555	1627	89	3	72	0.0416667
NODE_150_length_5572_cov_79.124246	1555	1627	90	2	72	0.0277778
NODE_150_length_5572_cov_79.124246	1555	1627	91	1	72	0.0138889
NODE_150_length_5572_cov_79.124246	1555	1627	92	2	72	0.0277778
NODE_150_length_5572_cov_79.124246	1555	1627	93	1	72	0.0138889
NODE_150_length_5572_cov_79.124246	1555	1627	94	1	72	0.0138889
NODE_150_length_5572_cov_79.124246	1555	1627	96	1	72	0.0138889
NODE_150_length_5572_cov_79.124246	1555	1627	97	1	72	0.0138889
NODE_150_length_5572_cov_79.124246	1555	1627	100	1	72	0.0138889
NODE_150_length_5572_cov_79.124246	1555	1627	102	2	72	0.0277778
NODE_150_length_5572_cov_79.124246	1555	1627	103	3	72	0.0416667
NODE_150_length_5572_cov_79.124246	1555	1627	110	2	72	0.0277778
NODE_150_length_5572_cov_79.124246	1555	1627	111	1	72	0.0138889
NODE_150_length_5572_cov_79.124246	1555	1627	112	2	72	0.0277778
NODE_150_length_5572_cov_79.124246	1555	1627	113	1	72	0.0138889
NODE_150_length_5572_cov_79.124246	1555	1627	115	1	72	0.0138889
NODE_150_length_5572_cov_79.124246	1555	1627	118	1	72	0.0138889
NODE_150_length_5572_cov_79.124246	1555	1627	120	1	72	0.0138889
NODE_150_length_5572_cov_79.124246	1555	1627	122	1	72	0.0138889
NODE_150_length_5572_cov_79.124246	1555	1627	123	3	72	0.0416667
NODE_150_length_5572_cov_79.124246	1555	1627	124	1	72	0.0138889
NODE_150_length_5572_cov_79.124246	1555	1627	128	1	72	0.0138889
NODE_150_length_5572_cov_79.124246	1555	1627	133	2	72	0.0277778
NODE_150_length_5572_cov_79.124246	1555	1627	138	4	72	0.0555556
NODE_150_length_5572_cov_79.124246	1555	1627	140	2	72	0.0277778
NODE_150_length_5572_cov_79.124246	1555	1627	141	1	72	0.0138889
NODE_150_length_5572_cov_79.124246	1555	1627	144	1	72	0.0138889
NODE_150_length_5572_cov_79.124246	1555	1627	149	2	72	0.0277778
NODE_150_length_5572_cov_79.124246	1555	1627	152	2	72	0.0277778
NODE_150_length_5572_cov_79.124246	1555	1627	153	1	72	0.0138889
NODE_150_length_5572_cov_79.124246	1555	1627	159	1	72	0.0138889
NODE_150_length_5572_cov_79.124246	1555	1627	161	1	72	0.0138889
NODE_150_length_5572_cov_79.124246	1555	1627	164	2	72	0.0277778
NODE_150_length_5572_cov_79.124246	1603	1680	123	3	77	0.0389610
NODE_150_length_5572_cov_79.124246	1603	1680	124	1	77	0.0129870
NODE_150_length_5572_cov_79.124246	1603	1680	128	1	77	0.0129870
NODE_150_length_5572_cov_79.124246	1603	1680	133	2	77	0.0259740
NODE_150_length_5572_cov_79.124246	1603	1680	138	4	77	0.0519481
NODE_150_length_5572_cov_79.124246	1603	1680	140	2	77	0.0259740
NODE_150_length_5572_cov_79.124246	1603	1680	141	1	77	0.0129870
NODE_150_length_5572_cov_79.124246	1603	1680	144	1	77	0.0129870
NODE_150_length_5572_cov_79.124246	1603	1680	149	2	77	0.0259740
NODE_150_length_5572_cov_79.124246	1603	1680	152	2	77	0.0259740
NODE_150_length_5572_cov_79.124246	1603	1680	153	1	77	0.0129870
NODE_150_length_5572_cov_79.124246	1603	1680	159	1	77	0.0129870
NODE_150_length_5572_cov_79.124246	1603	1680	161	1	77	0.0129870
NODE_150_length_5572_cov_79.124246	1603	1680	164	2	77	0.0259740
NODE_150_length_5572_cov_79.124246	1603	1680	166	2	77	0.0259740
NODE_150_length_5572_cov_79.124246	1603	1680	168	3	77	0.0389610
NODE_150_length_5572_cov_79.124246	1603	1680	171	1	77	0.0129870
NODE_150_length_5572_cov_79.124246	1603	1680	172	2	77	0.0259740
NODE_150_length_5572_cov_79.124246	1603	1680	173	1	77	0.0129870
NODE_150_length_5572_cov_79.124246	1603	1680	174	7	77	0.0909091
NODE_150_length_5572_cov_79.124246	1603	1680	176	1	77	0.0129870
NODE_150_length_5572_cov_79.124246	1603	1680	177	1	77	0.0129870
NODE_150_length_5572_cov_79.124246	1603	1680	179	2	77	0.0259740
NODE_150_length_5572_cov_79.124246	1603	1680	180	1	77	0.0129870
NODE_150_length_5572_cov_79.124246	1603	1680	181	1	77	0.0129870
NODE_150_length_5572_cov_79.124246	1603	1680	182	1	77	0.0129870
NODE_150_length_5572_cov_79.124246	1603	1680	183	1	77	0.0129870
NODE_150_length_5572_cov_79.124246	1603	1680	184	1	77	0.0129870
NODE_150_length_5572_cov_79.124246	1603	1680	190	1	77	0.0129870
NODE_150_length_5572_cov_79.124246	1603	1680	193	1	77	0.0129870
NODE_150_length_5572_cov_79.124246	1603	1680	203	1	77	0.0129870
NODE_150_length_5572_cov_79.124246	1603	1680	204	1	77	0.0129870
NODE_150_length_5572_cov_79.124246	1603	1680	206	1	77	0.0129870
NODE_150_length_5572_cov_79.124246	1603	1680	211	1	77	0.0129870
NODE_150_length_5572_cov_79.124246	1603	1680	213	1	77	0.0129870
NODE_150_length_5572_cov_79.124246	1603	1680	216	1	77	0.0129870
NODE_150_length_5572_cov_79.124246	1603	1680	222	1	77	0.0129870
NODE_150_length_5572_cov_79.124246	1603	1680	224	2	77	0.0259740
NODE_150_length_5572_cov_79.124246	1603	1680	227	1	77	0.0129870
NODE_150_length_5572_cov_79.124246	1603	1680	229	1	77	0.0129870
NODE_150_length_5572_cov_79.124246	1603	1680	230	2	77	0.0259740
NODE_150_length_5572_cov_79.124246	1603	1680	232	1	77	0.0129870
NODE_150_length_5572_cov_79.124246	1603	1680	233	2	77	0.0259740
NODE_150_length_5572_cov_79.124246	1603	1680	240	1	77	0.0129870
NODE_150_length_5572_cov_79.124246	1603	1680	242	1	77	0.0129870
NODE_150_length_5572_cov_79.124246	1603	1680	243	1	77	0.0129870
NODE_150_length_5572_cov_79.124246	1603	1680	244	1	77	0.0129870
NODE_150_length_5572_cov_79.124246	1603	1680	245	3	77	0.0389610
NODE_150_length_5572_cov_79.124246	1603	1680	246	1	77	0.0129870
NODE_150_length_5572_cov_79.124246	1603	1680	247	1	77	0.0129870
NODE_150_length_5572_cov_79.124246	1603	1680	248	1	77	0.0129870
NODE_150_length_5572_cov_79.124246	1637	1717	173	1	80	0.0125000
NODE_150_length_5572_cov_79.124246	1637	1717	174	6	80	0.0750000
NODE_150_length_5572_cov_79.124246	1637	1717	177	1	80	0.0125000
NODE_150_length_5572_cov_79.124246	1637	1717	179	2	80	0.0250000
NODE_150_length_5572_cov_79.124246	1637	1717	180	1	80	0.0125000
NODE_150_length_5572_cov_79.124246	1637	1717	181	1	80	0.0125000
NODE_150_length_5572_cov_79.124246	1637	1717	182	1	80	0.0125000
NODE_150_length_5572_cov_79.124246	1637	1717	183	1	80	0.0125000
NODE_150_length_5572_cov_79.124246	1637	1717	184	1	80	0.0125000
NODE_150_length_5572_cov_79.124246	1637	1717	190	1	80	0.0125000
NODE_150_length_5572_cov_79.124246	1637	1717	193	1	80	0.0125000
NODE_150_length_5572_cov_79.124246	1637	1717	203	1	80	0.0125000
NODE_150_length_5572_cov_79.124246	1637	1717	204	1	80	0.0125000
NODE_150_length_5572_cov_79.124246	1637	1717	206	1	80	0.0125000
NODE_150_length_5572_cov_79.124246	1637	1717	211	1	80	0.0125000
NODE_150_length_5572_cov_79.124246	1637	1717	213	1	80	0.0125000
NODE_150_length_5572_cov_79.124246	1637	1717	216	1	80	0.0125000
NODE_150_length_5572_cov_79.124246	1637	1717	222	1	80	0.0125000
NODE_150_length_5572_cov_79.124246	1637	1717	224	2	80	0.0250000
NODE_150_length_5572_cov_79.124246	1637	1717	227	1	80	0.0125000
NODE_150_length_5572_cov_79.124246	1637	1717	229	1	80	0.0125000
NODE_150_length_5572_cov_79.124246	1637	1717	230	2	80	0.0250000
NODE_150_length_5572_cov_79.124246	1637	1717	232	1	80	0.0125000
NODE_150_length_5572_cov_79.124246	1637	1717	233	2	80	0.0250000
NODE_150_length_5572_cov_79.124246	1637	1717	240	1	80	0.0125000
NODE_150_length_5572_cov_79.124246	1637	1717	242	1	80	0.0125000
NODE_150_length_5572_cov_79.124246	1637	1717	243	1	80	0.0125000
NODE_150_length_5572_cov_79.124246	1637	1717	244	1	80	0.0125000
NODE_150_length_5572_cov_79.124246	1637	1717	245	3	80	0.0375000
NODE_150_length_5572_cov_79.124246	1637	1717	246	1	80	0.0125000
NODE_150_length_5572_cov_79.124246	1637	1717	247	1	80	0.0125000
NODE_150_length_5572_cov_79.124246	1637	1717	248	2	80	0.0250000
NODE_150_length_5572_cov_79.124246	1637	1717	249	1	80	0.0125000
NODE_150_length_5572_cov_79.124246	1637	1717	251	1	80	0.0125000
NODE_150_length_5572_cov_79.124246	1637	1717	254	2	80	0.0250000
NODE_150_length_5572_cov_79.124246	1637	1717	255	1	80	0.0125000
NODE_150_length_5572_cov_79.124246	1637	1717	256	1	80	0.0125000
NODE_150_length_5572_cov_79.124246	1637	1717	257	1	80	0.0125000
NODE_150_length_5572_cov_79.124246	1637	1717	258	7	80	0.0875000
NODE_150_length_5572_cov_79.124246	1637	1717	260	2	80	0.0250000
NODE_150_length_5572_cov_79.124246	1637	1717	261	1	80	0.0125000
NODE_150_length_5572_cov_79.124246	1637	1717	262	3	80	0.0375000
NODE_150_length_5572_cov_79.124246	1637	1717	264	5	80	0.0625000
NODE_150_length_5572_cov_79.124246	1637	1717	265	1	80	0.0125000
NODE_150_length_5572_cov_79.124246	1637	1717	266	1	80	0.0125000
NODE_150_length_5572_cov_79.124246	1637	1717	267	3	80	0.0375000
NODE_150_length_5572_cov_79.124246	1637	1717	268	3	80	0.0375000
NODE_150_length_5572_cov_79.124246	1637	1717	269	2	80	0.0250000
NODE_150_length_5572_cov_79.124246	1637	1717	270	1	80	0.0125000
NODE_150_length_5572_cov_79.124246	1690	1770	166	2	80	0.0250000
NODE_150_length_5572_cov_79.124246	1690	1770	171	1	80	0.0125000
NODE_150_length_5572_cov_79.124246	1690	1770	174	1	80	0.0125000
NODE_150_length_5572_cov_79.124246	1690	1770	177	2	80	0.0250000
NODE_150_length_5572_cov_79.124246	1690	1770	179	3	80	0.0375000
NODE_150_length_5572_cov_79.124246	1690	1770	180	1	80	0.0125000
NODE_150_length_5572_cov_79.124246	1690	1770	184	1	80	0.0125000
NODE_150_length_5572_cov_79.124246	1690	1770	185	1	80	0.0125000
NODE_150_length_5572_cov_79.124246	1690	1770	190	1	80	0.0125000
NODE_150_length_5572_cov_79.124246	1690	1770	195	1	80	0.0125000
NODE_150_length_5572_cov_79.124246	1690	1770	196	1	80	0.0125000
NODE_150_length_5572_cov_79.124246	1690	1770	198	2	80	0.0250000
NODE_150_length_5572_cov_79.124246	1690	1770	199	1	80	0.0125000
NODE_150_length_5572_cov_79.124246	1690	1770	201	1	80	0.0125000
NODE_150_length_5572_cov_79.124246	1690	1770	203	1	80	0.0125000
NODE_150_length_5572_cov_79.124246	1690	1770	206	1	80	0.0125000
NODE_150_length_5572_cov_79.124246	1690	1770	208	1	80	0.0125000
NODE_150_length_5572_cov_79.124246	1690	1770	210	2	80	0.0250000
NODE_150_length_5572_cov_79.124246	1690	1770	211	1	80	0.0125000
NODE_150_length_5572_cov_79.124246	1690	1770	212	2	80	0.0250000
NODE_150_length_5572_cov_79.124246	1690	1770	218	1	80	0.0125000
NODE_150_length_5572_cov_79.124246	1690	1770	219	2	80	0.0250000
NODE_150_length_5572_cov_79.124246	1690	1770	223	2	80	0.0250000
NODE_150_length_5572_cov_79.124246	1690	1770	224	1	80	0.0125000
NODE_150_length_5572_cov_79.124246	1690	1770	229	1	80	0.0125000
NODE_150_length_5572_cov_79.124246	1690	1770	230	1	80	0.0125000
NODE_150_length_5572_cov_79.124246	1690	1770	232	1	80	0.0125000
NODE_150_length_5572_cov_79.124246	1690	1770	233	1	80	0.0125000
NODE_150_length_5572_cov_79.124246	1690	1770	234	2	80	0.0250000
NODE_150_length_5572_cov_79.124246	1690	1770	237	3	80	0.0375000
NODE_150_length_5572_cov_79.124246	1690	1770	239	1	80	0.0125000
NODE_150_length_5572_cov_79.124246	1690	1770	240	1	80	0.0125000
NODE_150_length_5572_cov_79.124246	1690	1770	242	2	80	0.0250000
NODE_150_length_5572_cov_79.124246	1690	1770	248	1	80	0.0125000
NODE_150_length_5572_cov_79.124246	1690	1770	249	3	80	0.0375000
NODE_150_length_5572_cov_79.124246	1690	1770	253	3	80	0.0375000
NODE_150_length_5572_cov_79.124246	1690	1770	254	1	80	0.0125000
NODE_150_length_5572_cov_79.124246	1690	1770	256	1	80	0.0125000
NODE_150_length_5572_cov_79.124246	1690	1770	258	5	80	0.0625000
NODE_150_length_5572_cov_79.124246	1690	1770	260	1	80	0.0125000
NODE_150_length_5572_cov_79.124246	1690	1770	262	3	80	0.0375000
NODE_150_length_5572_cov_79.124246	1690	1770	264	5	80	0.0625000
NODE_150_length_5572_cov_79.124246	1690	1770	265	1	80	0.0125000
NODE_150_length_5572_cov_79.124246	1690	1770	266	1	80	0.0125000
NODE_150_length_5572_cov_79.124246	1690	1770	267	3	80	0.0375000
NODE_150_length_5572_cov_79.124246	1690	1770	268	3	80	0.0375000
NODE_150_length_5572_cov_79.124246	1690	1770	269	2	80	0.0250000
NODE_150_length_5572_cov_79.124246	1690	1770	270	1	80	0.0125000
NODE_150_length_5572_cov_79.124246	5130	5210	3	22	80	0.2750000
NODE_150_length_5572_cov_79.124246	5130	5210	4	12	80	0.1500000
NODE_150_length_5572_cov_79.124246	5130	5210	5	1	80	0.0125000
NODE_150_length_5572_cov_79.124246	5130	5210	6	14	80	0.1750000
NODE_150_length_5572_cov_79.124246	5130	5210	21	31	80	0.3875000
NODE_150_length_5572_cov_79.124246	5183	5263	19	16	80	0.2000000
NODE_150_length_5572_cov_79.124246	5183	5263	20	16	80	0.2000000
NODE_150_length_5572_cov_79.124246	5183	5263	21	48	80	0.6000000
NODE_151_length_5557_cov_26.198241	341	414	1	73	73	1.0000000
NODE_151_length_5557_cov_26.198241	394	460	0	18	66	0.2727273
NODE_151_length_5557_cov_26.198241	394	460	1	48	66	0.7272727
NODE_156_length_5500_cov_35.832438	81	161	5	18	80	0.2250000
NODE_156_length_5500_cov_35.832438	81	161	6	6	80	0.0750000
NODE_156_length_5500_cov_35.832438	81	161	7	10	80	0.1250000
NODE_156_length_5500_cov_35.832438	81	161	8	11	80	0.1375000
NODE_156_length_5500_cov_35.832438	81	161	9	35	80	0.4375000
NODE_156_length_5500_cov_35.832438	134	214	7	6	80	0.0750000
NODE_156_length_5500_cov_35.832438	134	214	8	4	80	0.0500000
NODE_156_length_5500_cov_35.832438	134	214	9	35	80	0.4375000
NODE_156_length_5500_cov_35.832438	134	214	10	35	80	0.4375000
NODE_159_length_5470_cov_5.987526	5180	5249	2	30	69	0.4347826
NODE_159_length_5470_cov_5.987526	5180	5249	3	21	69	0.3043478
NODE_159_length_5470_cov_5.987526	5180	5249	4	18	69	0.2608696
NODE_160_length_5434_cov_14.997751	541	621	1	15	80	0.1875000
NODE_160_length_5434_cov_14.997751	541	621	2	65	80	0.8125000
NODE_160_length_5434_cov_14.997751	594	674	1	17	80	0.2125000
NODE_160_length_5434_cov_14.997751	594	674	2	63	80	0.7875000
NODE_160_length_5434_cov_14.997751	2664	2744	0	80	80	1.0000000
NODE_160_length_5434_cov_14.997751	2717	2797	0	80	80	1.0000000
NODE_160_length_5434_cov_14.997751	3041	3093	1	6	52	0.1153846
NODE_160_length_5434_cov_14.997751	3041	3093	2	46	52	0.8846154
NODE_160_length_5434_cov_14.997751	3419	3467	7	19	48	0.3958333
NODE_160_length_5434_cov_14.997751	3419	3467	8	29	48	0.6041667
NODE_161_length_5425_cov_15.812242	141	218	1	29	77	0.3766234
NODE_161_length_5425_cov_15.812242	141	218	2	12	77	0.1558442
NODE_161_length_5425_cov_15.812242	141	218	3	16	77	0.2077922
NODE_161_length_5425_cov_15.812242	141	218	5	9	77	0.1168831
NODE_161_length_5425_cov_15.812242	141	218	12	2	77	0.0259740
NODE_161_length_5425_cov_15.812242	141	218	13	9	77	0.1168831
NODE_161_length_5425_cov_15.812242	841	921	13	1	80	0.0125000
NODE_161_length_5425_cov_15.812242	841	921	14	28	80	0.3500000
NODE_161_length_5425_cov_15.812242	841	921	15	22	80	0.2750000
NODE_161_length_5425_cov_15.812242	841	921	16	29	80	0.3625000
NODE_161_length_5425_cov_15.812242	894	974	6	31	80	0.3875000
NODE_161_length_5425_cov_15.812242	894	974	9	22	80	0.2750000
NODE_161_length_5425_cov_15.812242	894	974	14	5	80	0.0625000
NODE_161_length_5425_cov_15.812242	894	974	15	22	80	0.2750000
NODE_163_length_5402_cov_5.397322	191	263	0	72	72	1.0000000
NODE_163_length_5402_cov_5.397322	2305	2385	11	1	80	0.0125000
NODE_163_length_5402_cov_5.397322	2305	2385	12	32	80	0.4000000
NODE_163_length_5402_cov_5.397322	2305	2385	14	7	80	0.0875000
NODE_163_length_5402_cov_5.397322	2305	2385	15	16	80	0.2000000
NODE_163_length_5402_cov_5.397322	2305	2385	16	7	80	0.0875000
NODE_163_length_5402_cov_5.397322	2305	2385	17	8	80	0.1000000
NODE_163_length_5402_cov_5.397322	2305	2385	18	9	80	0.1125000
NODE_163_length_5402_cov_5.397322	2358	2438	12	39	80	0.4875000
NODE_163_length_5402_cov_5.397322	2358	2438	13	4	80	0.0500000
NODE_163_length_5402_cov_5.397322	2358	2438	14	12	80	0.1500000
NODE_163_length_5402_cov_5.397322	2358	2438	15	14	80	0.1750000
NODE_163_length_5402_cov_5.397322	2358	2438	16	1	80	0.0125000
NODE_163_length_5402_cov_5.397322	2358	2438	17	1	80	0.0125000
NODE_163_length_5402_cov_5.397322	2358	2438	18	9	80	0.1125000
NODE_164_length_5383_cov_15.680545	205	285	0	80	80	1.0000000
NODE_164_length_5383_cov_15.680545	258	317	0	59	59	1.0000000
NODE_164_length_5383_cov_15.680545	2042	2122	10	9	80	0.1125000
NODE_164_length_5383_cov_15.680545	2042	2122	11	2	80	0.0250000
NODE_164_length_5383_cov_15.680545	2042	2122	12	2	80	0.0250000
NODE_164_length_5383_cov_15.680545	2042	2122	13	4	80	0.0500000
NODE_164_length_5383_cov_15.680545	2042	2122	14	18	80	0.2250000
NODE_164_length_5383_cov_15.680545	2042	2122	16	1	80	0.0125000
NODE_164_length_5383_cov_15.680545	2042	2122	17	44	80	0.5500000
NODE_164_length_5383_cov_15.680545	2095	2175	0	2	80	0.0250000
NODE_164_length_5383_cov_15.680545	2095	2175	1	9	80	0.1125000
NODE_164_length_5383_cov_15.680545	2095	2175	2	8	80	0.1000000
NODE_164_length_5383_cov_15.680545	2095	2175	3	5	80	0.0625000
NODE_164_length_5383_cov_15.680545	2095	2175	4	8	80	0.1000000
NODE_164_length_5383_cov_15.680545	2095	2175	5	4	80	0.0500000
NODE_164_length_5383_cov_15.680545	2095	2175	7	11	80	0.1375000
NODE_164_length_5383_cov_15.680545	2095	2175	9	4	80	0.0500000
NODE_164_length_5383_cov_15.680545	2095	2175	10	11	80	0.1375000
NODE_164_length_5383_cov_15.680545	2095	2175	11	2	80	0.0250000
NODE_164_length_5383_cov_15.680545	2095	2175	12	2	80	0.0250000
NODE_164_length_5383_cov_15.680545	2095	2175	13	4	80	0.0500000
NODE_164_length_5383_cov_15.680545	2095	2175	14	10	80	0.1250000
NODE_165_length_5382_cov_16.894378	1301	1347	20	4	46	0.0869565
NODE_165_length_5382_cov_16.894378	1301	1347	22	8	46	0.1739130
NODE_165_length_5382_cov_16.894378	1301	1347	24	1	46	0.0217391
NODE_165_length_5382_cov_16.894378	1301	1347	26	33	46	0.7173913
NODE_165_length_5382_cov_16.894378	5056	5082	24	14	26	0.5384616
NODE_165_length_5382_cov_16.894378	5056	5082	25	11	26	0.4230769
NODE_165_length_5382_cov_16.894378	5056	5082	26	1	26	0.0384615
NODE_165_length_5382_cov_16.894378	5056	5115	23	7	59	0.1186441
NODE_165_length_5382_cov_16.894378	5056	5115	24	25	59	0.4237288
NODE_165_length_5382_cov_16.894378	5056	5115	25	18	59	0.3050847
NODE_165_length_5382_cov_16.894378	5056	5115	26	8	59	0.1355932
NODE_165_length_5382_cov_16.894378	5056	5115	27	1	59	0.0169492
NODE_167_length_5339_cov_28.708969	3375	3455	17	1	80	0.0125000
NODE_167_length_5339_cov_28.708969	3375	3455	18	4	80	0.0500000
NODE_167_length_5339_cov_28.708969	3375	3455	19	10	80	0.1250000
NODE_167_length_5339_cov_28.708969	3375	3455	21	2	80	0.0250000
NODE_167_length_5339_cov_28.708969	3375	3455	23	2	80	0.0250000
NODE_167_length_5339_cov_28.708969	3375	3455	26	8	80	0.1000000
NODE_167_length_5339_cov_28.708969	3375	3455	29	3	80	0.0375000
NODE_167_length_5339_cov_28.708969	3375	3455	31	8	80	0.1000000
NODE_167_length_5339_cov_28.708969	3375	3455	33	1	80	0.0125000
NODE_167_length_5339_cov_28.708969	3375	3455	35	4	80	0.0500000
NODE_167_length_5339_cov_28.708969	3375	3455	36	4	80	0.0500000
NODE_167_length_5339_cov_28.708969	3375	3455	37	1	80	0.0125000
NODE_167_length_5339_cov_28.708969	3375	3455	39	4	80	0.0500000
NODE_167_length_5339_cov_28.708969	3375	3455	40	3	80	0.0375000
NODE_167_length_5339_cov_28.708969	3375	3455	41	10	80	0.1250000
NODE_167_length_5339_cov_28.708969	3375	3455	42	9	80	0.1125000
NODE_167_length_5339_cov_28.708969	3375	3455	43	6	80	0.0750000
NODE_167_length_5339_cov_28.708969	3428	3508	40	9	80	0.1125000
NODE_167_length_5339_cov_28.708969	3428	3508	41	11	80	0.1375000
NODE_167_length_5339_cov_28.708969	3428	3508	42	20	80	0.2500000
NODE_167_length_5339_cov_28.708969	3428	3508	43	9	80	0.1125000
NODE_167_length_5339_cov_28.708969	3428	3508	44	12	80	0.1500000
NODE_167_length_5339_cov_28.708969	3428	3508	45	9	80	0.1125000
NODE_167_length_5339_cov_28.708969	3428	3508	47	10	80	0.1250000
NODE_168_length_5336_cov_33.036471	3109	3189	51	3	80	0.0375000
NODE_168_length_5336_cov_33.036471	3109	3189	52	2	80	0.0250000
NODE_168_length_5336_cov_33.036471	3109	3189	53	8	80	0.1000000
NODE_168_length_5336_cov_33.036471	3109	3189	54	10	80	0.1250000
NODE_168_length_5336_cov_33.036471	3109	3189	55	15	80	0.1875000
NODE_168_length_5336_cov_33.036471	3109	3189	56	7	80	0.0875000
NODE_168_length_5336_cov_33.036471	3109	3189	57	2	80	0.0250000
NODE_168_length_5336_cov_33.036471	3109	3189	58	3	80	0.0375000
NODE_168_length_5336_cov_33.036471	3109	3189	59	7	80	0.0875000
NODE_168_length_5336_cov_33.036471	3109	3189	60	10	80	0.1250000
NODE_168_length_5336_cov_33.036471	3109	3189	61	2	80	0.0250000
NODE_168_length_5336_cov_33.036471	3109	3189	62	4	80	0.0500000
NODE_168_length_5336_cov_33.036471	3109	3189	63	3	80	0.0375000
NODE_168_length_5336_cov_33.036471	3109	3189	64	4	80	0.0500000
NODE_168_length_5336_cov_33.036471	3162	3242	40	3	80	0.0375000
NODE_168_length_5336_cov_33.036471	3162	3242	41	7	80	0.0875000
NODE_168_length_5336_cov_33.036471	3162	3242	42	1	80	0.0125000
NODE_168_length_5336_cov_33.036471	3162	3242	43	1	80	0.0125000
NODE_168_length_5336_cov_33.036471	3162	3242	44	2	80	0.0250000
NODE_168_length_5336_cov_33.036471	3162	3242	45	1	80	0.0125000
NODE_168_length_5336_cov_33.036471	3162	3242	46	1	80	0.0125000
NODE_168_length_5336_cov_33.036471	3162	3242	48	5	80	0.0625000
NODE_168_length_5336_cov_33.036471	3162	3242	49	3	80	0.0375000
NODE_168_length_5336_cov_33.036471	3162	3242	50	9	80	0.1125000
NODE_168_length_5336_cov_33.036471	3162	3242	51	5	80	0.0625000
NODE_168_length_5336_cov_33.036471	3162	3242	53	8	80	0.1000000
NODE_168_length_5336_cov_33.036471	3162	3242	54	5	80	0.0625000
NODE_168_length_5336_cov_33.036471	3162	3242	55	11	80	0.1375000
NODE_168_length_5336_cov_33.036471	3162	3242	56	10	80	0.1250000
NODE_168_length_5336_cov_33.036471	3162	3242	58	3	80	0.0375000
NODE_168_length_5336_cov_33.036471	3162	3242	59	1	80	0.0125000
NODE_168_length_5336_cov_33.036471	3162	3242	60	4	80	0.0500000
NODE_179_length_5269_cov_23.392650	1905	1985	7	7	80	0.0875000
NODE_179_length_5269_cov_23.392650	1905	1985	8	1	80	0.0125000
NODE_179_length_5269_cov_23.392650	1905	1985	9	9	80	0.1125000
NODE_179_length_5269_cov_23.392650	1905	1985	10	34	80	0.4250000
NODE_179_length_5269_cov_23.392650	1905	1985	11	9	80	0.1125000
NODE_179_length_5269_cov_23.392650	1905	1985	13	20	80	0.2500000
NODE_179_length_5269_cov_23.392650	1958	2038	9	26	80	0.3250000
NODE_179_length_5269_cov_23.392650	1958	2038	10	2	80	0.0250000
NODE_179_length_5269_cov_23.392650	1958	2038	11	14	80	0.1750000
NODE_179_length_5269_cov_23.392650	1958	2038	13	38	80	0.4750000
NODE_181_length_5207_cov_31.352780	4588	4668	4	4	80	0.0500000
NODE_181_length_5207_cov_31.352780	4588	4668	5	29	80	0.3625000
NODE_181_length_5207_cov_31.352780	4588	4668	6	37	80	0.4625000
NODE_181_length_5207_cov_31.352780	4588	4668	7	4	80	0.0500000
NODE_181_length_5207_cov_31.352780	4588	4668	8	6	80	0.0750000
NODE_181_length_5207_cov_31.352780	4641	4721	6	73	80	0.9125000
NODE_181_length_5207_cov_31.352780	4641	4721	7	4	80	0.0500000
NODE_181_length_5207_cov_31.352780	4641	4721	8	3	80	0.0375000
NODE_183_length_5193_cov_14.930506	4659	4739	12	8	80	0.1000000
NODE_183_length_5193_cov_14.930506	4659	4739	13	8	80	0.1000000
NODE_183_length_5193_cov_14.930506	4659	4739	15	24	80	0.3000000
NODE_183_length_5193_cov_14.930506	4659	4739	17	25	80	0.3125000
NODE_183_length_5193_cov_14.930506	4659	4739	18	15	80	0.1875000
NODE_183_length_5193_cov_14.930506	4712	4792	16	19	80	0.2375000
NODE_183_length_5193_cov_14.930506	4712	4792	17	25	80	0.3125000
NODE_183_length_5193_cov_14.930506	4712	4792	18	35	80	0.4375000
NODE_183_length_5193_cov_14.930506	4712	4792	19	1	80	0.0125000
NODE_183_length_5193_cov_14.930506	4788	4868	5	19	80	0.2375000
NODE_183_length_5193_cov_14.930506	4788	4868	7	24	80	0.3000000
NODE_183_length_5193_cov_14.930506	4788	4868	9	8	80	0.1000000
NODE_183_length_5193_cov_14.930506	4788	4868	10	8	80	0.1000000
NODE_183_length_5193_cov_14.930506	4788	4868	11	1	80	0.0125000
NODE_183_length_5193_cov_14.930506	4788	4868	13	9	80	0.1125000
NODE_183_length_5193_cov_14.930506	4788	4868	15	4	80	0.0500000
NODE_183_length_5193_cov_14.930506	4788	4868	16	7	80	0.0875000
NODE_183_length_5193_cov_14.930506	4841	4921	1	7	80	0.0875000
NODE_183_length_5193_cov_14.930506	4841	4921	3	12	80	0.1500000
NODE_183_length_5193_cov_14.930506	4841	4921	4	28	80	0.3500000
NODE_183_length_5193_cov_14.930506	4841	4921	5	25	80	0.3125000
NODE_183_length_5193_cov_14.930506	4841	4921	7	8	80	0.1000000
NODE_186_length_5159_cov_261.593676	158	227	222	1	69	0.0144928
NODE_186_length_5159_cov_261.593676	158	227	223	1	69	0.0144928
NODE_186_length_5159_cov_261.593676	158	227	225	1	69	0.0144928
NODE_186_length_5159_cov_261.593676	158	227	226	1	69	0.0144928
NODE_186_length_5159_cov_261.593676	158	227	228	1	69	0.0144928
NODE_186_length_5159_cov_261.593676	158	227	229	1	69	0.0144928
NODE_186_length_5159_cov_261.593676	158	227	232	1	69	0.0144928
NODE_186_length_5159_cov_261.593676	158	227	235	2	69	0.0289855
NODE_186_length_5159_cov_261.593676	158	227	236	3	69	0.0434783
NODE_186_length_5159_cov_261.593676	158	227	237	1	69	0.0144928
NODE_186_length_5159_cov_261.593676	158	227	238	1	69	0.0144928
NODE_186_length_5159_cov_261.593676	158	227	241	2	69	0.0289855
NODE_186_length_5159_cov_261.593676	158	227	242	4	69	0.0579710
NODE_186_length_5159_cov_261.593676	158	227	243	1	69	0.0144928
NODE_186_length_5159_cov_261.593676	158	227	244	3	69	0.0434783
NODE_186_length_5159_cov_261.593676	158	227	245	6	69	0.0869565
NODE_186_length_5159_cov_261.593676	158	227	246	1	69	0.0144928
NODE_186_length_5159_cov_261.593676	158	227	249	2	69	0.0289855
NODE_186_length_5159_cov_261.593676	158	227	250	1	69	0.0144928
NODE_186_length_5159_cov_261.593676	158	227	252	1	69	0.0144928
NODE_186_length_5159_cov_261.593676	158	227	253	3	69	0.0434783
NODE_186_length_5159_cov_261.593676	158	227	254	2	69	0.0289855
NODE_186_length_5159_cov_261.593676	158	227	255	1	69	0.0144928
NODE_186_length_5159_cov_261.593676	158	227	258	1	69	0.0144928
NODE_186_length_5159_cov_261.593676	158	227	259	2	69	0.0289855
NODE_186_length_5159_cov_261.593676	158	227	261	1	69	0.0144928
NODE_186_length_5159_cov_261.593676	158	227	262	2	69	0.0289855
NODE_186_length_5159_cov_261.593676	158	227	263	1	69	0.0144928
NODE_186_length_5159_cov_261.593676	158	227	266	1	69	0.0144928
NODE_186_length_5159_cov_261.593676	158	227	267	1	69	0.0144928
NODE_186_length_5159_cov_261.593676	158	227	268	9	69	0.1304348
NODE_186_length_5159_cov_261.593676	158	227	270	5	69	0.0724638
NODE_186_length_5159_cov_261.593676	158	227	271	3	69	0.0434783
NODE_186_length_5159_cov_261.593676	158	227	272	1	69	0.0144928
NODE_186_length_5159_cov_261.593676	158	227	273	1	69	0.0144928
NODE_189_length_5138_cov_31.467355	3004	3075	0	1	71	0.0140845
NODE_189_length_5138_cov_31.467355	3004	3075	2	70	71	0.9859155
NODE_191_length_5126_cov_5.900935	731	811	8	47	80	0.5875000
NODE_191_length_5126_cov_5.900935	731	811	9	1	80	0.0125000
NODE_191_length_5126_cov_5.900935	731	811	10	3	80	0.0375000
NODE_191_length_5126_cov_5.900935	731	811	11	21	80	0.2625000
NODE_191_length_5126_cov_5.900935	731	811	12	8	80	0.1000000
NODE_191_length_5126_cov_5.900935	784	864	6	17	80	0.2125000
NODE_191_length_5126_cov_5.900935	784	864	7	31	80	0.3875000
NODE_191_length_5126_cov_5.900935	784	864	8	32	80	0.4000000
NODE_194_length_5102_cov_12.729962	367	447	11	5	80	0.0625000
NODE_194_length_5102_cov_12.729962	367	447	13	16	80	0.2000000
NODE_194_length_5102_cov_12.729962	367	447	16	2	80	0.0250000
NODE_194_length_5102_cov_12.729962	367	447	17	25	80	0.3125000
NODE_194_length_5102_cov_12.729962	367	447	18	14	80	0.1750000
NODE_194_length_5102_cov_12.729962	367	447	19	1	80	0.0125000
NODE_194_length_5102_cov_12.729962	367	447	20	17	80	0.2125000
NODE_194_length_5102_cov_12.729962	420	500	13	7	80	0.0875000
NODE_194_length_5102_cov_12.729962	420	500	14	10	80	0.1250000
NODE_194_length_5102_cov_12.729962	420	500	16	1	80	0.0125000
NODE_194_length_5102_cov_12.729962	420	500	17	9	80	0.1125000
NODE_194_length_5102_cov_12.729962	420	500	19	2	80	0.0250000
NODE_194_length_5102_cov_12.729962	420	500	20	35	80	0.4375000
NODE_194_length_5102_cov_12.729962	420	500	22	10	80	0.1250000
NODE_194_length_5102_cov_12.729962	420	500	23	6	80	0.0750000
NODE_194_length_5102_cov_12.729962	496	576	9	5	80	0.0625000
NODE_194_length_5102_cov_12.729962	496	576	10	17	80	0.2125000
NODE_194_length_5102_cov_12.729962	496	576	11	16	80	0.2000000
NODE_194_length_5102_cov_12.729962	496	576	13	15	80	0.1875000
NODE_194_length_5102_cov_12.729962	496	576	14	26	80	0.3250000
NODE_194_length_5102_cov_12.729962	496	576	16	1	80	0.0125000
NODE_194_length_5102_cov_12.729962	549	629	8	1	80	0.0125000
NODE_194_length_5102_cov_12.729962	549	629	9	1	80	0.0125000
NODE_194_length_5102_cov_12.729962	549	629	10	12	80	0.1500000
NODE_194_length_5102_cov_12.729962	549	629	11	44	80	0.5500000
NODE_194_length_5102_cov_12.729962	549	629	12	5	80	0.0625000
NODE_194_length_5102_cov_12.729962	549	629	14	17	80	0.2125000
NODE_196_length_5079_cov_5.580522	875	940	0	65	65	1.0000000
NODE_197_length_5057_cov_16.348729	2929	3000	10	5	71	0.0704225
NODE_197_length_5057_cov_16.348729	2929	3000	14	4	71	0.0563380
NODE_197_length_5057_cov_16.348729	2929	3000	16	4	71	0.0563380
NODE_197_length_5057_cov_16.348729	2929	3000	17	6	71	0.0845070
NODE_197_length_5057_cov_16.348729	2929	3000	19	1	71	0.0140845
NODE_197_length_5057_cov_16.348729	2929	3000	20	1	71	0.0140845
NODE_197_length_5057_cov_16.348729	2929	3000	21	3	71	0.0422535
NODE_197_length_5057_cov_16.348729	2929	3000	22	1	71	0.0140845
NODE_197_length_5057_cov_16.348729	2929	3000	23	7	71	0.0985916
NODE_197_length_5057_cov_16.348729	2929	3000	24	7	71	0.0985916
NODE_197_length_5057_cov_16.348729	2929	3000	25	1	71	0.0140845
NODE_197_length_5057_cov_16.348729	2929	3000	27	1	71	0.0140845
NODE_197_length_5057_cov_16.348729	2929	3000	28	11	71	0.1549296
NODE_197_length_5057_cov_16.348729	2929	3000	29	14	71	0.1971831
NODE_197_length_5057_cov_16.348729	2929	3000	30	1	71	0.0140845
NODE_197_length_5057_cov_16.348729	2929	3000	31	1	71	0.0140845
NODE_197_length_5057_cov_16.348729	2929	3000	32	3	71	0.0422535
NODE_197_length_5057_cov_16.348729	2973	3012	28	8	39	0.2051282
NODE_197_length_5057_cov_16.348729	2973	3012	29	14	39	0.3589744
NODE_197_length_5057_cov_16.348729	2973	3012	30	1	39	0.0256410
NODE_197_length_5057_cov_16.348729	2973	3012	31	1	39	0.0256410
NODE_197_length_5057_cov_16.348729	2973	3012	32	3	39	0.0769231
NODE_197_length_5057_cov_16.348729	2973	3012	33	4	39	0.1025641
NODE_197_length_5057_cov_16.348729	2973	3012	37	8	39	0.2051282
NODE_198_length_5053_cov_11.281994	791	834	2	43	43	1.0000000
NODE_198_length_5053_cov_11.281994	807	887	2	80	80	1.0000000
NODE_198_length_5053_cov_11.281994	883	963	0	73	80	0.9125000
NODE_198_length_5053_cov_11.281994	883	963	2	7	80	0.0875000
NODE_198_length_5053_cov_11.281994	936	999	0	63	63	1.0000000
NODE_204_length_4906_cov_37.988350	3170	3251	4	3	81	0.0370370
NODE_204_length_4906_cov_37.988350	3170	3251	5	20	81	0.2469136
NODE_204_length_4906_cov_37.988350	3170	3251	7	4	81	0.0493827
NODE_204_length_4906_cov_37.988350	3170	3251	10	40	81	0.4938272
NODE_204_length_4906_cov_37.988350	3170	3251	13	14	81	0.1728395
NODE_205_length_4888_cov_60.162247	4029	4068	2	5	39	0.1282051
NODE_205_length_4888_cov_60.162247	4029	4068	3	34	39	0.8717949
NODE_205_length_4888_cov_60.162247	4041	4121	3	30	80	0.3750000
NODE_205_length_4888_cov_60.162247	4041	4121	4	2	80	0.0250000
NODE_205_length_4888_cov_60.162247	4041	4121	5	48	80	0.6000000
NODE_207_length_4875_cov_63.035176	2905	2985	0	80	80	1.0000000
NODE_207_length_4875_cov_63.035176	2958	3038	0	80	80	1.0000000
NODE_208_length_4875_cov_8.996859	4683	4760	2	77	77	1.0000000
NODE_208_length_4875_cov_8.996859	4736	4813	0	41	77	0.5324675
NODE_208_length_4875_cov_8.996859	4736	4813	2	36	77	0.4675325
NODE_211_length_4827_cov_15.364636	1803	1865	1	25	62	0.4032258
NODE_211_length_4827_cov_15.364636	1803	1865	2	11	62	0.1774193
NODE_211_length_4827_cov_15.364636	1803	1865	5	26	62	0.4193548
NODE_211_length_4827_cov_15.364636	1899	1979	2	42	80	0.5250000
NODE_211_length_4827_cov_15.364636	1899	1979	6	38	80	0.4750000
NODE_211_length_4827_cov_15.364636	1952	1996	5	14	44	0.3181818
NODE_211_length_4827_cov_15.364636	1952	1996	6	30	44	0.6818182
NODE_212_length_4821_cov_10.856840	999	1061	3	13	62	0.2096774
NODE_212_length_4821_cov_10.856840	999	1061	4	42	62	0.6774194
NODE_212_length_4821_cov_10.856840	999	1061	5	7	62	0.1129032
NODE_213_length_4819_cov_16.363347	2392	2461	11	69	69	1.0000000
NODE_217_length_4794_cov_14.912886	657	737	4	4	80	0.0500000
NODE_217_length_4794_cov_14.912886	657	737	6	12	80	0.1500000
NODE_217_length_4794_cov_14.912886	657	737	8	1	80	0.0125000
NODE_217_length_4794_cov_14.912886	657	737	10	14	80	0.1750000
NODE_217_length_4794_cov_14.912886	657	737	12	4	80	0.0500000
NODE_217_length_4794_cov_14.912886	657	737	13	27	80	0.3375000
NODE_217_length_4794_cov_14.912886	657	737	15	1	80	0.0125000
NODE_217_length_4794_cov_14.912886	657	737	16	15	80	0.1875000
NODE_217_length_4794_cov_14.912886	657	737	18	2	80	0.0250000
NODE_217_length_4794_cov_14.912886	4240	4312	13	20	72	0.2777778
NODE_217_length_4794_cov_14.912886	4240	4312	14	52	72	0.7222222
NODE_217_length_4794_cov_14.912886	4293	4312	14	19	19	1.0000000
NODE_217_length_4794_cov_14.912886	4345	4408	1	35	63	0.5555556
NODE_217_length_4794_cov_14.912886	4345	4408	10	2	63	0.0317460
NODE_217_length_4794_cov_14.912886	4345	4408	12	26	63	0.4126984
NODE_218_length_4791_cov_16.126172	2438	2518	0	80	80	1.0000000
NODE_218_length_4791_cov_16.126172	2491	2571	0	80	80	1.0000000
NODE_218_length_4791_cov_16.126172	2567	2647	0	80	80	1.0000000
NODE_218_length_4791_cov_16.126172	2620	2700	0	80	80	1.0000000
NODE_218_length_4791_cov_16.126172	4607	4687	0	80	80	1.0000000
NODE_219_length_4790_cov_9.713494	2159	2239	12	3	80	0.0375000
NODE_219_length_4790_cov_9.713494	2159	2239	13	12	80	0.1500000
NODE_219_length_4790_cov_9.713494	2159	2239	14	48	80	0.6000000
NODE_219_length_4790_cov_9.713494	2159	2239	15	17	80	0.2125000
NODE_219_length_4790_cov_9.713494	4273	4353	0	80	80	1.0000000
NODE_219_length_4790_cov_9.713494	4273	4335	0	62	62	1.0000000
NODE_219_length_4790_cov_9.713494	4326	4406	0	80	80	1.0000000
NODE_221_length_4772_cov_10.560454	4281	4367	6	60	86	0.6976744
NODE_221_length_4772_cov_10.560454	4281	4367	8	26	86	0.3023256
NODE_222_length_4770_cov_106.953543	2778	2858	31	2	80	0.0250000
NODE_222_length_4770_cov_106.953543	2778	2858	32	1	80	0.0125000
NODE_222_length_4770_cov_106.953543	2778	2858	33	2	80	0.0250000
NODE_222_length_4770_cov_106.953543	2778	2858	34	7	80	0.0875000
NODE_222_length_4770_cov_106.953543	2778	2858	35	3	80	0.0375000
NODE_222_length_4770_cov_106.953543	2778	2858	36	3	80	0.0375000
NODE_222_length_4770_cov_106.953543	2778	2858	37	3	80	0.0375000
NODE_222_length_4770_cov_106.953543	2778	2858	38	1	80	0.0125000
NODE_222_length_4770_cov_106.953543	2778	2858	40	2	80	0.0250000
NODE_222_length_4770_cov_106.953543	2778	2858	41	11	80	0.1375000
NODE_222_length_4770_cov_106.953543	2778	2858	42	20	80	0.2500000
NODE_222_length_4770_cov_106.953543	2778	2858	43	8	80	0.1000000
NODE_222_length_4770_cov_106.953543	2778	2858	44	5	80	0.0625000
NODE_222_length_4770_cov_106.953543	2778	2858	45	5	80	0.0625000
NODE_222_length_4770_cov_106.953543	2778	2858	46	7	80	0.0875000
NODE_222_length_4770_cov_106.953543	2831	2911	41	4	80	0.0500000
NODE_222_length_4770_cov_106.953543	2831	2911	42	5	80	0.0625000
NODE_222_length_4770_cov_106.953543	2831	2911	43	14	80	0.1750000
NODE_222_length_4770_cov_106.953543	2831	2911	44	8	80	0.1000000
NODE_222_length_4770_cov_106.953543	2831	2911	45	10	80	0.1250000
NODE_222_length_4770_cov_106.953543	2831	2911	46	8	80	0.1000000
NODE_222_length_4770_cov_106.953543	2831	2911	47	1	80	0.0125000
NODE_222_length_4770_cov_106.953543	2831	2911	49	3	80	0.0375000
NODE_222_length_4770_cov_106.953543	2831	2911	50	1	80	0.0125000
NODE_222_length_4770_cov_106.953543	2831	2911	52	1	80	0.0125000
NODE_222_length_4770_cov_106.953543	2831	2911	56	5	80	0.0625000
NODE_222_length_4770_cov_106.953543	2831	2911	57	4	80	0.0500000
NODE_222_length_4770_cov_106.953543	2831	2911	58	5	80	0.0625000
NODE_222_length_4770_cov_106.953543	2831	2911	59	5	80	0.0625000
NODE_222_length_4770_cov_106.953543	2831	2911	60	5	80	0.0625000
NODE_222_length_4770_cov_106.953543	2831	2911	61	1	80	0.0125000
NODE_222_length_4770_cov_106.953543	2907	2987	57	2	80	0.0250000
NODE_222_length_4770_cov_106.953543	2907	2987	58	3	80	0.0375000
NODE_222_length_4770_cov_106.953543	2907	2987	62	8	80	0.1000000
NODE_222_length_4770_cov_106.953543	2907	2987	63	1	80	0.0125000
NODE_222_length_4770_cov_106.953543	2907	2987	64	1	80	0.0125000
NODE_222_length_4770_cov_106.953543	2907	2987	65	2	80	0.0250000
NODE_222_length_4770_cov_106.953543	2907	2987	67	1	80	0.0125000
NODE_222_length_4770_cov_106.953543	2907	2987	69	2	80	0.0250000
NODE_222_length_4770_cov_106.953543	2907	2987	71	1	80	0.0125000
NODE_222_length_4770_cov_106.953543	2907	2987	73	1	80	0.0125000
NODE_222_length_4770_cov_106.953543	2907	2987	74	3	80	0.0375000
NODE_222_length_4770_cov_106.953543	2907	2987	77	1	80	0.0125000
NODE_222_length_4770_cov_106.953543	2907	2987	78	2	80	0.0250000
NODE_222_length_4770_cov_106.953543	2907	2987	79	2	80	0.0250000
NODE_222_length_4770_cov_106.953543	2907	2987	84	1	80	0.0125000
NODE_222_length_4770_cov_106.953543	2907	2987	85	1	80	0.0125000
NODE_222_length_4770_cov_106.953543	2907	2987	86	3	80	0.0375000
NODE_222_length_4770_cov_106.953543	2907	2987	87	9	80	0.1125000
NODE_222_length_4770_cov_106.953543	2907	2987	88	2	80	0.0250000
NODE_222_length_4770_cov_106.953543	2907	2987	89	1	80	0.0125000
NODE_222_length_4770_cov_106.953543	2907	2987	90	2	80	0.0250000
NODE_222_length_4770_cov_106.953543	2907	2987	91	3	80	0.0375000
NODE_222_length_4770_cov_106.953543	2907	2987	92	6	80	0.0750000
NODE_222_length_4770_cov_106.953543	2907	2987	93	1	80	0.0125000
NODE_222_length_4770_cov_106.953543	2907	2987	95	2	80	0.0250000
NODE_222_length_4770_cov_106.953543	2907	2987	96	4	80	0.0500000
NODE_222_length_4770_cov_106.953543	2907	2987	97	6	80	0.0750000
NODE_222_length_4770_cov_106.953543	2907	2987	98	3	80	0.0375000
NODE_222_length_4770_cov_106.953543	2907	2987	99	2	80	0.0250000
NODE_222_length_4770_cov_106.953543	2907	2987	102	4	80	0.0500000
NODE_222_length_4770_cov_106.953543	2960	3040	76	4	80	0.0500000
NODE_222_length_4770_cov_106.953543	2960	3040	81	1	80	0.0125000
NODE_222_length_4770_cov_106.953543	2960	3040	82	1	80	0.0125000
NODE_222_length_4770_cov_106.953543	2960	3040	83	3	80	0.0375000
NODE_222_length_4770_cov_106.953543	2960	3040	85	4	80	0.0500000
NODE_222_length_4770_cov_106.953543	2960	3040	86	3	80	0.0375000
NODE_222_length_4770_cov_106.953543	2960	3040	87	14	80	0.1750000
NODE_222_length_4770_cov_106.953543	2960	3040	88	11	80	0.1375000
NODE_222_length_4770_cov_106.953543	2960	3040	89	3	80	0.0375000
NODE_222_length_4770_cov_106.953543	2960	3040	90	8	80	0.1000000
NODE_222_length_4770_cov_106.953543	2960	3040	91	4	80	0.0500000
NODE_222_length_4770_cov_106.953543	2960	3040	92	8	80	0.1000000
NODE_222_length_4770_cov_106.953543	2960	3040	93	1	80	0.0125000
NODE_222_length_4770_cov_106.953543	2960	3040	95	2	80	0.0250000
NODE_222_length_4770_cov_106.953543	2960	3040	96	4	80	0.0500000
NODE_222_length_4770_cov_106.953543	2960	3040	97	1	80	0.0125000
NODE_222_length_4770_cov_106.953543	2960	3040	98	2	80	0.0250000
NODE_222_length_4770_cov_106.953543	2960	3040	99	2	80	0.0250000
NODE_222_length_4770_cov_106.953543	2960	3040	102	4	80	0.0500000
NODE_223_length_4768_cov_15.447205	1237	1317	7	15	80	0.1875000
NODE_223_length_4768_cov_15.447205	1237	1317	8	3	80	0.0375000
NODE_223_length_4768_cov_15.447205	1237	1317	10	13	80	0.1625000
NODE_223_length_4768_cov_15.447205	1237	1317	11	5	80	0.0625000
NODE_223_length_4768_cov_15.447205	1237	1317	12	20	80	0.2500000
NODE_223_length_4768_cov_15.447205	1237	1317	14	18	80	0.2250000
NODE_223_length_4768_cov_15.447205	1237	1317	15	6	80	0.0750000
NODE_228_length_4730_cov_30.142734	256	336	5	30	80	0.3750000
NODE_228_length_4730_cov_30.142734	256	336	6	12	80	0.1500000
NODE_228_length_4730_cov_30.142734	256	336	7	26	80	0.3250000
NODE_228_length_4730_cov_30.142734	256	336	8	12	80	0.1500000
NODE_228_length_4730_cov_30.142734	309	389	5	80	80	1.0000000
NODE_228_length_4730_cov_30.142734	4052	4132	2	16	80	0.2000000
NODE_228_length_4730_cov_30.142734	4052	4132	3	50	80	0.6250000
NODE_228_length_4730_cov_30.142734	4052	4132	4	14	80	0.1750000
NODE_228_length_4730_cov_30.142734	4105	4185	3	13	80	0.1625000
NODE_228_length_4730_cov_30.142734	4105	4185	4	18	80	0.2250000
NODE_228_length_4730_cov_30.142734	4105	4185	6	16	80	0.2000000
NODE_228_length_4730_cov_30.142734	4105	4185	7	33	80	0.4125000
NODE_231_length_4706_cov_25.522683	2181	2261	7	17	80	0.2125000
NODE_231_length_4706_cov_25.522683	2181	2261	8	7	80	0.0875000
NODE_231_length_4706_cov_25.522683	2181	2261	9	3	80	0.0375000
NODE_231_length_4706_cov_25.522683	2181	2261	11	9	80	0.1125000
NODE_231_length_4706_cov_25.522683	2181	2261	14	1	80	0.0125000
NODE_231_length_4706_cov_25.522683	2181	2261	15	3	80	0.0375000
NODE_231_length_4706_cov_25.522683	2181	2261	16	7	80	0.0875000
NODE_231_length_4706_cov_25.522683	2181	2261	17	12	80	0.1500000
NODE_231_length_4706_cov_25.522683	2181	2261	18	2	80	0.0250000
NODE_231_length_4706_cov_25.522683	2181	2261	20	12	80	0.1500000
NODE_231_length_4706_cov_25.522683	2181	2261	23	7	80	0.0875000
NODE_231_length_4706_cov_25.522683	2234	2288	0	2	54	0.0370370
NODE_231_length_4706_cov_25.522683	2234	2288	2	2	54	0.0370370
NODE_231_length_4706_cov_25.522683	2234	2288	3	2	54	0.0370370
NODE_231_length_4706_cov_25.522683	2234	2288	4	6	54	0.1111111
NODE_231_length_4706_cov_25.522683	2234	2288	7	32	54	0.5925926
NODE_231_length_4706_cov_25.522683	2234	2288	8	7	54	0.1296296
NODE_231_length_4706_cov_25.522683	2234	2288	9	3	54	0.0555556
NODE_231_length_4706_cov_25.522683	3943	4026	3	5	83	0.0602410
NODE_231_length_4706_cov_25.522683	3943	4026	4	1	83	0.0120482
NODE_231_length_4706_cov_25.522683	3943	4026	5	3	83	0.0361446
NODE_231_length_4706_cov_25.522683	3943	4026	6	4	83	0.0481928
NODE_231_length_4706_cov_25.522683	3943	4026	7	1	83	0.0120482
NODE_231_length_4706_cov_25.522683	3943	4026	8	2	83	0.0240964
NODE_231_length_4706_cov_25.522683	3943	4026	9	3	83	0.0361446
NODE_231_length_4706_cov_25.522683	3943	4026	10	15	83	0.1807229
NODE_231_length_4706_cov_25.522683	3943	4026	11	37	83	0.4457831
NODE_231_length_4706_cov_25.522683	3943	4026	13	12	83	0.1445783
NODE_235_length_4693_cov_16.973008	374	454	3	7	80	0.0875000
NODE_235_length_4693_cov_16.973008	374	454	5	18	80	0.2250000
NODE_235_length_4693_cov_16.973008	374	454	7	25	80	0.3125000
NODE_235_length_4693_cov_16.973008	374	454	8	9	80	0.1125000
NODE_235_length_4693_cov_16.973008	374	454	9	21	80	0.2625000
NODE_235_length_4693_cov_16.973008	427	507	8	6	80	0.0750000
NODE_235_length_4693_cov_16.973008	427	507	9	25	80	0.3125000
NODE_235_length_4693_cov_16.973008	427	507	10	40	80	0.5000000
NODE_235_length_4693_cov_16.973008	427	507	11	9	80	0.1125000
NODE_240_length_4672_cov_39.029084	1391	1470	9	47	79	0.5949367
NODE_240_length_4672_cov_39.029084	1391	1470	11	32	79	0.4050633
NODE_240_length_4672_cov_39.029084	1444	1523	4	1	79	0.0126582
NODE_240_length_4672_cov_39.029084	1444	1523	6	1	79	0.0126582
NODE_240_length_4672_cov_39.029084	1444	1523	8	3	79	0.0379747
NODE_240_length_4672_cov_39.029084	1444	1523	9	9	79	0.1139240
NODE_240_length_4672_cov_39.029084	1444	1523	10	1	79	0.0126582
NODE_240_length_4672_cov_39.029084	1444	1523	11	64	79	0.8101266
NODE_246_length_4602_cov_17.281368	3106	3186	14	6	80	0.0750000
NODE_246_length_4602_cov_17.281368	3106	3186	16	9	80	0.1125000
NODE_246_length_4602_cov_17.281368	3106	3186	17	10	80	0.1250000
NODE_246_length_4602_cov_17.281368	3106	3186	18	5	80	0.0625000
NODE_246_length_4602_cov_17.281368	3106	3186	19	7	80	0.0875000
NODE_246_length_4602_cov_17.281368	3106	3186	20	25	80	0.3125000
NODE_246_length_4602_cov_17.281368	3106	3186	21	18	80	0.2250000
NODE_246_length_4602_cov_17.281368	3159	3239	12	1	80	0.0125000
NODE_246_length_4602_cov_17.281368	3159	3239	13	2	80	0.0250000
NODE_246_length_4602_cov_17.281368	3159	3239	14	20	80	0.2500000
NODE_246_length_4602_cov_17.281368	3159	3239	15	3	80	0.0375000
NODE_246_length_4602_cov_17.281368	3159	3239	16	18	80	0.2250000
NODE_246_length_4602_cov_17.281368	3159	3239	17	19	80	0.2375000
NODE_246_length_4602_cov_17.281368	3159	3239	19	7	80	0.0875000
NODE_246_length_4602_cov_17.281368	3159	3239	21	10	80	0.1250000
NODE_248_length_4587_cov_14.431150	1294	1370	11	1	76	0.0131579
NODE_248_length_4587_cov_14.431150	1294	1370	12	7	76	0.0921053
NODE_248_length_4587_cov_14.431150	1294	1370	14	27	76	0.3552631
NODE_248_length_4587_cov_14.431150	1294	1370	15	1	76	0.0131579
NODE_248_length_4587_cov_14.431150	1294	1370	16	1	76	0.0131579
NODE_248_length_4587_cov_14.431150	1294	1370	17	8	76	0.1052632
NODE_248_length_4587_cov_14.431150	1294	1370	18	3	76	0.0394737
NODE_248_length_4587_cov_14.431150	1294	1370	19	7	76	0.0921053
NODE_248_length_4587_cov_14.431150	1294	1370	20	20	76	0.2631579
NODE_248_length_4587_cov_14.431150	1294	1370	22	1	76	0.0131579
NODE_248_length_4587_cov_14.431150	1347	1427	19	2	80	0.0250000
NODE_248_length_4587_cov_14.431150	1347	1427	20	33	80	0.4125000
NODE_248_length_4587_cov_14.431150	1347	1427	21	9	80	0.1125000
NODE_248_length_4587_cov_14.431150	1347	1427	22	11	80	0.1375000
NODE_248_length_4587_cov_14.431150	1347	1427	23	7	80	0.0875000
NODE_248_length_4587_cov_14.431150	1347	1427	24	1	80	0.0125000
NODE_248_length_4587_cov_14.431150	1347	1427	25	1	80	0.0125000
NODE_248_length_4587_cov_14.431150	1347	1427	27	16	80	0.2000000
NODE_248_length_4587_cov_14.431150	1466	1533	12	2	67	0.0298507
NODE_248_length_4587_cov_14.431150	1466	1533	14	27	67	0.4029851
NODE_248_length_4587_cov_14.431150	1466	1533	15	8	67	0.1194030
NODE_248_length_4587_cov_14.431150	1466	1533	16	13	67	0.1940299
NODE_248_length_4587_cov_14.431150	1466	1533	17	10	67	0.1492537
NODE_248_length_4587_cov_14.431150	1466	1533	18	5	67	0.0746269
NODE_248_length_4587_cov_14.431150	1466	1533	20	2	67	0.0298507
NODE_248_length_4587_cov_14.431150	4316	4382	13	23	66	0.3484848
NODE_248_length_4587_cov_14.431150	4316	4382	15	24	66	0.3636364
NODE_248_length_4587_cov_14.431150	4316	4382	16	19	66	0.2878788
NODE_248_length_4587_cov_14.431150	4355	4435	5	6	80	0.0750000
NODE_248_length_4587_cov_14.431150	4355	4435	7	1	80	0.0125000
NODE_248_length_4587_cov_14.431150	4355	4435	8	22	80	0.2750000
NODE_248_length_4587_cov_14.431150	4355	4435	9	2	80	0.0250000
NODE_248_length_4587_cov_14.431150	4355	4435	10	4	80	0.0500000
NODE_248_length_4587_cov_14.431150	4355	4435	12	1	80	0.0125000
NODE_248_length_4587_cov_14.431150	4355	4435	14	4	80	0.0500000
NODE_248_length_4587_cov_14.431150	4355	4435	15	27	80	0.3375000
NODE_248_length_4587_cov_14.431150	4355	4435	16	13	80	0.1625000
NODE_249_length_4572_cov_50.244579	2406	2483	0	20	77	0.2597403
NODE_249_length_4572_cov_50.244579	2406	2483	1	1	77	0.0129870
NODE_249_length_4572_cov_50.244579	2406	2483	2	42	77	0.5454546
NODE_249_length_4572_cov_50.244579	2406	2483	4	14	77	0.1818182
NODE_249_length_4572_cov_50.244579	2406	2483	0	20	77	0.2597403
NODE_249_length_4572_cov_50.244579	2406	2483	1	1	77	0.0129870
NODE_249_length_4572_cov_50.244579	2406	2483	2	42	77	0.5454546
NODE_249_length_4572_cov_50.244579	2406	2483	4	14	77	0.1818182
NODE_251_length_4556_cov_14.556652	4229	4288	6	7	59	0.1186441
NODE_251_length_4556_cov_14.556652	4229	4288	7	12	59	0.2033898
NODE_251_length_4556_cov_14.556652	4229	4288	10	1	59	0.0169492
NODE_251_length_4556_cov_14.556652	4229	4288	11	4	59	0.0677966
NODE_251_length_4556_cov_14.556652	4229	4288	12	1	59	0.0169492
NODE_251_length_4556_cov_14.556652	4229	4288	13	1	59	0.0169492
NODE_251_length_4556_cov_14.556652	4229	4288	14	16	59	0.2711864
NODE_251_length_4556_cov_14.556652	4229	4288	15	10	59	0.1694915
NODE_251_length_4556_cov_14.556652	4229	4288	19	1	59	0.0169492
NODE_251_length_4556_cov_14.556652	4229	4288	20	1	59	0.0169492
NODE_251_length_4556_cov_14.556652	4229	4288	23	5	59	0.0847458
NODE_252_length_4550_cov_5.664120	3548	3628	4	2	80	0.0250000
NODE_252_length_4550_cov_5.664120	3548	3628	5	78	80	0.9750000
NODE_252_length_4550_cov_5.664120	3601	3681	3	22	80	0.2750000
NODE_252_length_4550_cov_5.664120	3601	3681	4	22	80	0.2750000
NODE_252_length_4550_cov_5.664120	3601	3681	5	36	80	0.4500000
NODE_253_length_4544_cov_10.690439	353	433	2	2	80	0.0250000
NODE_253_length_4544_cov_10.690439	353	433	3	32	80	0.4000000
NODE_253_length_4544_cov_10.690439	353	433	5	4	80	0.0500000
NODE_253_length_4544_cov_10.690439	353	433	6	42	80	0.5250000
NODE_253_length_4544_cov_10.690439	406	486	5	5	80	0.0625000
NODE_253_length_4544_cov_10.690439	406	486	6	56	80	0.7000000
NODE_253_length_4544_cov_10.690439	406	486	7	19	80	0.2375000
NODE_253_length_4544_cov_10.690439	4487	4544	0	57	57	1.0000000
NODE_255_length_4535_cov_24.849188	675	755	4	32	80	0.4000000
NODE_255_length_4535_cov_24.849188	675	755	5	48	80	0.6000000
NODE_255_length_4535_cov_24.849188	728	809	3	4	81	0.0493827
NODE_255_length_4535_cov_24.849188	728	809	4	49	81	0.6049383
NODE_255_length_4535_cov_24.849188	728	809	5	28	81	0.3456790
NODE_255_length_4535_cov_24.849188	1319	1399	3	51	80	0.6375000
NODE_255_length_4535_cov_24.849188	1319	1399	4	29	80	0.3625000
NODE_255_length_4535_cov_24.849188	1372	1452	2	3	80	0.0375000
NODE_255_length_4535_cov_24.849188	1372	1452	3	35	80	0.4375000
NODE_255_length_4535_cov_24.849188	1372	1452	4	28	80	0.3500000
NODE_255_length_4535_cov_24.849188	1372	1452	5	14	80	0.1750000
NODE_258_length_4528_cov_19.736509	4295	4366	0	17	71	0.2394366
NODE_258_length_4528_cov_19.736509	4295	4366	1	34	71	0.4788733
NODE_258_length_4528_cov_19.736509	4295	4366	2	18	71	0.2535211
NODE_258_length_4528_cov_19.736509	4295	4366	3	2	71	0.0281690
NODE_259_length_4505_cov_10.409215	3166	3202	8	12	36	0.3333333
NODE_259_length_4505_cov_10.409215	3166	3202	9	12	36	0.3333333
NODE_259_length_4505_cov_10.409215	3166	3202	14	4	36	0.1111111
NODE_259_length_4505_cov_10.409215	3166	3202	15	8	36	0.2222222
NODE_259_length_4505_cov_10.409215	3175	3255	8	3	80	0.0375000
NODE_259_length_4505_cov_10.409215	3175	3255	9	12	80	0.1500000
NODE_259_length_4505_cov_10.409215	3175	3255	11	25	80	0.3125000
NODE_259_length_4505_cov_10.409215	3175	3255	12	8	80	0.1000000
NODE_259_length_4505_cov_10.409215	3175	3255	14	18	80	0.2250000
NODE_259_length_4505_cov_10.409215	3175	3255	15	14	80	0.1750000
NODE_260_length_4498_cov_8.216185	3161	3219	0	58	58	1.0000000
NODE_260_length_4498_cov_8.216185	4257	4314	0	57	57	1.0000000
NODE_263_length_4476_cov_29.825451	141	215	0	18	74	0.2432432
NODE_263_length_4476_cov_29.825451	141	215	1	13	74	0.1756757
NODE_263_length_4476_cov_29.825451	141	215	2	43	74	0.5810811
NODE_263_length_4476_cov_29.825451	1890	1970	6	29	80	0.3625000
NODE_263_length_4476_cov_29.825451	1890	1970	7	4	80	0.0500000
NODE_263_length_4476_cov_29.825451	1890	1970	8	15	80	0.1875000
NODE_263_length_4476_cov_29.825451	1890	1970	9	12	80	0.1500000
NODE_263_length_4476_cov_29.825451	1890	1970	10	20	80	0.2500000
NODE_263_length_4476_cov_29.825451	1943	2023	6	3	80	0.0375000
NODE_263_length_4476_cov_29.825451	1943	2023	7	51	80	0.6375000
NODE_263_length_4476_cov_29.825451	1943	2023	8	2	80	0.0250000
NODE_263_length_4476_cov_29.825451	1943	2023	9	4	80	0.0500000
NODE_263_length_4476_cov_29.825451	1943	2023	10	20	80	0.2500000
NODE_264_length_4474_cov_17.051886	23	99	0	76	76	1.0000000
NODE_264_length_4474_cov_17.051886	23	98	0	75	75	1.0000000
NODE_264_length_4474_cov_17.051886	23	99	0	76	76	1.0000000
NODE_264_length_4474_cov_17.051886	32	99	0	67	67	1.0000000
NODE_264_length_4474_cov_17.051886	76	140	0	64	64	1.0000000
NODE_264_length_4474_cov_17.051886	1528	1569	4	7	41	0.1707317
NODE_264_length_4474_cov_17.051886	1528	1569	5	1	41	0.0243902
NODE_264_length_4474_cov_17.051886	1528	1569	6	33	41	0.8048781
NODE_264_length_4474_cov_17.051886	1536	1609	2	34	73	0.4657534
NODE_264_length_4474_cov_17.051886	1536	1609	4	13	73	0.1780822
NODE_264_length_4474_cov_17.051886	1536	1609	5	1	73	0.0136986
NODE_264_length_4474_cov_17.051886	1536	1609	6	25	73	0.3424658
NODE_264_length_4474_cov_17.051886	1618	1643	5	20	25	0.8000000
NODE_264_length_4474_cov_17.051886	1618	1643	6	2	25	0.0800000
NODE_264_length_4474_cov_17.051886	1618	1643	7	3	25	0.1200000
NODE_264_length_4474_cov_17.051886	1618	1696	5	40	78	0.5128205
NODE_264_length_4474_cov_17.051886	1618	1696	6	13	78	0.1666667
NODE_264_length_4474_cov_17.051886	1618	1696	7	25	78	0.3205128
NODE_265_length_4474_cov_14.441829	282	362	2	22	80	0.2750000
NODE_265_length_4474_cov_14.441829	282	362	3	19	80	0.2375000
NODE_265_length_4474_cov_14.441829	282	362	5	28	80	0.3500000
NODE_265_length_4474_cov_14.441829	282	362	7	11	80	0.1375000
NODE_265_length_4474_cov_14.441829	335	415	0	18	80	0.2250000
NODE_265_length_4474_cov_14.441829	335	415	2	55	80	0.6875000
NODE_265_length_4474_cov_14.441829	335	415	3	7	80	0.0875000
NODE_265_length_4474_cov_14.441829	1522	1575	5	16	53	0.3018868
NODE_265_length_4474_cov_14.441829	1522	1575	6	31	53	0.5849057
NODE_265_length_4474_cov_14.441829	1522	1575	9	6	53	0.1132075
NODE_265_length_4474_cov_14.441829	1548	1623	6	21	75	0.2800000
NODE_265_length_4474_cov_14.441829	1548	1623	9	54	75	0.7200000
NODE_265_length_4474_cov_14.441829	3068	3121	2	11	53	0.2075472
NODE_265_length_4474_cov_14.441829	3068	3121	4	42	53	0.7924528
NODE_268_length_4463_cov_7.023144	119	168	0	49	49	1.0000000
NODE_270_length_4453_cov_16.820395	3383	3463	9	23	80	0.2875000
NODE_270_length_4453_cov_16.820395	3383	3463	10	17	80	0.2125000
NODE_270_length_4453_cov_16.820395	3383	3463	11	25	80	0.3125000
NODE_270_length_4453_cov_16.820395	3383	3463	12	1	80	0.0125000
NODE_270_length_4453_cov_16.820395	3383	3463	13	3	80	0.0375000
NODE_270_length_4453_cov_16.820395	3383	3463	14	1	80	0.0125000
NODE_270_length_4453_cov_16.820395	3383	3463	15	10	80	0.1250000
NODE_270_length_4453_cov_16.820395	3436	3496	4	5	60	0.0833333
NODE_270_length_4453_cov_16.820395	3436	3496	5	9	60	0.1500000
NODE_270_length_4453_cov_16.820395	3436	3496	6	8	60	0.1333333
NODE_270_length_4453_cov_16.820395	3436	3496	8	1	60	0.0166667
NODE_270_length_4453_cov_16.820395	3436	3496	9	33	60	0.5500000
NODE_270_length_4453_cov_16.820395	3436	3496	10	4	60	0.0666667
NODE_272_length_4436_cov_31.114595	2807	2871	0	64	64	1.0000000
NODE_272_length_4436_cov_31.114595	2846	2906	0	60	60	1.0000000
NODE_272_length_4436_cov_31.114595	2846	2898	0	52	52	1.0000000
NODE_278_length_4391_cov_7.711323	66	141	0	75	75	1.0000000
NODE_278_length_4391_cov_7.711323	119	155	0	36	36	1.0000000
NODE_279_length_4385_cov_6.067662	1556	1606	0	50	50	1.0000000
NODE_286_length_4331_cov_37.938800	1898	1978	33	1	80	0.0125000
NODE_286_length_4331_cov_37.938800	1898	1978	34	4	80	0.0500000
NODE_286_length_4331_cov_37.938800	1898	1978	35	14	80	0.1750000
NODE_286_length_4331_cov_37.938800	1898	1978	36	18	80	0.2250000
NODE_286_length_4331_cov_37.938800	1898	1978	37	13	80	0.1625000
NODE_286_length_4331_cov_37.938800	1898	1978	38	2	80	0.0250000
NODE_286_length_4331_cov_37.938800	1898	1978	40	6	80	0.0750000
NODE_286_length_4331_cov_37.938800	1898	1978	41	2	80	0.0250000
NODE_286_length_4331_cov_37.938800	1898	1978	42	4	80	0.0500000
NODE_286_length_4331_cov_37.938800	1898	1978	47	2	80	0.0250000
NODE_286_length_4331_cov_37.938800	1898	1978	50	1	80	0.0125000
NODE_286_length_4331_cov_37.938800	1898	1978	51	3	80	0.0375000
NODE_286_length_4331_cov_37.938800	1898	1978	53	10	80	0.1250000
NODE_286_length_4331_cov_37.938800	1951	2031	40	5	80	0.0625000
NODE_286_length_4331_cov_37.938800	1951	2031	41	2	80	0.0250000
NODE_286_length_4331_cov_37.938800	1951	2031	42	4	80	0.0500000
NODE_286_length_4331_cov_37.938800	1951	2031	47	2	80	0.0250000
NODE_286_length_4331_cov_37.938800	1951	2031	50	1	80	0.0125000
NODE_286_length_4331_cov_37.938800	1951	2031	51	3	80	0.0375000
NODE_286_length_4331_cov_37.938800	1951	2031	53	13	80	0.1625000
NODE_286_length_4331_cov_37.938800	1951	2031	54	5	80	0.0625000
NODE_286_length_4331_cov_37.938800	1951	2031	55	4	80	0.0500000
NODE_286_length_4331_cov_37.938800	1951	2031	56	8	80	0.1000000
NODE_286_length_4331_cov_37.938800	1951	2031	57	5	80	0.0625000
NODE_286_length_4331_cov_37.938800	1951	2031	58	1	80	0.0125000
NODE_286_length_4331_cov_37.938800	1951	2031	59	1	80	0.0125000
NODE_286_length_4331_cov_37.938800	1951	2031	61	1	80	0.0125000
NODE_286_length_4331_cov_37.938800	1951	2031	62	7	80	0.0875000
NODE_286_length_4331_cov_37.938800	1951	2031	63	2	80	0.0250000
NODE_286_length_4331_cov_37.938800	1951	2031	65	4	80	0.0500000
NODE_286_length_4331_cov_37.938800	1951	2031	69	2	80	0.0250000
NODE_286_length_4331_cov_37.938800	1951	2031	70	1	80	0.0125000
NODE_286_length_4331_cov_37.938800	1951	2031	71	5	80	0.0625000
NODE_286_length_4331_cov_37.938800	1951	2031	73	1	80	0.0125000
NODE_286_length_4331_cov_37.938800	1951	2031	74	3	80	0.0375000
NODE_286_length_4331_cov_37.938800	2027	2107	58	1	80	0.0125000
NODE_286_length_4331_cov_37.938800	2027	2107	59	5	80	0.0625000
NODE_286_length_4331_cov_37.938800	2027	2107	60	1	80	0.0125000
NODE_286_length_4331_cov_37.938800	2027	2107	62	14	80	0.1750000
NODE_286_length_4331_cov_37.938800	2027	2107	63	13	80	0.1625000
NODE_286_length_4331_cov_37.938800	2027	2107	64	7	80	0.0875000
NODE_286_length_4331_cov_37.938800	2027	2107	65	7	80	0.0875000
NODE_286_length_4331_cov_37.938800	2027	2107	66	7	80	0.0875000
NODE_286_length_4331_cov_37.938800	2027	2107	67	6	80	0.0750000
NODE_286_length_4331_cov_37.938800	2027	2107	68	4	80	0.0500000
NODE_286_length_4331_cov_37.938800	2027	2107	69	2	80	0.0250000
NODE_286_length_4331_cov_37.938800	2027	2107	70	3	80	0.0375000
NODE_286_length_4331_cov_37.938800	2027	2107	71	8	80	0.1000000
NODE_286_length_4331_cov_37.938800	2027	2107	73	2	80	0.0250000
NODE_286_length_4331_cov_37.938800	2080	2160	40	4	80	0.0500000
NODE_286_length_4331_cov_37.938800	2080	2160	43	1	80	0.0125000
NODE_286_length_4331_cov_37.938800	2080	2160	44	2	80	0.0250000
NODE_286_length_4331_cov_37.938800	2080	2160	47	2	80	0.0250000
NODE_286_length_4331_cov_37.938800	2080	2160	48	5	80	0.0625000
NODE_286_length_4331_cov_37.938800	2080	2160	49	20	80	0.2500000
NODE_286_length_4331_cov_37.938800	2080	2160	50	10	80	0.1250000
NODE_286_length_4331_cov_37.938800	2080	2160	51	2	80	0.0250000
NODE_286_length_4331_cov_37.938800	2080	2160	52	1	80	0.0125000
NODE_286_length_4331_cov_37.938800	2080	2160	53	1	80	0.0125000
NODE_286_length_4331_cov_37.938800	2080	2160	57	5	80	0.0625000
NODE_286_length_4331_cov_37.938800	2080	2160	58	1	80	0.0125000
NODE_286_length_4331_cov_37.938800	2080	2160	59	5	80	0.0625000
NODE_286_length_4331_cov_37.938800	2080	2160	60	1	80	0.0125000
NODE_286_length_4331_cov_37.938800	2080	2160	62	13	80	0.1625000
NODE_286_length_4331_cov_37.938800	2080	2160	63	5	80	0.0625000
NODE_286_length_4331_cov_37.938800	2080	2160	64	2	80	0.0250000
NODE_289_length_4320_cov_7.680881	442	522	5	13	80	0.1625000
NODE_289_length_4320_cov_7.680881	442	522	6	34	80	0.4250000
NODE_289_length_4320_cov_7.680881	442	522	7	30	80	0.3750000
NODE_289_length_4320_cov_7.680881	442	522	8	3	80	0.0375000
NODE_289_length_4320_cov_7.680881	495	575	4	12	80	0.1500000
NODE_289_length_4320_cov_7.680881	495	575	5	23	80	0.2875000
NODE_289_length_4320_cov_7.680881	495	575	6	45	80	0.5625000
NODE_289_length_4320_cov_7.680881	571	651	1	7	80	0.0875000
NODE_289_length_4320_cov_7.680881	571	651	2	27	80	0.3375000
NODE_289_length_4320_cov_7.680881	571	651	3	24	80	0.3000000
NODE_289_length_4320_cov_7.680881	571	651	4	22	80	0.2750000
NODE_289_length_4320_cov_7.680881	624	704	0	5	80	0.0625000
NODE_289_length_4320_cov_7.680881	624	704	1	55	80	0.6875000
NODE_289_length_4320_cov_7.680881	624	704	2	20	80	0.2500000
NODE_290_length_4314_cov_5.311507	1436	1516	0	80	80	1.0000000
NODE_290_length_4314_cov_5.311507	1489	1569	0	80	80	1.0000000
NODE_290_length_4314_cov_5.311507	3331	3400	5	15	69	0.2173913
NODE_290_length_4314_cov_5.311507	3331	3400	6	39	69	0.5652174
NODE_290_length_4314_cov_5.311507	3331	3400	7	15	69	0.2173913
NODE_290_length_4314_cov_5.311507	3420	3482	9	1	62	0.0161290
NODE_290_length_4314_cov_5.311507	3420	3482	10	22	62	0.3548387
NODE_290_length_4314_cov_5.311507	3420	3482	12	3	62	0.0483871
NODE_290_length_4314_cov_5.311507	3420	3482	13	1	62	0.0161290
NODE_290_length_4314_cov_5.311507	3420	3482	14	12	62	0.1935484
NODE_290_length_4314_cov_5.311507	3420	3482	16	23	62	0.3709677
NODE_292_length_4311_cov_8.733381	92	171	1	21	79	0.2658228
NODE_292_length_4311_cov_8.733381	92	171	2	12	79	0.1518987
NODE_292_length_4311_cov_8.733381	92	171	3	46	79	0.5822785
NODE_292_length_4311_cov_8.733381	1925	2005	3	80	80	1.0000000
NODE_292_length_4311_cov_8.733381	1978	2058	0	9	80	0.1125000
NODE_292_length_4311_cov_8.733381	1978	2058	1	35	80	0.4375000
NODE_292_length_4311_cov_8.733381	1978	2058	3	36	80	0.4500000
NODE_294_length_4293_cov_3.809251	244	326	0	82	82	1.0000000
NODE_294_length_4293_cov_3.809251	301	394	0	93	93	1.0000000
NODE_295_length_4284_cov_15.940263	3726	3806	27	10	80	0.1250000
NODE_295_length_4284_cov_15.940263	3726	3806	28	1	80	0.0125000
NODE_295_length_4284_cov_15.940263	3726	3806	30	5	80	0.0625000
NODE_295_length_4284_cov_15.940263	3726	3806	31	2	80	0.0250000
NODE_295_length_4284_cov_15.940263	3726	3806	33	25	80	0.3125000
NODE_295_length_4284_cov_15.940263	3726	3806	34	5	80	0.0625000
NODE_295_length_4284_cov_15.940263	3726	3806	35	23	80	0.2875000
NODE_295_length_4284_cov_15.940263	3726	3806	36	9	80	0.1125000
NODE_295_length_4284_cov_15.940263	3779	3858	10	10	79	0.1265823
NODE_295_length_4284_cov_15.940263	3779	3858	11	11	79	0.1392405
NODE_295_length_4284_cov_15.940263	3779	3858	13	9	79	0.1139240
NODE_295_length_4284_cov_15.940263	3779	3858	14	2	79	0.0253165
NODE_295_length_4284_cov_15.940263	3779	3858	26	15	79	0.1898734
NODE_295_length_4284_cov_15.940263	3779	3858	27	15	79	0.1898734
NODE_295_length_4284_cov_15.940263	3779	3858	28	1	79	0.0126582
NODE_295_length_4284_cov_15.940263	3779	3858	33	5	79	0.0632911
NODE_295_length_4284_cov_15.940263	3779	3858	35	2	79	0.0253165
NODE_295_length_4284_cov_15.940263	3779	3858	36	9	79	0.1139240
NODE_299_length_4277_cov_5.451173	3818	3898	0	80	80	1.0000000
NODE_299_length_4277_cov_5.451173	3927	3995	0	68	68	1.0000000
NODE_299_length_4277_cov_5.451173	3968	4048	0	80	80	1.0000000
NODE_300_length_4274_cov_18.943234	591	671	7	5	80	0.0625000
NODE_300_length_4274_cov_18.943234	591	671	8	9	80	0.1125000
NODE_300_length_4274_cov_18.943234	591	671	10	12	80	0.1500000
NODE_300_length_4274_cov_18.943234	591	671	19	4	80	0.0500000
NODE_300_length_4274_cov_18.943234	591	671	20	37	80	0.4625000
NODE_300_length_4274_cov_18.943234	591	671	22	13	80	0.1625000
NODE_300_length_4274_cov_18.943234	644	724	14	10	80	0.1250000
NODE_300_length_4274_cov_18.943234	644	724	18	1	80	0.0125000
NODE_300_length_4274_cov_18.943234	644	724	19	21	80	0.2625000
NODE_300_length_4274_cov_18.943234	644	724	20	36	80	0.4500000
NODE_300_length_4274_cov_18.943234	644	724	22	12	80	0.1500000
NODE_301_length_4274_cov_16.160958	416	496	5	10	80	0.1250000
NODE_301_length_4274_cov_16.160958	416	496	7	70	80	0.8750000
NODE_301_length_4274_cov_16.160958	1034	1114	14	4	80	0.0500000
NODE_301_length_4274_cov_16.160958	1034	1114	16	7	80	0.0875000
NODE_301_length_4274_cov_16.160958	1034	1114	17	45	80	0.5625000
NODE_301_length_4274_cov_16.160958	1034	1114	18	24	80	0.3000000
NODE_301_length_4274_cov_16.160958	1087	1167	13	7	80	0.0875000
NODE_301_length_4274_cov_16.160958	1087	1167	15	19	80	0.2375000
NODE_301_length_4274_cov_16.160958	1087	1167	16	25	80	0.3125000
NODE_301_length_4274_cov_16.160958	1087	1167	17	29	80	0.3625000
NODE_301_length_4274_cov_16.160958	1163	1243	2	33	80	0.4125000
NODE_301_length_4274_cov_16.160958	1163	1243	3	28	80	0.3500000
NODE_301_length_4274_cov_16.160958	1163	1243	9	2	80	0.0250000
NODE_301_length_4274_cov_16.160958	1163	1243	11	2	80	0.0250000
NODE_301_length_4274_cov_16.160958	1163	1243	12	4	80	0.0500000
NODE_301_length_4274_cov_16.160958	1163	1243	13	11	80	0.1375000
NODE_301_length_4274_cov_16.160958	1216	1296	1	9	80	0.1125000
NODE_301_length_4274_cov_16.160958	1216	1296	2	71	80	0.8875000
NODE_301_length_4274_cov_16.160958	3411	3491	5	5	80	0.0625000
NODE_301_length_4274_cov_16.160958	3411	3491	6	17	80	0.2125000
NODE_301_length_4274_cov_16.160958	3411	3491	7	8	80	0.1000000
NODE_301_length_4274_cov_16.160958	3411	3491	9	37	80	0.4625000
NODE_301_length_4274_cov_16.160958	3411	3491	10	13	80	0.1625000
NODE_302_length_4270_cov_14.045792	3835	3915	17	2	80	0.0250000
NODE_302_length_4270_cov_14.045792	3835	3915	19	5	80	0.0625000
NODE_302_length_4270_cov_14.045792	3835	3915	20	26	80	0.3250000
NODE_302_length_4270_cov_14.045792	3835	3915	21	17	80	0.2125000
NODE_302_length_4270_cov_14.045792	3835	3915	22	26	80	0.3250000
NODE_302_length_4270_cov_14.045792	3835	3915	23	4	80	0.0500000
NODE_302_length_4270_cov_14.045792	3888	3968	7	10	80	0.1250000
NODE_302_length_4270_cov_14.045792	3888	3968	8	13	80	0.1625000
NODE_302_length_4270_cov_14.045792	3888	3968	9	6	80	0.0750000
NODE_302_length_4270_cov_14.045792	3888	3968	11	20	80	0.2500000
NODE_302_length_4270_cov_14.045792	3888	3968	14	1	80	0.0125000
NODE_302_length_4270_cov_14.045792	3888	3968	15	3	80	0.0375000
NODE_302_length_4270_cov_14.045792	3888	3968	17	2	80	0.0250000
NODE_302_length_4270_cov_14.045792	3888	3968	19	5	80	0.0625000
NODE_302_length_4270_cov_14.045792	3888	3968	20	9	80	0.1125000
NODE_302_length_4270_cov_14.045792	3888	3968	21	11	80	0.1375000
NODE_303_length_4260_cov_24.780822	244	311	0	67	67	1.0000000
NODE_303_length_4260_cov_24.780822	244	311	0	67	67	1.0000000
NODE_303_length_4260_cov_24.780822	263	311	0	48	48	1.0000000
NODE_303_length_4260_cov_24.780822	1605	1633	0	26	28	0.9285714
NODE_303_length_4260_cov_24.780822	1605	1633	1	1	28	0.0357143
NODE_303_length_4260_cov_24.780822	1605	1633	2	1	28	0.0357143
NODE_303_length_4260_cov_24.780822	1660	1699	0	39	39	1.0000000
NODE_310_length_4207_cov_6.923564	3664	3722	6	24	58	0.4137931
NODE_310_length_4207_cov_6.923564	3664	3722	8	34	58	0.5862069
NODE_310_length_4207_cov_6.923564	3695	3775	6	8	80	0.1000000
NODE_310_length_4207_cov_6.923564	3695	3775	7	17	80	0.2125000
NODE_310_length_4207_cov_6.923564	3695	3775	8	44	80	0.5500000
NODE_310_length_4207_cov_6.923564	3695	3775	9	11	80	0.1375000
NODE_311_length_4205_cov_6.121042	592	632	5	23	40	0.5750000
NODE_311_length_4205_cov_6.121042	592	632	6	6	40	0.1500000
NODE_311_length_4205_cov_6.121042	592	632	7	11	40	0.2750000
NODE_311_length_4205_cov_6.121042	605	685	5	59	80	0.7375000
NODE_311_length_4205_cov_6.121042	605	685	6	6	80	0.0750000
NODE_311_length_4205_cov_6.121042	605	685	7	15	80	0.1875000
NODE_311_length_4205_cov_6.121042	681	745	3	14	64	0.2187500
NODE_311_length_4205_cov_6.121042	681	745	5	50	64	0.7812500
NODE_312_length_4196_cov_4.170857	340	420	0	80	80	1.0000000
NODE_312_length_4196_cov_4.170857	393	473	0	80	80	1.0000000
NODE_316_length_4179_cov_6.655882	1	65	0	64	64	1.0000000
NODE_316_length_4179_cov_6.655882	1087	1140	0	6	53	0.1132075
NODE_316_length_4179_cov_6.655882	1087	1140	1	36	53	0.6792453
NODE_316_length_4179_cov_6.655882	1087	1140	2	11	53	0.2075472
NODE_316_length_4179_cov_6.655882	1818	1898	0	80	80	1.0000000
NODE_319_length_4150_cov_10.600099	2827	2849	7	3	22	0.1363636
NODE_319_length_4150_cov_10.600099	2827	2849	8	19	22	0.8636364
NODE_319_length_4150_cov_10.600099	2973	3053	11	4	80	0.0500000
NODE_319_length_4150_cov_10.600099	2973	3053	13	4	80	0.0500000
NODE_319_length_4150_cov_10.600099	2973	3053	14	18	80	0.2250000
NODE_319_length_4150_cov_10.600099	2973	3053	15	7	80	0.0875000
NODE_319_length_4150_cov_10.600099	2973	3053	17	2	80	0.0250000
NODE_319_length_4150_cov_10.600099	2973	3053	18	7	80	0.0875000
NODE_319_length_4150_cov_10.600099	2973	3053	19	17	80	0.2125000
NODE_319_length_4150_cov_10.600099	2973	3053	20	21	80	0.2625000
NODE_319_length_4150_cov_10.600099	3026	3106	9	6	80	0.0750000
NODE_319_length_4150_cov_10.600099	3026	3106	11	22	80	0.2750000
NODE_319_length_4150_cov_10.600099	3026	3106	13	33	80	0.4125000
NODE_319_length_4150_cov_10.600099	3026	3106	14	6	80	0.0750000
NODE_319_length_4150_cov_10.600099	3026	3106	18	7	80	0.0875000
NODE_319_length_4150_cov_10.600099	3026	3106	20	6	80	0.0750000
NODE_324_length_4119_cov_27.984328	2818	2898	26	6	80	0.0750000
NODE_324_length_4119_cov_27.984328	2818	2898	27	1	80	0.0125000
NODE_324_length_4119_cov_27.984328	2818	2898	28	20	80	0.2500000
NODE_324_length_4119_cov_27.984328	2818	2898	29	6	80	0.0750000
NODE_324_length_4119_cov_27.984328	2818	2898	30	23	80	0.2875000
NODE_324_length_4119_cov_27.984328	2818	2898	31	7	80	0.0875000
NODE_324_length_4119_cov_27.984328	2818	2898	32	4	80	0.0500000
NODE_324_length_4119_cov_27.984328	2818	2898	33	5	80	0.0625000
NODE_324_length_4119_cov_27.984328	2818	2898	34	8	80	0.1000000
NODE_325_length_4108_cov_14.755550	378	422	2	44	44	1.0000000
NODE_325_length_4108_cov_14.755550	3537	3617	16	5	80	0.0625000
NODE_325_length_4108_cov_14.755550	3537	3617	17	14	80	0.1750000
NODE_325_length_4108_cov_14.755550	3537	3617	19	51	80	0.6375000
NODE_325_length_4108_cov_14.755550	3537	3617	20	10	80	0.1250000
NODE_325_length_4108_cov_14.755550	3590	3670	14	1	80	0.0125000
NODE_325_length_4108_cov_14.755550	3590	3670	15	2	80	0.0250000
NODE_325_length_4108_cov_14.755550	3590	3670	16	1	80	0.0125000
NODE_325_length_4108_cov_14.755550	3590	3670	17	25	80	0.3125000
NODE_325_length_4108_cov_14.755550	3590	3670	18	5	80	0.0625000
NODE_325_length_4108_cov_14.755550	3590	3670	19	41	80	0.5125000
NODE_325_length_4108_cov_14.755550	3590	3670	20	5	80	0.0625000
NODE_326_length_4107_cov_1.855539	207	287	0	80	80	1.0000000
NODE_328_length_4096_cov_31.197648	379	459	13	8	80	0.1000000
NODE_328_length_4096_cov_31.197648	379	459	14	2	80	0.0250000
NODE_328_length_4096_cov_31.197648	379	459	17	8	80	0.1000000
NODE_328_length_4096_cov_31.197648	379	459	18	1	80	0.0125000
NODE_328_length_4096_cov_31.197648	379	459	19	4	80	0.0500000
NODE_328_length_4096_cov_31.197648	379	459	20	2	80	0.0250000
NODE_328_length_4096_cov_31.197648	379	459	21	5	80	0.0625000
NODE_328_length_4096_cov_31.197648	379	459	22	15	80	0.1875000
NODE_328_length_4096_cov_31.197648	379	459	24	16	80	0.2000000
NODE_328_length_4096_cov_31.197648	379	459	25	1	80	0.0125000
NODE_328_length_4096_cov_31.197648	379	459	27	12	80	0.1500000
NODE_328_length_4096_cov_31.197648	379	459	29	6	80	0.0750000
NODE_328_length_4096_cov_31.197648	432	512	23	3	80	0.0375000
NODE_328_length_4096_cov_31.197648	432	512	24	9	80	0.1125000
NODE_328_length_4096_cov_31.197648	432	512	25	20	80	0.2500000
NODE_328_length_4096_cov_31.197648	432	512	26	21	80	0.2625000
NODE_328_length_4096_cov_31.197648	432	512	27	14	80	0.1750000
NODE_328_length_4096_cov_31.197648	432	512	28	7	80	0.0875000
NODE_328_length_4096_cov_31.197648	432	512	29	6	80	0.0750000
NODE_328_length_4096_cov_31.197648	3305	3385	0	80	80	1.0000000
NODE_328_length_4096_cov_31.197648	3358	3438	0	80	80	1.0000000
NODE_329_length_4081_cov_20.248870	3673	3753	1	8	80	0.1000000
NODE_329_length_4081_cov_20.248870	3673	3753	2	30	80	0.3750000
NODE_329_length_4081_cov_20.248870	3673	3753	3	16	80	0.2000000
NODE_329_length_4081_cov_20.248870	3673	3753	4	4	80	0.0500000
NODE_329_length_4081_cov_20.248870	3673	3753	5	22	80	0.2750000
NODE_329_length_4081_cov_20.248870	3726	3806	2	1	80	0.0125000
NODE_329_length_4081_cov_20.248870	3726	3806	4	4	80	0.0500000
NODE_329_length_4081_cov_20.248870	3726	3806	5	75	80	0.9375000
NODE_330_length_4076_cov_15.138044	1062	1142	4	48	80	0.6000000
NODE_330_length_4076_cov_15.138044	1062	1142	6	32	80	0.4000000
NODE_330_length_4076_cov_15.138044	1115	1195	2	26	80	0.3250000
NODE_330_length_4076_cov_15.138044	1115	1195	4	43	80	0.5375000
NODE_330_length_4076_cov_15.138044	1115	1195	6	11	80	0.1375000
NODE_331_length_4069_cov_14.261209	3871	3936	0	65	65	1.0000000
NODE_333_length_4050_cov_31.044039	1703	1783	35	10	80	0.1250000
NODE_333_length_4050_cov_31.044039	1703	1783	37	7	80	0.0875000
NODE_333_length_4050_cov_31.044039	1703	1783	38	8	80	0.1000000
NODE_333_length_4050_cov_31.044039	1703	1783	39	8	80	0.1000000
NODE_333_length_4050_cov_31.044039	1703	1783	40	1	80	0.0125000
NODE_333_length_4050_cov_31.044039	1703	1783	41	9	80	0.1125000
NODE_333_length_4050_cov_31.044039	1703	1783	42	13	80	0.1625000
NODE_333_length_4050_cov_31.044039	1703	1783	43	3	80	0.0375000
NODE_333_length_4050_cov_31.044039	1703	1783	44	2	80	0.0250000
NODE_333_length_4050_cov_31.044039	1703	1783	45	3	80	0.0375000
NODE_333_length_4050_cov_31.044039	1703	1783	46	4	80	0.0500000
NODE_333_length_4050_cov_31.044039	1703	1783	47	4	80	0.0500000
NODE_333_length_4050_cov_31.044039	1703	1783	51	2	80	0.0250000
NODE_333_length_4050_cov_31.044039	1703	1783	55	4	80	0.0500000
NODE_333_length_4050_cov_31.044039	1703	1783	56	2	80	0.0250000
NODE_335_length_4021_cov_34.619072	379	459	9	5	80	0.0625000
NODE_335_length_4021_cov_34.619072	379	459	10	3	80	0.0375000
NODE_335_length_4021_cov_34.619072	379	459	11	3	80	0.0375000
NODE_335_length_4021_cov_34.619072	379	459	13	30	80	0.3750000
NODE_335_length_4021_cov_34.619072	379	459	14	31	80	0.3875000
NODE_335_length_4021_cov_34.619072	379	459	16	8	80	0.1000000
NODE_335_length_4021_cov_34.619072	432	512	13	7	80	0.0875000
NODE_335_length_4021_cov_34.619072	432	512	14	12	80	0.1500000
NODE_335_length_4021_cov_34.619072	432	512	15	7	80	0.0875000
NODE_335_length_4021_cov_34.619072	432	512	16	43	80	0.5375000
NODE_335_length_4021_cov_34.619072	432	512	18	11	80	0.1375000
NODE_336_length_4020_cov_5.130834	3455	3535	5	2	80	0.0250000
NODE_336_length_4020_cov_5.130834	3455	3535	6	12	80	0.1500000
NODE_336_length_4020_cov_5.130834	3455	3535	7	50	80	0.6250000
NODE_336_length_4020_cov_5.130834	3455	3535	8	2	80	0.0250000
NODE_336_length_4020_cov_5.130834	3455	3535	10	14	80	0.1750000
NODE_336_length_4020_cov_5.130834	3508	3588	7	13	80	0.1625000
NODE_336_length_4020_cov_5.130834	3508	3588	9	26	80	0.3250000
NODE_336_length_4020_cov_5.130834	3508	3588	10	20	80	0.2500000
NODE_336_length_4020_cov_5.130834	3508	3588	11	2	80	0.0250000
NODE_336_length_4020_cov_5.130834	3508	3588	12	19	80	0.2375000
NODE_339_length_4004_cov_9.718054	387	467	2	1	80	0.0125000
NODE_339_length_4004_cov_9.718054	387	467	3	62	80	0.7750000
NODE_339_length_4004_cov_9.718054	387	467	4	17	80	0.2125000
NODE_339_length_4004_cov_9.718054	440	520	3	80	80	1.0000000
NODE_339_length_4004_cov_9.718054	516	596	1	53	80	0.6625000
NODE_339_length_4004_cov_9.718054	516	596	2	8	80	0.1000000
NODE_339_length_4004_cov_9.718054	516	596	3	19	80	0.2375000
NODE_339_length_4004_cov_9.718054	569	649	1	80	80	1.0000000
NODE_341_length_3991_cov_18.617934	867	947	19	5	80	0.0625000
NODE_341_length_3991_cov_18.617934	867	947	20	5	80	0.0625000
NODE_341_length_3991_cov_18.617934	867	947	21	6	80	0.0750000
NODE_341_length_3991_cov_18.617934	867	947	22	24	80	0.3000000
NODE_341_length_3991_cov_18.617934	867	947	23	12	80	0.1500000
NODE_341_length_3991_cov_18.617934	867	947	24	14	80	0.1750000
NODE_341_length_3991_cov_18.617934	867	947	25	11	80	0.1375000
NODE_341_length_3991_cov_18.617934	867	947	26	3	80	0.0375000
NODE_341_length_3991_cov_18.617934	920	1000	21	8	80	0.1000000
NODE_341_length_3991_cov_18.617934	920	1000	22	6	80	0.0750000
NODE_341_length_3991_cov_18.617934	920	1000	23	16	80	0.2000000
NODE_341_length_3991_cov_18.617934	920	1000	24	16	80	0.2000000
NODE_341_length_3991_cov_18.617934	920	1000	25	28	80	0.3500000
NODE_341_length_3991_cov_18.617934	920	1000	26	6	80	0.0750000
NODE_341_length_3991_cov_18.617934	996	1076	15	9	80	0.1125000
NODE_341_length_3991_cov_18.617934	996	1076	17	17	80	0.2125000
NODE_341_length_3991_cov_18.617934	996	1076	19	9	80	0.1125000
NODE_341_length_3991_cov_18.617934	996	1076	20	14	80	0.1750000
NODE_341_length_3991_cov_18.617934	996	1076	21	14	80	0.1750000
NODE_341_length_3991_cov_18.617934	996	1076	22	10	80	0.1250000
NODE_341_length_3991_cov_18.617934	996	1076	23	6	80	0.0750000
NODE_341_length_3991_cov_18.617934	996	1076	24	1	80	0.0125000
NODE_341_length_3991_cov_18.617934	1049	1124	8	6	75	0.0800000
NODE_341_length_3991_cov_18.617934	1049	1124	9	4	75	0.0533333
NODE_341_length_3991_cov_18.617934	1049	1124	10	3	75	0.0400000
NODE_341_length_3991_cov_18.617934	1049	1124	11	11	75	0.1466667
NODE_341_length_3991_cov_18.617934	1049	1124	12	12	75	0.1600000
NODE_341_length_3991_cov_18.617934	1049	1124	13	3	75	0.0400000
NODE_341_length_3991_cov_18.617934	1049	1124	15	18	75	0.2400000
NODE_341_length_3991_cov_18.617934	1049	1124	17	17	75	0.2266667
NODE_341_length_3991_cov_18.617934	1049	1124	19	1	75	0.0133333
NODE_348_length_3973_cov_6.906298	17	65	0	47	48	0.9791667
NODE_348_length_3973_cov_6.906298	17	65	2	1	48	0.0208333
NODE_348_length_3973_cov_6.906298	1945	1995	3	50	50	1.0000000
NODE_350_length_3960_cov_6.246827	2673	2761	0	88	88	1.0000000
NODE_350_length_3960_cov_6.246827	3520	3600	0	80	80	1.0000000
NODE_350_length_3960_cov_6.246827	3573	3653	0	80	80	1.0000000
NODE_353_length_3952_cov_8.805346	826	906	6	11	80	0.1375000
NODE_353_length_3952_cov_8.805346	826	906	8	4	80	0.0500000
NODE_353_length_3952_cov_8.805346	826	906	10	1	80	0.0125000
NODE_353_length_3952_cov_8.805346	826	906	14	13	80	0.1625000
NODE_353_length_3952_cov_8.805346	826	906	15	7	80	0.0875000
NODE_353_length_3952_cov_8.805346	826	906	18	23	80	0.2875000
NODE_353_length_3952_cov_8.805346	826	906	19	13	80	0.1625000
NODE_353_length_3952_cov_8.805346	826	906	20	8	80	0.1000000
NODE_353_length_3952_cov_8.805346	879	959	11	21	80	0.2625000
NODE_353_length_3952_cov_8.805346	879	959	17	14	80	0.1750000
NODE_353_length_3952_cov_8.805346	879	959	18	14	80	0.1750000
NODE_353_length_3952_cov_8.805346	879	959	19	23	80	0.2875000
NODE_353_length_3952_cov_8.805346	879	959	20	8	80	0.1000000
NODE_354_length_3928_cov_5.936798	2440	2521	3	81	81	1.0000000
NODE_354_length_3928_cov_5.936798	2493	2574	1	1	81	0.0123457
NODE_354_length_3928_cov_5.936798	2493	2574	2	34	81	0.4197531
NODE_354_length_3928_cov_5.936798	2493	2574	3	46	81	0.5679013
NODE_356_length_3923_cov_14.807793	3759	3800	1	41	41	1.0000000
NODE_358_length_3922_cov_7.609731	1493	1573	5	11	80	0.1375000
NODE_358_length_3922_cov_7.609731	1493	1573	8	69	80	0.8625000
NODE_358_length_3922_cov_7.609731	1546	1600	2	6	54	0.1111111
NODE_358_length_3922_cov_7.609731	1546	1600	5	32	54	0.5925926
NODE_358_length_3922_cov_7.609731	1546	1600	8	16	54	0.2962963
NODE_359_length_3921_cov_9.943223	2936	3016	5	6	80	0.0750000
NODE_359_length_3921_cov_9.943223	2936	3016	6	8	80	0.1000000
NODE_359_length_3921_cov_9.943223	2936	3016	7	2	80	0.0250000
NODE_359_length_3921_cov_9.943223	2936	3016	9	36	80	0.4500000
NODE_359_length_3921_cov_9.943223	2936	3016	10	25	80	0.3125000
NODE_359_length_3921_cov_9.943223	2936	3016	11	3	80	0.0375000
NODE_359_length_3921_cov_9.943223	2989	3057	5	6	68	0.0882353
NODE_359_length_3921_cov_9.943223	2989	3057	6	49	68	0.7205882
NODE_359_length_3921_cov_9.943223	2989	3057	7	2	68	0.0294118
NODE_359_length_3921_cov_9.943223	2989	3057	9	11	68	0.1617647
NODE_359_length_3921_cov_9.943223	3047	3066	6	19	19	1.0000000
NODE_363_length_3898_cov_40.033167	3296	3370	7	74	74	1.0000000
NODE_363_length_3898_cov_40.033167	3539	3619	1	18	80	0.2250000
NODE_363_length_3898_cov_40.033167	3539	3619	2	59	80	0.7375000
NODE_363_length_3898_cov_40.033167	3539	3619	3	3	80	0.0375000
NODE_364_length_3898_cov_7.550145	668	748	5	34	80	0.4250000
NODE_364_length_3898_cov_7.550145	668	748	6	19	80	0.2375000
NODE_364_length_3898_cov_7.550145	668	748	7	27	80	0.3375000
NODE_364_length_3898_cov_7.550145	721	801	4	7	80	0.0875000
NODE_364_length_3898_cov_7.550145	721	801	5	8	80	0.1000000
NODE_364_length_3898_cov_7.550145	721	801	6	60	80	0.7500000
NODE_364_length_3898_cov_7.550145	721	801	7	4	80	0.0500000
NODE_364_length_3898_cov_7.550145	721	801	9	1	80	0.0125000
NODE_367_length_3882_cov_4.166006	3244	3324	3	14	80	0.1750000
NODE_367_length_3882_cov_4.166006	3244	3324	4	25	80	0.3125000
NODE_367_length_3882_cov_4.166006	3244	3324	6	13	80	0.1625000
NODE_367_length_3882_cov_4.166006	3244	3324	7	19	80	0.2375000
NODE_367_length_3882_cov_4.166006	3244	3324	8	9	80	0.1125000
NODE_367_length_3882_cov_4.166006	3282	3324	4	2	42	0.0476190
NODE_367_length_3882_cov_4.166006	3282	3324	6	13	42	0.3095238
NODE_367_length_3882_cov_4.166006	3282	3324	7	18	42	0.4285714
NODE_367_length_3882_cov_4.166006	3282	3324	8	9	42	0.2142857
NODE_367_length_3882_cov_4.166006	3297	3377	7	18	80	0.2250000
NODE_367_length_3882_cov_4.166006	3297	3377	8	10	80	0.1250000
NODE_367_length_3882_cov_4.166006	3297	3377	9	48	80	0.6000000
NODE_367_length_3882_cov_4.166006	3297	3377	10	4	80	0.0500000
NODE_367_length_3882_cov_4.166006	3297	3377	7	18	80	0.2250000
NODE_367_length_3882_cov_4.166006	3297	3377	8	10	80	0.1250000
NODE_367_length_3882_cov_4.166006	3297	3377	9	48	80	0.6000000
NODE_367_length_3882_cov_4.166006	3297	3377	10	4	80	0.0500000
NODE_367_length_3882_cov_4.166006	3373	3450	4	3	77	0.0389610
NODE_367_length_3882_cov_4.166006	3373	3450	5	24	77	0.3116883
NODE_367_length_3882_cov_4.166006	3373	3450	7	10	77	0.1298701
NODE_367_length_3882_cov_4.166006	3373	3450	8	30	77	0.3896104
NODE_367_length_3882_cov_4.166006	3373	3450	10	10	77	0.1298701
NODE_374_length_3853_cov_18.816196	524	579	2	25	55	0.4545455
NODE_374_length_3853_cov_18.816196	524	579	4	15	55	0.2727273
NODE_374_length_3853_cov_18.816196	524	579	5	15	55	0.2727273
NODE_374_length_3853_cov_18.816196	559	639	4	23	80	0.2875000
NODE_374_length_3853_cov_18.816196	559	639	5	29	80	0.3625000
NODE_374_length_3853_cov_18.816196	559	639	6	4	80	0.0500000
NODE_374_length_3853_cov_18.816196	559	639	7	24	80	0.3000000
NODE_379_length_3829_cov_12.697319	515	595	5	12	80	0.1500000
NODE_379_length_3829_cov_12.697319	515	595	7	28	80	0.3500000
NODE_379_length_3829_cov_12.697319	515	595	8	24	80	0.3000000
NODE_379_length_3829_cov_12.697319	515	595	9	16	80	0.2000000
NODE_379_length_3829_cov_12.697319	568	648	5	7	80	0.0875000
NODE_379_length_3829_cov_12.697319	568	648	6	9	80	0.1125000
NODE_379_length_3829_cov_12.697319	568	648	8	12	80	0.1500000
NODE_379_length_3829_cov_12.697319	568	648	9	23	80	0.2875000
NODE_379_length_3829_cov_12.697319	568	648	10	29	80	0.3625000
NODE_379_length_3829_cov_12.697319	644	724	6	16	80	0.2000000
NODE_379_length_3829_cov_12.697319	644	724	7	5	80	0.0625000
NODE_379_length_3829_cov_12.697319	644	724	8	22	80	0.2750000
NODE_379_length_3829_cov_12.697319	644	724	9	4	80	0.0500000
NODE_379_length_3829_cov_12.697319	644	724	10	14	80	0.1750000
NODE_379_length_3829_cov_12.697319	644	724	12	19	80	0.2375000
NODE_379_length_3829_cov_12.697319	697	777	6	27	80	0.3375000
NODE_379_length_3829_cov_12.697319	697	777	7	6	80	0.0750000
NODE_379_length_3829_cov_12.697319	697	777	8	19	80	0.2375000
NODE_379_length_3829_cov_12.697319	697	777	10	8	80	0.1000000
NODE_379_length_3829_cov_12.697319	697	777	12	20	80	0.2500000
NODE_381_length_3815_cov_17.218784	399	479	10	16	80	0.2000000
NODE_381_length_3815_cov_17.218784	399	479	11	1	80	0.0125000
NODE_381_length_3815_cov_17.218784	399	479	12	11	80	0.1375000
NODE_381_length_3815_cov_17.218784	399	479	13	17	80	0.2125000
NODE_381_length_3815_cov_17.218784	399	479	14	7	80	0.0875000
NODE_381_length_3815_cov_17.218784	399	479	15	28	80	0.3500000
NODE_381_length_3815_cov_17.218784	452	532	3	2	80	0.0250000
NODE_381_length_3815_cov_17.218784	452	532	4	1	80	0.0125000
NODE_381_length_3815_cov_17.218784	452	532	8	12	80	0.1500000
NODE_381_length_3815_cov_17.218784	452	532	10	54	80	0.6750000
NODE_381_length_3815_cov_17.218784	452	532	11	1	80	0.0125000
NODE_381_length_3815_cov_17.218784	452	532	13	10	80	0.1250000
NODE_383_length_3812_cov_65.007272	840	903	0	19	63	0.3015873
NODE_383_length_3812_cov_65.007272	840	903	1	5	63	0.0793651
NODE_383_length_3812_cov_65.007272	840	903	3	8	63	0.1269841
NODE_383_length_3812_cov_65.007272	840	903	4	2	63	0.0317460
NODE_383_length_3812_cov_65.007272	840	903	6	6	63	0.0952381
NODE_383_length_3812_cov_65.007272	840	903	7	9	63	0.1428571
NODE_383_length_3812_cov_65.007272	840	903	8	2	63	0.0317460
NODE_383_length_3812_cov_65.007272	840	903	9	3	63	0.0476190
NODE_383_length_3812_cov_65.007272	840	903	11	1	63	0.0158730
NODE_383_length_3812_cov_65.007272	840	903	15	1	63	0.0158730
NODE_383_length_3812_cov_65.007272	840	903	16	3	63	0.0476190
NODE_383_length_3812_cov_65.007272	840	903	17	4	63	0.0634921
NODE_384_length_3805_cov_9.533189	145	236	0	91	91	1.0000000
NODE_384_length_3805_cov_9.533189	209	279	0	70	70	1.0000000
NODE_386_length_3799_cov_10.046486	2944	3024	10	10	80	0.1250000
NODE_386_length_3799_cov_10.046486	2944	3024	11	7	80	0.0875000
NODE_386_length_3799_cov_10.046486	2944	3024	12	2	80	0.0250000
NODE_386_length_3799_cov_10.046486	2944	3024	13	21	80	0.2625000
NODE_386_length_3799_cov_10.046486	2944	3024	14	12	80	0.1500000
NODE_386_length_3799_cov_10.046486	2944	3024	15	4	80	0.0500000
NODE_386_length_3799_cov_10.046486	2944	3024	16	8	80	0.1000000
NODE_386_length_3799_cov_10.046486	2944	3024	17	2	80	0.0250000
NODE_386_length_3799_cov_10.046486	2944	3024	18	14	80	0.1750000
NODE_386_length_3799_cov_10.046486	2997	3077	11	6	80	0.0750000
NODE_386_length_3799_cov_10.046486	2997	3077	12	19	80	0.2375000
NODE_386_length_3799_cov_10.046486	2997	3077	14	3	80	0.0375000
NODE_386_length_3799_cov_10.046486	2997	3077	15	23	80	0.2875000
NODE_386_length_3799_cov_10.046486	2997	3077	16	13	80	0.1625000
NODE_386_length_3799_cov_10.046486	2997	3077	17	2	80	0.0250000
NODE_386_length_3799_cov_10.046486	2997	3077	18	14	80	0.1750000
NODE_388_length_3795_cov_13.724297	3350	3430	6	31	80	0.3875000
NODE_388_length_3795_cov_13.724297	3350	3430	7	25	80	0.3125000
NODE_388_length_3795_cov_13.724297	3350	3430	10	24	80	0.3000000
NODE_388_length_3795_cov_13.724297	3403	3483	7	25	80	0.3125000
NODE_388_length_3795_cov_13.724297	3403	3483	8	3	80	0.0375000
NODE_388_length_3795_cov_13.724297	3403	3483	9	5	80	0.0625000
NODE_388_length_3795_cov_13.724297	3403	3483	10	47	80	0.5875000
NODE_388_length_3795_cov_13.724297	3479	3562	2	6	83	0.0722892
NODE_388_length_3795_cov_13.724297	3479	3562	4	44	83	0.5301205
NODE_388_length_3795_cov_13.724297	3479	3562	5	25	83	0.3012048
NODE_388_length_3795_cov_13.724297	3479	3562	6	4	83	0.0481928
NODE_388_length_3795_cov_13.724297	3479	3562	7	4	83	0.0481928
NODE_388_length_3795_cov_13.724297	3479	3562	2	6	83	0.0722892
NODE_388_length_3795_cov_13.724297	3479	3562	4	44	83	0.5301205
NODE_388_length_3795_cov_13.724297	3479	3562	5	25	83	0.3012048
NODE_388_length_3795_cov_13.724297	3479	3562	6	4	83	0.0481928
NODE_388_length_3795_cov_13.724297	3479	3562	7	4	83	0.0481928
NODE_388_length_3795_cov_13.724297	3479	3552	4	44	73	0.6027398
NODE_388_length_3795_cov_13.724297	3479	3552	5	21	73	0.2876712
NODE_388_length_3795_cov_13.724297	3479	3552	6	4	73	0.0547945
NODE_388_length_3795_cov_13.724297	3479	3552	7	4	73	0.0547945
NODE_388_length_3795_cov_13.724297	3535	3586	2	30	51	0.5882353
NODE_388_length_3795_cov_13.724297	3535	3586	5	21	51	0.4117647
NODE_388_length_3795_cov_13.724297	3535	3584	2	28	49	0.5714286
NODE_388_length_3795_cov_13.724297	3535	3584	5	21	49	0.4285714
NODE_388_length_3795_cov_13.724297	3698	3721	2	23	23	1.0000000
NODE_394_length_3774_cov_7.720544	538	595	3	43	57	0.7543859
NODE_394_length_3774_cov_7.720544	538	595	5	14	57	0.2456140
NODE_404_length_3747_cov_3.328947	2230	2292	5	31	62	0.5000000
NODE_404_length_3747_cov_3.328947	2230	2292	6	31	62	0.5000000
NODE_406_length_3743_cov_38.767014	1354	1434	14	8	80	0.1000000
NODE_406_length_3743_cov_38.767014	1354	1434	15	4	80	0.0500000
NODE_406_length_3743_cov_38.767014	1354	1434	16	23	80	0.2875000
NODE_406_length_3743_cov_38.767014	1354	1434	17	2	80	0.0250000
NODE_406_length_3743_cov_38.767014	1354	1434	18	4	80	0.0500000
NODE_406_length_3743_cov_38.767014	1354	1434	19	36	80	0.4500000
NODE_406_length_3743_cov_38.767014	1354	1434	20	3	80	0.0375000
NODE_406_length_3743_cov_38.767014	1407	1487	10	11	80	0.1375000
NODE_406_length_3743_cov_38.767014	1407	1487	12	4	80	0.0500000
NODE_406_length_3743_cov_38.767014	1407	1487	13	6	80	0.0750000
NODE_406_length_3743_cov_38.767014	1407	1487	14	26	80	0.3250000
NODE_406_length_3743_cov_38.767014	1407	1487	15	9	80	0.1125000
NODE_406_length_3743_cov_38.767014	1407	1487	16	12	80	0.1500000
NODE_406_length_3743_cov_38.767014	1407	1487	17	1	80	0.0125000
NODE_406_length_3743_cov_38.767014	1407	1487	19	8	80	0.1000000
NODE_406_length_3743_cov_38.767014	1407	1487	20	3	80	0.0375000
NODE_408_length_3733_cov_16.204458	186	249	0	51	63	0.8095238
NODE_408_length_3733_cov_16.204458	186	249	1	3	63	0.0476190
NODE_408_length_3733_cov_16.204458	186	249	2	5	63	0.0793651
NODE_408_length_3733_cov_16.204458	186	249	4	4	63	0.0634921
NODE_413_length_3707_cov_56.575665	2387	2467	15	16	80	0.2000000
NODE_413_length_3707_cov_56.575665	2387	2467	16	7	80	0.0875000
NODE_413_length_3707_cov_56.575665	2387	2467	18	5	80	0.0625000
NODE_413_length_3707_cov_56.575665	2387	2467	19	5	80	0.0625000
NODE_413_length_3707_cov_56.575665	2387	2467	23	3	80	0.0375000
NODE_413_length_3707_cov_56.575665	2387	2467	24	12	80	0.1500000
NODE_413_length_3707_cov_56.575665	2387	2467	25	1	80	0.0125000
NODE_413_length_3707_cov_56.575665	2387	2467	26	10	80	0.1250000
NODE_413_length_3707_cov_56.575665	2387	2467	27	6	80	0.0750000
NODE_413_length_3707_cov_56.575665	2387	2467	28	8	80	0.1000000
NODE_413_length_3707_cov_56.575665	2387	2467	29	5	80	0.0625000
NODE_413_length_3707_cov_56.575665	2387	2467	30	1	80	0.0125000
NODE_413_length_3707_cov_56.575665	2387	2467	31	1	80	0.0125000
NODE_413_length_3707_cov_56.575665	2440	2520	26	9	80	0.1125000
NODE_413_length_3707_cov_56.575665	2440	2520	27	5	80	0.0625000
NODE_413_length_3707_cov_56.575665	2440	2520	28	6	80	0.0750000
NODE_413_length_3707_cov_56.575665	2440	2520	29	5	80	0.0625000
NODE_413_length_3707_cov_56.575665	2440	2520	30	2	80	0.0250000
NODE_413_length_3707_cov_56.575665	2440	2520	31	1	80	0.0125000
NODE_413_length_3707_cov_56.575665	2440	2520	32	4	80	0.0500000
NODE_413_length_3707_cov_56.575665	2440	2520	33	3	80	0.0375000
NODE_413_length_3707_cov_56.575665	2440	2520	34	16	80	0.2000000
NODE_413_length_3707_cov_56.575665	2440	2520	35	19	80	0.2375000
NODE_413_length_3707_cov_56.575665	2440	2520	36	6	80	0.0750000
NODE_413_length_3707_cov_56.575665	2440	2520	37	4	80	0.0500000
NODE_413_length_3707_cov_56.575665	2516	2596	37	4	80	0.0500000
NODE_413_length_3707_cov_56.575665	2516	2596	38	3	80	0.0375000
NODE_413_length_3707_cov_56.575665	2516	2596	39	1	80	0.0125000
NODE_413_length_3707_cov_56.575665	2516	2596	40	10	80	0.1250000
NODE_413_length_3707_cov_56.575665	2516	2596	41	4	80	0.0500000
NODE_413_length_3707_cov_56.575665	2516	2596	42	1	80	0.0125000
NODE_413_length_3707_cov_56.575665	2516	2596	43	3	80	0.0375000
NODE_413_length_3707_cov_56.575665	2516	2596	44	1	80	0.0125000
NODE_413_length_3707_cov_56.575665	2516	2596	47	9	80	0.1125000
NODE_413_length_3707_cov_56.575665	2516	2596	48	7	80	0.0875000
NODE_413_length_3707_cov_56.575665	2516	2596	49	6	80	0.0750000
NODE_413_length_3707_cov_56.575665	2516	2596	50	14	80	0.1750000
NODE_413_length_3707_cov_56.575665	2516	2596	51	14	80	0.1750000
NODE_413_length_3707_cov_56.575665	2516	2596	52	3	80	0.0375000
NODE_413_length_3707_cov_56.575665	2569	2649	32	5	80	0.0625000
NODE_413_length_3707_cov_56.575665	2569	2649	33	12	80	0.1500000
NODE_413_length_3707_cov_56.575665	2569	2649	34	8	80	0.1000000
NODE_413_length_3707_cov_56.575665	2569	2649	36	3	80	0.0375000
NODE_413_length_3707_cov_56.575665	2569	2649	37	1	80	0.0125000
NODE_413_length_3707_cov_56.575665	2569	2649	38	1	80	0.0125000
NODE_413_length_3707_cov_56.575665	2569	2649	39	1	80	0.0125000
NODE_413_length_3707_cov_56.575665	2569	2649	41	1	80	0.0125000
NODE_413_length_3707_cov_56.575665	2569	2649	42	3	80	0.0375000
NODE_413_length_3707_cov_56.575665	2569	2649	43	1	80	0.0125000
NODE_413_length_3707_cov_56.575665	2569	2649	44	1	80	0.0125000
NODE_413_length_3707_cov_56.575665	2569	2649	46	5	80	0.0625000
NODE_413_length_3707_cov_56.575665	2569	2649	47	9	80	0.1125000
NODE_413_length_3707_cov_56.575665	2569	2649	48	6	80	0.0750000
NODE_413_length_3707_cov_56.575665	2569	2649	49	5	80	0.0625000
NODE_413_length_3707_cov_56.575665	2569	2649	50	12	80	0.1500000
NODE_413_length_3707_cov_56.575665	2569	2649	51	5	80	0.0625000
NODE_413_length_3707_cov_56.575665	2569	2649	52	1	80	0.0125000
NODE_416_length_3690_cov_7.476190	723	792	3	7	69	0.1014493
NODE_416_length_3690_cov_7.476190	723	792	4	62	69	0.8985507
NODE_416_length_3690_cov_7.476190	776	855	0	10	79	0.1265823
NODE_416_length_3690_cov_7.476190	776	855	1	28	79	0.3544304
NODE_416_length_3690_cov_7.476190	776	855	2	11	79	0.1392405
NODE_416_length_3690_cov_7.476190	776	855	3	21	79	0.2658228
NODE_416_length_3690_cov_7.476190	776	855	4	9	79	0.1139240
NODE_419_length_3685_cov_7.011154	1966	2046	18	3	80	0.0375000
NODE_419_length_3685_cov_7.011154	1966	2046	19	5	80	0.0625000
NODE_419_length_3685_cov_7.011154	1966	2046	20	3	80	0.0375000
NODE_419_length_3685_cov_7.011154	1966	2046	21	32	80	0.4000000
NODE_419_length_3685_cov_7.011154	1966	2046	22	13	80	0.1625000
NODE_419_length_3685_cov_7.011154	1966	2046	23	15	80	0.1875000
NODE_419_length_3685_cov_7.011154	1966	2046	24	9	80	0.1125000
NODE_419_length_3685_cov_7.011154	2019	2086	18	4	67	0.0597015
NODE_419_length_3685_cov_7.011154	2019	2086	19	12	67	0.1791045
NODE_419_length_3685_cov_7.011154	2019	2086	20	8	67	0.1194030
NODE_419_length_3685_cov_7.011154	2019	2086	21	11	67	0.1641791
NODE_419_length_3685_cov_7.011154	2019	2086	22	9	67	0.1343284
NODE_419_length_3685_cov_7.011154	2019	2086	24	23	67	0.3432836
NODE_426_length_3667_cov_1089.047365	1634	1705	719	1	71	0.0140845
NODE_426_length_3667_cov_1089.047365	1634	1705	723	1	71	0.0140845
NODE_426_length_3667_cov_1089.047365	1634	1705	729	1	71	0.0140845
NODE_426_length_3667_cov_1089.047365	1634	1705	733	1	71	0.0140845
NODE_426_length_3667_cov_1089.047365	1634	1705	734	1	71	0.0140845
NODE_426_length_3667_cov_1089.047365	1634	1705	736	1	71	0.0140845
NODE_426_length_3667_cov_1089.047365	1634	1705	738	1	71	0.0140845
NODE_426_length_3667_cov_1089.047365	1634	1705	752	1	71	0.0140845
NODE_426_length_3667_cov_1089.047365	1634	1705	753	1	71	0.0140845
NODE_426_length_3667_cov_1089.047365	1634	1705	758	3	71	0.0422535
NODE_426_length_3667_cov_1089.047365	1634	1705	762	1	71	0.0140845
NODE_426_length_3667_cov_1089.047365	1634	1705	763	3	71	0.0422535
NODE_426_length_3667_cov_1089.047365	1634	1705	765	1	71	0.0140845
NODE_426_length_3667_cov_1089.047365	1634	1705	766	1	71	0.0140845
NODE_426_length_3667_cov_1089.047365	1634	1705	767	1	71	0.0140845
NODE_426_length_3667_cov_1089.047365	1634	1705	780	1	71	0.0140845
NODE_426_length_3667_cov_1089.047365	1634	1705	783	2	71	0.0281690
NODE_426_length_3667_cov_1089.047365	1634	1705	789	1	71	0.0140845
NODE_426_length_3667_cov_1089.047365	1634	1705	791	1	71	0.0140845
NODE_426_length_3667_cov_1089.047365	1634	1705	805	1	71	0.0140845
NODE_426_length_3667_cov_1089.047365	1634	1705	806	1	71	0.0140845
NODE_426_length_3667_cov_1089.047365	1634	1705	811	1	71	0.0140845
NODE_426_length_3667_cov_1089.047365	1634	1705	816	1	71	0.0140845
NODE_426_length_3667_cov_1089.047365	1634	1705	839	1	71	0.0140845
NODE_426_length_3667_cov_1089.047365	1634	1705	844	1	71	0.0140845
NODE_426_length_3667_cov_1089.047365	1634	1705	851	1	71	0.0140845
NODE_426_length_3667_cov_1089.047365	1634	1705	852	1	71	0.0140845
NODE_426_length_3667_cov_1089.047365	1634	1705	855	1	71	0.0140845
NODE_426_length_3667_cov_1089.047365	1634	1705	861	1	71	0.0140845
NODE_426_length_3667_cov_1089.047365	1634	1705	867	1	71	0.0140845
NODE_426_length_3667_cov_1089.047365	1634	1705	880	1	71	0.0140845
NODE_426_length_3667_cov_1089.047365	1634	1705	900	2	71	0.0281690
NODE_426_length_3667_cov_1089.047365	1634	1705	907	1	71	0.0140845
NODE_426_length_3667_cov_1089.047365	1634	1705	913	1	71	0.0140845
NODE_426_length_3667_cov_1089.047365	1634	1705	915	1	71	0.0140845
NODE_426_length_3667_cov_1089.047365	1634	1705	916	2	71	0.0281690
NODE_426_length_3667_cov_1089.047365	1634	1705	917	1	71	0.0140845
NODE_426_length_3667_cov_1089.047365	1634	1705	919	1	71	0.0140845
NODE_426_length_3667_cov_1089.047365	1634	1705	920	1	71	0.0140845
NODE_426_length_3667_cov_1089.047365	1634	1705	921	1	71	0.0140845
NODE_426_length_3667_cov_1089.047365	1634	1705	922	1	71	0.0140845
NODE_426_length_3667_cov_1089.047365	1634	1705	939	2	71	0.0281690
NODE_426_length_3667_cov_1089.047365	1634	1705	947	1	71	0.0140845
NODE_426_length_3667_cov_1089.047365	1634	1705	966	1	71	0.0140845
NODE_426_length_3667_cov_1089.047365	1634	1705	968	1	71	0.0140845
NODE_426_length_3667_cov_1089.047365	1634	1705	970	1	71	0.0140845
NODE_426_length_3667_cov_1089.047365	1634	1705	973	2	71	0.0281690
NODE_426_length_3667_cov_1089.047365	1634	1705	986	1	71	0.0140845
NODE_426_length_3667_cov_1089.047365	1634	1705	987	1	71	0.0140845
NODE_426_length_3667_cov_1089.047365	1634	1705	991	1	71	0.0140845
NODE_426_length_3667_cov_1089.047365	1634	1705	992	1	71	0.0140845
NODE_426_length_3667_cov_1089.047365	1634	1705	1001	1	71	0.0140845
NODE_426_length_3667_cov_1089.047365	1634	1705	1006	1	71	0.0140845
NODE_426_length_3667_cov_1089.047365	1634	1705	1007	1	71	0.0140845
NODE_426_length_3667_cov_1089.047365	1634	1705	1011	1	71	0.0140845
NODE_426_length_3667_cov_1089.047365	1634	1705	1012	1	71	0.0140845
NODE_426_length_3667_cov_1089.047365	1634	1705	1013	2	71	0.0281690
NODE_426_length_3667_cov_1089.047365	1634	1705	1015	1	71	0.0140845
NODE_426_length_3667_cov_1089.047365	1634	1705	1016	1	71	0.0140845
NODE_426_length_3667_cov_1089.047365	1634	1705	1018	1	71	0.0140845
NODE_426_length_3667_cov_1089.047365	1634	1705	1019	1	71	0.0140845
NODE_426_length_3667_cov_1089.047365	1678	1758	919	1	80	0.0125000
NODE_426_length_3667_cov_1089.047365	1678	1758	920	1	80	0.0125000
NODE_426_length_3667_cov_1089.047365	1678	1758	921	1	80	0.0125000
NODE_426_length_3667_cov_1089.047365	1678	1758	922	1	80	0.0125000
NODE_426_length_3667_cov_1089.047365	1678	1758	939	2	80	0.0250000
NODE_426_length_3667_cov_1089.047365	1678	1758	947	1	80	0.0125000
NODE_426_length_3667_cov_1089.047365	1678	1758	966	1	80	0.0125000
NODE_426_length_3667_cov_1089.047365	1678	1758	968	1	80	0.0125000
NODE_426_length_3667_cov_1089.047365	1678	1758	970	1	80	0.0125000
NODE_426_length_3667_cov_1089.047365	1678	1758	973	2	80	0.0250000
NODE_426_length_3667_cov_1089.047365	1678	1758	986	1	80	0.0125000
NODE_426_length_3667_cov_1089.047365	1678	1758	987	1	80	0.0125000
NODE_426_length_3667_cov_1089.047365	1678	1758	991	1	80	0.0125000
NODE_426_length_3667_cov_1089.047365	1678	1758	992	1	80	0.0125000
NODE_426_length_3667_cov_1089.047365	1678	1758	1001	1	80	0.0125000
NODE_426_length_3667_cov_1089.047365	1678	1758	1006	1	80	0.0125000
NODE_426_length_3667_cov_1089.047365	1678	1758	1007	1	80	0.0125000
NODE_426_length_3667_cov_1089.047365	1678	1758	1011	1	80	0.0125000
NODE_426_length_3667_cov_1089.047365	1678	1758	1012	1	80	0.0125000
NODE_426_length_3667_cov_1089.047365	1678	1758	1013	2	80	0.0250000
NODE_426_length_3667_cov_1089.047365	1678	1758	1015	1	80	0.0125000
NODE_426_length_3667_cov_1089.047365	1678	1758	1016	1	80	0.0125000
NODE_426_length_3667_cov_1089.047365	1678	1758	1018	1	80	0.0125000
NODE_426_length_3667_cov_1089.047365	1678	1758	1019	2	80	0.0250000
NODE_426_length_3667_cov_1089.047365	1678	1758	1021	1	80	0.0125000
NODE_426_length_3667_cov_1089.047365	1678	1758	1022	1	80	0.0125000
NODE_426_length_3667_cov_1089.047365	1678	1758	1028	1	80	0.0125000
NODE_426_length_3667_cov_1089.047365	1678	1758	1035	2	80	0.0250000
NODE_426_length_3667_cov_1089.047365	1678	1758	1036	1	80	0.0125000
NODE_426_length_3667_cov_1089.047365	1678	1758	1038	2	80	0.0250000
NODE_426_length_3667_cov_1089.047365	1678	1758	1039	1	80	0.0125000
NODE_426_length_3667_cov_1089.047365	1678	1758	1040	1	80	0.0125000
NODE_426_length_3667_cov_1089.047365	1678	1758	1041	4	80	0.0500000
NODE_426_length_3667_cov_1089.047365	1678	1758	1046	3	80	0.0375000
NODE_426_length_3667_cov_1089.047365	1678	1758	1050	1	80	0.0125000
NODE_426_length_3667_cov_1089.047365	1678	1758	1053	3	80	0.0375000
NODE_426_length_3667_cov_1089.047365	1678	1758	1055	1	80	0.0125000
NODE_426_length_3667_cov_1089.047365	1678	1758	1057	1	80	0.0125000
NODE_426_length_3667_cov_1089.047365	1678	1758	1058	1	80	0.0125000
NODE_426_length_3667_cov_1089.047365	1678	1758	1062	1	80	0.0125000
NODE_426_length_3667_cov_1089.047365	1678	1758	1063	1	80	0.0125000
NODE_426_length_3667_cov_1089.047365	1678	1758	1064	1	80	0.0125000
NODE_426_length_3667_cov_1089.047365	1678	1758	1065	1	80	0.0125000
NODE_426_length_3667_cov_1089.047365	1678	1758	1066	1	80	0.0125000
NODE_426_length_3667_cov_1089.047365	1678	1758	1067	1	80	0.0125000
NODE_426_length_3667_cov_1089.047365	1678	1758	1069	2	80	0.0250000
NODE_426_length_3667_cov_1089.047365	1678	1758	1070	3	80	0.0375000
NODE_426_length_3667_cov_1089.047365	1678	1758	1072	2	80	0.0250000
NODE_426_length_3667_cov_1089.047365	1678	1758	1073	4	80	0.0500000
NODE_426_length_3667_cov_1089.047365	1678	1758	1074	1	80	0.0125000
NODE_426_length_3667_cov_1089.047365	1678	1758	1075	4	80	0.0500000
NODE_426_length_3667_cov_1089.047365	1678	1758	1076	1	80	0.0125000
NODE_426_length_3667_cov_1089.047365	1678	1758	1077	2	80	0.0250000
NODE_426_length_3667_cov_1089.047365	1678	1758	1078	1	80	0.0125000
NODE_426_length_3667_cov_1089.047365	1678	1758	1079	1	80	0.0125000
NODE_426_length_3667_cov_1089.047365	1678	1758	1080	1	80	0.0125000
NODE_428_length_3660_cov_79.447627	1806	1870	4	6	64	0.0937500
NODE_428_length_3660_cov_79.447627	1806	1870	7	9	64	0.1406250
NODE_428_length_3660_cov_79.447627	1806	1870	8	2	64	0.0312500
NODE_428_length_3660_cov_79.447627	1806	1870	10	14	64	0.2187500
NODE_428_length_3660_cov_79.447627	1806	1870	15	26	64	0.4062500
NODE_428_length_3660_cov_79.447627	1806	1870	22	7	64	0.1093750
NODE_428_length_3660_cov_79.447627	1859	1906	15	4	47	0.0851064
NODE_428_length_3660_cov_79.447627	1859	1906	21	11	47	0.2340426
NODE_428_length_3660_cov_79.447627	1859	1906	22	24	47	0.5106383
NODE_428_length_3660_cov_79.447627	1859	1906	23	8	47	0.1702128
NODE_428_length_3660_cov_79.447627	2358	2438	0	25	80	0.3125000
NODE_428_length_3660_cov_79.447627	2358	2438	1	46	80	0.5750000
NODE_428_length_3660_cov_79.447627	2358	2438	2	2	80	0.0250000
NODE_428_length_3660_cov_79.447627	2358	2438	4	7	80	0.0875000
NODE_428_length_3660_cov_79.447627	2411	2491	1	18	80	0.2250000
NODE_428_length_3660_cov_79.447627	2411	2491	2	2	80	0.0250000
NODE_428_length_3660_cov_79.447627	2411	2491	4	60	80	0.7500000
NODE_428_length_3660_cov_79.447627	2487	2567	3	18	80	0.2250000
NODE_428_length_3660_cov_79.447627	2487	2567	4	62	80	0.7750000
NODE_428_length_3660_cov_79.447627	2540	2620	2	39	80	0.4875000
NODE_428_length_3660_cov_79.447627	2540	2620	3	11	80	0.1375000
NODE_428_length_3660_cov_79.447627	2540	2620	4	20	80	0.2500000
NODE_428_length_3660_cov_79.447627	2540	2620	5	10	80	0.1250000
NODE_430_length_3634_cov_34.913154	1499	1544	13	1	45	0.0222222
NODE_430_length_3634_cov_34.913154	1499	1544	15	2	45	0.0444444
NODE_430_length_3634_cov_34.913154	1499	1544	16	1	45	0.0222222
NODE_430_length_3634_cov_34.913154	1499	1544	17	6	45	0.1333333
NODE_430_length_3634_cov_34.913154	1499	1544	20	2	45	0.0444444
NODE_430_length_3634_cov_34.913154	1499	1544	21	20	45	0.4444444
NODE_430_length_3634_cov_34.913154	1499	1544	22	7	45	0.1555556
NODE_430_length_3634_cov_34.913154	1499	1544	23	3	45	0.0666667
NODE_430_length_3634_cov_34.913154	1499	1544	24	3	45	0.0666667
NODE_430_length_3634_cov_34.913154	1517	1597	21	14	80	0.1750000
NODE_430_length_3634_cov_34.913154	1517	1597	22	7	80	0.0875000
NODE_430_length_3634_cov_34.913154	1517	1597	23	3	80	0.0375000
NODE_430_length_3634_cov_34.913154	1517	1597	24	18	80	0.2250000
NODE_430_length_3634_cov_34.913154	1517	1597	25	12	80	0.1500000
NODE_430_length_3634_cov_34.913154	1517	1597	26	6	80	0.0750000
NODE_430_length_3634_cov_34.913154	1517	1597	28	5	80	0.0625000
NODE_430_length_3634_cov_34.913154	1517	1597	29	8	80	0.1000000
NODE_430_length_3634_cov_34.913154	1517	1597	30	7	80	0.0875000
NODE_430_length_3634_cov_34.913154	1978	2058	12	3	80	0.0375000
NODE_430_length_3634_cov_34.913154	1978	2058	14	3	80	0.0375000
NODE_430_length_3634_cov_34.913154	1978	2058	15	4	80	0.0500000
NODE_430_length_3634_cov_34.913154	1978	2058	21	7	80	0.0875000
NODE_430_length_3634_cov_34.913154	1978	2058	23	6	80	0.0750000
NODE_430_length_3634_cov_34.913154	1978	2058	24	3	80	0.0375000
NODE_430_length_3634_cov_34.913154	1978	2058	25	7	80	0.0875000
NODE_430_length_3634_cov_34.913154	1978	2058	28	3	80	0.0375000
NODE_430_length_3634_cov_34.913154	1978	2058	29	11	80	0.1375000
NODE_430_length_3634_cov_34.913154	1978	2058	31	3	80	0.0375000
NODE_430_length_3634_cov_34.913154	1978	2058	32	1	80	0.0125000
NODE_430_length_3634_cov_34.913154	1978	2058	35	1	80	0.0125000
NODE_430_length_3634_cov_34.913154	1978	2058	36	5	80	0.0625000
NODE_430_length_3634_cov_34.913154	1978	2058	37	1	80	0.0125000
NODE_430_length_3634_cov_34.913154	1978	2058	38	8	80	0.1000000
NODE_430_length_3634_cov_34.913154	1978	2058	40	4	80	0.0500000
NODE_430_length_3634_cov_34.913154	1978	2058	41	1	80	0.0125000
NODE_430_length_3634_cov_34.913154	1978	2058	42	9	80	0.1125000
NODE_430_length_3634_cov_34.913154	2031	2077	3	3	46	0.0652174
NODE_430_length_3634_cov_34.913154	2031	2077	5	3	46	0.0652174
NODE_430_length_3634_cov_34.913154	2031	2077	6	5	46	0.1086956
NODE_430_length_3634_cov_34.913154	2031	2077	7	1	46	0.0217391
NODE_430_length_3634_cov_34.913154	2031	2077	8	4	46	0.0869565
NODE_430_length_3634_cov_34.913154	2031	2077	12	6	46	0.1304348
NODE_430_length_3634_cov_34.913154	2031	2077	14	3	46	0.0652174
NODE_430_length_3634_cov_34.913154	2031	2077	15	4	46	0.0869565
NODE_430_length_3634_cov_34.913154	2031	2077	21	7	46	0.1521739
NODE_430_length_3634_cov_34.913154	2031	2077	23	6	46	0.1304348
NODE_430_length_3634_cov_34.913154	2031	2077	24	3	46	0.0652174
NODE_430_length_3634_cov_34.913154	2031	2077	25	1	46	0.0217391
NODE_435_length_3622_cov_29.112120	201	281	2	5	80	0.0625000
NODE_435_length_3622_cov_29.112120	201	281	3	33	80	0.4125000
NODE_435_length_3622_cov_29.112120	201	281	10	42	80	0.5250000
NODE_435_length_3622_cov_29.112120	254	334	10	80	80	1.0000000
NODE_435_length_3622_cov_29.112120	2310	2390	20	3	80	0.0375000
NODE_435_length_3622_cov_29.112120	2310	2390	21	1	80	0.0125000
NODE_435_length_3622_cov_29.112120	2310	2390	24	1	80	0.0125000
NODE_435_length_3622_cov_29.112120	2310	2390	25	1	80	0.0125000
NODE_435_length_3622_cov_29.112120	2310	2390	26	7	80	0.0875000
NODE_435_length_3622_cov_29.112120	2310	2390	27	2	80	0.0250000
NODE_435_length_3622_cov_29.112120	2310	2390	28	2	80	0.0250000
NODE_435_length_3622_cov_29.112120	2310	2390	29	6	80	0.0750000
NODE_435_length_3622_cov_29.112120	2310	2390	30	14	80	0.1750000
NODE_435_length_3622_cov_29.112120	2310	2390	32	1	80	0.0125000
NODE_435_length_3622_cov_29.112120	2310	2390	33	9	80	0.1125000
NODE_435_length_3622_cov_29.112120	2310	2390	35	3	80	0.0375000
NODE_435_length_3622_cov_29.112120	2310	2390	36	8	80	0.1000000
NODE_435_length_3622_cov_29.112120	2310	2390	38	1	80	0.0125000
NODE_435_length_3622_cov_29.112120	2310	2390	39	4	80	0.0500000
NODE_435_length_3622_cov_29.112120	2310	2390	40	4	80	0.0500000
NODE_435_length_3622_cov_29.112120	2310	2390	41	10	80	0.1250000
NODE_435_length_3622_cov_29.112120	2310	2390	42	3	80	0.0375000
NODE_435_length_3622_cov_29.112120	2363	2441	7	1	78	0.0128205
NODE_435_length_3622_cov_29.112120	2363	2441	8	2	78	0.0256410
NODE_435_length_3622_cov_29.112120	2363	2441	10	3	78	0.0384615
NODE_435_length_3622_cov_29.112120	2363	2441	11	5	78	0.0641026
NODE_435_length_3622_cov_29.112120	2363	2441	13	15	78	0.1923077
NODE_435_length_3622_cov_29.112120	2363	2441	14	6	78	0.0769231
NODE_435_length_3622_cov_29.112120	2363	2441	15	16	78	0.2051282
NODE_435_length_3622_cov_29.112120	2363	2441	17	1	78	0.0128205
NODE_435_length_3622_cov_29.112120	2363	2441	19	1	78	0.0128205
NODE_435_length_3622_cov_29.112120	2363	2441	20	4	78	0.0512821
NODE_435_length_3622_cov_29.112120	2363	2441	21	1	78	0.0128205
NODE_435_length_3622_cov_29.112120	2363	2441	24	1	78	0.0128205
NODE_435_length_3622_cov_29.112120	2363	2441	25	1	78	0.0128205
NODE_435_length_3622_cov_29.112120	2363	2441	26	7	78	0.0897436
NODE_435_length_3622_cov_29.112120	2363	2441	27	2	78	0.0256410
NODE_435_length_3622_cov_29.112120	2363	2441	28	2	78	0.0256410
NODE_435_length_3622_cov_29.112120	2363	2441	29	6	78	0.0769231
NODE_435_length_3622_cov_29.112120	2363	2441	30	4	78	0.0512821
NODE_437_length_3610_cov_8.785816	294	340	1	10	46	0.2173913
NODE_437_length_3610_cov_8.785816	294	340	2	36	46	0.7826087
NODE_437_length_3610_cov_8.785816	313	393	2	37	80	0.4625000
NODE_437_length_3610_cov_8.785816	313	393	3	43	80	0.5375000
NODE_444_length_3588_cov_16.296360	2421	2501	19	37	80	0.4625000
NODE_444_length_3588_cov_16.296360	2421	2501	20	14	80	0.1750000
NODE_444_length_3588_cov_16.296360	2421	2501	21	27	80	0.3375000
NODE_444_length_3588_cov_16.296360	2421	2501	22	2	80	0.0250000
NODE_444_length_3588_cov_16.296360	2474	2539	12	2	65	0.0307692
NODE_444_length_3588_cov_16.296360	2474	2539	16	15	65	0.2307692
NODE_444_length_3588_cov_16.296360	2474	2539	17	3	65	0.0461538
NODE_444_length_3588_cov_16.296360	2474	2539	18	2	65	0.0307692
NODE_444_length_3588_cov_16.296360	2474	2539	19	39	65	0.6000000
NODE_444_length_3588_cov_16.296360	2474	2539	20	4	65	0.0615385
NODE_447_length_3585_cov_2.283419	605	668	2	63	63	1.0000000
NODE_451_length_3567_cov_16.283160	410	429	0	19	19	1.0000000
NODE_451_length_3567_cov_16.283160	2259	2339	22	7	80	0.0875000
NODE_451_length_3567_cov_16.283160	2259	2339	23	6	80	0.0750000
NODE_451_length_3567_cov_16.283160	2259	2339	24	3	80	0.0375000
NODE_451_length_3567_cov_16.283160	2259	2339	25	4	80	0.0500000
NODE_451_length_3567_cov_16.283160	2259	2339	26	6	80	0.0750000
NODE_451_length_3567_cov_16.283160	2259	2339	28	8	80	0.1000000
NODE_451_length_3567_cov_16.283160	2259	2339	29	20	80	0.2500000
NODE_451_length_3567_cov_16.283160	2259	2339	30	26	80	0.3250000
NODE_451_length_3567_cov_16.283160	2312	2379	0	1	67	0.0149254
NODE_451_length_3567_cov_16.283160	2312	2379	1	1	67	0.0149254
NODE_451_length_3567_cov_16.283160	2312	2379	2	3	67	0.0447761
NODE_451_length_3567_cov_16.283160	2312	2379	5	1	67	0.0149254
NODE_451_length_3567_cov_16.283160	2312	2379	7	3	67	0.0447761
NODE_451_length_3567_cov_16.283160	2312	2379	8	1	67	0.0149254
NODE_451_length_3567_cov_16.283160	2312	2379	10	1	67	0.0149254
NODE_451_length_3567_cov_16.283160	2312	2379	11	1	67	0.0149254
NODE_451_length_3567_cov_16.283160	2312	2379	13	1	67	0.0149254
NODE_451_length_3567_cov_16.283160	2312	2379	14	3	67	0.0447761
NODE_451_length_3567_cov_16.283160	2312	2379	15	2	67	0.0298507
NODE_451_length_3567_cov_16.283160	2312	2379	16	9	67	0.1343284
NODE_451_length_3567_cov_16.283160	2312	2379	17	1	67	0.0149254
NODE_451_length_3567_cov_16.283160	2312	2379	18	1	67	0.0149254
NODE_451_length_3567_cov_16.283160	2312	2379	20	1	67	0.0149254
NODE_451_length_3567_cov_16.283160	2312	2379	21	1	67	0.0149254
NODE_451_length_3567_cov_16.283160	2312	2379	22	16	67	0.2388060
NODE_451_length_3567_cov_16.283160	2312	2379	23	6	67	0.0895522
NODE_451_length_3567_cov_16.283160	2312	2379	24	3	67	0.0447761
NODE_451_length_3567_cov_16.283160	2312	2379	25	4	67	0.0597015
NODE_451_length_3567_cov_16.283160	2312	2379	26	6	67	0.0895522
NODE_451_length_3567_cov_16.283160	2312	2379	28	1	67	0.0149254
NODE_454_length_3557_cov_12.423077	640	718	0	78	78	1.0000000
NODE_454_length_3557_cov_12.423077	640	688	0	48	48	1.0000000
NODE_454_length_3557_cov_12.423077	640	688	0	48	48	1.0000000
NODE_454_length_3557_cov_12.423077	640	688	0	48	48	1.0000000
NODE_454_length_3557_cov_12.423077	640	688	0	48	48	1.0000000
NODE_454_length_3557_cov_12.423077	693	771	0	78	78	1.0000000
NODE_455_length_3548_cov_7.216295	554	634	5	40	80	0.5000000
NODE_455_length_3548_cov_7.216295	554	634	6	40	80	0.5000000
NODE_455_length_3548_cov_7.216295	607	687	3	23	80	0.2875000
NODE_455_length_3548_cov_7.216295	607	687	4	23	80	0.2875000
NODE_455_length_3548_cov_7.216295	607	687	5	24	80	0.3000000
NODE_455_length_3548_cov_7.216295	607	687	6	10	80	0.1250000
NODE_461_length_3518_cov_40.508336	1320	1400	6	17	80	0.2125000
NODE_461_length_3518_cov_40.508336	1320	1400	8	2	80	0.0250000
NODE_461_length_3518_cov_40.508336	1320	1400	11	2	80	0.0250000
NODE_461_length_3518_cov_40.508336	1320	1400	13	1	80	0.0125000
NODE_461_length_3518_cov_40.508336	1320	1400	14	14	80	0.1750000
NODE_461_length_3518_cov_40.508336	1320	1400	16	22	80	0.2750000
NODE_461_length_3518_cov_40.508336	1320	1400	18	22	80	0.2750000
NODE_461_length_3518_cov_40.508336	1373	1453	16	9	80	0.1125000
NODE_461_length_3518_cov_40.508336	1373	1453	17	12	80	0.1500000
NODE_461_length_3518_cov_40.508336	1373	1453	18	24	80	0.3000000
NODE_461_length_3518_cov_40.508336	1373	1453	19	5	80	0.0625000
NODE_461_length_3518_cov_40.508336	1373	1453	20	21	80	0.2625000
NODE_461_length_3518_cov_40.508336	1373	1453	21	5	80	0.0625000
NODE_461_length_3518_cov_40.508336	1373	1453	22	4	80	0.0500000
NODE_465_length_3497_cov_65.791348	3062	3142	16	11	80	0.1375000
NODE_465_length_3497_cov_65.791348	3062	3142	17	16	80	0.2000000
NODE_465_length_3497_cov_65.791348	3062	3142	18	13	80	0.1625000
NODE_465_length_3497_cov_65.791348	3062	3142	19	16	80	0.2000000
NODE_465_length_3497_cov_65.791348	3062	3142	20	13	80	0.1625000
NODE_465_length_3497_cov_65.791348	3062	3142	21	4	80	0.0500000
NODE_465_length_3497_cov_65.791348	3062	3142	22	6	80	0.0750000
NODE_465_length_3497_cov_65.791348	3062	3142	23	1	80	0.0125000
NODE_466_length_3488_cov_2.243730	506	529	0	23	23	1.0000000
NODE_470_length_3483_cov_14.759456	360	440	8	10	80	0.1250000
NODE_470_length_3483_cov_14.759456	360	440	9	7	80	0.0875000
NODE_470_length_3483_cov_14.759456	360	440	10	28	80	0.3500000
NODE_470_length_3483_cov_14.759456	360	440	11	13	80	0.1625000
NODE_470_length_3483_cov_14.759456	360	440	12	22	80	0.2750000
NODE_470_length_3483_cov_14.759456	413	493	8	10	80	0.1250000
NODE_470_length_3483_cov_14.759456	413	493	9	7	80	0.0875000
NODE_470_length_3483_cov_14.759456	413	493	10	42	80	0.5250000
NODE_470_length_3483_cov_14.759456	413	493	11	21	80	0.2625000
NODE_474_length_3471_cov_37.887604	2795	2875	0	8	80	0.1000000
NODE_474_length_3471_cov_37.887604	2795	2875	1	18	80	0.2250000
NODE_474_length_3471_cov_37.887604	2795	2875	2	54	80	0.6750000
NODE_474_length_3471_cov_37.887604	2848	2928	2	62	80	0.7750000
NODE_474_length_3471_cov_37.887604	2848	2928	4	1	80	0.0125000
NODE_474_length_3471_cov_37.887604	2848	2928	5	1	80	0.0125000
NODE_474_length_3471_cov_37.887604	2848	2928	6	16	80	0.2000000
NODE_474_length_3471_cov_37.887604	2924	2943	6	19	19	1.0000000
NODE_474_length_3471_cov_37.887604	2924	3004	5	3	80	0.0375000
NODE_474_length_3471_cov_37.887604	2924	3004	6	29	80	0.3625000
NODE_474_length_3471_cov_37.887604	2924	3004	7	1	80	0.0125000
NODE_474_length_3471_cov_37.887604	2924	3004	8	17	80	0.2125000
NODE_474_length_3471_cov_37.887604	2924	3004	9	5	80	0.0625000
NODE_474_length_3471_cov_37.887604	2924	3004	10	25	80	0.3125000
NODE_474_length_3471_cov_37.887604	2977	3057	8	2	80	0.0250000
NODE_474_length_3471_cov_37.887604	2977	3057	10	78	80	0.9750000
NODE_479_length_3451_cov_29.833234	2973	3053	0	63	80	0.7875000
NODE_479_length_3451_cov_29.833234	2973	3053	3	17	80	0.2125000
NODE_479_length_3451_cov_29.833234	3026	3106	0	80	80	1.0000000
NODE_481_length_3446_cov_32.421273	3181	3261	2	20	80	0.2500000
NODE_481_length_3446_cov_32.421273	3181	3261	3	26	80	0.3250000
NODE_481_length_3446_cov_32.421273	3181	3261	4	22	80	0.2750000
NODE_481_length_3446_cov_32.421273	3181	3261	5	12	80	0.1500000
NODE_482_length_3444_cov_29.954858	792	872	17	2	80	0.0250000
NODE_482_length_3444_cov_29.954858	792	872	18	8	80	0.1000000
NODE_482_length_3444_cov_29.954858	792	872	21	8	80	0.1000000
NODE_482_length_3444_cov_29.954858	792	872	22	2	80	0.0250000
NODE_482_length_3444_cov_29.954858	792	872	23	23	80	0.2875000
NODE_482_length_3444_cov_29.954858	792	872	24	29	80	0.3625000
NODE_482_length_3444_cov_29.954858	792	872	25	5	80	0.0625000
NODE_482_length_3444_cov_29.954858	792	872	26	1	80	0.0125000
NODE_482_length_3444_cov_29.954858	792	872	27	2	80	0.0250000
NODE_482_length_3444_cov_29.954858	845	925	24	22	80	0.2750000
NODE_482_length_3444_cov_29.954858	845	925	25	18	80	0.2250000
NODE_482_length_3444_cov_29.954858	845	925	26	2	80	0.0250000
NODE_482_length_3444_cov_29.954858	845	925	27	19	80	0.2375000
NODE_482_length_3444_cov_29.954858	845	925	28	4	80	0.0500000
NODE_482_length_3444_cov_29.954858	845	925	29	15	80	0.1875000
NODE_483_length_3442_cov_17.799880	3155	3220	0	1	65	0.0153846
NODE_483_length_3442_cov_17.799880	3155	3220	6	2	65	0.0307692
NODE_483_length_3442_cov_17.799880	3155	3220	8	5	65	0.0769231
NODE_483_length_3442_cov_17.799880	3155	3220	9	6	65	0.0923077
NODE_483_length_3442_cov_17.799880	3155	3220	10	27	65	0.4153846
NODE_483_length_3442_cov_17.799880	3155	3220	11	2	65	0.0307692
NODE_483_length_3442_cov_17.799880	3155	3220	12	3	65	0.0461538
NODE_483_length_3442_cov_17.799880	3155	3220	13	13	65	0.2000000
NODE_483_length_3442_cov_17.799880	3155	3220	14	1	65	0.0153846
NODE_483_length_3442_cov_17.799880	3155	3220	16	2	65	0.0307692
NODE_483_length_3442_cov_17.799880	3155	3220	17	3	65	0.0461538
NODE_483_length_3442_cov_17.799880	3208	3273	13	6	65	0.0923077
NODE_483_length_3442_cov_17.799880	3208	3273	14	1	65	0.0153846
NODE_483_length_3442_cov_17.799880	3208	3273	16	2	65	0.0307692
NODE_483_length_3442_cov_17.799880	3208	3273	17	19	65	0.2923077
NODE_483_length_3442_cov_17.799880	3208	3273	18	14	65	0.2153846
NODE_483_length_3442_cov_17.799880	3208	3273	19	19	65	0.2923077
NODE_483_length_3442_cov_17.799880	3208	3273	21	2	65	0.0307692
NODE_483_length_3442_cov_17.799880	3208	3273	23	2	65	0.0307692
NODE_486_length_3429_cov_5.070270	125	148	3	15	23	0.6521739
NODE_486_length_3429_cov_5.070270	125	148	5	8	23	0.3478261
NODE_493_length_3408_cov_2.406769	0	45	0	45	45	1.0000000
NODE_495_length_3405_cov_44.930127	2683	2759	28	13	76	0.1710526
NODE_495_length_3405_cov_44.930127	2683	2759	29	4	76	0.0526316
NODE_495_length_3405_cov_44.930127	2683	2759	30	12	76	0.1578947
NODE_495_length_3405_cov_44.930127	2683	2759	31	14	76	0.1842105
NODE_495_length_3405_cov_44.930127	2683	2759	32	6	76	0.0789474
NODE_495_length_3405_cov_44.930127	2683	2759	33	2	76	0.0263158
NODE_495_length_3405_cov_44.930127	2683	2759	34	4	76	0.0526316
NODE_495_length_3405_cov_44.930127	2683	2759	35	7	76	0.0921053
NODE_495_length_3405_cov_44.930127	2683	2759	36	3	76	0.0394737
NODE_495_length_3405_cov_44.930127	2683	2759	37	2	76	0.0263158
NODE_495_length_3405_cov_44.930127	2683	2759	38	3	76	0.0394737
NODE_495_length_3405_cov_44.930127	2683	2759	41	5	76	0.0657895
NODE_495_length_3405_cov_44.930127	2683	2759	42	1	76	0.0131579
NODE_495_length_3405_cov_44.930127	3116	3164	6	15	48	0.3125000
NODE_495_length_3405_cov_44.930127	3116	3164	7	25	48	0.5208333
NODE_495_length_3405_cov_44.930127	3116	3164	8	8	48	0.1666667
NODE_496_length_3402_cov_28.961550	128	183	0	55	55	1.0000000
NODE_496_length_3402_cov_28.961550	3154	3234	25	7	80	0.0875000
NODE_496_length_3402_cov_28.961550	3154	3234	26	8	80	0.1000000
NODE_496_length_3402_cov_28.961550	3154	3234	27	3	80	0.0375000
NODE_496_length_3402_cov_28.961550	3154	3234	29	2	80	0.0250000
NODE_496_length_3402_cov_28.961550	3154	3234	30	26	80	0.3250000
NODE_496_length_3402_cov_28.961550	3154	3234	31	4	80	0.0500000
NODE_496_length_3402_cov_28.961550	3154	3234	32	30	80	0.3750000
NODE_496_length_3402_cov_28.961550	3207	3287	0	1	80	0.0125000
NODE_496_length_3402_cov_28.961550	3207	3287	3	1	80	0.0125000
NODE_496_length_3402_cov_28.961550	3207	3287	9	6	80	0.0750000
NODE_496_length_3402_cov_28.961550	3207	3287	15	4	80	0.0500000
NODE_496_length_3402_cov_28.961550	3207	3287	21	13	80	0.1625000
NODE_496_length_3402_cov_28.961550	3207	3287	23	13	80	0.1625000
NODE_496_length_3402_cov_28.961550	3207	3287	25	22	80	0.2750000
NODE_496_length_3402_cov_28.961550	3207	3287	26	8	80	0.1000000
NODE_496_length_3402_cov_28.961550	3207	3287	27	3	80	0.0375000
NODE_496_length_3402_cov_28.961550	3207	3287	29	2	80	0.0250000
NODE_496_length_3402_cov_28.961550	3207	3287	31	4	80	0.0500000
NODE_496_length_3402_cov_28.961550	3207	3287	32	3	80	0.0375000
NODE_498_length_3393_cov_43.623558	1009	1075	5	66	66	1.0000000
NODE_498_length_3393_cov_43.623558	1048	1128	5	37	80	0.4625000
NODE_498_length_3393_cov_43.623558	1048	1128	6	20	80	0.2500000
NODE_498_length_3393_cov_43.623558	1048	1128	7	21	80	0.2625000
NODE_498_length_3393_cov_43.623558	1048	1128	8	2	80	0.0250000
NODE_498_length_3393_cov_43.623558	3086	3128	3	1	42	0.0238095
NODE_498_length_3393_cov_43.623558	3086	3128	5	2	42	0.0476190
NODE_498_length_3393_cov_43.623558	3086	3128	11	2	42	0.0476190
NODE_498_length_3393_cov_43.623558	3086	3128	13	3	42	0.0714286
NODE_498_length_3393_cov_43.623558	3086	3128	21	2	42	0.0476190
NODE_498_length_3393_cov_43.623558	3086	3128	23	6	42	0.1428571
NODE_498_length_3393_cov_43.623558	3086	3128	24	4	42	0.0952381
NODE_498_length_3393_cov_43.623558	3086	3128	25	1	42	0.0238095
NODE_498_length_3393_cov_43.623558	3086	3128	26	3	42	0.0714286
NODE_498_length_3393_cov_43.623558	3086	3128	28	10	42	0.2380952
NODE_498_length_3393_cov_43.623558	3086	3128	30	3	42	0.0714286
NODE_498_length_3393_cov_43.623558	3086	3128	31	4	42	0.0952381
NODE_498_length_3393_cov_43.623558	3086	3128	33	1	42	0.0238095
NODE_498_length_3393_cov_43.623558	3293	3373	20	1	80	0.0125000
NODE_498_length_3393_cov_43.623558	3293	3373	21	8	80	0.1000000
NODE_498_length_3393_cov_43.623558	3293	3373	22	1	80	0.0125000
NODE_498_length_3393_cov_43.623558	3293	3373	23	2	80	0.0250000
NODE_498_length_3393_cov_43.623558	3293	3373	24	7	80	0.0875000
NODE_498_length_3393_cov_43.623558	3293	3373	26	3	80	0.0375000
NODE_498_length_3393_cov_43.623558	3293	3373	28	2	80	0.0250000
NODE_498_length_3393_cov_43.623558	3293	3373	29	2	80	0.0250000
NODE_498_length_3393_cov_43.623558	3293	3373	30	1	80	0.0125000
NODE_498_length_3393_cov_43.623558	3293	3373	32	8	80	0.1000000
NODE_498_length_3393_cov_43.623558	3293	3373	33	3	80	0.0375000
NODE_498_length_3393_cov_43.623558	3293	3373	37	4	80	0.0500000
NODE_498_length_3393_cov_43.623558	3293	3373	39	1	80	0.0125000
NODE_498_length_3393_cov_43.623558	3293	3373	40	8	80	0.1000000
NODE_498_length_3393_cov_43.623558	3293	3373	42	13	80	0.1625000
NODE_498_length_3393_cov_43.623558	3293	3373	44	3	80	0.0375000
NODE_498_length_3393_cov_43.623558	3293	3373	45	1	80	0.0125000
NODE_498_length_3393_cov_43.623558	3293	3373	48	1	80	0.0125000
NODE_498_length_3393_cov_43.623558	3293	3373	51	4	80	0.0500000
NODE_498_length_3393_cov_43.623558	3293	3373	52	7	80	0.0875000
NODE_499_length_3392_cov_41.514728	255	335	11	66	80	0.8250000
NODE_499_length_3392_cov_41.514728	255	335	12	14	80	0.1750000
NODE_499_length_3392_cov_41.514728	308	388	11	20	80	0.2500000
NODE_499_length_3392_cov_41.514728	308	388	12	60	80	0.7500000
NODE_499_length_3392_cov_41.514728	917	997	39	2	80	0.0250000
NODE_499_length_3392_cov_41.514728	917	997	40	8	80	0.1000000
NODE_499_length_3392_cov_41.514728	917	997	41	1	80	0.0125000
NODE_499_length_3392_cov_41.514728	917	997	43	5	80	0.0625000
NODE_499_length_3392_cov_41.514728	917	997	45	1	80	0.0125000
NODE_499_length_3392_cov_41.514728	917	997	46	17	80	0.2125000
NODE_499_length_3392_cov_41.514728	917	997	47	22	80	0.2750000
NODE_499_length_3392_cov_41.514728	917	997	48	5	80	0.0625000
NODE_499_length_3392_cov_41.514728	917	997	49	3	80	0.0375000
NODE_499_length_3392_cov_41.514728	917	997	50	9	80	0.1125000
NODE_499_length_3392_cov_41.514728	917	997	51	4	80	0.0500000
NODE_499_length_3392_cov_41.514728	917	997	52	3	80	0.0375000
NODE_499_length_3392_cov_41.514728	970	1053	17	1	83	0.0120482
NODE_499_length_3392_cov_41.514728	970	1053	18	5	83	0.0602410
NODE_499_length_3392_cov_41.514728	970	1053	19	5	83	0.0602410
NODE_499_length_3392_cov_41.514728	970	1053	21	6	83	0.0722892
NODE_499_length_3392_cov_41.514728	970	1053	22	10	83	0.1204819
NODE_499_length_3392_cov_41.514728	970	1053	23	17	83	0.2048193
NODE_499_length_3392_cov_41.514728	970	1053	25	1	83	0.0120482
NODE_499_length_3392_cov_41.514728	970	1053	26	1	83	0.0120482
NODE_499_length_3392_cov_41.514728	970	1053	28	2	83	0.0240964
NODE_499_length_3392_cov_41.514728	970	1053	30	2	83	0.0240964
NODE_499_length_3392_cov_41.514728	970	1053	31	2	83	0.0240964
NODE_499_length_3392_cov_41.514728	970	1053	33	2	83	0.0240964
NODE_499_length_3392_cov_41.514728	970	1053	39	4	83	0.0481928
NODE_499_length_3392_cov_41.514728	970	1053	40	8	83	0.0963855
NODE_499_length_3392_cov_41.514728	970	1053	41	1	83	0.0120482
NODE_499_length_3392_cov_41.514728	970	1053	43	5	83	0.0602410
NODE_499_length_3392_cov_41.514728	970	1053	45	1	83	0.0120482
NODE_499_length_3392_cov_41.514728	970	1053	46	8	83	0.0963855
NODE_499_length_3392_cov_41.514728	970	1053	47	2	83	0.0240964
NODE_501_length_3389_cov_8.244073	2159	2239	6	10	80	0.1250000
NODE_501_length_3389_cov_8.244073	2159	2239	7	19	80	0.2375000
NODE_501_length_3389_cov_8.244073	2159	2239	8	22	80	0.2750000
NODE_501_length_3389_cov_8.244073	2159	2239	9	25	80	0.3125000
NODE_501_length_3389_cov_8.244073	2159	2239	10	4	80	0.0500000
NODE_501_length_3389_cov_8.244073	2212	2292	3	12	80	0.1500000
NODE_501_length_3389_cov_8.244073	2212	2292	5	13	80	0.1625000
NODE_501_length_3389_cov_8.244073	2212	2292	6	38	80	0.4750000
NODE_501_length_3389_cov_8.244073	2212	2292	8	11	80	0.1375000
NODE_501_length_3389_cov_8.244073	2212	2292	9	2	80	0.0250000
NODE_501_length_3389_cov_8.244073	2212	2292	10	4	80	0.0500000
NODE_506_length_3363_cov_4.412684	56	124	0	68	68	1.0000000
NODE_510_length_3353_cov_2.687462	0	61	0	61	61	1.0000000
NODE_510_length_3353_cov_2.687462	0	61	0	61	61	1.0000000
NODE_510_length_3353_cov_2.687462	34	99	0	65	65	1.0000000
NODE_513_length_3348_cov_243.959372	2473	2553	70	4	80	0.0500000
NODE_513_length_3348_cov_243.959372	2473	2553	71	8	80	0.1000000
NODE_513_length_3348_cov_243.959372	2473	2553	72	3	80	0.0375000
NODE_513_length_3348_cov_243.959372	2473	2553	74	1	80	0.0125000
NODE_513_length_3348_cov_243.959372	2473	2553	75	1	80	0.0125000
NODE_513_length_3348_cov_243.959372	2473	2553	78	3	80	0.0375000
NODE_513_length_3348_cov_243.959372	2473	2553	79	7	80	0.0875000
NODE_513_length_3348_cov_243.959372	2473	2553	80	2	80	0.0250000
NODE_513_length_3348_cov_243.959372	2473	2553	81	5	80	0.0625000
NODE_513_length_3348_cov_243.959372	2473	2553	82	9	80	0.1125000
NODE_513_length_3348_cov_243.959372	2473	2553	83	7	80	0.0875000
NODE_513_length_3348_cov_243.959372	2473	2553	84	12	80	0.1500000
NODE_513_length_3348_cov_243.959372	2473	2553	86	4	80	0.0500000
NODE_513_length_3348_cov_243.959372	2473	2553	87	2	80	0.0250000
NODE_513_length_3348_cov_243.959372	2473	2553	88	5	80	0.0625000
NODE_513_length_3348_cov_243.959372	2473	2553	89	1	80	0.0125000
NODE_513_length_3348_cov_243.959372	2473	2553	90	6	80	0.0750000
NODE_513_length_3348_cov_243.959372	2526	2606	56	6	80	0.0750000
NODE_513_length_3348_cov_243.959372	2526	2606	57	5	80	0.0625000
NODE_513_length_3348_cov_243.959372	2526	2606	58	2	80	0.0250000
NODE_513_length_3348_cov_243.959372	2526	2606	59	2	80	0.0250000
NODE_513_length_3348_cov_243.959372	2526	2606	60	1	80	0.0125000
NODE_513_length_3348_cov_243.959372	2526	2606	61	5	80	0.0625000
NODE_513_length_3348_cov_243.959372	2526	2606	62	6	80	0.0750000
NODE_513_length_3348_cov_243.959372	2526	2606	64	1	80	0.0125000
NODE_513_length_3348_cov_243.959372	2526	2606	65	1	80	0.0125000
NODE_513_length_3348_cov_243.959372	2526	2606	66	1	80	0.0125000
NODE_513_length_3348_cov_243.959372	2526	2606	68	1	80	0.0125000
NODE_513_length_3348_cov_243.959372	2526	2606	69	3	80	0.0375000
NODE_513_length_3348_cov_243.959372	2526	2606	70	4	80	0.0500000
NODE_513_length_3348_cov_243.959372	2526	2606	71	11	80	0.1375000
NODE_513_length_3348_cov_243.959372	2526	2606	72	4	80	0.0500000
NODE_513_length_3348_cov_243.959372	2526	2606	73	1	80	0.0125000
NODE_513_length_3348_cov_243.959372	2526	2606	74	1	80	0.0125000
NODE_513_length_3348_cov_243.959372	2526	2606	75	15	80	0.1875000
NODE_513_length_3348_cov_243.959372	2526	2606	78	3	80	0.0375000
NODE_513_length_3348_cov_243.959372	2526	2606	79	7	80	0.0875000
NODE_514_length_3348_cov_31.953216	103	183	12	15	80	0.1875000
NODE_514_length_3348_cov_31.953216	103	183	14	1	80	0.0125000
NODE_514_length_3348_cov_31.953216	103	183	16	14	80	0.1750000
NODE_514_length_3348_cov_31.953216	103	183	17	3	80	0.0375000
NODE_514_length_3348_cov_31.953216	103	183	19	1	80	0.0125000
NODE_514_length_3348_cov_31.953216	103	183	20	13	80	0.1625000
NODE_514_length_3348_cov_31.953216	103	183	21	1	80	0.0125000
NODE_514_length_3348_cov_31.953216	103	183	22	17	80	0.2125000
NODE_514_length_3348_cov_31.953216	103	183	23	15	80	0.1875000
NODE_514_length_3348_cov_31.953216	105	179	12	13	74	0.1756757
NODE_514_length_3348_cov_31.953216	105	179	14	1	74	0.0135135
NODE_514_length_3348_cov_31.953216	105	179	16	14	74	0.1891892
NODE_514_length_3348_cov_31.953216	105	179	17	3	74	0.0405405
NODE_514_length_3348_cov_31.953216	105	179	19	1	74	0.0135135
NODE_514_length_3348_cov_31.953216	105	179	20	13	74	0.1756757
NODE_514_length_3348_cov_31.953216	105	179	21	1	74	0.0135135
NODE_514_length_3348_cov_31.953216	105	179	22	13	74	0.1756757
NODE_514_length_3348_cov_31.953216	105	179	23	15	74	0.2027027
NODE_514_length_3348_cov_31.953216	156	236	16	4	80	0.0500000
NODE_514_length_3348_cov_31.953216	156	236	18	2	80	0.0250000
NODE_514_length_3348_cov_31.953216	156	236	19	6	80	0.0750000
NODE_514_length_3348_cov_31.953216	156	236	20	6	80	0.0750000
NODE_514_length_3348_cov_31.953216	156	236	21	22	80	0.2750000
NODE_514_length_3348_cov_31.953216	156	236	22	21	80	0.2625000
NODE_514_length_3348_cov_31.953216	156	236	23	19	80	0.2375000
NODE_514_length_3348_cov_31.953216	156	236	16	4	80	0.0500000
NODE_514_length_3348_cov_31.953216	156	236	18	2	80	0.0250000
NODE_514_length_3348_cov_31.953216	156	236	19	6	80	0.0750000
NODE_514_length_3348_cov_31.953216	156	236	20	6	80	0.0750000
NODE_514_length_3348_cov_31.953216	156	236	21	22	80	0.2750000
NODE_514_length_3348_cov_31.953216	156	236	22	21	80	0.2625000
NODE_514_length_3348_cov_31.953216	156	236	23	19	80	0.2375000
NODE_514_length_3348_cov_31.953216	2405	2476	6	6	71	0.0845070
NODE_514_length_3348_cov_31.953216	2405	2476	7	4	71	0.0563380
NODE_514_length_3348_cov_31.953216	2405	2476	8	1	71	0.0140845
NODE_514_length_3348_cov_31.953216	2405	2476	9	13	71	0.1830986
NODE_514_length_3348_cov_31.953216	2405	2476	11	4	71	0.0563380
NODE_514_length_3348_cov_31.953216	2405	2476	12	41	71	0.5774648
NODE_514_length_3348_cov_31.953216	2405	2476	13	2	71	0.0281690
NODE_514_length_3348_cov_31.953216	2458	2529	12	23	71	0.3239437
NODE_514_length_3348_cov_31.953216	2458	2529	13	48	71	0.6760563
NODE_517_length_3335_cov_19.649567	2100	2180	4	23	80	0.2875000
NODE_517_length_3335_cov_19.649567	2100	2180	5	57	80	0.7125000
NODE_517_length_3335_cov_19.649567	2153	2233	4	28	80	0.3500000
NODE_517_length_3335_cov_19.649567	2153	2233	5	29	80	0.3625000
NODE_517_length_3335_cov_19.649567	2153	2233	6	23	80	0.2875000
NODE_517_length_3335_cov_19.649567	2229	2309	3	66	80	0.8250000
NODE_517_length_3335_cov_19.649567	2229	2309	4	1	80	0.0125000
NODE_517_length_3335_cov_19.649567	2229	2309	6	13	80	0.1625000
NODE_517_length_3335_cov_19.649567	2282	2362	0	2	80	0.0250000
NODE_517_length_3335_cov_19.649567	2282	2362	2	32	80	0.4000000
NODE_517_length_3335_cov_19.649567	2282	2362	3	46	80	0.5750000
NODE_518_length_3333_cov_24.805504	734	814	2	31	80	0.3875000
NODE_518_length_3333_cov_24.805504	734	814	4	34	80	0.4250000
NODE_518_length_3333_cov_24.805504	734	814	6	5	80	0.0625000
NODE_518_length_3333_cov_24.805504	734	814	7	10	80	0.1250000
NODE_518_length_3333_cov_24.805504	787	867	4	12	80	0.1500000
NODE_518_length_3333_cov_24.805504	787	867	6	34	80	0.4250000
NODE_518_length_3333_cov_24.805504	787	867	7	15	80	0.1875000
NODE_518_length_3333_cov_24.805504	787	867	8	19	80	0.2375000
NODE_523_length_3312_cov_6.996576	85	165	4	59	80	0.7375000
NODE_523_length_3312_cov_6.996576	85	165	5	17	80	0.2125000
NODE_523_length_3312_cov_6.996576	85	165	6	4	80	0.0500000
NODE_523_length_3312_cov_6.996576	138	218	4	43	80	0.5375000
NODE_523_length_3312_cov_6.996576	138	218	5	24	80	0.3000000
NODE_523_length_3312_cov_6.996576	138	218	6	13	80	0.1625000
NODE_525_length_3302_cov_3.859195	3184	3262	0	78	78	1.0000000
NODE_525_length_3302_cov_3.859195	3184	3253	0	69	69	1.0000000
NODE_526_length_3299_cov_6.014687	1632	1688	0	19	56	0.3392857
NODE_526_length_3299_cov_6.014687	1632	1688	1	17	56	0.3035714
NODE_526_length_3299_cov_6.014687	1632	1688	2	20	56	0.3571429
NODE_530_length_3290_cov_17.805390	773	853	17	11	80	0.1375000
NODE_530_length_3290_cov_17.805390	773	853	18	11	80	0.1375000
NODE_530_length_3290_cov_17.805390	773	853	19	10	80	0.1250000
NODE_530_length_3290_cov_17.805390	773	853	20	10	80	0.1250000
NODE_530_length_3290_cov_17.805390	773	853	21	4	80	0.0500000
NODE_530_length_3290_cov_17.805390	773	853	22	9	80	0.1125000
NODE_530_length_3290_cov_17.805390	773	853	23	25	80	0.3125000
NODE_530_length_3290_cov_17.805390	826	906	12	1	80	0.0125000
NODE_530_length_3290_cov_17.805390	826	906	13	5	80	0.0625000
NODE_530_length_3290_cov_17.805390	826	906	14	4	80	0.0500000
NODE_530_length_3290_cov_17.805390	826	906	15	14	80	0.1750000
NODE_530_length_3290_cov_17.805390	826	906	18	3	80	0.0375000
NODE_530_length_3290_cov_17.805390	826	906	19	15	80	0.1875000
NODE_530_length_3290_cov_17.805390	826	906	20	5	80	0.0625000
NODE_530_length_3290_cov_17.805390	826	906	21	2	80	0.0250000
NODE_530_length_3290_cov_17.805390	826	906	22	13	80	0.1625000
NODE_530_length_3290_cov_17.805390	826	906	23	18	80	0.2250000
NODE_531_length_3290_cov_12.352554	2749	2829	5	26	80	0.3250000
NODE_531_length_3290_cov_12.352554	2749	2829	7	46	80	0.5750000
NODE_531_length_3290_cov_12.352554	2749	2829	8	8	80	0.1000000
NODE_531_length_3290_cov_12.352554	2802	2882	4	12	80	0.1500000
NODE_531_length_3290_cov_12.352554	2802	2882	5	1	80	0.0125000
NODE_531_length_3290_cov_12.352554	2802	2882	6	8	80	0.1000000
NODE_531_length_3290_cov_12.352554	2802	2882	7	50	80	0.6250000
NODE_531_length_3290_cov_12.352554	2802	2882	8	9	80	0.1125000
NODE_532_length_3286_cov_5.973015	0	50	0	50	50	1.0000000
NODE_532_length_3286_cov_5.973015	0	50	0	50	50	1.0000000
NODE_532_length_3286_cov_5.973015	0	50	0	50	50	1.0000000
NODE_532_length_3286_cov_5.973015	23	89	0	66	66	1.0000000
NODE_532_length_3286_cov_5.973015	23	94	0	71	71	1.0000000
NODE_533_length_3284_cov_6.453689	313	392	12	5	79	0.0632911
NODE_533_length_3284_cov_6.453689	313	392	14	48	79	0.6075949
NODE_533_length_3284_cov_6.453689	313	392	16	26	79	0.3291139
NODE_533_length_3284_cov_6.453689	365	445	7	5	80	0.0625000
NODE_533_length_3284_cov_6.453689	365	445	8	22	80	0.2750000
NODE_533_length_3284_cov_6.453689	365	445	9	13	80	0.1625000
NODE_533_length_3284_cov_6.453689	365	445	10	3	80	0.0375000
NODE_533_length_3284_cov_6.453689	365	445	12	15	80	0.1875000
NODE_533_length_3284_cov_6.453689	365	445	14	22	80	0.2750000
NODE_541_length_3267_cov_12.768624	11	91	6	6	80	0.0750000
NODE_541_length_3267_cov_12.768624	11	91	7	12	80	0.1500000
NODE_541_length_3267_cov_12.768624	11	91	9	5	80	0.0625000
NODE_541_length_3267_cov_12.768624	11	91	10	5	80	0.0625000
NODE_541_length_3267_cov_12.768624	11	91	11	2	80	0.0250000
NODE_541_length_3267_cov_12.768624	11	91	13	5	80	0.0625000
NODE_541_length_3267_cov_12.768624	11	91	14	6	80	0.0750000
NODE_541_length_3267_cov_12.768624	11	91	16	7	80	0.0875000
NODE_541_length_3267_cov_12.768624	11	91	17	4	80	0.0500000
NODE_541_length_3267_cov_12.768624	11	91	18	11	80	0.1375000
NODE_541_length_3267_cov_12.768624	11	91	20	9	80	0.1125000
NODE_541_length_3267_cov_12.768624	11	91	21	6	80	0.0750000
NODE_541_length_3267_cov_12.768624	11	91	23	2	80	0.0250000
NODE_542_length_3266_cov_14.108304	2620	2684	0	64	64	1.0000000
NODE_542_length_3266_cov_14.108304	2620	2684	0	64	64	1.0000000
NODE_542_length_3266_cov_14.108304	2620	2684	0	64	64	1.0000000
NODE_547_length_3242_cov_12.407891	391	471	6	10	80	0.1250000
NODE_547_length_3242_cov_12.407891	391	471	7	6	80	0.0750000
NODE_547_length_3242_cov_12.407891	391	471	8	2	80	0.0250000
NODE_547_length_3242_cov_12.407891	391	471	9	26	80	0.3250000
NODE_547_length_3242_cov_12.407891	391	471	10	20	80	0.2500000
NODE_547_length_3242_cov_12.407891	391	471	12	16	80	0.2000000
NODE_547_length_3242_cov_12.407891	444	524	7	6	80	0.0750000
NODE_547_length_3242_cov_12.407891	444	524	8	2	80	0.0250000
NODE_547_length_3242_cov_12.407891	444	524	10	3	80	0.0375000
NODE_547_length_3242_cov_12.407891	444	524	12	50	80	0.6250000
NODE_547_length_3242_cov_12.407891	444	524	13	19	80	0.2375000
NODE_550_length_3233_cov_19.903957	411	491	5	52	80	0.6500000
NODE_550_length_3233_cov_19.903957	411	491	6	28	80	0.3500000
NODE_550_length_3233_cov_19.903957	411	491	5	52	80	0.6500000
NODE_550_length_3233_cov_19.903957	411	491	6	28	80	0.3500000
NODE_550_length_3233_cov_19.903957	464	544	4	31	80	0.3875000
NODE_550_length_3233_cov_19.903957	464	544	5	37	80	0.4625000
NODE_550_length_3233_cov_19.903957	464	544	6	12	80	0.1500000
NODE_552_length_3232_cov_11.378870	2586	2621	0	35	35	1.0000000
NODE_555_length_3214_cov_22.853291	2090	2170	12	6	80	0.0750000
NODE_555_length_3214_cov_22.853291	2090	2170	13	10	80	0.1250000
NODE_555_length_3214_cov_22.853291	2090	2170	15	30	80	0.3750000
NODE_555_length_3214_cov_22.853291	2090	2170	18	16	80	0.2000000
NODE_555_length_3214_cov_22.853291	2090	2170	20	18	80	0.2250000
NODE_555_length_3214_cov_22.853291	2143	2223	12	12	80	0.1500000
NODE_555_length_3214_cov_22.853291	2143	2223	17	21	80	0.2625000
NODE_555_length_3214_cov_22.853291	2143	2223	18	16	80	0.2000000
NODE_555_length_3214_cov_22.853291	2143	2223	19	3	80	0.0375000
NODE_555_length_3214_cov_22.853291	2143	2223	20	22	80	0.2750000
NODE_555_length_3214_cov_22.853291	2143	2223	21	6	80	0.0750000
NODE_555_length_3214_cov_22.853291	3028	3086	0	58	58	1.0000000
NODE_556_length_3211_cov_1.921915	95	175	0	80	80	1.0000000
NODE_556_length_3211_cov_1.921915	148	178	0	30	30	1.0000000
NODE_557_length_3210_cov_7.428480	2040	2111	0	9	71	0.1267606
NODE_557_length_3210_cov_7.428480	2040	2111	1	17	71	0.2394366
NODE_557_length_3210_cov_7.428480	2040	2111	2	45	71	0.6338028
NODE_557_length_3210_cov_7.428480	2084	2164	2	80	80	1.0000000
NODE_557_length_3210_cov_7.428480	2715	2797	1	82	82	1.0000000
NODE_557_length_3210_cov_7.428480	2770	2850	1	80	80	1.0000000
NODE_562_length_3201_cov_3.591231	3120	3200	0	80	80	1.0000000
NODE_566_length_3189_cov_69.446602	137	188	0	51	51	1.0000000
NODE_567_length_3188_cov_7.233085	1663	1743	2	17	80	0.2125000
NODE_567_length_3188_cov_7.233085	1663	1743	4	4	80	0.0500000
NODE_567_length_3188_cov_7.233085	1663	1743	5	6	80	0.0750000
NODE_567_length_3188_cov_7.233085	1663	1743	6	13	80	0.1625000
NODE_567_length_3188_cov_7.233085	1663	1743	7	10	80	0.1250000
NODE_567_length_3188_cov_7.233085	1663	1743	8	30	80	0.3750000
NODE_567_length_3188_cov_7.233085	1716	1796	7	19	80	0.2375000
NODE_567_length_3188_cov_7.233085	1716	1796	8	61	80	0.7625000
NODE_570_length_3177_cov_2.789474	2021	2042	0	21	21	1.0000000
NODE_575_length_3158_cov_19.018960	840	920	0	13	80	0.1625000
NODE_575_length_3158_cov_19.018960	840	920	2	16	80	0.2000000
NODE_575_length_3158_cov_19.018960	840	920	3	19	80	0.2375000
NODE_575_length_3158_cov_19.018960	840	920	4	32	80	0.4000000
NODE_575_length_3158_cov_19.018960	893	973	4	80	80	1.0000000
NODE_575_length_3158_cov_19.018960	2833	2915	0	82	82	1.0000000
NODE_575_length_3158_cov_19.018960	2888	2959	0	71	71	1.0000000
NODE_576_length_3150_cov_26.520813	770	850	33	10	80	0.1250000
NODE_576_length_3150_cov_26.520813	770	850	34	10	80	0.1250000
NODE_576_length_3150_cov_26.520813	770	850	35	23	80	0.2875000
NODE_576_length_3150_cov_26.520813	770	850	36	20	80	0.2500000
NODE_576_length_3150_cov_26.520813	770	850	37	2	80	0.0250000
NODE_576_length_3150_cov_26.520813	770	850	38	14	80	0.1750000
NODE_576_length_3150_cov_26.520813	770	850	40	1	80	0.0125000
NODE_576_length_3150_cov_26.520813	823	901	23	4	78	0.0512821
NODE_576_length_3150_cov_26.520813	823	901	24	18	78	0.2307692
NODE_576_length_3150_cov_26.520813	823	901	27	1	78	0.0128205
NODE_576_length_3150_cov_26.520813	823	901	28	6	78	0.0769231
NODE_576_length_3150_cov_26.520813	823	901	29	2	78	0.0256410
NODE_576_length_3150_cov_26.520813	823	901	30	3	78	0.0384615
NODE_576_length_3150_cov_26.520813	823	901	31	2	78	0.0256410
NODE_576_length_3150_cov_26.520813	823	901	33	1	78	0.0128205
NODE_576_length_3150_cov_26.520813	823	901	34	9	78	0.1153846
NODE_576_length_3150_cov_26.520813	823	901	35	11	78	0.1410256
NODE_576_length_3150_cov_26.520813	823	901	36	3	78	0.0384615
NODE_576_length_3150_cov_26.520813	823	901	37	1	78	0.0128205
NODE_576_length_3150_cov_26.520813	823	901	38	16	78	0.2051282
NODE_576_length_3150_cov_26.520813	823	901	40	1	78	0.0128205
NODE_576_length_3150_cov_26.520813	2616	2696	6	9	80	0.1125000
NODE_576_length_3150_cov_26.520813	2616	2696	7	19	80	0.2375000
NODE_576_length_3150_cov_26.520813	2616	2696	8	32	80	0.4000000
NODE_576_length_3150_cov_26.520813	2616	2696	10	20	80	0.2500000
NODE_576_length_3150_cov_26.520813	2669	2749	7	7	80	0.0875000
NODE_576_length_3150_cov_26.520813	2669	2749	8	73	80	0.9125000
NODE_577_length_3150_cov_5.923959	2313	2393	3	4	80	0.0500000
NODE_577_length_3150_cov_5.923959	2313	2393	4	76	80	0.9500000
NODE_579_length_3148_cov_2.313873	3053	3105	0	52	52	1.0000000
NODE_581_length_3146_cov_18.277322	2418	2498	4	62	80	0.7750000
NODE_581_length_3146_cov_18.277322	2418	2498	5	1	80	0.0125000
NODE_581_length_3146_cov_18.277322	2418	2498	6	17	80	0.2125000
NODE_581_length_3146_cov_18.277322	2471	2551	4	10	80	0.1250000
NODE_581_length_3146_cov_18.277322	2471	2551	6	17	80	0.2125000
NODE_581_length_3146_cov_18.277322	2471	2551	8	1	80	0.0125000
NODE_581_length_3146_cov_18.277322	2471	2551	9	1	80	0.0125000
NODE_581_length_3146_cov_18.277322	2471	2551	13	9	80	0.1125000
NODE_581_length_3146_cov_18.277322	2471	2551	14	16	80	0.2000000
NODE_581_length_3146_cov_18.277322	2471	2551	17	2	80	0.0250000
NODE_581_length_3146_cov_18.277322	2471	2551	18	3	80	0.0375000
NODE_581_length_3146_cov_18.277322	2471	2551	20	3	80	0.0375000
NODE_581_length_3146_cov_18.277322	2471	2551	22	1	80	0.0125000
NODE_581_length_3146_cov_18.277322	2471	2551	23	1	80	0.0125000
NODE_581_length_3146_cov_18.277322	2471	2551	25	3	80	0.0375000
NODE_581_length_3146_cov_18.277322	2471	2551	26	6	80	0.0750000
NODE_581_length_3146_cov_18.277322	2471	2551	27	2	80	0.0250000
NODE_581_length_3146_cov_18.277322	2471	2551	28	3	80	0.0375000
NODE_581_length_3146_cov_18.277322	2471	2551	31	1	80	0.0125000
NODE_581_length_3146_cov_18.277322	2471	2551	35	1	80	0.0125000
NODE_581_length_3146_cov_18.277322	2547	2627	28	2	80	0.0250000
NODE_581_length_3146_cov_18.277322	2547	2627	31	1	80	0.0125000
NODE_581_length_3146_cov_18.277322	2547	2627	35	4	80	0.0500000
NODE_581_length_3146_cov_18.277322	2547	2627	39	3	80	0.0375000
NODE_581_length_3146_cov_18.277322	2547	2627	40	1	80	0.0125000
NODE_581_length_3146_cov_18.277322	2547	2627	41	1	80	0.0125000
NODE_581_length_3146_cov_18.277322	2547	2627	42	2	80	0.0250000
NODE_581_length_3146_cov_18.277322	2547	2627	43	1	80	0.0125000
NODE_581_length_3146_cov_18.277322	2547	2627	44	1	80	0.0125000
NODE_581_length_3146_cov_18.277322	2547	2627	48	2	80	0.0250000
NODE_581_length_3146_cov_18.277322	2547	2627	49	3	80	0.0375000
NODE_581_length_3146_cov_18.277322	2547	2627	52	2	80	0.0250000
NODE_581_length_3146_cov_18.277322	2547	2627	53	5	80	0.0625000
NODE_581_length_3146_cov_18.277322	2547	2627	56	1	80	0.0125000
NODE_581_length_3146_cov_18.277322	2547	2627	57	1	80	0.0125000
NODE_581_length_3146_cov_18.277322	2547	2627	58	5	80	0.0625000
NODE_581_length_3146_cov_18.277322	2547	2627	59	2	80	0.0250000
NODE_581_length_3146_cov_18.277322	2547	2627	60	1	80	0.0125000
NODE_581_length_3146_cov_18.277322	2547	2627	61	1	80	0.0125000
NODE_581_length_3146_cov_18.277322	2547	2627	63	1	80	0.0125000
NODE_581_length_3146_cov_18.277322	2547	2627	66	4	80	0.0500000
NODE_581_length_3146_cov_18.277322	2547	2627	67	1	80	0.0125000
NODE_581_length_3146_cov_18.277322	2547	2627	69	2	80	0.0250000
NODE_581_length_3146_cov_18.277322	2547	2627	70	1	80	0.0125000
NODE_581_length_3146_cov_18.277322	2547	2627	71	2	80	0.0250000
NODE_581_length_3146_cov_18.277322	2547	2627	74	1	80	0.0125000
NODE_581_length_3146_cov_18.277322	2547	2627	75	1	80	0.0125000
NODE_581_length_3146_cov_18.277322	2547	2627	80	3	80	0.0375000
NODE_581_length_3146_cov_18.277322	2547	2627	81	1	80	0.0125000
NODE_581_length_3146_cov_18.277322	2547	2627	83	1	80	0.0125000
NODE_581_length_3146_cov_18.277322	2547	2627	85	2	80	0.0250000
NODE_581_length_3146_cov_18.277322	2547	2627	86	3	80	0.0375000
NODE_581_length_3146_cov_18.277322	2547	2627	88	5	80	0.0625000
NODE_581_length_3146_cov_18.277322	2547	2627	92	1	80	0.0125000
NODE_581_length_3146_cov_18.277322	2547	2627	93	1	80	0.0125000
NODE_581_length_3146_cov_18.277322	2547	2627	94	1	80	0.0125000
NODE_581_length_3146_cov_18.277322	2547	2627	95	3	80	0.0375000
NODE_581_length_3146_cov_18.277322	2547	2627	97	5	80	0.0625000
NODE_581_length_3146_cov_18.277322	2547	2627	99	1	80	0.0125000
NODE_581_length_3146_cov_18.277322	2547	2627	105	1	80	0.0125000
NODE_581_length_3146_cov_18.277322	2600	2680	80	2	80	0.0250000
NODE_581_length_3146_cov_18.277322	2600	2680	81	1	80	0.0125000
NODE_581_length_3146_cov_18.277322	2600	2680	83	1	80	0.0125000
NODE_581_length_3146_cov_18.277322	2600	2680	85	2	80	0.0250000
NODE_581_length_3146_cov_18.277322	2600	2680	86	3	80	0.0375000
NODE_581_length_3146_cov_18.277322	2600	2680	88	5	80	0.0625000
NODE_581_length_3146_cov_18.277322	2600	2680	92	1	80	0.0125000
NODE_581_length_3146_cov_18.277322	2600	2680	93	1	80	0.0125000
NODE_581_length_3146_cov_18.277322	2600	2680	94	1	80	0.0125000
NODE_581_length_3146_cov_18.277322	2600	2680	95	3	80	0.0375000
NODE_581_length_3146_cov_18.277322	2600	2680	97	5	80	0.0625000
NODE_581_length_3146_cov_18.277322	2600	2680	99	1	80	0.0125000
NODE_581_length_3146_cov_18.277322	2600	2680	103	11	80	0.1375000
NODE_581_length_3146_cov_18.277322	2600	2680	104	10	80	0.1250000
NODE_581_length_3146_cov_18.277322	2600	2680	105	7	80	0.0875000
NODE_581_length_3146_cov_18.277322	2600	2680	106	6	80	0.0750000
NODE_581_length_3146_cov_18.277322	2600	2680	107	12	80	0.1500000
NODE_581_length_3146_cov_18.277322	2600	2680	108	3	80	0.0375000
NODE_581_length_3146_cov_18.277322	2600	2680	110	5	80	0.0625000
NODE_581_length_3146_cov_18.277322	2975	3055	0	80	80	1.0000000
NODE_585_length_3134_cov_8.717957	1290	1362	3	72	72	1.0000000
NODE_585_length_3134_cov_8.717957	1335	1415	3	31	80	0.3875000
NODE_585_length_3134_cov_8.717957	1335	1415	4	23	80	0.2875000
NODE_585_length_3134_cov_8.717957	1335	1415	5	15	80	0.1875000
NODE_585_length_3134_cov_8.717957	1335	1415	6	3	80	0.0375000
NODE_585_length_3134_cov_8.717957	1335	1415	7	8	80	0.1000000
NODE_586_length_3131_cov_26.910620	232	312	2	40	80	0.5000000
NODE_586_length_3131_cov_26.910620	232	312	3	16	80	0.2000000
NODE_586_length_3131_cov_26.910620	232	312	4	9	80	0.1125000
NODE_586_length_3131_cov_26.910620	232	312	6	15	80	0.1875000
NODE_586_length_3131_cov_26.910620	285	364	2	6	79	0.0759494
NODE_586_length_3131_cov_26.910620	285	364	3	16	79	0.2025317
NODE_586_length_3131_cov_26.910620	285	364	4	4	79	0.0506329
NODE_586_length_3131_cov_26.910620	285	364	6	53	79	0.6708861
NODE_586_length_3131_cov_26.910620	2151	2231	2	1	80	0.0125000
NODE_586_length_3131_cov_26.910620	2151	2231	3	34	80	0.4250000
NODE_586_length_3131_cov_26.910620	2151	2231	9	19	80	0.2375000
NODE_586_length_3131_cov_26.910620	2151	2231	10	26	80	0.3250000
NODE_586_length_3131_cov_26.910620	2155	2227	2	1	72	0.0138889
NODE_586_length_3131_cov_26.910620	2155	2227	3	30	72	0.4166667
NODE_586_length_3131_cov_26.910620	2155	2227	9	19	72	0.2638889
NODE_586_length_3131_cov_26.910620	2155	2227	10	22	72	0.3055556
NODE_586_length_3131_cov_26.910620	2204	2284	9	7	80	0.0875000
NODE_586_length_3131_cov_26.910620	2204	2284	10	43	80	0.5375000
NODE_586_length_3131_cov_26.910620	2204	2284	11	8	80	0.1000000
NODE_586_length_3131_cov_26.910620	2204	2284	16	6	80	0.0750000
NODE_586_length_3131_cov_26.910620	2204	2284	17	16	80	0.2000000
NODE_586_length_3131_cov_26.910620	2208	2284	9	6	76	0.0789474
NODE_586_length_3131_cov_26.910620	2208	2284	10	40	76	0.5263158
NODE_586_length_3131_cov_26.910620	2208	2284	11	8	76	0.1052632
NODE_586_length_3131_cov_26.910620	2208	2284	16	6	76	0.0789474
NODE_586_length_3131_cov_26.910620	2208	2284	17	16	76	0.2105263
NODE_586_length_3131_cov_26.910620	2280	2360	9	11	80	0.1375000
NODE_586_length_3131_cov_26.910620	2280	2360	10	13	80	0.1625000
NODE_586_length_3131_cov_26.910620	2280	2360	14	1	80	0.0125000
NODE_586_length_3131_cov_26.910620	2280	2360	15	17	80	0.2125000
NODE_586_length_3131_cov_26.910620	2280	2360	16	38	80	0.4750000
NODE_586_length_3131_cov_26.910620	2333	2413	1	1	80	0.0125000
NODE_586_length_3131_cov_26.910620	2333	2413	7	23	80	0.2875000
NODE_586_length_3131_cov_26.910620	2333	2413	9	40	80	0.5000000
NODE_586_length_3131_cov_26.910620	2333	2413	10	13	80	0.1625000
NODE_586_length_3131_cov_26.910620	2333	2413	14	1	80	0.0125000
NODE_586_length_3131_cov_26.910620	2333	2413	15	2	80	0.0250000
NODE_590_length_3118_cov_5.059622	367	445	6	65	78	0.8333333
NODE_590_length_3118_cov_5.059622	367	445	9	1	78	0.0128205
NODE_590_length_3118_cov_5.059622	367	445	10	12	78	0.1538462
NODE_590_length_3118_cov_5.059622	418	498	4	18	80	0.2250000
NODE_590_length_3118_cov_5.059622	418	498	5	10	80	0.1250000
NODE_590_length_3118_cov_5.059622	418	498	6	52	80	0.6500000
NODE_591_length_3117_cov_5.938038	2525	2605	1	80	80	1.0000000
NODE_591_length_3117_cov_5.938038	2578	2658	0	9	80	0.1125000
NODE_591_length_3117_cov_5.938038	2578	2658	1	71	80	0.8875000
NODE_595_length_3110_cov_31.733643	2864	2923	3	16	59	0.2711864
NODE_595_length_3110_cov_31.733643	2864	2923	4	23	59	0.3898305
NODE_595_length_3110_cov_31.733643	2864	2923	6	20	59	0.3389831
NODE_602_length_3093_cov_54.559786	571	651	5	9	80	0.1125000
NODE_602_length_3093_cov_54.559786	571	651	6	8	80	0.1000000
NODE_602_length_3093_cov_54.559786	571	651	7	9	80	0.1125000
NODE_602_length_3093_cov_54.559786	571	651	8	54	80	0.6750000
NODE_602_length_3093_cov_54.559786	624	704	0	4	80	0.0500000
NODE_602_length_3093_cov_54.559786	624	704	1	1	80	0.0125000
NODE_602_length_3093_cov_54.559786	624	704	8	75	80	0.9375000
NODE_602_length_3093_cov_54.559786	2901	2981	8	25	80	0.3125000
NODE_602_length_3093_cov_54.559786	2901	2981	9	7	80	0.0875000
NODE_602_length_3093_cov_54.559786	2901	2981	10	48	80	0.6000000
NODE_602_length_3093_cov_54.559786	2954	3034	5	20	80	0.2500000
NODE_602_length_3093_cov_54.559786	2954	3034	6	7	80	0.0875000
NODE_602_length_3093_cov_54.559786	2954	3034	7	17	80	0.2125000
NODE_602_length_3093_cov_54.559786	2954	3034	8	3	80	0.0375000
NODE_602_length_3093_cov_54.559786	2954	3034	10	33	80	0.4125000
NODE_603_length_3091_cov_35.895722	1743	1804	4	61	61	1.0000000
NODE_603_length_3091_cov_35.895722	1777	1857	4	80	80	1.0000000
NODE_603_length_3091_cov_35.895722	2472	2535	3	1	63	0.0158730
NODE_603_length_3091_cov_35.895722	2472	2535	8	4	63	0.0634921
NODE_603_length_3091_cov_35.895722	2472	2535	9	58	63	0.9206349
NODE_603_length_3091_cov_35.895722	2508	2553	1	7	45	0.1555556
NODE_603_length_3091_cov_35.895722	2508	2553	2	9	45	0.2000000
NODE_603_length_3091_cov_35.895722	2508	2553	3	3	45	0.0666667
NODE_603_length_3091_cov_35.895722	2508	2553	8	4	45	0.0888889
NODE_603_length_3091_cov_35.895722	2508	2553	9	22	45	0.4888889
NODE_603_length_3091_cov_35.895722	2534	2604	0	24	70	0.3428572
NODE_603_length_3091_cov_35.895722	2534	2604	1	16	70	0.2285714
NODE_603_length_3091_cov_35.895722	2534	2604	2	9	70	0.1285714
NODE_603_length_3091_cov_35.895722	2534	2604	3	3	70	0.0428571
NODE_603_length_3091_cov_35.895722	2534	2604	4	18	70	0.2571429
NODE_603_length_3091_cov_35.895722	2578	2618	0	8	40	0.2000000
NODE_603_length_3091_cov_35.895722	2578	2618	4	32	40	0.8000000
NODE_603_length_3091_cov_35.895722	2586	2623	4	37	37	1.0000000
NODE_603_length_3091_cov_35.895722	2626	2671	4	45	45	1.0000000
NODE_603_length_3091_cov_35.895722	2682	2730	4	48	48	1.0000000
NODE_603_length_3091_cov_35.895722	2918	2969	0	51	51	1.0000000
NODE_603_length_3091_cov_35.895722	2942	2987	0	45	45	1.0000000
NODE_603_length_3091_cov_35.895722	2994	3039	0	45	45	1.0000000
NODE_607_length_3079_cov_7.081879	2340	2420	0	80	80	1.0000000
NODE_607_length_3079_cov_7.081879	2886	2938	12	6	52	0.1153846
NODE_607_length_3079_cov_7.081879	2886	2938	21	1	52	0.0192308
NODE_607_length_3079_cov_7.081879	2886	2938	22	5	52	0.0961538
NODE_607_length_3079_cov_7.081879	2886	2938	23	18	52	0.3461539
NODE_607_length_3079_cov_7.081879	2886	2938	24	22	52	0.4230769
NODE_607_length_3079_cov_7.081879	2893	2959	20	7	66	0.1060606
NODE_607_length_3079_cov_7.081879	2893	2959	21	3	66	0.0454545
NODE_607_length_3079_cov_7.081879	2893	2959	22	5	66	0.0757576
NODE_607_length_3079_cov_7.081879	2893	2959	23	29	66	0.4393939
NODE_607_length_3079_cov_7.081879	2893	2959	24	22	66	0.3333333
NODE_607_length_3079_cov_7.081879	2932	2993	13	28	61	0.4590164
NODE_607_length_3079_cov_7.081879	2932	2993	18	2	61	0.0327869
NODE_607_length_3079_cov_7.081879	2932	2993	20	11	61	0.1803279
NODE_607_length_3079_cov_7.081879	2932	2993	21	3	61	0.0491803
NODE_607_length_3079_cov_7.081879	2932	2993	23	12	61	0.1967213
NODE_607_length_3079_cov_7.081879	2932	2993	24	5	61	0.0819672
NODE_607_length_3079_cov_7.081879	2932	2995	13	30	63	0.4761905
NODE_607_length_3079_cov_7.081879	2932	2995	18	2	63	0.0317460
NODE_607_length_3079_cov_7.081879	2932	2995	20	11	63	0.1746032
NODE_607_length_3079_cov_7.081879	2932	2995	21	3	63	0.0476190
NODE_607_length_3079_cov_7.081879	2932	2995	23	12	63	0.1904762
NODE_607_length_3079_cov_7.081879	2932	2995	24	5	63	0.0793651
NODE_607_length_3079_cov_7.081879	2932	2995	13	30	63	0.4761905
NODE_607_length_3079_cov_7.081879	2932	2995	18	2	63	0.0317460
NODE_607_length_3079_cov_7.081879	2932	2995	20	11	63	0.1746032
NODE_607_length_3079_cov_7.081879	2932	2995	21	3	63	0.0476190
NODE_607_length_3079_cov_7.081879	2932	2995	23	12	63	0.1904762
NODE_607_length_3079_cov_7.081879	2932	2995	24	5	63	0.0793651
NODE_608_length_3077_cov_23.535259	1244	1321	17	29	77	0.3766234
NODE_608_length_3077_cov_23.535259	1244	1321	18	1	77	0.0129870
NODE_608_length_3077_cov_23.535259	1244	1321	19	7	77	0.0909091
NODE_608_length_3077_cov_23.535259	1244	1321	20	10	77	0.1298701
NODE_608_length_3077_cov_23.535259	1244	1321	22	8	77	0.1038961
NODE_608_length_3077_cov_23.535259	1244	1321	24	22	77	0.2857143
NODE_608_length_3077_cov_23.535259	1911	1991	0	14	80	0.1750000
NODE_608_length_3077_cov_23.535259	1911	1991	1	66	80	0.8250000
NODE_608_length_3077_cov_23.535259	1964	2016	1	37	52	0.7115384
NODE_608_length_3077_cov_23.535259	1964	2016	2	15	52	0.2884615
NODE_608_length_3077_cov_23.535259	2028	2114	2	23	86	0.2674419
NODE_608_length_3077_cov_23.535259	2028	2114	3	15	86	0.1744186
NODE_608_length_3077_cov_23.535259	2028	2114	4	14	86	0.1627907
NODE_608_length_3077_cov_23.535259	2028	2114	6	3	86	0.0348837
NODE_608_length_3077_cov_23.535259	2028	2114	7	5	86	0.0581395
NODE_608_length_3077_cov_23.535259	2028	2114	10	6	86	0.0697674
NODE_608_length_3077_cov_23.535259	2028	2114	11	11	86	0.1279070
NODE_608_length_3077_cov_23.535259	2028	2114	12	9	86	0.1046512
NODE_609_length_3077_cov_8.693083	1157	1237	0	9	80	0.1125000
NODE_609_length_3077_cov_8.693083	1157	1237	1	19	80	0.2375000
NODE_609_length_3077_cov_8.693083	1157	1237	2	32	80	0.4000000
NODE_609_length_3077_cov_8.693083	1157	1237	3	3	80	0.0375000
NODE_609_length_3077_cov_8.693083	1157	1237	4	4	80	0.0500000
NODE_609_length_3077_cov_8.693083	1157	1237	7	5	80	0.0625000
NODE_609_length_3077_cov_8.693083	1157	1237	8	6	80	0.0750000
NODE_609_length_3077_cov_8.693083	1157	1237	9	2	80	0.0250000
NODE_609_length_3077_cov_8.693083	1161	1184	0	5	23	0.2173913
NODE_609_length_3077_cov_8.693083	1161	1184	1	18	23	0.7826087
NODE_609_length_3077_cov_8.693083	1233	1313	8	2	80	0.0250000
NODE_609_length_3077_cov_8.693083	1233	1313	9	7	80	0.0875000
NODE_609_length_3077_cov_8.693083	1233	1313	10	2	80	0.0250000
NODE_609_length_3077_cov_8.693083	1233	1313	11	8	80	0.1000000
NODE_609_length_3077_cov_8.693083	1233	1313	12	3	80	0.0375000
NODE_609_length_3077_cov_8.693083	1233	1313	13	13	80	0.1625000
NODE_609_length_3077_cov_8.693083	1233	1313	14	2	80	0.0250000
NODE_609_length_3077_cov_8.693083	1233	1313	15	2	80	0.0250000
NODE_609_length_3077_cov_8.693083	1233	1313	16	1	80	0.0125000
NODE_609_length_3077_cov_8.693083	1233	1313	18	16	80	0.2000000
NODE_609_length_3077_cov_8.693083	1233	1313	19	5	80	0.0625000
NODE_609_length_3077_cov_8.693083	1233	1313	20	19	80	0.2375000
NODE_609_length_3077_cov_8.693083	1286	1352	18	11	66	0.1666667
NODE_609_length_3077_cov_8.693083	1286	1352	19	8	66	0.1212121
NODE_609_length_3077_cov_8.693083	1286	1352	20	45	66	0.6818182
NODE_609_length_3077_cov_8.693083	1286	1352	21	2	66	0.0303030
NODE_609_length_3077_cov_8.693083	2672	2757	0	13	85	0.1529412
NODE_609_length_3077_cov_8.693083	2672	2757	2	35	85	0.4117647
NODE_609_length_3077_cov_8.693083	2672	2757	4	8	85	0.0941176
NODE_609_length_3077_cov_8.693083	2672	2757	8	4	85	0.0470588
NODE_609_length_3077_cov_8.693083	2672	2757	10	3	85	0.0352941
NODE_609_length_3077_cov_8.693083	2672	2757	13	22	85	0.2588235
NODE_611_length_3074_cov_2.996303	2561	2629	2	6	68	0.0882353
NODE_611_length_3074_cov_2.996303	2561	2629	3	18	68	0.2647059
NODE_611_length_3074_cov_2.996303	2561	2629	4	9	68	0.1323529
NODE_611_length_3074_cov_2.996303	2561	2629	6	2	68	0.0294118
NODE_611_length_3074_cov_2.996303	2561	2629	7	16	68	0.2352941
NODE_611_length_3074_cov_2.996303	2561	2629	8	7	68	0.1029412
NODE_611_length_3074_cov_2.996303	2561	2629	9	1	68	0.0147059
NODE_611_length_3074_cov_2.996303	2561	2629	10	9	68	0.1323529
NODE_615_length_3069_cov_2.448822	2948	2991	0	43	43	1.0000000
NODE_616_length_3059_cov_20.037500	346	426	4	2	80	0.0250000
NODE_616_length_3059_cov_20.037500	346	426	6	32	80	0.4000000
NODE_616_length_3059_cov_20.037500	346	426	8	2	80	0.0250000
NODE_616_length_3059_cov_20.037500	346	426	11	38	80	0.4750000
NODE_616_length_3059_cov_20.037500	346	426	12	6	80	0.0750000
NODE_616_length_3059_cov_20.037500	399	479	6	13	80	0.1625000
NODE_616_length_3059_cov_20.037500	399	479	7	5	80	0.0625000
NODE_616_length_3059_cov_20.037500	399	479	9	19	80	0.2375000
NODE_616_length_3059_cov_20.037500	399	479	11	43	80	0.5375000
NODE_616_length_3059_cov_20.037500	1317	1397	9	42	80	0.5250000
NODE_616_length_3059_cov_20.037500	1317	1397	10	25	80	0.3125000
NODE_616_length_3059_cov_20.037500	1317	1397	11	13	80	0.1625000
NODE_616_length_3059_cov_20.037500	1370	1447	2	7	77	0.0909091
NODE_616_length_3059_cov_20.037500	1370	1447	6	4	77	0.0519481
NODE_616_length_3059_cov_20.037500	1370	1447	7	8	77	0.1038961
NODE_616_length_3059_cov_20.037500	1370	1447	8	20	77	0.2597403
NODE_616_length_3059_cov_20.037500	1370	1447	9	35	77	0.4545455
NODE_616_length_3059_cov_20.037500	1370	1447	10	3	77	0.0389610
NODE_616_length_3059_cov_20.037500	2514	2594	0	12	80	0.1500000
NODE_616_length_3059_cov_20.037500	2514	2594	1	28	80	0.3500000
NODE_616_length_3059_cov_20.037500	2514	2594	3	9	80	0.1125000
NODE_616_length_3059_cov_20.037500	2514	2594	4	31	80	0.3875000
NODE_616_length_3059_cov_20.037500	2567	2647	4	80	80	1.0000000
NODE_617_length_3058_cov_21.767489	2802	2882	0	33	80	0.4125000
NODE_617_length_3058_cov_21.767489	2802	2882	3	46	80	0.5750000
NODE_617_length_3058_cov_21.767489	2802	2882	5	1	80	0.0125000
NODE_617_length_3058_cov_21.767489	2855	2930	0	75	75	1.0000000
NODE_621_length_3047_cov_47.232361	418	489	1	71	71	1.0000000
NODE_621_length_3047_cov_47.232361	758	801	0	18	43	0.4186046
NODE_621_length_3047_cov_47.232361	758	801	3	1	43	0.0232558
NODE_621_length_3047_cov_47.232361	758	801	7	19	43	0.4418605
NODE_621_length_3047_cov_47.232361	758	801	8	5	43	0.1162791
NODE_623_length_3044_cov_38.951783	1702	1782	0	24	80	0.3000000
NODE_623_length_3044_cov_38.951783	1702	1782	1	27	80	0.3375000
NODE_623_length_3044_cov_38.951783	1702	1782	4	29	80	0.3625000
NODE_623_length_3044_cov_38.951783	1755	1835	4	74	80	0.9250000
NODE_623_length_3044_cov_38.951783	1755	1835	7	6	80	0.0750000
NODE_623_length_3044_cov_38.951783	1831	1911	4	8	80	0.1000000
NODE_623_length_3044_cov_38.951783	1831	1911	7	41	80	0.5125000
NODE_623_length_3044_cov_38.951783	1831	1911	8	31	80	0.3875000
NODE_623_length_3044_cov_38.951783	1884	1964	4	18	80	0.2250000
NODE_623_length_3044_cov_38.951783	1884	1964	5	38	80	0.4750000
NODE_623_length_3044_cov_38.951783	1884	1964	6	5	80	0.0625000
NODE_623_length_3044_cov_38.951783	1884	1964	7	19	80	0.2375000
NODE_623_length_3044_cov_38.951783	2556	2636	13	28	80	0.3500000
NODE_623_length_3044_cov_38.951783	2556	2636	14	4	80	0.0500000
NODE_623_length_3044_cov_38.951783	2556	2636	15	2	80	0.0250000
NODE_623_length_3044_cov_38.951783	2556	2636	16	38	80	0.4750000
NODE_623_length_3044_cov_38.951783	2556	2636	17	8	80	0.1000000
NODE_623_length_3044_cov_38.951783	2609	2689	6	4	80	0.0500000
NODE_623_length_3044_cov_38.951783	2609	2689	10	2	80	0.0250000
NODE_623_length_3044_cov_38.951783	2609	2689	11	16	80	0.2000000
NODE_623_length_3044_cov_38.951783	2609	2689	12	29	80	0.3625000
NODE_623_length_3044_cov_38.951783	2609	2689	13	13	80	0.1625000
NODE_623_length_3044_cov_38.951783	2609	2689	14	4	80	0.0500000
NODE_623_length_3044_cov_38.951783	2609	2689	15	1	80	0.0125000
NODE_623_length_3044_cov_38.951783	2609	2689	16	11	80	0.1375000
NODE_625_length_3039_cov_3.258163	261	337	0	76	76	1.0000000
NODE_625_length_3039_cov_3.258163	261	336	0	75	75	1.0000000
NODE_625_length_3039_cov_3.258163	261	337	0	76	76	1.0000000
NODE_625_length_3039_cov_3.258163	270	337	0	67	67	1.0000000
NODE_627_length_3036_cov_8.968676	2303	2367	7	47	64	0.7343750
NODE_627_length_3036_cov_8.968676	2303	2367	8	17	64	0.2656250
NODE_627_length_3036_cov_8.968676	2340	2420	6	27	80	0.3375000
NODE_627_length_3036_cov_8.968676	2340	2420	7	28	80	0.3500000
NODE_627_length_3036_cov_8.968676	2340	2420	8	16	80	0.2000000
NODE_627_length_3036_cov_8.968676	2340	2420	10	9	80	0.1125000
NODE_627_length_3036_cov_8.968676	2416	2496	7	39	80	0.4875000
NODE_627_length_3036_cov_8.968676	2416	2496	9	1	80	0.0125000
NODE_627_length_3036_cov_8.968676	2416	2496	10	40	80	0.5000000
NODE_627_length_3036_cov_8.968676	2469	2549	7	2	80	0.0250000
NODE_627_length_3036_cov_8.968676	2469	2549	9	46	80	0.5750000
NODE_627_length_3036_cov_8.968676	2469	2549	10	32	80	0.4000000
NODE_629_length_3032_cov_7.470849	1026	1068	0	42	42	1.0000000
NODE_630_length_3025_cov_11.862611	2371	2451	9	16	80	0.2000000
NODE_630_length_3025_cov_11.862611	2371	2451	11	2	80	0.0250000
NODE_630_length_3025_cov_11.862611	2371	2451	12	12	80	0.1500000
NODE_630_length_3025_cov_11.862611	2371	2451	13	6	80	0.0750000
NODE_630_length_3025_cov_11.862611	2371	2451	14	12	80	0.1500000
NODE_630_length_3025_cov_11.862611	2371	2451	15	1	80	0.0125000
NODE_630_length_3025_cov_11.862611	2371	2451	16	26	80	0.3250000
NODE_630_length_3025_cov_11.862611	2371	2451	17	4	80	0.0500000
NODE_630_length_3025_cov_11.862611	2371	2451	18	1	80	0.0125000
NODE_630_length_3025_cov_11.862611	2424	2504	15	27	80	0.3375000
NODE_630_length_3025_cov_11.862611	2424	2504	16	28	80	0.3500000
NODE_630_length_3025_cov_11.862611	2424	2504	17	4	80	0.0500000
NODE_630_length_3025_cov_11.862611	2424	2504	18	20	80	0.2500000
NODE_630_length_3025_cov_11.862611	2424	2504	19	1	80	0.0125000
NODE_630_length_3025_cov_11.862611	2500	2580	7	10	80	0.1250000
NODE_630_length_3025_cov_11.862611	2500	2580	8	2	80	0.0250000
NODE_630_length_3025_cov_11.862611	2500	2580	9	23	80	0.2875000
NODE_630_length_3025_cov_11.862611	2500	2580	11	8	80	0.1000000
NODE_630_length_3025_cov_11.862611	2500	2580	12	4	80	0.0500000
NODE_630_length_3025_cov_11.862611	2500	2580	13	27	80	0.3375000
NODE_630_length_3025_cov_11.862611	2500	2580	15	6	80	0.0750000
NODE_630_length_3025_cov_11.862611	2553	2633	3	26	80	0.3250000
NODE_630_length_3025_cov_11.862611	2553	2633	4	8	80	0.1000000
NODE_630_length_3025_cov_11.862611	2553	2633	6	10	80	0.1250000
NODE_630_length_3025_cov_11.862611	2553	2633	7	19	80	0.2375000
NODE_630_length_3025_cov_11.862611	2553	2633	8	2	80	0.0250000
NODE_630_length_3025_cov_11.862611	2553	2633	9	15	80	0.1875000
NODE_635_length_3012_cov_33.100240	2379	2459	20	5	80	0.0625000
NODE_635_length_3012_cov_33.100240	2379	2459	21	5	80	0.0625000
NODE_635_length_3012_cov_33.100240	2379	2459	22	8	80	0.1000000
NODE_635_length_3012_cov_33.100240	2379	2459	27	9	80	0.1125000
NODE_635_length_3012_cov_33.100240	2379	2459	28	3	80	0.0375000
NODE_635_length_3012_cov_33.100240	2379	2459	29	11	80	0.1375000
NODE_635_length_3012_cov_33.100240	2379	2459	30	1	80	0.0125000
NODE_635_length_3012_cov_33.100240	2379	2459	33	3	80	0.0375000
NODE_635_length_3012_cov_33.100240	2379	2459	35	10	80	0.1250000
NODE_635_length_3012_cov_33.100240	2379	2459	36	9	80	0.1125000
NODE_635_length_3012_cov_33.100240	2379	2459	37	9	80	0.1125000
NODE_635_length_3012_cov_33.100240	2379	2459	38	7	80	0.0875000
NODE_635_length_3012_cov_33.100240	2432	2512	35	11	80	0.1375000
NODE_635_length_3012_cov_33.100240	2432	2512	36	23	80	0.2875000
NODE_635_length_3012_cov_33.100240	2432	2512	37	18	80	0.2250000
NODE_635_length_3012_cov_33.100240	2432	2512	38	17	80	0.2125000
NODE_635_length_3012_cov_33.100240	2432	2512	39	10	80	0.1250000
NODE_635_length_3012_cov_33.100240	2432	2512	40	1	80	0.0125000
NODE_637_length_3007_cov_11.843535	2641	2721	0	80	80	1.0000000
NODE_643_length_2992_cov_2.636709	2032	2112	0	80	80	1.0000000
NODE_643_length_2992_cov_2.636709	2085	2165	0	80	80	1.0000000
NODE_646_length_2978_cov_4.883293	382	452	0	70	70	1.0000000
NODE_646_length_2978_cov_4.883293	1858	1938	4	2	80	0.0250000
NODE_646_length_2978_cov_4.883293	1858	1938	6	78	80	0.9750000
NODE_646_length_2978_cov_4.883293	1926	1991	4	8	65	0.1230769
NODE_646_length_2978_cov_4.883293	1926	1991	5	4	65	0.0615385
NODE_646_length_2978_cov_4.883293	1926	1991	6	53	65	0.8153846
NODE_646_length_2978_cov_4.883293	1987	2066	0	55	79	0.6962025
NODE_646_length_2978_cov_4.883293	1987	2066	2	2	79	0.0253165
NODE_646_length_2978_cov_4.883293	1987	2066	3	7	79	0.0886076
NODE_646_length_2978_cov_4.883293	1987	2066	4	15	79	0.1898734
NODE_646_length_2978_cov_4.883293	2040	2079	0	39	39	1.0000000
NODE_647_length_2976_cov_24.683003	1764	1844	5	25	80	0.3125000
NODE_647_length_2976_cov_24.683003	1764	1844	6	15	80	0.1875000
NODE_647_length_2976_cov_24.683003	1764	1844	7	17	80	0.2125000
NODE_647_length_2976_cov_24.683003	1764	1844	10	1	80	0.0125000
NODE_647_length_2976_cov_24.683003	1764	1844	11	9	80	0.1125000
NODE_647_length_2976_cov_24.683003	1764	1844	12	10	80	0.1250000
NODE_647_length_2976_cov_24.683003	1764	1844	13	3	80	0.0375000
NODE_647_length_2976_cov_24.683003	1817	1897	7	4	80	0.0500000
NODE_647_length_2976_cov_24.683003	1817	1897	10	1	80	0.0125000
NODE_647_length_2976_cov_24.683003	1817	1897	11	9	80	0.1125000
NODE_647_length_2976_cov_24.683003	1817	1897	12	10	80	0.1250000
NODE_647_length_2976_cov_24.683003	1817	1897	13	17	80	0.2125000
NODE_647_length_2976_cov_24.683003	1817	1897	14	13	80	0.1625000
NODE_647_length_2976_cov_24.683003	1817	1897	15	16	80	0.2000000
NODE_647_length_2976_cov_24.683003	1817	1897	16	9	80	0.1125000
NODE_647_length_2976_cov_24.683003	1817	1897	17	1	80	0.0125000
NODE_647_length_2976_cov_24.683003	1893	1973	15	9	80	0.1125000
NODE_647_length_2976_cov_24.683003	1893	1973	16	8	80	0.1000000
NODE_647_length_2976_cov_24.683003	1893	1973	18	10	80	0.1250000
NODE_647_length_2976_cov_24.683003	1893	1973	19	24	80	0.3000000
NODE_647_length_2976_cov_24.683003	1893	1973	20	2	80	0.0250000
NODE_647_length_2976_cov_24.683003	1893	1973	26	5	80	0.0625000
NODE_647_length_2976_cov_24.683003	1893	1973	27	13	80	0.1625000
NODE_647_length_2976_cov_24.683003	1893	1973	28	6	80	0.0750000
NODE_647_length_2976_cov_24.683003	1893	1973	30	3	80	0.0375000
NODE_647_length_2976_cov_24.683003	1946	2026	22	3	80	0.0375000
NODE_647_length_2976_cov_24.683003	1946	2026	23	32	80	0.4000000
NODE_647_length_2976_cov_24.683003	1946	2026	24	16	80	0.2000000
NODE_647_length_2976_cov_24.683003	1946	2026	26	7	80	0.0875000
NODE_647_length_2976_cov_24.683003	1946	2026	27	13	80	0.1625000
NODE_647_length_2976_cov_24.683003	1946	2026	28	6	80	0.0750000
NODE_647_length_2976_cov_24.683003	1946	2026	30	3	80	0.0375000
NODE_651_length_2967_cov_16.146095	238	318	26	5	80	0.0625000
NODE_651_length_2967_cov_16.146095	238	318	27	6	80	0.0750000
NODE_651_length_2967_cov_16.146095	238	318	28	4	80	0.0500000
NODE_651_length_2967_cov_16.146095	238	318	29	8	80	0.1000000
NODE_651_length_2967_cov_16.146095	238	318	30	1	80	0.0125000
NODE_651_length_2967_cov_16.146095	238	318	31	2	80	0.0250000
NODE_651_length_2967_cov_16.146095	238	318	32	1	80	0.0125000
NODE_651_length_2967_cov_16.146095	238	318	33	7	80	0.0875000
NODE_651_length_2967_cov_16.146095	238	318	34	12	80	0.1500000
NODE_651_length_2967_cov_16.146095	238	318	35	1	80	0.0125000
NODE_651_length_2967_cov_16.146095	238	318	36	22	80	0.2750000
NODE_651_length_2967_cov_16.146095	238	318	37	3	80	0.0375000
NODE_651_length_2967_cov_16.146095	238	318	38	7	80	0.0875000
NODE_651_length_2967_cov_16.146095	238	318	39	1	80	0.0125000
NODE_651_length_2967_cov_16.146095	291	371	21	5	80	0.0625000
NODE_651_length_2967_cov_16.146095	291	371	22	1	80	0.0125000
NODE_651_length_2967_cov_16.146095	291	371	23	8	80	0.1000000
NODE_651_length_2967_cov_16.146095	291	371	24	1	80	0.0125000
NODE_651_length_2967_cov_16.146095	291	371	25	4	80	0.0500000
NODE_651_length_2967_cov_16.146095	291	371	30	10	80	0.1250000
NODE_651_length_2967_cov_16.146095	291	371	31	19	80	0.2375000
NODE_651_length_2967_cov_16.146095	291	371	32	7	80	0.0875000
NODE_651_length_2967_cov_16.146095	291	371	33	6	80	0.0750000
NODE_651_length_2967_cov_16.146095	291	371	34	7	80	0.0875000
NODE_651_length_2967_cov_16.146095	291	371	35	1	80	0.0125000
NODE_651_length_2967_cov_16.146095	291	371	36	7	80	0.0875000
NODE_651_length_2967_cov_16.146095	291	371	37	3	80	0.0375000
NODE_651_length_2967_cov_16.146095	291	371	39	1	80	0.0125000
NODE_651_length_2967_cov_16.146095	367	447	8	6	80	0.0750000
NODE_651_length_2967_cov_16.146095	367	447	10	7	80	0.0875000
NODE_651_length_2967_cov_16.146095	367	447	11	8	80	0.1000000
NODE_651_length_2967_cov_16.146095	367	447	12	7	80	0.0875000
NODE_651_length_2967_cov_16.146095	367	447	13	7	80	0.0875000
NODE_651_length_2967_cov_16.146095	367	447	16	1	80	0.0125000
NODE_651_length_2967_cov_16.146095	367	447	17	5	80	0.0625000
NODE_651_length_2967_cov_16.146095	367	447	18	4	80	0.0500000
NODE_651_length_2967_cov_16.146095	367	447	19	5	80	0.0625000
NODE_651_length_2967_cov_16.146095	367	447	20	4	80	0.0500000
NODE_651_length_2967_cov_16.146095	367	447	21	16	80	0.2000000
NODE_651_length_2967_cov_16.146095	367	447	22	10	80	0.1250000
NODE_651_length_2967_cov_16.146095	420	500	6	21	80	0.2625000
NODE_651_length_2967_cov_16.146095	420	500	7	8	80	0.1000000
NODE_651_length_2967_cov_16.146095	420	500	8	24	80	0.3000000
NODE_651_length_2967_cov_16.146095	420	500	9	6	80	0.0750000
NODE_651_length_2967_cov_16.146095	420	500	10	7	80	0.0875000
NODE_651_length_2967_cov_16.146095	420	500	11	7	80	0.0875000
NODE_651_length_2967_cov_16.146095	420	500	12	7	80	0.0875000
NODE_653_length_2965_cov_19.913468	92	134	0	42	42	1.0000000
NODE_653_length_2965_cov_19.913468	109	178	0	69	69	1.0000000
NODE_653_length_2965_cov_19.913468	109	178	0	69	69	1.0000000
NODE_653_length_2965_cov_19.913468	2298	2378	4	43	80	0.5375000
NODE_653_length_2965_cov_19.913468	2298	2378	5	1	80	0.0125000
NODE_653_length_2965_cov_19.913468	2298	2378	6	36	80	0.4500000
NODE_653_length_2965_cov_19.913468	2351	2431	4	12	80	0.1500000
NODE_653_length_2965_cov_19.913468	2351	2431	6	49	80	0.6125000
NODE_653_length_2965_cov_19.913468	2351	2431	8	18	80	0.2250000
NODE_653_length_2965_cov_19.913468	2351	2431	10	1	80	0.0125000
NODE_653_length_2965_cov_19.913468	2427	2507	6	28	80	0.3500000
NODE_653_length_2965_cov_19.913468	2427	2507	8	52	80	0.6500000
NODE_653_length_2965_cov_19.913468	2480	2560	4	44	80	0.5500000
NODE_653_length_2965_cov_19.913468	2480	2560	6	36	80	0.4500000
NODE_656_length_2960_cov_35.741699	459	539	6	40	80	0.5000000
NODE_656_length_2960_cov_35.741699	459	539	7	32	80	0.4000000
NODE_656_length_2960_cov_35.741699	459	539	8	8	80	0.1000000
NODE_656_length_2960_cov_35.741699	512	592	2	35	80	0.4375000
NODE_656_length_2960_cov_35.741699	512	592	3	2	80	0.0250000
NODE_656_length_2960_cov_35.741699	512	592	5	5	80	0.0625000
NODE_656_length_2960_cov_35.741699	512	592	6	38	80	0.4750000
NODE_659_length_2951_cov_7.195652	1100	1141	9	18	41	0.4390244
NODE_659_length_2951_cov_7.195652	1100	1141	10	4	41	0.0975610
NODE_659_length_2951_cov_7.195652	1100	1141	11	17	41	0.4146341
NODE_659_length_2951_cov_7.195652	1100	1141	12	2	41	0.0487805
NODE_665_length_2935_cov_37.693230	1492	1572	7	7	80	0.0875000
NODE_665_length_2935_cov_37.693230	1492	1572	8	1	80	0.0125000
NODE_665_length_2935_cov_37.693230	1492	1572	9	3	80	0.0375000
NODE_665_length_2935_cov_37.693230	1492	1572	10	5	80	0.0625000
NODE_665_length_2935_cov_37.693230	1492	1572	11	19	80	0.2375000
NODE_665_length_2935_cov_37.693230	1492	1572	12	5	80	0.0625000
NODE_665_length_2935_cov_37.693230	1492	1572	14	8	80	0.1000000
NODE_665_length_2935_cov_37.693230	1492	1572	15	21	80	0.2625000
NODE_665_length_2935_cov_37.693230	1492	1572	16	11	80	0.1375000
NODE_665_length_2935_cov_37.693230	1534	1589	12	5	55	0.0909091
NODE_665_length_2935_cov_37.693230	1534	1589	14	8	55	0.1454545
NODE_665_length_2935_cov_37.693230	1534	1589	15	25	55	0.4545455
NODE_665_length_2935_cov_37.693230	1534	1589	16	17	55	0.3090909
NODE_665_length_2935_cov_37.693230	1545	1619	12	5	74	0.0675676
NODE_665_length_2935_cov_37.693230	1545	1619	14	8	74	0.1081081
NODE_665_length_2935_cov_37.693230	1545	1619	15	42	74	0.5675676
NODE_665_length_2935_cov_37.693230	1545	1619	16	19	74	0.2567568
NODE_665_length_2935_cov_37.693230	1625	1701	7	23	76	0.3026316
NODE_665_length_2935_cov_37.693230	1625	1701	8	1	76	0.0131579
NODE_665_length_2935_cov_37.693230	1625	1701	10	1	76	0.0131579
NODE_665_length_2935_cov_37.693230	1625	1701	12	21	76	0.2763158
NODE_665_length_2935_cov_37.693230	1625	1701	13	20	76	0.2631579
NODE_665_length_2935_cov_37.693230	1625	1701	14	10	76	0.1315790
NODE_665_length_2935_cov_37.693230	2863	2906	0	43	43	1.0000000
NODE_675_length_2913_cov_4.376688	2664	2739	2	8	75	0.1066667
NODE_675_length_2913_cov_4.376688	2664	2739	3	67	75	0.8933333
NODE_675_length_2913_cov_4.376688	2664	2723	3	59	59	1.0000000
NODE_675_length_2913_cov_4.376688	2664	2739	2	8	75	0.1066667
NODE_675_length_2913_cov_4.376688	2664	2739	3	67	75	0.8933333
NODE_675_length_2913_cov_4.376688	2664	2739	2	8	75	0.1066667
NODE_675_length_2913_cov_4.376688	2664	2739	3	67	75	0.8933333
NODE_675_length_2913_cov_4.376688	2673	2739	2	8	66	0.1212121
NODE_675_length_2913_cov_4.376688	2673	2739	3	58	66	0.8787879
NODE_675_length_2913_cov_4.376688	2717	2780	0	18	63	0.2857143
NODE_675_length_2913_cov_4.376688	2717	2780	2	8	63	0.1269841
NODE_675_length_2913_cov_4.376688	2717	2780	3	37	63	0.5873016
NODE_675_length_2913_cov_4.376688	2745	2778	0	12	33	0.3636364
NODE_675_length_2913_cov_4.376688	2745	2778	3	21	33	0.6363636
NODE_677_length_2909_cov_71.975089	2090	2174	2	17	84	0.2023810
NODE_677_length_2909_cov_71.975089	2090	2174	3	11	84	0.1309524
NODE_677_length_2909_cov_71.975089	2090	2174	5	17	84	0.2023810
NODE_677_length_2909_cov_71.975089	2090	2174	6	26	84	0.3095238
NODE_677_length_2909_cov_71.975089	2090	2174	7	13	84	0.1547619
NODE_678_length_2908_cov_5.937344	2495	2575	5	18	80	0.2250000
NODE_678_length_2908_cov_5.937344	2495	2575	7	1	80	0.0125000
NODE_678_length_2908_cov_5.937344	2495	2575	8	41	80	0.5125000
NODE_678_length_2908_cov_5.937344	2495	2575	9	20	80	0.2500000
NODE_678_length_2908_cov_5.937344	2548	2628	1	3	80	0.0375000
NODE_678_length_2908_cov_5.937344	2548	2628	2	26	80	0.3250000
NODE_678_length_2908_cov_5.937344	2548	2628	3	3	80	0.0375000
NODE_678_length_2908_cov_5.937344	2548	2628	4	17	80	0.2125000
NODE_678_length_2908_cov_5.937344	2548	2628	5	22	80	0.2750000
NODE_678_length_2908_cov_5.937344	2548	2628	7	1	80	0.0125000
NODE_678_length_2908_cov_5.937344	2548	2628	8	4	80	0.0500000
NODE_678_length_2908_cov_5.937344	2548	2628	9	4	80	0.0500000
NODE_678_length_2908_cov_5.937344	2624	2704	0	22	80	0.2750000
NODE_678_length_2908_cov_5.937344	2624	2704	1	57	80	0.7125000
NODE_678_length_2908_cov_5.937344	2624	2704	2	1	80	0.0125000
NODE_678_length_2908_cov_5.937344	2677	2757	0	75	80	0.9375000
NODE_678_length_2908_cov_5.937344	2677	2757	1	5	80	0.0625000
NODE_679_length_2905_cov_12.777619	2358	2419	0	61	61	1.0000000
NODE_679_length_2905_cov_12.777619	2358	2419	0	61	61	1.0000000
NODE_679_length_2905_cov_12.777619	2358	2419	0	61	61	1.0000000
NODE_679_length_2905_cov_12.777619	2392	2472	0	80	80	1.0000000
NODE_680_length_2903_cov_5.474322	2423	2464	2	8	41	0.1951219
NODE_680_length_2903_cov_5.474322	2423	2464	5	33	41	0.8048781
NODE_684_length_2898_cov_5.786352	0	74	0	36	74	0.4864865
NODE_684_length_2898_cov_5.786352	0	74	1	38	74	0.5135135
NODE_684_length_2898_cov_5.786352	47	124	1	77	77	1.0000000
NODE_686_length_2895_cov_8.519313	869	949	3	67	80	0.8375000
NODE_686_length_2895_cov_8.519313	869	949	4	13	80	0.1625000
NODE_686_length_2895_cov_8.519313	922	1002	1	34	80	0.4250000
NODE_686_length_2895_cov_8.519313	922	1002	2	3	80	0.0375000
NODE_686_length_2895_cov_8.519313	922	1002	3	14	80	0.1750000
NODE_686_length_2895_cov_8.519313	922	1002	4	29	80	0.3625000
NODE_688_length_2894_cov_2.036136	2677	2757	0	80	80	1.0000000
NODE_689_length_2891_cov_7.938037	193	275	0	82	82	1.0000000
NODE_691_length_2889_cov_11.426882	407	487	4	7	80	0.0875000
NODE_691_length_2889_cov_11.426882	407	487	5	73	80	0.9125000
NODE_691_length_2889_cov_11.426882	460	540	3	37	80	0.4625000
NODE_691_length_2889_cov_11.426882	460	540	4	23	80	0.2875000
NODE_691_length_2889_cov_11.426882	460	540	5	20	80	0.2500000
NODE_691_length_2889_cov_11.426882	1006	1086	1	8	80	0.1000000
NODE_691_length_2889_cov_11.426882	1006	1086	3	29	80	0.3625000
NODE_691_length_2889_cov_11.426882	1006	1086	4	4	80	0.0500000
NODE_691_length_2889_cov_11.426882	1006	1086	6	23	80	0.2875000
NODE_691_length_2889_cov_11.426882	1006	1086	8	16	80	0.2000000
NODE_691_length_2889_cov_11.426882	1007	1086	1	8	79	0.1012658
NODE_691_length_2889_cov_11.426882	1007	1086	3	29	79	0.3670886
NODE_691_length_2889_cov_11.426882	1007	1086	4	4	79	0.0506329
NODE_691_length_2889_cov_11.426882	1007	1086	6	23	79	0.2911392
NODE_691_length_2889_cov_11.426882	1007	1086	8	15	79	0.1898734
NODE_691_length_2889_cov_11.426882	1059	1138	0	38	79	0.4810127
NODE_691_length_2889_cov_11.426882	1059	1138	1	22	79	0.2784810
NODE_691_length_2889_cov_11.426882	1059	1138	3	19	79	0.2405063
NODE_691_length_2889_cov_11.426882	1059	1138	0	38	79	0.4810127
NODE_691_length_2889_cov_11.426882	1059	1138	1	22	79	0.2784810
NODE_691_length_2889_cov_11.426882	1059	1138	3	19	79	0.2405063
NODE_693_length_2888_cov_3.789172	992	1072	2	36	80	0.4500000
NODE_693_length_2888_cov_3.789172	992	1072	3	44	80	0.5500000
NODE_693_length_2888_cov_3.789172	1045	1087	1	9	42	0.2142857
NODE_693_length_2888_cov_3.789172	1045	1087	2	2	42	0.0476190
NODE_693_length_2888_cov_3.789172	1045	1087	3	31	42	0.7380952
NODE_697_length_2878_cov_6.277798	2712	2781	0	69	69	1.0000000
NODE_703_length_2862_cov_9.060803	2409	2489	0	17	80	0.2125000
NODE_703_length_2862_cov_9.060803	2409	2489	2	51	80	0.6375000
NODE_703_length_2862_cov_9.060803	2409	2489	3	7	80	0.0875000
NODE_703_length_2862_cov_9.060803	2409	2489	4	5	80	0.0625000
NODE_703_length_2862_cov_9.060803	2462	2542	2	15	80	0.1875000
NODE_703_length_2862_cov_9.060803	2462	2542	3	7	80	0.0875000
NODE_703_length_2862_cov_9.060803	2462	2542	4	16	80	0.2000000
NODE_703_length_2862_cov_9.060803	2462	2542	5	9	80	0.1125000
NODE_703_length_2862_cov_9.060803	2462	2542	6	33	80	0.4125000
NODE_712_length_2840_cov_2.079533	1660	1740	1	56	80	0.7000000
NODE_712_length_2840_cov_2.079533	1660	1740	2	24	80	0.3000000
NODE_713_length_2839_cov_16.762044	327	402	0	75	75	1.0000000
NODE_713_length_2839_cov_16.762044	380	468	0	88	88	1.0000000
NODE_713_length_2839_cov_16.762044	1021	1101	3	14	80	0.1750000
NODE_713_length_2839_cov_16.762044	1021	1101	4	12	80	0.1500000
NODE_713_length_2839_cov_16.762044	1021	1101	5	38	80	0.4750000
NODE_713_length_2839_cov_16.762044	1021	1101	6	12	80	0.1500000
NODE_713_length_2839_cov_16.762044	1021	1101	7	4	80	0.0500000
NODE_713_length_2839_cov_16.762044	1074	1154	4	3	80	0.0375000
NODE_713_length_2839_cov_16.762044	1074	1154	5	15	80	0.1875000
NODE_713_length_2839_cov_16.762044	1074	1154	6	62	80	0.7750000
NODE_714_length_2835_cov_29.691520	1552	1581	13	3	29	0.1034483
NODE_714_length_2835_cov_29.691520	1552	1581	14	16	29	0.5517241
NODE_714_length_2835_cov_29.691520	1552	1581	15	10	29	0.3448276
NODE_714_length_2835_cov_29.691520	1554	1629	4	2	75	0.0266667
NODE_714_length_2835_cov_29.691520	1554	1629	5	2	75	0.0266667
NODE_714_length_2835_cov_29.691520	1554	1629	6	12	75	0.1600000
NODE_714_length_2835_cov_29.691520	1554	1629	7	2	75	0.0266667
NODE_714_length_2835_cov_29.691520	1554	1629	8	4	75	0.0533333
NODE_714_length_2835_cov_29.691520	1554	1629	9	6	75	0.0800000
NODE_714_length_2835_cov_29.691520	1554	1629	12	19	75	0.2533333
NODE_714_length_2835_cov_29.691520	1554	1629	13	4	75	0.0533333
NODE_714_length_2835_cov_29.691520	1554	1629	14	16	75	0.2133333
NODE_714_length_2835_cov_29.691520	1554	1629	15	8	75	0.1066667
NODE_720_length_2825_cov_9.731108	487	567	4	14	80	0.1750000
NODE_720_length_2825_cov_9.731108	487	567	5	6	80	0.0750000
NODE_720_length_2825_cov_9.731108	487	567	6	32	80	0.4000000
NODE_720_length_2825_cov_9.731108	487	567	7	28	80	0.3500000
NODE_720_length_2825_cov_9.731108	540	620	2	12	80	0.1500000
NODE_720_length_2825_cov_9.731108	540	620	3	16	80	0.2000000
NODE_720_length_2825_cov_9.731108	540	620	4	39	80	0.4875000
NODE_720_length_2825_cov_9.731108	540	620	6	1	80	0.0125000
NODE_720_length_2825_cov_9.731108	540	620	7	12	80	0.1500000
NODE_726_length_2810_cov_2.844338	206	289	0	83	83	1.0000000
NODE_728_length_2808_cov_2.867110	140	163	0	23	23	1.0000000
NODE_729_length_2807_cov_8.423191	125	205	2	9	80	0.1125000
NODE_729_length_2807_cov_8.423191	125	205	3	68	80	0.8500000
NODE_729_length_2807_cov_8.423191	125	205	4	3	80	0.0375000
NODE_729_length_2807_cov_8.423191	178	258	2	5	80	0.0625000
NODE_729_length_2807_cov_8.423191	178	258	3	19	80	0.2375000
NODE_729_length_2807_cov_8.423191	178	258	4	29	80	0.3625000
NODE_729_length_2807_cov_8.423191	178	258	5	27	80	0.3375000
NODE_729_length_2807_cov_8.423191	2451	2515	0	62	64	0.9687500
NODE_729_length_2807_cov_8.423191	2451	2515	2	2	64	0.0312500
NODE_735_length_2801_cov_26.131384	461	521	9	5	60	0.0833333
NODE_735_length_2801_cov_26.131384	461	521	10	1	60	0.0166667
NODE_735_length_2801_cov_26.131384	461	521	11	1	60	0.0166667
NODE_735_length_2801_cov_26.131384	461	521	12	10	60	0.1666667
NODE_735_length_2801_cov_26.131384	461	521	13	6	60	0.1000000
NODE_735_length_2801_cov_26.131384	461	521	14	1	60	0.0166667
NODE_735_length_2801_cov_26.131384	461	521	16	35	60	0.5833333
NODE_735_length_2801_cov_26.131384	461	521	17	1	60	0.0166667
NODE_735_length_2801_cov_26.131384	494	574	6	4	80	0.0500000
NODE_735_length_2801_cov_26.131384	494	574	7	4	80	0.0500000
NODE_735_length_2801_cov_26.131384	494	574	8	15	80	0.1875000
NODE_735_length_2801_cov_26.131384	494	574	9	16	80	0.2000000
NODE_735_length_2801_cov_26.131384	494	574	10	4	80	0.0500000
NODE_735_length_2801_cov_26.131384	494	574	11	17	80	0.2125000
NODE_735_length_2801_cov_26.131384	494	574	12	10	80	0.1250000
NODE_735_length_2801_cov_26.131384	494	574	13	6	80	0.0750000
NODE_735_length_2801_cov_26.131384	494	574	14	1	80	0.0125000
NODE_735_length_2801_cov_26.131384	494	574	16	3	80	0.0375000
NODE_735_length_2801_cov_26.131384	1536	1596	0	10	60	0.1666667
NODE_735_length_2801_cov_26.131384	1536	1596	1	31	60	0.5166667
NODE_735_length_2801_cov_26.131384	1536	1596	3	6	60	0.1000000
NODE_735_length_2801_cov_26.131384	1536	1596	4	3	60	0.0500000
NODE_735_length_2801_cov_26.131384	1536	1596	6	6	60	0.1000000
NODE_735_length_2801_cov_26.131384	1536	1596	7	4	60	0.0666667
NODE_735_length_2801_cov_26.131384	1815	1881	4	11	66	0.1666667
NODE_735_length_2801_cov_26.131384	1815	1881	5	18	66	0.2727273
NODE_735_length_2801_cov_26.131384	1815	1881	7	1	66	0.0151515
NODE_735_length_2801_cov_26.131384	1815	1881	14	1	66	0.0151515
NODE_735_length_2801_cov_26.131384	1815	1881	15	4	66	0.0606061
NODE_735_length_2801_cov_26.131384	1815	1881	16	2	66	0.0303030
NODE_735_length_2801_cov_26.131384	1815	1881	17	15	66	0.2272727
NODE_735_length_2801_cov_26.131384	1815	1881	19	8	66	0.1212121
NODE_735_length_2801_cov_26.131384	1815	1881	21	5	66	0.0757576
NODE_735_length_2801_cov_26.131384	1815	1881	22	1	66	0.0151515
NODE_735_length_2801_cov_26.131384	1854	1934	17	13	80	0.1625000
NODE_735_length_2801_cov_26.131384	1854	1934	19	8	80	0.1000000
NODE_735_length_2801_cov_26.131384	1854	1934	21	5	80	0.0625000
NODE_735_length_2801_cov_26.131384	1854	1934	22	3	80	0.0375000
NODE_735_length_2801_cov_26.131384	1854	1934	23	12	80	0.1500000
NODE_735_length_2801_cov_26.131384	1854	1934	24	2	80	0.0250000
NODE_735_length_2801_cov_26.131384	1854	1934	26	2	80	0.0250000
NODE_735_length_2801_cov_26.131384	1854	1934	27	18	80	0.2250000
NODE_735_length_2801_cov_26.131384	1854	1934	31	4	80	0.0500000
NODE_735_length_2801_cov_26.131384	1854	1934	33	1	80	0.0125000
NODE_735_length_2801_cov_26.131384	1854	1934	34	12	80	0.1500000
NODE_736_length_2801_cov_3.594375	2589	2645	5	2	56	0.0357143
NODE_736_length_2801_cov_3.594375	2589	2645	6	19	56	0.3392857
NODE_736_length_2801_cov_3.594375	2589	2645	7	1	56	0.0178571
NODE_736_length_2801_cov_3.594375	2589	2645	8	34	56	0.6071429
NODE_738_length_2796_cov_94.511680	1090	1137	10	1	47	0.0212766
NODE_738_length_2796_cov_94.511680	1090	1137	11	10	47	0.2127660
NODE_738_length_2796_cov_94.511680	1090	1137	12	18	47	0.3829787
NODE_738_length_2796_cov_94.511680	1090	1137	13	2	47	0.0425532
NODE_738_length_2796_cov_94.511680	1090	1137	14	1	47	0.0212766
NODE_738_length_2796_cov_94.511680	1090	1137	15	1	47	0.0212766
NODE_738_length_2796_cov_94.511680	1090	1137	18	4	47	0.0851064
NODE_738_length_2796_cov_94.511680	1090	1137	22	1	47	0.0212766
NODE_738_length_2796_cov_94.511680	1090	1137	23	1	47	0.0212766
NODE_738_length_2796_cov_94.511680	1090	1137	24	3	47	0.0638298
NODE_738_length_2796_cov_94.511680	1090	1137	26	1	47	0.0212766
NODE_738_length_2796_cov_94.511680	1090	1137	29	4	47	0.0851064
NODE_738_length_2796_cov_94.511680	2717	2796	0	79	79	1.0000000
NODE_744_length_2791_cov_9.997028	310	390	3	19	80	0.2375000
NODE_744_length_2791_cov_9.997028	310	390	4	5	80	0.0625000
NODE_744_length_2791_cov_9.997028	310	390	5	5	80	0.0625000
NODE_744_length_2791_cov_9.997028	310	390	6	35	80	0.4375000
NODE_744_length_2791_cov_9.997028	310	390	7	10	80	0.1250000
NODE_744_length_2791_cov_9.997028	310	390	8	6	80	0.0750000
NODE_744_length_2791_cov_9.997028	363	443	6	11	80	0.1375000
NODE_744_length_2791_cov_9.997028	363	443	7	10	80	0.1250000
NODE_744_length_2791_cov_9.997028	363	443	8	59	80	0.7375000
NODE_752_length_2778_cov_31.340799	2241	2321	9	23	80	0.2875000
NODE_752_length_2778_cov_31.340799	2241	2321	10	15	80	0.1875000
NODE_752_length_2778_cov_31.340799	2241	2321	11	13	80	0.1625000
NODE_752_length_2778_cov_31.340799	2241	2321	12	26	80	0.3250000
NODE_752_length_2778_cov_31.340799	2241	2321	13	1	80	0.0125000
NODE_752_length_2778_cov_31.340799	2241	2321	14	2	80	0.0250000
NODE_752_length_2778_cov_31.340799	2294	2374	11	22	80	0.2750000
NODE_752_length_2778_cov_31.340799	2294	2374	12	14	80	0.1750000
NODE_752_length_2778_cov_31.340799	2294	2374	13	6	80	0.0750000
NODE_752_length_2778_cov_31.340799	2294	2374	14	23	80	0.2875000
NODE_752_length_2778_cov_31.340799	2294	2374	15	9	80	0.1125000
NODE_752_length_2778_cov_31.340799	2294	2374	16	6	80	0.0750000
NODE_752_length_2778_cov_31.340799	2370	2450	12	22	80	0.2750000
NODE_752_length_2778_cov_31.340799	2370	2450	13	22	80	0.2750000
NODE_752_length_2778_cov_31.340799	2370	2450	14	22	80	0.2750000
NODE_752_length_2778_cov_31.340799	2370	2450	15	3	80	0.0375000
NODE_752_length_2778_cov_31.340799	2370	2450	17	11	80	0.1375000
NODE_752_length_2778_cov_31.340799	2423	2503	8	20	80	0.2500000
NODE_752_length_2778_cov_31.340799	2423	2503	11	20	80	0.2500000
NODE_752_length_2778_cov_31.340799	2423	2503	12	1	80	0.0125000
NODE_752_length_2778_cov_31.340799	2423	2503	14	33	80	0.4125000
NODE_752_length_2778_cov_31.340799	2423	2503	17	6	80	0.0750000
NODE_752_length_2778_cov_31.340799	2564	2620	0	52	56	0.9285714
NODE_752_length_2778_cov_31.340799	2564	2620	2	1	56	0.0178571
NODE_752_length_2778_cov_31.340799	2564	2620	5	3	56	0.0535714
NODE_758_length_2767_cov_12.450150	1941	2021	5	5	80	0.0625000
NODE_758_length_2767_cov_12.450150	1941	2021	6	34	80	0.4250000
NODE_758_length_2767_cov_12.450150	1941	2021	7	2	80	0.0250000
NODE_758_length_2767_cov_12.450150	1941	2021	9	39	80	0.4875000
NODE_758_length_2767_cov_12.450150	1994	2074	6	35	80	0.4375000
NODE_758_length_2767_cov_12.450150	1994	2074	7	6	80	0.0750000
NODE_758_length_2767_cov_12.450150	1994	2074	9	39	80	0.4875000
NODE_767_length_2745_cov_5.322751	511	583	2	53	72	0.7361111
NODE_767_length_2745_cov_5.322751	511	583	4	19	72	0.2638889
NODE_777_length_2720_cov_25.561618	2213	2293	2	47	80	0.5875000
NODE_777_length_2720_cov_25.561618	2213	2293	3	1	80	0.0125000
NODE_777_length_2720_cov_25.561618	2213	2293	4	32	80	0.4000000
NODE_777_length_2720_cov_25.561618	2266	2346	2	36	80	0.4500000
NODE_777_length_2720_cov_25.561618	2266	2346	4	44	80	0.5500000
NODE_782_length_2716_cov_39.885747	715	795	1	2	80	0.0250000
NODE_782_length_2716_cov_39.885747	715	795	3	78	80	0.9750000
NODE_782_length_2716_cov_39.885747	768	848	3	36	80	0.4500000
NODE_782_length_2716_cov_39.885747	768	848	4	10	80	0.1250000
NODE_782_length_2716_cov_39.885747	768	848	5	17	80	0.2125000
NODE_782_length_2716_cov_39.885747	768	848	6	17	80	0.2125000
NODE_782_length_2716_cov_39.885747	844	924	5	60	80	0.7500000
NODE_782_length_2716_cov_39.885747	844	924	6	11	80	0.1375000
NODE_782_length_2716_cov_39.885747	844	924	7	9	80	0.1125000
NODE_782_length_2716_cov_39.885747	897	977	3	36	80	0.4500000
NODE_782_length_2716_cov_39.885747	897	977	4	9	80	0.1125000
NODE_782_length_2716_cov_39.885747	897	977	5	35	80	0.4375000
NODE_785_length_2710_cov_10.896974	2410	2446	0	36	36	1.0000000
NODE_785_length_2710_cov_10.896974	2419	2499	0	80	80	1.0000000
NODE_788_length_2708_cov_25.097355	2289	2369	0	80	80	1.0000000
NODE_788_length_2708_cov_25.097355	2342	2422	0	80	80	1.0000000
NODE_789_length_2708_cov_14.569950	18	98	0	80	80	1.0000000
NODE_789_length_2708_cov_14.569950	71	134	0	63	63	1.0000000
NODE_797_length_2691_cov_35.457948	401	481	16	43	80	0.5375000
NODE_797_length_2691_cov_35.457948	401	481	17	22	80	0.2750000
NODE_797_length_2691_cov_35.457948	401	481	18	10	80	0.1250000
NODE_797_length_2691_cov_35.457948	401	481	19	5	80	0.0625000
NODE_797_length_2691_cov_35.457948	454	534	5	2	80	0.0250000
NODE_797_length_2691_cov_35.457948	454	534	14	23	80	0.2875000
NODE_797_length_2691_cov_35.457948	454	534	15	5	80	0.0625000
NODE_797_length_2691_cov_35.457948	454	534	17	12	80	0.1500000
NODE_797_length_2691_cov_35.457948	454	534	18	33	80	0.4125000
NODE_797_length_2691_cov_35.457948	454	534	19	5	80	0.0625000
NODE_803_length_2684_cov_17.345068	146	194	5	6	48	0.1250000
NODE_803_length_2684_cov_17.345068	146	194	6	24	48	0.5000000
NODE_803_length_2684_cov_17.345068	146	194	7	11	48	0.2291667
NODE_803_length_2684_cov_17.345068	146	194	9	7	48	0.1458333
NODE_803_length_2684_cov_17.345068	146	194	5	6	48	0.1250000
NODE_803_length_2684_cov_17.345068	146	194	6	24	48	0.5000000
NODE_803_length_2684_cov_17.345068	146	194	7	11	48	0.2291667
NODE_803_length_2684_cov_17.345068	146	194	9	7	48	0.1458333
NODE_803_length_2684_cov_17.345068	146	194	5	6	48	0.1250000
NODE_803_length_2684_cov_17.345068	146	194	6	24	48	0.5000000
NODE_803_length_2684_cov_17.345068	146	194	7	11	48	0.2291667
NODE_803_length_2684_cov_17.345068	146	194	9	7	48	0.1458333
NODE_803_length_2684_cov_17.345068	146	194	5	6	48	0.1250000
NODE_803_length_2684_cov_17.345068	146	194	6	24	48	0.5000000
NODE_803_length_2684_cov_17.345068	146	194	7	11	48	0.2291667
NODE_803_length_2684_cov_17.345068	146	194	9	7	48	0.1458333
NODE_803_length_2684_cov_17.345068	146	194	5	6	48	0.1250000
NODE_803_length_2684_cov_17.345068	146	194	6	24	48	0.5000000
NODE_803_length_2684_cov_17.345068	146	194	7	11	48	0.2291667
NODE_803_length_2684_cov_17.345068	146	194	9	7	48	0.1458333
NODE_805_length_2682_cov_43.500581	913	992	38	1	79	0.0126582
NODE_805_length_2682_cov_43.500581	913	992	39	22	79	0.2784810
NODE_805_length_2682_cov_43.500581	913	992	40	8	79	0.1012658
NODE_805_length_2682_cov_43.500581	913	992	41	7	79	0.0886076
NODE_805_length_2682_cov_43.500581	913	992	42	14	79	0.1772152
NODE_805_length_2682_cov_43.500581	913	992	43	18	79	0.2278481
NODE_805_length_2682_cov_43.500581	913	992	44	1	79	0.0126582
NODE_805_length_2682_cov_43.500581	913	992	46	1	79	0.0126582
NODE_805_length_2682_cov_43.500581	913	992	48	7	79	0.0886076
NODE_805_length_2682_cov_43.500581	965	1002	39	5	37	0.1351351
NODE_805_length_2682_cov_43.500581	965	1002	40	14	37	0.3783784
NODE_805_length_2682_cov_43.500581	965	1002	41	3	37	0.0810811
NODE_805_length_2682_cov_43.500581	965	1002	42	3	37	0.0810811
NODE_805_length_2682_cov_43.500581	965	1002	43	11	37	0.2972973
NODE_805_length_2682_cov_43.500581	965	1002	46	1	37	0.0270270
NODE_808_length_2675_cov_10.369565	209	289	0	80	80	1.0000000
NODE_813_length_2670_cov_17.489304	1995	2075	13	2	80	0.0250000
NODE_813_length_2670_cov_17.489304	1995	2075	18	5	80	0.0625000
NODE_813_length_2670_cov_17.489304	1995	2075	19	36	80	0.4500000
NODE_813_length_2670_cov_17.489304	1995	2075	21	1	80	0.0125000
NODE_813_length_2670_cov_17.489304	1995	2075	22	14	80	0.1750000
NODE_813_length_2670_cov_17.489304	1995	2075	23	6	80	0.0750000
NODE_813_length_2670_cov_17.489304	1995	2075	25	16	80	0.2000000
NODE_813_length_2670_cov_17.489304	2048	2128	10	10	80	0.1250000
NODE_813_length_2670_cov_17.489304	2048	2128	11	19	80	0.2375000
NODE_813_length_2670_cov_17.489304	2048	2128	13	19	80	0.2375000
NODE_813_length_2670_cov_17.489304	2048	2128	14	7	80	0.0875000
NODE_813_length_2670_cov_17.489304	2048	2128	18	5	80	0.0625000
NODE_813_length_2670_cov_17.489304	2048	2128	19	9	80	0.1125000
NODE_813_length_2670_cov_17.489304	2048	2128	22	11	80	0.1375000
NODE_813_length_2670_cov_17.489304	2124	2204	10	8	80	0.1000000
NODE_813_length_2670_cov_17.489304	2124	2204	12	31	80	0.3875000
NODE_813_length_2670_cov_17.489304	2124	2204	15	28	80	0.3500000
NODE_813_length_2670_cov_17.489304	2124	2204	16	6	80	0.0750000
NODE_813_length_2670_cov_17.489304	2124	2204	17	2	80	0.0250000
NODE_813_length_2670_cov_17.489304	2124	2204	18	5	80	0.0625000
NODE_813_length_2670_cov_17.489304	2177	2257	12	39	80	0.4875000
NODE_813_length_2670_cov_17.489304	2177	2257	13	20	80	0.2500000
NODE_813_length_2670_cov_17.489304	2177	2257	14	10	80	0.1250000
NODE_813_length_2670_cov_17.489304	2177	2257	15	11	80	0.1375000
NODE_815_length_2665_cov_19.145752	548	628	3	35	80	0.4375000
NODE_815_length_2665_cov_19.145752	548	628	4	36	80	0.4500000
NODE_815_length_2665_cov_19.145752	548	628	5	9	80	0.1125000
NODE_815_length_2665_cov_19.145752	601	681	4	47	80	0.5875000
NODE_815_length_2665_cov_19.145752	601	681	5	26	80	0.3250000
NODE_815_length_2665_cov_19.145752	601	681	6	7	80	0.0875000
NODE_815_length_2665_cov_19.145752	2099	2176	13	4	77	0.0519481
NODE_815_length_2665_cov_19.145752	2099	2176	14	25	77	0.3246753
NODE_815_length_2665_cov_19.145752	2099	2176	15	6	77	0.0779221
NODE_815_length_2665_cov_19.145752	2099	2176	17	3	77	0.0389610
NODE_815_length_2665_cov_19.145752	2099	2176	21	11	77	0.1428571
NODE_815_length_2665_cov_19.145752	2099	2176	23	4	77	0.0519481
NODE_815_length_2665_cov_19.145752	2099	2176	24	24	77	0.3116883
NODE_815_length_2665_cov_19.145752	2172	2252	5	4	80	0.0500000
NODE_815_length_2665_cov_19.145752	2172	2252	7	5	80	0.0625000
NODE_815_length_2665_cov_19.145752	2172	2252	8	1	80	0.0125000
NODE_815_length_2665_cov_19.145752	2172	2252	10	1	80	0.0125000
NODE_815_length_2665_cov_19.145752	2172	2252	11	22	80	0.2750000
NODE_815_length_2665_cov_19.145752	2172	2252	12	31	80	0.3875000
NODE_815_length_2665_cov_19.145752	2172	2252	13	5	80	0.0625000
NODE_815_length_2665_cov_19.145752	2172	2252	14	6	80	0.0750000
NODE_815_length_2665_cov_19.145752	2172	2252	16	5	80	0.0625000
NODE_815_length_2665_cov_19.145752	2172	2252	5	4	80	0.0500000
NODE_815_length_2665_cov_19.145752	2172	2252	7	5	80	0.0625000
NODE_815_length_2665_cov_19.145752	2172	2252	8	1	80	0.0125000
NODE_815_length_2665_cov_19.145752	2172	2252	10	1	80	0.0125000
NODE_815_length_2665_cov_19.145752	2172	2252	11	22	80	0.2750000
NODE_815_length_2665_cov_19.145752	2172	2252	12	31	80	0.3875000
NODE_815_length_2665_cov_19.145752	2172	2252	13	5	80	0.0625000
NODE_815_length_2665_cov_19.145752	2172	2252	14	6	80	0.0750000
NODE_815_length_2665_cov_19.145752	2172	2252	16	5	80	0.0625000
NODE_815_length_2665_cov_19.145752	2225	2267	5	19	42	0.4523810
NODE_815_length_2665_cov_19.145752	2225	2267	7	5	42	0.1190476
NODE_815_length_2665_cov_19.145752	2225	2267	8	1	42	0.0238095
NODE_815_length_2665_cov_19.145752	2225	2267	10	1	42	0.0238095
NODE_815_length_2665_cov_19.145752	2225	2267	11	16	42	0.3809524
NODE_816_length_2664_cov_4.175049	2005	2085	6	51	80	0.6375000
NODE_816_length_2664_cov_4.175049	2005	2085	7	7	80	0.0875000
NODE_816_length_2664_cov_4.175049	2005	2085	8	22	80	0.2750000
NODE_816_length_2664_cov_4.175049	2058	2138	3	1	80	0.0125000
NODE_816_length_2664_cov_4.175049	2058	2138	5	30	80	0.3750000
NODE_816_length_2664_cov_4.175049	2058	2138	6	49	80	0.6125000
NODE_822_length_2650_cov_19.800862	800	880	12	3	80	0.0375000
NODE_822_length_2650_cov_19.800862	800	880	13	42	80	0.5250000
NODE_822_length_2650_cov_19.800862	800	880	14	24	80	0.3000000
NODE_822_length_2650_cov_19.800862	800	880	15	11	80	0.1375000
NODE_824_length_2645_cov_8.618225	931	1011	2	80	80	1.0000000
NODE_824_length_2645_cov_8.618225	984	1064	0	47	80	0.5875000
NODE_824_length_2645_cov_8.618225	984	1064	2	33	80	0.4125000
NODE_827_length_2640_cov_16.462810	94	164	29	9	70	0.1285714
NODE_827_length_2640_cov_16.462810	94	164	30	14	70	0.2000000
NODE_827_length_2640_cov_16.462810	94	164	31	2	70	0.0285714
NODE_827_length_2640_cov_16.462810	94	164	32	5	70	0.0714286
NODE_827_length_2640_cov_16.462810	94	164	33	6	70	0.0857143
NODE_827_length_2640_cov_16.462810	94	164	35	1	70	0.0142857
NODE_827_length_2640_cov_16.462810	94	164	37	1	70	0.0142857
NODE_827_length_2640_cov_16.462810	94	164	38	6	70	0.0857143
NODE_827_length_2640_cov_16.462810	94	164	39	16	70	0.2285714
NODE_827_length_2640_cov_16.462810	94	164	40	10	70	0.1428571
NODE_827_length_2640_cov_16.462810	147	209	14	6	62	0.0967742
NODE_827_length_2640_cov_16.462810	147	209	17	1	62	0.0161290
NODE_827_length_2640_cov_16.462810	147	209	18	10	62	0.1612903
NODE_827_length_2640_cov_16.462810	147	209	19	1	62	0.0161290
NODE_827_length_2640_cov_16.462810	147	209	20	3	62	0.0483871
NODE_827_length_2640_cov_16.462810	147	209	21	7	62	0.1129032
NODE_827_length_2640_cov_16.462810	147	209	23	1	62	0.0161290
NODE_827_length_2640_cov_16.462810	147	209	24	10	62	0.1612903
NODE_827_length_2640_cov_16.462810	147	209	26	1	62	0.0161290
NODE_827_length_2640_cov_16.462810	147	209	27	2	62	0.0322581
NODE_827_length_2640_cov_16.462810	147	209	28	2	62	0.0322581
NODE_827_length_2640_cov_16.462810	147	209	29	8	62	0.1290323
NODE_827_length_2640_cov_16.462810	147	209	30	4	62	0.0645161
NODE_827_length_2640_cov_16.462810	147	209	31	2	62	0.0322581
NODE_827_length_2640_cov_16.462810	147	209	32	4	62	0.0645161
NODE_828_length_2636_cov_200.191171	561	641	43	4	80	0.0500000
NODE_828_length_2636_cov_200.191171	561	641	44	5	80	0.0625000
NODE_828_length_2636_cov_200.191171	561	641	46	4	80	0.0500000
NODE_828_length_2636_cov_200.191171	561	641	47	3	80	0.0375000
NODE_828_length_2636_cov_200.191171	561	641	48	19	80	0.2375000
NODE_828_length_2636_cov_200.191171	561	641	49	4	80	0.0500000
NODE_828_length_2636_cov_200.191171	561	641	54	1	80	0.0125000
NODE_828_length_2636_cov_200.191171	561	641	56	3	80	0.0375000
NODE_828_length_2636_cov_200.191171	561	641	59	15	80	0.1875000
NODE_828_length_2636_cov_200.191171	561	641	60	21	80	0.2625000
NODE_828_length_2636_cov_200.191171	561	641	61	1	80	0.0125000
NODE_828_length_2636_cov_200.191171	614	695	11	1	81	0.0123457
NODE_828_length_2636_cov_200.191171	614	695	13	3	81	0.0370370
NODE_828_length_2636_cov_200.191171	614	695	16	5	81	0.0617284
NODE_828_length_2636_cov_200.191171	614	695	17	3	81	0.0370370
NODE_828_length_2636_cov_200.191171	614	695	20	1	81	0.0123457
NODE_828_length_2636_cov_200.191171	614	695	21	1	81	0.0123457
NODE_828_length_2636_cov_200.191171	614	695	24	7	81	0.0864198
NODE_828_length_2636_cov_200.191171	614	695	25	4	81	0.0493827
NODE_828_length_2636_cov_200.191171	614	695	26	7	81	0.0864198
NODE_828_length_2636_cov_200.191171	614	695	28	4	81	0.0493827
NODE_828_length_2636_cov_200.191171	614	695	29	3	81	0.0370370
NODE_828_length_2636_cov_200.191171	614	695	31	2	81	0.0246914
NODE_828_length_2636_cov_200.191171	614	695	32	1	81	0.0123457
NODE_828_length_2636_cov_200.191171	614	695	34	1	81	0.0123457
NODE_828_length_2636_cov_200.191171	614	695	35	1	81	0.0123457
NODE_828_length_2636_cov_200.191171	614	695	36	7	81	0.0864198
NODE_828_length_2636_cov_200.191171	614	695	40	1	81	0.0123457
NODE_828_length_2636_cov_200.191171	614	695	41	1	81	0.0123457
NODE_828_length_2636_cov_200.191171	614	695	43	5	81	0.0617284
NODE_828_length_2636_cov_200.191171	614	695	44	5	81	0.0617284
NODE_828_length_2636_cov_200.191171	614	695	46	4	81	0.0493827
NODE_828_length_2636_cov_200.191171	614	695	47	1	81	0.0123457
NODE_828_length_2636_cov_200.191171	614	695	48	10	81	0.1234568
NODE_828_length_2636_cov_200.191171	614	695	49	3	81	0.0370370
NODE_830_length_2631_cov_10.831754	446	526	18	5	80	0.0625000
NODE_830_length_2631_cov_10.831754	446	526	19	12	80	0.1500000
NODE_830_length_2631_cov_10.831754	446	526	20	6	80	0.0750000
NODE_830_length_2631_cov_10.831754	446	526	21	2	80	0.0250000
NODE_830_length_2631_cov_10.831754	446	526	23	1	80	0.0125000
NODE_830_length_2631_cov_10.831754	446	526	24	4	80	0.0500000
NODE_830_length_2631_cov_10.831754	446	526	25	4	80	0.0500000
NODE_830_length_2631_cov_10.831754	446	526	26	4	80	0.0500000
NODE_830_length_2631_cov_10.831754	446	526	27	11	80	0.1375000
NODE_830_length_2631_cov_10.831754	446	526	28	11	80	0.1375000
NODE_830_length_2631_cov_10.831754	446	526	29	15	80	0.1875000
NODE_830_length_2631_cov_10.831754	446	526	30	5	80	0.0625000
NODE_830_length_2631_cov_10.831754	499	572	26	4	73	0.0547945
NODE_830_length_2631_cov_10.831754	499	572	27	4	73	0.0547945
NODE_830_length_2631_cov_10.831754	499	572	28	13	73	0.1780822
NODE_830_length_2631_cov_10.831754	499	572	29	25	73	0.3424658
NODE_830_length_2631_cov_10.831754	499	572	30	11	73	0.1506849
NODE_830_length_2631_cov_10.831754	499	572	31	15	73	0.2054795
NODE_830_length_2631_cov_10.831754	499	572	32	1	73	0.0136986
NODE_833_length_2622_cov_63.057471	1877	1953	47	1	76	0.0131579
NODE_833_length_2622_cov_63.057471	1877	1953	48	11	76	0.1447368
NODE_833_length_2622_cov_63.057471	1877	1953	49	8	76	0.1052632
NODE_833_length_2622_cov_63.057471	1877	1953	50	9	76	0.1184211
NODE_833_length_2622_cov_63.057471	1877	1953	51	36	76	0.4736842
NODE_833_length_2622_cov_63.057471	1877	1953	52	2	76	0.0263158
NODE_833_length_2622_cov_63.057471	1877	1953	53	8	76	0.1052632
NODE_833_length_2622_cov_63.057471	1877	1953	56	1	76	0.0131579
NODE_833_length_2622_cov_63.057471	2426	2506	48	3	80	0.0375000
NODE_833_length_2622_cov_63.057471	2426	2506	50	13	80	0.1625000
NODE_833_length_2622_cov_63.057471	2426	2506	51	9	80	0.1125000
NODE_833_length_2622_cov_63.057471	2426	2506	52	3	80	0.0375000
NODE_833_length_2622_cov_63.057471	2426	2506	53	1	80	0.0125000
NODE_833_length_2622_cov_63.057471	2426	2506	54	3	80	0.0375000
NODE_833_length_2622_cov_63.057471	2426	2506	55	6	80	0.0750000
NODE_833_length_2622_cov_63.057471	2426	2506	56	8	80	0.1000000
NODE_833_length_2622_cov_63.057471	2426	2506	57	3	80	0.0375000
NODE_833_length_2622_cov_63.057471	2426	2506	60	1	80	0.0125000
NODE_833_length_2622_cov_63.057471	2426	2506	64	1	80	0.0125000
NODE_833_length_2622_cov_63.057471	2426	2506	65	2	80	0.0250000
NODE_833_length_2622_cov_63.057471	2426	2506	67	4	80	0.0500000
NODE_833_length_2622_cov_63.057471	2426	2506	70	13	80	0.1625000
NODE_833_length_2622_cov_63.057471	2426	2506	71	1	80	0.0125000
NODE_833_length_2622_cov_63.057471	2426	2506	72	9	80	0.1125000
NODE_833_length_2622_cov_63.057471	2479	2559	26	3	80	0.0375000
NODE_833_length_2622_cov_63.057471	2479	2559	28	1	80	0.0125000
NODE_833_length_2622_cov_63.057471	2479	2559	30	1	80	0.0125000
NODE_833_length_2622_cov_63.057471	2479	2559	32	4	80	0.0500000
NODE_833_length_2622_cov_63.057471	2479	2559	34	1	80	0.0125000
NODE_833_length_2622_cov_63.057471	2479	2559	35	7	80	0.0875000
NODE_833_length_2622_cov_63.057471	2479	2559	39	5	80	0.0625000
NODE_833_length_2622_cov_63.057471	2479	2559	40	4	80	0.0500000
NODE_833_length_2622_cov_63.057471	2479	2559	42	1	80	0.0125000
NODE_833_length_2622_cov_63.057471	2479	2559	43	9	80	0.1125000
NODE_833_length_2622_cov_63.057471	2479	2559	45	9	80	0.1125000
NODE_833_length_2622_cov_63.057471	2479	2559	47	5	80	0.0625000
NODE_833_length_2622_cov_63.057471	2479	2559	48	6	80	0.0750000
NODE_833_length_2622_cov_63.057471	2479	2559	50	12	80	0.1500000
NODE_833_length_2622_cov_63.057471	2479	2559	51	9	80	0.1125000
NODE_833_length_2622_cov_63.057471	2479	2559	52	3	80	0.0375000
NODE_836_length_2617_cov_16.817315	1404	1448	0	44	44	1.0000000
NODE_836_length_2617_cov_16.817315	1467	1521	0	54	54	1.0000000
NODE_839_length_2610_cov_2.232577	2127	2163	1	15	36	0.4166667
NODE_839_length_2610_cov_2.232577	2127	2163	2	21	36	0.5833333
NODE_840_length_2609_cov_13.245418	2066	2146	29	11	80	0.1375000
NODE_840_length_2609_cov_13.245418	2066	2146	31	13	80	0.1625000
NODE_840_length_2609_cov_13.245418	2066	2146	32	8	80	0.1000000
NODE_840_length_2609_cov_13.245418	2066	2146	34	48	80	0.6000000
NODE_840_length_2609_cov_13.245418	2119	2199	4	3	80	0.0375000
NODE_840_length_2609_cov_13.245418	2119	2199	9	6	80	0.0750000
NODE_840_length_2609_cov_13.245418	2119	2199	12	28	80	0.3500000
NODE_840_length_2609_cov_13.245418	2119	2199	13	8	80	0.1000000
NODE_840_length_2609_cov_13.245418	2119	2199	19	2	80	0.0250000
NODE_840_length_2609_cov_13.245418	2119	2199	24	1	80	0.0125000
NODE_840_length_2609_cov_13.245418	2119	2199	25	2	80	0.0250000
NODE_840_length_2609_cov_13.245418	2119	2199	29	14	80	0.1750000
NODE_840_length_2609_cov_13.245418	2119	2199	31	13	80	0.1625000
NODE_840_length_2609_cov_13.245418	2119	2199	34	3	80	0.0375000
NODE_840_length_2609_cov_13.245418	2195	2275	3	51	80	0.6375000
NODE_840_length_2609_cov_13.245418	2195	2275	4	5	80	0.0625000
NODE_840_length_2609_cov_13.245418	2195	2275	5	23	80	0.2875000
NODE_840_length_2609_cov_13.245418	2195	2275	9	1	80	0.0125000
NODE_840_length_2609_cov_13.245418	2248	2328	1	2	80	0.0250000
NODE_840_length_2609_cov_13.245418	2248	2328	2	26	80	0.3250000
NODE_840_length_2609_cov_13.245418	2248	2328	3	52	80	0.6500000
NODE_845_length_2595_cov_5.638622	2157	2237	0	80	80	1.0000000
NODE_847_length_2594_cov_109.880160	386	450	102	4	64	0.0625000
NODE_847_length_2594_cov_109.880160	386	450	104	1	64	0.0156250
NODE_847_length_2594_cov_109.880160	386	450	105	2	64	0.0312500
NODE_847_length_2594_cov_109.880160	386	450	106	2	64	0.0312500
NODE_847_length_2594_cov_109.880160	386	450	107	1	64	0.0156250
NODE_847_length_2594_cov_109.880160	386	450	108	8	64	0.1250000
NODE_847_length_2594_cov_109.880160	386	450	110	1	64	0.0156250
NODE_847_length_2594_cov_109.880160	386	450	111	1	64	0.0156250
NODE_847_length_2594_cov_109.880160	386	450	115	1	64	0.0156250
NODE_847_length_2594_cov_109.880160	386	450	116	2	64	0.0312500
NODE_847_length_2594_cov_109.880160	386	450	117	1	64	0.0156250
NODE_847_length_2594_cov_109.880160	386	450	118	3	64	0.0468750
NODE_847_length_2594_cov_109.880160	386	450	119	5	64	0.0781250
NODE_847_length_2594_cov_109.880160	386	450	121	1	64	0.0156250
NODE_847_length_2594_cov_109.880160	386	450	122	7	64	0.1093750
NODE_847_length_2594_cov_109.880160	386	450	123	2	64	0.0312500
NODE_847_length_2594_cov_109.880160	386	450	124	1	64	0.0156250
NODE_847_length_2594_cov_109.880160	386	450	128	2	64	0.0312500
NODE_847_length_2594_cov_109.880160	386	450	129	1	64	0.0156250
NODE_847_length_2594_cov_109.880160	386	450	130	3	64	0.0468750
NODE_847_length_2594_cov_109.880160	386	450	131	1	64	0.0156250
NODE_847_length_2594_cov_109.880160	386	450	132	6	64	0.0937500
NODE_847_length_2594_cov_109.880160	386	450	133	2	64	0.0312500
NODE_847_length_2594_cov_109.880160	386	450	134	1	64	0.0156250
NODE_847_length_2594_cov_109.880160	386	450	135	2	64	0.0312500
NODE_847_length_2594_cov_109.880160	386	450	136	2	64	0.0312500
NODE_847_length_2594_cov_109.880160	386	450	137	1	64	0.0156250
NODE_856_length_2575_cov_4.890549	1860	1912	0	1	52	0.0192308
NODE_856_length_2575_cov_4.890549	1860	1912	2	3	52	0.0576923
NODE_856_length_2575_cov_4.890549	1860	1912	3	12	52	0.2307692
NODE_856_length_2575_cov_4.890549	1860	1912	4	14	52	0.2692308
NODE_856_length_2575_cov_4.890549	1860	1912	5	22	52	0.4230769
NODE_857_length_2572_cov_46.828548	302	382	0	33	80	0.4125000
NODE_857_length_2572_cov_46.828548	302	382	1	21	80	0.2625000
NODE_857_length_2572_cov_46.828548	302	382	2	26	80	0.3250000
NODE_857_length_2572_cov_46.828548	355	435	1	1	80	0.0125000
NODE_857_length_2572_cov_46.828548	355	435	2	79	80	0.9875000
NODE_868_length_2551_cov_40.721860	1104	1150	6	27	46	0.5869565
NODE_868_length_2551_cov_40.721860	1104	1150	8	19	46	0.4130435
NODE_868_length_2551_cov_40.721860	1199	1259	2	21	60	0.3500000
NODE_868_length_2551_cov_40.721860	1199	1259	4	19	60	0.3166667
NODE_868_length_2551_cov_40.721860	1199	1259	6	20	60	0.3333333
NODE_870_length_2547_cov_218.062908	436	486	0	9	50	0.1800000
NODE_870_length_2547_cov_218.062908	436	486	1	21	50	0.4200000
NODE_870_length_2547_cov_218.062908	436	486	2	8	50	0.1600000
NODE_870_length_2547_cov_218.062908	436	486	3	7	50	0.1400000
NODE_870_length_2547_cov_218.062908	436	486	17	1	50	0.0200000
NODE_870_length_2547_cov_218.062908	436	486	18	4	50	0.0800000
NODE_879_length_2527_cov_27.275947	503	548	0	42	45	0.9333333
NODE_879_length_2527_cov_27.275947	503	548	2	3	45	0.0666667
NODE_884_length_2519_cov_15.991322	2122	2202	4	2	80	0.0250000
NODE_884_length_2519_cov_15.991322	2122	2202	5	5	80	0.0625000
NODE_884_length_2519_cov_15.991322	2122	2202	7	67	80	0.8375000
NODE_884_length_2519_cov_15.991322	2122	2202	10	6	80	0.0750000
NODE_884_length_2519_cov_15.991322	2175	2255	0	32	80	0.4000000
NODE_884_length_2519_cov_15.991322	2175	2255	1	10	80	0.1250000
NODE_884_length_2519_cov_15.991322	2175	2255	4	13	80	0.1625000
NODE_884_length_2519_cov_15.991322	2175	2255	5	5	80	0.0625000
NODE_884_length_2519_cov_15.991322	2175	2255	7	20	80	0.2500000
NODE_885_length_2518_cov_7.035965	62	142	0	80	80	1.0000000
NODE_885_length_2518_cov_7.035965	2005	2085	0	20	80	0.2500000
NODE_885_length_2518_cov_7.035965	2005	2085	1	60	80	0.7500000
NODE_885_length_2518_cov_7.035965	2058	2138	1	39	80	0.4875000
NODE_885_length_2518_cov_7.035965	2058	2138	2	41	80	0.5125000
NODE_887_length_2515_cov_37.984272	393	473	0	48	80	0.6000000
NODE_887_length_2515_cov_37.984272	393	473	3	32	80	0.4000000
NODE_887_length_2515_cov_37.984272	446	526	0	80	80	1.0000000
NODE_887_length_2515_cov_37.984272	1896	1976	4	4	80	0.0500000
NODE_887_length_2515_cov_37.984272	1896	1976	5	33	80	0.4125000
NODE_887_length_2515_cov_37.984272	1896	1976	6	25	80	0.3125000
NODE_887_length_2515_cov_37.984272	1896	1976	7	15	80	0.1875000
NODE_887_length_2515_cov_37.984272	1896	1976	9	3	80	0.0375000
NODE_887_length_2515_cov_37.984272	1949	2029	6	9	80	0.1125000
NODE_887_length_2515_cov_37.984272	1949	2029	7	15	80	0.1875000
NODE_887_length_2515_cov_37.984272	1949	2029	9	6	80	0.0750000
NODE_887_length_2515_cov_37.984272	1949	2029	10	18	80	0.2250000
NODE_887_length_2515_cov_37.984272	1949	2029	11	6	80	0.0750000
NODE_887_length_2515_cov_37.984272	1949	2029	12	26	80	0.3250000
NODE_887_length_2515_cov_37.984272	2025	2105	9	5	80	0.0625000
NODE_887_length_2515_cov_37.984272	2025	2105	10	29	80	0.3625000
NODE_887_length_2515_cov_37.984272	2025	2105	11	36	80	0.4500000
NODE_887_length_2515_cov_37.984272	2025	2105	12	10	80	0.1250000
NODE_887_length_2515_cov_37.984272	2025	2104	9	5	79	0.0632911
NODE_887_length_2515_cov_37.984272	2025	2104	10	28	79	0.3544304
NODE_887_length_2515_cov_37.984272	2025	2104	11	36	79	0.4556962
NODE_887_length_2515_cov_37.984272	2025	2104	12	10	79	0.1265823
NODE_887_length_2515_cov_37.984272	2078	2158	2	5	80	0.0625000
NODE_887_length_2515_cov_37.984272	2078	2158	3	7	80	0.0875000
NODE_887_length_2515_cov_37.984272	2078	2158	4	9	80	0.1125000
NODE_887_length_2515_cov_37.984272	2078	2158	6	9	80	0.1125000
NODE_887_length_2515_cov_37.984272	2078	2158	7	20	80	0.2500000
NODE_887_length_2515_cov_37.984272	2078	2158	9	1	80	0.0125000
NODE_887_length_2515_cov_37.984272	2078	2158	10	17	80	0.2125000
NODE_887_length_2515_cov_37.984272	2078	2158	11	12	80	0.1500000
NODE_888_length_2512_cov_48.259428	1299	1379	20	4	80	0.0500000
NODE_888_length_2512_cov_48.259428	1299	1379	21	15	80	0.1875000
NODE_888_length_2512_cov_48.259428	1299	1379	22	7	80	0.0875000
NODE_888_length_2512_cov_48.259428	1299	1379	23	4	80	0.0500000
NODE_888_length_2512_cov_48.259428	1299	1379	24	2	80	0.0250000
NODE_888_length_2512_cov_48.259428	1299	1379	26	1	80	0.0125000
NODE_888_length_2512_cov_48.259428	1299	1379	28	7	80	0.0875000
NODE_888_length_2512_cov_48.259428	1299	1379	29	2	80	0.0250000
NODE_888_length_2512_cov_48.259428	1299	1379	30	9	80	0.1125000
NODE_888_length_2512_cov_48.259428	1299	1379	31	4	80	0.0500000
NODE_888_length_2512_cov_48.259428	1299	1379	32	1	80	0.0125000
NODE_888_length_2512_cov_48.259428	1299	1379	33	15	80	0.1875000
NODE_888_length_2512_cov_48.259428	1299	1379	34	4	80	0.0500000
NODE_888_length_2512_cov_48.259428	1299	1379	35	5	80	0.0625000
NODE_888_length_2512_cov_48.259428	1352	1432	30	2	80	0.0250000
NODE_888_length_2512_cov_48.259428	1352	1432	32	1	80	0.0125000
NODE_888_length_2512_cov_48.259428	1352	1432	33	15	80	0.1875000
NODE_888_length_2512_cov_48.259428	1352	1432	34	4	80	0.0500000
NODE_888_length_2512_cov_48.259428	1352	1432	35	9	80	0.1125000
NODE_888_length_2512_cov_48.259428	1352	1432	37	8	80	0.1000000
NODE_888_length_2512_cov_48.259428	1352	1432	40	4	80	0.0500000
NODE_888_length_2512_cov_48.259428	1352	1432	42	1	80	0.0125000
NODE_888_length_2512_cov_48.259428	1352	1432	43	2	80	0.0250000
NODE_888_length_2512_cov_48.259428	1352	1432	44	1	80	0.0125000
NODE_888_length_2512_cov_48.259428	1352	1432	45	12	80	0.1500000
NODE_888_length_2512_cov_48.259428	1352	1432	46	1	80	0.0125000
NODE_888_length_2512_cov_48.259428	1352	1432	47	3	80	0.0375000
NODE_888_length_2512_cov_48.259428	1352	1432	48	5	80	0.0625000
NODE_888_length_2512_cov_48.259428	1352	1432	49	5	80	0.0625000
NODE_888_length_2512_cov_48.259428	1352	1432	51	4	80	0.0500000
NODE_888_length_2512_cov_48.259428	1352	1432	52	3	80	0.0375000
NODE_888_length_2512_cov_48.259428	1428	1512	50	5	84	0.0595238
NODE_888_length_2512_cov_48.259428	1428	1512	51	1	84	0.0119048
NODE_888_length_2512_cov_48.259428	1428	1512	52	4	84	0.0476190
NODE_888_length_2512_cov_48.259428	1428	1512	53	2	84	0.0238095
NODE_888_length_2512_cov_48.259428	1428	1512	54	1	84	0.0119048
NODE_888_length_2512_cov_48.259428	1428	1512	55	2	84	0.0238095
NODE_888_length_2512_cov_48.259428	1428	1512	56	3	84	0.0357143
NODE_888_length_2512_cov_48.259428	1428	1512	57	19	84	0.2261905
NODE_888_length_2512_cov_48.259428	1428	1512	58	10	84	0.1190476
NODE_888_length_2512_cov_48.259428	1428	1512	59	15	84	0.1785714
NODE_888_length_2512_cov_48.259428	1428	1512	60	11	84	0.1309524
NODE_888_length_2512_cov_48.259428	1428	1512	61	4	84	0.0476190
NODE_888_length_2512_cov_48.259428	1428	1512	62	6	84	0.0714286
NODE_888_length_2512_cov_48.259428	1428	1512	63	1	84	0.0119048
NODE_888_length_2512_cov_48.259428	1485	1565	54	1	80	0.0125000
NODE_888_length_2512_cov_48.259428	1485	1565	55	3	80	0.0375000
NODE_888_length_2512_cov_48.259428	1485	1565	56	2	80	0.0250000
NODE_888_length_2512_cov_48.259428	1485	1565	57	9	80	0.1125000
NODE_888_length_2512_cov_48.259428	1485	1565	58	9	80	0.1125000
NODE_888_length_2512_cov_48.259428	1485	1565	59	16	80	0.2000000
NODE_888_length_2512_cov_48.259428	1485	1565	60	5	80	0.0625000
NODE_888_length_2512_cov_48.259428	1485	1565	61	1	80	0.0125000
NODE_888_length_2512_cov_48.259428	1485	1565	62	2	80	0.0250000
NODE_888_length_2512_cov_48.259428	1485	1565	63	13	80	0.1625000
NODE_888_length_2512_cov_48.259428	1485	1565	64	9	80	0.1125000
NODE_888_length_2512_cov_48.259428	1485	1565	65	6	80	0.0750000
NODE_888_length_2512_cov_48.259428	1485	1565	66	4	80	0.0500000
NODE_891_length_2505_cov_102.009975	390	470	4	3	80	0.0375000
NODE_891_length_2505_cov_102.009975	390	470	5	28	80	0.3500000
NODE_891_length_2505_cov_102.009975	390	470	6	12	80	0.1500000
NODE_891_length_2505_cov_102.009975	390	470	7	37	80	0.4625000
NODE_891_length_2505_cov_102.009975	443	510	1	3	67	0.0447761
NODE_891_length_2505_cov_102.009975	443	510	2	17	67	0.2537313
NODE_891_length_2505_cov_102.009975	443	510	3	12	67	0.1791045
NODE_891_length_2505_cov_102.009975	443	510	4	11	67	0.1641791
NODE_891_length_2505_cov_102.009975	443	510	5	24	67	0.3582090
NODE_894_length_2499_cov_2.655417	2325	2375	0	50	50	1.0000000
NODE_895_length_2498_cov_9.614840	239	281	0	42	42	1.0000000
NODE_895_length_2498_cov_9.614840	254	335	0	70	81	0.8641976
NODE_895_length_2498_cov_9.614840	254	335	1	11	81	0.1358025
NODE_895_length_2498_cov_9.614840	254	335	0	70	81	0.8641976
NODE_895_length_2498_cov_9.614840	254	335	1	11	81	0.1358025
NODE_895_length_2498_cov_9.614840	331	411	1	6	80	0.0750000
NODE_895_length_2498_cov_9.614840	331	411	3	34	80	0.4250000
NODE_895_length_2498_cov_9.614840	331	411	4	40	80	0.5000000
NODE_895_length_2498_cov_9.614840	384	464	4	80	80	1.0000000
NODE_898_length_2495_cov_5.151085	2395	2444	0	49	49	1.0000000
NODE_898_length_2495_cov_5.151085	2395	2444	0	49	49	1.0000000
NODE_898_length_2495_cov_5.151085	2396	2444	0	48	48	1.0000000
NODE_898_length_2495_cov_5.151085	2396	2444	0	48	48	1.0000000
NODE_898_length_2495_cov_5.151085	2396	2444	0	48	48	1.0000000
NODE_900_length_2492_cov_43.645215	408	488	3	64	80	0.8000000
NODE_900_length_2492_cov_43.645215	408	488	4	16	80	0.2000000
NODE_903_length_2489_cov_15.105021	204	234	1	9	30	0.3000000
NODE_903_length_2489_cov_15.105021	204	234	3	9	30	0.3000000
NODE_903_length_2489_cov_15.105021	204	234	4	7	30	0.2333333
NODE_903_length_2489_cov_15.105021	204	234	5	5	30	0.1666667
NODE_905_length_2488_cov_2.434910	2141	2200	7	19	59	0.3220339
NODE_905_length_2488_cov_2.434910	2141	2200	9	24	59	0.4067796
NODE_905_length_2488_cov_2.434910	2141	2200	10	13	59	0.2203390
NODE_905_length_2488_cov_2.434910	2141	2200	11	3	59	0.0508475
NODE_906_length_2484_cov_335.301887	224	279	93	4	55	0.0727273
NODE_906_length_2484_cov_335.301887	224	279	94	9	55	0.1636364
NODE_906_length_2484_cov_335.301887	224	279	95	1	55	0.0181818
NODE_906_length_2484_cov_335.301887	224	279	96	3	55	0.0545455
NODE_906_length_2484_cov_335.301887	224	279	98	13	55	0.2363636
NODE_906_length_2484_cov_335.301887	224	279	99	2	55	0.0363636
NODE_906_length_2484_cov_335.301887	224	279	104	2	55	0.0363636
NODE_906_length_2484_cov_335.301887	224	279	105	3	55	0.0545455
NODE_906_length_2484_cov_335.301887	224	279	106	4	55	0.0727273
NODE_906_length_2484_cov_335.301887	224	279	110	3	55	0.0545455
NODE_906_length_2484_cov_335.301887	224	279	111	4	55	0.0727273
NODE_906_length_2484_cov_335.301887	224	279	112	7	55	0.1272727
NODE_906_length_2484_cov_335.301887	252	332	61	1	80	0.0125000
NODE_906_length_2484_cov_335.301887	252	332	63	1	80	0.0125000
NODE_906_length_2484_cov_335.301887	252	332	70	1	80	0.0125000
NODE_906_length_2484_cov_335.301887	252	332	74	1	80	0.0125000
NODE_906_length_2484_cov_335.301887	252	332	77	9	80	0.1125000
NODE_906_length_2484_cov_335.301887	252	332	78	2	80	0.0250000
NODE_906_length_2484_cov_335.301887	252	332	79	1	80	0.0125000
NODE_906_length_2484_cov_335.301887	252	332	80	1	80	0.0125000
NODE_906_length_2484_cov_335.301887	252	332	81	2	80	0.0250000
NODE_906_length_2484_cov_335.301887	252	332	82	1	80	0.0125000
NODE_906_length_2484_cov_335.301887	252	332	85	1	80	0.0125000
NODE_906_length_2484_cov_335.301887	252	332	88	1	80	0.0125000
NODE_906_length_2484_cov_335.301887	252	332	90	3	80	0.0375000
NODE_906_length_2484_cov_335.301887	252	332	92	2	80	0.0250000
NODE_906_length_2484_cov_335.301887	252	332	93	2	80	0.0250000
NODE_906_length_2484_cov_335.301887	252	332	94	3	80	0.0375000
NODE_906_length_2484_cov_335.301887	252	332	95	10	80	0.1250000
NODE_906_length_2484_cov_335.301887	252	332	98	3	80	0.0375000
NODE_906_length_2484_cov_335.301887	252	332	99	1	80	0.0125000
NODE_906_length_2484_cov_335.301887	252	332	104	2	80	0.0250000
NODE_906_length_2484_cov_335.301887	252	332	105	3	80	0.0375000
NODE_906_length_2484_cov_335.301887	252	332	106	4	80	0.0500000
NODE_906_length_2484_cov_335.301887	252	332	107	3	80	0.0375000
NODE_906_length_2484_cov_335.301887	252	332	108	1	80	0.0125000
NODE_906_length_2484_cov_335.301887	252	332	109	3	80	0.0375000
NODE_906_length_2484_cov_335.301887	252	332	110	7	80	0.0875000
NODE_906_length_2484_cov_335.301887	252	332	111	4	80	0.0500000
NODE_906_length_2484_cov_335.301887	252	332	112	7	80	0.0875000
NODE_912_length_2479_cov_90.381092	369	449	0	80	80	1.0000000
NODE_912_length_2479_cov_90.381092	422	499	0	32	77	0.4155844
NODE_912_length_2479_cov_90.381092	422	499	1	45	77	0.5844156
NODE_912_length_2479_cov_90.381092	1610	1685	8	1	75	0.0133333
NODE_912_length_2479_cov_90.381092	1610	1685	9	2	75	0.0266667
NODE_912_length_2479_cov_90.381092	1610	1685	13	2	75	0.0266667
NODE_912_length_2479_cov_90.381092	1610	1685	15	6	75	0.0800000
NODE_912_length_2479_cov_90.381092	1610	1685	18	1	75	0.0133333
NODE_912_length_2479_cov_90.381092	1610	1685	23	5	75	0.0666667
NODE_912_length_2479_cov_90.381092	1610	1685	29	2	75	0.0266667
NODE_912_length_2479_cov_90.381092	1610	1685	32	1	75	0.0133333
NODE_912_length_2479_cov_90.381092	1610	1685	33	1	75	0.0133333
NODE_912_length_2479_cov_90.381092	1610	1685	35	2	75	0.0266667
NODE_912_length_2479_cov_90.381092	1610	1685	36	3	75	0.0400000
NODE_912_length_2479_cov_90.381092	1610	1685	37	5	75	0.0666667
NODE_912_length_2479_cov_90.381092	1610	1685	38	2	75	0.0266667
NODE_912_length_2479_cov_90.381092	1610	1685	40	1	75	0.0133333
NODE_912_length_2479_cov_90.381092	1610	1685	41	1	75	0.0133333
NODE_912_length_2479_cov_90.381092	1610	1685	42	4	75	0.0533333
NODE_912_length_2479_cov_90.381092	1610	1685	44	2	75	0.0266667
NODE_912_length_2479_cov_90.381092	1610	1685	45	3	75	0.0400000
NODE_912_length_2479_cov_90.381092	1610	1685	47	8	75	0.1066667
NODE_912_length_2479_cov_90.381092	1610	1685	48	2	75	0.0266667
NODE_912_length_2479_cov_90.381092	1610	1685	52	2	75	0.0266667
NODE_912_length_2479_cov_90.381092	1610	1685	53	3	75	0.0400000
NODE_912_length_2479_cov_90.381092	1610	1685	55	1	75	0.0133333
NODE_912_length_2479_cov_90.381092	1610	1685	56	3	75	0.0400000
NODE_912_length_2479_cov_90.381092	1610	1685	59	7	75	0.0933333
NODE_912_length_2479_cov_90.381092	1610	1685	60	1	75	0.0133333
NODE_912_length_2479_cov_90.381092	1610	1685	61	4	75	0.0533333
NODE_912_length_2479_cov_90.381092	1658	1730	47	4	72	0.0555556
NODE_912_length_2479_cov_90.381092	1658	1730	48	2	72	0.0277778
NODE_912_length_2479_cov_90.381092	1658	1730	52	2	72	0.0277778
NODE_912_length_2479_cov_90.381092	1658	1730	53	3	72	0.0416667
NODE_912_length_2479_cov_90.381092	1658	1730	55	1	72	0.0138889
NODE_912_length_2479_cov_90.381092	1658	1730	56	3	72	0.0416667
NODE_912_length_2479_cov_90.381092	1658	1730	58	6	72	0.0833333
NODE_912_length_2479_cov_90.381092	1658	1730	59	18	72	0.2500000
NODE_912_length_2479_cov_90.381092	1658	1730	60	7	72	0.0972222
NODE_912_length_2479_cov_90.381092	1658	1730	61	19	72	0.2638889
NODE_912_length_2479_cov_90.381092	1658	1730	62	5	72	0.0694444
NODE_912_length_2479_cov_90.381092	1658	1730	63	2	72	0.0277778
NODE_913_length_2479_cov_3.433193	2379	2426	0	47	47	1.0000000
NODE_913_length_2479_cov_3.433193	2399	2479	0	80	80	1.0000000
NODE_915_length_2474_cov_7.237895	399	479	3	3	80	0.0375000
NODE_915_length_2474_cov_7.237895	399	479	5	6	80	0.0750000
NODE_915_length_2474_cov_7.237895	399	479	8	1	80	0.0125000
NODE_915_length_2474_cov_7.237895	399	479	11	31	80	0.3875000
NODE_915_length_2474_cov_7.237895	399	479	12	39	80	0.4875000
NODE_915_length_2474_cov_7.237895	452	532	0	35	80	0.4375000
NODE_915_length_2474_cov_7.237895	452	532	1	17	80	0.2125000
NODE_915_length_2474_cov_7.237895	452	532	2	1	80	0.0125000
NODE_915_length_2474_cov_7.237895	452	532	3	3	80	0.0375000
NODE_915_length_2474_cov_7.237895	452	532	5	6	80	0.0750000
NODE_915_length_2474_cov_7.237895	452	532	8	1	80	0.0125000
NODE_915_length_2474_cov_7.237895	452	532	11	17	80	0.2125000
NODE_922_length_2465_cov_3.098056	2133	2213	0	80	80	1.0000000
NODE_922_length_2465_cov_3.098056	2191	2253	0	62	62	1.0000000
NODE_923_length_2464_cov_24.562791	331	409	6	14	78	0.1794872
NODE_923_length_2464_cov_24.562791	331	409	7	64	78	0.8205128
NODE_923_length_2464_cov_24.562791	382	462	3	7	80	0.0875000
NODE_923_length_2464_cov_24.562791	382	462	5	4	80	0.0500000
NODE_923_length_2464_cov_24.562791	382	462	6	46	80	0.5750000
NODE_923_length_2464_cov_24.562791	382	462	7	13	80	0.1625000
NODE_923_length_2464_cov_24.562791	382	462	8	10	80	0.1250000
NODE_924_length_2461_cov_2.696444	292	372	0	80	80	1.0000000
NODE_924_length_2461_cov_2.696444	345	425	0	80	80	1.0000000
NODE_938_length_2447_cov_16.079216	2344	2424	2	2	80	0.0250000
NODE_938_length_2447_cov_16.079216	2344	2424	3	23	80	0.2875000
NODE_938_length_2447_cov_16.079216	2344	2424	4	2	80	0.0250000
NODE_938_length_2447_cov_16.079216	2344	2424	5	5	80	0.0625000
NODE_938_length_2447_cov_16.079216	2344	2424	6	48	80	0.6000000
NODE_938_length_2447_cov_16.079216	2397	2447	2	25	50	0.5000000
NODE_938_length_2447_cov_16.079216	2397	2447	3	23	50	0.4600000
NODE_938_length_2447_cov_16.079216	2397	2447	4	2	50	0.0400000
NODE_940_length_2446_cov_2.341287	1521	1578	0	57	57	1.0000000
NODE_940_length_2446_cov_2.341287	1551	1593	0	42	42	1.0000000
NODE_949_length_2437_cov_13.341745	418	498	4	2	80	0.0250000
NODE_949_length_2437_cov_13.341745	418	498	5	5	80	0.0625000
NODE_949_length_2437_cov_13.341745	418	498	6	22	80	0.2750000
NODE_949_length_2437_cov_13.341745	418	498	7	47	80	0.5875000
NODE_949_length_2437_cov_13.341745	418	498	8	4	80	0.0500000
NODE_949_length_2437_cov_13.341745	471	551	6	35	80	0.4375000
NODE_949_length_2437_cov_13.341745	471	551	7	37	80	0.4625000
NODE_949_length_2437_cov_13.341745	471	551	8	4	80	0.0500000
NODE_949_length_2437_cov_13.341745	471	551	14	4	80	0.0500000
NODE_951_length_2432_cov_70.360909	1875	1955	0	2	80	0.0250000
NODE_951_length_2432_cov_70.360909	1875	1955	14	10	80	0.1250000
NODE_951_length_2432_cov_70.360909	1875	1955	15	8	80	0.1000000
NODE_951_length_2432_cov_70.360909	1875	1955	16	2	80	0.0250000
NODE_951_length_2432_cov_70.360909	1875	1955	20	5	80	0.0625000
NODE_951_length_2432_cov_70.360909	1875	1955	21	35	80	0.4375000
NODE_951_length_2432_cov_70.360909	1875	1955	24	13	80	0.1625000
NODE_951_length_2432_cov_70.360909	1875	1955	26	5	80	0.0625000
NODE_951_length_2432_cov_70.360909	1928	2008	21	9	80	0.1125000
NODE_951_length_2432_cov_70.360909	1928	2008	22	5	80	0.0625000
NODE_951_length_2432_cov_70.360909	1928	2008	24	13	80	0.1625000
NODE_951_length_2432_cov_70.360909	1928	2008	25	1	80	0.0125000
NODE_951_length_2432_cov_70.360909	1928	2008	26	29	80	0.3625000
NODE_951_length_2432_cov_70.360909	1928	2008	27	16	80	0.2000000
NODE_951_length_2432_cov_70.360909	1928	2008	28	1	80	0.0125000
NODE_951_length_2432_cov_70.360909	1928	2008	29	6	80	0.0750000
NODE_955_length_2430_cov_19.835264	0	68	6	10	68	0.1470588
NODE_955_length_2430_cov_19.835264	0	68	8	8	68	0.1176471
NODE_955_length_2430_cov_19.835264	0	68	9	3	68	0.0441176
NODE_955_length_2430_cov_19.835264	0	68	10	23	68	0.3382353
NODE_955_length_2430_cov_19.835264	0	68	11	18	68	0.2647059
NODE_955_length_2430_cov_19.835264	0	68	12	1	68	0.0147059
NODE_955_length_2430_cov_19.835264	0	68	14	5	68	0.0735294
NODE_955_length_2430_cov_19.835264	0	24	6	10	24	0.4166667
NODE_955_length_2430_cov_19.835264	0	24	8	8	24	0.3333333
NODE_955_length_2430_cov_19.835264	0	24	9	3	24	0.1250000
NODE_955_length_2430_cov_19.835264	0	24	10	3	24	0.1250000
NODE_956_length_2428_cov_179.842422	538	618	4	41	80	0.5125000
NODE_956_length_2428_cov_179.842422	538	618	5	31	80	0.3875000
NODE_956_length_2428_cov_179.842422	538	618	7	8	80	0.1000000
NODE_956_length_2428_cov_179.842422	591	671	4	19	80	0.2375000
NODE_956_length_2428_cov_179.842422	591	671	5	20	80	0.2500000
NODE_956_length_2428_cov_179.842422	591	671	6	14	80	0.1750000
NODE_956_length_2428_cov_179.842422	591	671	7	27	80	0.3375000
NODE_956_length_2428_cov_179.842422	667	747	3	6	80	0.0750000
NODE_956_length_2428_cov_179.842422	667	747	5	74	80	0.9250000
NODE_956_length_2428_cov_179.842422	720	800	0	19	80	0.2375000
NODE_956_length_2428_cov_179.842422	720	800	2	21	80	0.2625000
NODE_956_length_2428_cov_179.842422	720	800	5	40	80	0.5000000
NODE_956_length_2428_cov_179.842422	1308	1388	9	16	80	0.2000000
NODE_956_length_2428_cov_179.842422	1308	1388	10	4	80	0.0500000
NODE_956_length_2428_cov_179.842422	1308	1388	11	30	80	0.3750000
NODE_956_length_2428_cov_179.842422	1308	1388	12	30	80	0.3750000
NODE_956_length_2428_cov_179.842422	1361	1441	9	16	80	0.2000000
NODE_956_length_2428_cov_179.842422	1361	1441	11	21	80	0.2625000
NODE_956_length_2428_cov_179.842422	1361	1441	12	5	80	0.0625000
NODE_956_length_2428_cov_179.842422	1361	1441	14	30	80	0.3750000
NODE_956_length_2428_cov_179.842422	1361	1441	15	5	80	0.0625000
NODE_956_length_2428_cov_179.842422	1361	1441	16	3	80	0.0375000
NODE_956_length_2428_cov_179.842422	1437	1517	14	26	80	0.3250000
NODE_956_length_2428_cov_179.842422	1437	1517	15	47	80	0.5875000
NODE_956_length_2428_cov_179.842422	1437	1517	16	1	80	0.0125000
NODE_956_length_2428_cov_179.842422	1437	1517	17	6	80	0.0750000
NODE_956_length_2428_cov_179.842422	1490	1570	7	6	80	0.0750000
NODE_956_length_2428_cov_179.842422	1490	1570	9	11	80	0.1375000
NODE_956_length_2428_cov_179.842422	1490	1570	11	1	80	0.0125000
NODE_956_length_2428_cov_179.842422	1490	1570	12	17	80	0.2125000
NODE_956_length_2428_cov_179.842422	1490	1570	14	18	80	0.2250000
NODE_956_length_2428_cov_179.842422	1490	1570	15	20	80	0.2500000
NODE_956_length_2428_cov_179.842422	1490	1570	17	7	80	0.0875000
NODE_956_length_2428_cov_179.842422	1986	2026	56	12	40	0.3000000
NODE_956_length_2428_cov_179.842422	1986	2026	57	4	40	0.1000000
NODE_956_length_2428_cov_179.842422	1986	2026	58	1	40	0.0250000
NODE_956_length_2428_cov_179.842422	1986	2026	60	3	40	0.0750000
NODE_956_length_2428_cov_179.842422	1986	2026	61	2	40	0.0500000
NODE_956_length_2428_cov_179.842422	1986	2026	63	4	40	0.1000000
NODE_956_length_2428_cov_179.842422	1986	2026	65	5	40	0.1250000
NODE_956_length_2428_cov_179.842422	1986	2026	66	2	40	0.0500000
NODE_956_length_2428_cov_179.842422	1986	2026	77	1	40	0.0250000
NODE_956_length_2428_cov_179.842422	1986	2026	78	1	40	0.0250000
NODE_956_length_2428_cov_179.842422	1986	2026	80	1	40	0.0250000
NODE_956_length_2428_cov_179.842422	1986	2026	81	1	40	0.0250000
NODE_956_length_2428_cov_179.842422	1986	2026	82	2	40	0.0500000
NODE_956_length_2428_cov_179.842422	1986	2026	83	1	40	0.0250000
NODE_959_length_2422_cov_6.665088	197	255	2	58	58	1.0000000
NODE_963_length_2414_cov_32.871706	411	491	17	31	80	0.3875000
NODE_963_length_2414_cov_32.871706	411	491	18	22	80	0.2750000
NODE_963_length_2414_cov_32.871706	411	491	19	4	80	0.0500000
NODE_963_length_2414_cov_32.871706	411	491	20	15	80	0.1875000
NODE_963_length_2414_cov_32.871706	411	491	21	8	80	0.1000000
NODE_963_length_2414_cov_32.871706	464	544	7	2	80	0.0250000
NODE_963_length_2414_cov_32.871706	464	544	8	1	80	0.0125000
NODE_963_length_2414_cov_32.871706	464	544	9	24	80	0.3000000
NODE_963_length_2414_cov_32.871706	464	544	10	10	80	0.1250000
NODE_963_length_2414_cov_32.871706	464	544	12	5	80	0.0625000
NODE_963_length_2414_cov_32.871706	464	544	13	7	80	0.0875000
NODE_963_length_2414_cov_32.871706	464	544	14	2	80	0.0250000
NODE_963_length_2414_cov_32.871706	464	544	17	29	80	0.3625000
NODE_964_length_2414_cov_2.105832	2349	2390	0	41	41	1.0000000
NODE_968_length_2410_cov_9.107313	1874	1954	1	11	80	0.1375000
NODE_968_length_2410_cov_9.107313	1874	1954	3	8	80	0.1000000
NODE_968_length_2410_cov_9.107313	1874	1954	5	46	80	0.5750000
NODE_968_length_2410_cov_9.107313	1874	1954	6	15	80	0.1875000
NODE_968_length_2410_cov_9.107313	1927	2007	5	35	80	0.4375000
NODE_968_length_2410_cov_9.107313	1927	2007	6	45	80	0.5625000
NODE_977_length_2390_cov_20.371454	1753	1833	2	56	80	0.7000000
NODE_977_length_2390_cov_20.371454	1753	1833	4	24	80	0.3000000
NODE_977_length_2390_cov_20.371454	1806	1886	0	18	80	0.2250000
NODE_977_length_2390_cov_20.371454	1806	1886	2	62	80	0.7750000
NODE_979_length_2389_cov_17.904803	1601	1681	13	48	80	0.6000000
NODE_979_length_2389_cov_17.904803	1601	1681	14	16	80	0.2000000
NODE_979_length_2389_cov_17.904803	1601	1681	15	1	80	0.0125000
NODE_979_length_2389_cov_17.904803	1601	1681	16	1	80	0.0125000
NODE_979_length_2389_cov_17.904803	1601	1681	17	7	80	0.0875000
NODE_979_length_2389_cov_17.904803	1601	1681	18	7	80	0.0875000
NODE_979_length_2389_cov_17.904803	1654	1734	5	4	80	0.0500000
NODE_979_length_2389_cov_17.904803	1654	1734	9	5	80	0.0625000
NODE_979_length_2389_cov_17.904803	1654	1734	10	39	80	0.4875000
NODE_979_length_2389_cov_17.904803	1654	1734	13	14	80	0.1750000
NODE_979_length_2389_cov_17.904803	1654	1734	14	18	80	0.2250000
NODE_979_length_2389_cov_17.904803	1730	1810	1	49	80	0.6125000
NODE_979_length_2389_cov_17.904803	1730	1810	2	1	80	0.0125000
NODE_979_length_2389_cov_17.904803	1730	1810	3	1	80	0.0125000
NODE_979_length_2389_cov_17.904803	1730	1810	4	23	80	0.2875000
NODE_979_length_2389_cov_17.904803	1730	1810	5	6	80	0.0750000
NODE_979_length_2389_cov_17.904803	1783	1863	0	28	80	0.3500000
NODE_979_length_2389_cov_17.904803	1783	1863	1	33	80	0.4125000
NODE_979_length_2389_cov_17.904803	1783	1863	3	19	80	0.2375000
NODE_988_length_2381_cov_32.280894	398	478	2	3	80	0.0375000
NODE_988_length_2381_cov_32.280894	398	478	3	5	80	0.0625000
NODE_988_length_2381_cov_32.280894	398	478	7	31	80	0.3875000
NODE_988_length_2381_cov_32.280894	398	478	8	7	80	0.0875000
NODE_988_length_2381_cov_32.280894	398	478	9	34	80	0.4250000
NODE_988_length_2381_cov_32.280894	451	531	2	3	80	0.0375000
NODE_988_length_2381_cov_32.280894	451	531	3	58	80	0.7250000
NODE_988_length_2381_cov_32.280894	451	531	8	7	80	0.0875000
NODE_988_length_2381_cov_32.280894	451	531	9	12	80	0.1500000
NODE_988_length_2381_cov_32.280894	527	607	1	34	80	0.4250000
NODE_988_length_2381_cov_32.280894	527	607	3	46	80	0.5750000
NODE_988_length_2381_cov_32.280894	580	660	0	37	80	0.4625000
NODE_988_length_2381_cov_32.280894	580	660	1	43	80	0.5375000
NODE_988_length_2381_cov_32.280894	2288	2368	0	80	80	1.0000000
NODE_997_length_2369_cov_4.896916	241	321	1	6	80	0.0750000
NODE_997_length_2369_cov_4.896916	241	321	2	74	80	0.9250000
NODE_997_length_2369_cov_4.896916	294	374	1	16	80	0.2000000
NODE_997_length_2369_cov_4.896916	294	374	2	64	80	0.8000000
NODE_1002_length_2364_cov_2.482561	0	79	0	79	79	1.0000000
NODE_1004_length_2360_cov_8.620080	587	651	5	64	64	1.0000000
NODE_1004_length_2360_cov_8.620080	587	651	5	64	64	1.0000000
NODE_1004_length_2360_cov_8.620080	624	684	0	1	60	0.0166667
NODE_1004_length_2360_cov_8.620080	624	684	3	23	60	0.3833333
NODE_1004_length_2360_cov_8.620080	624	684	5	36	60	0.6000000
NODE_1004_length_2360_cov_8.620080	1827	1907	2	12	80	0.1500000
NODE_1004_length_2360_cov_8.620080	1827	1907	5	1	80	0.0125000
NODE_1004_length_2360_cov_8.620080	1827	1907	7	20	80	0.2500000
NODE_1004_length_2360_cov_8.620080	1827	1907	9	32	80	0.4000000
NODE_1004_length_2360_cov_8.620080	1827	1907	11	5	80	0.0625000
NODE_1004_length_2360_cov_8.620080	1827	1907	14	10	80	0.1250000
NODE_1004_length_2360_cov_8.620080	1880	1960	9	12	80	0.1500000
NODE_1004_length_2360_cov_8.620080	1880	1960	11	5	80	0.0625000
NODE_1004_length_2360_cov_8.620080	1880	1960	14	56	80	0.7000000
NODE_1004_length_2360_cov_8.620080	1880	1960	16	7	80	0.0875000
NODE_1005_length_2359_cov_22.317257	958	1038	4	8	80	0.1000000
NODE_1005_length_2359_cov_22.317257	958	1038	6	72	80	0.9000000
NODE_1005_length_2359_cov_22.317257	1011	1091	0	2	80	0.0250000
NODE_1005_length_2359_cov_22.317257	1011	1091	1	8	80	0.1000000
NODE_1005_length_2359_cov_22.317257	1011	1091	2	9	80	0.1125000
NODE_1005_length_2359_cov_22.317257	1011	1091	4	42	80	0.5250000
NODE_1005_length_2359_cov_22.317257	1011	1091	6	19	80	0.2375000
NODE_1008_length_2357_cov_25.711249	716	796	4	6	80	0.0750000
NODE_1008_length_2357_cov_25.711249	716	796	6	15	80	0.1875000
NODE_1008_length_2357_cov_25.711249	716	796	7	3	80	0.0375000
NODE_1008_length_2357_cov_25.711249	716	796	10	14	80	0.1750000
NODE_1008_length_2357_cov_25.711249	716	796	11	10	80	0.1250000
NODE_1008_length_2357_cov_25.711249	716	796	12	29	80	0.3625000
NODE_1008_length_2357_cov_25.711249	716	796	13	3	80	0.0375000
NODE_1008_length_2357_cov_25.711249	769	849	11	56	80	0.7000000
NODE_1008_length_2357_cov_25.711249	769	849	12	21	80	0.2625000
NODE_1008_length_2357_cov_25.711249	769	849	13	3	80	0.0375000
NODE_1015_length_2345_cov_5.386465	1845	1925	0	9	80	0.1125000
NODE_1015_length_2345_cov_5.386465	1845	1925	10	71	80	0.8875000
NODE_1015_length_2345_cov_5.386465	1898	1978	0	62	80	0.7750000
NODE_1015_length_2345_cov_5.386465	1898	1978	10	18	80	0.2250000
NODE_1016_length_2344_cov_6.236526	1208	1269	2	61	61	1.0000000
NODE_1016_length_2344_cov_6.236526	1208	1269	2	61	61	1.0000000
NODE_1016_length_2344_cov_6.236526	1208	1269	2	61	61	1.0000000
NODE_1016_length_2344_cov_6.236526	1208	1267	2	59	59	1.0000000
NODE_1023_length_2332_cov_4.725929	34	101	2	67	67	1.0000000
NODE_1027_length_2327_cov_18.210952	2213	2293	15	4	80	0.0500000
NODE_1027_length_2327_cov_18.210952	2213	2293	16	4	80	0.0500000
NODE_1027_length_2327_cov_18.210952	2213	2293	17	8	80	0.1000000
NODE_1027_length_2327_cov_18.210952	2213	2293	18	36	80	0.4500000
NODE_1027_length_2327_cov_18.210952	2213	2293	20	25	80	0.3125000
NODE_1027_length_2327_cov_18.210952	2213	2293	22	3	80	0.0375000
NODE_1027_length_2327_cov_18.210952	2266	2327	11	4	61	0.0655738
NODE_1027_length_2327_cov_18.210952	2266	2327	13	13	61	0.2131148
NODE_1027_length_2327_cov_18.210952	2266	2327	15	21	61	0.3442623
NODE_1027_length_2327_cov_18.210952	2266	2327	17	8	61	0.1311475
NODE_1027_length_2327_cov_18.210952	2266	2327	18	15	61	0.2459016
NODE_1028_length_2326_cov_15.583745	1709	1789	9	15	80	0.1875000
NODE_1028_length_2326_cov_15.583745	1709	1789	10	19	80	0.2375000
NODE_1028_length_2326_cov_15.583745	1709	1789	12	20	80	0.2500000
NODE_1028_length_2326_cov_15.583745	1709	1789	14	2	80	0.0250000
NODE_1028_length_2326_cov_15.583745	1709	1789	15	2	80	0.0250000
NODE_1028_length_2326_cov_15.583745	1709	1789	16	13	80	0.1625000
NODE_1028_length_2326_cov_15.583745	1709	1789	19	9	80	0.1125000
NODE_1028_length_2326_cov_15.583745	1762	1842	12	1	80	0.0125000
NODE_1028_length_2326_cov_15.583745	1762	1842	13	3	80	0.0375000
NODE_1028_length_2326_cov_15.583745	1762	1842	14	2	80	0.0250000
NODE_1028_length_2326_cov_15.583745	1762	1842	15	25	80	0.3125000
NODE_1028_length_2326_cov_15.583745	1762	1842	16	13	80	0.1625000
NODE_1028_length_2326_cov_15.583745	1762	1842	19	20	80	0.2500000
NODE_1028_length_2326_cov_15.583745	1762	1842	20	16	80	0.2000000
NODE_1030_length_2325_cov_14.998652	553	633	5	22	80	0.2750000
NODE_1030_length_2325_cov_14.998652	553	633	7	58	80	0.7250000
NODE_1030_length_2325_cov_14.998652	606	686	6	13	80	0.1625000
NODE_1030_length_2325_cov_14.998652	606	686	7	49	80	0.6125000
NODE_1030_length_2325_cov_14.998652	606	686	10	5	80	0.0625000
NODE_1030_length_2325_cov_14.998652	606	686	11	13	80	0.1625000
NODE_1034_length_2317_cov_11.956718	920	1000	15	12	80	0.1500000
NODE_1034_length_2317_cov_11.956718	920	1000	16	3	80	0.0375000
NODE_1034_length_2317_cov_11.956718	920	1000	20	42	80	0.5250000
NODE_1034_length_2317_cov_11.956718	920	1000	21	20	80	0.2500000
NODE_1034_length_2317_cov_11.956718	920	1000	22	3	80	0.0375000
NODE_1034_length_2317_cov_11.956718	973	1053	15	13	80	0.1625000
NODE_1034_length_2317_cov_11.956718	973	1053	16	8	80	0.1000000
NODE_1034_length_2317_cov_11.956718	973	1053	17	15	80	0.1875000
NODE_1034_length_2317_cov_11.956718	973	1053	18	6	80	0.0750000
NODE_1034_length_2317_cov_11.956718	973	1053	19	5	80	0.0625000
NODE_1034_length_2317_cov_11.956718	973	1053	20	3	80	0.0375000
NODE_1034_length_2317_cov_11.956718	973	1053	21	24	80	0.3000000
NODE_1034_length_2317_cov_11.956718	973	1053	22	5	80	0.0625000
NODE_1034_length_2317_cov_11.956718	973	1053	23	1	80	0.0125000
NODE_1034_length_2317_cov_11.956718	1049	1129	21	4	80	0.0500000
NODE_1034_length_2317_cov_11.956718	1049	1129	23	1	80	0.0125000
NODE_1034_length_2317_cov_11.956718	1049	1129	24	16	80	0.2000000
NODE_1034_length_2317_cov_11.956718	1049	1129	25	7	80	0.0875000
NODE_1034_length_2317_cov_11.956718	1049	1129	26	6	80	0.0750000
NODE_1034_length_2317_cov_11.956718	1049	1129	30	13	80	0.1625000
NODE_1034_length_2317_cov_11.956718	1049	1129	33	6	80	0.0750000
NODE_1034_length_2317_cov_11.956718	1049	1129	35	11	80	0.1375000
NODE_1034_length_2317_cov_11.956718	1049	1129	36	1	80	0.0125000
NODE_1034_length_2317_cov_11.956718	1049	1129	37	7	80	0.0875000
NODE_1034_length_2317_cov_11.956718	1049	1129	39	1	80	0.0125000
NODE_1034_length_2317_cov_11.956718	1049	1129	40	7	80	0.0875000
NODE_1034_length_2317_cov_11.956718	1102	1184	35	11	82	0.1341463
NODE_1034_length_2317_cov_11.956718	1102	1184	36	1	82	0.0121951
NODE_1034_length_2317_cov_11.956718	1102	1184	37	7	82	0.0853659
NODE_1034_length_2317_cov_11.956718	1102	1184	39	28	82	0.3414634
NODE_1034_length_2317_cov_11.956718	1102	1184	40	8	82	0.0975610
NODE_1034_length_2317_cov_11.956718	1102	1184	41	1	82	0.0121951
NODE_1034_length_2317_cov_11.956718	1102	1184	42	7	82	0.0853659
NODE_1034_length_2317_cov_11.956718	1102	1184	43	18	82	0.2195122
NODE_1034_length_2317_cov_11.956718	1102	1184	44	1	82	0.0121951
NODE_1037_length_2316_cov_8.556608	168	247	6	29	79	0.3670886
NODE_1037_length_2316_cov_8.556608	168	247	9	8	79	0.1012658
NODE_1037_length_2316_cov_8.556608	168	247	10	9	79	0.1139240
NODE_1037_length_2316_cov_8.556608	168	247	11	13	79	0.1645570
NODE_1037_length_2316_cov_8.556608	168	247	12	20	79	0.2531646
NODE_1037_length_2316_cov_8.556608	1117	1198	5	21	81	0.2592593
NODE_1037_length_2316_cov_8.556608	1117	1198	6	1	81	0.0123457
NODE_1037_length_2316_cov_8.556608	1117	1198	10	59	81	0.7283950
NODE_1037_length_2316_cov_8.556608	1369	1412	6	3	43	0.0697674
NODE_1037_length_2316_cov_8.556608	1369	1412	7	4	43	0.0930233
NODE_1037_length_2316_cov_8.556608	1369	1412	9	22	43	0.5116279
NODE_1037_length_2316_cov_8.556608	1369	1412	10	14	43	0.3255814
NODE_1040_length_2311_cov_2.821881	2121	2201	0	80	80	1.0000000
NODE_1040_length_2311_cov_2.821881	2174	2225	0	51	51	1.0000000
NODE_1044_length_2306_cov_17.347984	995	1075	4	16	80	0.2000000
NODE_1044_length_2306_cov_17.347984	995	1075	5	1	80	0.0125000
NODE_1044_length_2306_cov_17.347984	995	1075	6	1	80	0.0125000
NODE_1044_length_2306_cov_17.347984	995	1075	7	36	80	0.4500000
NODE_1044_length_2306_cov_17.347984	995	1075	9	26	80	0.3250000
NODE_1044_length_2306_cov_17.347984	1048	1128	7	6	80	0.0750000
NODE_1044_length_2306_cov_17.347984	1048	1128	8	9	80	0.1125000
NODE_1044_length_2306_cov_17.347984	1048	1128	9	27	80	0.3375000
NODE_1044_length_2306_cov_17.347984	1048	1128	10	38	80	0.4750000
NODE_1052_length_2300_cov_9.803271	934	1014	0	73	80	0.9125000
NODE_1052_length_2300_cov_9.803271	934	1014	1	7	80	0.0875000
NODE_1052_length_2300_cov_9.803271	1892	1965	0	73	73	1.0000000
NODE_1059_length_2289_cov_17.807306	968	1026	8	2	58	0.0344828
NODE_1059_length_2289_cov_17.807306	968	1026	10	2	58	0.0344828
NODE_1059_length_2289_cov_17.807306	968	1026	11	28	58	0.4827586
NODE_1059_length_2289_cov_17.807306	968	1026	12	1	58	0.0172414
NODE_1059_length_2289_cov_17.807306	968	1026	13	25	58	0.4310345
NODE_1059_length_2289_cov_17.807306	1021	1079	10	10	58	0.1724138
NODE_1059_length_2289_cov_17.807306	1021	1079	11	1	58	0.0172414
NODE_1059_length_2289_cov_17.807306	1021	1079	12	28	58	0.4827586
NODE_1059_length_2289_cov_17.807306	1021	1079	13	19	58	0.3275862
NODE_1060_length_2289_cov_7.736986	2161	2218	0	57	57	1.0000000
NODE_1060_length_2289_cov_7.736986	2191	2271	0	80	80	1.0000000
NODE_1061_length_2288_cov_8.539973	340	420	3	80	80	1.0000000
NODE_1061_length_2288_cov_8.539973	393	473	3	75	80	0.9375000
NODE_1061_length_2288_cov_8.539973	393	473	6	5	80	0.0625000
NODE_1065_length_2278_cov_19.655805	450	530	8	3	80	0.0375000
NODE_1065_length_2278_cov_19.655805	450	530	9	2	80	0.0250000
NODE_1065_length_2278_cov_19.655805	450	530	10	18	80	0.2250000
NODE_1065_length_2278_cov_19.655805	450	530	17	15	80	0.1875000
NODE_1065_length_2278_cov_19.655805	450	530	18	1	80	0.0125000
NODE_1065_length_2278_cov_19.655805	450	530	21	8	80	0.1000000
NODE_1065_length_2278_cov_19.655805	450	530	22	33	80	0.4125000
NODE_1065_length_2278_cov_19.655805	503	583	17	19	80	0.2375000
NODE_1065_length_2278_cov_19.655805	503	583	18	7	80	0.0875000
NODE_1065_length_2278_cov_19.655805	503	583	19	2	80	0.0250000
NODE_1065_length_2278_cov_19.655805	503	583	20	9	80	0.1125000
NODE_1065_length_2278_cov_19.655805	503	583	21	25	80	0.3125000
NODE_1065_length_2278_cov_19.655805	503	583	22	18	80	0.2250000
NODE_1065_length_2278_cov_19.655805	579	659	15	11	80	0.1375000
NODE_1065_length_2278_cov_19.655805	579	659	16	9	80	0.1125000
NODE_1065_length_2278_cov_19.655805	579	659	17	17	80	0.2125000
NODE_1065_length_2278_cov_19.655805	579	659	19	21	80	0.2625000
NODE_1065_length_2278_cov_19.655805	579	659	20	14	80	0.1750000
NODE_1065_length_2278_cov_19.655805	579	659	21	1	80	0.0125000
NODE_1065_length_2278_cov_19.655805	579	659	25	2	80	0.0250000
NODE_1065_length_2278_cov_19.655805	579	659	26	5	80	0.0625000
NODE_1065_length_2278_cov_19.655805	632	712	11	6	80	0.0750000
NODE_1065_length_2278_cov_19.655805	632	712	13	4	80	0.0500000
NODE_1065_length_2278_cov_19.655805	632	712	14	17	80	0.2125000
NODE_1065_length_2278_cov_19.655805	632	712	19	47	80	0.5875000
NODE_1065_length_2278_cov_19.655805	632	712	20	5	80	0.0625000
NODE_1065_length_2278_cov_19.655805	632	712	21	1	80	0.0125000
NODE_1071_length_2272_cov_26.123792	226	306	2	80	80	1.0000000
NODE_1071_length_2272_cov_26.123792	279	359	0	48	80	0.6000000
NODE_1071_length_2272_cov_26.123792	279	359	2	32	80	0.4000000
NODE_1071_length_2272_cov_26.123792	1684	1731	1	2	47	0.0425532
NODE_1071_length_2272_cov_26.123792	1684	1731	4	2	47	0.0425532
NODE_1071_length_2272_cov_26.123792	1684	1731	9	1	47	0.0212766
NODE_1071_length_2272_cov_26.123792	1684	1731	11	30	47	0.6382979
NODE_1071_length_2272_cov_26.123792	1684	1731	12	3	47	0.0638298
NODE_1071_length_2272_cov_26.123792	1684	1731	13	9	47	0.1914894
NODE_1071_length_2272_cov_26.123792	1694	1725	11	29	31	0.9354839
NODE_1071_length_2272_cov_26.123792	1694	1725	12	2	31	0.0645161
NODE_1071_length_2272_cov_26.123792	1759	1833	0	42	74	0.5675676
NODE_1071_length_2272_cov_26.123792	1759	1833	1	15	74	0.2027027
NODE_1071_length_2272_cov_26.123792	1759	1833	2	17	74	0.2297297
NODE_1071_length_2272_cov_26.123792	1812	1892	1	4	80	0.0500000
NODE_1071_length_2272_cov_26.123792	1812	1892	2	55	80	0.6875000
NODE_1071_length_2272_cov_26.123792	1812	1892	3	1	80	0.0125000
NODE_1071_length_2272_cov_26.123792	1812	1892	4	17	80	0.2125000
NODE_1071_length_2272_cov_26.123792	1812	1892	5	3	80	0.0375000
NODE_1072_length_2272_cov_8.175334	213	293	11	40	80	0.5000000
NODE_1072_length_2272_cov_8.175334	213	293	12	28	80	0.3500000
NODE_1072_length_2272_cov_8.175334	213	293	13	12	80	0.1500000
NODE_1072_length_2272_cov_8.175334	266	346	0	2	80	0.0250000
NODE_1072_length_2272_cov_8.175334	266	346	5	16	80	0.2000000
NODE_1072_length_2272_cov_8.175334	266	346	6	3	80	0.0375000
NODE_1072_length_2272_cov_8.175334	266	346	8	30	80	0.3750000
NODE_1072_length_2272_cov_8.175334	266	346	11	14	80	0.1750000
NODE_1072_length_2272_cov_8.175334	266	346	12	15	80	0.1875000
NODE_1077_length_2266_cov_13.206276	359	439	16	19	80	0.2375000
NODE_1077_length_2266_cov_13.206276	359	439	17	5	80	0.0625000
NODE_1077_length_2266_cov_13.206276	359	439	18	8	80	0.1000000
NODE_1077_length_2266_cov_13.206276	359	439	20	4	80	0.0500000
NODE_1077_length_2266_cov_13.206276	359	439	21	19	80	0.2375000
NODE_1077_length_2266_cov_13.206276	359	439	22	10	80	0.1250000
NODE_1077_length_2266_cov_13.206276	359	439	23	7	80	0.0875000
NODE_1077_length_2266_cov_13.206276	359	439	24	8	80	0.1000000
NODE_1077_length_2266_cov_13.206276	412	492	20	4	80	0.0500000
NODE_1077_length_2266_cov_13.206276	412	492	21	23	80	0.2875000
NODE_1077_length_2266_cov_13.206276	412	492	22	13	80	0.1625000
NODE_1077_length_2266_cov_13.206276	412	492	23	14	80	0.1750000
NODE_1077_length_2266_cov_13.206276	412	492	24	7	80	0.0875000
NODE_1077_length_2266_cov_13.206276	412	492	25	2	80	0.0250000
NODE_1077_length_2266_cov_13.206276	412	492	26	3	80	0.0375000
NODE_1077_length_2266_cov_13.206276	412	492	27	2	80	0.0250000
NODE_1077_length_2266_cov_13.206276	412	492	28	6	80	0.0750000
NODE_1077_length_2266_cov_13.206276	412	492	29	6	80	0.0750000
NODE_1077_length_2266_cov_13.206276	488	568	20	1	80	0.0125000
NODE_1077_length_2266_cov_13.206276	488	568	21	6	80	0.0750000
NODE_1077_length_2266_cov_13.206276	488	568	22	16	80	0.2000000
NODE_1077_length_2266_cov_13.206276	488	568	23	4	80	0.0500000
NODE_1077_length_2266_cov_13.206276	488	568	24	5	80	0.0625000
NODE_1077_length_2266_cov_13.206276	488	568	25	6	80	0.0750000
NODE_1077_length_2266_cov_13.206276	488	568	26	5	80	0.0625000
NODE_1077_length_2266_cov_13.206276	488	568	27	22	80	0.2750000
NODE_1077_length_2266_cov_13.206276	488	568	28	3	80	0.0375000
NODE_1077_length_2266_cov_13.206276	488	568	29	12	80	0.1500000
NODE_1077_length_2266_cov_13.206276	541	627	11	4	86	0.0465116
NODE_1077_length_2266_cov_13.206276	541	627	13	6	86	0.0697674
NODE_1077_length_2266_cov_13.206276	541	627	16	1	86	0.0116279
NODE_1077_length_2266_cov_13.206276	541	627	17	12	86	0.1395349
NODE_1077_length_2266_cov_13.206276	541	627	18	17	86	0.1976744
NODE_1077_length_2266_cov_13.206276	541	627	19	2	86	0.0232558
NODE_1077_length_2266_cov_13.206276	541	627	20	3	86	0.0348837
NODE_1077_length_2266_cov_13.206276	541	627	21	19	86	0.2209302
NODE_1077_length_2266_cov_13.206276	541	627	22	18	86	0.2093023
NODE_1077_length_2266_cov_13.206276	541	627	23	4	86	0.0465116
NODE_1078_length_2262_cov_11.759131	413	493	0	80	80	1.0000000
NODE_1078_length_2262_cov_11.759131	466	546	0	80	80	1.0000000
NODE_1079_length_2260_cov_37.814901	219	299	2	4	80	0.0500000
NODE_1079_length_2260_cov_37.814901	219	299	4	23	80	0.2875000
NODE_1079_length_2260_cov_37.814901	219	299	5	17	80	0.2125000
NODE_1079_length_2260_cov_37.814901	219	299	6	36	80	0.4500000
NODE_1079_length_2260_cov_37.814901	742	822	6	7	80	0.0875000
NODE_1079_length_2260_cov_37.814901	742	822	11	5	80	0.0625000
NODE_1079_length_2260_cov_37.814901	742	822	12	51	80	0.6375000
NODE_1079_length_2260_cov_37.814901	742	822	13	17	80	0.2125000
NODE_1079_length_2260_cov_37.814901	795	875	9	3	80	0.0375000
NODE_1079_length_2260_cov_37.814901	795	875	10	5	80	0.0625000
NODE_1079_length_2260_cov_37.814901	795	875	11	41	80	0.5125000
NODE_1079_length_2260_cov_37.814901	795	875	12	10	80	0.1250000
NODE_1079_length_2260_cov_37.814901	795	875	13	21	80	0.2625000
NODE_1079_length_2260_cov_37.814901	1533	1613	23	4	80	0.0500000
NODE_1079_length_2260_cov_37.814901	1533	1613	26	2	80	0.0250000
NODE_1079_length_2260_cov_37.814901	1533	1613	27	1	80	0.0125000
NODE_1079_length_2260_cov_37.814901	1533	1613	28	5	80	0.0625000
NODE_1079_length_2260_cov_37.814901	1533	1613	29	12	80	0.1500000
NODE_1079_length_2260_cov_37.814901	1533	1613	30	5	80	0.0625000
NODE_1079_length_2260_cov_37.814901	1533	1613	31	24	80	0.3000000
NODE_1079_length_2260_cov_37.814901	1533	1613	32	7	80	0.0875000
NODE_1079_length_2260_cov_37.814901	1533	1613	33	11	80	0.1375000
NODE_1079_length_2260_cov_37.814901	1533	1613	34	9	80	0.1125000
NODE_1079_length_2260_cov_37.814901	1586	1666	24	9	80	0.1125000
NODE_1079_length_2260_cov_37.814901	1586	1666	25	2	80	0.0250000
NODE_1079_length_2260_cov_37.814901	1586	1666	26	7	80	0.0875000
NODE_1079_length_2260_cov_37.814901	1586	1666	27	5	80	0.0625000
NODE_1079_length_2260_cov_37.814901	1586	1666	28	5	80	0.0625000
NODE_1079_length_2260_cov_37.814901	1586	1666	29	14	80	0.1750000
NODE_1079_length_2260_cov_37.814901	1586	1666	31	21	80	0.2625000
NODE_1079_length_2260_cov_37.814901	1586	1666	32	7	80	0.0875000
NODE_1079_length_2260_cov_37.814901	1586	1666	33	3	80	0.0375000
NODE_1079_length_2260_cov_37.814901	1586	1666	34	7	80	0.0875000
NODE_1079_length_2260_cov_37.814901	1662	1742	11	8	80	0.1000000
NODE_1079_length_2260_cov_37.814901	1662	1742	12	1	80	0.0125000
NODE_1079_length_2260_cov_37.814901	1662	1742	13	7	80	0.0875000
NODE_1079_length_2260_cov_37.814901	1662	1742	14	8	80	0.1000000
NODE_1079_length_2260_cov_37.814901	1662	1742	15	14	80	0.1750000
NODE_1079_length_2260_cov_37.814901	1662	1742	16	10	80	0.1250000
NODE_1079_length_2260_cov_37.814901	1662	1742	17	7	80	0.0875000
NODE_1079_length_2260_cov_37.814901	1662	1742	19	3	80	0.0375000
NODE_1079_length_2260_cov_37.814901	1662	1742	20	3	80	0.0375000
NODE_1079_length_2260_cov_37.814901	1662	1742	21	14	80	0.1750000
NODE_1079_length_2260_cov_37.814901	1662	1742	24	5	80	0.0625000
NODE_1079_length_2260_cov_37.814901	1715	1795	6	1	80	0.0125000
NODE_1079_length_2260_cov_37.814901	1715	1795	7	5	80	0.0625000
NODE_1079_length_2260_cov_37.814901	1715	1795	8	19	80	0.2375000
NODE_1079_length_2260_cov_37.814901	1715	1795	9	22	80	0.2750000
NODE_1079_length_2260_cov_37.814901	1715	1795	11	14	80	0.1750000
NODE_1079_length_2260_cov_37.814901	1715	1795	12	1	80	0.0125000
NODE_1079_length_2260_cov_37.814901	1715	1795	13	7	80	0.0875000
NODE_1079_length_2260_cov_37.814901	1715	1795	14	5	80	0.0625000
NODE_1079_length_2260_cov_37.814901	1715	1795	15	6	80	0.0750000
NODE_1082_length_2253_cov_8.904828	472	552	13	2	80	0.0250000
NODE_1082_length_2253_cov_8.904828	472	552	14	1	80	0.0125000
NODE_1082_length_2253_cov_8.904828	472	552	15	4	80	0.0500000
NODE_1082_length_2253_cov_8.904828	472	552	17	4	80	0.0500000
NODE_1082_length_2253_cov_8.904828	472	552	18	2	80	0.0250000
NODE_1082_length_2253_cov_8.904828	472	552	20	1	80	0.0125000
NODE_1082_length_2253_cov_8.904828	472	552	21	18	80	0.2250000
NODE_1082_length_2253_cov_8.904828	472	552	22	1	80	0.0125000
NODE_1082_length_2253_cov_8.904828	472	552	23	17	80	0.2125000
NODE_1082_length_2253_cov_8.904828	472	552	25	26	80	0.3250000
NODE_1082_length_2253_cov_8.904828	472	552	26	2	80	0.0250000
NODE_1082_length_2253_cov_8.904828	472	552	28	2	80	0.0250000
NODE_1085_length_2252_cov_2.801208	1128	1170	1	42	42	1.0000000
NODE_1085_length_2252_cov_2.801208	1137	1172	1	35	35	1.0000000
NODE_1086_length_2252_cov_2.078031	13	62	0	49	49	1.0000000
NODE_1086_length_2252_cov_2.078031	13	61	0	48	48	1.0000000
NODE_1086_length_2252_cov_2.078031	13	62	0	49	49	1.0000000
NODE_1086_length_2252_cov_2.078031	13	62	0	49	49	1.0000000
NODE_1086_length_2252_cov_2.078031	13	61	0	48	48	1.0000000
NODE_1087_length_2251_cov_15.458178	1443	1506	6	15	63	0.2380952
NODE_1087_length_2251_cov_15.458178	1443	1506	8	4	63	0.0634921
NODE_1087_length_2251_cov_15.458178	1443	1506	9	44	63	0.6984127
NODE_1087_length_2251_cov_15.458178	1496	1550	9	21	54	0.3888889
NODE_1087_length_2251_cov_15.458178	1496	1550	10	1	54	0.0185185
NODE_1087_length_2251_cov_15.458178	1496	1550	11	14	54	0.2592593
NODE_1087_length_2251_cov_15.458178	1496	1550	13	4	54	0.0740741
NODE_1087_length_2251_cov_15.458178	1496	1550	15	14	54	0.2592593
NODE_1089_length_2250_cov_18.370990	1658	1738	2	7	80	0.0875000
NODE_1089_length_2250_cov_18.370990	1658	1738	3	1	80	0.0125000
NODE_1089_length_2250_cov_18.370990	1658	1738	4	15	80	0.1875000
NODE_1089_length_2250_cov_18.370990	1658	1738	5	48	80	0.6000000
NODE_1089_length_2250_cov_18.370990	1658	1738	6	9	80	0.1125000
NODE_1089_length_2250_cov_18.370990	1711	1791	2	23	80	0.2875000
NODE_1089_length_2250_cov_18.370990	1711	1791	3	7	80	0.0875000
NODE_1089_length_2250_cov_18.370990	1711	1791	4	31	80	0.3875000
NODE_1089_length_2250_cov_18.370990	1711	1791	5	19	80	0.2375000
NODE_1090_length_2250_cov_5.331474	1844	1924	0	80	80	1.0000000
NODE_1093_length_2247_cov_7.906890	364	436	6	17	72	0.2361111
NODE_1093_length_2247_cov_7.906890	364	436	7	15	72	0.2083333
NODE_1093_length_2247_cov_7.906890	364	436	8	24	72	0.3333333
NODE_1093_length_2247_cov_7.906890	364	436	9	16	72	0.2222222
NODE_1095_length_2246_cov_7.612948	1992	2055	0	63	63	1.0000000
NODE_1095_length_2246_cov_7.612948	2045	2108	0	63	63	1.0000000
NODE_1104_length_2233_cov_35.127460	1517	1597	5	72	80	0.9000000
NODE_1104_length_2233_cov_35.127460	1517	1597	6	8	80	0.1000000
NODE_1104_length_2233_cov_35.127460	1570	1650	4	30	80	0.3750000
NODE_1104_length_2233_cov_35.127460	1570	1650	5	50	80	0.6250000
NODE_1105_length_2231_cov_45.701689	315	396	2	9	81	0.1111111
NODE_1105_length_2231_cov_45.701689	315	396	3	44	81	0.5432099
NODE_1105_length_2231_cov_45.701689	315	396	5	28	81	0.3456790
NODE_1105_length_2231_cov_45.701689	369	449	4	3	80	0.0375000
NODE_1105_length_2231_cov_45.701689	369	449	5	76	80	0.9500000
NODE_1105_length_2231_cov_45.701689	369	449	6	1	80	0.0125000
NODE_1105_length_2231_cov_45.701689	496	576	5	13	80	0.1625000
NODE_1105_length_2231_cov_45.701689	496	576	7	41	80	0.5125000
NODE_1105_length_2231_cov_45.701689	496	576	8	26	80	0.3250000
NODE_1105_length_2231_cov_45.701689	582	662	5	18	80	0.2250000
NODE_1105_length_2231_cov_45.701689	582	662	6	1	80	0.0125000
NODE_1105_length_2231_cov_45.701689	582	662	7	23	80	0.2875000
NODE_1105_length_2231_cov_45.701689	582	662	8	38	80	0.4750000
NODE_1105_length_2231_cov_45.701689	625	705	2	19	80	0.2375000
NODE_1105_length_2231_cov_45.701689	625	705	3	5	80	0.0625000
NODE_1105_length_2231_cov_45.701689	625	705	5	37	80	0.4625000
NODE_1105_length_2231_cov_45.701689	625	705	6	1	80	0.0125000
NODE_1105_length_2231_cov_45.701689	625	705	8	18	80	0.2250000
NODE_1105_length_2231_cov_45.701689	711	791	2	2	80	0.0250000
NODE_1105_length_2231_cov_45.701689	711	791	4	22	80	0.2750000
NODE_1105_length_2231_cov_45.701689	711	791	5	18	80	0.2250000
NODE_1105_length_2231_cov_45.701689	711	791	6	38	80	0.4750000
NODE_1105_length_2231_cov_45.701689	1141	1186	10	45	45	1.0000000
NODE_1105_length_2231_cov_45.701689	1787	1867	4	10	80	0.1250000
NODE_1105_length_2231_cov_45.701689	1787	1867	5	28	80	0.3500000
NODE_1105_length_2231_cov_45.701689	1787	1867	6	7	80	0.0875000
NODE_1105_length_2231_cov_45.701689	1787	1867	7	35	80	0.4375000
NODE_1105_length_2231_cov_45.701689	1840	1920	3	40	80	0.5000000
NODE_1105_length_2231_cov_45.701689	1840	1920	4	23	80	0.2875000
NODE_1105_length_2231_cov_45.701689	1840	1920	5	17	80	0.2125000
NODE_1106_length_2230_cov_12.608634	1520	1600	6	30	80	0.3750000
NODE_1106_length_2230_cov_12.608634	1520	1600	8	14	80	0.1750000
NODE_1106_length_2230_cov_12.608634	1520	1600	9	23	80	0.2875000
NODE_1106_length_2230_cov_12.608634	1520	1600	10	1	80	0.0125000
NODE_1106_length_2230_cov_12.608634	1520	1600	12	1	80	0.0125000
NODE_1106_length_2230_cov_12.608634	1520	1600	13	11	80	0.1375000
NODE_1106_length_2230_cov_12.608634	1573	1653	8	5	80	0.0625000
NODE_1106_length_2230_cov_12.608634	1573	1653	9	17	80	0.2125000
NODE_1106_length_2230_cov_12.608634	1573	1653	10	54	80	0.6750000
NODE_1106_length_2230_cov_12.608634	1573	1653	13	4	80	0.0500000
NODE_1112_length_2218_cov_5.292591	1427	1497	9	28	70	0.4000000
NODE_1112_length_2218_cov_5.292591	1427	1497	10	15	70	0.2142857
NODE_1112_length_2218_cov_5.292591	1427	1497	12	12	70	0.1714286
NODE_1112_length_2218_cov_5.292591	1427	1497	13	3	70	0.0428571
NODE_1112_length_2218_cov_5.292591	1427	1497	14	11	70	0.1571429
NODE_1112_length_2218_cov_5.292591	1427	1497	15	1	70	0.0142857
NODE_1112_length_2218_cov_5.292591	1470	1536	12	25	66	0.3787879
NODE_1112_length_2218_cov_5.292591	1470	1536	13	29	66	0.4393939
NODE_1112_length_2218_cov_5.292591	1470	1536	14	11	66	0.1666667
NODE_1112_length_2218_cov_5.292591	1470	1536	15	1	66	0.0151515
NODE_1115_length_2215_cov_51.865784	108	188	0	80	80	1.0000000
NODE_1115_length_2215_cov_51.865784	161	241	0	80	80	1.0000000
NODE_1115_length_2215_cov_51.865784	237	317	0	80	80	1.0000000
NODE_1115_length_2215_cov_51.865784	290	370	0	80	80	1.0000000
NODE_1115_length_2215_cov_51.865784	1030	1102	20	1	72	0.0138889
NODE_1115_length_2215_cov_51.865784	1030	1102	21	4	72	0.0555556
NODE_1115_length_2215_cov_51.865784	1030	1102	24	6	72	0.0833333
NODE_1115_length_2215_cov_51.865784	1030	1102	26	7	72	0.0972222
NODE_1115_length_2215_cov_51.865784	1030	1102	29	4	72	0.0555556
NODE_1115_length_2215_cov_51.865784	1030	1102	30	7	72	0.0972222
NODE_1115_length_2215_cov_51.865784	1030	1102	32	1	72	0.0138889
NODE_1115_length_2215_cov_51.865784	1030	1102	33	3	72	0.0416667
NODE_1115_length_2215_cov_51.865784	1030	1102	38	1	72	0.0138889
NODE_1115_length_2215_cov_51.865784	1030	1102	39	2	72	0.0277778
NODE_1115_length_2215_cov_51.865784	1030	1102	42	7	72	0.0972222
NODE_1115_length_2215_cov_51.865784	1030	1102	43	2	72	0.0277778
NODE_1115_length_2215_cov_51.865784	1030	1102	44	3	72	0.0416667
NODE_1115_length_2215_cov_51.865784	1030	1102	46	2	72	0.0277778
NODE_1115_length_2215_cov_51.865784	1030	1102	50	5	72	0.0694444
NODE_1115_length_2215_cov_51.865784	1030	1102	51	4	72	0.0555556
NODE_1115_length_2215_cov_51.865784	1030	1102	52	4	72	0.0555556
NODE_1115_length_2215_cov_51.865784	1030	1102	53	9	72	0.1250000
NODE_1115_length_2215_cov_51.865784	1571	1651	17	6	80	0.0750000
NODE_1115_length_2215_cov_51.865784	1571	1651	18	3	80	0.0375000
NODE_1115_length_2215_cov_51.865784	1571	1651	19	2	80	0.0250000
NODE_1115_length_2215_cov_51.865784	1571	1651	20	1	80	0.0125000
NODE_1115_length_2215_cov_51.865784	1571	1651	21	5	80	0.0625000
NODE_1115_length_2215_cov_51.865784	1571	1651	23	1	80	0.0125000
NODE_1115_length_2215_cov_51.865784	1571	1651	25	5	80	0.0625000
NODE_1115_length_2215_cov_51.865784	1571	1651	26	7	80	0.0875000
NODE_1115_length_2215_cov_51.865784	1571	1651	27	5	80	0.0625000
NODE_1115_length_2215_cov_51.865784	1571	1651	28	3	80	0.0375000
NODE_1115_length_2215_cov_51.865784	1571	1651	32	18	80	0.2250000
NODE_1115_length_2215_cov_51.865784	1571	1651	33	6	80	0.0750000
NODE_1115_length_2215_cov_51.865784	1571	1651	34	12	80	0.1500000
NODE_1115_length_2215_cov_51.865784	1571	1651	35	6	80	0.0750000
NODE_1115_length_2215_cov_51.865784	1624	1704	32	3	80	0.0375000
NODE_1115_length_2215_cov_51.865784	1624	1704	33	15	80	0.1875000
NODE_1115_length_2215_cov_51.865784	1624	1704	34	21	80	0.2625000
NODE_1115_length_2215_cov_51.865784	1624	1704	35	13	80	0.1625000
NODE_1115_length_2215_cov_51.865784	1624	1704	36	10	80	0.1250000
NODE_1115_length_2215_cov_51.865784	1624	1704	37	5	80	0.0625000
NODE_1115_length_2215_cov_51.865784	1624	1704	38	8	80	0.1000000
NODE_1115_length_2215_cov_51.865784	1624	1704	39	5	80	0.0625000
NODE_1117_length_2212_cov_63.988168	459	539	4	15	80	0.1875000
NODE_1117_length_2212_cov_63.988168	459	539	10	13	80	0.1625000
NODE_1117_length_2212_cov_63.988168	459	539	11	15	80	0.1875000
NODE_1117_length_2212_cov_63.988168	459	539	12	25	80	0.3125000
NODE_1117_length_2212_cov_63.988168	459	539	13	12	80	0.1500000
NODE_1117_length_2212_cov_63.988168	512	592	12	22	80	0.2750000
NODE_1117_length_2212_cov_63.988168	512	592	13	12	80	0.1500000
NODE_1117_length_2212_cov_63.988168	512	592	17	1	80	0.0125000
NODE_1117_length_2212_cov_63.988168	512	592	18	21	80	0.2625000
NODE_1117_length_2212_cov_63.988168	512	592	19	24	80	0.3000000
NODE_1117_length_2212_cov_63.988168	588	668	10	16	80	0.2000000
NODE_1117_length_2212_cov_63.988168	588	668	11	15	80	0.1875000
NODE_1117_length_2212_cov_63.988168	588	668	12	13	80	0.1625000
NODE_1117_length_2212_cov_63.988168	588	668	17	17	80	0.2125000
NODE_1117_length_2212_cov_63.988168	588	668	18	12	80	0.1500000
NODE_1117_length_2212_cov_63.988168	588	668	19	7	80	0.0875000
NODE_1117_length_2212_cov_63.988168	641	721	2	8	80	0.1000000
NODE_1117_length_2212_cov_63.988168	641	721	3	17	80	0.2125000
NODE_1117_length_2212_cov_63.988168	641	721	9	22	80	0.2750000
NODE_1117_length_2212_cov_63.988168	641	721	10	22	80	0.2750000
NODE_1117_length_2212_cov_63.988168	641	721	11	11	80	0.1375000
NODE_1119_length_2212_cov_4.632750	1479	1559	4	4	80	0.0500000
NODE_1119_length_2212_cov_4.632750	1479	1559	5	3	80	0.0375000
NODE_1119_length_2212_cov_4.632750	1479	1559	6	12	80	0.1500000
NODE_1119_length_2212_cov_4.632750	1479	1559	8	10	80	0.1250000
NODE_1119_length_2212_cov_4.632750	1479	1559	9	23	80	0.2875000
NODE_1119_length_2212_cov_4.632750	1479	1559	10	27	80	0.3375000
NODE_1119_length_2212_cov_4.632750	1479	1559	11	1	80	0.0125000
NODE_1119_length_2212_cov_4.632750	1532	1612	8	9	80	0.1125000
NODE_1119_length_2212_cov_4.632750	1532	1612	10	24	80	0.3000000
NODE_1119_length_2212_cov_4.632750	1532	1612	11	39	80	0.4875000
NODE_1119_length_2212_cov_4.632750	1532	1612	12	8	80	0.1000000
NODE_1122_length_2211_cov_16.247159	1808	1888	0	11	80	0.1375000
NODE_1122_length_2211_cov_16.247159	1808	1888	2	69	80	0.8625000
NODE_1124_length_2207_cov_46.766129	1273	1348	16	13	75	0.1733333
NODE_1124_length_2207_cov_46.766129	1273	1348	18	18	75	0.2400000
NODE_1124_length_2207_cov_46.766129	1273	1348	19	7	75	0.0933333
NODE_1124_length_2207_cov_46.766129	1273	1348	20	11	75	0.1466667
NODE_1124_length_2207_cov_46.766129	1273	1348	21	1	75	0.0133333
NODE_1124_length_2207_cov_46.766129	1273	1348	22	3	75	0.0400000
NODE_1124_length_2207_cov_46.766129	1273	1348	23	1	75	0.0133333
NODE_1124_length_2207_cov_46.766129	1273	1348	24	8	75	0.1066667
NODE_1124_length_2207_cov_46.766129	1273	1348	25	9	75	0.1200000
NODE_1124_length_2207_cov_46.766129	1273	1348	26	4	75	0.0533333
NODE_1124_length_2207_cov_46.766129	1324	1401	19	1	77	0.0129870
NODE_1124_length_2207_cov_46.766129	1324	1401	20	14	77	0.1818182
NODE_1124_length_2207_cov_46.766129	1324	1401	21	5	77	0.0649351
NODE_1124_length_2207_cov_46.766129	1324	1401	22	20	77	0.2597403
NODE_1124_length_2207_cov_46.766129	1324	1401	23	6	77	0.0779221
NODE_1124_length_2207_cov_46.766129	1324	1401	24	10	77	0.1298701
NODE_1124_length_2207_cov_46.766129	1324	1401	25	9	77	0.1168831
NODE_1124_length_2207_cov_46.766129	1324	1401	26	12	77	0.1558442
NODE_1127_length_2205_cov_12.762108	1818	1898	13	36	80	0.4500000
NODE_1127_length_2205_cov_12.762108	1818	1898	16	29	80	0.3625000
NODE_1127_length_2205_cov_12.762108	1818	1898	17	14	80	0.1750000
NODE_1127_length_2205_cov_12.762108	1818	1898	18	1	80	0.0125000
NODE_1127_length_2205_cov_12.762108	1871	1951	11	7	80	0.0875000
NODE_1127_length_2205_cov_12.762108	1871	1951	12	11	80	0.1375000
NODE_1127_length_2205_cov_12.762108	1871	1951	15	1	80	0.0125000
NODE_1127_length_2205_cov_12.762108	1871	1951	16	31	80	0.3875000
NODE_1127_length_2205_cov_12.762108	1871	1951	17	30	80	0.3750000
NODE_1127_length_2205_cov_12.762108	1872	1951	11	7	79	0.0886076
NODE_1127_length_2205_cov_12.762108	1872	1951	12	11	79	0.1392405
NODE_1127_length_2205_cov_12.762108	1872	1951	15	1	79	0.0126582
NODE_1127_length_2205_cov_12.762108	1872	1951	16	30	79	0.3797468
NODE_1127_length_2205_cov_12.762108	1872	1951	17	30	79	0.3797468
NODE_1127_length_2205_cov_12.762108	1947	2020	4	5	73	0.0684932
NODE_1127_length_2205_cov_12.762108	1947	2020	5	11	73	0.1506849
NODE_1127_length_2205_cov_12.762108	1947	2020	8	17	73	0.2328767
NODE_1127_length_2205_cov_12.762108	1947	2020	9	24	73	0.3287671
NODE_1127_length_2205_cov_12.762108	1947	2020	10	3	73	0.0410959
NODE_1127_length_2205_cov_12.762108	1947	2020	11	10	73	0.1369863
NODE_1127_length_2205_cov_12.762108	1947	2020	12	3	73	0.0410959
NODE_1128_length_2202_cov_8.687114	1848	1912	0	64	64	1.0000000
NODE_1130_length_2200_cov_10.639695	1461	1541	0	80	80	1.0000000
NODE_1130_length_2200_cov_10.639695	1514	1594	0	80	80	1.0000000
NODE_1131_length_2199_cov_10.839524	1709	1789	5	80	80	1.0000000
NODE_1131_length_2199_cov_10.839524	1762	1842	5	40	80	0.5000000
NODE_1131_length_2199_cov_10.839524	1762	1842	7	34	80	0.4250000
NODE_1131_length_2199_cov_10.839524	1762	1842	8	3	80	0.0375000
NODE_1131_length_2199_cov_10.839524	1762	1842	9	3	80	0.0375000
NODE_1135_length_2196_cov_64.718646	885	965	21	1	80	0.0125000
NODE_1135_length_2196_cov_64.718646	885	965	22	2	80	0.0250000
NODE_1135_length_2196_cov_64.718646	885	965	23	4	80	0.0500000
NODE_1135_length_2196_cov_64.718646	885	965	24	2	80	0.0250000
NODE_1135_length_2196_cov_64.718646	885	965	25	9	80	0.1125000
NODE_1135_length_2196_cov_64.718646	885	965	26	5	80	0.0625000
NODE_1135_length_2196_cov_64.718646	885	965	29	5	80	0.0625000
NODE_1135_length_2196_cov_64.718646	885	965	30	31	80	0.3875000
NODE_1135_length_2196_cov_64.718646	885	965	31	14	80	0.1750000
NODE_1135_length_2196_cov_64.718646	885	965	32	7	80	0.0875000
NODE_1135_length_2196_cov_64.718646	938	1018	19	5	80	0.0625000
NODE_1135_length_2196_cov_64.718646	938	1018	21	5	80	0.0625000
NODE_1135_length_2196_cov_64.718646	938	1018	22	2	80	0.0250000
NODE_1135_length_2196_cov_64.718646	938	1018	23	4	80	0.0500000
NODE_1135_length_2196_cov_64.718646	938	1018	25	2	80	0.0250000
NODE_1135_length_2196_cov_64.718646	938	1018	27	2	80	0.0250000
NODE_1135_length_2196_cov_64.718646	938	1018	28	2	80	0.0250000
NODE_1135_length_2196_cov_64.718646	938	1018	29	9	80	0.1125000
NODE_1135_length_2196_cov_64.718646	938	1018	30	19	80	0.2375000
NODE_1135_length_2196_cov_64.718646	938	1018	31	7	80	0.0875000
NODE_1135_length_2196_cov_64.718646	938	1018	32	7	80	0.0875000
NODE_1135_length_2196_cov_64.718646	938	1018	33	16	80	0.2000000
NODE_1138_length_2195_cov_8.443225	114	136	0	22	22	1.0000000
NODE_1139_length_2195_cov_6.113550	1245	1330	1	61	85	0.7176471
NODE_1139_length_2195_cov_6.113550	1245	1330	2	24	85	0.2823530
NODE_1139_length_2195_cov_6.113550	1306	1352	0	3	46	0.0652174
NODE_1139_length_2195_cov_6.113550	1306	1352	1	43	46	0.9347826
NODE_1141_length_2194_cov_1.366587	15	77	0	62	62	1.0000000
NODE_1142_length_2193_cov_8.320917	374	454	0	80	80	1.0000000
NODE_1142_length_2193_cov_8.320917	427	502	0	73	75	0.9733334
NODE_1142_length_2193_cov_8.320917	427	502	1	2	75	0.0266667
NODE_1146_length_2189_cov_36.884689	383	463	0	11	80	0.1375000
NODE_1146_length_2189_cov_36.884689	383	463	1	28	80	0.3500000
NODE_1146_length_2189_cov_36.884689	383	463	3	9	80	0.1125000
NODE_1146_length_2189_cov_36.884689	383	463	5	14	80	0.1750000
NODE_1146_length_2189_cov_36.884689	383	463	7	18	80	0.2250000
NODE_1146_length_2189_cov_36.884689	436	516	5	9	80	0.1125000
NODE_1146_length_2189_cov_36.884689	436	516	7	71	80	0.8875000
NODE_1146_length_2189_cov_36.884689	1257	1337	1	2	80	0.0250000
NODE_1146_length_2189_cov_36.884689	1257	1337	4	8	80	0.1000000
NODE_1146_length_2189_cov_36.884689	1257	1337	5	53	80	0.6625000
NODE_1146_length_2189_cov_36.884689	1257	1337	7	17	80	0.2125000
NODE_1146_length_2189_cov_36.884689	1310	1390	5	10	80	0.1250000
NODE_1146_length_2189_cov_36.884689	1310	1390	7	26	80	0.3250000
NODE_1146_length_2189_cov_36.884689	1310	1390	8	44	80	0.5500000
NODE_1146_length_2189_cov_36.884689	1427	1507	1	11	80	0.1375000
NODE_1146_length_2189_cov_36.884689	1427	1507	2	26	80	0.3250000
NODE_1146_length_2189_cov_36.884689	1427	1507	5	43	80	0.5375000
NODE_1146_length_2189_cov_36.884689	1480	1560	0	6	80	0.0750000
NODE_1146_length_2189_cov_36.884689	1480	1560	1	58	80	0.7250000
NODE_1146_length_2189_cov_36.884689	1480	1560	2	16	80	0.2000000
NODE_1152_length_2184_cov_9.464748	1536	1616	7	30	80	0.3750000
NODE_1152_length_2184_cov_9.464748	1536	1616	8	20	80	0.2500000
NODE_1152_length_2184_cov_9.464748	1536	1616	9	30	80	0.3750000
NODE_1152_length_2184_cov_9.464748	1589	1669	6	11	80	0.1375000
NODE_1152_length_2184_cov_9.464748	1589	1669	7	35	80	0.4375000
NODE_1152_length_2184_cov_9.464748	1589	1669	8	17	80	0.2125000
NODE_1152_length_2184_cov_9.464748	1589	1669	9	14	80	0.1750000
NODE_1152_length_2184_cov_9.464748	1589	1669	10	3	80	0.0375000
NODE_1154_length_2183_cov_45.471209	1632	1712	22	1	80	0.0125000
NODE_1154_length_2183_cov_45.471209	1632	1712	23	2	80	0.0250000
NODE_1154_length_2183_cov_45.471209	1632	1712	25	7	80	0.0875000
NODE_1154_length_2183_cov_45.471209	1632	1712	26	4	80	0.0500000
NODE_1154_length_2183_cov_45.471209	1632	1712	27	1	80	0.0125000
NODE_1154_length_2183_cov_45.471209	1632	1712	28	3	80	0.0375000
NODE_1154_length_2183_cov_45.471209	1632	1712	29	4	80	0.0500000
NODE_1154_length_2183_cov_45.471209	1632	1712	30	3	80	0.0375000
NODE_1154_length_2183_cov_45.471209	1632	1712	31	4	80	0.0500000
NODE_1154_length_2183_cov_45.471209	1632	1712	32	1	80	0.0125000
NODE_1154_length_2183_cov_45.471209	1632	1712	33	10	80	0.1250000
NODE_1154_length_2183_cov_45.471209	1632	1712	40	13	80	0.1625000
NODE_1154_length_2183_cov_45.471209	1632	1712	41	1	80	0.0125000
NODE_1154_length_2183_cov_45.471209	1632	1712	42	8	80	0.1000000
NODE_1154_length_2183_cov_45.471209	1632	1712	43	12	80	0.1500000
NODE_1154_length_2183_cov_45.471209	1632	1712	46	6	80	0.0750000
NODE_1154_length_2183_cov_45.471209	1685	1765	40	1	80	0.0125000
NODE_1154_length_2183_cov_45.471209	1685	1765	41	1	80	0.0125000
NODE_1154_length_2183_cov_45.471209	1685	1765	42	7	80	0.0875000
NODE_1154_length_2183_cov_45.471209	1685	1765	43	12	80	0.1500000
NODE_1154_length_2183_cov_45.471209	1685	1765	45	9	80	0.1125000
NODE_1154_length_2183_cov_45.471209	1685	1765	46	12	80	0.1500000
NODE_1154_length_2183_cov_45.471209	1685	1765	47	10	80	0.1250000
NODE_1154_length_2183_cov_45.471209	1685	1765	48	9	80	0.1125000
NODE_1154_length_2183_cov_45.471209	1685	1765	49	19	80	0.2375000
NODE_1159_length_2176_cov_47.338950	0	52	0	52	52	1.0000000
NODE_1162_length_2174_cov_40.560964	1638	1718	1	11	80	0.1375000
NODE_1162_length_2174_cov_40.560964	1638	1718	2	22	80	0.2750000
NODE_1162_length_2174_cov_40.560964	1638	1718	5	17	80	0.2125000
NODE_1162_length_2174_cov_40.560964	1638	1718	6	30	80	0.3750000
NODE_1162_length_2174_cov_40.560964	1691	1771	5	70	80	0.8750000
NODE_1162_length_2174_cov_40.560964	1691	1771	6	10	80	0.1250000
NODE_1163_length_2174_cov_35.399518	284	364	0	34	80	0.4250000
NODE_1163_length_2174_cov_35.399518	284	364	1	20	80	0.2500000
NODE_1163_length_2174_cov_35.399518	284	364	2	26	80	0.3250000
NODE_1163_length_2174_cov_35.399518	337	414	1	1	77	0.0129870
NODE_1163_length_2174_cov_35.399518	337	414	2	76	77	0.9870130
NODE_1163_length_2174_cov_35.399518	1542	1620	4	10	78	0.1282051
NODE_1163_length_2174_cov_35.399518	1542	1620	6	10	78	0.1282051
NODE_1163_length_2174_cov_35.399518	1542	1620	9	18	78	0.2307692
NODE_1163_length_2174_cov_35.399518	1542	1620	10	14	78	0.1794872
NODE_1163_length_2174_cov_35.399518	1542	1620	11	18	78	0.2307692
NODE_1163_length_2174_cov_35.399518	1542	1620	12	8	78	0.1025641
NODE_1163_length_2174_cov_35.399518	1593	1673	10	1	80	0.0125000
NODE_1163_length_2174_cov_35.399518	1593	1673	11	18	80	0.2250000
NODE_1163_length_2174_cov_35.399518	1593	1673	12	12	80	0.1500000
NODE_1163_length_2174_cov_35.399518	1593	1673	14	6	80	0.0750000
NODE_1163_length_2174_cov_35.399518	1593	1673	15	3	80	0.0375000
NODE_1163_length_2174_cov_35.399518	1593	1673	16	6	80	0.0750000
NODE_1163_length_2174_cov_35.399518	1593	1673	17	32	80	0.4000000
NODE_1163_length_2174_cov_35.399518	1593	1673	18	2	80	0.0250000
NODE_1163_length_2174_cov_35.399518	2075	2152	1	28	77	0.3636364
NODE_1163_length_2174_cov_35.399518	2075	2152	2	15	77	0.1948052
NODE_1163_length_2174_cov_35.399518	2075	2152	3	6	77	0.0779221
NODE_1163_length_2174_cov_35.399518	2075	2152	6	28	77	0.3636364
NODE_1163_length_2174_cov_35.399518	2075	2152	1	28	77	0.3636364
NODE_1163_length_2174_cov_35.399518	2075	2152	2	15	77	0.1948052
NODE_1163_length_2174_cov_35.399518	2075	2152	3	6	77	0.0779221
NODE_1163_length_2174_cov_35.399518	2075	2152	6	28	77	0.3636364
NODE_1163_length_2174_cov_35.399518	2075	2152	1	28	77	0.3636364
NODE_1163_length_2174_cov_35.399518	2075	2152	2	15	77	0.1948052
NODE_1163_length_2174_cov_35.399518	2075	2152	3	6	77	0.0779221
NODE_1163_length_2174_cov_35.399518	2075	2152	6	28	77	0.3636364
NODE_1163_length_2174_cov_35.399518	2125	2174	0	15	49	0.3061225
NODE_1163_length_2174_cov_35.399518	2125	2174	1	34	49	0.6938776
NODE_1163_length_2174_cov_35.399518	2128	2174	0	15	46	0.3260870
NODE_1163_length_2174_cov_35.399518	2128	2174	1	31	46	0.6739131
NODE_1163_length_2174_cov_35.399518	2130	2174	0	15	44	0.3409091
NODE_1163_length_2174_cov_35.399518	2130	2174	1	29	44	0.6590909
NODE_1164_length_2172_cov_44.861553	1110	1190	10	1	80	0.0125000
NODE_1164_length_2172_cov_44.861553	1110	1190	11	17	80	0.2125000
NODE_1164_length_2172_cov_44.861553	1110	1190	13	7	80	0.0875000
NODE_1164_length_2172_cov_44.861553	1110	1190	15	6	80	0.0750000
NODE_1164_length_2172_cov_44.861553	1110	1190	16	4	80	0.0500000
NODE_1164_length_2172_cov_44.861553	1110	1190	17	2	80	0.0250000
NODE_1164_length_2172_cov_44.861553	1110	1190	18	24	80	0.3000000
NODE_1164_length_2172_cov_44.861553	1110	1190	19	14	80	0.1750000
NODE_1164_length_2172_cov_44.861553	1110	1190	20	5	80	0.0625000
NODE_1164_length_2172_cov_44.861553	1163	1243	16	6	80	0.0750000
NODE_1164_length_2172_cov_44.861553	1163	1243	18	12	80	0.1500000
NODE_1164_length_2172_cov_44.861553	1163	1243	19	16	80	0.2000000
NODE_1164_length_2172_cov_44.861553	1163	1243	20	28	80	0.3500000
NODE_1164_length_2172_cov_44.861553	1163	1243	21	18	80	0.2250000
NODE_1164_length_2172_cov_44.861553	1239	1319	7	15	80	0.1875000
NODE_1164_length_2172_cov_44.861553	1239	1319	8	12	80	0.1500000
NODE_1164_length_2172_cov_44.861553	1239	1319	10	15	80	0.1875000
NODE_1164_length_2172_cov_44.861553	1239	1319	12	17	80	0.2125000
NODE_1164_length_2172_cov_44.861553	1239	1319	13	2	80	0.0250000
NODE_1164_length_2172_cov_44.861553	1239	1319	14	12	80	0.1500000
NODE_1164_length_2172_cov_44.861553	1239	1319	16	7	80	0.0875000
NODE_1164_length_2172_cov_44.861553	1292	1372	5	9	80	0.1125000
NODE_1164_length_2172_cov_44.861553	1292	1372	6	9	80	0.1125000
NODE_1164_length_2172_cov_44.861553	1292	1372	7	28	80	0.3500000
NODE_1164_length_2172_cov_44.861553	1292	1372	8	11	80	0.1375000
NODE_1164_length_2172_cov_44.861553	1292	1372	9	14	80	0.1750000
NODE_1164_length_2172_cov_44.861553	1292	1372	10	9	80	0.1125000
NODE_1166_length_2167_cov_33.133946	414	494	10	3	80	0.0375000
NODE_1166_length_2167_cov_33.133946	414	494	12	12	80	0.1500000
NODE_1166_length_2167_cov_33.133946	414	494	13	12	80	0.1500000
NODE_1166_length_2167_cov_33.133946	414	494	14	46	80	0.5750000
NODE_1166_length_2167_cov_33.133946	414	494	15	1	80	0.0125000
NODE_1166_length_2167_cov_33.133946	414	494	16	1	80	0.0125000
NODE_1166_length_2167_cov_33.133946	414	494	18	5	80	0.0625000
NODE_1166_length_2167_cov_33.133946	467	547	10	15	80	0.1875000
NODE_1166_length_2167_cov_33.133946	467	547	11	1	80	0.0125000
NODE_1166_length_2167_cov_33.133946	467	547	12	18	80	0.2250000
NODE_1166_length_2167_cov_33.133946	467	547	13	5	80	0.0625000
NODE_1166_length_2167_cov_33.133946	467	547	14	35	80	0.4375000
NODE_1166_length_2167_cov_33.133946	467	547	15	1	80	0.0125000
NODE_1166_length_2167_cov_33.133946	467	547	16	1	80	0.0125000
NODE_1166_length_2167_cov_33.133946	467	547	18	4	80	0.0500000
NODE_1166_length_2167_cov_33.133946	543	623	10	7	80	0.0875000
NODE_1166_length_2167_cov_33.133946	543	623	14	33	80	0.4125000
NODE_1166_length_2167_cov_33.133946	543	623	15	25	80	0.3125000
NODE_1166_length_2167_cov_33.133946	543	623	16	6	80	0.0750000
NODE_1166_length_2167_cov_33.133946	543	623	17	9	80	0.1125000
NODE_1166_length_2167_cov_33.133946	596	676	7	3	80	0.0375000
NODE_1166_length_2167_cov_33.133946	596	676	8	16	80	0.2000000
NODE_1166_length_2167_cov_33.133946	596	676	9	27	80	0.3375000
NODE_1166_length_2167_cov_33.133946	596	676	10	10	80	0.1250000
NODE_1166_length_2167_cov_33.133946	596	676	11	4	80	0.0500000
NODE_1166_length_2167_cov_33.133946	596	676	14	16	80	0.2000000
NODE_1166_length_2167_cov_33.133946	596	676	15	4	80	0.0500000
NODE_1169_length_2165_cov_21.460794	980	1060	11	54	80	0.6750000
NODE_1169_length_2165_cov_21.460794	980	1060	13	8	80	0.1000000
NODE_1169_length_2165_cov_21.460794	980	1060	15	8	80	0.1000000
NODE_1169_length_2165_cov_21.460794	980	1060	16	1	80	0.0125000
NODE_1169_length_2165_cov_21.460794	980	1060	17	9	80	0.1125000
NODE_1169_length_2165_cov_21.460794	1033	1113	8	9	80	0.1125000
NODE_1169_length_2165_cov_21.460794	1033	1113	9	21	80	0.2625000
NODE_1169_length_2165_cov_21.460794	1033	1113	10	9	80	0.1125000
NODE_1169_length_2165_cov_21.460794	1033	1113	11	1	80	0.0125000
NODE_1169_length_2165_cov_21.460794	1033	1113	13	9	80	0.1125000
NODE_1169_length_2165_cov_21.460794	1033	1113	15	21	80	0.2625000
NODE_1169_length_2165_cov_21.460794	1033	1113	16	1	80	0.0125000
NODE_1169_length_2165_cov_21.460794	1033	1113	17	9	80	0.1125000
NODE_1176_length_2157_cov_22.284257	989	1069	4	11	80	0.1375000
NODE_1176_length_2157_cov_22.284257	989	1069	5	6	80	0.0750000
NODE_1176_length_2157_cov_22.284257	989	1069	6	2	80	0.0250000
NODE_1176_length_2157_cov_22.284257	989	1069	7	7	80	0.0875000
NODE_1176_length_2157_cov_22.284257	989	1069	8	3	80	0.0375000
NODE_1176_length_2157_cov_22.284257	989	1069	9	32	80	0.4000000
NODE_1176_length_2157_cov_22.284257	989	1069	10	19	80	0.2375000
NODE_1176_length_2157_cov_22.284257	1042	1122	7	46	80	0.5750000
NODE_1176_length_2157_cov_22.284257	1042	1122	9	8	80	0.1000000
NODE_1176_length_2157_cov_22.284257	1042	1122	10	26	80	0.3250000
NODE_1176_length_2157_cov_22.284257	1118	1198	2	30	80	0.3750000
NODE_1176_length_2157_cov_22.284257	1118	1198	3	8	80	0.1000000
NODE_1176_length_2157_cov_22.284257	1118	1198	4	4	80	0.0500000
NODE_1176_length_2157_cov_22.284257	1118	1198	5	6	80	0.0750000
NODE_1176_length_2157_cov_22.284257	1118	1198	6	19	80	0.2375000
NODE_1176_length_2157_cov_22.284257	1118	1198	7	13	80	0.1625000
NODE_1176_length_2157_cov_22.284257	1171	1251	1	6	80	0.0750000
NODE_1176_length_2157_cov_22.284257	1171	1251	2	70	80	0.8750000
NODE_1176_length_2157_cov_22.284257	1171	1251	4	4	80	0.0500000
NODE_1177_length_2157_cov_8.830418	867	947	7	48	80	0.6000000
NODE_1177_length_2157_cov_8.830418	867	947	8	19	80	0.2375000
NODE_1177_length_2157_cov_8.830418	867	947	9	6	80	0.0750000
NODE_1177_length_2157_cov_8.830418	867	947	10	7	80	0.0875000
NODE_1177_length_2157_cov_8.830418	920	1000	7	40	80	0.5000000
NODE_1177_length_2157_cov_8.830418	920	1000	8	12	80	0.1500000
NODE_1177_length_2157_cov_8.830418	920	1000	9	2	80	0.0250000
NODE_1177_length_2157_cov_8.830418	920	1000	10	15	80	0.1875000
NODE_1177_length_2157_cov_8.830418	920	1000	11	11	80	0.1375000
NODE_1177_length_2157_cov_8.830418	996	1076	7	10	80	0.1250000
NODE_1177_length_2157_cov_8.830418	996	1076	8	9	80	0.1125000
NODE_1177_length_2157_cov_8.830418	996	1076	9	7	80	0.0875000
NODE_1177_length_2157_cov_8.830418	996	1076	10	54	80	0.6750000
NODE_1177_length_2157_cov_8.830418	1049	1129	7	22	80	0.2750000
NODE_1177_length_2157_cov_8.830418	1049	1129	8	6	80	0.0750000
NODE_1177_length_2157_cov_8.830418	1049	1129	9	31	80	0.3875000
NODE_1177_length_2157_cov_8.830418	1049	1129	10	21	80	0.2625000
NODE_1178_length_2156_cov_25.065630	0	41	9	1	41	0.0243902
NODE_1178_length_2156_cov_25.065630	0	41	10	3	41	0.0731707
NODE_1178_length_2156_cov_25.065630	0	41	11	5	41	0.1219512
NODE_1178_length_2156_cov_25.065630	0	41	12	1	41	0.0243902
NODE_1178_length_2156_cov_25.065630	0	41	13	9	41	0.2195122
NODE_1178_length_2156_cov_25.065630	0	41	15	6	41	0.1463415
NODE_1178_length_2156_cov_25.065630	0	41	16	5	41	0.1219512
NODE_1178_length_2156_cov_25.065630	0	41	18	11	41	0.2682927
NODE_1178_length_2156_cov_25.065630	14	94	13	5	80	0.0625000
NODE_1178_length_2156_cov_25.065630	14	94	15	6	80	0.0750000
NODE_1178_length_2156_cov_25.065630	14	94	16	5	80	0.0625000
NODE_1178_length_2156_cov_25.065630	14	94	18	11	80	0.1375000
NODE_1178_length_2156_cov_25.065630	14	94	19	3	80	0.0375000
NODE_1178_length_2156_cov_25.065630	14	94	23	3	80	0.0375000
NODE_1178_length_2156_cov_25.065630	14	94	26	8	80	0.1000000
NODE_1178_length_2156_cov_25.065630	14	94	28	13	80	0.1625000
NODE_1178_length_2156_cov_25.065630	14	94	30	4	80	0.0500000
NODE_1178_length_2156_cov_25.065630	14	94	34	2	80	0.0250000
NODE_1178_length_2156_cov_25.065630	14	94	36	5	80	0.0625000
NODE_1178_length_2156_cov_25.065630	14	94	40	15	80	0.1875000
NODE_1181_length_2156_cov_3.216334	1890	1970	0	23	80	0.2875000
NODE_1181_length_2156_cov_3.216334	1890	1970	6	57	80	0.7125000
NODE_1181_length_2156_cov_3.216334	1943	2023	0	76	80	0.9500000
NODE_1181_length_2156_cov_3.216334	1943	2023	6	4	80	0.0500000
NODE_1184_length_2153_cov_11.610029	1968	2048	5	80	80	1.0000000
NODE_1184_length_2153_cov_11.610029	1977	2048	5	71	71	1.0000000
NODE_1190_length_2147_cov_25.116211	814	894	25	1	80	0.0125000
NODE_1190_length_2147_cov_25.116211	814	894	27	6	80	0.0750000
NODE_1190_length_2147_cov_25.116211	814	894	34	7	80	0.0875000
NODE_1190_length_2147_cov_25.116211	814	894	36	3	80	0.0375000
NODE_1190_length_2147_cov_25.116211	814	894	40	19	80	0.2375000
NODE_1190_length_2147_cov_25.116211	814	894	41	7	80	0.0875000
NODE_1190_length_2147_cov_25.116211	814	894	42	4	80	0.0500000
NODE_1190_length_2147_cov_25.116211	814	894	43	18	80	0.2250000
NODE_1190_length_2147_cov_25.116211	814	894	44	1	80	0.0125000
NODE_1190_length_2147_cov_25.116211	814	894	45	1	80	0.0125000
NODE_1190_length_2147_cov_25.116211	814	894	46	2	80	0.0250000
NODE_1190_length_2147_cov_25.116211	814	894	47	7	80	0.0875000
NODE_1190_length_2147_cov_25.116211	814	894	51	1	80	0.0125000
NODE_1190_length_2147_cov_25.116211	814	894	53	3	80	0.0375000
NODE_1190_length_2147_cov_25.116211	867	947	40	3	80	0.0375000
NODE_1190_length_2147_cov_25.116211	867	947	42	3	80	0.0375000
NODE_1190_length_2147_cov_25.116211	867	947	43	6	80	0.0750000
NODE_1190_length_2147_cov_25.116211	867	947	44	1	80	0.0125000
NODE_1190_length_2147_cov_25.116211	867	947	45	1	80	0.0125000
NODE_1190_length_2147_cov_25.116211	867	947	46	2	80	0.0250000
NODE_1190_length_2147_cov_25.116211	867	947	47	7	80	0.0875000
NODE_1190_length_2147_cov_25.116211	867	947	49	2	80	0.0250000
NODE_1190_length_2147_cov_25.116211	867	947	50	9	80	0.1125000
NODE_1190_length_2147_cov_25.116211	867	947	51	9	80	0.1125000
NODE_1190_length_2147_cov_25.116211	867	947	52	28	80	0.3500000
NODE_1190_length_2147_cov_25.116211	867	947	53	8	80	0.1000000
NODE_1190_length_2147_cov_25.116211	867	947	54	1	80	0.0125000
NODE_1197_length_2136_cov_16.947472	279	359	6	26	80	0.3250000
NODE_1197_length_2136_cov_16.947472	279	359	7	20	80	0.2500000
NODE_1197_length_2136_cov_16.947472	279	359	8	26	80	0.3250000
NODE_1197_length_2136_cov_16.947472	279	359	9	8	80	0.1000000
NODE_1197_length_2136_cov_16.947472	332	412	1	1	80	0.0125000
NODE_1197_length_2136_cov_16.947472	332	412	2	5	80	0.0625000
NODE_1197_length_2136_cov_16.947472	332	412	4	3	80	0.0375000
NODE_1197_length_2136_cov_16.947472	332	412	5	33	80	0.4125000
NODE_1197_length_2136_cov_16.947472	332	412	6	37	80	0.4625000
NODE_1197_length_2136_cov_16.947472	332	412	7	1	80	0.0125000
NODE_1197_length_2136_cov_16.947472	408	488	0	37	80	0.4625000
NODE_1197_length_2136_cov_16.947472	408	488	1	40	80	0.5000000
NODE_1197_length_2136_cov_16.947472	408	488	2	3	80	0.0375000
NODE_1197_length_2136_cov_16.947472	461	541	0	80	80	1.0000000
NODE_1199_length_2133_cov_15.038840	498	578	0	80	80	1.0000000
NODE_1199_length_2133_cov_15.038840	551	631	0	34	80	0.4250000
NODE_1199_length_2133_cov_15.038840	551	631	1	46	80	0.5750000
NODE_1199_length_2133_cov_15.038840	627	707	1	80	80	1.0000000
NODE_1199_length_2133_cov_15.038840	680	722	1	42	42	1.0000000
NODE_1204_length_2128_cov_11.799409	1698	1778	0	80	80	1.0000000
NODE_1204_length_2128_cov_11.799409	1751	1831	0	80	80	1.0000000
NODE_1206_length_2126_cov_6.854465	1614	1694	4	6	80	0.0750000
NODE_1206_length_2126_cov_6.854465	1614	1694	6	35	80	0.4375000
NODE_1206_length_2126_cov_6.854465	1614	1694	7	39	80	0.4875000
NODE_1206_length_2126_cov_6.854465	1667	1747	0	9	80	0.1125000
NODE_1206_length_2126_cov_6.854465	1667	1747	1	1	80	0.0125000
NODE_1206_length_2126_cov_6.854465	1667	1747	2	15	80	0.1875000
NODE_1206_length_2126_cov_6.854465	1667	1747	3	7	80	0.0875000
NODE_1206_length_2126_cov_6.854465	1667	1747	4	27	80	0.3375000
NODE_1206_length_2126_cov_6.854465	1667	1747	6	21	80	0.2625000
NODE_1209_length_2123_cov_12.668478	102	143	0	41	41	1.0000000
NODE_1209_length_2123_cov_12.668478	1474	1500	2	14	26	0.5384616
NODE_1209_length_2123_cov_12.668478	1474	1500	3	12	26	0.4615385
NODE_1209_length_2123_cov_12.668478	1552	1601	4	5	49	0.1020408
NODE_1209_length_2123_cov_12.668478	1552	1601	5	2	49	0.0408163
NODE_1209_length_2123_cov_12.668478	1552	1601	6	4	49	0.0816327
NODE_1209_length_2123_cov_12.668478	1552	1601	7	2	49	0.0408163
NODE_1209_length_2123_cov_12.668478	1552	1601	8	21	49	0.4285714
NODE_1209_length_2123_cov_12.668478	1552	1601	9	15	49	0.3061225
NODE_1209_length_2123_cov_12.668478	1574	1654	7	3	80	0.0375000
NODE_1209_length_2123_cov_12.668478	1574	1654	8	39	80	0.4875000
NODE_1209_length_2123_cov_12.668478	1574	1654	9	38	80	0.4750000
NODE_1211_length_2121_cov_10.101879	497	577	0	66	80	0.8250000
NODE_1211_length_2121_cov_10.101879	497	577	1	14	80	0.1750000
NODE_1211_length_2121_cov_10.101879	550	630	0	13	80	0.1625000
NODE_1211_length_2121_cov_10.101879	550	630	1	67	80	0.8375000
NODE_1211_length_2121_cov_10.101879	1935	2008	4	14	73	0.1917808
NODE_1211_length_2121_cov_10.101879	1935	2008	5	16	73	0.2191781
NODE_1211_length_2121_cov_10.101879	1935	2008	7	8	73	0.1095890
NODE_1211_length_2121_cov_10.101879	1935	2008	9	35	73	0.4794520
NODE_1212_length_2121_cov_9.964886	1523	1603	4	13	80	0.1625000
NODE_1212_length_2121_cov_9.964886	1523	1603	7	10	80	0.1250000
NODE_1212_length_2121_cov_9.964886	1523	1603	8	9	80	0.1125000
NODE_1212_length_2121_cov_9.964886	1523	1603	10	48	80	0.6000000
NODE_1212_length_2121_cov_9.964886	1576	1656	4	9	80	0.1125000
NODE_1212_length_2121_cov_9.964886	1576	1656	6	19	80	0.2375000
NODE_1212_length_2121_cov_9.964886	1576	1656	7	11	80	0.1375000
NODE_1212_length_2121_cov_9.964886	1576	1656	10	41	80	0.5125000
NODE_1213_length_2120_cov_24.609599	25	92	0	22	67	0.3283582
NODE_1213_length_2120_cov_24.609599	25	92	3	45	67	0.6716418
NODE_1215_length_2119_cov_18.446040	366	446	1	7	80	0.0875000
NODE_1215_length_2119_cov_18.446040	366	446	3	3	80	0.0375000
NODE_1215_length_2119_cov_18.446040	366	446	4	6	80	0.0750000
NODE_1215_length_2119_cov_18.446040	366	446	5	64	80	0.8000000
NODE_1215_length_2119_cov_18.446040	419	499	4	33	80	0.4125000
NODE_1215_length_2119_cov_18.446040	419	499	5	21	80	0.2625000
NODE_1215_length_2119_cov_18.446040	419	499	6	17	80	0.2125000
NODE_1215_length_2119_cov_18.446040	419	499	7	2	80	0.0250000
NODE_1215_length_2119_cov_18.446040	419	499	8	1	80	0.0125000
NODE_1215_length_2119_cov_18.446040	419	499	9	6	80	0.0750000
NODE_1215_length_2119_cov_18.446040	1239	1319	10	1	80	0.0125000
NODE_1215_length_2119_cov_18.446040	1239	1319	12	12	80	0.1500000
NODE_1215_length_2119_cov_18.446040	1239	1319	13	5	80	0.0625000
NODE_1215_length_2119_cov_18.446040	1239	1319	14	23	80	0.2875000
NODE_1215_length_2119_cov_18.446040	1239	1319	15	11	80	0.1375000
NODE_1215_length_2119_cov_18.446040	1239	1319	16	6	80	0.0750000
NODE_1215_length_2119_cov_18.446040	1239	1319	17	6	80	0.0750000
NODE_1215_length_2119_cov_18.446040	1239	1319	18	2	80	0.0250000
NODE_1215_length_2119_cov_18.446040	1239	1319	19	5	80	0.0625000
NODE_1215_length_2119_cov_18.446040	1239	1319	20	9	80	0.1125000
NODE_1215_length_2119_cov_18.446040	1292	1372	14	2	80	0.0250000
NODE_1215_length_2119_cov_18.446040	1292	1372	15	3	80	0.0375000
NODE_1215_length_2119_cov_18.446040	1292	1372	17	6	80	0.0750000
NODE_1215_length_2119_cov_18.446040	1292	1372	18	15	80	0.1875000
NODE_1215_length_2119_cov_18.446040	1292	1372	19	30	80	0.3750000
NODE_1215_length_2119_cov_18.446040	1292	1372	20	9	80	0.1125000
NODE_1215_length_2119_cov_18.446040	1292	1372	22	2	80	0.0250000
NODE_1215_length_2119_cov_18.446040	1292	1372	25	4	80	0.0500000
NODE_1215_length_2119_cov_18.446040	1292	1372	26	9	80	0.1125000
NODE_1225_length_2110_cov_8.668324	1755	1835	0	80	80	1.0000000
NODE_1225_length_2110_cov_8.668324	1808	1888	0	80	80	1.0000000
NODE_1227_length_2106_cov_14.643747	1579	1659	5	21	80	0.2625000
NODE_1227_length_2106_cov_14.643747	1579	1659	7	10	80	0.1250000
NODE_1227_length_2106_cov_14.643747	1579	1659	10	9	80	0.1125000
NODE_1227_length_2106_cov_14.643747	1579	1659	12	40	80	0.5000000
NODE_1227_length_2106_cov_14.643747	1632	1712	3	49	80	0.6125000
NODE_1227_length_2106_cov_14.643747	1632	1712	5	25	80	0.3125000
NODE_1227_length_2106_cov_14.643747	1632	1712	7	6	80	0.0750000
NODE_1227_length_2106_cov_14.643747	1708	1786	0	61	78	0.7820513
NODE_1227_length_2106_cov_14.643747	1708	1786	3	17	78	0.2179487
NODE_1227_length_2106_cov_14.643747	1759	1839	0	80	80	1.0000000
NODE_1228_length_2106_cov_3.173393	48	96	0	48	48	1.0000000
NODE_1228_length_2106_cov_3.173393	48	96	0	48	48	1.0000000
NODE_1228_length_2106_cov_3.173393	48	96	0	48	48	1.0000000
NODE_1228_length_2106_cov_3.173393	48	96	0	48	48	1.0000000
NODE_1228_length_2106_cov_3.173393	48	96	0	48	48	1.0000000
NODE_1229_length_2102_cov_23.872192	390	470	8	7	80	0.0875000
NODE_1229_length_2102_cov_23.872192	390	470	9	8	80	0.1000000
NODE_1229_length_2102_cov_23.872192	390	470	10	12	80	0.1500000
NODE_1229_length_2102_cov_23.872192	390	470	11	16	80	0.2000000
NODE_1229_length_2102_cov_23.872192	390	470	12	2	80	0.0250000
NODE_1229_length_2102_cov_23.872192	390	470	14	35	80	0.4375000
NODE_1229_length_2102_cov_23.872192	443	523	8	4	80	0.0500000
NODE_1229_length_2102_cov_23.872192	443	523	10	11	80	0.1375000
NODE_1229_length_2102_cov_23.872192	443	523	11	20	80	0.2500000
NODE_1229_length_2102_cov_23.872192	443	523	13	2	80	0.0250000
NODE_1229_length_2102_cov_23.872192	443	523	17	22	80	0.2750000
NODE_1229_length_2102_cov_23.872192	443	523	20	21	80	0.2625000
NODE_1229_length_2102_cov_23.872192	519	599	15	1	80	0.0125000
NODE_1229_length_2102_cov_23.872192	519	599	16	2	80	0.0250000
NODE_1229_length_2102_cov_23.872192	519	599	17	3	80	0.0375000
NODE_1229_length_2102_cov_23.872192	519	599	19	40	80	0.5000000
NODE_1229_length_2102_cov_23.872192	519	599	20	28	80	0.3500000
NODE_1229_length_2102_cov_23.872192	519	599	23	6	80	0.0750000
NODE_1229_length_2102_cov_23.872192	572	652	13	21	80	0.2625000
NODE_1229_length_2102_cov_23.872192	572	652	14	1	80	0.0125000
NODE_1229_length_2102_cov_23.872192	572	652	16	1	80	0.0125000
NODE_1229_length_2102_cov_23.872192	572	652	17	1	80	0.0125000
NODE_1229_length_2102_cov_23.872192	572	652	19	25	80	0.3125000
NODE_1229_length_2102_cov_23.872192	572	652	22	20	80	0.2500000
NODE_1229_length_2102_cov_23.872192	572	652	23	11	80	0.1375000
NODE_1229_length_2102_cov_23.872192	1049	1101	13	4	52	0.0769231
NODE_1229_length_2102_cov_23.872192	1049	1101	14	12	52	0.2307692
NODE_1229_length_2102_cov_23.872192	1049	1101	16	22	52	0.4230769
NODE_1229_length_2102_cov_23.872192	1049	1101	17	14	52	0.2692308
NODE_1231_length_2100_cov_21.504248	450	530	0	28	80	0.3500000
NODE_1231_length_2100_cov_21.504248	450	530	3	52	80	0.6500000
NODE_1231_length_2100_cov_21.504248	503	578	3	75	75	1.0000000
NODE_1231_length_2100_cov_21.504248	579	659	0	31	80	0.3875000
NODE_1231_length_2100_cov_21.504248	579	659	3	49	80	0.6125000
NODE_1231_length_2100_cov_21.504248	632	712	0	80	80	1.0000000
NODE_1231_length_2100_cov_21.504248	1420	1500	1	8	80	0.1000000
NODE_1231_length_2100_cov_21.504248	1420	1500	2	5	80	0.0625000
NODE_1231_length_2100_cov_21.504248	1420	1500	3	20	80	0.2500000
NODE_1231_length_2100_cov_21.504248	1420	1500	4	19	80	0.2375000
NODE_1231_length_2100_cov_21.504248	1420	1500	5	27	80	0.3375000
NODE_1231_length_2100_cov_21.504248	1420	1500	6	1	80	0.0125000
NODE_1231_length_2100_cov_21.504248	1473	1553	1	8	80	0.1000000
NODE_1231_length_2100_cov_21.504248	1473	1553	4	23	80	0.2875000
NODE_1231_length_2100_cov_21.504248	1473	1553	5	49	80	0.6125000
NODE_1232_length_2100_cov_6.399300	1510	1590	7	18	80	0.2250000
NODE_1232_length_2100_cov_6.399300	1510	1590	8	36	80	0.4500000
NODE_1232_length_2100_cov_6.399300	1510	1590	9	26	80	0.3250000
NODE_1232_length_2100_cov_6.399300	1559	1590	7	2	31	0.0645161
NODE_1232_length_2100_cov_6.399300	1559	1590	8	29	31	0.9354839
NODE_1232_length_2100_cov_6.399300	1563	1644	2	9	81	0.1111111
NODE_1232_length_2100_cov_6.399300	1563	1644	4	20	81	0.2469136
NODE_1232_length_2100_cov_6.399300	1563	1644	5	10	81	0.1234568
NODE_1232_length_2100_cov_6.399300	1563	1644	6	12	81	0.1481481
NODE_1232_length_2100_cov_6.399300	1563	1644	7	5	81	0.0617284
NODE_1232_length_2100_cov_6.399300	1563	1644	8	25	81	0.3086420
NODE_1232_length_2100_cov_6.399300	1563	1644	2	9	81	0.1111111
NODE_1232_length_2100_cov_6.399300	1563	1644	4	20	81	0.2469136
NODE_1232_length_2100_cov_6.399300	1563	1644	5	10	81	0.1234568
NODE_1232_length_2100_cov_6.399300	1563	1644	6	12	81	0.1481481
NODE_1232_length_2100_cov_6.399300	1563	1644	7	5	81	0.0617284
NODE_1232_length_2100_cov_6.399300	1563	1644	8	25	81	0.3086420
NODE_1234_length_2099_cov_40.603500	960	1040	12	8	80	0.1000000
NODE_1234_length_2099_cov_40.603500	960	1040	15	9	80	0.1125000
NODE_1234_length_2099_cov_40.603500	960	1040	16	2	80	0.0250000
NODE_1234_length_2099_cov_40.603500	960	1040	18	20	80	0.2500000
NODE_1234_length_2099_cov_40.603500	960	1040	19	11	80	0.1375000
NODE_1234_length_2099_cov_40.603500	960	1040	20	9	80	0.1125000
NODE_1234_length_2099_cov_40.603500	960	1040	22	4	80	0.0500000
NODE_1234_length_2099_cov_40.603500	960	1040	23	5	80	0.0625000
NODE_1234_length_2099_cov_40.603500	960	1040	24	3	80	0.0375000
NODE_1234_length_2099_cov_40.603500	960	1040	25	5	80	0.0625000
NODE_1234_length_2099_cov_40.603500	960	1040	26	1	80	0.0125000
NODE_1234_length_2099_cov_40.603500	960	1040	27	1	80	0.0125000
NODE_1234_length_2099_cov_40.603500	960	1040	28	2	80	0.0250000
NODE_1234_length_2099_cov_40.603500	1013	1093	20	6	80	0.0750000
NODE_1234_length_2099_cov_40.603500	1013	1093	22	4	80	0.0500000
NODE_1234_length_2099_cov_40.603500	1013	1093	23	5	80	0.0625000
NODE_1234_length_2099_cov_40.603500	1013	1093	24	3	80	0.0375000
NODE_1234_length_2099_cov_40.603500	1013	1093	25	23	80	0.2875000
NODE_1234_length_2099_cov_40.603500	1013	1093	26	3	80	0.0375000
NODE_1234_length_2099_cov_40.603500	1013	1093	27	5	80	0.0625000
NODE_1234_length_2099_cov_40.603500	1013	1093	28	11	80	0.1375000
NODE_1234_length_2099_cov_40.603500	1013	1093	29	4	80	0.0500000
NODE_1234_length_2099_cov_40.603500	1013	1093	30	2	80	0.0250000
NODE_1234_length_2099_cov_40.603500	1013	1093	31	4	80	0.0500000
NODE_1234_length_2099_cov_40.603500	1013	1093	32	4	80	0.0500000
NODE_1234_length_2099_cov_40.603500	1013	1093	33	6	80	0.0750000
NODE_1234_length_2099_cov_40.603500	1089	1169	32	1	80	0.0125000
NODE_1234_length_2099_cov_40.603500	1089	1169	33	7	80	0.0875000
NODE_1234_length_2099_cov_40.603500	1089	1169	34	8	80	0.1000000
NODE_1234_length_2099_cov_40.603500	1089	1169	35	4	80	0.0500000
NODE_1234_length_2099_cov_40.603500	1089	1169	36	1	80	0.0125000
NODE_1234_length_2099_cov_40.603500	1089	1169	37	9	80	0.1125000
NODE_1234_length_2099_cov_40.603500	1089	1169	38	5	80	0.0625000
NODE_1234_length_2099_cov_40.603500	1089	1169	39	6	80	0.0750000
NODE_1234_length_2099_cov_40.603500	1089	1169	40	2	80	0.0250000
NODE_1234_length_2099_cov_40.603500	1089	1169	41	25	80	0.3125000
NODE_1234_length_2099_cov_40.603500	1089	1169	42	5	80	0.0625000
NODE_1234_length_2099_cov_40.603500	1089	1169	43	2	80	0.0250000
NODE_1234_length_2099_cov_40.603500	1089	1169	44	5	80	0.0625000
NODE_1234_length_2099_cov_40.603500	1142	1222	33	2	80	0.0250000
NODE_1234_length_2099_cov_40.603500	1142	1222	34	4	80	0.0500000
NODE_1234_length_2099_cov_40.603500	1142	1222	35	2	80	0.0250000
NODE_1234_length_2099_cov_40.603500	1142	1222	36	25	80	0.3125000
NODE_1234_length_2099_cov_40.603500	1142	1222	38	1	80	0.0125000
NODE_1234_length_2099_cov_40.603500	1142	1222	39	2	80	0.0250000
NODE_1234_length_2099_cov_40.603500	1142	1222	40	1	80	0.0125000
NODE_1234_length_2099_cov_40.603500	1142	1222	41	22	80	0.2750000
NODE_1234_length_2099_cov_40.603500	1142	1222	42	9	80	0.1125000
NODE_1234_length_2099_cov_40.603500	1142	1222	43	7	80	0.0875000
NODE_1234_length_2099_cov_40.603500	1142	1222	44	5	80	0.0625000
NODE_1235_length_2098_cov_62.733867	1042	1122	10	7	80	0.0875000
NODE_1235_length_2098_cov_62.733867	1042	1122	11	22	80	0.2750000
NODE_1235_length_2098_cov_62.733867	1042	1122	12	35	80	0.4375000
NODE_1235_length_2098_cov_62.733867	1042	1122	13	1	80	0.0125000
NODE_1235_length_2098_cov_62.733867	1042	1122	14	2	80	0.0250000
NODE_1235_length_2098_cov_62.733867	1042	1122	16	3	80	0.0375000
NODE_1235_length_2098_cov_62.733867	1042	1122	17	5	80	0.0625000
NODE_1235_length_2098_cov_62.733867	1042	1122	18	5	80	0.0625000
NODE_1235_length_2098_cov_62.733867	1095	1175	10	7	80	0.0875000
NODE_1235_length_2098_cov_62.733867	1095	1175	11	4	80	0.0500000
NODE_1235_length_2098_cov_62.733867	1095	1175	13	1	80	0.0125000
NODE_1235_length_2098_cov_62.733867	1095	1175	14	7	80	0.0875000
NODE_1235_length_2098_cov_62.733867	1095	1175	15	18	80	0.2250000
NODE_1235_length_2098_cov_62.733867	1095	1175	16	23	80	0.2875000
NODE_1235_length_2098_cov_62.733867	1095	1175	17	15	80	0.1875000
NODE_1235_length_2098_cov_62.733867	1095	1175	18	5	80	0.0625000
NODE_1235_length_2098_cov_62.733867	1171	1251	13	9	80	0.1125000
NODE_1235_length_2098_cov_62.733867	1171	1251	14	25	80	0.3125000
NODE_1235_length_2098_cov_62.733867	1171	1251	15	24	80	0.3000000
NODE_1235_length_2098_cov_62.733867	1171	1251	17	22	80	0.2750000
NODE_1235_length_2098_cov_62.733867	1224	1304	11	13	80	0.1625000
NODE_1235_length_2098_cov_62.733867	1224	1304	12	32	80	0.4000000
NODE_1235_length_2098_cov_62.733867	1224	1304	14	16	80	0.2000000
NODE_1235_length_2098_cov_62.733867	1224	1304	15	3	80	0.0375000
NODE_1235_length_2098_cov_62.733867	1224	1304	16	1	80	0.0125000
NODE_1235_length_2098_cov_62.733867	1224	1304	17	15	80	0.1875000
NODE_1236_length_2098_cov_20.220110	550	630	0	48	80	0.6000000
NODE_1236_length_2098_cov_20.220110	550	630	1	32	80	0.4000000
NODE_1236_length_2098_cov_20.220110	603	683	1	80	80	1.0000000
NODE_1236_length_2098_cov_20.220110	1571	1651	2	13	80	0.1625000
NODE_1236_length_2098_cov_20.220110	1571	1651	3	2	80	0.0250000
NODE_1236_length_2098_cov_20.220110	1571	1651	5	26	80	0.3250000
NODE_1236_length_2098_cov_20.220110	1571	1651	6	39	80	0.4875000
NODE_1236_length_2098_cov_20.220110	1624	1704	3	23	80	0.2875000
NODE_1236_length_2098_cov_20.220110	1624	1704	4	20	80	0.2500000
NODE_1236_length_2098_cov_20.220110	1624	1704	5	30	80	0.3750000
NODE_1236_length_2098_cov_20.220110	1624	1704	6	7	80	0.0875000
NODE_1237_length_2098_cov_8.261631	324	404	0	80	80	1.0000000
NODE_1239_length_2095_cov_29.930862	1128	1209	20	10	81	0.1234568
NODE_1239_length_2095_cov_29.930862	1128	1209	23	4	81	0.0493827
NODE_1239_length_2095_cov_29.930862	1128	1209	24	23	81	0.2839506
NODE_1239_length_2095_cov_29.930862	1128	1209	25	1	81	0.0123457
NODE_1239_length_2095_cov_29.930862	1128	1209	27	1	81	0.0123457
NODE_1239_length_2095_cov_29.930862	1128	1209	28	10	81	0.1234568
NODE_1239_length_2095_cov_29.930862	1128	1209	29	4	81	0.0493827
NODE_1239_length_2095_cov_29.930862	1128	1209	30	4	81	0.0493827
NODE_1239_length_2095_cov_29.930862	1128	1209	31	9	81	0.1111111
NODE_1239_length_2095_cov_29.930862	1128	1209	32	10	81	0.1234568
NODE_1239_length_2095_cov_29.930862	1128	1209	35	5	81	0.0617284
NODE_1239_length_2095_cov_29.930862	1204	1258	32	2	54	0.0370370
NODE_1239_length_2095_cov_29.930862	1204	1258	33	1	54	0.0185185
NODE_1239_length_2095_cov_29.930862	1204	1258	34	17	54	0.3148148
NODE_1239_length_2095_cov_29.930862	1204	1258	35	25	54	0.4629630
NODE_1239_length_2095_cov_29.930862	1204	1258	36	4	54	0.0740741
NODE_1239_length_2095_cov_29.930862	1204	1258	38	5	54	0.0925926
NODE_1251_length_2084_cov_1.720403	959	1039	0	80	80	1.0000000
NODE_1251_length_2084_cov_1.720403	1012	1092	0	80	80	1.0000000
NODE_1252_length_2083_cov_5.864415	419	499	3	7	80	0.0875000
NODE_1252_length_2083_cov_5.864415	419	499	4	14	80	0.1750000
NODE_1252_length_2083_cov_5.864415	419	499	5	4	80	0.0500000
NODE_1252_length_2083_cov_5.864415	419	499	6	1	80	0.0125000
NODE_1252_length_2083_cov_5.864415	419	499	7	19	80	0.2375000
NODE_1252_length_2083_cov_5.864415	419	499	9	11	80	0.1375000
NODE_1252_length_2083_cov_5.864415	419	499	10	11	80	0.1375000
NODE_1252_length_2083_cov_5.864415	419	499	11	3	80	0.0375000
NODE_1252_length_2083_cov_5.864415	419	499	14	10	80	0.1250000
NODE_1252_length_2083_cov_5.864415	472	552	9	3	80	0.0375000
NODE_1252_length_2083_cov_5.864415	472	552	10	11	80	0.1375000
NODE_1252_length_2083_cov_5.864415	472	552	11	3	80	0.0375000
NODE_1252_length_2083_cov_5.864415	472	552	14	14	80	0.1750000
NODE_1252_length_2083_cov_5.864415	472	552	15	8	80	0.1000000
NODE_1252_length_2083_cov_5.864415	472	552	16	7	80	0.0875000
NODE_1252_length_2083_cov_5.864415	472	552	17	14	80	0.1750000
NODE_1252_length_2083_cov_5.864415	472	552	18	2	80	0.0250000
NODE_1252_length_2083_cov_5.864415	472	552	20	2	80	0.0250000
NODE_1252_length_2083_cov_5.864415	472	552	22	16	80	0.2000000
NODE_1252_length_2083_cov_5.864415	548	628	16	1	80	0.0125000
NODE_1252_length_2083_cov_5.864415	548	628	17	24	80	0.3000000
NODE_1252_length_2083_cov_5.864415	548	628	18	21	80	0.2625000
NODE_1252_length_2083_cov_5.864415	548	628	19	13	80	0.1625000
NODE_1252_length_2083_cov_5.864415	548	628	21	15	80	0.1875000
NODE_1252_length_2083_cov_5.864415	548	628	22	6	80	0.0750000
NODE_1252_length_2083_cov_5.864415	601	681	13	1	80	0.0125000
NODE_1252_length_2083_cov_5.864415	601	681	14	14	80	0.1750000
NODE_1252_length_2083_cov_5.864415	601	681	15	13	80	0.1625000
NODE_1252_length_2083_cov_5.864415	601	681	16	13	80	0.1625000
NODE_1252_length_2083_cov_5.864415	601	681	17	21	80	0.2625000
NODE_1252_length_2083_cov_5.864415	601	681	18	15	80	0.1875000
NODE_1252_length_2083_cov_5.864415	601	681	19	3	80	0.0375000
NODE_1256_length_2078_cov_47.394644	311	391	0	8	80	0.1000000
NODE_1256_length_2078_cov_47.394644	311	391	2	64	80	0.8000000
NODE_1256_length_2078_cov_47.394644	311	391	3	1	80	0.0125000
NODE_1256_length_2078_cov_47.394644	311	391	4	7	80	0.0875000
NODE_1256_length_2078_cov_47.394644	364	444	0	61	80	0.7625000
NODE_1256_length_2078_cov_47.394644	364	444	2	19	80	0.2375000
NODE_1256_length_2078_cov_47.394644	440	520	0	80	80	1.0000000
NODE_1256_length_2078_cov_47.394644	493	573	0	80	80	1.0000000
NODE_1267_length_2067_cov_13.647866	1349	1429	8	13	80	0.1625000
NODE_1267_length_2067_cov_13.647866	1349	1429	9	1	80	0.0125000
NODE_1267_length_2067_cov_13.647866	1349	1429	11	6	80	0.0750000
NODE_1267_length_2067_cov_13.647866	1349	1429	14	11	80	0.1375000
NODE_1267_length_2067_cov_13.647866	1349	1429	15	10	80	0.1250000
NODE_1267_length_2067_cov_13.647866	1349	1429	16	4	80	0.0500000
NODE_1267_length_2067_cov_13.647866	1349	1429	17	1	80	0.0125000
NODE_1267_length_2067_cov_13.647866	1349	1429	18	21	80	0.2625000
NODE_1267_length_2067_cov_13.647866	1349	1429	19	13	80	0.1625000
NODE_1267_length_2067_cov_13.647866	1402	1482	12	11	80	0.1375000
NODE_1267_length_2067_cov_13.647866	1402	1482	14	13	80	0.1625000
NODE_1267_length_2067_cov_13.647866	1402	1482	15	2	80	0.0250000
NODE_1267_length_2067_cov_13.647866	1402	1482	16	16	80	0.2000000
NODE_1267_length_2067_cov_13.647866	1402	1482	17	13	80	0.1625000
NODE_1267_length_2067_cov_13.647866	1402	1482	18	12	80	0.1500000
NODE_1267_length_2067_cov_13.647866	1402	1482	19	13	80	0.1625000
NODE_1269_length_2066_cov_19.127605	1497	1577	6	27	80	0.3375000
NODE_1269_length_2066_cov_19.127605	1497	1577	7	2	80	0.0250000
NODE_1269_length_2066_cov_19.127605	1497	1577	8	18	80	0.2250000
NODE_1269_length_2066_cov_19.127605	1497	1577	9	1	80	0.0125000
NODE_1269_length_2066_cov_19.127605	1497	1577	11	3	80	0.0375000
NODE_1269_length_2066_cov_19.127605	1497	1577	12	3	80	0.0375000
NODE_1269_length_2066_cov_19.127605	1497	1577	15	26	80	0.3250000
NODE_1269_length_2066_cov_19.127605	1550	1630	11	3	80	0.0375000
NODE_1269_length_2066_cov_19.127605	1550	1630	12	24	80	0.3000000
NODE_1269_length_2066_cov_19.127605	1550	1630	13	24	80	0.3000000
NODE_1269_length_2066_cov_19.127605	1550	1630	15	29	80	0.3625000
NODE_1274_length_2061_cov_43.187054	364	444	4	1	80	0.0125000
NODE_1274_length_2061_cov_43.187054	364	444	5	57	80	0.7125000
NODE_1274_length_2061_cov_43.187054	364	444	6	22	80	0.2750000
NODE_1274_length_2061_cov_43.187054	417	497	2	16	80	0.2000000
NODE_1274_length_2061_cov_43.187054	417	497	4	38	80	0.4750000
NODE_1274_length_2061_cov_43.187054	417	497	5	26	80	0.3250000
NODE_1275_length_2061_cov_3.251784	981	1033	1	52	52	1.0000000
NODE_1275_length_2061_cov_3.251784	1006	1086	1	35	80	0.4375000
NODE_1275_length_2061_cov_3.251784	1006	1086	2	13	80	0.1625000
NODE_1275_length_2061_cov_3.251784	1006	1086	3	1	80	0.0125000
NODE_1275_length_2061_cov_3.251784	1006	1086	6	12	80	0.1500000
NODE_1275_length_2061_cov_3.251784	1006	1086	8	19	80	0.2375000
NODE_1277_length_2058_cov_4.531394	1844	1875	0	4	31	0.1290323
NODE_1277_length_2058_cov_4.531394	1844	1875	2	27	31	0.8709677
NODE_1277_length_2058_cov_4.531394	1848	1928	2	80	80	1.0000000
NODE_1279_length_2056_cov_20.525805	749	829	4	4	80	0.0500000
NODE_1279_length_2056_cov_20.525805	749	829	8	2	80	0.0250000
NODE_1279_length_2056_cov_20.525805	749	829	9	21	80	0.2625000
NODE_1279_length_2056_cov_20.525805	749	829	10	13	80	0.1625000
NODE_1279_length_2056_cov_20.525805	749	829	11	17	80	0.2125000
NODE_1279_length_2056_cov_20.525805	749	829	12	1	80	0.0125000
NODE_1279_length_2056_cov_20.525805	749	829	13	10	80	0.1250000
NODE_1279_length_2056_cov_20.525805	749	829	14	5	80	0.0625000
NODE_1279_length_2056_cov_20.525805	749	829	16	7	80	0.0875000
NODE_1279_length_2056_cov_20.525805	802	882	11	4	80	0.0500000
NODE_1279_length_2056_cov_20.525805	802	882	12	1	80	0.0125000
NODE_1279_length_2056_cov_20.525805	802	882	13	10	80	0.1250000
NODE_1279_length_2056_cov_20.525805	802	882	14	5	80	0.0625000
NODE_1279_length_2056_cov_20.525805	802	882	16	21	80	0.2625000
NODE_1279_length_2056_cov_20.525805	802	882	18	16	80	0.2000000
NODE_1279_length_2056_cov_20.525805	802	882	19	16	80	0.2000000
NODE_1279_length_2056_cov_20.525805	802	882	20	7	80	0.0875000
NODE_1279_length_2056_cov_20.525805	878	958	19	10	80	0.1250000
NODE_1279_length_2056_cov_20.525805	878	958	20	2	80	0.0250000
NODE_1279_length_2056_cov_20.525805	878	958	21	37	80	0.4625000
NODE_1279_length_2056_cov_20.525805	878	958	22	10	80	0.1250000
NODE_1279_length_2056_cov_20.525805	878	958	23	20	80	0.2500000
NODE_1279_length_2056_cov_20.525805	878	958	24	1	80	0.0125000
NODE_1279_length_2056_cov_20.525805	931	1011	16	20	80	0.2500000
NODE_1279_length_2056_cov_20.525805	931	1011	18	1	80	0.0125000
NODE_1279_length_2056_cov_20.525805	931	1011	19	8	80	0.1000000
NODE_1279_length_2056_cov_20.525805	931	1011	20	19	80	0.2375000
NODE_1279_length_2056_cov_20.525805	931	1011	21	19	80	0.2375000
NODE_1279_length_2056_cov_20.525805	931	1011	22	13	80	0.1625000
NODE_1281_length_2055_cov_10.047546	1468	1548	3	5	80	0.0625000
NODE_1281_length_2055_cov_10.047546	1468	1548	8	8	80	0.1000000
NODE_1281_length_2055_cov_10.047546	1468	1548	10	58	80	0.7250000
NODE_1281_length_2055_cov_10.047546	1468	1548	11	9	80	0.1125000
NODE_1281_length_2055_cov_10.047546	1521	1601	1	10	80	0.1250000
NODE_1281_length_2055_cov_10.047546	1521	1601	3	48	80	0.6000000
NODE_1281_length_2055_cov_10.047546	1521	1601	8	8	80	0.1000000
NODE_1281_length_2055_cov_10.047546	1521	1601	10	14	80	0.1750000
NODE_1286_length_2049_cov_6.846154	270	350	0	24	80	0.3000000
NODE_1286_length_2049_cov_6.846154	270	350	1	56	80	0.7000000
NODE_1286_length_2049_cov_6.846154	323	403	1	80	80	1.0000000
NODE_1286_length_2049_cov_6.846154	1595	1674	6	29	79	0.3670886
NODE_1286_length_2049_cov_6.846154	1595	1674	7	50	79	0.6329114
NODE_1286_length_2049_cov_6.846154	1648	1712	6	1	64	0.0156250
NODE_1286_length_2049_cov_6.846154	1648	1712	7	63	64	0.9843750
NODE_1293_length_2045_cov_46.790339	876	956	22	8	80	0.1000000
NODE_1293_length_2045_cov_46.790339	876	956	23	1	80	0.0125000
NODE_1293_length_2045_cov_46.790339	876	956	24	1	80	0.0125000
NODE_1293_length_2045_cov_46.790339	876	956	25	9	80	0.1125000
NODE_1293_length_2045_cov_46.790339	876	956	26	1	80	0.0125000
NODE_1293_length_2045_cov_46.790339	876	956	27	11	80	0.1375000
NODE_1293_length_2045_cov_46.790339	876	956	28	9	80	0.1125000
NODE_1293_length_2045_cov_46.790339	876	956	29	25	80	0.3125000
NODE_1293_length_2045_cov_46.790339	876	956	30	10	80	0.1250000
NODE_1293_length_2045_cov_46.790339	876	956	31	3	80	0.0375000
NODE_1293_length_2045_cov_46.790339	876	956	32	2	80	0.0250000
NODE_1293_length_2045_cov_46.790339	929	1009	27	5	80	0.0625000
NODE_1293_length_2045_cov_46.790339	929	1009	29	24	80	0.3000000
NODE_1293_length_2045_cov_46.790339	929	1009	30	44	80	0.5500000
NODE_1293_length_2045_cov_46.790339	929	1009	31	4	80	0.0500000
NODE_1293_length_2045_cov_46.790339	929	1009	32	3	80	0.0375000
NODE_1293_length_2045_cov_46.790339	1005	1085	9	12	80	0.1500000
NODE_1293_length_2045_cov_46.790339	1005	1085	11	3	80	0.0375000
NODE_1293_length_2045_cov_46.790339	1005	1085	13	15	80	0.1875000
NODE_1293_length_2045_cov_46.790339	1005	1085	15	9	80	0.1125000
NODE_1293_length_2045_cov_46.790339	1005	1085	16	2	80	0.0250000
NODE_1293_length_2045_cov_46.790339	1005	1085	17	3	80	0.0375000
NODE_1293_length_2045_cov_46.790339	1005	1085	18	4	80	0.0500000
NODE_1293_length_2045_cov_46.790339	1005	1085	20	2	80	0.0250000
NODE_1293_length_2045_cov_46.790339	1005	1085	23	5	80	0.0625000
NODE_1293_length_2045_cov_46.790339	1005	1085	24	4	80	0.0500000
NODE_1293_length_2045_cov_46.790339	1005	1085	26	6	80	0.0750000
NODE_1293_length_2045_cov_46.790339	1005	1085	27	10	80	0.1250000
NODE_1293_length_2045_cov_46.790339	1005	1085	29	5	80	0.0625000
NODE_1293_length_2045_cov_46.790339	1058	1138	0	24	80	0.3000000
NODE_1293_length_2045_cov_46.790339	1058	1138	3	9	80	0.1125000
NODE_1293_length_2045_cov_46.790339	1058	1138	4	6	80	0.0750000
NODE_1293_length_2045_cov_46.790339	1058	1138	5	9	80	0.1125000
NODE_1293_length_2045_cov_46.790339	1058	1138	6	3	80	0.0375000
NODE_1293_length_2045_cov_46.790339	1058	1138	9	14	80	0.1750000
NODE_1293_length_2045_cov_46.790339	1058	1138	11	3	80	0.0375000
NODE_1293_length_2045_cov_46.790339	1058	1138	13	12	80	0.1500000
NODE_1298_length_2042_cov_4.447761	241	315	0	74	74	1.0000000
NODE_1301_length_2040_cov_30.109737	1760	1844	25	1	84	0.0119048
NODE_1301_length_2040_cov_30.109737	1760	1844	26	12	84	0.1428571
NODE_1301_length_2040_cov_30.109737	1760	1844	27	7	84	0.0833333
NODE_1301_length_2040_cov_30.109737	1760	1844	28	20	84	0.2380952
NODE_1301_length_2040_cov_30.109737	1760	1844	29	35	84	0.4166667
NODE_1301_length_2040_cov_30.109737	1760	1844	30	5	84	0.0595238
NODE_1301_length_2040_cov_30.109737	1760	1844	31	4	84	0.0476190
NODE_1306_length_2036_cov_11.672173	369	449	0	1	80	0.0125000
NODE_1306_length_2036_cov_11.672173	369	449	2	47	80	0.5875000
NODE_1306_length_2036_cov_11.672173	369	449	3	14	80	0.1750000
NODE_1306_length_2036_cov_11.672173	369	449	4	18	80	0.2250000
NODE_1306_length_2036_cov_11.672173	422	502	3	9	80	0.1125000
NODE_1306_length_2036_cov_11.672173	422	502	4	56	80	0.7000000
NODE_1306_length_2036_cov_11.672173	422	502	5	15	80	0.1875000
NODE_1312_length_2032_cov_11.188308	416	496	9	40	80	0.5000000
NODE_1312_length_2032_cov_11.188308	416	496	10	8	80	0.1000000
NODE_1312_length_2032_cov_11.188308	416	496	11	13	80	0.1625000
NODE_1312_length_2032_cov_11.188308	416	496	12	19	80	0.2375000
NODE_1312_length_2032_cov_11.188308	469	549	6	29	80	0.3625000
NODE_1312_length_2032_cov_11.188308	469	549	7	8	80	0.1000000
NODE_1312_length_2032_cov_11.188308	469	549	9	43	80	0.5375000
NODE_1318_length_2027_cov_43.702282	1129	1209	14	8	80	0.1000000
NODE_1318_length_2027_cov_43.702282	1129	1209	15	3	80	0.0375000
NODE_1318_length_2027_cov_43.702282	1129	1209	16	2	80	0.0250000
NODE_1318_length_2027_cov_43.702282	1129	1209	17	3	80	0.0375000
NODE_1318_length_2027_cov_43.702282	1129	1209	18	3	80	0.0375000
NODE_1318_length_2027_cov_43.702282	1129	1209	19	10	80	0.1250000
NODE_1318_length_2027_cov_43.702282	1129	1209	23	15	80	0.1875000
NODE_1318_length_2027_cov_43.702282	1129	1209	24	7	80	0.0875000
NODE_1318_length_2027_cov_43.702282	1129	1209	25	3	80	0.0375000
NODE_1318_length_2027_cov_43.702282	1129	1209	26	26	80	0.3250000
NODE_1318_length_2027_cov_43.702282	1182	1262	24	4	80	0.0500000
NODE_1318_length_2027_cov_43.702282	1182	1262	25	2	80	0.0250000
NODE_1318_length_2027_cov_43.702282	1182	1262	26	24	80	0.3000000
NODE_1318_length_2027_cov_43.702282	1182	1262	27	8	80	0.1000000
NODE_1318_length_2027_cov_43.702282	1182	1262	28	14	80	0.1750000
NODE_1318_length_2027_cov_43.702282	1182	1262	29	22	80	0.2750000
NODE_1318_length_2027_cov_43.702282	1182	1262	31	3	80	0.0375000
NODE_1318_length_2027_cov_43.702282	1182	1262	32	3	80	0.0375000
NODE_1318_length_2027_cov_43.702282	1258	1338	29	18	80	0.2250000
NODE_1318_length_2027_cov_43.702282	1258	1338	30	4	80	0.0500000
NODE_1318_length_2027_cov_43.702282	1258	1338	31	7	80	0.0875000
NODE_1318_length_2027_cov_43.702282	1258	1338	32	2	80	0.0250000
NODE_1318_length_2027_cov_43.702282	1258	1338	33	10	80	0.1250000
NODE_1318_length_2027_cov_43.702282	1258	1338	34	1	80	0.0125000
NODE_1318_length_2027_cov_43.702282	1258	1338	35	10	80	0.1250000
NODE_1318_length_2027_cov_43.702282	1258	1338	36	6	80	0.0750000
NODE_1318_length_2027_cov_43.702282	1258	1338	37	7	80	0.0875000
NODE_1318_length_2027_cov_43.702282	1258	1338	38	15	80	0.1875000
NODE_1318_length_2027_cov_43.702282	1311	1391	26	6	80	0.0750000
NODE_1318_length_2027_cov_43.702282	1311	1391	27	5	80	0.0625000
NODE_1318_length_2027_cov_43.702282	1311	1391	28	2	80	0.0250000
NODE_1318_length_2027_cov_43.702282	1311	1391	29	2	80	0.0250000
NODE_1318_length_2027_cov_43.702282	1311	1391	30	14	80	0.1750000
NODE_1318_length_2027_cov_43.702282	1311	1391	33	5	80	0.0625000
NODE_1318_length_2027_cov_43.702282	1311	1391	34	4	80	0.0500000
NODE_1318_length_2027_cov_43.702282	1311	1391	35	23	80	0.2875000
NODE_1318_length_2027_cov_43.702282	1311	1391	36	2	80	0.0250000
NODE_1318_length_2027_cov_43.702282	1311	1391	37	2	80	0.0250000
NODE_1318_length_2027_cov_43.702282	1311	1391	38	15	80	0.1875000
NODE_1319_length_2027_cov_6.558610	229	303	0	74	74	1.0000000
NODE_1319_length_2027_cov_6.558610	229	303	0	74	74	1.0000000
NODE_1319_length_2027_cov_6.558610	276	356	0	80	80	1.0000000
NODE_1320_length_2026_cov_18.457706	688	768	3	11	80	0.1375000
NODE_1320_length_2026_cov_18.457706	688	768	4	14	80	0.1750000
NODE_1320_length_2026_cov_18.457706	688	768	5	10	80	0.1250000
NODE_1320_length_2026_cov_18.457706	688	768	6	2	80	0.0250000
NODE_1320_length_2026_cov_18.457706	688	768	7	13	80	0.1625000
NODE_1320_length_2026_cov_18.457706	688	768	8	30	80	0.3750000
NODE_1320_length_2026_cov_18.457706	741	821	6	11	80	0.1375000
NODE_1320_length_2026_cov_18.457706	741	821	7	20	80	0.2500000
NODE_1320_length_2026_cov_18.457706	741	821	8	49	80	0.6125000
NODE_1324_length_2025_cov_10.711319	617	697	3	58	80	0.7250000
NODE_1324_length_2025_cov_10.711319	617	697	4	21	80	0.2625000
NODE_1324_length_2025_cov_10.711319	617	697	5	1	80	0.0125000
NODE_1324_length_2025_cov_10.711319	712	783	7	18	71	0.2535211
NODE_1324_length_2025_cov_10.711319	712	783	8	37	71	0.5211267
NODE_1324_length_2025_cov_10.711319	712	783	9	7	71	0.0985916
NODE_1324_length_2025_cov_10.711319	712	783	10	9	71	0.1267606
NODE_1324_length_2025_cov_10.711319	756	829	6	4	73	0.0547945
NODE_1324_length_2025_cov_10.711319	756	829	7	60	73	0.8219178
NODE_1324_length_2025_cov_10.711319	756	829	8	2	73	0.0273973
NODE_1324_length_2025_cov_10.711319	756	829	9	7	73	0.0958904
NODE_1325_length_2024_cov_33.891948	1045	1125	16	14	80	0.1750000
NODE_1325_length_2024_cov_33.891948	1045	1125	17	16	80	0.2000000
NODE_1325_length_2024_cov_33.891948	1045	1125	18	2	80	0.0250000
NODE_1325_length_2024_cov_33.891948	1045	1125	19	25	80	0.3125000
NODE_1325_length_2024_cov_33.891948	1045	1125	20	15	80	0.1875000
NODE_1325_length_2024_cov_33.891948	1045	1125	21	8	80	0.1000000
NODE_1325_length_2024_cov_33.891948	1098	1178	5	3	80	0.0375000
NODE_1325_length_2024_cov_33.891948	1098	1178	6	9	80	0.1125000
NODE_1325_length_2024_cov_33.891948	1098	1178	7	4	80	0.0500000
NODE_1325_length_2024_cov_33.891948	1098	1178	8	7	80	0.0875000
NODE_1325_length_2024_cov_33.891948	1098	1178	9	5	80	0.0625000
NODE_1325_length_2024_cov_33.891948	1098	1178	10	4	80	0.0500000
NODE_1325_length_2024_cov_33.891948	1098	1178	13	2	80	0.0250000
NODE_1325_length_2024_cov_33.891948	1098	1178	14	3	80	0.0375000
NODE_1325_length_2024_cov_33.891948	1098	1178	15	3	80	0.0375000
NODE_1325_length_2024_cov_33.891948	1098	1178	16	1	80	0.0125000
NODE_1325_length_2024_cov_33.891948	1098	1178	17	16	80	0.2000000
NODE_1325_length_2024_cov_33.891948	1098	1178	18	1	80	0.0125000
NODE_1325_length_2024_cov_33.891948	1098	1178	19	22	80	0.2750000
NODE_1331_length_2018_cov_33.742053	1215	1295	12	1	80	0.0125000
NODE_1331_length_2018_cov_33.742053	1215	1295	14	4	80	0.0500000
NODE_1331_length_2018_cov_33.742053	1215	1295	15	10	80	0.1250000
NODE_1331_length_2018_cov_33.742053	1215	1295	16	26	80	0.3250000
NODE_1331_length_2018_cov_33.742053	1215	1295	17	39	80	0.4875000
NODE_1331_length_2018_cov_33.742053	1268	1298	15	2	30	0.0666667
NODE_1331_length_2018_cov_33.742053	1268	1298	16	8	30	0.2666667
NODE_1331_length_2018_cov_33.742053	1268	1298	17	20	30	0.6666667
NODE_1331_length_2018_cov_33.742053	1876	1942	10	19	66	0.2878788
NODE_1331_length_2018_cov_33.742053	1876	1942	11	47	66	0.7121212
NODE_1331_length_2018_cov_33.742053	1915	1995	0	4	80	0.0500000
NODE_1331_length_2018_cov_33.742053	1915	1995	4	6	80	0.0750000
NODE_1331_length_2018_cov_33.742053	1915	1995	6	7	80	0.0875000
NODE_1331_length_2018_cov_33.742053	1915	1995	11	63	80	0.7875000
NODE_1337_length_2011_cov_22.430439	434	514	0	80	80	1.0000000
NODE_1337_length_2011_cov_22.430439	487	567	0	80	80	1.0000000
NODE_1337_length_2011_cov_22.430439	1124	1204	8	32	80	0.4000000
NODE_1337_length_2011_cov_22.430439	1124	1204	9	1	80	0.0125000
NODE_1337_length_2011_cov_22.430439	1124	1204	10	14	80	0.1750000
NODE_1337_length_2011_cov_22.430439	1124	1204	12	2	80	0.0250000
NODE_1337_length_2011_cov_22.430439	1124	1204	14	10	80	0.1250000
NODE_1337_length_2011_cov_22.430439	1124	1204	16	17	80	0.2125000
NODE_1337_length_2011_cov_22.430439	1124	1204	17	4	80	0.0500000
NODE_1337_length_2011_cov_22.430439	1177	1257	12	4	80	0.0500000
NODE_1337_length_2011_cov_22.430439	1177	1257	14	9	80	0.1125000
NODE_1337_length_2011_cov_22.430439	1177	1257	16	29	80	0.3625000
NODE_1337_length_2011_cov_22.430439	1177	1257	17	24	80	0.3000000
NODE_1337_length_2011_cov_22.430439	1177	1257	18	12	80	0.1500000
NODE_1337_length_2011_cov_22.430439	1177	1257	19	2	80	0.0250000
NODE_1343_length_2001_cov_10.416404	692	772	8	16	80	0.2000000
NODE_1343_length_2001_cov_10.416404	692	772	9	7	80	0.0875000
NODE_1343_length_2001_cov_10.416404	692	772	10	17	80	0.2125000
NODE_1343_length_2001_cov_10.416404	692	772	12	13	80	0.1625000
NODE_1343_length_2001_cov_10.416404	692	772	13	9	80	0.1125000
NODE_1343_length_2001_cov_10.416404	692	772	14	1	80	0.0125000
NODE_1343_length_2001_cov_10.416404	692	772	18	6	80	0.0750000
NODE_1343_length_2001_cov_10.416404	692	772	19	8	80	0.1000000
NODE_1343_length_2001_cov_10.416404	692	772	20	3	80	0.0375000
NODE_1343_length_2001_cov_10.416404	745	825	12	9	80	0.1125000
NODE_1343_length_2001_cov_10.416404	745	825	14	1	80	0.0125000
NODE_1343_length_2001_cov_10.416404	745	825	17	1	80	0.0125000
NODE_1343_length_2001_cov_10.416404	745	825	18	8	80	0.1000000
NODE_1343_length_2001_cov_10.416404	745	825	19	9	80	0.1125000
NODE_1343_length_2001_cov_10.416404	745	825	20	18	80	0.2250000
NODE_1343_length_2001_cov_10.416404	745	825	21	34	80	0.4250000
NODE_1350_length_1991_cov_112.926533	212	292	141	1	80	0.0125000
NODE_1350_length_1991_cov_112.926533	212	292	143	3	80	0.0375000
NODE_1350_length_1991_cov_112.926533	212	292	147	2	80	0.0250000
NODE_1350_length_1991_cov_112.926533	212	292	149	1	80	0.0125000
NODE_1350_length_1991_cov_112.926533	212	292	150	1	80	0.0125000
NODE_1350_length_1991_cov_112.926533	212	292	151	2	80	0.0250000
NODE_1350_length_1991_cov_112.926533	212	292	152	1	80	0.0125000
NODE_1350_length_1991_cov_112.926533	212	292	153	1	80	0.0125000
NODE_1350_length_1991_cov_112.926533	212	292	154	1	80	0.0125000
NODE_1350_length_1991_cov_112.926533	212	292	155	3	80	0.0375000
NODE_1350_length_1991_cov_112.926533	212	292	157	5	80	0.0625000
NODE_1350_length_1991_cov_112.926533	212	292	158	1	80	0.0125000
NODE_1350_length_1991_cov_112.926533	212	292	161	1	80	0.0125000
NODE_1350_length_1991_cov_112.926533	212	292	162	1	80	0.0125000
NODE_1350_length_1991_cov_112.926533	212	292	164	1	80	0.0125000
NODE_1350_length_1991_cov_112.926533	212	292	166	1	80	0.0125000
NODE_1350_length_1991_cov_112.926533	212	292	167	3	80	0.0375000
NODE_1350_length_1991_cov_112.926533	212	292	168	2	80	0.0250000
NODE_1350_length_1991_cov_112.926533	212	292	169	2	80	0.0250000
NODE_1350_length_1991_cov_112.926533	212	292	170	1	80	0.0125000
NODE_1350_length_1991_cov_112.926533	212	292	171	1	80	0.0125000
NODE_1350_length_1991_cov_112.926533	212	292	174	3	80	0.0375000
NODE_1350_length_1991_cov_112.926533	212	292	175	2	80	0.0250000
NODE_1350_length_1991_cov_112.926533	212	292	176	2	80	0.0250000
NODE_1350_length_1991_cov_112.926533	212	292	177	5	80	0.0625000
NODE_1350_length_1991_cov_112.926533	212	292	178	5	80	0.0625000
NODE_1350_length_1991_cov_112.926533	212	292	179	2	80	0.0250000
NODE_1350_length_1991_cov_112.926533	212	292	180	6	80	0.0750000
NODE_1350_length_1991_cov_112.926533	212	292	181	15	80	0.1875000
NODE_1350_length_1991_cov_112.926533	212	292	182	2	80	0.0250000
NODE_1350_length_1991_cov_112.926533	212	292	183	1	80	0.0125000
NODE_1350_length_1991_cov_112.926533	212	292	184	1	80	0.0125000
NODE_1350_length_1991_cov_112.926533	212	292	185	1	80	0.0125000
NODE_1352_length_1988_cov_13.736368	865	945	6	19	80	0.2375000
NODE_1352_length_1988_cov_13.736368	865	945	8	23	80	0.2875000
NODE_1352_length_1988_cov_13.736368	865	945	9	15	80	0.1875000
NODE_1352_length_1988_cov_13.736368	865	945	10	23	80	0.2875000
NODE_1352_length_1988_cov_13.736368	918	998	6	25	80	0.3125000
NODE_1352_length_1988_cov_13.736368	918	998	7	13	80	0.1625000
NODE_1352_length_1988_cov_13.736368	918	998	8	19	80	0.2375000
NODE_1352_length_1988_cov_13.736368	918	998	9	23	80	0.2875000
NODE_1353_length_1988_cov_9.980413	1616	1696	5	8	80	0.1000000
NODE_1353_length_1988_cov_9.980413	1616	1696	6	31	80	0.3875000
NODE_1353_length_1988_cov_9.980413	1616	1696	7	41	80	0.5125000
NODE_1353_length_1988_cov_9.980413	1669	1749	3	1	80	0.0125000
NODE_1353_length_1988_cov_9.980413	1669	1749	4	14	80	0.1750000
NODE_1353_length_1988_cov_9.980413	1669	1749	5	46	80	0.5750000
NODE_1353_length_1988_cov_9.980413	1669	1749	6	11	80	0.1375000
NODE_1353_length_1988_cov_9.980413	1669	1749	7	8	80	0.1000000
NODE_1356_length_1983_cov_17.332803	494	574	0	15	80	0.1875000
NODE_1356_length_1983_cov_17.332803	494	574	2	65	80	0.8125000
NODE_1356_length_1983_cov_17.332803	547	627	2	80	80	1.0000000
NODE_1356_length_1983_cov_17.332803	1600	1680	2	16	80	0.2000000
NODE_1356_length_1983_cov_17.332803	1600	1680	4	64	80	0.8000000
NODE_1356_length_1983_cov_17.332803	1653	1733	0	17	80	0.2125000
NODE_1356_length_1983_cov_17.332803	1653	1733	2	52	80	0.6500000
NODE_1356_length_1983_cov_17.332803	1653	1733	4	11	80	0.1375000
NODE_1359_length_1982_cov_17.164100	457	537	0	80	80	1.0000000
NODE_1359_length_1982_cov_17.164100	510	590	0	80	80	1.0000000
NODE_1359_length_1982_cov_17.164100	586	666	0	80	80	1.0000000
NODE_1359_length_1982_cov_17.164100	639	723	0	84	84	1.0000000
NODE_1360_length_1981_cov_46.444208	0	70	0	24	70	0.3428572
NODE_1360_length_1981_cov_46.444208	0	70	2	46	70	0.6571429
NODE_1362_length_1979_cov_1.630851	1554	1634	0	80	80	1.0000000
NODE_1364_length_1976_cov_1.959510	154	215	4	50	61	0.8196721
NODE_1364_length_1976_cov_1.959510	154	215	5	11	61	0.1803279
NODE_1364_length_1976_cov_1.959510	154	215	4	50	61	0.8196721
NODE_1364_length_1976_cov_1.959510	154	215	5	11	61	0.1803279
NODE_1364_length_1976_cov_1.959510	154	213	4	48	59	0.8135593
NODE_1364_length_1976_cov_1.959510	154	213	5	11	59	0.1864407
NODE_1365_length_1974_cov_8.058133	617	697	4	80	80	1.0000000
NODE_1365_length_1974_cov_8.058133	670	750	1	7	80	0.0875000
NODE_1365_length_1974_cov_8.058133	670	750	2	17	80	0.2125000
NODE_1365_length_1974_cov_8.058133	670	750	3	22	80	0.2750000
NODE_1365_length_1974_cov_8.058133	670	750	4	34	80	0.4250000
NODE_1366_length_1973_cov_14.885272	640	726	1	69	86	0.8023256
NODE_1366_length_1973_cov_14.885272	640	726	2	17	86	0.1976744
NODE_1366_length_1973_cov_14.885272	699	779	1	29	80	0.3625000
NODE_1366_length_1973_cov_14.885272	699	779	2	51	80	0.6375000
NODE_1366_length_1973_cov_14.885272	1389	1469	4	8	80	0.1000000
NODE_1366_length_1973_cov_14.885272	1389	1469	5	3	80	0.0375000
NODE_1366_length_1973_cov_14.885272	1389	1469	6	33	80	0.4125000
NODE_1366_length_1973_cov_14.885272	1389	1469	9	10	80	0.1250000
NODE_1366_length_1973_cov_14.885272	1389	1469	12	26	80	0.3250000
NODE_1366_length_1973_cov_14.885272	1442	1522	1	8	80	0.1000000
NODE_1366_length_1973_cov_14.885272	1442	1522	2	27	80	0.3375000
NODE_1366_length_1973_cov_14.885272	1442	1522	4	26	80	0.3250000
NODE_1366_length_1973_cov_14.885272	1442	1522	5	3	80	0.0375000
NODE_1366_length_1973_cov_14.885272	1442	1522	6	16	80	0.2000000
NODE_1372_length_1971_cov_3.126068	1662	1742	0	80	80	1.0000000
NODE_1372_length_1971_cov_3.126068	1715	1799	0	84	84	1.0000000
NODE_1386_length_1962_cov_23.774557	281	311	1	30	30	1.0000000
NODE_1386_length_1962_cov_23.774557	329	355	1	26	26	1.0000000
NODE_1386_length_1962_cov_23.774557	408	487	2	4	79	0.0506329
NODE_1386_length_1962_cov_23.774557	408	487	3	5	79	0.0632911
NODE_1386_length_1962_cov_23.774557	408	487	4	70	79	0.8860760
NODE_1386_length_1962_cov_23.774557	460	540	2	11	80	0.1375000
NODE_1386_length_1962_cov_23.774557	460	540	3	8	80	0.1000000
NODE_1386_length_1962_cov_23.774557	460	540	4	61	80	0.7625000
NODE_1386_length_1962_cov_23.774557	1417	1497	2	25	80	0.3125000
NODE_1386_length_1962_cov_23.774557	1417	1497	3	22	80	0.2750000
NODE_1386_length_1962_cov_23.774557	1417	1497	4	33	80	0.4125000
NODE_1386_length_1962_cov_23.774557	1470	1550	4	77	80	0.9625000
NODE_1386_length_1962_cov_23.774557	1470	1550	5	3	80	0.0375000
NODE_1386_length_1962_cov_23.774557	1607	1640	1	26	33	0.7878788
NODE_1386_length_1962_cov_23.774557	1607	1640	2	7	33	0.2121212
NODE_1395_length_1953_cov_26.183927	1	81	0	14	80	0.1750000
NODE_1395_length_1953_cov_26.183927	1	81	1	66	80	0.8250000
NODE_1395_length_1953_cov_26.183927	6	28	0	9	22	0.4090909
NODE_1395_length_1953_cov_26.183927	6	28	1	13	22	0.5909091
NODE_1395_length_1953_cov_26.183927	152	232	1	67	80	0.8375000
NODE_1395_length_1953_cov_26.183927	152	232	2	13	80	0.1625000
NODE_1395_length_1953_cov_26.183927	205	257	1	52	52	1.0000000
NODE_1405_length_1943_cov_11.218547	516	596	0	80	80	1.0000000
NODE_1405_length_1943_cov_11.218547	569	649	0	80	80	1.0000000
NODE_1408_length_1941_cov_14.407709	891	921	4	30	30	1.0000000
NODE_1408_length_1941_cov_14.407709	894	964	1	7	70	0.1000000
NODE_1408_length_1941_cov_14.407709	894	964	2	31	70	0.4428571
NODE_1408_length_1941_cov_14.407709	894	964	3	5	70	0.0714286
NODE_1408_length_1941_cov_14.407709	894	964	4	27	70	0.3857143
NODE_1408_length_1941_cov_14.407709	1878	1941	0	63	63	1.0000000
NODE_1409_length_1941_cov_9.632465	139	213	12	8	74	0.1081081
NODE_1409_length_1941_cov_9.632465	139	213	13	5	74	0.0675676
NODE_1409_length_1941_cov_9.632465	139	213	14	5	74	0.0675676
NODE_1409_length_1941_cov_9.632465	139	213	16	4	74	0.0540541
NODE_1409_length_1941_cov_9.632465	139	213	17	2	74	0.0270270
NODE_1409_length_1941_cov_9.632465	139	213	19	2	74	0.0270270
NODE_1409_length_1941_cov_9.632465	139	213	22	8	74	0.1081081
NODE_1409_length_1941_cov_9.632465	139	213	23	20	74	0.2702703
NODE_1409_length_1941_cov_9.632465	139	213	26	3	74	0.0405405
NODE_1409_length_1941_cov_9.632465	139	213	27	4	74	0.0540541
NODE_1409_length_1941_cov_9.632465	139	213	29	2	74	0.0270270
NODE_1409_length_1941_cov_9.632465	139	213	31	11	74	0.1486486
NODE_1409_length_1941_cov_9.632465	139	219	12	8	80	0.1000000
NODE_1409_length_1941_cov_9.632465	139	219	13	5	80	0.0625000
NODE_1409_length_1941_cov_9.632465	139	219	14	5	80	0.0625000
NODE_1409_length_1941_cov_9.632465	139	219	16	4	80	0.0500000
NODE_1409_length_1941_cov_9.632465	139	219	17	2	80	0.0250000
NODE_1409_length_1941_cov_9.632465	139	219	19	2	80	0.0250000
NODE_1409_length_1941_cov_9.632465	139	219	22	8	80	0.1000000
NODE_1409_length_1941_cov_9.632465	139	219	23	20	80	0.2500000
NODE_1409_length_1941_cov_9.632465	139	219	26	3	80	0.0375000
NODE_1409_length_1941_cov_9.632465	139	219	27	4	80	0.0500000
NODE_1409_length_1941_cov_9.632465	139	219	29	2	80	0.0250000
NODE_1409_length_1941_cov_9.632465	139	219	31	12	80	0.1500000
NODE_1409_length_1941_cov_9.632465	139	219	32	1	80	0.0125000
NODE_1409_length_1941_cov_9.632465	139	219	34	4	80	0.0500000
NODE_1409_length_1941_cov_9.632465	139	194	12	8	55	0.1454545
NODE_1409_length_1941_cov_9.632465	139	194	13	5	55	0.0909091
NODE_1409_length_1941_cov_9.632465	139	194	14	5	55	0.0909091
NODE_1409_length_1941_cov_9.632465	139	194	16	4	55	0.0727273
NODE_1409_length_1941_cov_9.632465	139	194	17	2	55	0.0363636
NODE_1409_length_1941_cov_9.632465	139	194	19	2	55	0.0363636
NODE_1409_length_1941_cov_9.632465	139	194	22	8	55	0.1454545
NODE_1409_length_1941_cov_9.632465	139	194	23	20	55	0.3636364
NODE_1409_length_1941_cov_9.632465	139	194	26	1	55	0.0181818
NODE_1409_length_1941_cov_9.632465	192	272	23	1	80	0.0125000
NODE_1409_length_1941_cov_9.632465	192	272	26	3	80	0.0375000
NODE_1409_length_1941_cov_9.632465	192	272	27	4	80	0.0500000
NODE_1409_length_1941_cov_9.632465	192	272	29	3	80	0.0375000
NODE_1409_length_1941_cov_9.632465	192	272	31	12	80	0.1500000
NODE_1409_length_1941_cov_9.632465	192	272	32	5	80	0.0625000
NODE_1409_length_1941_cov_9.632465	192	272	33	2	80	0.0250000
NODE_1409_length_1941_cov_9.632465	192	272	34	11	80	0.1375000
NODE_1409_length_1941_cov_9.632465	192	272	35	1	80	0.0125000
NODE_1409_length_1941_cov_9.632465	192	272	36	6	80	0.0750000
NODE_1409_length_1941_cov_9.632465	192	272	37	2	80	0.0250000
NODE_1409_length_1941_cov_9.632465	192	272	38	20	80	0.2500000
NODE_1409_length_1941_cov_9.632465	192	272	39	10	80	0.1250000
NODE_1414_length_1936_cov_13.338596	679	759	1	2	80	0.0250000
NODE_1414_length_1936_cov_13.338596	679	759	2	2	80	0.0250000
NODE_1414_length_1936_cov_13.338596	679	759	3	35	80	0.4375000
NODE_1414_length_1936_cov_13.338596	679	759	4	41	80	0.5125000
NODE_1414_length_1936_cov_13.338596	732	812	1	55	80	0.6875000
NODE_1414_length_1936_cov_13.338596	732	812	2	2	80	0.0250000
NODE_1414_length_1936_cov_13.338596	732	812	3	23	80	0.2875000
NODE_1414_length_1936_cov_13.338596	738	812	1	55	74	0.7432432
NODE_1414_length_1936_cov_13.338596	738	812	2	2	74	0.0270270
NODE_1414_length_1936_cov_13.338596	738	812	3	17	74	0.2297297
NODE_1414_length_1936_cov_13.338596	738	759	1	2	21	0.0952381
NODE_1414_length_1936_cov_13.338596	738	759	2	2	21	0.0952381
NODE_1414_length_1936_cov_13.338596	738	759	3	17	21	0.8095238
NODE_1415_length_1936_cov_12.592814	102	153	2	7	51	0.1372549
NODE_1415_length_1936_cov_12.592814	102	153	3	44	51	0.8627451
NODE_1415_length_1936_cov_12.592814	154	230	0	32	76	0.4210526
NODE_1415_length_1936_cov_12.592814	154	230	1	1	76	0.0131579
NODE_1415_length_1936_cov_12.592814	154	230	2	43	76	0.5657895
NODE_1415_length_1936_cov_12.592814	211	251	2	40	40	1.0000000
NODE_1416_length_1933_cov_86.724646	1044	1124	32	7	80	0.0875000
NODE_1416_length_1933_cov_86.724646	1044	1124	33	5	80	0.0625000
NODE_1416_length_1933_cov_86.724646	1044	1124	34	3	80	0.0375000
NODE_1416_length_1933_cov_86.724646	1044	1124	36	4	80	0.0500000
NODE_1416_length_1933_cov_86.724646	1044	1124	37	1	80	0.0125000
NODE_1416_length_1933_cov_86.724646	1044	1124	39	1	80	0.0125000
NODE_1416_length_1933_cov_86.724646	1044	1124	40	2	80	0.0250000
NODE_1416_length_1933_cov_86.724646	1044	1124	41	3	80	0.0375000
NODE_1416_length_1933_cov_86.724646	1044	1124	42	19	80	0.2375000
NODE_1416_length_1933_cov_86.724646	1044	1124	43	5	80	0.0625000
NODE_1416_length_1933_cov_86.724646	1044	1124	45	1	80	0.0125000
NODE_1416_length_1933_cov_86.724646	1044	1124	46	7	80	0.0875000
NODE_1416_length_1933_cov_86.724646	1044	1124	47	6	80	0.0750000
NODE_1416_length_1933_cov_86.724646	1044	1124	48	8	80	0.1000000
NODE_1416_length_1933_cov_86.724646	1044	1124	49	8	80	0.1000000
NODE_1416_length_1933_cov_86.724646	1097	1177	43	2	80	0.0250000
NODE_1416_length_1933_cov_86.724646	1097	1177	44	3	80	0.0375000
NODE_1416_length_1933_cov_86.724646	1097	1177	45	1	80	0.0125000
NODE_1416_length_1933_cov_86.724646	1097	1177	46	11	80	0.1375000
NODE_1416_length_1933_cov_86.724646	1097	1177	47	7	80	0.0875000
NODE_1416_length_1933_cov_86.724646	1097	1177	48	10	80	0.1250000
NODE_1416_length_1933_cov_86.724646	1097	1177	49	30	80	0.3750000
NODE_1416_length_1933_cov_86.724646	1097	1177	50	11	80	0.1375000
NODE_1416_length_1933_cov_86.724646	1097	1177	51	3	80	0.0375000
NODE_1416_length_1933_cov_86.724646	1097	1177	52	2	80	0.0250000
NODE_1416_length_1933_cov_86.724646	1173	1253	19	4	80	0.0500000
NODE_1416_length_1933_cov_86.724646	1173	1253	20	2	80	0.0250000
NODE_1416_length_1933_cov_86.724646	1173	1253	21	3	80	0.0375000
NODE_1416_length_1933_cov_86.724646	1173	1253	23	2	80	0.0250000
NODE_1416_length_1933_cov_86.724646	1173	1253	25	2	80	0.0250000
NODE_1416_length_1933_cov_86.724646	1173	1253	26	3	80	0.0375000
NODE_1416_length_1933_cov_86.724646	1173	1253	28	15	80	0.1875000
NODE_1416_length_1933_cov_86.724646	1173	1253	29	1	80	0.0125000
NODE_1416_length_1933_cov_86.724646	1173	1253	30	7	80	0.0875000
NODE_1416_length_1933_cov_86.724646	1173	1253	31	1	80	0.0125000
NODE_1416_length_1933_cov_86.724646	1173	1253	33	3	80	0.0375000
NODE_1416_length_1933_cov_86.724646	1173	1253	35	3	80	0.0375000
NODE_1416_length_1933_cov_86.724646	1173	1253	36	1	80	0.0125000
NODE_1416_length_1933_cov_86.724646	1173	1253	37	1	80	0.0125000
NODE_1416_length_1933_cov_86.724646	1173	1253	38	7	80	0.0875000
NODE_1416_length_1933_cov_86.724646	1173	1253	39	8	80	0.1000000
NODE_1416_length_1933_cov_86.724646	1173	1253	40	8	80	0.1000000
NODE_1416_length_1933_cov_86.724646	1173	1253	43	7	80	0.0875000
NODE_1416_length_1933_cov_86.724646	1173	1253	44	2	80	0.0250000
NODE_1416_length_1933_cov_86.724646	1226	1306	14	1	80	0.0125000
NODE_1416_length_1933_cov_86.724646	1226	1306	16	2	80	0.0250000
NODE_1416_length_1933_cov_86.724646	1226	1306	17	6	80	0.0750000
NODE_1416_length_1933_cov_86.724646	1226	1306	18	11	80	0.1375000
NODE_1416_length_1933_cov_86.724646	1226	1306	19	27	80	0.3375000
NODE_1416_length_1933_cov_86.724646	1226	1306	20	6	80	0.0750000
NODE_1416_length_1933_cov_86.724646	1226	1306	21	9	80	0.1125000
NODE_1416_length_1933_cov_86.724646	1226	1306	23	2	80	0.0250000
NODE_1416_length_1933_cov_86.724646	1226	1306	25	2	80	0.0250000
NODE_1416_length_1933_cov_86.724646	1226	1306	26	3	80	0.0375000
NODE_1416_length_1933_cov_86.724646	1226	1306	28	8	80	0.1000000
NODE_1416_length_1933_cov_86.724646	1226	1306	29	1	80	0.0125000
NODE_1416_length_1933_cov_86.724646	1226	1306	30	2	80	0.0250000
NODE_1419_length_1932_cov_5.905074	1534	1614	2	20	80	0.2500000
NODE_1419_length_1932_cov_5.905074	1534	1614	4	60	80	0.7500000
NODE_1422_length_1930_cov_3.005461	1700	1780	2	80	80	1.0000000
NODE_1427_length_1928_cov_2.580098	74	131	0	57	57	1.0000000
NODE_1427_length_1928_cov_2.580098	127	184	0	57	57	1.0000000
NODE_1434_length_1919_cov_17.901099	454	529	11	3	75	0.0400000
NODE_1434_length_1919_cov_17.901099	454	529	13	5	75	0.0666667
NODE_1434_length_1919_cov_17.901099	454	529	15	1	75	0.0133333
NODE_1434_length_1919_cov_17.901099	454	529	17	1	75	0.0133333
NODE_1434_length_1919_cov_17.901099	454	529	18	5	75	0.0666667
NODE_1434_length_1919_cov_17.901099	454	529	19	3	75	0.0400000
NODE_1434_length_1919_cov_17.901099	454	529	21	15	75	0.2000000
NODE_1434_length_1919_cov_17.901099	454	529	22	13	75	0.1733333
NODE_1434_length_1919_cov_17.901099	454	529	26	1	75	0.0133333
NODE_1434_length_1919_cov_17.901099	454	529	28	16	75	0.2133333
NODE_1434_length_1919_cov_17.901099	454	529	30	4	75	0.0533333
NODE_1434_length_1919_cov_17.901099	454	529	31	6	75	0.0800000
NODE_1434_length_1919_cov_17.901099	454	529	32	1	75	0.0133333
NODE_1434_length_1919_cov_17.901099	454	529	33	1	75	0.0133333
NODE_1434_length_1919_cov_17.901099	507	558	1	12	51	0.2352941
NODE_1434_length_1919_cov_17.901099	507	558	2	14	51	0.2745098
NODE_1434_length_1919_cov_17.901099	507	558	6	3	51	0.0588235
NODE_1434_length_1919_cov_17.901099	507	558	11	3	51	0.0588235
NODE_1434_length_1919_cov_17.901099	507	558	13	5	51	0.0980392
NODE_1434_length_1919_cov_17.901099	507	558	15	1	51	0.0196078
NODE_1434_length_1919_cov_17.901099	507	558	17	1	51	0.0196078
NODE_1434_length_1919_cov_17.901099	507	558	18	5	51	0.0980392
NODE_1434_length_1919_cov_17.901099	507	558	19	3	51	0.0588235
NODE_1434_length_1919_cov_17.901099	507	558	21	4	51	0.0784314
NODE_1436_length_1918_cov_14.876855	314	396	6	82	82	1.0000000
NODE_1438_length_1918_cov_3.493128	9	55	0	46	46	1.0000000
NODE_1438_length_1918_cov_3.493128	1480	1561	0	81	81	1.0000000
NODE_1440_length_1916_cov_4.426527	162	192	0	30	30	1.0000000
NODE_1442_length_1915_cov_35.787996	106	186	4	13	80	0.1625000
NODE_1442_length_1915_cov_35.787996	106	186	5	17	80	0.2125000
NODE_1442_length_1915_cov_35.787996	106	186	6	50	80	0.6250000
NODE_1451_length_1905_cov_18.464563	740	820	2	5	80	0.0625000
NODE_1451_length_1905_cov_18.464563	740	820	3	25	80	0.3125000
NODE_1451_length_1905_cov_18.464563	740	820	4	10	80	0.1250000
NODE_1451_length_1905_cov_18.464563	740	820	5	40	80	0.5000000
NODE_1451_length_1905_cov_18.464563	793	873	0	14	80	0.1750000
NODE_1451_length_1905_cov_18.464563	793	873	1	33	80	0.4125000
NODE_1451_length_1905_cov_18.464563	793	873	2	11	80	0.1375000
NODE_1451_length_1905_cov_18.464563	793	873	3	22	80	0.2750000
NODE_1451_length_1905_cov_18.464563	869	949	1	80	80	1.0000000
NODE_1451_length_1905_cov_18.464563	922	1010	0	18	88	0.2045455
NODE_1451_length_1905_cov_18.464563	922	1010	1	70	88	0.7954546
NODE_1452_length_1905_cov_7.197121	596	676	8	11	80	0.1375000
NODE_1452_length_1905_cov_7.197121	596	676	9	3	80	0.0375000
NODE_1452_length_1905_cov_7.197121	596	676	11	10	80	0.1250000
NODE_1452_length_1905_cov_7.197121	596	676	12	7	80	0.0875000
NODE_1452_length_1905_cov_7.197121	596	676	14	49	80	0.6125000
NODE_1452_length_1905_cov_7.197121	649	682	8	17	33	0.5151515
NODE_1452_length_1905_cov_7.197121	649	682	9	3	33	0.0909091
NODE_1452_length_1905_cov_7.197121	649	682	11	10	33	0.3030303
NODE_1452_length_1905_cov_7.197121	649	682	12	3	33	0.0909091
NODE_1455_length_1902_cov_1.633943	1728	1792	1	37	64	0.5781250
NODE_1455_length_1902_cov_1.633943	1728	1792	2	27	64	0.4218750
NODE_1458_length_1900_cov_1.081066	1805	1851	0	46	46	1.0000000
NODE_1458_length_1900_cov_1.081066	1824	1900	0	76	76	1.0000000
NODE_1461_length_1895_cov_17.940980	1070	1150	3	19	80	0.2375000
NODE_1461_length_1895_cov_17.940980	1070	1150	4	9	80	0.1125000
NODE_1461_length_1895_cov_17.940980	1070	1150	5	50	80	0.6250000
NODE_1461_length_1895_cov_17.940980	1070	1150	6	2	80	0.0250000
NODE_1461_length_1895_cov_17.940980	1123	1203	3	11	80	0.1375000
NODE_1461_length_1895_cov_17.940980	1123	1203	4	27	80	0.3375000
NODE_1461_length_1895_cov_17.940980	1123	1203	5	42	80	0.5250000
NODE_1466_length_1893_cov_3.299331	918	998	1	80	80	1.0000000
NODE_1467_length_1892_cov_5.158394	317	397	0	80	80	1.0000000
NODE_1467_length_1892_cov_5.158394	370	445	0	64	75	0.8533334
NODE_1467_length_1892_cov_5.158394	370	445	1	11	75	0.1466667
NODE_1469_length_1889_cov_4.049162	1652	1686	1	18	34	0.5294118
NODE_1469_length_1889_cov_4.049162	1652	1686	2	16	34	0.4705882
NODE_1470_length_1889_cov_3.888268	960	1040	0	80	80	1.0000000
NODE_1470_length_1889_cov_3.888268	1013	1093	0	80	80	1.0000000
NODE_1472_length_1888_cov_17.106764	15	96	1	15	81	0.1851852
NODE_1472_length_1888_cov_17.106764	15	96	2	5	81	0.0617284
NODE_1472_length_1888_cov_17.106764	15	96	3	11	81	0.1358025
NODE_1472_length_1888_cov_17.106764	15	96	4	4	81	0.0493827
NODE_1472_length_1888_cov_17.106764	15	96	5	3	81	0.0370370
NODE_1472_length_1888_cov_17.106764	15	96	6	7	81	0.0864198
NODE_1472_length_1888_cov_17.106764	15	96	8	1	81	0.0123457
NODE_1472_length_1888_cov_17.106764	15	96	9	21	81	0.2592593
NODE_1472_length_1888_cov_17.106764	15	96	10	11	81	0.1358025
NODE_1472_length_1888_cov_17.106764	15	96	11	3	81	0.0370370
NODE_1472_length_1888_cov_17.106764	68	143	9	14	75	0.1866667
NODE_1472_length_1888_cov_17.106764	68	143	10	11	75	0.1466667
NODE_1472_length_1888_cov_17.106764	68	143	11	15	75	0.2000000
NODE_1472_length_1888_cov_17.106764	68	143	12	35	75	0.4666667
NODE_1477_length_1885_cov_4.439530	441	521	0	54	80	0.6750000
NODE_1477_length_1885_cov_4.439530	441	521	1	26	80	0.3250000
NODE_1477_length_1885_cov_4.439530	494	574	0	1	80	0.0125000
NODE_1477_length_1885_cov_4.439530	494	574	1	79	80	0.9875000
NODE_1483_length_1882_cov_5.884464	1499	1579	0	29	80	0.3625000
NODE_1483_length_1882_cov_5.884464	1499	1579	2	51	80	0.6375000
NODE_1483_length_1882_cov_5.884464	1552	1632	0	80	80	1.0000000
NODE_1493_length_1875_cov_3.974662	1650	1730	3	23	80	0.2875000
NODE_1493_length_1875_cov_3.974662	1650	1730	4	57	80	0.7125000
NODE_1497_length_1872_cov_21.355330	153	201	0	48	48	1.0000000
NODE_1503_length_1868_cov_96.046919	1018	1098	81	3	80	0.0375000
NODE_1503_length_1868_cov_96.046919	1018	1098	82	5	80	0.0625000
NODE_1503_length_1868_cov_96.046919	1018	1098	83	1	80	0.0125000
NODE_1503_length_1868_cov_96.046919	1018	1098	84	5	80	0.0625000
NODE_1503_length_1868_cov_96.046919	1018	1098	88	3	80	0.0375000
NODE_1503_length_1868_cov_96.046919	1018	1098	89	2	80	0.0250000
NODE_1503_length_1868_cov_96.046919	1018	1098	90	5	80	0.0625000
NODE_1503_length_1868_cov_96.046919	1018	1098	91	2	80	0.0250000
NODE_1503_length_1868_cov_96.046919	1018	1098	92	2	80	0.0250000
NODE_1503_length_1868_cov_96.046919	1018	1098	93	6	80	0.0750000
NODE_1503_length_1868_cov_96.046919	1018	1098	94	3	80	0.0375000
NODE_1503_length_1868_cov_96.046919	1018	1098	99	1	80	0.0125000
NODE_1503_length_1868_cov_96.046919	1018	1098	100	4	80	0.0500000
NODE_1503_length_1868_cov_96.046919	1018	1098	101	10	80	0.1250000
NODE_1503_length_1868_cov_96.046919	1018	1098	102	5	80	0.0625000
NODE_1503_length_1868_cov_96.046919	1018	1098	103	6	80	0.0750000
NODE_1503_length_1868_cov_96.046919	1018	1098	104	7	80	0.0875000
NODE_1503_length_1868_cov_96.046919	1018	1098	106	2	80	0.0250000
NODE_1503_length_1868_cov_96.046919	1018	1098	107	1	80	0.0125000
NODE_1503_length_1868_cov_96.046919	1018	1098	108	2	80	0.0250000
NODE_1503_length_1868_cov_96.046919	1018	1098	109	4	80	0.0500000
NODE_1503_length_1868_cov_96.046919	1018	1098	111	1	80	0.0125000
NODE_1503_length_1868_cov_96.046919	1071	1151	77	2	80	0.0250000
NODE_1503_length_1868_cov_96.046919	1071	1151	78	1	80	0.0125000
NODE_1503_length_1868_cov_96.046919	1071	1151	79	1	80	0.0125000
NODE_1503_length_1868_cov_96.046919	1071	1151	80	2	80	0.0250000
NODE_1503_length_1868_cov_96.046919	1071	1151	84	1	80	0.0125000
NODE_1503_length_1868_cov_96.046919	1071	1151	86	2	80	0.0250000
NODE_1503_length_1868_cov_96.046919	1071	1151	87	6	80	0.0750000
NODE_1503_length_1868_cov_96.046919	1071	1151	88	3	80	0.0375000
NODE_1503_length_1868_cov_96.046919	1071	1151	89	4	80	0.0500000
NODE_1503_length_1868_cov_96.046919	1071	1151	94	1	80	0.0125000
NODE_1503_length_1868_cov_96.046919	1071	1151	96	1	80	0.0125000
NODE_1503_length_1868_cov_96.046919	1071	1151	97	1	80	0.0125000
NODE_1503_length_1868_cov_96.046919	1071	1151	100	6	80	0.0750000
NODE_1503_length_1868_cov_96.046919	1071	1151	101	7	80	0.0875000
NODE_1503_length_1868_cov_96.046919	1071	1151	102	5	80	0.0625000
NODE_1503_length_1868_cov_96.046919	1071	1151	103	4	80	0.0500000
NODE_1503_length_1868_cov_96.046919	1071	1151	104	7	80	0.0875000
NODE_1503_length_1868_cov_96.046919	1071	1151	105	1	80	0.0125000
NODE_1503_length_1868_cov_96.046919	1071	1151	106	3	80	0.0375000
NODE_1503_length_1868_cov_96.046919	1071	1151	107	2	80	0.0250000
NODE_1503_length_1868_cov_96.046919	1071	1151	108	5	80	0.0625000
NODE_1503_length_1868_cov_96.046919	1071	1151	109	5	80	0.0625000
NODE_1503_length_1868_cov_96.046919	1071	1151	110	2	80	0.0250000
NODE_1503_length_1868_cov_96.046919	1071	1151	111	6	80	0.0750000
NODE_1503_length_1868_cov_96.046919	1071	1151	113	2	80	0.0250000
NODE_1508_length_1866_cov_53.869270	1149	1229	5	5	80	0.0625000
NODE_1508_length_1866_cov_53.869270	1149	1229	6	44	80	0.5500000
NODE_1508_length_1866_cov_53.869270	1149	1229	7	1	80	0.0125000
NODE_1508_length_1866_cov_53.869270	1149	1229	8	8	80	0.1000000
NODE_1508_length_1866_cov_53.869270	1149	1229	9	1	80	0.0125000
NODE_1508_length_1866_cov_53.869270	1149	1229	10	5	80	0.0625000
NODE_1508_length_1866_cov_53.869270	1149	1229	11	16	80	0.2000000
NODE_1508_length_1866_cov_53.869270	1202	1282	6	6	80	0.0750000
NODE_1508_length_1866_cov_53.869270	1202	1282	10	5	80	0.0625000
NODE_1508_length_1866_cov_53.869270	1202	1282	11	20	80	0.2500000
NODE_1508_length_1866_cov_53.869270	1202	1282	14	5	80	0.0625000
NODE_1508_length_1866_cov_53.869270	1202	1282	15	14	80	0.1750000
NODE_1508_length_1866_cov_53.869270	1202	1282	17	8	80	0.1000000
NODE_1508_length_1866_cov_53.869270	1202	1282	18	22	80	0.2750000
NODE_1508_length_1866_cov_53.869270	1278	1358	18	22	80	0.2750000
NODE_1508_length_1866_cov_53.869270	1278	1358	19	12	80	0.1500000
NODE_1508_length_1866_cov_53.869270	1278	1358	20	5	80	0.0625000
NODE_1508_length_1866_cov_53.869270	1278	1358	21	2	80	0.0250000
NODE_1508_length_1866_cov_53.869270	1278	1358	22	18	80	0.2250000
NODE_1508_length_1866_cov_53.869270	1278	1358	23	19	80	0.2375000
NODE_1508_length_1866_cov_53.869270	1278	1358	25	2	80	0.0250000
NODE_1508_length_1866_cov_53.869270	1331	1411	16	11	80	0.1375000
NODE_1508_length_1866_cov_53.869270	1331	1411	17	8	80	0.1000000
NODE_1508_length_1866_cov_53.869270	1331	1411	18	4	80	0.0500000
NODE_1508_length_1866_cov_53.869270	1331	1411	19	5	80	0.0625000
NODE_1508_length_1866_cov_53.869270	1331	1411	20	20	80	0.2500000
NODE_1508_length_1866_cov_53.869270	1331	1411	21	5	80	0.0625000
NODE_1508_length_1866_cov_53.869270	1331	1411	22	14	80	0.1750000
NODE_1508_length_1866_cov_53.869270	1331	1411	23	11	80	0.1375000
NODE_1508_length_1866_cov_53.869270	1331	1411	25	2	80	0.0250000
NODE_1510_length_1866_cov_3.347482	888	966	0	78	78	1.0000000
NODE_1510_length_1866_cov_3.347482	939	1019	0	80	80	1.0000000
NODE_1513_length_1863_cov_11.265306	698	778	19	1	80	0.0125000
NODE_1513_length_1863_cov_11.265306	698	778	20	4	80	0.0500000
NODE_1513_length_1863_cov_11.265306	698	778	21	8	80	0.1000000
NODE_1513_length_1863_cov_11.265306	698	778	22	15	80	0.1875000
NODE_1513_length_1863_cov_11.265306	698	778	23	2	80	0.0250000
NODE_1513_length_1863_cov_11.265306	698	778	24	3	80	0.0375000
NODE_1513_length_1863_cov_11.265306	698	778	26	8	80	0.1000000
NODE_1513_length_1863_cov_11.265306	698	778	28	5	80	0.0625000
NODE_1513_length_1863_cov_11.265306	698	778	29	16	80	0.2000000
NODE_1513_length_1863_cov_11.265306	698	778	31	1	80	0.0125000
NODE_1513_length_1863_cov_11.265306	698	778	32	8	80	0.1000000
NODE_1513_length_1863_cov_11.265306	698	778	33	2	80	0.0250000
NODE_1513_length_1863_cov_11.265306	698	778	34	5	80	0.0625000
NODE_1513_length_1863_cov_11.265306	698	778	35	2	80	0.0250000
NODE_1513_length_1863_cov_11.265306	751	831	25	1	80	0.0125000
NODE_1513_length_1863_cov_11.265306	751	831	28	12	80	0.1500000
NODE_1513_length_1863_cov_11.265306	751	831	29	9	80	0.1125000
NODE_1513_length_1863_cov_11.265306	751	831	30	2	80	0.0250000
NODE_1513_length_1863_cov_11.265306	751	831	31	2	80	0.0250000
NODE_1513_length_1863_cov_11.265306	751	831	32	8	80	0.1000000
NODE_1513_length_1863_cov_11.265306	751	831	33	4	80	0.0500000
NODE_1513_length_1863_cov_11.265306	751	831	34	22	80	0.2750000
NODE_1513_length_1863_cov_11.265306	751	831	35	11	80	0.1375000
NODE_1513_length_1863_cov_11.265306	751	831	36	9	80	0.1125000
NODE_1518_length_1858_cov_19.019329	23	85	0	62	62	1.0000000
NODE_1518_length_1858_cov_19.019329	1125	1205	4	55	80	0.6875000
NODE_1518_length_1858_cov_19.019329	1125	1205	5	25	80	0.3125000
NODE_1518_length_1858_cov_19.019329	1178	1256	4	2	78	0.0256410
NODE_1518_length_1858_cov_19.019329	1178	1256	5	26	78	0.3333333
NODE_1518_length_1858_cov_19.019329	1178	1256	7	50	78	0.6410257
NODE_1518_length_1858_cov_19.019329	1387	1464	6	7	77	0.0909091
NODE_1518_length_1858_cov_19.019329	1387	1464	8	1	77	0.0129870
NODE_1518_length_1858_cov_19.019329	1387	1464	10	21	77	0.2727273
NODE_1518_length_1858_cov_19.019329	1387	1464	11	4	77	0.0519481
NODE_1518_length_1858_cov_19.019329	1387	1464	12	3	77	0.0389610
NODE_1518_length_1858_cov_19.019329	1387	1464	14	10	77	0.1298701
NODE_1518_length_1858_cov_19.019329	1387	1464	15	12	77	0.1558442
NODE_1518_length_1858_cov_19.019329	1387	1464	16	19	77	0.2467532
NODE_1518_length_1858_cov_19.019329	1440	1503	15	5	63	0.0793651
NODE_1518_length_1858_cov_19.019329	1440	1503	16	29	63	0.4603175
NODE_1518_length_1858_cov_19.019329	1440	1503	17	29	63	0.4603175
NODE_1519_length_1857_cov_18.402730	1282	1348	4	41	66	0.6212121
NODE_1519_length_1857_cov_18.402730	1282	1348	6	25	66	0.3787879
NODE_1519_length_1857_cov_18.402730	1321	1401	4	8	80	0.1000000
NODE_1519_length_1857_cov_18.402730	1321	1401	5	36	80	0.4500000
NODE_1519_length_1857_cov_18.402730	1321	1401	6	36	80	0.4500000
NODE_1519_length_1857_cov_18.402730	1397	1477	2	4	80	0.0500000
NODE_1519_length_1857_cov_18.402730	1397	1477	4	61	80	0.7625000
NODE_1519_length_1857_cov_18.402730	1397	1477	5	13	80	0.1625000
NODE_1519_length_1857_cov_18.402730	1397	1477	6	2	80	0.0250000
NODE_1519_length_1857_cov_18.402730	1450	1530	2	57	80	0.7125000
NODE_1519_length_1857_cov_18.402730	1450	1530	4	23	80	0.2875000
NODE_1531_length_1845_cov_12.653494	473	553	1	8	80	0.1000000
NODE_1531_length_1845_cov_12.653494	473	553	2	43	80	0.5375000
NODE_1531_length_1845_cov_12.653494	473	553	3	29	80	0.3625000
NODE_1531_length_1845_cov_12.653494	526	606	1	35	80	0.4375000
NODE_1531_length_1845_cov_12.653494	526	606	2	26	80	0.3250000
NODE_1531_length_1845_cov_12.653494	526	606	3	19	80	0.2375000
NODE_1546_length_1833_cov_31.337947	810	888	14	10	78	0.1282051
NODE_1546_length_1833_cov_31.337947	810	888	15	37	78	0.4743590
NODE_1546_length_1833_cov_31.337947	810	888	16	2	78	0.0256410
NODE_1546_length_1833_cov_31.337947	810	888	17	12	78	0.1538462
NODE_1546_length_1833_cov_31.337947	810	888	19	17	78	0.2179487
NODE_1546_length_1833_cov_31.337947	861	941	17	10	80	0.1250000
NODE_1546_length_1833_cov_31.337947	861	941	19	18	80	0.2250000
NODE_1546_length_1833_cov_31.337947	861	941	20	4	80	0.0500000
NODE_1546_length_1833_cov_31.337947	861	941	21	2	80	0.0250000
NODE_1546_length_1833_cov_31.337947	861	941	23	1	80	0.0125000
NODE_1546_length_1833_cov_31.337947	861	941	24	9	80	0.1125000
NODE_1546_length_1833_cov_31.337947	861	941	25	7	80	0.0875000
NODE_1546_length_1833_cov_31.337947	861	941	26	12	80	0.1500000
NODE_1546_length_1833_cov_31.337947	861	941	27	4	80	0.0500000
NODE_1546_length_1833_cov_31.337947	861	941	28	1	80	0.0125000
NODE_1546_length_1833_cov_31.337947	861	941	29	12	80	0.1500000
NODE_1546_length_1833_cov_31.337947	937	1017	20	12	80	0.1500000
NODE_1546_length_1833_cov_31.337947	937	1017	22	1	80	0.0125000
NODE_1546_length_1833_cov_31.337947	937	1017	23	28	80	0.3500000
NODE_1546_length_1833_cov_31.337947	937	1017	24	5	80	0.0625000
NODE_1546_length_1833_cov_31.337947	937	1017	25	7	80	0.0875000
NODE_1546_length_1833_cov_31.337947	937	1017	26	6	80	0.0750000
NODE_1546_length_1833_cov_31.337947	937	1017	27	21	80	0.2625000
NODE_1546_length_1833_cov_31.337947	990	1070	11	19	80	0.2375000
NODE_1546_length_1833_cov_31.337947	990	1070	13	1	80	0.0125000
NODE_1546_length_1833_cov_31.337947	990	1070	14	2	80	0.0250000
NODE_1546_length_1833_cov_31.337947	990	1070	16	5	80	0.0625000
NODE_1546_length_1833_cov_31.337947	990	1070	19	2	80	0.0250000
NODE_1546_length_1833_cov_31.337947	990	1070	20	2	80	0.0250000
NODE_1546_length_1833_cov_31.337947	990	1070	21	18	80	0.2250000
NODE_1546_length_1833_cov_31.337947	990	1070	23	12	80	0.1500000
NODE_1546_length_1833_cov_31.337947	990	1070	24	2	80	0.0250000
NODE_1546_length_1833_cov_31.337947	990	1070	25	2	80	0.0250000
NODE_1546_length_1833_cov_31.337947	990	1070	26	6	80	0.0750000
NODE_1546_length_1833_cov_31.337947	990	1070	27	9	80	0.1125000
NODE_1550_length_1831_cov_3.065820	112	154	0	42	42	1.0000000
NODE_1553_length_1830_cov_2.512998	123	203	0	80	80	1.0000000
NODE_1553_length_1830_cov_2.512998	176	256	0	80	80	1.0000000
NODE_1553_length_1830_cov_2.512998	308	357	3	49	49	1.0000000
NODE_1554_length_1828_cov_40.437825	789	869	7	22	80	0.2750000
NODE_1554_length_1828_cov_40.437825	789	869	9	6	80	0.0750000
NODE_1554_length_1828_cov_40.437825	789	869	12	4	80	0.0500000
NODE_1554_length_1828_cov_40.437825	789	869	14	47	80	0.5875000
NODE_1554_length_1828_cov_40.437825	789	869	15	1	80	0.0125000
NODE_1554_length_1828_cov_40.437825	842	922	14	26	80	0.3250000
NODE_1554_length_1828_cov_40.437825	842	922	15	1	80	0.0125000
NODE_1554_length_1828_cov_40.437825	842	922	17	14	80	0.1750000
NODE_1554_length_1828_cov_40.437825	842	922	19	24	80	0.3000000
NODE_1554_length_1828_cov_40.437825	842	922	20	15	80	0.1875000
NODE_1554_length_1828_cov_40.437825	918	998	13	4	80	0.0500000
NODE_1554_length_1828_cov_40.437825	918	998	15	17	80	0.2125000
NODE_1554_length_1828_cov_40.437825	918	998	16	29	80	0.3625000
NODE_1554_length_1828_cov_40.437825	918	998	17	2	80	0.0250000
NODE_1554_length_1828_cov_40.437825	918	998	18	6	80	0.0750000
NODE_1554_length_1828_cov_40.437825	918	998	19	15	80	0.1875000
NODE_1554_length_1828_cov_40.437825	918	998	20	7	80	0.0875000
NODE_1554_length_1828_cov_40.437825	971	1051	11	2	80	0.0250000
NODE_1554_length_1828_cov_40.437825	971	1051	12	11	80	0.1375000
NODE_1554_length_1828_cov_40.437825	971	1051	13	4	80	0.0500000
NODE_1554_length_1828_cov_40.437825	971	1051	14	19	80	0.2375000
NODE_1554_length_1828_cov_40.437825	971	1051	15	13	80	0.1625000
NODE_1554_length_1828_cov_40.437825	971	1051	16	29	80	0.3625000
NODE_1554_length_1828_cov_40.437825	971	1051	19	1	80	0.0125000
NODE_1554_length_1828_cov_40.437825	971	1051	20	1	80	0.0125000
NODE_1559_length_1825_cov_6.652955	641	689	3	17	48	0.3541667
NODE_1559_length_1825_cov_6.652955	641	689	4	4	48	0.0833333
NODE_1559_length_1825_cov_6.652955	641	689	6	27	48	0.5625000
NODE_1559_length_1825_cov_6.652955	694	744	5	6	50	0.1200000
NODE_1559_length_1825_cov_6.652955	694	744	6	43	50	0.8600000
NODE_1559_length_1825_cov_6.652955	694	744	7	1	50	0.0200000
NODE_1562_length_1824_cov_10.152464	685	765	10	47	80	0.5875000
NODE_1562_length_1824_cov_10.152464	685	765	11	33	80	0.4125000
NODE_1562_length_1824_cov_10.152464	738	818	2	24	80	0.3000000
NODE_1562_length_1824_cov_10.152464	738	818	3	16	80	0.2000000
NODE_1562_length_1824_cov_10.152464	738	818	5	6	80	0.0750000
NODE_1562_length_1824_cov_10.152464	738	818	10	20	80	0.2500000
NODE_1562_length_1824_cov_10.152464	738	818	11	14	80	0.1750000
NODE_1562_length_1824_cov_10.152464	1412	1433	0	21	21	1.0000000
NODE_1564_length_1821_cov_7.682346	953	1033	8	10	80	0.1250000
NODE_1564_length_1821_cov_7.682346	953	1033	12	14	80	0.1750000
NODE_1564_length_1821_cov_7.682346	953	1033	13	53	80	0.6625000
NODE_1564_length_1821_cov_7.682346	953	1033	14	3	80	0.0375000
NODE_1564_length_1821_cov_7.682346	1006	1086	6	48	80	0.6000000
NODE_1564_length_1821_cov_7.682346	1006	1086	7	4	80	0.0500000
NODE_1564_length_1821_cov_7.682346	1006	1086	12	15	80	0.1875000
NODE_1564_length_1821_cov_7.682346	1006	1086	13	13	80	0.1625000
NODE_1566_length_1820_cov_12.061592	477	557	22	1	80	0.0125000
NODE_1566_length_1820_cov_12.061592	477	557	23	8	80	0.1000000
NODE_1566_length_1820_cov_12.061592	477	557	25	13	80	0.1625000
NODE_1566_length_1820_cov_12.061592	477	557	26	24	80	0.3000000
NODE_1566_length_1820_cov_12.061592	477	557	27	8	80	0.1000000
NODE_1566_length_1820_cov_12.061592	477	557	28	9	80	0.1125000
NODE_1566_length_1820_cov_12.061592	477	557	29	3	80	0.0375000
NODE_1566_length_1820_cov_12.061592	477	557	30	8	80	0.1000000
NODE_1566_length_1820_cov_12.061592	477	557	31	4	80	0.0500000
NODE_1566_length_1820_cov_12.061592	477	557	32	2	80	0.0250000
NODE_1566_length_1820_cov_12.061592	530	610	23	2	80	0.0250000
NODE_1566_length_1820_cov_12.061592	530	610	24	4	80	0.0500000
NODE_1566_length_1820_cov_12.061592	530	610	25	17	80	0.2125000
NODE_1566_length_1820_cov_12.061592	530	610	26	17	80	0.2125000
NODE_1566_length_1820_cov_12.061592	530	610	27	19	80	0.2375000
NODE_1566_length_1820_cov_12.061592	530	610	28	18	80	0.2250000
NODE_1566_length_1820_cov_12.061592	530	610	31	3	80	0.0375000
NODE_1566_length_1820_cov_12.061592	1232	1312	1	67	80	0.8375000
NODE_1566_length_1820_cov_12.061592	1232	1312	2	13	80	0.1625000
NODE_1566_length_1820_cov_12.061592	1285	1365	1	73	80	0.9125000
NODE_1566_length_1820_cov_12.061592	1285	1365	2	7	80	0.0875000
NODE_1572_length_1817_cov_8.302095	63	122	0	59	59	1.0000000
NODE_1572_length_1817_cov_8.302095	1195	1275	2	20	80	0.2500000
NODE_1572_length_1817_cov_8.302095	1195	1275	4	60	80	0.7500000
NODE_1572_length_1817_cov_8.302095	1248	1328	0	3	80	0.0375000
NODE_1572_length_1817_cov_8.302095	1248	1328	2	70	80	0.8750000
NODE_1572_length_1817_cov_8.302095	1248	1328	4	7	80	0.0875000
NODE_1573_length_1816_cov_25.489225	1059	1139	3	42	80	0.5250000
NODE_1573_length_1816_cov_25.489225	1059	1139	5	30	80	0.3750000
NODE_1573_length_1816_cov_25.489225	1059	1139	7	8	80	0.1000000
NODE_1573_length_1816_cov_25.489225	1112	1192	5	30	80	0.3750000
NODE_1573_length_1816_cov_25.489225	1112	1192	6	28	80	0.3500000
NODE_1573_length_1816_cov_25.489225	1112	1192	7	22	80	0.2750000
NODE_1578_length_1812_cov_11.453006	398	427	5	29	29	1.0000000
NODE_1578_length_1812_cov_11.453006	400	480	5	51	80	0.6375000
NODE_1578_length_1812_cov_11.453006	400	480	6	11	80	0.1375000
NODE_1578_length_1812_cov_11.453006	400	480	8	18	80	0.2250000
NODE_1586_length_1807_cov_3.977752	1743	1807	0	64	64	1.0000000
NODE_1590_length_1806_cov_2.681312	1461	1541	3	6	80	0.0750000
NODE_1590_length_1806_cov_2.681312	1461	1541	5	4	80	0.0500000
NODE_1590_length_1806_cov_2.681312	1461	1541	6	70	80	0.8750000
NODE_1590_length_1806_cov_2.681312	1517	1594	0	33	77	0.4285714
NODE_1590_length_1806_cov_2.681312	1517	1594	3	26	77	0.3376623
NODE_1590_length_1806_cov_2.681312	1517	1594	6	18	77	0.2337662
NODE_1593_length_1805_cov_10.271395	258	329	4	45	71	0.6338028
NODE_1593_length_1805_cov_10.271395	258	329	5	13	71	0.1830986
NODE_1593_length_1805_cov_10.271395	258	329	6	13	71	0.1830986
NODE_1593_length_1805_cov_10.271395	311	391	2	12	80	0.1500000
NODE_1593_length_1805_cov_10.271395	311	391	4	43	80	0.5375000
NODE_1593_length_1805_cov_10.271395	311	391	5	25	80	0.3125000
NODE_1598_length_1802_cov_11.546682	1284	1364	6	67	80	0.8375000
NODE_1598_length_1802_cov_11.546682	1284	1364	8	13	80	0.1625000
NODE_1598_length_1802_cov_11.546682	1337	1417	0	19	80	0.2375000
NODE_1598_length_1802_cov_11.546682	1337	1417	2	14	80	0.1750000
NODE_1598_length_1802_cov_11.546682	1337	1417	4	17	80	0.2125000
NODE_1598_length_1802_cov_11.546682	1337	1417	6	30	80	0.3750000
NODE_1600_length_1801_cov_12.145711	85	165	6	16	80	0.2000000
NODE_1600_length_1801_cov_12.145711	85	165	8	38	80	0.4750000
NODE_1600_length_1801_cov_12.145711	85	165	10	26	80	0.3250000
NODE_1600_length_1801_cov_12.145711	138	218	8	1	80	0.0125000
NODE_1600_length_1801_cov_12.145711	138	218	9	31	80	0.3875000
NODE_1600_length_1801_cov_12.145711	138	218	10	48	80	0.6000000
NODE_1601_length_1801_cov_9.793184	1010	1090	2	59	80	0.7375000
NODE_1601_length_1801_cov_9.793184	1010	1090	3	21	80	0.2625000
NODE_1601_length_1801_cov_9.793184	1063	1143	2	15	80	0.1875000
NODE_1601_length_1801_cov_9.793184	1063	1143	3	42	80	0.5250000
NODE_1601_length_1801_cov_9.793184	1063	1143	4	23	80	0.2875000
NODE_1604_length_1800_cov_15.074662	695	775	4	27	80	0.3375000
NODE_1604_length_1800_cov_15.074662	695	775	5	4	80	0.0500000
NODE_1604_length_1800_cov_15.074662	695	775	6	49	80	0.6125000
NODE_1604_length_1800_cov_15.074662	755	826	5	1	71	0.0140845
NODE_1604_length_1800_cov_15.074662	755	826	6	29	71	0.4084507
NODE_1604_length_1800_cov_15.074662	755	826	7	41	71	0.5774648
NODE_1605_length_1800_cov_7.281599	10	74	2	50	64	0.7812500
NODE_1605_length_1800_cov_7.281599	10	74	4	14	64	0.2187500
NODE_1605_length_1800_cov_7.281599	10	74	2	50	64	0.7812500
NODE_1605_length_1800_cov_7.281599	10	74	4	14	64	0.2187500
NODE_1605_length_1800_cov_7.281599	10	74	2	50	64	0.7812500
NODE_1605_length_1800_cov_7.281599	10	74	4	14	64	0.2187500
NODE_1605_length_1800_cov_7.281599	47	127	2	13	80	0.1625000
NODE_1605_length_1800_cov_7.281599	47	127	4	67	80	0.8375000
NODE_1605_length_1800_cov_7.281599	63	126	4	63	63	1.0000000
NODE_1616_length_1793_cov_16.161157	539	619	6	2	80	0.0250000
NODE_1616_length_1793_cov_16.161157	539	619	8	25	80	0.3125000
NODE_1616_length_1793_cov_16.161157	539	619	9	11	80	0.1375000
NODE_1616_length_1793_cov_16.161157	539	619	11	38	80	0.4750000
NODE_1616_length_1793_cov_16.161157	539	619	12	4	80	0.0500000
NODE_1616_length_1793_cov_16.161157	592	672	7	22	80	0.2750000
NODE_1616_length_1793_cov_16.161157	592	672	8	54	80	0.6750000
NODE_1616_length_1793_cov_16.161157	592	672	9	2	80	0.0250000
NODE_1616_length_1793_cov_16.161157	592	672	11	2	80	0.0250000
NODE_1616_length_1793_cov_16.161157	1202	1281	0	19	79	0.2405063
NODE_1616_length_1793_cov_16.161157	1202	1281	1	60	79	0.7594936
NODE_1616_length_1793_cov_16.161157	1254	1335	1	27	81	0.3333333
NODE_1616_length_1793_cov_16.161157	1254	1335	2	54	81	0.6666667
NODE_1617_length_1793_cov_14.322904	521	601	6	32	80	0.4000000
NODE_1617_length_1793_cov_14.322904	521	601	7	48	80	0.6000000
NODE_1617_length_1793_cov_14.322904	574	654	1	34	80	0.4250000
NODE_1617_length_1793_cov_14.322904	574	654	4	12	80	0.1500000
NODE_1617_length_1793_cov_14.322904	574	654	5	1	80	0.0125000
NODE_1617_length_1793_cov_14.322904	574	654	6	33	80	0.4125000
NODE_1617_length_1793_cov_14.322904	1230	1310	2	10	80	0.1250000
NODE_1617_length_1793_cov_14.322904	1230	1310	3	23	80	0.2875000
NODE_1617_length_1793_cov_14.322904	1230	1310	4	47	80	0.5875000
NODE_1618_length_1791_cov_5.516548	1190	1261	2	48	71	0.6760563
NODE_1618_length_1791_cov_5.516548	1190	1261	3	23	71	0.3239437
NODE_1621_length_1790_cov_4.282082	684	764	2	12	80	0.1500000
NODE_1621_length_1790_cov_4.282082	684	764	3	1	80	0.0125000
NODE_1621_length_1790_cov_4.282082	684	764	4	42	80	0.5250000
NODE_1621_length_1790_cov_4.282082	684	764	5	25	80	0.3125000
NODE_1621_length_1790_cov_4.282082	737	817	4	27	80	0.3375000
NODE_1621_length_1790_cov_4.282082	737	817	5	36	80	0.4500000
NODE_1621_length_1790_cov_4.282082	737	817	6	17	80	0.2125000
NODE_1623_length_1788_cov_39.558911	385	465	17	1	80	0.0125000
NODE_1623_length_1788_cov_39.558911	385	465	18	16	80	0.2000000
NODE_1623_length_1788_cov_39.558911	385	465	19	5	80	0.0625000
NODE_1623_length_1788_cov_39.558911	385	465	20	2	80	0.0250000
NODE_1623_length_1788_cov_39.558911	385	465	22	4	80	0.0500000
NODE_1623_length_1788_cov_39.558911	385	465	25	9	80	0.1125000
NODE_1623_length_1788_cov_39.558911	385	465	29	1	80	0.0125000
NODE_1623_length_1788_cov_39.558911	385	465	31	4	80	0.0500000
NODE_1623_length_1788_cov_39.558911	385	465	32	7	80	0.0875000
NODE_1623_length_1788_cov_39.558911	385	465	33	3	80	0.0375000
NODE_1623_length_1788_cov_39.558911	385	465	34	7	80	0.0875000
NODE_1623_length_1788_cov_39.558911	385	465	35	14	80	0.1750000
NODE_1623_length_1788_cov_39.558911	385	465	36	7	80	0.0875000
NODE_1623_length_1788_cov_39.558911	438	518	29	2	80	0.0250000
NODE_1623_length_1788_cov_39.558911	438	518	31	5	80	0.0625000
NODE_1623_length_1788_cov_39.558911	438	518	32	18	80	0.2250000
NODE_1623_length_1788_cov_39.558911	438	518	33	12	80	0.1500000
NODE_1623_length_1788_cov_39.558911	438	518	34	17	80	0.2125000
NODE_1623_length_1788_cov_39.558911	438	518	35	6	80	0.0750000
NODE_1623_length_1788_cov_39.558911	438	518	36	7	80	0.0875000
NODE_1623_length_1788_cov_39.558911	438	518	38	8	80	0.1000000
NODE_1623_length_1788_cov_39.558911	438	518	44	1	80	0.0125000
NODE_1623_length_1788_cov_39.558911	438	518	45	2	80	0.0250000
NODE_1623_length_1788_cov_39.558911	438	518	46	1	80	0.0125000
NODE_1623_length_1788_cov_39.558911	438	518	47	1	80	0.0125000
NODE_1623_length_1788_cov_39.558911	514	594	43	5	80	0.0625000
NODE_1623_length_1788_cov_39.558911	514	594	44	5	80	0.0625000
NODE_1623_length_1788_cov_39.558911	514	594	45	8	80	0.1000000
NODE_1623_length_1788_cov_39.558911	514	594	46	2	80	0.0250000
NODE_1623_length_1788_cov_39.558911	514	594	47	1	80	0.0125000
NODE_1623_length_1788_cov_39.558911	514	594	48	4	80	0.0500000
NODE_1623_length_1788_cov_39.558911	514	594	49	1	80	0.0125000
NODE_1623_length_1788_cov_39.558911	514	594	51	12	80	0.1500000
NODE_1623_length_1788_cov_39.558911	514	594	52	20	80	0.2500000
NODE_1623_length_1788_cov_39.558911	514	594	53	9	80	0.1125000
NODE_1623_length_1788_cov_39.558911	514	594	54	4	80	0.0500000
NODE_1623_length_1788_cov_39.558911	514	594	55	6	80	0.0750000
NODE_1623_length_1788_cov_39.558911	514	594	56	3	80	0.0375000
NODE_1623_length_1788_cov_39.558911	567	647	41	3	80	0.0375000
NODE_1623_length_1788_cov_39.558911	567	647	42	11	80	0.1375000
NODE_1623_length_1788_cov_39.558911	567	647	43	5	80	0.0625000
NODE_1623_length_1788_cov_39.558911	567	647	44	8	80	0.1000000
NODE_1623_length_1788_cov_39.558911	567	647	45	10	80	0.1250000
NODE_1623_length_1788_cov_39.558911	567	647	46	17	80	0.2125000
NODE_1623_length_1788_cov_39.558911	567	647	47	12	80	0.1500000
NODE_1623_length_1788_cov_39.558911	567	647	48	6	80	0.0750000
NODE_1623_length_1788_cov_39.558911	567	647	49	3	80	0.0375000
NODE_1623_length_1788_cov_39.558911	567	647	52	1	80	0.0125000
NODE_1623_length_1788_cov_39.558911	567	647	53	4	80	0.0500000
NODE_1624_length_1787_cov_44.927133	530	610	11	7	80	0.0875000
NODE_1624_length_1787_cov_44.927133	530	610	12	7	80	0.0875000
NODE_1624_length_1787_cov_44.927133	530	610	13	27	80	0.3375000
NODE_1624_length_1787_cov_44.927133	530	610	14	25	80	0.3125000
NODE_1624_length_1787_cov_44.927133	530	610	15	14	80	0.1750000
NODE_1625_length_1787_cov_2.752370	675	755	0	15	80	0.1875000
NODE_1625_length_1787_cov_2.752370	675	755	4	65	80	0.8125000
NODE_1625_length_1787_cov_2.752370	728	806	0	66	78	0.8461539
NODE_1625_length_1787_cov_2.752370	728	806	4	12	78	0.1538462
NODE_1626_length_1786_cov_13.459395	523	603	12	7	80	0.0875000
NODE_1626_length_1786_cov_13.459395	523	603	13	10	80	0.1250000
NODE_1626_length_1786_cov_13.459395	523	603	14	1	80	0.0125000
NODE_1626_length_1786_cov_13.459395	523	603	15	5	80	0.0625000
NODE_1626_length_1786_cov_13.459395	523	603	16	8	80	0.1000000
NODE_1626_length_1786_cov_13.459395	523	603	18	24	80	0.3000000
NODE_1626_length_1786_cov_13.459395	523	603	19	25	80	0.3125000
NODE_1626_length_1786_cov_13.459395	576	656	11	3	80	0.0375000
NODE_1626_length_1786_cov_13.459395	576	656	12	16	80	0.2000000
NODE_1626_length_1786_cov_13.459395	576	656	14	17	80	0.2125000
NODE_1626_length_1786_cov_13.459395	576	656	16	1	80	0.0125000
NODE_1626_length_1786_cov_13.459395	576	656	17	9	80	0.1125000
NODE_1626_length_1786_cov_13.459395	576	656	18	17	80	0.2125000
NODE_1626_length_1786_cov_13.459395	576	656	19	17	80	0.2125000
NODE_1633_length_1784_cov_40.769733	358	438	2	37	80	0.4625000
NODE_1633_length_1784_cov_40.769733	358	438	3	34	80	0.4250000
NODE_1633_length_1784_cov_40.769733	358	438	4	9	80	0.1125000
NODE_1633_length_1784_cov_40.769733	411	491	2	8	80	0.1000000
NODE_1633_length_1784_cov_40.769733	411	491	3	43	80	0.5375000
NODE_1633_length_1784_cov_40.769733	411	491	4	29	80	0.3625000
NODE_1633_length_1784_cov_40.769733	1057	1137	5	17	80	0.2125000
NODE_1633_length_1784_cov_40.769733	1057	1137	6	63	80	0.7875000
NODE_1633_length_1784_cov_40.769733	1110	1190	1	25	80	0.3125000
NODE_1633_length_1784_cov_40.769733	1110	1190	2	4	80	0.0500000
NODE_1633_length_1784_cov_40.769733	1110	1190	4	2	80	0.0250000
NODE_1633_length_1784_cov_40.769733	1110	1190	6	49	80	0.6125000
NODE_1633_length_1784_cov_40.769733	1186	1266	1	6	80	0.0750000
NODE_1633_length_1784_cov_40.769733	1186	1266	2	3	80	0.0375000
NODE_1633_length_1784_cov_40.769733	1186	1266	3	9	80	0.1125000
NODE_1633_length_1784_cov_40.769733	1186	1266	5	13	80	0.1625000
NODE_1633_length_1784_cov_40.769733	1186	1266	6	3	80	0.0375000
NODE_1633_length_1784_cov_40.769733	1186	1266	7	11	80	0.1375000
NODE_1633_length_1784_cov_40.769733	1186	1266	8	10	80	0.1250000
NODE_1633_length_1784_cov_40.769733	1186	1266	10	25	80	0.3125000
NODE_1633_length_1784_cov_40.769733	1239	1319	8	2	80	0.0250000
NODE_1633_length_1784_cov_40.769733	1239	1319	10	46	80	0.5750000
NODE_1633_length_1784_cov_40.769733	1239	1319	11	32	80	0.4000000
NODE_1634_length_1784_cov_6.049258	1646	1725	0	79	79	1.0000000
NODE_1637_length_1783_cov_45.569477	600	680	15	8	80	0.1000000
NODE_1637_length_1783_cov_45.569477	600	680	16	3	80	0.0375000
NODE_1637_length_1783_cov_45.569477	600	680	17	26	80	0.3250000
NODE_1637_length_1783_cov_45.569477	600	680	20	1	80	0.0125000
NODE_1637_length_1783_cov_45.569477	600	680	21	4	80	0.0500000
NODE_1637_length_1783_cov_45.569477	600	680	22	2	80	0.0250000
NODE_1637_length_1783_cov_45.569477	600	680	24	26	80	0.3250000
NODE_1637_length_1783_cov_45.569477	600	680	25	5	80	0.0625000
NODE_1637_length_1783_cov_45.569477	600	680	26	5	80	0.0625000
NODE_1637_length_1783_cov_45.569477	653	733	20	6	80	0.0750000
NODE_1637_length_1783_cov_45.569477	653	733	21	3	80	0.0375000
NODE_1637_length_1783_cov_45.569477	653	733	22	15	80	0.1875000
NODE_1637_length_1783_cov_45.569477	653	733	23	11	80	0.1375000
NODE_1637_length_1783_cov_45.569477	653	733	24	18	80	0.2250000
NODE_1637_length_1783_cov_45.569477	653	733	25	4	80	0.0500000
NODE_1637_length_1783_cov_45.569477	653	733	26	23	80	0.2875000
NODE_1640_length_1780_cov_21.089233	361	441	12	27	80	0.3375000
NODE_1640_length_1780_cov_21.089233	361	441	13	33	80	0.4125000
NODE_1640_length_1780_cov_21.089233	361	441	15	8	80	0.1000000
NODE_1640_length_1780_cov_21.089233	361	441	17	12	80	0.1500000
NODE_1640_length_1780_cov_21.089233	414	494	9	2	80	0.0250000
NODE_1640_length_1780_cov_21.089233	414	494	11	17	80	0.2125000
NODE_1640_length_1780_cov_21.089233	414	494	13	25	80	0.3125000
NODE_1640_length_1780_cov_21.089233	414	494	15	20	80	0.2500000
NODE_1640_length_1780_cov_21.089233	414	494	17	16	80	0.2000000
NODE_1640_length_1780_cov_21.089233	1031	1104	1	9	73	0.1232877
NODE_1640_length_1780_cov_21.089233	1031	1104	4	9	73	0.1232877
NODE_1640_length_1780_cov_21.089233	1031	1104	5	23	73	0.3150685
NODE_1640_length_1780_cov_21.089233	1031	1104	7	2	73	0.0273973
NODE_1640_length_1780_cov_21.089233	1031	1104	8	30	73	0.4109589
NODE_1640_length_1780_cov_21.089233	1071	1112	5	1	41	0.0243902
NODE_1640_length_1780_cov_21.089233	1071	1112	7	2	41	0.0487805
NODE_1640_length_1780_cov_21.089233	1071	1112	8	38	41	0.9268293
NODE_1641_length_1780_cov_7.837597	1682	1747	0	65	65	1.0000000
NODE_1649_length_1778_cov_52.804050	1528	1568	13	15	40	0.3750000
NODE_1649_length_1778_cov_52.804050	1528	1568	14	7	40	0.1750000
NODE_1649_length_1778_cov_52.804050	1528	1568	15	1	40	0.0250000
NODE_1649_length_1778_cov_52.804050	1528	1568	16	2	40	0.0500000
NODE_1649_length_1778_cov_52.804050	1528	1568	19	4	40	0.1000000
NODE_1649_length_1778_cov_52.804050	1528	1568	21	5	40	0.1250000
NODE_1649_length_1778_cov_52.804050	1528	1568	25	6	40	0.1500000
NODE_1649_length_1778_cov_52.804050	1541	1621	13	6	80	0.0750000
NODE_1649_length_1778_cov_52.804050	1541	1621	14	6	80	0.0750000
NODE_1649_length_1778_cov_52.804050	1541	1621	19	4	80	0.0500000
NODE_1649_length_1778_cov_52.804050	1541	1621	21	5	80	0.0625000
NODE_1649_length_1778_cov_52.804050	1541	1621	25	18	80	0.2250000
NODE_1649_length_1778_cov_52.804050	1541	1621	29	1	80	0.0125000
NODE_1649_length_1778_cov_52.804050	1541	1621	31	3	80	0.0375000
NODE_1649_length_1778_cov_52.804050	1541	1621	34	11	80	0.1375000
NODE_1649_length_1778_cov_52.804050	1541	1621	36	1	80	0.0125000
NODE_1649_length_1778_cov_52.804050	1541	1621	38	15	80	0.1875000
NODE_1649_length_1778_cov_52.804050	1541	1621	39	4	80	0.0500000
NODE_1649_length_1778_cov_52.804050	1541	1621	40	6	80	0.0750000
NODE_1649_length_1778_cov_52.804050	1541	1621	13	6	80	0.0750000
NODE_1649_length_1778_cov_52.804050	1541	1621	14	6	80	0.0750000
NODE_1649_length_1778_cov_52.804050	1541	1621	19	4	80	0.0500000
NODE_1649_length_1778_cov_52.804050	1541	1621	21	5	80	0.0625000
NODE_1649_length_1778_cov_52.804050	1541	1621	25	18	80	0.2250000
NODE_1649_length_1778_cov_52.804050	1541	1621	29	1	80	0.0125000
NODE_1649_length_1778_cov_52.804050	1541	1621	31	3	80	0.0375000
NODE_1649_length_1778_cov_52.804050	1541	1621	34	11	80	0.1375000
NODE_1649_length_1778_cov_52.804050	1541	1621	36	1	80	0.0125000
NODE_1649_length_1778_cov_52.804050	1541	1621	38	15	80	0.1875000
NODE_1649_length_1778_cov_52.804050	1541	1621	39	4	80	0.0500000
NODE_1649_length_1778_cov_52.804050	1541	1621	40	6	80	0.0750000
NODE_1649_length_1778_cov_52.804050	1541	1621	13	6	80	0.0750000
NODE_1649_length_1778_cov_52.804050	1541	1621	14	6	80	0.0750000
NODE_1649_length_1778_cov_52.804050	1541	1621	19	4	80	0.0500000
NODE_1649_length_1778_cov_52.804050	1541	1621	21	5	80	0.0625000
NODE_1649_length_1778_cov_52.804050	1541	1621	25	18	80	0.2250000
NODE_1649_length_1778_cov_52.804050	1541	1621	29	1	80	0.0125000
NODE_1649_length_1778_cov_52.804050	1541	1621	31	3	80	0.0375000
NODE_1649_length_1778_cov_52.804050	1541	1621	34	11	80	0.1375000
NODE_1649_length_1778_cov_52.804050	1541	1621	36	1	80	0.0125000
NODE_1649_length_1778_cov_52.804050	1541	1621	38	15	80	0.1875000
NODE_1649_length_1778_cov_52.804050	1541	1621	39	4	80	0.0500000
NODE_1649_length_1778_cov_52.804050	1541	1621	40	6	80	0.0750000
NODE_1649_length_1778_cov_52.804050	1541	1621	13	6	80	0.0750000
NODE_1649_length_1778_cov_52.804050	1541	1621	14	6	80	0.0750000
NODE_1649_length_1778_cov_52.804050	1541	1621	19	4	80	0.0500000
NODE_1649_length_1778_cov_52.804050	1541	1621	21	5	80	0.0625000
NODE_1649_length_1778_cov_52.804050	1541	1621	25	18	80	0.2250000
NODE_1649_length_1778_cov_52.804050	1541	1621	29	1	80	0.0125000
NODE_1649_length_1778_cov_52.804050	1541	1621	31	3	80	0.0375000
NODE_1649_length_1778_cov_52.804050	1541	1621	34	11	80	0.1375000
NODE_1649_length_1778_cov_52.804050	1541	1621	36	1	80	0.0125000
NODE_1649_length_1778_cov_52.804050	1541	1621	38	15	80	0.1875000
NODE_1649_length_1778_cov_52.804050	1541	1621	39	4	80	0.0500000
NODE_1649_length_1778_cov_52.804050	1541	1621	40	6	80	0.0750000
NODE_1649_length_1778_cov_52.804050	1541	1621	13	6	80	0.0750000
NODE_1649_length_1778_cov_52.804050	1541	1621	14	6	80	0.0750000
NODE_1649_length_1778_cov_52.804050	1541	1621	19	4	80	0.0500000
NODE_1649_length_1778_cov_52.804050	1541	1621	21	5	80	0.0625000
NODE_1649_length_1778_cov_52.804050	1541	1621	25	18	80	0.2250000
NODE_1649_length_1778_cov_52.804050	1541	1621	29	1	80	0.0125000
NODE_1649_length_1778_cov_52.804050	1541	1621	31	3	80	0.0375000
NODE_1649_length_1778_cov_52.804050	1541	1621	34	11	80	0.1375000
NODE_1649_length_1778_cov_52.804050	1541	1621	36	1	80	0.0125000
NODE_1649_length_1778_cov_52.804050	1541	1621	38	15	80	0.1875000
NODE_1649_length_1778_cov_52.804050	1541	1621	39	4	80	0.0500000
NODE_1649_length_1778_cov_52.804050	1541	1621	40	6	80	0.0750000
NODE_1649_length_1778_cov_52.804050	1541	1621	13	6	80	0.0750000
NODE_1649_length_1778_cov_52.804050	1541	1621	14	6	80	0.0750000
NODE_1649_length_1778_cov_52.804050	1541	1621	19	4	80	0.0500000
NODE_1649_length_1778_cov_52.804050	1541	1621	21	5	80	0.0625000
NODE_1649_length_1778_cov_52.804050	1541	1621	25	18	80	0.2250000
NODE_1649_length_1778_cov_52.804050	1541	1621	29	1	80	0.0125000
NODE_1649_length_1778_cov_52.804050	1541	1621	31	3	80	0.0375000
NODE_1649_length_1778_cov_52.804050	1541	1621	34	11	80	0.1375000
NODE_1649_length_1778_cov_52.804050	1541	1621	36	1	80	0.0125000
NODE_1649_length_1778_cov_52.804050	1541	1621	38	15	80	0.1875000
NODE_1649_length_1778_cov_52.804050	1541	1621	39	4	80	0.0500000
NODE_1649_length_1778_cov_52.804050	1541	1621	40	6	80	0.0750000
NODE_1649_length_1778_cov_52.804050	1617	1697	27	4	80	0.0500000
NODE_1649_length_1778_cov_52.804050	1617	1697	28	10	80	0.1250000
NODE_1649_length_1778_cov_52.804050	1617	1697	29	1	80	0.0125000
NODE_1649_length_1778_cov_52.804050	1617	1697	30	6	80	0.0750000
NODE_1649_length_1778_cov_52.804050	1617	1697	31	6	80	0.0750000
NODE_1649_length_1778_cov_52.804050	1617	1697	33	3	80	0.0375000
NODE_1649_length_1778_cov_52.804050	1617	1697	36	23	80	0.2875000
NODE_1649_length_1778_cov_52.804050	1617	1697	37	15	80	0.1875000
NODE_1649_length_1778_cov_52.804050	1617	1697	40	12	80	0.1500000
NODE_1649_length_1778_cov_52.804050	1617	1697	27	4	80	0.0500000
NODE_1649_length_1778_cov_52.804050	1617	1697	28	10	80	0.1250000
NODE_1649_length_1778_cov_52.804050	1617	1697	29	1	80	0.0125000
NODE_1649_length_1778_cov_52.804050	1617	1697	30	6	80	0.0750000
NODE_1649_length_1778_cov_52.804050	1617	1697	31	6	80	0.0750000
NODE_1649_length_1778_cov_52.804050	1617	1697	33	3	80	0.0375000
NODE_1649_length_1778_cov_52.804050	1617	1697	36	23	80	0.2875000
NODE_1649_length_1778_cov_52.804050	1617	1697	37	15	80	0.1875000
NODE_1649_length_1778_cov_52.804050	1617	1697	40	12	80	0.1500000
NODE_1649_length_1778_cov_52.804050	1617	1697	27	4	80	0.0500000
NODE_1649_length_1778_cov_52.804050	1617	1697	28	10	80	0.1250000
NODE_1649_length_1778_cov_52.804050	1617	1697	29	1	80	0.0125000
NODE_1649_length_1778_cov_52.804050	1617	1697	30	6	80	0.0750000
NODE_1649_length_1778_cov_52.804050	1617	1697	31	6	80	0.0750000
NODE_1649_length_1778_cov_52.804050	1617	1697	33	3	80	0.0375000
NODE_1649_length_1778_cov_52.804050	1617	1697	36	23	80	0.2875000
NODE_1649_length_1778_cov_52.804050	1617	1697	37	15	80	0.1875000
NODE_1649_length_1778_cov_52.804050	1617	1697	40	12	80	0.1500000
NODE_1649_length_1778_cov_52.804050	1617	1697	27	4	80	0.0500000
NODE_1649_length_1778_cov_52.804050	1617	1697	28	10	80	0.1250000
NODE_1649_length_1778_cov_52.804050	1617	1697	29	1	80	0.0125000
NODE_1649_length_1778_cov_52.804050	1617	1697	30	6	80	0.0750000
NODE_1649_length_1778_cov_52.804050	1617	1697	31	6	80	0.0750000
NODE_1649_length_1778_cov_52.804050	1617	1697	33	3	80	0.0375000
NODE_1649_length_1778_cov_52.804050	1617	1697	36	23	80	0.2875000
NODE_1649_length_1778_cov_52.804050	1617	1697	37	15	80	0.1875000
NODE_1649_length_1778_cov_52.804050	1617	1697	40	12	80	0.1500000
NODE_1649_length_1778_cov_52.804050	1670	1750	3	4	80	0.0500000
NODE_1649_length_1778_cov_52.804050	1670	1750	6	1	80	0.0125000
NODE_1649_length_1778_cov_52.804050	1670	1750	9	11	80	0.1375000
NODE_1649_length_1778_cov_52.804050	1670	1750	12	3	80	0.0375000
NODE_1649_length_1778_cov_52.804050	1670	1750	14	1	80	0.0125000
NODE_1649_length_1778_cov_52.804050	1670	1750	18	18	80	0.2250000
NODE_1649_length_1778_cov_52.804050	1670	1750	20	5	80	0.0625000
NODE_1649_length_1778_cov_52.804050	1670	1750	21	1	80	0.0125000
NODE_1649_length_1778_cov_52.804050	1670	1750	22	2	80	0.0250000
NODE_1649_length_1778_cov_52.804050	1670	1750	24	1	80	0.0125000
NODE_1649_length_1778_cov_52.804050	1670	1750	27	10	80	0.1250000
NODE_1649_length_1778_cov_52.804050	1670	1750	28	10	80	0.1250000
NODE_1649_length_1778_cov_52.804050	1670	1750	29	1	80	0.0125000
NODE_1649_length_1778_cov_52.804050	1670	1750	30	6	80	0.0750000
NODE_1649_length_1778_cov_52.804050	1670	1750	31	6	80	0.0750000
NODE_1649_length_1778_cov_52.804050	1670	1750	3	4	80	0.0500000
NODE_1649_length_1778_cov_52.804050	1670	1750	6	1	80	0.0125000
NODE_1649_length_1778_cov_52.804050	1670	1750	9	11	80	0.1375000
NODE_1649_length_1778_cov_52.804050	1670	1750	12	3	80	0.0375000
NODE_1649_length_1778_cov_52.804050	1670	1750	14	1	80	0.0125000
NODE_1649_length_1778_cov_52.804050	1670	1750	18	18	80	0.2250000
NODE_1649_length_1778_cov_52.804050	1670	1750	20	5	80	0.0625000
NODE_1649_length_1778_cov_52.804050	1670	1750	21	1	80	0.0125000
NODE_1649_length_1778_cov_52.804050	1670	1750	22	2	80	0.0250000
NODE_1649_length_1778_cov_52.804050	1670	1750	24	1	80	0.0125000
NODE_1649_length_1778_cov_52.804050	1670	1750	27	10	80	0.1250000
NODE_1649_length_1778_cov_52.804050	1670	1750	28	10	80	0.1250000
NODE_1649_length_1778_cov_52.804050	1670	1750	29	1	80	0.0125000
NODE_1649_length_1778_cov_52.804050	1670	1750	30	6	80	0.0750000
NODE_1649_length_1778_cov_52.804050	1670	1750	31	6	80	0.0750000
NODE_1649_length_1778_cov_52.804050	1670	1750	3	4	80	0.0500000
NODE_1649_length_1778_cov_52.804050	1670	1750	6	1	80	0.0125000
NODE_1649_length_1778_cov_52.804050	1670	1750	9	11	80	0.1375000
NODE_1649_length_1778_cov_52.804050	1670	1750	12	3	80	0.0375000
NODE_1649_length_1778_cov_52.804050	1670	1750	14	1	80	0.0125000
NODE_1649_length_1778_cov_52.804050	1670	1750	18	18	80	0.2250000
NODE_1649_length_1778_cov_52.804050	1670	1750	20	5	80	0.0625000
NODE_1649_length_1778_cov_52.804050	1670	1750	21	1	80	0.0125000
NODE_1649_length_1778_cov_52.804050	1670	1750	22	2	80	0.0250000
NODE_1649_length_1778_cov_52.804050	1670	1750	24	1	80	0.0125000
NODE_1649_length_1778_cov_52.804050	1670	1750	27	10	80	0.1250000
NODE_1649_length_1778_cov_52.804050	1670	1750	28	10	80	0.1250000
NODE_1649_length_1778_cov_52.804050	1670	1750	29	1	80	0.0125000
NODE_1649_length_1778_cov_52.804050	1670	1750	30	6	80	0.0750000
NODE_1649_length_1778_cov_52.804050	1670	1750	31	6	80	0.0750000
NODE_1649_length_1778_cov_52.804050	1670	1741	9	7	71	0.0985916
NODE_1649_length_1778_cov_52.804050	1670	1741	12	3	71	0.0422535
NODE_1649_length_1778_cov_52.804050	1670	1741	14	1	71	0.0140845
NODE_1649_length_1778_cov_52.804050	1670	1741	18	18	71	0.2535211
NODE_1649_length_1778_cov_52.804050	1670	1741	20	5	71	0.0704225
NODE_1649_length_1778_cov_52.804050	1670	1741	21	1	71	0.0140845
NODE_1649_length_1778_cov_52.804050	1670	1741	22	2	71	0.0281690
NODE_1649_length_1778_cov_52.804050	1670	1741	24	1	71	0.0140845
NODE_1649_length_1778_cov_52.804050	1670	1741	27	10	71	0.1408451
NODE_1649_length_1778_cov_52.804050	1670	1741	28	10	71	0.1408451
NODE_1649_length_1778_cov_52.804050	1670	1741	29	1	71	0.0140845
NODE_1649_length_1778_cov_52.804050	1670	1741	30	6	71	0.0845070
NODE_1649_length_1778_cov_52.804050	1670	1741	31	6	71	0.0845070
NODE_1649_length_1778_cov_52.804050	1673	1743	9	9	70	0.1285714
NODE_1649_length_1778_cov_52.804050	1673	1743	12	3	70	0.0428571
NODE_1649_length_1778_cov_52.804050	1673	1743	14	1	70	0.0142857
NODE_1649_length_1778_cov_52.804050	1673	1743	18	18	70	0.2571429
NODE_1649_length_1778_cov_52.804050	1673	1743	20	5	70	0.0714286
NODE_1649_length_1778_cov_52.804050	1673	1743	21	1	70	0.0142857
NODE_1649_length_1778_cov_52.804050	1673	1743	22	2	70	0.0285714
NODE_1649_length_1778_cov_52.804050	1673	1743	24	1	70	0.0142857
NODE_1649_length_1778_cov_52.804050	1673	1743	27	10	70	0.1428571
NODE_1649_length_1778_cov_52.804050	1673	1743	28	10	70	0.1428571
NODE_1649_length_1778_cov_52.804050	1673	1743	29	1	70	0.0142857
NODE_1649_length_1778_cov_52.804050	1673	1743	30	4	70	0.0571429
NODE_1649_length_1778_cov_52.804050	1673	1743	31	5	70	0.0714286
NODE_1649_length_1778_cov_52.804050	1679	1750	3	4	71	0.0563380
NODE_1649_length_1778_cov_52.804050	1679	1750	6	1	71	0.0140845
NODE_1649_length_1778_cov_52.804050	1679	1750	9	11	71	0.1549296
NODE_1649_length_1778_cov_52.804050	1679	1750	12	3	71	0.0422535
NODE_1649_length_1778_cov_52.804050	1679	1750	14	1	71	0.0140845
NODE_1649_length_1778_cov_52.804050	1679	1750	18	18	71	0.2535211
NODE_1649_length_1778_cov_52.804050	1679	1750	20	5	71	0.0704225
NODE_1649_length_1778_cov_52.804050	1679	1750	21	1	71	0.0140845
NODE_1649_length_1778_cov_52.804050	1679	1750	22	2	71	0.0281690
NODE_1649_length_1778_cov_52.804050	1679	1750	24	1	71	0.0140845
NODE_1649_length_1778_cov_52.804050	1679	1750	27	10	71	0.1408451
NODE_1649_length_1778_cov_52.804050	1679	1750	28	10	71	0.1408451
NODE_1649_length_1778_cov_52.804050	1679	1750	29	1	71	0.0140845
NODE_1649_length_1778_cov_52.804050	1679	1750	30	3	71	0.0422535
NODE_1651_length_1776_cov_43.081694	1246	1308	18	62	62	1.0000000
NODE_1651_length_1776_cov_43.081694	1281	1361	17	2	80	0.0250000
NODE_1651_length_1776_cov_43.081694	1281	1361	18	78	80	0.9750000
NODE_1652_length_1776_cov_9.256410	1120	1200	1	27	80	0.3375000
NODE_1652_length_1776_cov_9.256410	1120	1200	2	13	80	0.1625000
NODE_1652_length_1776_cov_9.256410	1120	1200	3	32	80	0.4000000
NODE_1652_length_1776_cov_9.256410	1120	1200	6	8	80	0.1000000
NODE_1652_length_1776_cov_9.256410	1173	1253	3	19	80	0.2375000
NODE_1652_length_1776_cov_9.256410	1173	1253	6	9	80	0.1125000
NODE_1652_length_1776_cov_9.256410	1173	1253	7	17	80	0.2125000
NODE_1652_length_1776_cov_9.256410	1173	1253	8	13	80	0.1625000
NODE_1652_length_1776_cov_9.256410	1173	1253	9	3	80	0.0375000
NODE_1652_length_1776_cov_9.256410	1173	1253	10	6	80	0.0750000
NODE_1652_length_1776_cov_9.256410	1173	1253	11	13	80	0.1625000
NODE_1652_length_1776_cov_9.256410	1249	1329	10	9	80	0.1125000
NODE_1652_length_1776_cov_9.256410	1249	1329	11	12	80	0.1500000
NODE_1652_length_1776_cov_9.256410	1249	1329	12	9	80	0.1125000
NODE_1652_length_1776_cov_9.256410	1249	1329	13	15	80	0.1875000
NODE_1652_length_1776_cov_9.256410	1249	1329	14	28	80	0.3500000
NODE_1652_length_1776_cov_9.256410	1249	1329	15	7	80	0.0875000
NODE_1652_length_1776_cov_9.256410	1302	1382	8	1	80	0.0125000
NODE_1652_length_1776_cov_9.256410	1302	1382	9	13	80	0.1625000
NODE_1652_length_1776_cov_9.256410	1302	1382	10	17	80	0.2125000
NODE_1652_length_1776_cov_9.256410	1302	1382	11	9	80	0.1125000
NODE_1652_length_1776_cov_9.256410	1302	1382	13	15	80	0.1875000
NODE_1652_length_1776_cov_9.256410	1302	1382	14	18	80	0.2250000
NODE_1652_length_1776_cov_9.256410	1302	1382	15	7	80	0.0875000
NODE_1657_length_1775_cov_54.208234	1103	1167	13	1	64	0.0156250
NODE_1657_length_1775_cov_54.208234	1103	1167	14	4	64	0.0625000
NODE_1657_length_1775_cov_54.208234	1103	1167	15	1	64	0.0156250
NODE_1657_length_1775_cov_54.208234	1103	1167	16	1	64	0.0156250
NODE_1657_length_1775_cov_54.208234	1103	1167	17	8	64	0.1250000
NODE_1657_length_1775_cov_54.208234	1103	1167	19	2	64	0.0312500
NODE_1657_length_1775_cov_54.208234	1103	1167	21	5	64	0.0781250
NODE_1657_length_1775_cov_54.208234	1103	1167	22	1	64	0.0156250
NODE_1657_length_1775_cov_54.208234	1103	1167	23	1	64	0.0156250
NODE_1657_length_1775_cov_54.208234	1103	1167	25	2	64	0.0312500
NODE_1657_length_1775_cov_54.208234	1103	1167	28	1	64	0.0156250
NODE_1657_length_1775_cov_54.208234	1103	1167	29	5	64	0.0781250
NODE_1657_length_1775_cov_54.208234	1103	1167	30	8	64	0.1250000
NODE_1657_length_1775_cov_54.208234	1103	1167	32	1	64	0.0156250
NODE_1657_length_1775_cov_54.208234	1103	1167	34	1	64	0.0156250
NODE_1657_length_1775_cov_54.208234	1103	1167	35	6	64	0.0937500
NODE_1657_length_1775_cov_54.208234	1103	1167	36	16	64	0.2500000
NODE_1657_length_1775_cov_54.208234	1103	1167	13	1	64	0.0156250
NODE_1657_length_1775_cov_54.208234	1103	1167	14	4	64	0.0625000
NODE_1657_length_1775_cov_54.208234	1103	1167	15	1	64	0.0156250
NODE_1657_length_1775_cov_54.208234	1103	1167	16	1	64	0.0156250
NODE_1657_length_1775_cov_54.208234	1103	1167	17	8	64	0.1250000
NODE_1657_length_1775_cov_54.208234	1103	1167	19	2	64	0.0312500
NODE_1657_length_1775_cov_54.208234	1103	1167	21	5	64	0.0781250
NODE_1657_length_1775_cov_54.208234	1103	1167	22	1	64	0.0156250
NODE_1657_length_1775_cov_54.208234	1103	1167	23	1	64	0.0156250
NODE_1657_length_1775_cov_54.208234	1103	1167	25	2	64	0.0312500
NODE_1657_length_1775_cov_54.208234	1103	1167	28	1	64	0.0156250
NODE_1657_length_1775_cov_54.208234	1103	1167	29	5	64	0.0781250
NODE_1657_length_1775_cov_54.208234	1103	1167	30	8	64	0.1250000
NODE_1657_length_1775_cov_54.208234	1103	1167	32	1	64	0.0156250
NODE_1657_length_1775_cov_54.208234	1103	1167	34	1	64	0.0156250
NODE_1657_length_1775_cov_54.208234	1103	1167	35	6	64	0.0937500
NODE_1657_length_1775_cov_54.208234	1103	1167	36	16	64	0.2500000
NODE_1657_length_1775_cov_54.208234	1140	1200	7	2	60	0.0333333
NODE_1657_length_1775_cov_54.208234	1140	1200	8	16	60	0.2666667
NODE_1657_length_1775_cov_54.208234	1140	1200	10	1	60	0.0166667
NODE_1657_length_1775_cov_54.208234	1140	1200	11	6	60	0.1000000
NODE_1657_length_1775_cov_54.208234	1140	1200	13	1	60	0.0166667
NODE_1657_length_1775_cov_54.208234	1140	1200	14	12	60	0.2000000
NODE_1657_length_1775_cov_54.208234	1140	1200	15	1	60	0.0166667
NODE_1657_length_1775_cov_54.208234	1140	1200	16	1	60	0.0166667
NODE_1657_length_1775_cov_54.208234	1140	1200	17	8	60	0.1333333
NODE_1657_length_1775_cov_54.208234	1140	1200	19	2	60	0.0333333
NODE_1657_length_1775_cov_54.208234	1140	1200	21	5	60	0.0833333
NODE_1657_length_1775_cov_54.208234	1140	1200	22	1	60	0.0166667
NODE_1657_length_1775_cov_54.208234	1140	1200	23	1	60	0.0166667
NODE_1657_length_1775_cov_54.208234	1140	1200	25	2	60	0.0333333
NODE_1657_length_1775_cov_54.208234	1140	1200	28	1	60	0.0166667
NODE_1658_length_1775_cov_13.181981	1170	1250	3	19	80	0.2375000
NODE_1658_length_1775_cov_13.181981	1170	1250	4	45	80	0.5625000
NODE_1658_length_1775_cov_13.181981	1170	1250	5	16	80	0.2000000
NODE_1658_length_1775_cov_13.181981	1223	1303	2	27	80	0.3375000
NODE_1658_length_1775_cov_13.181981	1223	1303	3	24	80	0.3000000
NODE_1658_length_1775_cov_13.181981	1223	1303	4	29	80	0.3625000
NODE_1659_length_1775_cov_4.218974	1304	1384	4	43	80	0.5375000
NODE_1659_length_1775_cov_4.218974	1304	1384	5	13	80	0.1625000
NODE_1659_length_1775_cov_4.218974	1304	1384	6	24	80	0.3000000
NODE_1659_length_1775_cov_4.218974	1357	1437	4	12	80	0.1500000
NODE_1659_length_1775_cov_4.218974	1357	1437	5	5	80	0.0625000
NODE_1659_length_1775_cov_4.218974	1357	1437	6	63	80	0.7875000
NODE_1660_length_1774_cov_48.617313	345	425	6	11	80	0.1375000
NODE_1660_length_1774_cov_48.617313	345	425	10	46	80	0.5750000
NODE_1660_length_1774_cov_48.617313	345	425	11	23	80	0.2875000
NODE_1660_length_1774_cov_48.617313	398	478	6	6	80	0.0750000
NODE_1660_length_1774_cov_48.617313	398	478	7	9	80	0.1125000
NODE_1660_length_1774_cov_48.617313	398	478	8	5	80	0.0625000
NODE_1660_length_1774_cov_48.617313	398	478	9	28	80	0.3500000
NODE_1660_length_1774_cov_48.617313	398	478	10	32	80	0.4000000
NODE_1660_length_1774_cov_48.617313	474	554	5	48	80	0.6000000
NODE_1660_length_1774_cov_48.617313	474	554	7	2	80	0.0250000
NODE_1660_length_1774_cov_48.617313	474	554	8	15	80	0.1875000
NODE_1660_length_1774_cov_48.617313	474	554	10	15	80	0.1875000
NODE_1660_length_1774_cov_48.617313	527	607	4	18	80	0.2250000
NODE_1660_length_1774_cov_48.617313	527	607	5	62	80	0.7750000
NODE_1660_length_1774_cov_48.617313	1027	1107	11	5	80	0.0625000
NODE_1660_length_1774_cov_48.617313	1027	1107	12	61	80	0.7625000
NODE_1660_length_1774_cov_48.617313	1027	1107	13	2	80	0.0250000
NODE_1660_length_1774_cov_48.617313	1027	1107	14	8	80	0.1000000
NODE_1660_length_1774_cov_48.617313	1027	1107	15	4	80	0.0500000
NODE_1660_length_1774_cov_48.617313	1080	1160	6	5	80	0.0625000
NODE_1660_length_1774_cov_48.617313	1080	1160	7	7	80	0.0875000
NODE_1660_length_1774_cov_48.617313	1080	1160	8	7	80	0.0875000
NODE_1660_length_1774_cov_48.617313	1080	1160	9	22	80	0.2750000
NODE_1660_length_1774_cov_48.617313	1080	1160	10	4	80	0.0500000
NODE_1660_length_1774_cov_48.617313	1080	1160	11	10	80	0.1250000
NODE_1660_length_1774_cov_48.617313	1080	1160	12	23	80	0.2875000
NODE_1660_length_1774_cov_48.617313	1080	1160	13	2	80	0.0250000
NODE_1660_length_1774_cov_48.617313	1156	1236	8	1	80	0.0125000
NODE_1660_length_1774_cov_48.617313	1156	1236	12	29	80	0.3625000
NODE_1660_length_1774_cov_48.617313	1156	1236	13	9	80	0.1125000
NODE_1660_length_1774_cov_48.617313	1156	1236	14	14	80	0.1750000
NODE_1660_length_1774_cov_48.617313	1156	1236	16	13	80	0.1625000
NODE_1660_length_1774_cov_48.617313	1156	1236	17	14	80	0.1750000
NODE_1660_length_1774_cov_48.617313	1209	1289	13	9	80	0.1125000
NODE_1660_length_1774_cov_48.617313	1209	1289	14	7	80	0.0875000
NODE_1660_length_1774_cov_48.617313	1209	1289	15	5	80	0.0625000
NODE_1660_length_1774_cov_48.617313	1209	1289	16	38	80	0.4750000
NODE_1660_length_1774_cov_48.617313	1209	1289	17	14	80	0.1750000
NODE_1660_length_1774_cov_48.617313	1209	1289	18	7	80	0.0875000
NODE_1662_length_1774_cov_8.011343	1655	1735	0	80	80	1.0000000
NODE_1663_length_1773_cov_5.547192	433	513	8	4	80	0.0500000
NODE_1663_length_1773_cov_5.547192	433	513	9	36	80	0.4500000
NODE_1663_length_1773_cov_5.547192	433	513	10	20	80	0.2500000
NODE_1663_length_1773_cov_5.547192	433	513	11	10	80	0.1250000
NODE_1663_length_1773_cov_5.547192	433	513	12	10	80	0.1250000
NODE_1663_length_1773_cov_5.547192	486	566	9	25	80	0.3125000
NODE_1663_length_1773_cov_5.547192	486	566	11	48	80	0.6000000
NODE_1663_length_1773_cov_5.547192	486	566	12	7	80	0.0875000
NODE_1664_length_1773_cov_3.925329	267	347	0	80	80	1.0000000
NODE_1664_length_1773_cov_3.925329	320	400	0	80	80	1.0000000
NODE_1666_length_1770_cov_9.912029	369	437	6	27	68	0.3970588
NODE_1666_length_1770_cov_9.912029	369	437	10	41	68	0.6029412
NODE_1666_length_1770_cov_9.912029	388	431	6	8	43	0.1860465
NODE_1666_length_1770_cov_9.912029	388	431	10	35	43	0.8139535
NODE_1666_length_1770_cov_9.912029	509	577	5	6	68	0.0882353
NODE_1666_length_1770_cov_9.912029	509	577	6	26	68	0.3823529
NODE_1666_length_1770_cov_9.912029	509	577	7	28	68	0.4117647
NODE_1666_length_1770_cov_9.912029	509	577	9	8	68	0.1176471
NODE_1666_length_1770_cov_9.912029	515	571	6	26	56	0.4642857
NODE_1666_length_1770_cov_9.912029	515	571	7	28	56	0.5000000
NODE_1666_length_1770_cov_9.912029	515	571	9	2	56	0.0357143
NODE_1666_length_1770_cov_9.912029	579	618	4	24	39	0.6153846
NODE_1666_length_1770_cov_9.912029	579	618	6	6	39	0.1538462
NODE_1666_length_1770_cov_9.912029	579	618	7	6	39	0.1538462
NODE_1666_length_1770_cov_9.912029	579	618	9	3	39	0.0769231
NODE_1666_length_1770_cov_9.912029	697	776	0	4	79	0.0506329
NODE_1666_length_1770_cov_9.912029	697	776	1	1	79	0.0126582
NODE_1666_length_1770_cov_9.912029	697	776	2	74	79	0.9367089
NODE_1666_length_1770_cov_9.912029	714	794	2	80	80	1.0000000
NODE_1666_length_1770_cov_9.912029	767	819	2	52	52	1.0000000
NODE_1666_length_1770_cov_9.912029	785	819	2	34	34	1.0000000
NODE_1667_length_1768_cov_9.134811	687	736	4	43	49	0.8775510
NODE_1667_length_1768_cov_9.134811	687	736	5	6	49	0.1224490
NODE_1668_length_1768_cov_6.605153	1207	1287	0	10	80	0.1250000
NODE_1668_length_1768_cov_6.605153	1207	1287	1	40	80	0.5000000
NODE_1668_length_1768_cov_6.605153	1207	1287	2	30	80	0.3750000
NODE_1668_length_1768_cov_6.605153	1260	1340	2	80	80	1.0000000
NODE_1668_length_1768_cov_6.605153	1336	1416	0	9	80	0.1125000
NODE_1668_length_1768_cov_6.605153	1336	1416	1	40	80	0.5000000
NODE_1668_length_1768_cov_6.605153	1336	1416	2	31	80	0.3875000
NODE_1668_length_1768_cov_6.605153	1389	1469	0	62	80	0.7750000
NODE_1668_length_1768_cov_6.605153	1389	1469	1	18	80	0.2250000
NODE_1669_length_1767_cov_5.475420	508	588	6	12	80	0.1500000
NODE_1669_length_1767_cov_5.475420	508	588	7	38	80	0.4750000
NODE_1669_length_1767_cov_5.475420	508	588	8	7	80	0.0875000
NODE_1669_length_1767_cov_5.475420	508	588	10	23	80	0.2875000
NODE_1680_length_1762_cov_18.673482	606	686	2	5	80	0.0625000
NODE_1680_length_1762_cov_18.673482	606	686	4	7	80	0.0875000
NODE_1680_length_1762_cov_18.673482	606	686	5	47	80	0.5875000
NODE_1680_length_1762_cov_18.673482	606	686	6	2	80	0.0250000
NODE_1680_length_1762_cov_18.673482	606	686	7	19	80	0.2375000
NODE_1680_length_1762_cov_18.673482	659	739	4	6	80	0.0750000
NODE_1680_length_1762_cov_18.673482	659	739	6	2	80	0.0250000
NODE_1680_length_1762_cov_18.673482	659	739	7	72	80	0.9000000
NODE_1680_length_1762_cov_18.673482	735	815	3	6	80	0.0750000
NODE_1680_length_1762_cov_18.673482	735	815	4	2	80	0.0250000
NODE_1680_length_1762_cov_18.673482	735	815	5	63	80	0.7875000
NODE_1680_length_1762_cov_18.673482	735	815	7	9	80	0.1125000
NODE_1680_length_1762_cov_18.673482	788	868	0	53	80	0.6625000
NODE_1680_length_1762_cov_18.673482	788	868	3	6	80	0.0750000
NODE_1680_length_1762_cov_18.673482	788	868	4	2	80	0.0250000
NODE_1680_length_1762_cov_18.673482	788	868	5	19	80	0.2375000
NODE_1681_length_1762_cov_6.760072	1033	1113	6	35	80	0.4375000
NODE_1681_length_1762_cov_6.760072	1033	1113	7	45	80	0.5625000
NODE_1681_length_1762_cov_6.760072	1086	1166	7	59	80	0.7375000
NODE_1681_length_1762_cov_6.760072	1086	1166	11	1	80	0.0125000
NODE_1681_length_1762_cov_6.760072	1086	1166	12	20	80	0.2500000
NODE_1685_length_1760_cov_8.064419	941	1021	0	80	80	1.0000000
NODE_1685_length_1760_cov_8.064419	994	1074	0	80	80	1.0000000
NODE_1692_length_1758_cov_99.869198	599	679	20	1	80	0.0125000
NODE_1692_length_1758_cov_99.869198	599	679	22	3	80	0.0375000
NODE_1692_length_1758_cov_99.869198	599	679	23	1	80	0.0125000
NODE_1692_length_1758_cov_99.869198	599	679	24	4	80	0.0500000
NODE_1692_length_1758_cov_99.869198	599	679	25	7	80	0.0875000
NODE_1692_length_1758_cov_99.869198	599	679	26	5	80	0.0625000
NODE_1692_length_1758_cov_99.869198	599	679	27	19	80	0.2375000
NODE_1692_length_1758_cov_99.869198	599	679	28	7	80	0.0875000
NODE_1692_length_1758_cov_99.869198	599	679	31	5	80	0.0625000
NODE_1692_length_1758_cov_99.869198	599	679	33	3	80	0.0375000
NODE_1692_length_1758_cov_99.869198	599	679	34	3	80	0.0375000
NODE_1692_length_1758_cov_99.869198	599	679	35	14	80	0.1750000
NODE_1692_length_1758_cov_99.869198	599	679	37	1	80	0.0125000
NODE_1692_length_1758_cov_99.869198	599	679	38	3	80	0.0375000
NODE_1692_length_1758_cov_99.869198	599	679	39	4	80	0.0500000
NODE_1692_length_1758_cov_99.869198	652	732	32	2	80	0.0250000
NODE_1692_length_1758_cov_99.869198	652	732	33	6	80	0.0750000
NODE_1692_length_1758_cov_99.869198	652	732	34	2	80	0.0250000
NODE_1692_length_1758_cov_99.869198	652	732	35	14	80	0.1750000
NODE_1692_length_1758_cov_99.869198	652	732	36	3	80	0.0375000
NODE_1692_length_1758_cov_99.869198	652	732	37	1	80	0.0125000
NODE_1692_length_1758_cov_99.869198	652	732	38	4	80	0.0500000
NODE_1692_length_1758_cov_99.869198	652	732	39	6	80	0.0750000
NODE_1692_length_1758_cov_99.869198	652	732	41	7	80	0.0875000
NODE_1692_length_1758_cov_99.869198	652	732	43	1	80	0.0125000
NODE_1692_length_1758_cov_99.869198	652	732	46	3	80	0.0375000
NODE_1692_length_1758_cov_99.869198	652	732	48	3	80	0.0375000
NODE_1692_length_1758_cov_99.869198	652	732	50	2	80	0.0250000
NODE_1692_length_1758_cov_99.869198	652	732	51	3	80	0.0375000
NODE_1692_length_1758_cov_99.869198	652	732	52	11	80	0.1375000
NODE_1692_length_1758_cov_99.869198	652	732	53	1	80	0.0125000
NODE_1692_length_1758_cov_99.869198	652	732	54	6	80	0.0750000
NODE_1692_length_1758_cov_99.869198	652	732	57	1	80	0.0125000
NODE_1692_length_1758_cov_99.869198	652	732	58	2	80	0.0250000
NODE_1692_length_1758_cov_99.869198	652	732	60	2	80	0.0250000
NODE_1692_length_1758_cov_99.869198	728	808	58	2	80	0.0250000
NODE_1692_length_1758_cov_99.869198	728	808	60	7	80	0.0875000
NODE_1692_length_1758_cov_99.869198	728	808	61	13	80	0.1625000
NODE_1692_length_1758_cov_99.869198	728	808	62	9	80	0.1125000
NODE_1692_length_1758_cov_99.869198	728	808	63	8	80	0.1000000
NODE_1692_length_1758_cov_99.869198	728	808	64	12	80	0.1500000
NODE_1692_length_1758_cov_99.869198	728	808	65	7	80	0.0875000
NODE_1692_length_1758_cov_99.869198	728	808	66	3	80	0.0375000
NODE_1692_length_1758_cov_99.869198	728	808	67	12	80	0.1500000
NODE_1692_length_1758_cov_99.869198	728	808	68	1	80	0.0125000
NODE_1692_length_1758_cov_99.869198	728	808	69	1	80	0.0125000
NODE_1692_length_1758_cov_99.869198	728	808	71	2	80	0.0250000
NODE_1692_length_1758_cov_99.869198	728	808	72	3	80	0.0375000
NODE_1692_length_1758_cov_99.869198	781	861	42	3	80	0.0375000
NODE_1692_length_1758_cov_99.869198	781	861	43	4	80	0.0500000
NODE_1692_length_1758_cov_99.869198	781	861	46	3	80	0.0375000
NODE_1692_length_1758_cov_99.869198	781	861	47	1	80	0.0125000
NODE_1692_length_1758_cov_99.869198	781	861	48	2	80	0.0250000
NODE_1692_length_1758_cov_99.869198	781	861	50	5	80	0.0625000
NODE_1692_length_1758_cov_99.869198	781	861	51	2	80	0.0250000
NODE_1692_length_1758_cov_99.869198	781	861	52	4	80	0.0500000
NODE_1692_length_1758_cov_99.869198	781	861	53	2	80	0.0250000
NODE_1692_length_1758_cov_99.869198	781	861	55	2	80	0.0250000
NODE_1692_length_1758_cov_99.869198	781	861	56	8	80	0.1000000
NODE_1692_length_1758_cov_99.869198	781	861	57	6	80	0.0750000
NODE_1692_length_1758_cov_99.869198	781	861	61	17	80	0.2125000
NODE_1692_length_1758_cov_99.869198	781	861	64	1	80	0.0125000
NODE_1692_length_1758_cov_99.869198	781	861	66	2	80	0.0250000
NODE_1692_length_1758_cov_99.869198	781	861	67	11	80	0.1375000
NODE_1692_length_1758_cov_99.869198	781	861	68	1	80	0.0125000
NODE_1692_length_1758_cov_99.869198	781	861	69	1	80	0.0125000
NODE_1692_length_1758_cov_99.869198	781	861	71	2	80	0.0250000
NODE_1692_length_1758_cov_99.869198	781	861	72	3	80	0.0375000
NODE_1693_length_1757_cov_3.126659	49	121	0	72	72	1.0000000
NODE_1696_length_1755_cov_9.938406	231	311	2	41	80	0.5125000
NODE_1696_length_1755_cov_9.938406	231	311	3	24	80	0.3000000
NODE_1696_length_1755_cov_9.938406	231	311	4	12	80	0.1500000
NODE_1696_length_1755_cov_9.938406	231	311	5	3	80	0.0375000
NODE_1696_length_1755_cov_9.938406	284	364	3	12	80	0.1500000
NODE_1696_length_1755_cov_9.938406	284	364	4	47	80	0.5875000
NODE_1696_length_1755_cov_9.938406	284	364	5	21	80	0.2625000
NODE_1698_length_1755_cov_3.614130	171	222	2	51	51	1.0000000
NODE_1699_length_1754_cov_8.523263	0	77	0	77	77	1.0000000
NODE_1699_length_1754_cov_8.523263	0	77	0	77	77	1.0000000
NODE_1699_length_1754_cov_8.523263	0	77	0	77	77	1.0000000
NODE_1699_length_1754_cov_8.523263	50	99	0	49	49	1.0000000
NODE_1699_length_1754_cov_8.523263	53	99	0	46	46	1.0000000
NODE_1699_length_1754_cov_8.523263	55	99	0	44	44	1.0000000
NODE_1700_length_1753_cov_26.851874	356	436	1	16	80	0.2000000
NODE_1700_length_1753_cov_26.851874	356	436	2	64	80	0.8000000
NODE_1700_length_1753_cov_26.851874	409	489	1	69	80	0.8625000
NODE_1700_length_1753_cov_26.851874	409	489	2	11	80	0.1375000
NODE_1701_length_1753_cov_12.297461	355	435	7	1	80	0.0125000
NODE_1701_length_1753_cov_12.297461	355	435	9	24	80	0.3000000
NODE_1701_length_1753_cov_12.297461	355	435	10	21	80	0.2625000
NODE_1701_length_1753_cov_12.297461	355	435	11	10	80	0.1250000
NODE_1701_length_1753_cov_12.297461	355	435	12	24	80	0.3000000
NODE_1701_length_1753_cov_12.297461	408	488	5	3	80	0.0375000
NODE_1701_length_1753_cov_12.297461	408	488	7	5	80	0.0625000
NODE_1701_length_1753_cov_12.297461	408	488	8	19	80	0.2375000
NODE_1701_length_1753_cov_12.297461	408	488	9	24	80	0.3000000
NODE_1701_length_1753_cov_12.297461	408	488	10	3	80	0.0375000
NODE_1701_length_1753_cov_12.297461	408	488	11	1	80	0.0125000
NODE_1701_length_1753_cov_12.297461	408	488	12	25	80	0.3125000
NODE_1705_length_1750_cov_90.732283	1191	1254	25	5	63	0.0793651
NODE_1705_length_1750_cov_90.732283	1191	1254	26	6	63	0.0952381
NODE_1705_length_1750_cov_90.732283	1191	1254	27	8	63	0.1269841
NODE_1705_length_1750_cov_90.732283	1191	1254	28	16	63	0.2539683
NODE_1705_length_1750_cov_90.732283	1191	1254	29	19	63	0.3015873
NODE_1705_length_1750_cov_90.732283	1191	1254	30	9	63	0.1428571
NODE_1705_length_1750_cov_90.732283	1239	1310	26	1	71	0.0140845
NODE_1705_length_1750_cov_90.732283	1239	1310	27	2	71	0.0281690
NODE_1705_length_1750_cov_90.732283	1239	1310	28	11	71	0.1549296
NODE_1705_length_1750_cov_90.732283	1239	1310	29	17	71	0.2394366
NODE_1705_length_1750_cov_90.732283	1239	1310	30	19	71	0.2676056
NODE_1705_length_1750_cov_90.732283	1239	1310	31	16	71	0.2253521
NODE_1705_length_1750_cov_90.732283	1239	1310	32	5	71	0.0704225
NODE_1711_length_1746_cov_3.095932	458	524	0	66	66	1.0000000
NODE_1712_length_1745_cov_7.646416	430	510	7	25	80	0.3125000
NODE_1712_length_1745_cov_7.646416	430	510	8	24	80	0.3000000
NODE_1712_length_1745_cov_7.646416	430	510	11	3	80	0.0375000
NODE_1712_length_1745_cov_7.646416	430	510	12	28	80	0.3500000
NODE_1712_length_1745_cov_7.646416	483	563	7	18	80	0.2250000
NODE_1712_length_1745_cov_7.646416	483	563	9	18	80	0.2250000
NODE_1712_length_1745_cov_7.646416	483	563	10	16	80	0.2000000
NODE_1712_length_1745_cov_7.646416	483	563	11	3	80	0.0375000
NODE_1712_length_1745_cov_7.646416	483	563	12	25	80	0.3125000
NODE_1715_length_1744_cov_10.144681	1213	1289	0	15	76	0.1973684
NODE_1715_length_1744_cov_10.144681	1213	1289	1	16	76	0.2105263
NODE_1715_length_1744_cov_10.144681	1213	1289	3	6	76	0.0789474
NODE_1715_length_1744_cov_10.144681	1213	1289	4	39	76	0.5131579
NODE_1715_length_1744_cov_10.144681	1262	1342	4	80	80	1.0000000
NODE_1719_length_1742_cov_18.923311	699	776	12	10	77	0.1298701
NODE_1719_length_1742_cov_18.923311	699	776	13	1	77	0.0129870
NODE_1719_length_1742_cov_18.923311	699	776	14	1	77	0.0129870
NODE_1719_length_1742_cov_18.923311	699	776	15	1	77	0.0129870
NODE_1719_length_1742_cov_18.923311	699	776	18	10	77	0.1298701
NODE_1719_length_1742_cov_18.923311	699	776	19	4	77	0.0519481
NODE_1719_length_1742_cov_18.923311	699	776	21	1	77	0.0129870
NODE_1719_length_1742_cov_18.923311	699	776	22	14	77	0.1818182
NODE_1719_length_1742_cov_18.923311	699	776	23	27	77	0.3506494
NODE_1719_length_1742_cov_18.923311	699	776	24	2	77	0.0259740
NODE_1719_length_1742_cov_18.923311	699	776	25	6	77	0.0779221
NODE_1719_length_1742_cov_18.923311	749	829	17	24	80	0.3000000
NODE_1719_length_1742_cov_18.923311	749	829	18	3	80	0.0375000
NODE_1719_length_1742_cov_18.923311	749	829	21	4	80	0.0500000
NODE_1719_length_1742_cov_18.923311	749	829	22	10	80	0.1250000
NODE_1719_length_1742_cov_18.923311	749	829	23	31	80	0.3875000
NODE_1719_length_1742_cov_18.923311	749	829	24	8	80	0.1000000
NODE_1722_length_1741_cov_7.657734	1234	1314	0	80	80	1.0000000
NODE_1722_length_1741_cov_7.657734	1287	1367	0	80	80	1.0000000
NODE_1722_length_1741_cov_7.657734	1363	1443	0	80	80	1.0000000
NODE_1722_length_1741_cov_7.657734	1416	1496	0	80	80	1.0000000
NODE_1726_length_1740_cov_38.411335	517	597	13	3	80	0.0375000
NODE_1726_length_1740_cov_38.411335	517	597	14	6	80	0.0750000
NODE_1726_length_1740_cov_38.411335	517	597	15	9	80	0.1125000
NODE_1726_length_1740_cov_38.411335	517	597	18	2	80	0.0250000
NODE_1726_length_1740_cov_38.411335	517	597	19	10	80	0.1250000
NODE_1726_length_1740_cov_38.411335	517	597	20	2	80	0.0250000
NODE_1726_length_1740_cov_38.411335	517	597	22	6	80	0.0750000
NODE_1726_length_1740_cov_38.411335	517	597	25	11	80	0.1375000
NODE_1726_length_1740_cov_38.411335	517	597	26	11	80	0.1375000
NODE_1726_length_1740_cov_38.411335	517	597	28	2	80	0.0250000
NODE_1726_length_1740_cov_38.411335	517	597	29	3	80	0.0375000
NODE_1726_length_1740_cov_38.411335	517	597	30	15	80	0.1875000
NODE_1726_length_1740_cov_38.411335	570	650	26	7	80	0.0875000
NODE_1726_length_1740_cov_38.411335	570	650	28	6	80	0.0750000
NODE_1726_length_1740_cov_38.411335	570	650	29	6	80	0.0750000
NODE_1726_length_1740_cov_38.411335	570	650	30	25	80	0.3125000
NODE_1726_length_1740_cov_38.411335	570	650	32	7	80	0.0875000
NODE_1726_length_1740_cov_38.411335	570	650	33	18	80	0.2250000
NODE_1726_length_1740_cov_38.411335	570	650	34	5	80	0.0625000
NODE_1726_length_1740_cov_38.411335	570	650	35	6	80	0.0750000
NODE_1726_length_1740_cov_38.411335	646	726	24	2	80	0.0250000
NODE_1726_length_1740_cov_38.411335	646	726	25	19	80	0.2375000
NODE_1726_length_1740_cov_38.411335	646	726	28	6	80	0.0750000
NODE_1726_length_1740_cov_38.411335	646	726	29	4	80	0.0500000
NODE_1726_length_1740_cov_38.411335	646	726	30	6	80	0.0750000
NODE_1726_length_1740_cov_38.411335	646	726	31	12	80	0.1500000
NODE_1726_length_1740_cov_38.411335	646	726	33	14	80	0.1750000
NODE_1726_length_1740_cov_38.411335	646	726	34	6	80	0.0750000
NODE_1726_length_1740_cov_38.411335	646	726	35	11	80	0.1375000
NODE_1726_length_1740_cov_38.411335	699	779	19	3	80	0.0375000
NODE_1726_length_1740_cov_38.411335	699	779	20	12	80	0.1500000
NODE_1726_length_1740_cov_38.411335	699	779	22	9	80	0.1125000
NODE_1726_length_1740_cov_38.411335	699	779	23	3	80	0.0375000
NODE_1726_length_1740_cov_38.411335	699	779	24	27	80	0.3375000
NODE_1726_length_1740_cov_38.411335	699	779	25	20	80	0.2500000
NODE_1726_length_1740_cov_38.411335	699	779	28	6	80	0.0750000
NODE_1727_length_1740_cov_10.843388	552	632	3	11	80	0.1375000
NODE_1727_length_1740_cov_10.843388	552	632	4	15	80	0.1875000
NODE_1727_length_1740_cov_10.843388	552	632	5	16	80	0.2000000
NODE_1727_length_1740_cov_10.843388	552	632	6	38	80	0.4750000
NODE_1727_length_1740_cov_10.843388	708	788	4	70	80	0.8750000
NODE_1727_length_1740_cov_10.843388	708	788	5	10	80	0.1250000
NODE_1727_length_1740_cov_10.843388	708	788	4	70	80	0.8750000
NODE_1727_length_1740_cov_10.843388	708	788	5	10	80	0.1250000
NODE_1727_length_1740_cov_10.843388	708	788	4	70	80	0.8750000
NODE_1727_length_1740_cov_10.843388	708	788	5	10	80	0.1250000
NODE_1727_length_1740_cov_10.843388	761	841	0	2	80	0.0250000
NODE_1727_length_1740_cov_10.843388	761	841	2	6	80	0.0750000
NODE_1727_length_1740_cov_10.843388	761	841	4	72	80	0.9000000
NODE_1727_length_1740_cov_10.843388	761	808	4	47	47	1.0000000
NODE_1727_length_1740_cov_10.843388	761	808	4	47	47	1.0000000
NODE_1737_length_1736_cov_71.959682	841	901	31	4	60	0.0666667
NODE_1737_length_1736_cov_71.959682	841	901	32	3	60	0.0500000
NODE_1737_length_1736_cov_71.959682	841	901	33	6	60	0.1000000
NODE_1737_length_1736_cov_71.959682	841	901	34	3	60	0.0500000
NODE_1737_length_1736_cov_71.959682	841	901	35	12	60	0.2000000
NODE_1737_length_1736_cov_71.959682	841	901	36	14	60	0.2333333
NODE_1737_length_1736_cov_71.959682	841	901	37	17	60	0.2833333
NODE_1737_length_1736_cov_71.959682	841	901	38	1	60	0.0166667
NODE_1738_length_1736_cov_29.174710	1361	1390	4	2	29	0.0689655
NODE_1738_length_1736_cov_29.174710	1361	1390	5	27	29	0.9310345
NODE_1738_length_1736_cov_29.174710	1566	1628	6	11	62	0.1774193
NODE_1738_length_1736_cov_29.174710	1566	1628	7	30	62	0.4838710
NODE_1738_length_1736_cov_29.174710	1566	1628	8	11	62	0.1774193
NODE_1738_length_1736_cov_29.174710	1566	1628	9	10	62	0.1612903
NODE_1743_length_1732_cov_6.162890	807	887	0	80	80	1.0000000
NODE_1743_length_1732_cov_6.162890	860	940	0	80	80	1.0000000
NODE_1749_length_1729_cov_23.708589	364	443	8	9	79	0.1139240
NODE_1749_length_1729_cov_23.708589	364	443	10	5	79	0.0632911
NODE_1749_length_1729_cov_23.708589	364	443	11	41	79	0.5189874
NODE_1749_length_1729_cov_23.708589	364	443	12	22	79	0.2784810
NODE_1749_length_1729_cov_23.708589	364	443	13	2	79	0.0253165
NODE_1749_length_1729_cov_23.708589	416	496	10	10	80	0.1250000
NODE_1749_length_1729_cov_23.708589	416	496	11	13	80	0.1625000
NODE_1749_length_1729_cov_23.708589	416	496	12	32	80	0.4000000
NODE_1749_length_1729_cov_23.708589	416	496	13	6	80	0.0750000
NODE_1749_length_1729_cov_23.708589	416	496	14	6	80	0.0750000
NODE_1749_length_1729_cov_23.708589	416	496	15	5	80	0.0625000
NODE_1749_length_1729_cov_23.708589	416	496	16	8	80	0.1000000
NODE_1749_length_1729_cov_23.708589	492	572	4	6	80	0.0750000
NODE_1749_length_1729_cov_23.708589	492	572	6	10	80	0.1250000
NODE_1749_length_1729_cov_23.708589	492	572	7	28	80	0.3500000
NODE_1749_length_1729_cov_23.708589	492	572	8	5	80	0.0625000
NODE_1749_length_1729_cov_23.708589	492	572	10	31	80	0.3875000
NODE_1749_length_1729_cov_23.708589	545	625	0	16	80	0.2000000
NODE_1749_length_1729_cov_23.708589	545	625	1	9	80	0.1125000
NODE_1749_length_1729_cov_23.708589	545	625	2	2	80	0.0250000
NODE_1749_length_1729_cov_23.708589	545	625	4	32	80	0.4000000
NODE_1749_length_1729_cov_23.708589	545	625	6	10	80	0.1250000
NODE_1749_length_1729_cov_23.708589	545	625	7	11	80	0.1375000
NODE_1753_length_1728_cov_26.505832	259	339	1	29	80	0.3625000
NODE_1753_length_1728_cov_26.505832	259	339	2	29	80	0.3625000
NODE_1753_length_1728_cov_26.505832	259	339	4	22	80	0.2750000
NODE_1753_length_1728_cov_26.505832	312	392	2	76	80	0.9500000
NODE_1753_length_1728_cov_26.505832	312	392	3	4	80	0.0500000
NODE_1757_length_1725_cov_142.158057	767	814	35	1	47	0.0212766
NODE_1757_length_1725_cov_142.158057	767	814	39	4	47	0.0851064
NODE_1757_length_1725_cov_142.158057	767	814	40	16	47	0.3404255
NODE_1757_length_1725_cov_142.158057	767	814	41	14	47	0.2978723
NODE_1757_length_1725_cov_142.158057	767	814	42	11	47	0.2340426
NODE_1757_length_1725_cov_142.158057	767	814	43	1	47	0.0212766
NODE_1757_length_1725_cov_142.158057	803	867	28	6	64	0.0937500
NODE_1757_length_1725_cov_142.158057	803	867	29	8	64	0.1250000
NODE_1757_length_1725_cov_142.158057	803	867	30	5	64	0.0781250
NODE_1757_length_1725_cov_142.158057	803	867	31	2	64	0.0312500
NODE_1757_length_1725_cov_142.158057	803	867	33	18	64	0.2812500
NODE_1757_length_1725_cov_142.158057	803	867	34	7	64	0.1093750
NODE_1757_length_1725_cov_142.158057	803	867	41	4	64	0.0625000
NODE_1757_length_1725_cov_142.158057	803	867	42	7	64	0.1093750
NODE_1757_length_1725_cov_142.158057	803	867	43	5	64	0.0781250
NODE_1757_length_1725_cov_142.158057	803	867	44	2	64	0.0312500
NODE_1759_length_1724_cov_17.931077	677	746	0	28	69	0.4057971
NODE_1759_length_1724_cov_17.931077	677	746	1	1	69	0.0144928
NODE_1759_length_1724_cov_17.931077	677	746	2	33	69	0.4782609
NODE_1759_length_1724_cov_17.931077	677	746	3	1	69	0.0144928
NODE_1759_length_1724_cov_17.931077	677	746	4	5	69	0.0724638
NODE_1759_length_1724_cov_17.931077	677	746	6	1	69	0.0144928
NODE_1759_length_1724_cov_17.931077	788	850	10	9	62	0.1451613
NODE_1759_length_1724_cov_17.931077	788	850	13	46	62	0.7419355
NODE_1759_length_1724_cov_17.931077	788	850	14	7	62	0.1129032
NODE_1761_length_1723_cov_35.355296	1174	1254	14	8	80	0.1000000
NODE_1761_length_1723_cov_35.355296	1174	1254	15	2	80	0.0250000
NODE_1761_length_1723_cov_35.355296	1174	1254	16	21	80	0.2625000
NODE_1761_length_1723_cov_35.355296	1174	1254	17	2	80	0.0250000
NODE_1761_length_1723_cov_35.355296	1174	1254	18	16	80	0.2000000
NODE_1761_length_1723_cov_35.355296	1174	1254	19	3	80	0.0375000
NODE_1761_length_1723_cov_35.355296	1174	1254	20	26	80	0.3250000
NODE_1761_length_1723_cov_35.355296	1174	1254	21	2	80	0.0250000
NODE_1761_length_1723_cov_35.355296	1227	1307	8	12	80	0.1500000
NODE_1761_length_1723_cov_35.355296	1227	1307	13	10	80	0.1250000
NODE_1761_length_1723_cov_35.355296	1227	1307	14	28	80	0.3500000
NODE_1761_length_1723_cov_35.355296	1227	1307	15	5	80	0.0625000
NODE_1761_length_1723_cov_35.355296	1227	1307	16	12	80	0.1500000
NODE_1761_length_1723_cov_35.355296	1227	1307	17	2	80	0.0250000
NODE_1761_length_1723_cov_35.355296	1227	1307	18	5	80	0.0625000
NODE_1761_length_1723_cov_35.355296	1227	1307	19	2	80	0.0250000
NODE_1761_length_1723_cov_35.355296	1227	1307	20	4	80	0.0500000
NODE_1763_length_1722_cov_13.235367	708	788	10	5	80	0.0625000
NODE_1763_length_1722_cov_13.235367	708	788	11	46	80	0.5750000
NODE_1763_length_1722_cov_13.235367	708	788	12	9	80	0.1125000
NODE_1763_length_1722_cov_13.235367	708	788	13	13	80	0.1625000
NODE_1763_length_1722_cov_13.235367	708	788	14	7	80	0.0875000
NODE_1763_length_1722_cov_13.235367	761	841	10	10	80	0.1250000
NODE_1763_length_1722_cov_13.235367	761	841	11	3	80	0.0375000
NODE_1763_length_1722_cov_13.235367	761	841	12	6	80	0.0750000
NODE_1763_length_1722_cov_13.235367	761	841	13	18	80	0.2250000
NODE_1763_length_1722_cov_13.235367	761	841	14	43	80	0.5375000
NODE_1763_length_1722_cov_13.235367	1319	1399	0	80	80	1.0000000
NODE_1763_length_1722_cov_13.235367	1372	1452	0	80	80	1.0000000
NODE_1765_length_1720_cov_27.328192	1248	1307	51	1	59	0.0169492
NODE_1765_length_1720_cov_27.328192	1248	1307	52	1	59	0.0169492
NODE_1765_length_1720_cov_27.328192	1248	1307	57	4	59	0.0677966
NODE_1765_length_1720_cov_27.328192	1248	1307	58	1	59	0.0169492
NODE_1765_length_1720_cov_27.328192	1248	1307	60	5	59	0.0847458
NODE_1765_length_1720_cov_27.328192	1248	1307	61	3	59	0.0508475
NODE_1765_length_1720_cov_27.328192	1248	1307	63	4	59	0.0677966
NODE_1765_length_1720_cov_27.328192	1248	1307	64	8	59	0.1355932
NODE_1765_length_1720_cov_27.328192	1248	1307	65	1	59	0.0169492
NODE_1765_length_1720_cov_27.328192	1248	1307	67	3	59	0.0508475
NODE_1765_length_1720_cov_27.328192	1248	1307	68	2	59	0.0338983
NODE_1765_length_1720_cov_27.328192	1248	1307	69	3	59	0.0508475
NODE_1765_length_1720_cov_27.328192	1248	1307	70	10	59	0.1694915
NODE_1765_length_1720_cov_27.328192	1248	1307	71	1	59	0.0169492
NODE_1765_length_1720_cov_27.328192	1248	1307	74	1	59	0.0169492
NODE_1765_length_1720_cov_27.328192	1248	1307	75	5	59	0.0847458
NODE_1765_length_1720_cov_27.328192	1248	1307	76	1	59	0.0169492
NODE_1765_length_1720_cov_27.328192	1248	1307	77	2	59	0.0338983
NODE_1765_length_1720_cov_27.328192	1248	1307	80	1	59	0.0169492
NODE_1765_length_1720_cov_27.328192	1248	1307	81	2	59	0.0338983
NODE_1765_length_1720_cov_27.328192	1280	1360	61	1	80	0.0125000
NODE_1765_length_1720_cov_27.328192	1280	1360	62	1	80	0.0125000
NODE_1765_length_1720_cov_27.328192	1280	1360	63	1	80	0.0125000
NODE_1765_length_1720_cov_27.328192	1280	1360	64	4	80	0.0500000
NODE_1765_length_1720_cov_27.328192	1280	1360	65	1	80	0.0125000
NODE_1765_length_1720_cov_27.328192	1280	1360	66	3	80	0.0375000
NODE_1765_length_1720_cov_27.328192	1280	1360	67	2	80	0.0250000
NODE_1765_length_1720_cov_27.328192	1280	1360	68	1	80	0.0125000
NODE_1765_length_1720_cov_27.328192	1280	1360	69	14	80	0.1750000
NODE_1765_length_1720_cov_27.328192	1280	1360	70	14	80	0.1750000
NODE_1765_length_1720_cov_27.328192	1280	1360	71	5	80	0.0625000
NODE_1765_length_1720_cov_27.328192	1280	1360	72	3	80	0.0375000
NODE_1765_length_1720_cov_27.328192	1280	1360	73	1	80	0.0125000
NODE_1765_length_1720_cov_27.328192	1280	1360	74	2	80	0.0250000
NODE_1765_length_1720_cov_27.328192	1280	1360	75	5	80	0.0625000
NODE_1765_length_1720_cov_27.328192	1280	1360	76	4	80	0.0500000
NODE_1765_length_1720_cov_27.328192	1280	1360	77	3	80	0.0375000
NODE_1765_length_1720_cov_27.328192	1280	1360	78	4	80	0.0500000
NODE_1765_length_1720_cov_27.328192	1280	1360	79	8	80	0.1000000
NODE_1765_length_1720_cov_27.328192	1280	1360	80	1	80	0.0125000
NODE_1765_length_1720_cov_27.328192	1280	1360	81	2	80	0.0250000
NODE_1766_length_1720_cov_4.129550	241	321	1	3	80	0.0375000
NODE_1766_length_1720_cov_4.129550	241	321	2	47	80	0.5875000
NODE_1766_length_1720_cov_4.129550	241	321	3	30	80	0.3750000
NODE_1766_length_1720_cov_4.129550	294	374	3	80	80	1.0000000
NODE_1768_length_1719_cov_9.878395	410	490	0	32	80	0.4000000
NODE_1768_length_1719_cov_9.878395	410	490	1	20	80	0.2500000
NODE_1768_length_1719_cov_9.878395	410	490	2	28	80	0.3500000
NODE_1768_length_1719_cov_9.878395	463	543	2	80	80	1.0000000
NODE_1768_length_1719_cov_9.878395	539	619	2	25	80	0.3125000
NODE_1768_length_1719_cov_9.878395	539	619	3	20	80	0.2500000
NODE_1768_length_1719_cov_9.878395	539	619	4	35	80	0.4375000
NODE_1768_length_1719_cov_9.878395	592	672	2	60	80	0.7500000
NODE_1768_length_1719_cov_9.878395	592	672	3	20	80	0.2500000
NODE_1772_length_1717_cov_5.159456	145	219	0	7	74	0.0945946
NODE_1772_length_1717_cov_5.159456	145	219	1	67	74	0.9054054
NODE_1772_length_1717_cov_5.159456	1450	1508	1	51	58	0.8793104
NODE_1772_length_1717_cov_5.159456	1450	1508	2	7	58	0.1206897
NODE_1772_length_1717_cov_5.159456	1503	1561	1	10	58	0.1724138
NODE_1772_length_1717_cov_5.159456	1503	1561	2	48	58	0.8275862
NODE_1778_length_1715_cov_12.607054	555	635	2	35	80	0.4375000
NODE_1778_length_1715_cov_12.607054	555	635	3	9	80	0.1125000
NODE_1778_length_1715_cov_12.607054	555	635	4	10	80	0.1250000
NODE_1778_length_1715_cov_12.607054	555	635	5	26	80	0.3250000
NODE_1778_length_1715_cov_12.607054	608	688	2	80	80	1.0000000
NODE_1778_length_1715_cov_12.607054	684	764	0	50	80	0.6250000
NODE_1778_length_1715_cov_12.607054	684	764	2	30	80	0.3750000
NODE_1778_length_1715_cov_12.607054	737	817	0	80	80	1.0000000
NODE_1788_length_1707_cov_16.909204	397	477	0	50	80	0.6250000
NODE_1788_length_1707_cov_16.909204	397	477	2	1	80	0.0125000
NODE_1788_length_1707_cov_16.909204	397	477	3	29	80	0.3625000
NODE_1788_length_1707_cov_16.909204	450	530	3	46	80	0.5750000
NODE_1788_length_1707_cov_16.909204	450	530	4	34	80	0.4250000
NODE_1788_length_1707_cov_16.909204	1151	1231	10	20	80	0.2500000
NODE_1788_length_1707_cov_16.909204	1151	1231	11	56	80	0.7000000
NODE_1788_length_1707_cov_16.909204	1151	1231	12	4	80	0.0500000
NODE_1788_length_1707_cov_16.909204	1204	1284	4	14	80	0.1750000
NODE_1788_length_1707_cov_16.909204	1204	1284	5	12	80	0.1500000
NODE_1788_length_1707_cov_16.909204	1204	1284	6	3	80	0.0375000
NODE_1788_length_1707_cov_16.909204	1204	1284	7	7	80	0.0875000
NODE_1788_length_1707_cov_16.909204	1204	1284	10	7	80	0.0875000
NODE_1788_length_1707_cov_16.909204	1204	1284	11	37	80	0.4625000
NODE_1792_length_1705_cov_19.645081	451	531	1	5	80	0.0625000
NODE_1792_length_1705_cov_19.645081	451	531	2	48	80	0.6000000
NODE_1792_length_1705_cov_19.645081	451	531	3	27	80	0.3375000
NODE_1792_length_1705_cov_19.645081	504	584	3	42	80	0.5250000
NODE_1792_length_1705_cov_19.645081	504	584	4	38	80	0.4750000
NODE_1792_length_1705_cov_19.645081	580	660	2	6	80	0.0750000
NODE_1792_length_1705_cov_19.645081	580	660	3	53	80	0.6625000
NODE_1792_length_1705_cov_19.645081	580	660	4	21	80	0.2625000
NODE_1792_length_1705_cov_19.645081	633	714	1	18	81	0.2222222
NODE_1792_length_1705_cov_19.645081	633	714	2	42	81	0.5185185
NODE_1792_length_1705_cov_19.645081	633	714	3	21	81	0.2592593
NODE_1792_length_1705_cov_19.645081	1315	1395	2	22	80	0.2750000
NODE_1792_length_1705_cov_19.645081	1315	1395	3	15	80	0.1875000
NODE_1792_length_1705_cov_19.645081	1315	1395	5	1	80	0.0125000
NODE_1792_length_1705_cov_19.645081	1315	1395	6	39	80	0.4875000
NODE_1792_length_1705_cov_19.645081	1315	1395	10	3	80	0.0375000
NODE_1792_length_1705_cov_19.645081	1368	1448	6	24	80	0.3000000
NODE_1792_length_1705_cov_19.645081	1368	1448	10	16	80	0.2000000
NODE_1792_length_1705_cov_19.645081	1368	1448	11	40	80	0.5000000
NODE_1796_length_1703_cov_26.016833	1201	1264	0	24	63	0.3809524
NODE_1796_length_1703_cov_26.016833	1201	1264	1	31	63	0.4920635
NODE_1796_length_1703_cov_26.016833	1201	1264	2	8	63	0.1269841
NODE_1796_length_1703_cov_26.016833	1207	1264	0	24	57	0.4210526
NODE_1796_length_1703_cov_26.016833	1207	1264	1	31	57	0.5438597
NODE_1796_length_1703_cov_26.016833	1207	1264	2	2	57	0.0350877
NODE_1796_length_1703_cov_26.016833	1207	1264	0	24	57	0.4210526
NODE_1796_length_1703_cov_26.016833	1207	1264	1	31	57	0.5438597
NODE_1796_length_1703_cov_26.016833	1207	1264	2	2	57	0.0350877
NODE_1799_length_1701_cov_15.969413	1490	1565	3	11	75	0.1466667
NODE_1799_length_1701_cov_15.969413	1490	1565	4	3	75	0.0400000
NODE_1799_length_1701_cov_15.969413	1490	1565	5	13	75	0.1733333
NODE_1799_length_1701_cov_15.969413	1490	1565	6	1	75	0.0133333
NODE_1799_length_1701_cov_15.969413	1490	1565	7	2	75	0.0266667
NODE_1799_length_1701_cov_15.969413	1490	1565	8	5	75	0.0666667
NODE_1799_length_1701_cov_15.969413	1490	1565	9	23	75	0.3066667
NODE_1799_length_1701_cov_15.969413	1490	1565	10	17	75	0.2266667
NODE_1799_length_1701_cov_15.969413	1538	1603	9	10	65	0.1538462
NODE_1799_length_1701_cov_15.969413	1538	1603	10	55	65	0.8461539
NODE_1800_length_1701_cov_13.549313	607	687	2	7	80	0.0875000
NODE_1800_length_1701_cov_13.549313	607	687	3	2	80	0.0250000
NODE_1800_length_1701_cov_13.549313	607	687	4	14	80	0.1750000
NODE_1800_length_1701_cov_13.549313	607	687	5	8	80	0.1000000
NODE_1800_length_1701_cov_13.549313	607	687	6	1	80	0.0125000
NODE_1800_length_1701_cov_13.549313	607	687	7	20	80	0.2500000
NODE_1800_length_1701_cov_13.549313	607	687	8	28	80	0.3500000
NODE_1800_length_1701_cov_13.549313	660	740	7	2	80	0.0250000
NODE_1800_length_1701_cov_13.549313	660	740	8	29	80	0.3625000
NODE_1800_length_1701_cov_13.549313	660	740	9	40	80	0.5000000
NODE_1800_length_1701_cov_13.549313	660	740	10	9	80	0.1125000
NODE_1805_length_1700_cov_20.003123	1168	1197	16	6	29	0.2068966
NODE_1805_length_1700_cov_20.003123	1168	1197	17	12	29	0.4137931
NODE_1805_length_1700_cov_20.003123	1168	1197	18	7	29	0.2413793
NODE_1805_length_1700_cov_20.003123	1168	1197	22	4	29	0.1379310
NODE_1805_length_1700_cov_20.003123	1184	1263	13	9	79	0.1139240
NODE_1805_length_1700_cov_20.003123	1184	1263	14	17	79	0.2151899
NODE_1805_length_1700_cov_20.003123	1184	1263	15	3	79	0.0379747
NODE_1805_length_1700_cov_20.003123	1184	1263	16	1	79	0.0126582
NODE_1805_length_1700_cov_20.003123	1184	1263	17	14	79	0.1772152
NODE_1805_length_1700_cov_20.003123	1184	1263	18	10	79	0.1265823
NODE_1805_length_1700_cov_20.003123	1184	1263	21	21	79	0.2658228
NODE_1805_length_1700_cov_20.003123	1184	1263	22	4	79	0.0506329
NODE_1810_length_1698_cov_19.175735	1001	1081	0	80	80	1.0000000
NODE_1810_length_1698_cov_19.175735	1054	1134	0	80	80	1.0000000
NODE_1814_length_1696_cov_11.494678	590	670	7	16	80	0.2000000
NODE_1814_length_1696_cov_11.494678	590	670	8	64	80	0.8000000
NODE_1814_length_1696_cov_11.494678	643	723	0	1	80	0.0125000
NODE_1814_length_1696_cov_11.494678	643	723	1	13	80	0.1625000
NODE_1814_length_1696_cov_11.494678	643	723	2	2	80	0.0250000
NODE_1814_length_1696_cov_11.494678	643	723	3	13	80	0.1625000
NODE_1814_length_1696_cov_11.494678	643	723	4	3	80	0.0375000
NODE_1814_length_1696_cov_11.494678	643	723	7	37	80	0.4625000
NODE_1814_length_1696_cov_11.494678	643	723	8	11	80	0.1375000
NODE_1815_length_1696_cov_6.620539	369	449	9	12	80	0.1500000
NODE_1815_length_1696_cov_6.620539	369	449	11	20	80	0.2500000
NODE_1815_length_1696_cov_6.620539	369	449	12	3	80	0.0375000
NODE_1815_length_1696_cov_6.620539	369	449	13	2	80	0.0250000
NODE_1815_length_1696_cov_6.620539	369	449	14	6	80	0.0750000
NODE_1815_length_1696_cov_6.620539	369	449	15	2	80	0.0250000
NODE_1815_length_1696_cov_6.620539	369	449	16	5	80	0.0625000
NODE_1815_length_1696_cov_6.620539	369	449	18	3	80	0.0375000
NODE_1815_length_1696_cov_6.620539	369	449	19	27	80	0.3375000
NODE_1815_length_1696_cov_6.620539	422	502	7	10	80	0.1250000
NODE_1815_length_1696_cov_6.620539	422	502	8	4	80	0.0500000
NODE_1815_length_1696_cov_6.620539	422	502	9	18	80	0.2250000
NODE_1815_length_1696_cov_6.620539	422	502	10	21	80	0.2625000
NODE_1815_length_1696_cov_6.620539	422	502	11	18	80	0.2250000
NODE_1815_length_1696_cov_6.620539	422	502	12	9	80	0.1125000
NODE_1816_length_1695_cov_27.783208	399	479	6	9	80	0.1125000
NODE_1816_length_1695_cov_27.783208	399	479	7	1	80	0.0125000
NODE_1816_length_1695_cov_27.783208	399	479	8	26	80	0.3250000
NODE_1816_length_1695_cov_27.783208	399	479	9	21	80	0.2625000
NODE_1816_length_1695_cov_27.783208	399	479	10	4	80	0.0500000
NODE_1816_length_1695_cov_27.783208	399	479	11	19	80	0.2375000
NODE_1816_length_1695_cov_27.783208	452	532	6	50	80	0.6250000
NODE_1816_length_1695_cov_27.783208	452	532	7	1	80	0.0125000
NODE_1816_length_1695_cov_27.783208	452	532	8	29	80	0.3625000
NODE_1817_length_1695_cov_12.084586	1047	1127	0	80	80	1.0000000
NODE_1817_length_1695_cov_12.084586	1100	1180	0	80	80	1.0000000
NODE_1825_length_1692_cov_4.557439	727	807	4	2	80	0.0250000
NODE_1825_length_1692_cov_4.557439	727	807	5	16	80	0.2000000
NODE_1825_length_1692_cov_4.557439	727	807	7	42	80	0.5250000
NODE_1825_length_1692_cov_4.557439	727	807	8	20	80	0.2500000
NODE_1825_length_1692_cov_4.557439	780	860	2	46	80	0.5750000
NODE_1825_length_1692_cov_4.557439	780	860	4	9	80	0.1125000
NODE_1825_length_1692_cov_4.557439	780	860	5	16	80	0.2000000
NODE_1825_length_1692_cov_4.557439	780	860	7	9	80	0.1125000
NODE_1830_length_1689_cov_5.844025	1210	1285	0	75	75	1.0000000
NODE_1830_length_1689_cov_5.844025	1260	1338	0	78	78	1.0000000
NODE_1837_length_1682_cov_14.416930	1183	1263	3	8	80	0.1000000
NODE_1837_length_1682_cov_14.416930	1183	1263	6	38	80	0.4750000
NODE_1837_length_1682_cov_14.416930	1183	1263	7	34	80	0.4250000
NODE_1837_length_1682_cov_14.416930	1236	1315	4	15	79	0.1898734
NODE_1837_length_1682_cov_14.416930	1236	1315	5	29	79	0.3670886
NODE_1837_length_1682_cov_14.416930	1236	1315	7	35	79	0.4430380
NODE_1843_length_1678_cov_23.965168	636	716	2	39	80	0.4875000
NODE_1843_length_1678_cov_23.965168	636	716	4	41	80	0.5125000
NODE_1843_length_1678_cov_23.965168	689	769	2	55	80	0.6875000
NODE_1843_length_1678_cov_23.965168	689	769	4	25	80	0.3125000
NODE_1843_length_1678_cov_23.965168	1145	1225	13	26	80	0.3250000
NODE_1843_length_1678_cov_23.965168	1145	1225	14	23	80	0.2875000
NODE_1843_length_1678_cov_23.965168	1145	1225	15	22	80	0.2750000
NODE_1843_length_1678_cov_23.965168	1145	1225	16	9	80	0.1125000
NODE_1843_length_1678_cov_23.965168	1198	1278	8	12	80	0.1500000
NODE_1843_length_1678_cov_23.965168	1198	1278	10	9	80	0.1125000
NODE_1843_length_1678_cov_23.965168	1198	1278	11	3	80	0.0375000
NODE_1843_length_1678_cov_23.965168	1198	1278	13	30	80	0.3750000
NODE_1843_length_1678_cov_23.965168	1198	1278	14	7	80	0.0875000
NODE_1843_length_1678_cov_23.965168	1198	1278	15	19	80	0.2375000
NODE_1846_length_1677_cov_3.578580	407	487	1	70	80	0.8750000
NODE_1846_length_1677_cov_3.578580	407	487	3	5	80	0.0625000
NODE_1846_length_1677_cov_3.578580	407	487	5	5	80	0.0625000
NODE_1846_length_1677_cov_3.578580	460	530	1	22	70	0.3142857
NODE_1846_length_1677_cov_3.578580	460	530	2	28	70	0.4000000
NODE_1846_length_1677_cov_3.578580	460	530	3	20	70	0.2857143
NODE_1846_length_1677_cov_3.578580	666	724	0	58	58	1.0000000
NODE_1856_length_1670_cov_29.264163	741	821	8	10	80	0.1250000
NODE_1856_length_1670_cov_29.264163	741	821	10	1	80	0.0125000
NODE_1856_length_1670_cov_29.264163	741	821	12	61	80	0.7625000
NODE_1856_length_1670_cov_29.264163	741	821	13	8	80	0.1000000
NODE_1856_length_1670_cov_29.264163	794	874	8	10	80	0.1250000
NODE_1856_length_1670_cov_29.264163	794	874	9	14	80	0.1750000
NODE_1856_length_1670_cov_29.264163	794	874	10	7	80	0.0875000
NODE_1856_length_1670_cov_29.264163	794	874	12	33	80	0.4125000
NODE_1856_length_1670_cov_29.264163	794	874	13	16	80	0.2000000
NODE_1857_length_1669_cov_5.913376	246	326	0	80	80	1.0000000
NODE_1857_length_1669_cov_5.913376	299	379	0	80	80	1.0000000
NODE_1860_length_1668_cov_18.372212	1100	1180	6	6	80	0.0750000
NODE_1860_length_1668_cov_18.372212	1100	1180	7	12	80	0.1500000
NODE_1860_length_1668_cov_18.372212	1100	1180	8	4	80	0.0500000
NODE_1860_length_1668_cov_18.372212	1100	1180	9	23	80	0.2875000
NODE_1860_length_1668_cov_18.372212	1100	1180	10	35	80	0.4375000
NODE_1860_length_1668_cov_18.372212	1153	1233	5	1	80	0.0125000
NODE_1860_length_1668_cov_18.372212	1153	1233	6	1	80	0.0125000
NODE_1860_length_1668_cov_18.372212	1153	1233	7	6	80	0.0750000
NODE_1860_length_1668_cov_18.372212	1153	1233	9	44	80	0.5500000
NODE_1860_length_1668_cov_18.372212	1153	1233	10	28	80	0.3500000
NODE_1861_length_1667_cov_15.651786	902	982	10	13	80	0.1625000
NODE_1861_length_1667_cov_15.651786	902	982	12	41	80	0.5125000
NODE_1861_length_1667_cov_15.651786	902	982	13	26	80	0.3250000
NODE_1861_length_1667_cov_15.651786	955	1035	6	3	80	0.0375000
NODE_1861_length_1667_cov_15.651786	955	1035	9	5	80	0.0625000
NODE_1861_length_1667_cov_15.651786	955	1035	10	25	80	0.3125000
NODE_1861_length_1667_cov_15.651786	955	1035	11	28	80	0.3500000
NODE_1861_length_1667_cov_15.651786	955	1035	12	19	80	0.2375000
NODE_1862_length_1667_cov_3.661352	649	679	0	30	30	1.0000000
NODE_1865_length_1666_cov_4.601149	1541	1623	0	82	82	1.0000000
NODE_1865_length_1666_cov_4.601149	1553	1613	0	60	60	1.0000000
NODE_1865_length_1666_cov_4.601149	1553	1613	0	60	60	1.0000000
NODE_1865_length_1666_cov_4.601149	1557	1623	0	66	66	1.0000000
NODE_1865_length_1666_cov_4.601149	1596	1666	0	70	70	1.0000000
NODE_1865_length_1666_cov_4.601149	1596	1666	0	70	70	1.0000000
NODE_1865_length_1666_cov_4.601149	1596	1666	0	70	70	1.0000000
NODE_1872_length_1662_cov_16.638516	538	618	3	25	80	0.3125000
NODE_1872_length_1662_cov_16.638516	538	618	4	55	80	0.6875000
NODE_1872_length_1662_cov_16.638516	591	671	1	27	80	0.3375000
NODE_1872_length_1662_cov_16.638516	591	671	2	26	80	0.3250000
NODE_1872_length_1662_cov_16.638516	591	671	3	25	80	0.3125000
NODE_1872_length_1662_cov_16.638516	591	671	4	2	80	0.0250000
NODE_1872_length_1662_cov_16.638516	667	747	1	80	80	1.0000000
NODE_1872_length_1662_cov_16.638516	720	800	0	15	80	0.1875000
NODE_1872_length_1662_cov_16.638516	720	800	1	65	80	0.8125000
NODE_1876_length_1660_cov_28.297886	415	495	6	37	80	0.4625000
NODE_1876_length_1660_cov_28.297886	415	495	7	36	80	0.4500000
NODE_1876_length_1660_cov_28.297886	415	495	8	7	80	0.0875000
NODE_1876_length_1660_cov_28.297886	468	548	5	35	80	0.4375000
NODE_1876_length_1660_cov_28.297886	468	548	6	13	80	0.1625000
NODE_1876_length_1660_cov_28.297886	468	548	7	32	80	0.4000000
NODE_1886_length_1654_cov_17.245016	631	711	9	3	80	0.0375000
NODE_1886_length_1654_cov_17.245016	631	711	14	7	80	0.0875000
NODE_1886_length_1654_cov_17.245016	631	711	15	4	80	0.0500000
NODE_1886_length_1654_cov_17.245016	631	711	16	10	80	0.1250000
NODE_1886_length_1654_cov_17.245016	631	711	17	47	80	0.5875000
NODE_1886_length_1654_cov_17.245016	631	711	18	2	80	0.0250000
NODE_1886_length_1654_cov_17.245016	631	711	19	7	80	0.0875000
NODE_1886_length_1654_cov_17.245016	684	764	13	25	80	0.3125000
NODE_1886_length_1654_cov_17.245016	684	764	14	3	80	0.0375000
NODE_1886_length_1654_cov_17.245016	684	764	15	13	80	0.1625000
NODE_1886_length_1654_cov_17.245016	684	764	16	4	80	0.0500000
NODE_1886_length_1654_cov_17.245016	684	764	17	18	80	0.2250000
NODE_1886_length_1654_cov_17.245016	684	764	18	2	80	0.0250000
NODE_1886_length_1654_cov_17.245016	684	764	19	15	80	0.1875000
NODE_1888_length_1653_cov_34.827542	0	41	0	30	41	0.7317073
NODE_1888_length_1653_cov_34.827542	0	41	1	11	41	0.2682927
NODE_1888_length_1653_cov_34.827542	14	44	0	16	30	0.5333334
NODE_1888_length_1653_cov_34.827542	14	44	1	14	30	0.4666667
NODE_1888_length_1653_cov_34.827542	1081	1161	6	2	80	0.0250000
NODE_1888_length_1653_cov_34.827542	1081	1161	9	1	80	0.0125000
NODE_1888_length_1653_cov_34.827542	1081	1161	10	13	80	0.1625000
NODE_1888_length_1653_cov_34.827542	1081	1161	11	5	80	0.0625000
NODE_1888_length_1653_cov_34.827542	1081	1161	13	3	80	0.0375000
NODE_1888_length_1653_cov_34.827542	1081	1161	15	10	80	0.1250000
NODE_1888_length_1653_cov_34.827542	1081	1161	16	5	80	0.0625000
NODE_1888_length_1653_cov_34.827542	1081	1161	17	14	80	0.1750000
NODE_1888_length_1653_cov_34.827542	1081	1161	18	5	80	0.0625000
NODE_1888_length_1653_cov_34.827542	1081	1161	19	20	80	0.2500000
NODE_1888_length_1653_cov_34.827542	1081	1161	21	2	80	0.0250000
NODE_1888_length_1653_cov_34.827542	1134	1214	18	5	80	0.0625000
NODE_1888_length_1653_cov_34.827542	1134	1214	19	20	80	0.2500000
NODE_1888_length_1653_cov_34.827542	1134	1214	21	5	80	0.0625000
NODE_1888_length_1653_cov_34.827542	1134	1214	22	1	80	0.0125000
NODE_1888_length_1653_cov_34.827542	1134	1214	25	8	80	0.1000000
NODE_1888_length_1653_cov_34.827542	1134	1214	26	1	80	0.0125000
NODE_1888_length_1653_cov_34.827542	1134	1214	27	21	80	0.2625000
NODE_1888_length_1653_cov_34.827542	1134	1214	28	12	80	0.1500000
NODE_1888_length_1653_cov_34.827542	1134	1214	31	7	80	0.0875000
NODE_1888_length_1653_cov_34.827542	1210	1290	16	7	80	0.0875000
NODE_1888_length_1653_cov_34.827542	1210	1290	17	8	80	0.1000000
NODE_1888_length_1653_cov_34.827542	1210	1290	18	17	80	0.2125000
NODE_1888_length_1653_cov_34.827542	1210	1290	19	6	80	0.0750000
NODE_1888_length_1653_cov_34.827542	1210	1290	23	8	80	0.1000000
NODE_1888_length_1653_cov_34.827542	1210	1290	24	7	80	0.0875000
NODE_1888_length_1653_cov_34.827542	1210	1290	25	4	80	0.0500000
NODE_1888_length_1653_cov_34.827542	1210	1290	27	1	80	0.0125000
NODE_1888_length_1653_cov_34.827542	1210	1290	28	2	80	0.0250000
NODE_1888_length_1653_cov_34.827542	1210	1290	31	20	80	0.2500000
NODE_1888_length_1653_cov_34.827542	1263	1339	9	16	76	0.2105263
NODE_1888_length_1653_cov_34.827542	1263	1339	10	8	76	0.1052632
NODE_1888_length_1653_cov_34.827542	1263	1339	12	1	76	0.0131579
NODE_1888_length_1653_cov_34.827542	1263	1339	13	4	76	0.0526316
NODE_1888_length_1653_cov_34.827542	1263	1339	15	1	76	0.0131579
NODE_1888_length_1653_cov_34.827542	1263	1339	16	7	76	0.0921053
NODE_1888_length_1653_cov_34.827542	1263	1339	17	27	76	0.3552631
NODE_1888_length_1653_cov_34.827542	1263	1339	18	7	76	0.0921053
NODE_1888_length_1653_cov_34.827542	1263	1339	19	5	76	0.0657895
NODE_1892_length_1652_cov_23.939472	1352	1432	2	37	80	0.4625000
NODE_1892_length_1652_cov_23.939472	1352	1432	4	43	80	0.5375000
NODE_1892_length_1652_cov_23.939472	1405	1485	2	19	80	0.2375000
NODE_1892_length_1652_cov_23.939472	1405	1485	4	61	80	0.7625000
NODE_1894_length_1651_cov_3.916881	1552	1617	0	65	65	1.0000000
NODE_1899_length_1649_cov_7.480000	774	854	5	24	80	0.3000000
NODE_1899_length_1649_cov_7.480000	774	854	6	56	80	0.7000000
NODE_1899_length_1649_cov_7.480000	827	907	5	10	80	0.1250000
NODE_1899_length_1649_cov_7.480000	827	907	6	56	80	0.7000000
NODE_1899_length_1649_cov_7.480000	827	907	7	14	80	0.1750000
NODE_1903_length_1647_cov_3.534238	1012	1075	4	4	63	0.0634921
NODE_1903_length_1647_cov_3.534238	1012	1075	5	10	63	0.1587302
NODE_1903_length_1647_cov_3.534238	1012	1075	6	49	63	0.7777778
NODE_1906_length_1645_cov_16.040103	155	235	7	14	80	0.1750000
NODE_1906_length_1645_cov_16.040103	155	235	8	20	80	0.2500000
NODE_1906_length_1645_cov_16.040103	155	235	9	18	80	0.2250000
NODE_1906_length_1645_cov_16.040103	155	235	10	28	80	0.3500000
NODE_1906_length_1645_cov_16.040103	208	288	3	2	80	0.0250000
NODE_1906_length_1645_cov_16.040103	208	288	4	22	80	0.2750000
NODE_1906_length_1645_cov_16.040103	208	288	7	43	80	0.5375000
NODE_1906_length_1645_cov_16.040103	208	288	9	13	80	0.1625000
NODE_1906_length_1645_cov_16.040103	1090	1170	3	47	80	0.5875000
NODE_1906_length_1645_cov_16.040103	1090	1170	4	33	80	0.4125000
NODE_1906_length_1645_cov_16.040103	1143	1222	2	10	79	0.1265823
NODE_1906_length_1645_cov_16.040103	1143	1222	3	41	79	0.5189874
NODE_1906_length_1645_cov_16.040103	1143	1222	4	28	79	0.3544304
NODE_1908_length_1644_cov_2.902913	1160	1240	2	21	80	0.2625000
NODE_1908_length_1644_cov_2.902913	1160	1240	3	59	80	0.7375000
NODE_1917_length_1641_cov_34.032425	487	567	1	31	80	0.3875000
NODE_1917_length_1641_cov_34.032425	487	567	2	12	80	0.1500000
NODE_1917_length_1641_cov_34.032425	487	567	5	6	80	0.0750000
NODE_1917_length_1641_cov_34.032425	487	567	6	31	80	0.3875000
NODE_1917_length_1641_cov_34.032425	540	620	1	41	80	0.5125000
NODE_1917_length_1641_cov_34.032425	540	620	6	9	80	0.1125000
NODE_1917_length_1641_cov_34.032425	540	620	7	30	80	0.3750000
NODE_1917_length_1641_cov_34.032425	616	696	7	41	80	0.5125000
NODE_1917_length_1641_cov_34.032425	616	696	8	39	80	0.4875000
NODE_1917_length_1641_cov_34.032425	669	749	1	9	80	0.1125000
NODE_1917_length_1641_cov_34.032425	669	749	2	9	80	0.1125000
NODE_1917_length_1641_cov_34.032425	669	749	7	54	80	0.6750000
NODE_1917_length_1641_cov_34.032425	669	749	8	8	80	0.1000000
NODE_1917_length_1641_cov_34.032425	1168	1248	4	80	80	1.0000000
NODE_1917_length_1641_cov_34.032425	1219	1301	3	25	82	0.3048781
NODE_1917_length_1641_cov_34.032425	1219	1301	4	57	82	0.6951219
NODE_1918_length_1641_cov_7.042802	339	390	2	33	51	0.6470588
NODE_1918_length_1641_cov_7.042802	339	390	3	18	51	0.3529412
NODE_1922_length_1640_cov_33.097339	943	1023	4	7	80	0.0875000
NODE_1922_length_1640_cov_33.097339	943	1023	6	19	80	0.2375000
NODE_1922_length_1640_cov_33.097339	943	1023	7	2	80	0.0250000
NODE_1922_length_1640_cov_33.097339	943	1023	9	24	80	0.3000000
NODE_1922_length_1640_cov_33.097339	943	1023	11	1	80	0.0125000
NODE_1922_length_1640_cov_33.097339	943	1023	13	27	80	0.3375000
NODE_1922_length_1640_cov_33.097339	996	1076	11	38	80	0.4750000
NODE_1922_length_1640_cov_33.097339	996	1076	12	7	80	0.0875000
NODE_1922_length_1640_cov_33.097339	996	1076	13	35	80	0.4375000
NODE_1922_length_1640_cov_33.097339	1072	1152	1	6	80	0.0750000
NODE_1922_length_1640_cov_33.097339	1072	1152	3	1	80	0.0125000
NODE_1922_length_1640_cov_33.097339	1072	1152	5	24	80	0.3000000
NODE_1922_length_1640_cov_33.097339	1072	1152	7	2	80	0.0250000
NODE_1922_length_1640_cov_33.097339	1072	1152	8	25	80	0.3125000
NODE_1922_length_1640_cov_33.097339	1072	1152	9	4	80	0.0500000
NODE_1922_length_1640_cov_33.097339	1072	1152	10	10	80	0.1250000
NODE_1922_length_1640_cov_33.097339	1072	1152	11	8	80	0.1000000
NODE_1922_length_1640_cov_33.097339	1125	1206	1	60	81	0.7407407
NODE_1922_length_1640_cov_33.097339	1125	1206	3	1	81	0.0123457
NODE_1922_length_1640_cov_33.097339	1125	1206	5	20	81	0.2469136
NODE_1923_length_1640_cov_18.519143	471	551	6	1	80	0.0125000
NODE_1923_length_1640_cov_18.519143	471	551	7	10	80	0.1250000
NODE_1923_length_1640_cov_18.519143	471	551	9	31	80	0.3875000
NODE_1923_length_1640_cov_18.519143	471	551	10	14	80	0.1750000
NODE_1923_length_1640_cov_18.519143	471	551	11	6	80	0.0750000
NODE_1923_length_1640_cov_18.519143	471	551	14	18	80	0.2250000
NODE_1923_length_1640_cov_18.519143	524	604	9	3	80	0.0375000
NODE_1923_length_1640_cov_18.519143	524	604	10	2	80	0.0250000
NODE_1923_length_1640_cov_18.519143	524	604	11	13	80	0.1625000
NODE_1923_length_1640_cov_18.519143	524	604	12	24	80	0.3000000
NODE_1923_length_1640_cov_18.519143	524	604	13	18	80	0.2250000
NODE_1923_length_1640_cov_18.519143	524	604	14	20	80	0.2500000
NODE_1925_length_1639_cov_6.585714	975	1056	0	81	81	1.0000000
NODE_1925_length_1639_cov_6.585714	1028	1109	0	71	81	0.8765432
NODE_1925_length_1639_cov_6.585714	1028	1109	2	10	81	0.1234568
NODE_1926_length_1639_cov_2.163636	1260	1334	0	74	74	1.0000000
NODE_1926_length_1639_cov_2.163636	1312	1387	0	75	75	1.0000000
NODE_1928_length_1638_cov_18.598441	443	523	5	80	80	1.0000000
NODE_1928_length_1638_cov_18.598441	496	576	0	23	80	0.2875000
NODE_1928_length_1638_cov_18.598441	496	576	1	13	80	0.1625000
NODE_1928_length_1638_cov_18.598441	496	576	4	1	80	0.0125000
NODE_1928_length_1638_cov_18.598441	496	576	5	43	80	0.5375000
NODE_1928_length_1638_cov_18.598441	1157	1237	1	29	80	0.3625000
NODE_1928_length_1638_cov_18.598441	1157	1237	4	51	80	0.6375000
NODE_1928_length_1638_cov_18.598441	1210	1290	4	37	80	0.4625000
NODE_1928_length_1638_cov_18.598441	1210	1290	6	23	80	0.2875000
NODE_1928_length_1638_cov_18.598441	1210	1290	7	20	80	0.2500000
NODE_1932_length_1637_cov_12.048765	410	490	0	80	80	1.0000000
NODE_1932_length_1637_cov_12.048765	463	543	0	80	80	1.0000000
NODE_1932_length_1637_cov_12.048765	1081	1161	7	21	80	0.2625000
NODE_1932_length_1637_cov_12.048765	1081	1161	8	12	80	0.1500000
NODE_1932_length_1637_cov_12.048765	1081	1161	10	17	80	0.2125000
NODE_1932_length_1637_cov_12.048765	1081	1161	11	4	80	0.0500000
NODE_1932_length_1637_cov_12.048765	1081	1161	12	26	80	0.3250000
NODE_1932_length_1637_cov_12.048765	1134	1214	8	63	80	0.7875000
NODE_1932_length_1637_cov_12.048765	1134	1214	10	9	80	0.1125000
NODE_1932_length_1637_cov_12.048765	1134	1214	12	8	80	0.1000000
NODE_1934_length_1635_cov_21.022786	958	1038	6	10	80	0.1250000
NODE_1934_length_1635_cov_21.022786	958	1038	9	4	80	0.0500000
NODE_1934_length_1635_cov_21.022786	958	1038	10	22	80	0.2750000
NODE_1934_length_1635_cov_21.022786	958	1038	12	36	80	0.4500000
NODE_1934_length_1635_cov_21.022786	958	1038	13	8	80	0.1000000
NODE_1934_length_1635_cov_21.022786	1011	1091	9	17	80	0.2125000
NODE_1934_length_1635_cov_21.022786	1011	1091	10	3	80	0.0375000
NODE_1934_length_1635_cov_21.022786	1011	1091	11	15	80	0.1875000
NODE_1934_length_1635_cov_21.022786	1011	1091	12	35	80	0.4375000
NODE_1934_length_1635_cov_21.022786	1011	1091	15	2	80	0.0250000
NODE_1934_length_1635_cov_21.022786	1011	1091	16	3	80	0.0375000
NODE_1934_length_1635_cov_21.022786	1011	1091	18	5	80	0.0625000
NODE_1934_length_1635_cov_21.022786	1087	1167	12	23	80	0.2875000
NODE_1934_length_1635_cov_21.022786	1087	1167	15	22	80	0.2750000
NODE_1934_length_1635_cov_21.022786	1087	1167	16	4	80	0.0500000
NODE_1934_length_1635_cov_21.022786	1087	1167	18	6	80	0.0750000
NODE_1934_length_1635_cov_21.022786	1087	1167	19	25	80	0.3125000
NODE_1934_length_1635_cov_21.022786	1140	1220	8	4	80	0.0500000
NODE_1934_length_1635_cov_21.022786	1140	1220	10	3	80	0.0375000
NODE_1934_length_1635_cov_21.022786	1140	1220	12	69	80	0.8625000
NODE_1934_length_1635_cov_21.022786	1140	1220	15	4	80	0.0500000
NODE_1936_length_1633_cov_16.743807	1067	1147	7	16	80	0.2000000
NODE_1936_length_1633_cov_16.743807	1067	1147	8	5	80	0.0625000
NODE_1936_length_1633_cov_16.743807	1067	1147	10	59	80	0.7375000
NODE_1936_length_1633_cov_16.743807	1120	1200	5	11	80	0.1375000
NODE_1936_length_1633_cov_16.743807	1120	1200	6	15	80	0.1875000
NODE_1936_length_1633_cov_16.743807	1120	1200	7	43	80	0.5375000
NODE_1936_length_1633_cov_16.743807	1120	1200	10	11	80	0.1375000
NODE_1937_length_1633_cov_14.271838	977	1057	8	32	80	0.4000000
NODE_1937_length_1633_cov_14.271838	977	1057	9	16	80	0.2000000
NODE_1937_length_1633_cov_14.271838	977	1057	10	1	80	0.0125000
NODE_1937_length_1633_cov_14.271838	977	1057	12	9	80	0.1125000
NODE_1937_length_1633_cov_14.271838	977	1057	13	11	80	0.1375000
NODE_1937_length_1633_cov_14.271838	977	1057	15	11	80	0.1375000
NODE_1937_length_1633_cov_14.271838	1030	1110	11	1	80	0.0125000
NODE_1937_length_1633_cov_14.271838	1030	1110	12	5	80	0.0625000
NODE_1937_length_1633_cov_14.271838	1030	1110	13	11	80	0.1375000
NODE_1937_length_1633_cov_14.271838	1030	1110	14	9	80	0.1125000
NODE_1937_length_1633_cov_14.271838	1030	1110	15	53	80	0.6625000
NODE_1937_length_1633_cov_14.271838	1030	1110	16	1	80	0.0125000
NODE_1937_length_1633_cov_14.271838	1106	1186	8	1	80	0.0125000
NODE_1937_length_1633_cov_14.271838	1106	1186	9	16	80	0.2000000
NODE_1937_length_1633_cov_14.271838	1106	1186	10	24	80	0.3000000
NODE_1937_length_1633_cov_14.271838	1106	1186	11	21	80	0.2625000
NODE_1937_length_1633_cov_14.271838	1106	1186	12	15	80	0.1875000
NODE_1937_length_1633_cov_14.271838	1106	1186	14	3	80	0.0375000
NODE_1937_length_1633_cov_14.271838	1159	1239	5	19	80	0.2375000
NODE_1937_length_1633_cov_14.271838	1159	1239	6	24	80	0.3000000
NODE_1937_length_1633_cov_14.271838	1159	1239	8	11	80	0.1375000
NODE_1937_length_1633_cov_14.271838	1159	1239	9	10	80	0.1250000
NODE_1937_length_1633_cov_14.271838	1159	1239	10	10	80	0.1250000
NODE_1937_length_1633_cov_14.271838	1159	1239	11	2	80	0.0250000
NODE_1937_length_1633_cov_14.271838	1159	1239	12	4	80	0.0500000
NODE_1939_length_1631_cov_25.881201	424	504	6	13	80	0.1625000
NODE_1939_length_1631_cov_25.881201	424	504	8	3	80	0.0375000
NODE_1939_length_1631_cov_25.881201	424	504	10	31	80	0.3875000
NODE_1939_length_1631_cov_25.881201	424	504	12	30	80	0.3750000
NODE_1939_length_1631_cov_25.881201	424	504	13	3	80	0.0375000
NODE_1939_length_1631_cov_25.881201	477	557	12	28	80	0.3500000
NODE_1939_length_1631_cov_25.881201	477	557	13	3	80	0.0375000
NODE_1939_length_1631_cov_25.881201	477	557	14	17	80	0.2125000
NODE_1939_length_1631_cov_25.881201	477	557	16	13	80	0.1625000
NODE_1939_length_1631_cov_25.881201	477	557	17	4	80	0.0500000
NODE_1939_length_1631_cov_25.881201	477	557	18	15	80	0.1875000
NODE_1939_length_1631_cov_25.881201	553	633	16	5	80	0.0625000
NODE_1939_length_1631_cov_25.881201	553	633	17	10	80	0.1250000
NODE_1939_length_1631_cov_25.881201	553	633	18	19	80	0.2375000
NODE_1939_length_1631_cov_25.881201	553	633	19	19	80	0.2375000
NODE_1939_length_1631_cov_25.881201	553	633	20	26	80	0.3250000
NODE_1939_length_1631_cov_25.881201	553	633	21	1	80	0.0125000
NODE_1939_length_1631_cov_25.881201	606	686	13	11	80	0.1375000
NODE_1939_length_1631_cov_25.881201	606	686	16	5	80	0.0625000
NODE_1939_length_1631_cov_25.881201	606	686	17	17	80	0.2125000
NODE_1939_length_1631_cov_25.881201	606	686	18	4	80	0.0500000
NODE_1939_length_1631_cov_25.881201	606	686	19	28	80	0.3500000
NODE_1939_length_1631_cov_25.881201	606	686	20	14	80	0.1750000
NODE_1939_length_1631_cov_25.881201	606	686	21	1	80	0.0125000
NODE_1943_length_1629_cov_32.733987	518	598	2	57	80	0.7125000
NODE_1943_length_1629_cov_32.733987	518	598	5	14	80	0.1750000
NODE_1943_length_1629_cov_32.733987	518	598	6	9	80	0.1125000
NODE_1943_length_1629_cov_32.733987	635	715	13	1	80	0.0125000
NODE_1943_length_1629_cov_32.733987	635	715	14	2	80	0.0250000
NODE_1943_length_1629_cov_32.733987	635	715	16	5	80	0.0625000
NODE_1943_length_1629_cov_32.733987	635	715	19	4	80	0.0500000
NODE_1943_length_1629_cov_32.733987	635	715	20	13	80	0.1625000
NODE_1943_length_1629_cov_32.733987	635	715	21	28	80	0.3500000
NODE_1943_length_1629_cov_32.733987	635	715	22	2	80	0.0250000
NODE_1943_length_1629_cov_32.733987	635	715	24	1	80	0.0125000
NODE_1943_length_1629_cov_32.733987	635	715	25	8	80	0.1000000
NODE_1943_length_1629_cov_32.733987	635	715	26	16	80	0.2000000
NODE_1943_length_1629_cov_32.733987	688	768	21	7	80	0.0875000
NODE_1943_length_1629_cov_32.733987	688	768	22	2	80	0.0250000
NODE_1943_length_1629_cov_32.733987	688	768	24	2	80	0.0250000
NODE_1943_length_1629_cov_32.733987	688	768	25	8	80	0.1000000
NODE_1943_length_1629_cov_32.733987	688	768	26	41	80	0.5125000
NODE_1943_length_1629_cov_32.733987	688	768	27	17	80	0.2125000
NODE_1943_length_1629_cov_32.733987	688	768	29	3	80	0.0375000
NODE_1946_length_1628_cov_15.551995	1454	1518	4	11	64	0.1718750
NODE_1946_length_1628_cov_15.551995	1454	1518	5	15	64	0.2343750
NODE_1946_length_1628_cov_15.551995	1454	1518	6	38	64	0.5937500
NODE_1947_length_1628_cov_4.852845	81	163	2	44	82	0.5365854
NODE_1947_length_1628_cov_4.852845	81	163	3	38	82	0.4634146
NODE_1952_length_1626_cov_20.549443	495	575	8	19	80	0.2375000
NODE_1952_length_1626_cov_20.549443	495	575	9	26	80	0.3250000
NODE_1952_length_1626_cov_20.549443	495	575	11	35	80	0.4375000
NODE_1952_length_1626_cov_20.549443	548	628	5	21	80	0.2625000
NODE_1952_length_1626_cov_20.549443	548	628	6	10	80	0.1250000
NODE_1952_length_1626_cov_20.549443	548	628	11	48	80	0.6000000
NODE_1952_length_1626_cov_20.549443	548	628	12	1	80	0.0125000
NODE_1953_length_1626_cov_6.552718	1189	1269	5	17	80	0.2125000
NODE_1953_length_1626_cov_6.552718	1189	1269	9	1	80	0.0125000
NODE_1953_length_1626_cov_6.552718	1189	1269	10	12	80	0.1500000
NODE_1953_length_1626_cov_6.552718	1189	1269	11	13	80	0.1625000
NODE_1953_length_1626_cov_6.552718	1189	1269	12	24	80	0.3000000
NODE_1953_length_1626_cov_6.552718	1189	1269	15	13	80	0.1625000
NODE_1953_length_1626_cov_6.552718	1242	1321	9	1	79	0.0126582
NODE_1953_length_1626_cov_6.552718	1242	1321	10	38	79	0.4810127
NODE_1953_length_1626_cov_6.552718	1242	1321	11	8	79	0.1012658
NODE_1953_length_1626_cov_6.552718	1242	1321	15	32	79	0.4050633
NODE_1954_length_1626_cov_4.728880	247	329	2	35	82	0.4268293
NODE_1954_length_1626_cov_4.728880	247	329	3	43	82	0.5243902
NODE_1954_length_1626_cov_4.728880	247	329	4	4	82	0.0487805
NODE_1954_length_1626_cov_4.728880	302	382	2	54	80	0.6750000
NODE_1954_length_1626_cov_4.728880	302	382	3	26	80	0.3250000
NODE_1956_length_1625_cov_20.598952	938	1018	20	10	80	0.1250000
NODE_1956_length_1625_cov_20.598952	938	1018	21	22	80	0.2750000
NODE_1956_length_1625_cov_20.598952	938	1018	22	13	80	0.1625000
NODE_1956_length_1625_cov_20.598952	938	1018	23	3	80	0.0375000
NODE_1956_length_1625_cov_20.598952	938	1018	24	1	80	0.0125000
NODE_1956_length_1625_cov_20.598952	938	1018	25	28	80	0.3500000
NODE_1956_length_1625_cov_20.598952	938	1018	26	3	80	0.0375000
NODE_1956_length_1625_cov_20.598952	991	1071	10	2	80	0.0250000
NODE_1956_length_1625_cov_20.598952	991	1071	12	1	80	0.0125000
NODE_1956_length_1625_cov_20.598952	991	1071	14	9	80	0.1125000
NODE_1956_length_1625_cov_20.598952	991	1071	15	7	80	0.0875000
NODE_1956_length_1625_cov_20.598952	991	1071	18	11	80	0.1375000
NODE_1956_length_1625_cov_20.598952	991	1071	19	14	80	0.1750000
NODE_1956_length_1625_cov_20.598952	991	1071	20	19	80	0.2375000
NODE_1956_length_1625_cov_20.598952	991	1071	21	17	80	0.2125000
NODE_1962_length_1623_cov_28.551181	416	486	3	5	70	0.0714286
NODE_1962_length_1623_cov_28.551181	416	486	4	55	70	0.7857143
NODE_1962_length_1623_cov_28.551181	416	486	5	10	70	0.1428571
NODE_1962_length_1623_cov_28.551181	459	507	2	12	48	0.2500000
NODE_1962_length_1623_cov_28.551181	459	507	3	14	48	0.2916667
NODE_1962_length_1623_cov_28.551181	459	507	4	22	48	0.4583333
NODE_1965_length_1622_cov_7.969140	645	725	6	74	80	0.9250000
NODE_1965_length_1622_cov_7.969140	645	725	8	6	80	0.0750000
NODE_1965_length_1622_cov_7.969140	698	778	0	6	80	0.0750000
NODE_1965_length_1622_cov_7.969140	698	778	2	17	80	0.2125000
NODE_1965_length_1622_cov_7.969140	698	778	4	11	80	0.1375000
NODE_1965_length_1622_cov_7.969140	698	778	6	46	80	0.5750000
NODE_1970_length_1621_cov_2.192510	330	401	2	38	71	0.5352113
NODE_1970_length_1621_cov_2.192510	330	401	4	33	71	0.4647887
NODE_1975_length_1618_cov_44.138907	361	441	6	11	80	0.1375000
NODE_1975_length_1618_cov_44.138907	361	441	8	69	80	0.8625000
NODE_1975_length_1618_cov_44.138907	414	494	1	3	80	0.0375000
NODE_1975_length_1618_cov_44.138907	414	494	2	6	80	0.0750000
NODE_1975_length_1618_cov_44.138907	414	494	6	55	80	0.6875000
NODE_1975_length_1618_cov_44.138907	414	494	8	16	80	0.2000000
NODE_1975_length_1618_cov_44.138907	1063	1143	18	3	80	0.0375000
NODE_1975_length_1618_cov_44.138907	1063	1143	21	4	80	0.0500000
NODE_1975_length_1618_cov_44.138907	1063	1143	24	1	80	0.0125000
NODE_1975_length_1618_cov_44.138907	1063	1143	25	24	80	0.3000000
NODE_1975_length_1618_cov_44.138907	1063	1143	26	5	80	0.0625000
NODE_1975_length_1618_cov_44.138907	1063	1143	27	1	80	0.0125000
NODE_1975_length_1618_cov_44.138907	1063	1143	28	32	80	0.4000000
NODE_1975_length_1618_cov_44.138907	1063	1143	31	10	80	0.1250000
NODE_1975_length_1618_cov_44.138907	1116	1196	24	8	80	0.1000000
NODE_1975_length_1618_cov_44.138907	1116	1196	25	1	80	0.0125000
NODE_1975_length_1618_cov_44.138907	1116	1196	26	11	80	0.1375000
NODE_1975_length_1618_cov_44.138907	1116	1196	27	18	80	0.2250000
NODE_1975_length_1618_cov_44.138907	1116	1196	28	18	80	0.2250000
NODE_1975_length_1618_cov_44.138907	1116	1196	29	10	80	0.1250000
NODE_1975_length_1618_cov_44.138907	1116	1196	31	14	80	0.1750000
NODE_1976_length_1618_cov_5.779460	332	414	1	36	82	0.4390244
NODE_1976_length_1618_cov_5.779460	332	414	2	46	82	0.5609756
NODE_1976_length_1618_cov_5.779460	387	467	1	2	80	0.0250000
NODE_1976_length_1618_cov_5.779460	387	467	2	78	80	0.9750000
NODE_1976_length_1618_cov_5.779460	972	1028	0	56	56	1.0000000
NODE_1980_length_1616_cov_5.313777	589	669	0	49	80	0.6125000
NODE_1980_length_1616_cov_5.313777	589	669	1	31	80	0.3875000
NODE_1980_length_1616_cov_5.313777	642	722	1	80	80	1.0000000
NODE_1981_length_1615_cov_12.575858	1032	1112	2	7	80	0.0875000
NODE_1981_length_1615_cov_12.575858	1032	1112	3	47	80	0.5875000
NODE_1981_length_1615_cov_12.575858	1032	1112	4	26	80	0.3250000
NODE_1981_length_1615_cov_12.575858	1085	1162	1	37	77	0.4805195
NODE_1981_length_1615_cov_12.575858	1085	1162	2	20	77	0.2597403
NODE_1981_length_1615_cov_12.575858	1085	1162	3	20	77	0.2597403
NODE_1981_length_1615_cov_12.575858	1158	1238	0	48	80	0.6000000
NODE_1981_length_1615_cov_12.575858	1158	1238	1	32	80	0.4000000
NODE_1981_length_1615_cov_12.575858	1211	1291	0	80	80	1.0000000
NODE_1983_length_1614_cov_94.900990	0	46	0	46	46	1.0000000
NODE_1983_length_1614_cov_94.900990	23	99	0	76	76	1.0000000
NODE_1984_length_1614_cov_18.799340	655	735	11	40	80	0.5000000
NODE_1984_length_1614_cov_18.799340	655	735	12	31	80	0.3875000
NODE_1984_length_1614_cov_18.799340	655	735	13	7	80	0.0875000
NODE_1984_length_1614_cov_18.799340	655	735	14	2	80	0.0250000
NODE_1984_length_1614_cov_18.799340	708	788	7	12	80	0.1500000
NODE_1984_length_1614_cov_18.799340	708	788	8	2	80	0.0250000
NODE_1984_length_1614_cov_18.799340	708	788	10	25	80	0.3125000
NODE_1984_length_1614_cov_18.799340	708	788	11	16	80	0.2000000
NODE_1984_length_1614_cov_18.799340	708	788	12	16	80	0.2000000
NODE_1984_length_1614_cov_18.799340	708	788	13	7	80	0.0875000
NODE_1984_length_1614_cov_18.799340	708	788	14	2	80	0.0250000
NODE_1986_length_1613_cov_6.865258	1128	1203	9	8	75	0.1066667
NODE_1986_length_1613_cov_6.865258	1128	1203	10	10	75	0.1333333
NODE_1986_length_1613_cov_6.865258	1128	1203	11	27	75	0.3600000
NODE_1986_length_1613_cov_6.865258	1128	1203	12	15	75	0.2000000
NODE_1986_length_1613_cov_6.865258	1128	1203	14	15	75	0.2000000
NODE_1986_length_1613_cov_6.865258	1176	1256	7	50	80	0.6250000
NODE_1986_length_1613_cov_6.865258	1176	1256	9	11	80	0.1375000
NODE_1986_length_1613_cov_6.865258	1176	1256	10	10	80	0.1250000
NODE_1986_length_1613_cov_6.865258	1176	1256	11	9	80	0.1125000
NODE_1993_length_1610_cov_18.014560	1035	1115	10	8	80	0.1000000
NODE_1993_length_1610_cov_18.014560	1035	1115	11	8	80	0.1000000
NODE_1993_length_1610_cov_18.014560	1035	1115	12	23	80	0.2875000
NODE_1993_length_1610_cov_18.014560	1035	1115	14	7	80	0.0875000
NODE_1993_length_1610_cov_18.014560	1035	1115	16	34	80	0.4250000
NODE_1993_length_1610_cov_18.014560	1088	1168	14	8	80	0.1000000
NODE_1993_length_1610_cov_18.014560	1088	1168	15	16	80	0.2000000
NODE_1993_length_1610_cov_18.014560	1088	1168	16	29	80	0.3625000
NODE_1993_length_1610_cov_18.014560	1088	1168	17	4	80	0.0500000
NODE_1993_length_1610_cov_18.014560	1088	1168	18	23	80	0.2875000
NODE_2001_length_1603_cov_9.128324	1109	1189	0	28	80	0.3500000
NODE_2001_length_1603_cov_9.128324	1109	1189	2	16	80	0.2000000
NODE_2001_length_1603_cov_9.128324	1109	1189	3	36	80	0.4500000
NODE_2001_length_1603_cov_9.128324	1162	1242	3	39	80	0.4875000
NODE_2001_length_1603_cov_9.128324	1162	1242	4	21	80	0.2625000
NODE_2001_length_1603_cov_9.128324	1162	1242	8	20	80	0.2500000
NODE_2003_length_1602_cov_79.840319	1378	1445	6	4	67	0.0597015
NODE_2003_length_1602_cov_79.840319	1378	1445	7	15	67	0.2238806
NODE_2003_length_1602_cov_79.840319	1378	1445	9	45	67	0.6716418
NODE_2003_length_1602_cov_79.840319	1378	1445	10	3	67	0.0447761
NODE_2003_length_1602_cov_79.840319	1462	1508	2	1	46	0.0217391
NODE_2003_length_1602_cov_79.840319	1462	1508	4	43	46	0.9347826
NODE_2003_length_1602_cov_79.840319	1462	1508	6	2	46	0.0434783
NODE_2004_length_1602_cov_2.701264	1490	1570	0	80	80	1.0000000
NODE_2009_length_1600_cov_34.988008	785	865	18	9	80	0.1125000
NODE_2009_length_1600_cov_34.988008	785	865	19	8	80	0.1000000
NODE_2009_length_1600_cov_34.988008	785	865	21	23	80	0.2875000
NODE_2009_length_1600_cov_34.988008	785	865	22	11	80	0.1375000
NODE_2009_length_1600_cov_34.988008	785	865	23	16	80	0.2000000
NODE_2009_length_1600_cov_34.988008	785	865	24	13	80	0.1625000
NODE_2009_length_1600_cov_34.988008	838	918	19	1	80	0.0125000
NODE_2009_length_1600_cov_34.988008	838	918	21	18	80	0.2250000
NODE_2009_length_1600_cov_34.988008	838	918	22	5	80	0.0625000
NODE_2009_length_1600_cov_34.988008	838	918	23	11	80	0.1375000
NODE_2009_length_1600_cov_34.988008	838	918	24	32	80	0.4000000
NODE_2009_length_1600_cov_34.988008	838	918	25	4	80	0.0500000
NODE_2009_length_1600_cov_34.988008	838	918	26	9	80	0.1125000
NODE_2009_length_1600_cov_34.988008	914	994	17	4	80	0.0500000
NODE_2009_length_1600_cov_34.988008	914	994	18	6	80	0.0750000
NODE_2009_length_1600_cov_34.988008	914	994	19	2	80	0.0250000
NODE_2009_length_1600_cov_34.988008	914	994	20	8	80	0.1000000
NODE_2009_length_1600_cov_34.988008	914	994	21	23	80	0.2875000
NODE_2009_length_1600_cov_34.988008	914	994	22	3	80	0.0375000
NODE_2009_length_1600_cov_34.988008	914	994	23	17	80	0.2125000
NODE_2009_length_1600_cov_34.988008	914	994	24	4	80	0.0500000
NODE_2009_length_1600_cov_34.988008	914	994	25	12	80	0.1500000
NODE_2009_length_1600_cov_34.988008	914	994	26	1	80	0.0125000
NODE_2009_length_1600_cov_34.988008	967	1047	13	8	80	0.1000000
NODE_2009_length_1600_cov_34.988008	967	1047	14	12	80	0.1500000
NODE_2009_length_1600_cov_34.988008	967	1047	15	7	80	0.0875000
NODE_2009_length_1600_cov_34.988008	967	1047	17	4	80	0.0500000
NODE_2009_length_1600_cov_34.988008	967	1047	18	14	80	0.1750000
NODE_2009_length_1600_cov_34.988008	967	1047	20	15	80	0.1875000
NODE_2009_length_1600_cov_34.988008	967	1047	21	20	80	0.2500000
NODE_2011_length_1600_cov_11.383744	0	72	0	72	72	1.0000000
NODE_2011_length_1600_cov_11.383744	45	99	0	54	54	1.0000000
NODE_2011_length_1600_cov_11.383744	891	971	5	1	80	0.0125000
NODE_2011_length_1600_cov_11.383744	891	971	7	3	80	0.0375000
NODE_2011_length_1600_cov_11.383744	891	971	8	26	80	0.3250000
NODE_2011_length_1600_cov_11.383744	891	971	9	50	80	0.6250000
NODE_2011_length_1600_cov_11.383744	944	1024	4	17	80	0.2125000
NODE_2011_length_1600_cov_11.383744	944	1024	5	18	80	0.2250000
NODE_2011_length_1600_cov_11.383744	944	1024	6	2	80	0.0250000
NODE_2011_length_1600_cov_11.383744	944	1024	8	36	80	0.4500000
NODE_2011_length_1600_cov_11.383744	944	1024	9	7	80	0.0875000
NODE_2013_length_1600_cov_7.236509	1037	1109	1	59	72	0.8194444
NODE_2013_length_1600_cov_7.236509	1037	1109	2	13	72	0.1805556
NODE_2013_length_1600_cov_7.236509	1090	1160	0	47	70	0.6714286
NODE_2013_length_1600_cov_7.236509	1090	1160	1	23	70	0.3285714
NODE_2018_length_1598_cov_29.337558	335	415	11	41	80	0.5125000
NODE_2018_length_1598_cov_29.337558	335	415	12	34	80	0.4250000
NODE_2018_length_1598_cov_29.337558	335	415	13	5	80	0.0625000
NODE_2018_length_1598_cov_29.337558	388	468	8	1	80	0.0125000
NODE_2018_length_1598_cov_29.337558	388	468	9	2	80	0.0250000
NODE_2018_length_1598_cov_29.337558	388	468	10	14	80	0.1750000
NODE_2018_length_1598_cov_29.337558	388	468	12	30	80	0.3750000
NODE_2018_length_1598_cov_29.337558	388	468	13	31	80	0.3875000
NODE_2018_length_1598_cov_29.337558	388	468	14	2	80	0.0250000
NODE_2018_length_1598_cov_29.337558	464	516	9	45	52	0.8653846
NODE_2018_length_1598_cov_29.337558	464	516	10	7	52	0.1346154
NODE_2018_length_1598_cov_29.337558	1026	1106	6	37	80	0.4625000
NODE_2018_length_1598_cov_29.337558	1026	1106	7	9	80	0.1125000
NODE_2018_length_1598_cov_29.337558	1026	1106	8	32	80	0.4000000
NODE_2018_length_1598_cov_29.337558	1026	1106	11	1	80	0.0125000
NODE_2018_length_1598_cov_29.337558	1026	1106	12	1	80	0.0125000
NODE_2018_length_1598_cov_29.337558	1079	1159	5	6	80	0.0750000
NODE_2018_length_1598_cov_29.337558	1079	1159	6	10	80	0.1250000
NODE_2018_length_1598_cov_29.337558	1079	1159	7	13	80	0.1625000
NODE_2018_length_1598_cov_29.337558	1079	1159	8	50	80	0.6250000
NODE_2018_length_1598_cov_29.337558	1079	1159	12	1	80	0.0125000
NODE_2019_length_1598_cov_3.730487	1117	1197	1	9	80	0.1125000
NODE_2019_length_1598_cov_3.730487	1117	1197	2	61	80	0.7625000
NODE_2019_length_1598_cov_3.730487	1117	1197	3	10	80	0.1250000
NODE_2021_length_1597_cov_7.434579	1373	1453	3	4	80	0.0500000
NODE_2021_length_1597_cov_7.434579	1373	1453	4	6	80	0.0750000
NODE_2021_length_1597_cov_7.434579	1373	1453	5	9	80	0.1125000
NODE_2021_length_1597_cov_7.434579	1373	1453	6	28	80	0.3500000
NODE_2021_length_1597_cov_7.434579	1373	1453	7	21	80	0.2625000
NODE_2021_length_1597_cov_7.434579	1373	1453	11	1	80	0.0125000
NODE_2021_length_1597_cov_7.434579	1373	1453	13	11	80	0.1375000
NODE_2021_length_1597_cov_7.434579	1382	1453	4	1	71	0.0140845
NODE_2021_length_1597_cov_7.434579	1382	1453	5	9	71	0.1267606
NODE_2021_length_1597_cov_7.434579	1382	1453	6	28	71	0.3943662
NODE_2021_length_1597_cov_7.434579	1382	1453	7	21	71	0.2957746
NODE_2021_length_1597_cov_7.434579	1382	1453	11	1	71	0.0140845
NODE_2021_length_1597_cov_7.434579	1382	1453	13	11	71	0.1549296
NODE_2022_length_1595_cov_16.788770	215	267	1	1	52	0.0192308
NODE_2022_length_1595_cov_16.788770	215	267	2	51	52	0.9807692
NODE_2022_length_1595_cov_16.788770	614	673	2	59	59	1.0000000
NODE_2025_length_1593_cov_22.412316	144	224	9	46	80	0.5750000
NODE_2025_length_1593_cov_22.412316	144	224	10	3	80	0.0375000
NODE_2025_length_1593_cov_22.412316	144	224	12	22	80	0.2750000
NODE_2025_length_1593_cov_22.412316	144	224	13	9	80	0.1125000
NODE_2025_length_1593_cov_22.412316	197	277	8	20	80	0.2500000
NODE_2025_length_1593_cov_22.412316	197	277	9	1	80	0.0125000
NODE_2025_length_1593_cov_22.412316	197	277	10	3	80	0.0375000
NODE_2025_length_1593_cov_22.412316	197	277	11	10	80	0.1250000
NODE_2025_length_1593_cov_22.412316	197	277	12	34	80	0.4250000
NODE_2025_length_1593_cov_22.412316	197	277	13	12	80	0.1500000
NODE_2025_length_1593_cov_22.412316	1192	1272	11	14	80	0.1750000
NODE_2025_length_1593_cov_22.412316	1192	1272	14	18	80	0.2250000
NODE_2025_length_1593_cov_22.412316	1192	1272	15	2	80	0.0250000
NODE_2025_length_1593_cov_22.412316	1192	1272	17	35	80	0.4375000
NODE_2025_length_1593_cov_22.412316	1192	1272	18	2	80	0.0250000
NODE_2025_length_1593_cov_22.412316	1192	1272	20	7	80	0.0875000
NODE_2025_length_1593_cov_22.412316	1192	1272	21	2	80	0.0250000
NODE_2025_length_1593_cov_22.412316	1245	1325	14	14	80	0.1750000
NODE_2025_length_1593_cov_22.412316	1245	1325	15	12	80	0.1500000
NODE_2025_length_1593_cov_22.412316	1245	1325	17	20	80	0.2500000
NODE_2025_length_1593_cov_22.412316	1245	1325	18	2	80	0.0250000
NODE_2025_length_1593_cov_22.412316	1245	1325	19	2	80	0.0250000
NODE_2025_length_1593_cov_22.412316	1245	1325	20	28	80	0.3500000
NODE_2025_length_1593_cov_22.412316	1245	1325	21	2	80	0.0250000
NODE_2026_length_1593_cov_14.092369	357	437	0	22	80	0.2750000
NODE_2026_length_1593_cov_14.092369	357	437	2	58	80	0.7250000
NODE_2026_length_1593_cov_14.092369	410	490	0	29	80	0.3625000
NODE_2026_length_1593_cov_14.092369	410	490	2	51	80	0.6375000
NODE_2026_length_1593_cov_14.092369	1061	1141	1	17	80	0.2125000
NODE_2026_length_1593_cov_14.092369	1061	1141	2	63	80	0.7875000
NODE_2026_length_1593_cov_14.092369	1114	1194	2	31	80	0.3875000
NODE_2026_length_1593_cov_14.092369	1114	1194	3	27	80	0.3375000
NODE_2026_length_1593_cov_14.092369	1114	1194	4	13	80	0.1625000
NODE_2026_length_1593_cov_14.092369	1114	1194	5	2	80	0.0250000
NODE_2026_length_1593_cov_14.092369	1114	1194	6	7	80	0.0875000
NODE_2031_length_1592_cov_4.576691	277	357	5	80	80	1.0000000
NODE_2031_length_1592_cov_4.576691	330	410	3	19	80	0.2375000
NODE_2031_length_1592_cov_4.576691	330	410	4	12	80	0.1500000
NODE_2031_length_1592_cov_4.576691	330	410	5	31	80	0.3875000
NODE_2031_length_1592_cov_4.576691	330	410	7	10	80	0.1250000
NODE_2031_length_1592_cov_4.576691	330	410	8	8	80	0.1000000
NODE_2034_length_1591_cov_15.481233	841	921	4	12	80	0.1500000
NODE_2034_length_1591_cov_15.481233	841	921	6	4	80	0.0500000
NODE_2034_length_1591_cov_15.481233	841	921	8	11	80	0.1375000
NODE_2034_length_1591_cov_15.481233	841	921	9	6	80	0.0750000
NODE_2034_length_1591_cov_15.481233	841	921	10	28	80	0.3500000
NODE_2034_length_1591_cov_15.481233	841	921	11	7	80	0.0875000
NODE_2034_length_1591_cov_15.481233	841	921	12	12	80	0.1500000
NODE_2034_length_1591_cov_15.481233	894	974	10	8	80	0.1000000
NODE_2034_length_1591_cov_15.481233	894	974	11	7	80	0.0875000
NODE_2034_length_1591_cov_15.481233	894	974	12	21	80	0.2625000
NODE_2034_length_1591_cov_15.481233	894	974	14	44	80	0.5500000
NODE_2035_length_1591_cov_4.040885	35	65	0	30	30	1.0000000
NODE_2035_length_1591_cov_4.040885	38	99	0	61	61	1.0000000
NODE_2042_length_1589_cov_10.184564	379	459	0	28	80	0.3500000
NODE_2042_length_1589_cov_10.184564	379	459	1	40	80	0.5000000
NODE_2042_length_1589_cov_10.184564	379	459	3	12	80	0.1500000
NODE_2042_length_1589_cov_10.184564	432	512	1	15	80	0.1875000
NODE_2042_length_1589_cov_10.184564	432	512	3	30	80	0.3750000
NODE_2042_length_1589_cov_10.184564	432	512	5	13	80	0.1625000
NODE_2042_length_1589_cov_10.184564	432	512	6	6	80	0.0750000
NODE_2042_length_1589_cov_10.184564	432	512	7	3	80	0.0375000
NODE_2042_length_1589_cov_10.184564	432	512	8	13	80	0.1625000
NODE_2042_length_1589_cov_10.184564	473	512	3	4	39	0.1025641
NODE_2042_length_1589_cov_10.184564	473	512	5	13	39	0.3333333
NODE_2042_length_1589_cov_10.184564	473	512	6	6	39	0.1538462
NODE_2042_length_1589_cov_10.184564	473	512	7	3	39	0.0769231
NODE_2042_length_1589_cov_10.184564	473	512	8	13	39	0.3333333
NODE_2042_length_1589_cov_10.184564	508	588	8	23	80	0.2875000
NODE_2042_length_1589_cov_10.184564	508	588	12	3	80	0.0375000
NODE_2042_length_1589_cov_10.184564	508	588	13	44	80	0.5500000
NODE_2042_length_1589_cov_10.184564	508	588	14	10	80	0.1250000
NODE_2042_length_1589_cov_10.184564	561	641	8	14	80	0.1750000
NODE_2042_length_1589_cov_10.184564	561	641	10	13	80	0.1625000
NODE_2042_length_1589_cov_10.184564	561	641	11	17	80	0.2125000
NODE_2042_length_1589_cov_10.184564	561	641	13	36	80	0.4500000
NODE_2043_length_1588_cov_9.955675	415	495	0	63	80	0.7875000
NODE_2043_length_1588_cov_9.955675	415	495	4	17	80	0.2125000
NODE_2043_length_1588_cov_9.955675	468	548	0	80	80	1.0000000
NODE_2046_length_1587_cov_7.942204	710	790	1	48	80	0.6000000
NODE_2046_length_1587_cov_7.942204	710	790	2	32	80	0.4000000
NODE_2046_length_1587_cov_7.942204	763	843	0	50	80	0.6250000
NODE_2046_length_1587_cov_7.942204	763	843	1	30	80	0.3750000
NODE_2049_length_1586_cov_6.488231	447	474	0	27	27	1.0000000
NODE_2049_length_1586_cov_6.488231	447	527	0	80	80	1.0000000
NODE_2049_length_1586_cov_6.488231	500	580	0	80	80	1.0000000
NODE_2056_length_1583_cov_27.825472	800	880	25	3	80	0.0375000
NODE_2056_length_1583_cov_27.825472	800	880	26	1	80	0.0125000
NODE_2056_length_1583_cov_27.825472	800	880	29	3	80	0.0375000
NODE_2056_length_1583_cov_27.825472	800	880	30	1	80	0.0125000
NODE_2056_length_1583_cov_27.825472	800	880	33	8	80	0.1000000
NODE_2056_length_1583_cov_27.825472	800	880	37	9	80	0.1125000
NODE_2056_length_1583_cov_27.825472	800	880	38	17	80	0.2125000
NODE_2056_length_1583_cov_27.825472	800	880	39	16	80	0.2000000
NODE_2056_length_1583_cov_27.825472	800	880	40	3	80	0.0375000
NODE_2056_length_1583_cov_27.825472	800	880	41	1	80	0.0125000
NODE_2056_length_1583_cov_27.825472	800	880	42	18	80	0.2250000
NODE_2056_length_1583_cov_27.825472	853	933	37	7	80	0.0875000
NODE_2056_length_1583_cov_27.825472	853	933	38	13	80	0.1625000
NODE_2056_length_1583_cov_27.825472	853	933	39	16	80	0.2000000
NODE_2056_length_1583_cov_27.825472	853	933	40	6	80	0.0750000
NODE_2056_length_1583_cov_27.825472	853	933	41	9	80	0.1125000
NODE_2056_length_1583_cov_27.825472	853	933	42	8	80	0.1000000
NODE_2056_length_1583_cov_27.825472	853	933	43	10	80	0.1250000
NODE_2056_length_1583_cov_27.825472	853	933	45	11	80	0.1375000
NODE_2056_length_1583_cov_27.825472	929	1009	26	11	80	0.1375000
NODE_2056_length_1583_cov_27.825472	929	1009	28	11	80	0.1375000
NODE_2056_length_1583_cov_27.825472	929	1009	29	7	80	0.0875000
NODE_2056_length_1583_cov_27.825472	929	1009	31	11	80	0.1375000
NODE_2056_length_1583_cov_27.825472	929	1009	33	3	80	0.0375000
NODE_2056_length_1583_cov_27.825472	929	1009	36	8	80	0.1000000
NODE_2056_length_1583_cov_27.825472	929	1009	39	1	80	0.0125000
NODE_2056_length_1583_cov_27.825472	929	1009	40	3	80	0.0375000
NODE_2056_length_1583_cov_27.825472	929	1009	42	2	80	0.0250000
NODE_2056_length_1583_cov_27.825472	929	1009	43	1	80	0.0125000
NODE_2056_length_1583_cov_27.825472	929	1009	44	11	80	0.1375000
NODE_2056_length_1583_cov_27.825472	929	1009	45	8	80	0.1000000
NODE_2056_length_1583_cov_27.825472	929	1009	47	1	80	0.0125000
NODE_2056_length_1583_cov_27.825472	929	1009	48	1	80	0.0125000
NODE_2056_length_1583_cov_27.825472	929	1009	49	1	80	0.0125000
NODE_2056_length_1583_cov_27.825472	982	1062	19	10	80	0.1250000
NODE_2056_length_1583_cov_27.825472	982	1062	20	4	80	0.0500000
NODE_2056_length_1583_cov_27.825472	982	1062	21	3	80	0.0375000
NODE_2056_length_1583_cov_27.825472	982	1062	22	7	80	0.0875000
NODE_2056_length_1583_cov_27.825472	982	1062	25	2	80	0.0250000
NODE_2056_length_1583_cov_27.825472	982	1062	26	38	80	0.4750000
NODE_2056_length_1583_cov_27.825472	982	1062	28	9	80	0.1125000
NODE_2056_length_1583_cov_27.825472	982	1062	29	7	80	0.0875000
NODE_2060_length_1581_cov_10.610661	457	537	0	80	80	1.0000000
NODE_2060_length_1581_cov_10.610661	510	590	0	41	80	0.5125000
NODE_2060_length_1581_cov_10.610661	510	590	3	39	80	0.4875000
NODE_2065_length_1579_cov_7.395946	5	80	0	75	75	1.0000000
NODE_2065_length_1579_cov_7.395946	58	126	0	68	68	1.0000000
NODE_2066_length_1579_cov_7.152027	1331	1409	2	29	78	0.3717949
NODE_2066_length_1579_cov_7.152027	1331	1409	3	25	78	0.3205128
NODE_2066_length_1579_cov_7.152027	1331	1409	4	24	78	0.3076923
NODE_2066_length_1579_cov_7.152027	1382	1462	1	8	80	0.1000000
NODE_2066_length_1579_cov_7.152027	1382	1462	2	72	80	0.9000000
NODE_2067_length_1579_cov_6.741892	4	52	0	48	48	1.0000000
NODE_2067_length_1579_cov_6.741892	4	52	0	48	48	1.0000000
NODE_2067_length_1579_cov_6.741892	4	52	0	48	48	1.0000000
NODE_2067_length_1579_cov_6.741892	25	105	0	80	80	1.0000000
NODE_2067_length_1579_cov_6.741892	25	91	0	66	66	1.0000000
NODE_2067_length_1579_cov_6.741892	25	96	0	71	71	1.0000000
NODE_2076_length_1575_cov_4.250000	993	1073	0	6	80	0.0750000
NODE_2076_length_1575_cov_4.250000	993	1073	1	20	80	0.2500000
NODE_2076_length_1575_cov_4.250000	993	1073	2	42	80	0.5250000
NODE_2076_length_1575_cov_4.250000	993	1073	3	12	80	0.1500000
NODE_2076_length_1575_cov_4.250000	1046	1126	2	15	80	0.1875000
NODE_2076_length_1575_cov_4.250000	1046	1126	3	13	80	0.1625000
NODE_2076_length_1575_cov_4.250000	1046	1126	4	52	80	0.6500000
NODE_2078_length_1574_cov_40.682034	551	631	15	17	80	0.2125000
NODE_2078_length_1574_cov_40.682034	551	631	16	5	80	0.0625000
NODE_2078_length_1574_cov_40.682034	551	631	17	32	80	0.4000000
NODE_2078_length_1574_cov_40.682034	551	631	18	6	80	0.0750000
NODE_2078_length_1574_cov_40.682034	551	631	19	20	80	0.2500000
NODE_2078_length_1574_cov_40.682034	604	684	10	7	80	0.0875000
NODE_2078_length_1574_cov_40.682034	604	684	11	9	80	0.1125000
NODE_2078_length_1574_cov_40.682034	604	684	12	11	80	0.1375000
NODE_2078_length_1574_cov_40.682034	604	684	13	8	80	0.1000000
NODE_2078_length_1574_cov_40.682034	604	684	14	1	80	0.0125000
NODE_2078_length_1574_cov_40.682034	604	684	15	24	80	0.3000000
NODE_2078_length_1574_cov_40.682034	604	684	16	8	80	0.1000000
NODE_2078_length_1574_cov_40.682034	604	684	17	12	80	0.1500000
NODE_2078_length_1574_cov_40.682034	680	760	12	4	80	0.0500000
NODE_2078_length_1574_cov_40.682034	680	760	13	1	80	0.0125000
NODE_2078_length_1574_cov_40.682034	680	760	15	25	80	0.3125000
NODE_2078_length_1574_cov_40.682034	680	760	16	17	80	0.2125000
NODE_2078_length_1574_cov_40.682034	680	760	17	14	80	0.1750000
NODE_2078_length_1574_cov_40.682034	680	760	18	10	80	0.1250000
NODE_2078_length_1574_cov_40.682034	680	760	19	9	80	0.1125000
NODE_2078_length_1574_cov_40.682034	733	813	16	3	80	0.0375000
NODE_2078_length_1574_cov_40.682034	733	813	17	40	80	0.5000000
NODE_2078_length_1574_cov_40.682034	733	813	18	9	80	0.1125000
NODE_2078_length_1574_cov_40.682034	733	813	19	28	80	0.3500000
NODE_2079_length_1574_cov_7.572203	1306	1386	2	4	80	0.0500000
NODE_2079_length_1574_cov_7.572203	1306	1386	4	21	80	0.2625000
NODE_2079_length_1574_cov_7.572203	1306	1386	5	55	80	0.6875000
NODE_2079_length_1574_cov_7.572203	1359	1439	1	13	80	0.1625000
NODE_2079_length_1574_cov_7.572203	1359	1439	2	27	80	0.3375000
NODE_2079_length_1574_cov_7.572203	1359	1439	3	17	80	0.2125000
NODE_2079_length_1574_cov_7.572203	1359	1439	4	21	80	0.2625000
NODE_2079_length_1574_cov_7.572203	1359	1439	5	2	80	0.0250000
NODE_2081_length_1573_cov_16.107191	437	512	0	75	75	1.0000000
NODE_2081_length_1573_cov_16.107191	485	565	0	80	80	1.0000000
NODE_2081_length_1573_cov_16.107191	561	639	0	21	78	0.2692308
NODE_2081_length_1573_cov_16.107191	561	639	2	2	78	0.0256410
NODE_2081_length_1573_cov_16.107191	561	639	3	1	78	0.0128205
NODE_2081_length_1573_cov_16.107191	561	639	4	28	78	0.3589744
NODE_2081_length_1573_cov_16.107191	561	639	5	11	78	0.1410256
NODE_2081_length_1573_cov_16.107191	561	639	6	15	78	0.1923077
NODE_2081_length_1573_cov_16.107191	612	692	4	1	80	0.0125000
NODE_2081_length_1573_cov_16.107191	612	692	5	11	80	0.1375000
NODE_2081_length_1573_cov_16.107191	612	692	6	68	80	0.8500000
NODE_2085_length_1572_cov_25.966735	359	404	17	3	45	0.0666667
NODE_2085_length_1572_cov_25.966735	359	404	18	7	45	0.1555556
NODE_2085_length_1572_cov_25.966735	359	404	19	8	45	0.1777778
NODE_2085_length_1572_cov_25.966735	359	404	20	3	45	0.0666667
NODE_2085_length_1572_cov_25.966735	359	404	21	1	45	0.0222222
NODE_2085_length_1572_cov_25.966735	359	404	22	13	45	0.2888889
NODE_2085_length_1572_cov_25.966735	359	404	23	4	45	0.0888889
NODE_2085_length_1572_cov_25.966735	359	404	25	6	45	0.1333333
NODE_2085_length_1572_cov_25.966735	405	477	20	19	72	0.2638889
NODE_2085_length_1572_cov_25.966735	405	477	21	11	72	0.1527778
NODE_2085_length_1572_cov_25.966735	405	477	22	11	72	0.1527778
NODE_2085_length_1572_cov_25.966735	405	477	23	16	72	0.2222222
NODE_2085_length_1572_cov_25.966735	405	477	24	10	72	0.1388889
NODE_2085_length_1572_cov_25.966735	405	477	25	5	72	0.0694444
NODE_2085_length_1572_cov_25.966735	1016	1096	10	9	80	0.1125000
NODE_2085_length_1572_cov_25.966735	1016	1096	11	4	80	0.0500000
NODE_2085_length_1572_cov_25.966735	1016	1096	12	8	80	0.1000000
NODE_2085_length_1572_cov_25.966735	1016	1096	13	12	80	0.1500000
NODE_2085_length_1572_cov_25.966735	1016	1096	14	19	80	0.2375000
NODE_2085_length_1572_cov_25.966735	1016	1096	16	1	80	0.0125000
NODE_2085_length_1572_cov_25.966735	1016	1096	17	12	80	0.1500000
NODE_2085_length_1572_cov_25.966735	1016	1096	18	7	80	0.0875000
NODE_2085_length_1572_cov_25.966735	1016	1096	19	8	80	0.1000000
NODE_2085_length_1572_cov_25.966735	1069	1149	9	7	80	0.0875000
NODE_2085_length_1572_cov_25.966735	1069	1149	13	7	80	0.0875000
NODE_2085_length_1572_cov_25.966735	1069	1149	15	1	80	0.0125000
NODE_2085_length_1572_cov_25.966735	1069	1149	17	12	80	0.1500000
NODE_2085_length_1572_cov_25.966735	1069	1149	18	31	80	0.3875000
NODE_2085_length_1572_cov_25.966735	1069	1149	19	22	80	0.2750000
NODE_2086_length_1572_cov_3.513238	1386	1462	0	76	76	1.0000000
NODE_2090_length_1570_cov_21.745071	700	780	17	3	80	0.0375000
NODE_2090_length_1570_cov_21.745071	700	780	18	10	80	0.1250000
NODE_2090_length_1570_cov_21.745071	700	780	19	30	80	0.3750000
NODE_2090_length_1570_cov_21.745071	700	780	20	12	80	0.1500000
NODE_2090_length_1570_cov_21.745071	700	780	21	14	80	0.1750000
NODE_2090_length_1570_cov_21.745071	700	780	22	1	80	0.0125000
NODE_2090_length_1570_cov_21.745071	700	780	23	6	80	0.0750000
NODE_2090_length_1570_cov_21.745071	700	780	25	4	80	0.0500000
NODE_2090_length_1570_cov_21.745071	753	833	12	15	80	0.1875000
NODE_2090_length_1570_cov_21.745071	753	833	13	1	80	0.0125000
NODE_2090_length_1570_cov_21.745071	753	833	14	9	80	0.1125000
NODE_2090_length_1570_cov_21.745071	753	833	15	1	80	0.0125000
NODE_2090_length_1570_cov_21.745071	753	833	16	4	80	0.0500000
NODE_2090_length_1570_cov_21.745071	753	833	18	32	80	0.4000000
NODE_2090_length_1570_cov_21.745071	753	833	19	5	80	0.0625000
NODE_2090_length_1570_cov_21.745071	753	833	20	11	80	0.1375000
NODE_2090_length_1570_cov_21.745071	753	833	21	1	80	0.0125000
NODE_2090_length_1570_cov_21.745071	753	833	22	1	80	0.0125000
NODE_2091_length_1570_cov_3.276003	387	467	1	11	80	0.1375000
NODE_2091_length_1570_cov_3.276003	387	467	2	42	80	0.5250000
NODE_2091_length_1570_cov_3.276003	387	467	3	25	80	0.3125000
NODE_2091_length_1570_cov_3.276003	387	467	4	2	80	0.0250000
NODE_2091_length_1570_cov_3.276003	440	520	3	34	80	0.4250000
NODE_2091_length_1570_cov_3.276003	440	520	4	46	80	0.5750000
NODE_2093_length_1569_cov_53.941497	741	821	34	1	80	0.0125000
NODE_2093_length_1569_cov_53.941497	741	821	36	11	80	0.1375000
NODE_2093_length_1569_cov_53.941497	741	821	43	4	80	0.0500000
NODE_2093_length_1569_cov_53.941497	741	821	44	25	80	0.3125000
NODE_2093_length_1569_cov_53.941497	741	821	45	7	80	0.0875000
NODE_2093_length_1569_cov_53.941497	741	821	47	8	80	0.1000000
NODE_2093_length_1569_cov_53.941497	741	821	48	1	80	0.0125000
NODE_2093_length_1569_cov_53.941497	741	821	51	1	80	0.0125000
NODE_2093_length_1569_cov_53.941497	741	821	52	7	80	0.0875000
NODE_2093_length_1569_cov_53.941497	741	821	53	2	80	0.0250000
NODE_2093_length_1569_cov_53.941497	741	821	54	2	80	0.0250000
NODE_2093_length_1569_cov_53.941497	741	821	55	4	80	0.0500000
NODE_2093_length_1569_cov_53.941497	741	821	57	3	80	0.0375000
NODE_2093_length_1569_cov_53.941497	741	821	58	4	80	0.0500000
NODE_2093_length_1569_cov_53.941497	794	874	41	5	80	0.0625000
NODE_2093_length_1569_cov_53.941497	794	874	42	5	80	0.0625000
NODE_2093_length_1569_cov_53.941497	794	874	43	9	80	0.1125000
NODE_2093_length_1569_cov_53.941497	794	874	44	26	80	0.3250000
NODE_2093_length_1569_cov_53.941497	794	874	45	1	80	0.0125000
NODE_2093_length_1569_cov_53.941497	794	874	48	1	80	0.0125000
NODE_2093_length_1569_cov_53.941497	794	874	51	12	80	0.1500000
NODE_2093_length_1569_cov_53.941497	794	874	52	19	80	0.2375000
NODE_2093_length_1569_cov_53.941497	794	874	53	2	80	0.0250000
NODE_2093_length_1569_cov_53.941497	870	950	21	6	80	0.0750000
NODE_2093_length_1569_cov_53.941497	870	950	22	8	80	0.1000000
NODE_2093_length_1569_cov_53.941497	870	950	24	12	80	0.1500000
NODE_2093_length_1569_cov_53.941497	870	950	36	1	80	0.0125000
NODE_2093_length_1569_cov_53.941497	870	950	37	1	80	0.0125000
NODE_2093_length_1569_cov_53.941497	870	950	38	14	80	0.1750000
NODE_2093_length_1569_cov_53.941497	870	950	40	5	80	0.0625000
NODE_2093_length_1569_cov_53.941497	870	950	43	1	80	0.0125000
NODE_2093_length_1569_cov_53.941497	870	950	44	3	80	0.0375000
NODE_2093_length_1569_cov_53.941497	870	950	45	16	80	0.2000000
NODE_2093_length_1569_cov_53.941497	870	950	46	1	80	0.0125000
NODE_2093_length_1569_cov_53.941497	870	950	47	6	80	0.0750000
NODE_2093_length_1569_cov_53.941497	870	950	51	5	80	0.0625000
NODE_2093_length_1569_cov_53.941497	870	950	52	1	80	0.0125000
NODE_2093_length_1569_cov_53.941497	923	1003	7	9	80	0.1125000
NODE_2093_length_1569_cov_53.941497	923	1003	19	27	80	0.3375000
NODE_2093_length_1569_cov_53.941497	923	1003	20	11	80	0.1375000
NODE_2093_length_1569_cov_53.941497	923	1003	21	12	80	0.1500000
NODE_2093_length_1569_cov_53.941497	923	1003	22	8	80	0.1000000
NODE_2093_length_1569_cov_53.941497	923	1003	24	12	80	0.1500000
NODE_2093_length_1569_cov_53.941497	923	1003	36	1	80	0.0125000
NODE_2094_length_1569_cov_12.426531	640	720	11	15	80	0.1875000
NODE_2094_length_1569_cov_12.426531	640	720	12	29	80	0.3625000
NODE_2094_length_1569_cov_12.426531	640	720	13	5	80	0.0625000
NODE_2094_length_1569_cov_12.426531	640	720	14	31	80	0.3875000
NODE_2094_length_1569_cov_12.426531	693	773	9	16	80	0.2000000
NODE_2094_length_1569_cov_12.426531	693	773	10	14	80	0.1750000
NODE_2094_length_1569_cov_12.426531	693	773	11	15	80	0.1875000
NODE_2094_length_1569_cov_12.426531	693	773	12	19	80	0.2375000
NODE_2094_length_1569_cov_12.426531	693	773	13	1	80	0.0125000
NODE_2094_length_1569_cov_12.426531	693	773	14	15	80	0.1875000
NODE_2094_length_1569_cov_12.426531	769	849	3	20	80	0.2500000
NODE_2094_length_1569_cov_12.426531	769	849	4	37	80	0.4625000
NODE_2094_length_1569_cov_12.426531	769	849	7	7	80	0.0875000
NODE_2094_length_1569_cov_12.426531	769	849	8	5	80	0.0625000
NODE_2094_length_1569_cov_12.426531	769	849	9	11	80	0.1375000
NODE_2094_length_1569_cov_12.426531	822	902	0	30	80	0.3750000
NODE_2094_length_1569_cov_12.426531	822	902	3	43	80	0.5375000
NODE_2094_length_1569_cov_12.426531	822	902	4	7	80	0.0875000
NODE_2095_length_1569_cov_12.365986	450	530	5	9	80	0.1125000
NODE_2095_length_1569_cov_12.365986	450	530	6	26	80	0.3250000
NODE_2095_length_1569_cov_12.365986	450	530	8	10	80	0.1250000
NODE_2095_length_1569_cov_12.365986	450	530	10	23	80	0.2875000
NODE_2095_length_1569_cov_12.365986	450	530	12	12	80	0.1500000
NODE_2095_length_1569_cov_12.365986	450	530	5	9	80	0.1125000
NODE_2095_length_1569_cov_12.365986	450	530	6	26	80	0.3250000
NODE_2095_length_1569_cov_12.365986	450	530	8	10	80	0.1250000
NODE_2095_length_1569_cov_12.365986	450	530	10	23	80	0.2875000
NODE_2095_length_1569_cov_12.365986	450	530	12	12	80	0.1500000
NODE_2095_length_1569_cov_12.365986	503	564	6	8	61	0.1311475
NODE_2095_length_1569_cov_12.365986	503	564	7	4	61	0.0655738
NODE_2095_length_1569_cov_12.365986	503	564	8	3	61	0.0491803
NODE_2095_length_1569_cov_12.365986	503	564	10	24	61	0.3934426
NODE_2095_length_1569_cov_12.365986	503	564	12	22	61	0.3606557
NODE_2095_length_1569_cov_12.365986	503	556	7	4	53	0.0754717
NODE_2095_length_1569_cov_12.365986	503	556	8	3	53	0.0566038
NODE_2095_length_1569_cov_12.365986	503	556	10	24	53	0.4528302
NODE_2095_length_1569_cov_12.365986	503	556	12	22	53	0.4150943
NODE_2096_length_1569_cov_11.599320	798	878	1	72	80	0.9000000
NODE_2096_length_1569_cov_11.599320	798	878	2	8	80	0.1000000
NODE_2096_length_1569_cov_11.599320	851	931	1	49	80	0.6125000
NODE_2096_length_1569_cov_11.599320	851	931	2	31	80	0.3875000
NODE_2097_length_1569_cov_10.917687	521	601	3	36	80	0.4500000
NODE_2097_length_1569_cov_10.917687	521	601	4	4	80	0.0500000
NODE_2097_length_1569_cov_10.917687	521	601	6	14	80	0.1750000
NODE_2097_length_1569_cov_10.917687	521	601	7	14	80	0.1750000
NODE_2097_length_1569_cov_10.917687	521	601	8	12	80	0.1500000
NODE_2097_length_1569_cov_10.917687	574	654	6	1	80	0.0125000
NODE_2097_length_1569_cov_10.917687	574	654	7	45	80	0.5625000
NODE_2097_length_1569_cov_10.917687	574	654	8	15	80	0.1875000
NODE_2097_length_1569_cov_10.917687	574	654	9	10	80	0.1250000
NODE_2097_length_1569_cov_10.917687	574	654	10	9	80	0.1125000
NODE_2108_length_1563_cov_15.357240	590	670	10	19	80	0.2375000
NODE_2108_length_1563_cov_15.357240	590	670	11	13	80	0.1625000
NODE_2108_length_1563_cov_15.357240	590	670	12	11	80	0.1375000
NODE_2108_length_1563_cov_15.357240	590	670	13	29	80	0.3625000
NODE_2108_length_1563_cov_15.357240	590	670	14	8	80	0.1000000
NODE_2108_length_1563_cov_15.357240	643	723	10	15	80	0.1875000
NODE_2108_length_1563_cov_15.357240	643	723	11	4	80	0.0500000
NODE_2108_length_1563_cov_15.357240	643	723	12	23	80	0.2875000
NODE_2108_length_1563_cov_15.357240	643	723	13	38	80	0.4750000
NODE_2110_length_1561_cov_18.420657	354	434	0	59	80	0.7375000
NODE_2110_length_1561_cov_18.420657	354	434	1	2	80	0.0250000
NODE_2110_length_1561_cov_18.420657	354	434	2	19	80	0.2375000
NODE_2110_length_1561_cov_18.420657	407	487	0	6	80	0.0750000
NODE_2110_length_1561_cov_18.420657	407	487	1	2	80	0.0250000
NODE_2110_length_1561_cov_18.420657	407	487	2	51	80	0.6375000
NODE_2110_length_1561_cov_18.420657	407	487	3	2	80	0.0250000
NODE_2110_length_1561_cov_18.420657	407	487	4	6	80	0.0750000
NODE_2110_length_1561_cov_18.420657	407	487	6	11	80	0.1375000
NODE_2110_length_1561_cov_18.420657	407	487	7	2	80	0.0250000
NODE_2110_length_1561_cov_18.420657	483	563	6	2	80	0.0250000
NODE_2110_length_1561_cov_18.420657	483	563	7	5	80	0.0625000
NODE_2110_length_1561_cov_18.420657	483	563	8	68	80	0.8500000
NODE_2110_length_1561_cov_18.420657	483	563	10	5	80	0.0625000
NODE_2110_length_1561_cov_18.420657	536	616	8	73	80	0.9125000
NODE_2110_length_1561_cov_18.420657	536	616	9	2	80	0.0250000
NODE_2110_length_1561_cov_18.420657	536	616	10	5	80	0.0625000
NODE_2116_length_1559_cov_7.071233	347	427	0	80	80	1.0000000
NODE_2116_length_1559_cov_7.071233	400	478	0	78	78	1.0000000
NODE_2116_length_1559_cov_7.071233	1187	1238	11	9	51	0.1764706
NODE_2116_length_1559_cov_7.071233	1187	1238	12	42	51	0.8235294
NODE_2118_length_1558_cov_3.486635	338	418	1	80	80	1.0000000
NODE_2118_length_1558_cov_3.486635	391	471	0	50	80	0.6250000
NODE_2118_length_1558_cov_3.486635	391	471	1	30	80	0.3750000
NODE_2119_length_1557_cov_17.089163	542	622	10	2	80	0.0250000
NODE_2119_length_1557_cov_17.089163	542	622	11	17	80	0.2125000
NODE_2119_length_1557_cov_17.089163	542	622	12	29	80	0.3625000
NODE_2119_length_1557_cov_17.089163	542	622	13	14	80	0.1750000
NODE_2119_length_1557_cov_17.089163	542	622	14	7	80	0.0875000
NODE_2119_length_1557_cov_17.089163	542	622	15	11	80	0.1375000
NODE_2119_length_1557_cov_17.089163	595	675	8	3	80	0.0375000
NODE_2119_length_1557_cov_17.089163	595	675	9	9	80	0.1125000
NODE_2119_length_1557_cov_17.089163	595	675	10	5	80	0.0625000
NODE_2119_length_1557_cov_17.089163	595	675	11	23	80	0.2875000
NODE_2119_length_1557_cov_17.089163	595	675	12	40	80	0.5000000
NODE_2120_length_1557_cov_4.639918	0	56	0	56	56	1.0000000
NODE_2120_length_1557_cov_4.639918	49	112	0	63	63	1.0000000
NODE_2120_length_1557_cov_4.639918	85	161	0	76	76	1.0000000
NODE_2123_length_1556_cov_23.289636	456	536	7	15	80	0.1875000
NODE_2123_length_1556_cov_23.289636	456	536	8	6	80	0.0750000
NODE_2123_length_1556_cov_23.289636	456	536	9	10	80	0.1250000
NODE_2123_length_1556_cov_23.289636	456	536	10	29	80	0.3625000
NODE_2123_length_1556_cov_23.289636	456	536	11	20	80	0.2500000
NODE_2123_length_1556_cov_23.289636	509	589	7	10	80	0.1250000
NODE_2123_length_1556_cov_23.289636	509	589	8	8	80	0.1000000
NODE_2123_length_1556_cov_23.289636	509	589	9	51	80	0.6375000
NODE_2123_length_1556_cov_23.289636	509	589	10	11	80	0.1375000
NODE_2123_length_1556_cov_23.289636	681	761	1	4	80	0.0500000
NODE_2123_length_1556_cov_23.289636	681	761	2	33	80	0.4125000
NODE_2123_length_1556_cov_23.289636	681	761	4	43	80	0.5375000
NODE_2123_length_1556_cov_23.289636	734	814	3	15	80	0.1875000
NODE_2123_length_1556_cov_23.289636	734	814	4	65	80	0.8125000
NODE_2123_length_1556_cov_23.289636	1445	1525	0	80	80	1.0000000
NODE_2124_length_1556_cov_7.494166	300	380	2	22	80	0.2750000
NODE_2124_length_1556_cov_7.494166	300	380	3	34	80	0.4250000
NODE_2124_length_1556_cov_7.494166	300	380	4	24	80	0.3000000
NODE_2124_length_1556_cov_7.494166	353	433	3	3	80	0.0375000
NODE_2124_length_1556_cov_7.494166	353	433	4	77	80	0.9625000
NODE_2126_length_1555_cov_13.461538	666	746	4	4	80	0.0500000
NODE_2126_length_1555_cov_13.461538	666	746	5	17	80	0.2125000
NODE_2126_length_1555_cov_13.461538	666	746	8	55	80	0.6875000
NODE_2126_length_1555_cov_13.461538	666	746	9	4	80	0.0500000
NODE_2126_length_1555_cov_13.461538	719	799	8	35	80	0.4375000
NODE_2126_length_1555_cov_13.461538	719	799	11	7	80	0.0875000
NODE_2126_length_1555_cov_13.461538	719	799	14	1	80	0.0125000
NODE_2126_length_1555_cov_13.461538	719	799	15	1	80	0.0125000
NODE_2126_length_1555_cov_13.461538	719	799	16	34	80	0.4250000
NODE_2126_length_1555_cov_13.461538	719	799	17	2	80	0.0250000
NODE_2127_length_1554_cov_30.239175	144	226	0	82	82	1.0000000
NODE_2127_length_1554_cov_30.239175	199	279	0	80	80	1.0000000
NODE_2127_length_1554_cov_30.239175	877	903	7	15	26	0.5769231
NODE_2127_length_1554_cov_30.239175	877	903	8	10	26	0.3846154
NODE_2127_length_1554_cov_30.239175	877	903	11	1	26	0.0384615
NODE_2127_length_1554_cov_30.239175	930	1010	9	10	80	0.1250000
NODE_2127_length_1554_cov_30.239175	930	1010	11	54	80	0.6750000
NODE_2127_length_1554_cov_30.239175	930	1010	12	3	80	0.0375000
NODE_2127_length_1554_cov_30.239175	930	1010	14	13	80	0.1625000
NODE_2127_length_1554_cov_30.239175	983	1063	6	2	80	0.0250000
NODE_2127_length_1554_cov_30.239175	983	1063	7	3	80	0.0375000
NODE_2127_length_1554_cov_30.239175	983	1063	10	16	80	0.2000000
NODE_2127_length_1554_cov_30.239175	983	1063	11	34	80	0.4250000
NODE_2127_length_1554_cov_30.239175	983	1063	12	3	80	0.0375000
NODE_2127_length_1554_cov_30.239175	983	1063	14	22	80	0.2750000
NODE_2128_length_1554_cov_5.381443	1494	1554	0	60	60	1.0000000
NODE_2132_length_1552_cov_11.367515	379	445	16	23	66	0.3484848
NODE_2132_length_1552_cov_11.367515	379	445	18	43	66	0.6515151
NODE_2132_length_1552_cov_11.367515	418	484	6	18	66	0.2727273
NODE_2132_length_1552_cov_11.367515	418	484	14	15	66	0.2272727
NODE_2132_length_1552_cov_11.367515	418	484	15	2	66	0.0303030
NODE_2132_length_1552_cov_11.367515	418	484	16	5	66	0.0757576
NODE_2132_length_1552_cov_11.367515	418	484	18	26	66	0.3939394
NODE_2138_length_1549_cov_15.480000	1288	1368	0	80	80	1.0000000
NODE_2138_length_1549_cov_15.480000	1341	1421	0	80	80	1.0000000
NODE_2142_length_1548_cov_12.789510	770	850	4	9	80	0.1125000
NODE_2142_length_1548_cov_12.789510	770	850	6	6	80	0.0750000
NODE_2142_length_1548_cov_12.789510	770	850	8	65	80	0.8125000
NODE_2142_length_1548_cov_12.789510	823	903	4	5	80	0.0625000
NODE_2142_length_1548_cov_12.789510	823	903	6	23	80	0.2875000
NODE_2142_length_1548_cov_12.789510	823	903	8	52	80	0.6500000
NODE_2149_length_1546_cov_24.069800	775	855	10	22	80	0.2750000
NODE_2149_length_1546_cov_24.069800	775	855	11	6	80	0.0750000
NODE_2149_length_1546_cov_24.069800	775	855	12	33	80	0.4125000
NODE_2149_length_1546_cov_24.069800	775	855	14	19	80	0.2375000
NODE_2149_length_1546_cov_24.069800	828	908	4	10	80	0.1250000
NODE_2149_length_1546_cov_24.069800	828	908	5	6	80	0.0750000
NODE_2149_length_1546_cov_24.069800	828	908	6	8	80	0.1000000
NODE_2149_length_1546_cov_24.069800	828	908	8	4	80	0.0500000
NODE_2149_length_1546_cov_24.069800	828	908	10	5	80	0.0625000
NODE_2149_length_1546_cov_24.069800	828	908	11	1	80	0.0125000
NODE_2149_length_1546_cov_24.069800	828	908	12	26	80	0.3250000
NODE_2149_length_1546_cov_24.069800	828	908	14	20	80	0.2500000
NODE_2150_length_1546_cov_10.911541	417	497	2	4	80	0.0500000
NODE_2150_length_1546_cov_10.911541	417	497	3	26	80	0.3250000
NODE_2150_length_1546_cov_10.911541	417	497	4	12	80	0.1500000
NODE_2150_length_1546_cov_10.911541	417	497	5	12	80	0.1500000
NODE_2150_length_1546_cov_10.911541	417	497	6	19	80	0.2375000
NODE_2150_length_1546_cov_10.911541	417	497	7	7	80	0.0875000
NODE_2150_length_1546_cov_10.911541	470	550	5	1	80	0.0125000
NODE_2150_length_1546_cov_10.911541	470	550	6	33	80	0.4125000
NODE_2150_length_1546_cov_10.911541	470	550	7	46	80	0.5750000
NODE_2150_length_1546_cov_10.911541	1065	1145	0	80	80	1.0000000
NODE_2150_length_1546_cov_10.911541	1118	1198	0	80	80	1.0000000
NODE_2155_length_1543_cov_10.400970	480	560	3	43	80	0.5375000
NODE_2155_length_1543_cov_10.400970	480	560	4	14	80	0.1750000
NODE_2155_length_1543_cov_10.400970	480	560	5	20	80	0.2500000
NODE_2155_length_1543_cov_10.400970	480	560	6	3	80	0.0375000
NODE_2155_length_1543_cov_10.400970	533	613	4	4	80	0.0500000
NODE_2155_length_1543_cov_10.400970	533	613	5	42	80	0.5250000
NODE_2155_length_1543_cov_10.400970	533	613	6	17	80	0.2125000
NODE_2155_length_1543_cov_10.400970	533	613	7	17	80	0.2125000
NODE_2156_length_1543_cov_4.532548	43	98	0	55	55	1.0000000
NODE_2162_length_1541_cov_7.316921	523	603	0	17	80	0.2125000
NODE_2162_length_1541_cov_7.316921	523	603	1	28	80	0.3500000
NODE_2162_length_1541_cov_7.316921	523	603	2	35	80	0.4375000
NODE_2162_length_1541_cov_7.316921	576	658	2	82	82	1.0000000
NODE_2165_length_1539_cov_19.067361	334	414	3	6	80	0.0750000
NODE_2165_length_1539_cov_19.067361	334	414	4	6	80	0.0750000
NODE_2165_length_1539_cov_19.067361	334	414	7	18	80	0.2250000
NODE_2165_length_1539_cov_19.067361	334	414	10	8	80	0.1000000
NODE_2165_length_1539_cov_19.067361	334	414	11	24	80	0.3000000
NODE_2165_length_1539_cov_19.067361	334	414	12	16	80	0.2000000
NODE_2165_length_1539_cov_19.067361	334	414	13	2	80	0.0250000
NODE_2165_length_1539_cov_19.067361	387	467	10	17	80	0.2125000
NODE_2165_length_1539_cov_19.067361	387	467	11	36	80	0.4500000
NODE_2165_length_1539_cov_19.067361	387	467	12	25	80	0.3125000
NODE_2165_length_1539_cov_19.067361	387	467	13	2	80	0.0250000
NODE_2165_length_1539_cov_19.067361	463	543	9	4	80	0.0500000
NODE_2165_length_1539_cov_19.067361	463	543	10	4	80	0.0500000
NODE_2165_length_1539_cov_19.067361	463	543	11	16	80	0.2000000
NODE_2165_length_1539_cov_19.067361	463	543	12	27	80	0.3375000
NODE_2165_length_1539_cov_19.067361	463	543	13	2	80	0.0250000
NODE_2165_length_1539_cov_19.067361	463	543	14	21	80	0.2625000
NODE_2165_length_1539_cov_19.067361	463	543	15	2	80	0.0250000
NODE_2165_length_1539_cov_19.067361	463	543	17	4	80	0.0500000
NODE_2165_length_1539_cov_19.067361	516	596	9	2	80	0.0250000
NODE_2165_length_1539_cov_19.067361	516	596	11	16	80	0.2000000
NODE_2165_length_1539_cov_19.067361	516	596	12	3	80	0.0375000
NODE_2165_length_1539_cov_19.067361	516	596	13	2	80	0.0250000
NODE_2165_length_1539_cov_19.067361	516	596	15	10	80	0.1250000
NODE_2165_length_1539_cov_19.067361	516	596	16	2	80	0.0250000
NODE_2165_length_1539_cov_19.067361	516	596	17	28	80	0.3500000
NODE_2165_length_1539_cov_19.067361	516	596	19	17	80	0.2125000
NODE_2171_length_1538_cov_68.273801	604	684	18	4	80	0.0500000
NODE_2171_length_1538_cov_68.273801	604	684	20	14	80	0.1750000
NODE_2171_length_1538_cov_68.273801	604	684	21	2	80	0.0250000
NODE_2171_length_1538_cov_68.273801	604	684	24	8	80	0.1000000
NODE_2171_length_1538_cov_68.273801	604	684	25	9	80	0.1125000
NODE_2171_length_1538_cov_68.273801	604	684	26	1	80	0.0125000
NODE_2171_length_1538_cov_68.273801	604	684	27	1	80	0.0125000
NODE_2171_length_1538_cov_68.273801	604	684	28	1	80	0.0125000
NODE_2171_length_1538_cov_68.273801	604	684	29	1	80	0.0125000
NODE_2171_length_1538_cov_68.273801	604	684	30	4	80	0.0500000
NODE_2171_length_1538_cov_68.273801	604	684	31	11	80	0.1375000
NODE_2171_length_1538_cov_68.273801	604	684	32	4	80	0.0500000
NODE_2171_length_1538_cov_68.273801	604	684	33	20	80	0.2500000
NODE_2171_length_1538_cov_68.273801	657	737	13	20	80	0.2500000
NODE_2171_length_1538_cov_68.273801	657	737	14	13	80	0.1625000
NODE_2171_length_1538_cov_68.273801	657	737	15	13	80	0.1625000
NODE_2171_length_1538_cov_68.273801	657	737	18	11	80	0.1375000
NODE_2171_length_1538_cov_68.273801	657	737	20	14	80	0.1750000
NODE_2171_length_1538_cov_68.273801	657	737	21	2	80	0.0250000
NODE_2171_length_1538_cov_68.273801	657	737	24	7	80	0.0875000
NODE_2172_length_1538_cov_2.402363	1456	1499	0	43	43	1.0000000
NODE_2173_length_1537_cov_39.413074	782	862	8	27	80	0.3375000
NODE_2173_length_1537_cov_39.413074	782	862	9	21	80	0.2625000
NODE_2173_length_1537_cov_39.413074	782	862	10	14	80	0.1750000
NODE_2173_length_1537_cov_39.413074	782	862	11	12	80	0.1500000
NODE_2173_length_1537_cov_39.413074	782	862	12	2	80	0.0250000
NODE_2173_length_1537_cov_39.413074	782	862	16	4	80	0.0500000
NODE_2173_length_1537_cov_39.413074	835	915	9	12	80	0.1500000
NODE_2173_length_1537_cov_39.413074	835	915	10	3	80	0.0375000
NODE_2173_length_1537_cov_39.413074	835	915	11	8	80	0.1000000
NODE_2173_length_1537_cov_39.413074	835	915	16	5	80	0.0625000
NODE_2173_length_1537_cov_39.413074	835	915	17	14	80	0.1750000
NODE_2173_length_1537_cov_39.413074	835	915	20	10	80	0.1250000
NODE_2173_length_1537_cov_39.413074	835	915	21	4	80	0.0500000
NODE_2173_length_1537_cov_39.413074	835	915	22	1	80	0.0125000
NODE_2173_length_1537_cov_39.413074	835	915	25	15	80	0.1875000
NODE_2173_length_1537_cov_39.413074	835	915	27	1	80	0.0125000
NODE_2173_length_1537_cov_39.413074	835	915	28	7	80	0.0875000
NODE_2173_length_1537_cov_39.413074	911	991	24	2	80	0.0250000
NODE_2173_length_1537_cov_39.413074	911	991	26	1	80	0.0125000
NODE_2173_length_1537_cov_39.413074	911	991	27	2	80	0.0250000
NODE_2173_length_1537_cov_39.413074	911	991	28	8	80	0.1000000
NODE_2173_length_1537_cov_39.413074	911	991	29	1	80	0.0125000
NODE_2173_length_1537_cov_39.413074	911	991	30	3	80	0.0375000
NODE_2173_length_1537_cov_39.413074	911	991	33	18	80	0.2250000
NODE_2173_length_1537_cov_39.413074	911	991	34	9	80	0.1125000
NODE_2173_length_1537_cov_39.413074	911	991	35	20	80	0.2500000
NODE_2173_length_1537_cov_39.413074	911	991	36	16	80	0.2000000
NODE_2173_length_1537_cov_39.413074	964	1044	21	2	80	0.0250000
NODE_2173_length_1537_cov_39.413074	964	1044	24	2	80	0.0250000
NODE_2173_length_1537_cov_39.413074	964	1044	25	5	80	0.0625000
NODE_2173_length_1537_cov_39.413074	964	1044	26	8	80	0.1000000
NODE_2173_length_1537_cov_39.413074	964	1044	27	14	80	0.1750000
NODE_2173_length_1537_cov_39.413074	964	1044	28	5	80	0.0625000
NODE_2173_length_1537_cov_39.413074	964	1044	33	9	80	0.1125000
NODE_2173_length_1537_cov_39.413074	964	1044	34	12	80	0.1500000
NODE_2173_length_1537_cov_39.413074	964	1044	35	23	80	0.2875000
NODE_2174_length_1537_cov_30.412378	739	819	8	8	80	0.1000000
NODE_2174_length_1537_cov_30.412378	739	819	9	6	80	0.0750000
NODE_2174_length_1537_cov_30.412378	739	819	12	6	80	0.0750000
NODE_2174_length_1537_cov_30.412378	739	819	15	2	80	0.0250000
NODE_2174_length_1537_cov_30.412378	739	819	16	11	80	0.1375000
NODE_2174_length_1537_cov_30.412378	739	819	17	4	80	0.0500000
NODE_2174_length_1537_cov_30.412378	739	819	18	35	80	0.4375000
NODE_2174_length_1537_cov_30.412378	739	819	19	4	80	0.0500000
NODE_2174_length_1537_cov_30.412378	739	819	20	4	80	0.0500000
NODE_2174_length_1537_cov_30.412378	792	872	15	1	80	0.0125000
NODE_2174_length_1537_cov_30.412378	792	872	16	7	80	0.0875000
NODE_2174_length_1537_cov_30.412378	792	872	17	7	80	0.0875000
NODE_2174_length_1537_cov_30.412378	792	872	18	22	80	0.2750000
NODE_2174_length_1537_cov_30.412378	792	872	20	4	80	0.0500000
NODE_2174_length_1537_cov_30.412378	792	872	21	28	80	0.3500000
NODE_2174_length_1537_cov_30.412378	792	872	22	11	80	0.1375000
NODE_2174_length_1537_cov_30.412378	868	948	7	20	80	0.2500000
NODE_2174_length_1537_cov_30.412378	868	948	8	4	80	0.0500000
NODE_2174_length_1537_cov_30.412378	868	948	9	14	80	0.1750000
NODE_2174_length_1537_cov_30.412378	868	948	10	1	80	0.0125000
NODE_2174_length_1537_cov_30.412378	868	948	14	6	80	0.0750000
NODE_2174_length_1537_cov_30.412378	868	948	18	9	80	0.1125000
NODE_2174_length_1537_cov_30.412378	868	948	20	26	80	0.3250000
NODE_2174_length_1537_cov_30.412378	921	1001	1	22	80	0.2750000
NODE_2174_length_1537_cov_30.412378	921	1001	4	1	80	0.0125000
NODE_2174_length_1537_cov_30.412378	921	1001	5	6	80	0.0750000
NODE_2174_length_1537_cov_30.412378	921	1001	6	7	80	0.0875000
NODE_2174_length_1537_cov_30.412378	921	1001	7	37	80	0.4625000
NODE_2174_length_1537_cov_30.412378	921	1001	8	4	80	0.0500000
NODE_2174_length_1537_cov_30.412378	921	1001	9	3	80	0.0375000
NODE_2175_length_1537_cov_18.707232	669	749	12	15	80	0.1875000
NODE_2175_length_1537_cov_18.707232	669	749	14	43	80	0.5375000
NODE_2175_length_1537_cov_18.707232	669	749	16	16	80	0.2000000
NODE_2175_length_1537_cov_18.707232	669	749	17	6	80	0.0750000
NODE_2175_length_1537_cov_18.707232	722	802	9	1	80	0.0125000
NODE_2175_length_1537_cov_18.707232	722	802	10	25	80	0.3125000
NODE_2175_length_1537_cov_18.707232	722	802	11	2	80	0.0250000
NODE_2175_length_1537_cov_18.707232	722	802	12	3	80	0.0375000
NODE_2175_length_1537_cov_18.707232	722	802	13	15	80	0.1875000
NODE_2175_length_1537_cov_18.707232	722	802	14	9	80	0.1125000
NODE_2175_length_1537_cov_18.707232	722	802	15	3	80	0.0375000
NODE_2175_length_1537_cov_18.707232	722	802	16	16	80	0.2000000
NODE_2175_length_1537_cov_18.707232	722	802	17	6	80	0.0750000
NODE_2176_length_1536_cov_24.991649	832	912	3	4	80	0.0500000
NODE_2176_length_1536_cov_24.991649	832	912	5	2	80	0.0250000
NODE_2176_length_1536_cov_24.991649	832	912	6	45	80	0.5625000
NODE_2176_length_1536_cov_24.991649	832	912	7	20	80	0.2500000
NODE_2176_length_1536_cov_24.991649	832	912	8	9	80	0.1125000
NODE_2176_length_1536_cov_24.991649	885	965	7	19	80	0.2375000
NODE_2176_length_1536_cov_24.991649	885	965	8	9	80	0.1125000
NODE_2176_length_1536_cov_24.991649	885	965	9	14	80	0.1750000
NODE_2176_length_1536_cov_24.991649	885	965	10	15	80	0.1875000
NODE_2176_length_1536_cov_24.991649	885	965	11	5	80	0.0625000
NODE_2176_length_1536_cov_24.991649	885	965	12	4	80	0.0500000
NODE_2176_length_1536_cov_24.991649	885	965	13	1	80	0.0125000
NODE_2176_length_1536_cov_24.991649	885	965	14	6	80	0.0750000
NODE_2176_length_1536_cov_24.991649	885	965	15	7	80	0.0875000
NODE_2176_length_1536_cov_24.991649	961	1041	12	3	80	0.0375000
NODE_2176_length_1536_cov_24.991649	961	1041	13	26	80	0.3250000
NODE_2176_length_1536_cov_24.991649	961	1041	14	11	80	0.1375000
NODE_2176_length_1536_cov_24.991649	961	1041	15	40	80	0.5000000
NODE_2176_length_1536_cov_24.991649	1014	1094	8	2	80	0.0250000
NODE_2176_length_1536_cov_24.991649	1014	1094	9	15	80	0.1875000
NODE_2176_length_1536_cov_24.991649	1014	1094	10	1	80	0.0125000
NODE_2176_length_1536_cov_24.991649	1014	1094	12	13	80	0.1625000
NODE_2176_length_1536_cov_24.991649	1014	1094	13	7	80	0.0875000
NODE_2176_length_1536_cov_24.991649	1014	1094	14	23	80	0.2875000
NODE_2176_length_1536_cov_24.991649	1014	1094	15	19	80	0.2375000
NODE_2183_length_1535_cov_46.662256	992	1072	9	10	80	0.1250000
NODE_2183_length_1535_cov_46.662256	992	1072	12	25	80	0.3125000
NODE_2183_length_1535_cov_46.662256	992	1072	13	2	80	0.0250000
NODE_2183_length_1535_cov_46.662256	992	1072	14	10	80	0.1250000
NODE_2183_length_1535_cov_46.662256	992	1072	16	1	80	0.0125000
NODE_2183_length_1535_cov_46.662256	992	1072	17	32	80	0.4000000
NODE_2183_length_1535_cov_46.662256	1045	1125	9	3	80	0.0375000
NODE_2183_length_1535_cov_46.662256	1045	1125	12	20	80	0.2500000
NODE_2183_length_1535_cov_46.662256	1045	1125	13	14	80	0.1750000
NODE_2183_length_1535_cov_46.662256	1045	1125	14	10	80	0.1250000
NODE_2183_length_1535_cov_46.662256	1045	1125	15	10	80	0.1250000
NODE_2183_length_1535_cov_46.662256	1045	1125	16	10	80	0.1250000
NODE_2183_length_1535_cov_46.662256	1045	1125	17	13	80	0.1625000
NODE_2183_length_1535_cov_46.662256	1127	1203	15	1	76	0.0131579
NODE_2183_length_1535_cov_46.662256	1127	1203	16	13	76	0.1710526
NODE_2183_length_1535_cov_46.662256	1127	1203	17	4	76	0.0526316
NODE_2183_length_1535_cov_46.662256	1127	1203	20	7	76	0.0921053
NODE_2183_length_1535_cov_46.662256	1127	1203	21	51	76	0.6710526
NODE_2183_length_1535_cov_46.662256	1176	1256	13	11	80	0.1375000
NODE_2183_length_1535_cov_46.662256	1176	1256	14	1	80	0.0125000
NODE_2183_length_1535_cov_46.662256	1176	1256	15	4	80	0.0500000
NODE_2183_length_1535_cov_46.662256	1176	1256	16	40	80	0.5000000
NODE_2183_length_1535_cov_46.662256	1176	1256	20	2	80	0.0250000
NODE_2183_length_1535_cov_46.662256	1176	1256	21	22	80	0.2750000
NODE_2184_length_1535_cov_32.610724	992	1072	0	54	80	0.6750000
NODE_2184_length_1535_cov_32.610724	992	1072	1	9	80	0.1125000
NODE_2184_length_1535_cov_32.610724	992	1072	2	4	80	0.0500000
NODE_2184_length_1535_cov_32.610724	992	1072	3	5	80	0.0625000
NODE_2184_length_1535_cov_32.610724	992	1072	4	4	80	0.0500000
NODE_2184_length_1535_cov_32.610724	992	1072	6	4	80	0.0500000
NODE_2184_length_1535_cov_32.610724	1045	1125	0	1	80	0.0125000
NODE_2184_length_1535_cov_32.610724	1045	1125	1	9	80	0.1125000
NODE_2184_length_1535_cov_32.610724	1045	1125	2	4	80	0.0500000
NODE_2184_length_1535_cov_32.610724	1045	1125	3	5	80	0.0625000
NODE_2184_length_1535_cov_32.610724	1045	1125	4	4	80	0.0500000
NODE_2184_length_1535_cov_32.610724	1045	1125	6	29	80	0.3625000
NODE_2184_length_1535_cov_32.610724	1045	1125	7	1	80	0.0125000
NODE_2184_length_1535_cov_32.610724	1045	1125	8	23	80	0.2875000
NODE_2184_length_1535_cov_32.610724	1045	1125	10	4	80	0.0500000
NODE_2184_length_1535_cov_32.610724	1121	1201	10	4	80	0.0500000
NODE_2184_length_1535_cov_32.610724	1121	1201	11	22	80	0.2750000
NODE_2184_length_1535_cov_32.610724	1121	1201	12	20	80	0.2500000
NODE_2184_length_1535_cov_32.610724	1121	1201	13	1	80	0.0125000
NODE_2184_length_1535_cov_32.610724	1121	1201	14	10	80	0.1250000
NODE_2184_length_1535_cov_32.610724	1121	1201	16	14	80	0.1750000
NODE_2184_length_1535_cov_32.610724	1121	1201	17	9	80	0.1125000
NODE_2184_length_1535_cov_32.610724	1174	1254	9	18	80	0.2250000
NODE_2184_length_1535_cov_32.610724	1174	1254	11	18	80	0.2250000
NODE_2184_length_1535_cov_32.610724	1174	1254	13	4	80	0.0500000
NODE_2184_length_1535_cov_32.610724	1174	1254	14	9	80	0.1125000
NODE_2184_length_1535_cov_32.610724	1174	1254	15	4	80	0.0500000
NODE_2184_length_1535_cov_32.610724	1174	1254	16	18	80	0.2250000
NODE_2184_length_1535_cov_32.610724	1174	1254	17	9	80	0.1125000
NODE_2185_length_1535_cov_25.406685	619	699	6	6	80	0.0750000
NODE_2185_length_1535_cov_25.406685	619	699	7	32	80	0.4000000
NODE_2185_length_1535_cov_25.406685	619	699	8	33	80	0.4125000
NODE_2185_length_1535_cov_25.406685	619	699	9	9	80	0.1125000
NODE_2185_length_1535_cov_25.406685	672	752	7	22	80	0.2750000
NODE_2185_length_1535_cov_25.406685	672	752	8	48	80	0.6000000
NODE_2185_length_1535_cov_25.406685	672	752	9	10	80	0.1250000
NODE_2190_length_1534_cov_13.542857	439	519	7	8	80	0.1000000
NODE_2190_length_1534_cov_13.542857	439	519	8	33	80	0.4125000
NODE_2190_length_1534_cov_13.542857	439	519	9	3	80	0.0375000
NODE_2190_length_1534_cov_13.542857	439	519	11	6	80	0.0750000
NODE_2190_length_1534_cov_13.542857	439	519	13	5	80	0.0625000
NODE_2190_length_1534_cov_13.542857	439	519	14	6	80	0.0750000
NODE_2190_length_1534_cov_13.542857	439	519	15	1	80	0.0125000
NODE_2190_length_1534_cov_13.542857	439	519	16	10	80	0.1250000
NODE_2190_length_1534_cov_13.542857	439	519	17	8	80	0.1000000
NODE_2190_length_1534_cov_13.542857	492	567	13	2	75	0.0266667
NODE_2190_length_1534_cov_13.542857	492	567	14	9	75	0.1200000
NODE_2190_length_1534_cov_13.542857	492	567	15	23	75	0.3066667
NODE_2190_length_1534_cov_13.542857	492	567	16	33	75	0.4400000
NODE_2190_length_1534_cov_13.542857	492	567	17	8	75	0.1066667
NODE_2197_length_1531_cov_17.336592	324	404	2	15	80	0.1875000
NODE_2197_length_1531_cov_17.336592	324	404	6	32	80	0.4000000
NODE_2197_length_1531_cov_17.336592	324	404	7	33	80	0.4125000
NODE_2198_length_1531_cov_6.267458	606	686	4	80	80	1.0000000
NODE_2198_length_1531_cov_6.267458	659	739	3	13	80	0.1625000
NODE_2198_length_1531_cov_6.267458	659	739	4	50	80	0.6250000
NODE_2198_length_1531_cov_6.267458	659	739	5	17	80	0.2125000
NODE_2199_length_1530_cov_13.514326	323	403	2	18	80	0.2250000
NODE_2199_length_1530_cov_13.514326	323	403	4	25	80	0.3125000
NODE_2199_length_1530_cov_13.514326	323	403	7	37	80	0.4625000
NODE_2199_length_1530_cov_13.514326	376	456	7	51	80	0.6375000
NODE_2199_length_1530_cov_13.514326	376	456	9	29	80	0.3625000
NODE_2199_length_1530_cov_13.514326	1465	1513	0	48	48	1.0000000
NODE_2200_length_1530_cov_9.012579	637	717	2	80	80	1.0000000
NODE_2200_length_1530_cov_9.012579	690	770	0	47	80	0.5875000
NODE_2200_length_1530_cov_9.012579	690	770	2	33	80	0.4125000
NODE_2203_length_1529_cov_21.061538	983	1063	8	1	80	0.0125000
NODE_2203_length_1529_cov_21.061538	983	1063	9	65	80	0.8125000
NODE_2203_length_1529_cov_21.061538	983	1063	11	11	80	0.1375000
NODE_2203_length_1529_cov_21.061538	983	1063	12	3	80	0.0375000
NODE_2203_length_1529_cov_21.061538	1036	1116	9	24	80	0.3000000
NODE_2203_length_1529_cov_21.061538	1036	1116	10	18	80	0.2250000
NODE_2203_length_1529_cov_21.061538	1036	1116	11	9	80	0.1125000
NODE_2203_length_1529_cov_21.061538	1036	1116	12	7	80	0.0875000
NODE_2203_length_1529_cov_21.061538	1036	1116	14	22	80	0.2750000
NODE_2205_length_1529_cov_1.380420	219	282	0	3	63	0.0476190
NODE_2205_length_1529_cov_1.380420	219	282	2	60	63	0.9523810
NODE_2205_length_1529_cov_1.380420	272	323	0	36	51	0.7058824
NODE_2205_length_1529_cov_1.380420	272	323	2	15	51	0.2941177
NODE_2206_length_1528_cov_8.578027	449	529	0	3	80	0.0375000
NODE_2206_length_1528_cov_8.578027	449	529	2	77	80	0.9625000
NODE_2206_length_1528_cov_8.578027	502	582	0	11	80	0.1375000
NODE_2206_length_1528_cov_8.578027	502	582	2	69	80	0.8625000
NODE_2210_length_1526_cov_92.265592	986	1066	6	9	80	0.1125000
NODE_2210_length_1526_cov_92.265592	986	1066	7	9	80	0.1125000
NODE_2210_length_1526_cov_92.265592	986	1066	8	1	80	0.0125000
NODE_2210_length_1526_cov_92.265592	986	1066	9	12	80	0.1500000
NODE_2210_length_1526_cov_92.265592	986	1066	10	1	80	0.0125000
NODE_2210_length_1526_cov_92.265592	986	1066	11	17	80	0.2125000
NODE_2210_length_1526_cov_92.265592	986	1066	12	8	80	0.1000000
NODE_2210_length_1526_cov_92.265592	986	1066	14	2	80	0.0250000
NODE_2210_length_1526_cov_92.265592	986	1066	15	9	80	0.1125000
NODE_2210_length_1526_cov_92.265592	986	1066	16	12	80	0.1500000
NODE_2210_length_1526_cov_92.265592	1039	1119	12	4	80	0.0500000
NODE_2210_length_1526_cov_92.265592	1039	1119	14	7	80	0.0875000
NODE_2210_length_1526_cov_92.265592	1039	1119	15	38	80	0.4750000
NODE_2210_length_1526_cov_92.265592	1039	1119	16	26	80	0.3250000
NODE_2210_length_1526_cov_92.265592	1039	1119	17	3	80	0.0375000
NODE_2210_length_1526_cov_92.265592	1039	1119	18	2	80	0.0250000
NODE_2211_length_1526_cov_4.051857	291	370	6	59	79	0.7468355
NODE_2211_length_1526_cov_4.051857	291	370	9	9	79	0.1139240
NODE_2211_length_1526_cov_4.051857	291	370	10	9	79	0.1139240
NODE_2211_length_1526_cov_4.051857	291	370	11	2	79	0.0253165
NODE_2213_length_1525_cov_20.232118	1014	1090	9	1	76	0.0131579
NODE_2213_length_1525_cov_20.232118	1014	1090	10	12	76	0.1578947
NODE_2213_length_1525_cov_20.232118	1014	1090	12	20	76	0.2631579
NODE_2213_length_1525_cov_20.232118	1014	1090	14	19	76	0.2500000
NODE_2213_length_1525_cov_20.232118	1014	1090	15	24	76	0.3157895
NODE_2213_length_1525_cov_20.232118	1281	1338	0	57	57	1.0000000
NODE_2214_length_1525_cov_11.421459	804	884	2	4	80	0.0500000
NODE_2214_length_1525_cov_11.421459	804	884	3	7	80	0.0875000
NODE_2214_length_1525_cov_11.421459	804	884	4	69	80	0.8625000
NODE_2214_length_1525_cov_11.421459	857	937	2	22	80	0.2750000
NODE_2214_length_1525_cov_11.421459	857	937	3	38	80	0.4750000
NODE_2214_length_1525_cov_11.421459	857	937	4	20	80	0.2500000
NODE_2217_length_1524_cov_130.874386	171	243	115	1	72	0.0138889
NODE_2217_length_1524_cov_130.874386	171	243	117	2	72	0.0277778
NODE_2217_length_1524_cov_130.874386	171	243	120	1	72	0.0138889
NODE_2217_length_1524_cov_130.874386	171	243	122	1	72	0.0138889
NODE_2217_length_1524_cov_130.874386	171	243	125	1	72	0.0138889
NODE_2217_length_1524_cov_130.874386	171	243	126	5	72	0.0694444
NODE_2217_length_1524_cov_130.874386	171	243	127	1	72	0.0138889
NODE_2217_length_1524_cov_130.874386	171	243	128	1	72	0.0138889
NODE_2217_length_1524_cov_130.874386	171	243	131	1	72	0.0138889
NODE_2217_length_1524_cov_130.874386	171	243	137	5	72	0.0694444
NODE_2217_length_1524_cov_130.874386	171	243	139	2	72	0.0277778
NODE_2217_length_1524_cov_130.874386	171	243	142	1	72	0.0138889
NODE_2217_length_1524_cov_130.874386	171	243	143	1	72	0.0138889
NODE_2217_length_1524_cov_130.874386	171	243	145	2	72	0.0277778
NODE_2217_length_1524_cov_130.874386	171	243	148	1	72	0.0138889
NODE_2217_length_1524_cov_130.874386	171	243	153	1	72	0.0138889
NODE_2217_length_1524_cov_130.874386	171	243	154	1	72	0.0138889
NODE_2217_length_1524_cov_130.874386	171	243	156	1	72	0.0138889
NODE_2217_length_1524_cov_130.874386	171	243	158	1	72	0.0138889
NODE_2217_length_1524_cov_130.874386	171	243	159	1	72	0.0138889
NODE_2217_length_1524_cov_130.874386	171	243	163	1	72	0.0138889
NODE_2217_length_1524_cov_130.874386	171	243	164	1	72	0.0138889
NODE_2217_length_1524_cov_130.874386	171	243	166	2	72	0.0277778
NODE_2217_length_1524_cov_130.874386	171	243	167	2	72	0.0277778
NODE_2217_length_1524_cov_130.874386	171	243	168	3	72	0.0416667
NODE_2217_length_1524_cov_130.874386	171	243	169	1	72	0.0138889
NODE_2217_length_1524_cov_130.874386	171	243	170	1	72	0.0138889
NODE_2217_length_1524_cov_130.874386	171	243	172	1	72	0.0138889
NODE_2217_length_1524_cov_130.874386	171	243	173	2	72	0.0277778
NODE_2217_length_1524_cov_130.874386	171	243	174	1	72	0.0138889
NODE_2217_length_1524_cov_130.874386	171	243	175	1	72	0.0138889
NODE_2217_length_1524_cov_130.874386	171	243	177	1	72	0.0138889
NODE_2217_length_1524_cov_130.874386	171	243	179	1	72	0.0138889
NODE_2217_length_1524_cov_130.874386	171	243	180	1	72	0.0138889
NODE_2217_length_1524_cov_130.874386	171	243	181	2	72	0.0277778
NODE_2217_length_1524_cov_130.874386	171	243	183	1	72	0.0138889
NODE_2217_length_1524_cov_130.874386	171	243	190	1	72	0.0138889
NODE_2217_length_1524_cov_130.874386	171	243	193	1	72	0.0138889
NODE_2217_length_1524_cov_130.874386	171	243	194	1	72	0.0138889
NODE_2217_length_1524_cov_130.874386	171	243	195	1	72	0.0138889
NODE_2217_length_1524_cov_130.874386	171	243	197	1	72	0.0138889
NODE_2217_length_1524_cov_130.874386	171	243	198	1	72	0.0138889
NODE_2217_length_1524_cov_130.874386	171	243	199	1	72	0.0138889
NODE_2217_length_1524_cov_130.874386	171	243	200	2	72	0.0277778
NODE_2217_length_1524_cov_130.874386	171	243	203	2	72	0.0277778
NODE_2217_length_1524_cov_130.874386	171	243	205	1	72	0.0138889
NODE_2217_length_1524_cov_130.874386	171	243	206	1	72	0.0138889
NODE_2217_length_1524_cov_130.874386	171	243	207	1	72	0.0138889
NODE_2217_length_1524_cov_130.874386	171	243	208	3	72	0.0416667
NODE_2217_length_1524_cov_130.874386	171	243	209	2	72	0.0277778
NODE_2217_length_1524_cov_130.874386	191	247	139	1	56	0.0178571
NODE_2217_length_1524_cov_130.874386	191	247	142	1	56	0.0178571
NODE_2217_length_1524_cov_130.874386	191	247	143	1	56	0.0178571
NODE_2217_length_1524_cov_130.874386	191	247	145	2	56	0.0357143
NODE_2217_length_1524_cov_130.874386	191	247	148	1	56	0.0178571
NODE_2217_length_1524_cov_130.874386	191	247	153	1	56	0.0178571
NODE_2217_length_1524_cov_130.874386	191	247	154	1	56	0.0178571
NODE_2217_length_1524_cov_130.874386	191	247	156	1	56	0.0178571
NODE_2217_length_1524_cov_130.874386	191	247	158	1	56	0.0178571
NODE_2217_length_1524_cov_130.874386	191	247	159	1	56	0.0178571
NODE_2217_length_1524_cov_130.874386	191	247	163	1	56	0.0178571
NODE_2217_length_1524_cov_130.874386	191	247	164	1	56	0.0178571
NODE_2217_length_1524_cov_130.874386	191	247	166	2	56	0.0357143
NODE_2217_length_1524_cov_130.874386	191	247	167	2	56	0.0357143
NODE_2217_length_1524_cov_130.874386	191	247	168	3	56	0.0535714
NODE_2217_length_1524_cov_130.874386	191	247	169	1	56	0.0178571
NODE_2217_length_1524_cov_130.874386	191	247	170	1	56	0.0178571
NODE_2217_length_1524_cov_130.874386	191	247	172	1	56	0.0178571
NODE_2217_length_1524_cov_130.874386	191	247	173	2	56	0.0357143
NODE_2217_length_1524_cov_130.874386	191	247	174	1	56	0.0178571
NODE_2217_length_1524_cov_130.874386	191	247	175	1	56	0.0178571
NODE_2217_length_1524_cov_130.874386	191	247	177	1	56	0.0178571
NODE_2217_length_1524_cov_130.874386	191	247	179	1	56	0.0178571
NODE_2217_length_1524_cov_130.874386	191	247	180	1	56	0.0178571
NODE_2217_length_1524_cov_130.874386	191	247	181	2	56	0.0357143
NODE_2217_length_1524_cov_130.874386	191	247	183	1	56	0.0178571
NODE_2217_length_1524_cov_130.874386	191	247	190	1	56	0.0178571
NODE_2217_length_1524_cov_130.874386	191	247	193	1	56	0.0178571
NODE_2217_length_1524_cov_130.874386	191	247	194	1	56	0.0178571
NODE_2217_length_1524_cov_130.874386	191	247	195	1	56	0.0178571
NODE_2217_length_1524_cov_130.874386	191	247	197	1	56	0.0178571
NODE_2217_length_1524_cov_130.874386	191	247	198	1	56	0.0178571
NODE_2217_length_1524_cov_130.874386	191	247	199	1	56	0.0178571
NODE_2217_length_1524_cov_130.874386	191	247	200	2	56	0.0357143
NODE_2217_length_1524_cov_130.874386	191	247	203	2	56	0.0357143
NODE_2217_length_1524_cov_130.874386	191	247	205	1	56	0.0178571
NODE_2217_length_1524_cov_130.874386	191	247	206	1	56	0.0178571
NODE_2217_length_1524_cov_130.874386	191	247	207	3	56	0.0535714
NODE_2217_length_1524_cov_130.874386	191	247	208	3	56	0.0535714
NODE_2217_length_1524_cov_130.874386	191	247	209	2	56	0.0357143
NODE_2217_length_1524_cov_130.874386	191	247	211	2	56	0.0357143
NODE_2217_length_1524_cov_130.874386	219	296	179	1	77	0.0129870
NODE_2217_length_1524_cov_130.874386	219	296	180	1	77	0.0129870
NODE_2217_length_1524_cov_130.874386	219	296	181	2	77	0.0259740
NODE_2217_length_1524_cov_130.874386	219	296	183	1	77	0.0129870
NODE_2217_length_1524_cov_130.874386	219	296	190	1	77	0.0129870
NODE_2217_length_1524_cov_130.874386	219	296	192	1	77	0.0129870
NODE_2217_length_1524_cov_130.874386	219	296	193	1	77	0.0129870
NODE_2217_length_1524_cov_130.874386	219	296	194	2	77	0.0259740
NODE_2217_length_1524_cov_130.874386	219	296	195	1	77	0.0129870
NODE_2217_length_1524_cov_130.874386	219	296	197	2	77	0.0259740
NODE_2217_length_1524_cov_130.874386	219	296	198	2	77	0.0259740
NODE_2217_length_1524_cov_130.874386	219	296	199	1	77	0.0129870
NODE_2217_length_1524_cov_130.874386	219	296	200	5	77	0.0649351
NODE_2217_length_1524_cov_130.874386	219	296	201	3	77	0.0389610
NODE_2217_length_1524_cov_130.874386	219	296	202	10	77	0.1298701
NODE_2217_length_1524_cov_130.874386	219	296	203	5	77	0.0649351
NODE_2217_length_1524_cov_130.874386	219	296	204	2	77	0.0259740
NODE_2217_length_1524_cov_130.874386	219	296	205	1	77	0.0129870
NODE_2217_length_1524_cov_130.874386	219	296	206	10	77	0.1298701
NODE_2217_length_1524_cov_130.874386	219	296	207	6	77	0.0779221
NODE_2217_length_1524_cov_130.874386	219	296	208	8	77	0.1038961
NODE_2217_length_1524_cov_130.874386	219	296	209	6	77	0.0779221
NODE_2217_length_1524_cov_130.874386	219	296	211	2	77	0.0259740
NODE_2217_length_1524_cov_130.874386	219	296	212	3	77	0.0389610
NODE_2217_length_1524_cov_130.874386	253	333	146	1	80	0.0125000
NODE_2217_length_1524_cov_130.874386	253	333	147	1	80	0.0125000
NODE_2217_length_1524_cov_130.874386	253	333	149	1	80	0.0125000
NODE_2217_length_1524_cov_130.874386	253	333	151	3	80	0.0375000
NODE_2217_length_1524_cov_130.874386	253	333	152	1	80	0.0125000
NODE_2217_length_1524_cov_130.874386	253	333	153	2	80	0.0250000
NODE_2217_length_1524_cov_130.874386	253	333	154	1	80	0.0125000
NODE_2217_length_1524_cov_130.874386	253	333	156	1	80	0.0125000
NODE_2217_length_1524_cov_130.874386	253	333	157	1	80	0.0125000
NODE_2217_length_1524_cov_130.874386	253	333	159	2	80	0.0250000
NODE_2217_length_1524_cov_130.874386	253	333	160	3	80	0.0375000
NODE_2217_length_1524_cov_130.874386	253	333	161	3	80	0.0375000
NODE_2217_length_1524_cov_130.874386	253	333	162	1	80	0.0125000
NODE_2217_length_1524_cov_130.874386	253	333	165	1	80	0.0125000
NODE_2217_length_1524_cov_130.874386	253	333	171	2	80	0.0250000
NODE_2217_length_1524_cov_130.874386	253	333	172	2	80	0.0250000
NODE_2217_length_1524_cov_130.874386	253	333	174	2	80	0.0250000
NODE_2217_length_1524_cov_130.874386	253	333	177	1	80	0.0125000
NODE_2217_length_1524_cov_130.874386	253	333	178	1	80	0.0125000
NODE_2217_length_1524_cov_130.874386	253	333	179	2	80	0.0250000
NODE_2217_length_1524_cov_130.874386	253	333	180	1	80	0.0125000
NODE_2217_length_1524_cov_130.874386	253	333	181	1	80	0.0125000
NODE_2217_length_1524_cov_130.874386	253	333	182	1	80	0.0125000
NODE_2217_length_1524_cov_130.874386	253	333	188	1	80	0.0125000
NODE_2217_length_1524_cov_130.874386	253	333	190	1	80	0.0125000
NODE_2217_length_1524_cov_130.874386	253	333	192	1	80	0.0125000
NODE_2217_length_1524_cov_130.874386	253	333	194	1	80	0.0125000
NODE_2217_length_1524_cov_130.874386	253	333	197	1	80	0.0125000
NODE_2217_length_1524_cov_130.874386	253	333	198	1	80	0.0125000
NODE_2217_length_1524_cov_130.874386	253	333	200	3	80	0.0375000
NODE_2217_length_1524_cov_130.874386	253	333	201	3	80	0.0375000
NODE_2217_length_1524_cov_130.874386	253	333	202	10	80	0.1250000
NODE_2217_length_1524_cov_130.874386	253	333	203	3	80	0.0375000
NODE_2217_length_1524_cov_130.874386	253	333	204	2	80	0.0250000
NODE_2217_length_1524_cov_130.874386	253	333	206	9	80	0.1125000
NODE_2217_length_1524_cov_130.874386	253	333	207	3	80	0.0375000
NODE_2217_length_1524_cov_130.874386	253	333	208	2	80	0.0250000
NODE_2217_length_1524_cov_130.874386	253	333	209	1	80	0.0125000
NODE_2217_length_1524_cov_130.874386	253	333	212	3	80	0.0375000
NODE_2217_length_1524_cov_130.874386	306	386	50	2	80	0.0250000
NODE_2217_length_1524_cov_130.874386	306	386	57	1	80	0.0125000
NODE_2217_length_1524_cov_130.874386	306	386	63	1	80	0.0125000
NODE_2217_length_1524_cov_130.874386	306	386	65	1	80	0.0125000
NODE_2217_length_1524_cov_130.874386	306	386	66	1	80	0.0125000
NODE_2217_length_1524_cov_130.874386	306	386	70	2	80	0.0250000
NODE_2217_length_1524_cov_130.874386	306	386	72	2	80	0.0250000
NODE_2217_length_1524_cov_130.874386	306	386	74	1	80	0.0125000
NODE_2217_length_1524_cov_130.874386	306	386	77	1	80	0.0125000
NODE_2217_length_1524_cov_130.874386	306	386	85	1	80	0.0125000
NODE_2217_length_1524_cov_130.874386	306	386	89	2	80	0.0250000
NODE_2217_length_1524_cov_130.874386	306	386	93	2	80	0.0250000
NODE_2217_length_1524_cov_130.874386	306	386	96	1	80	0.0125000
NODE_2217_length_1524_cov_130.874386	306	386	98	1	80	0.0125000
NODE_2217_length_1524_cov_130.874386	306	386	99	1	80	0.0125000
NODE_2217_length_1524_cov_130.874386	306	386	100	2	80	0.0250000
NODE_2217_length_1524_cov_130.874386	306	386	101	2	80	0.0250000
NODE_2217_length_1524_cov_130.874386	306	386	102	1	80	0.0125000
NODE_2217_length_1524_cov_130.874386	306	386	103	1	80	0.0125000
NODE_2217_length_1524_cov_130.874386	306	386	108	4	80	0.0500000
NODE_2217_length_1524_cov_130.874386	306	386	109	2	80	0.0250000
NODE_2217_length_1524_cov_130.874386	306	386	111	2	80	0.0250000
NODE_2217_length_1524_cov_130.874386	306	386	113	1	80	0.0125000
NODE_2217_length_1524_cov_130.874386	306	386	117	1	80	0.0125000
NODE_2217_length_1524_cov_130.874386	306	386	121	2	80	0.0250000
NODE_2217_length_1524_cov_130.874386	306	386	124	1	80	0.0125000
NODE_2217_length_1524_cov_130.874386	306	386	131	1	80	0.0125000
NODE_2217_length_1524_cov_130.874386	306	386	134	2	80	0.0250000
NODE_2217_length_1524_cov_130.874386	306	386	136	1	80	0.0125000
NODE_2217_length_1524_cov_130.874386	306	386	137	1	80	0.0125000
NODE_2217_length_1524_cov_130.874386	306	386	140	1	80	0.0125000
NODE_2217_length_1524_cov_130.874386	306	386	141	1	80	0.0125000
NODE_2217_length_1524_cov_130.874386	306	386	142	2	80	0.0250000
NODE_2217_length_1524_cov_130.874386	306	386	143	3	80	0.0375000
NODE_2217_length_1524_cov_130.874386	306	386	146	1	80	0.0125000
NODE_2217_length_1524_cov_130.874386	306	386	147	2	80	0.0250000
NODE_2217_length_1524_cov_130.874386	306	386	149	1	80	0.0125000
NODE_2217_length_1524_cov_130.874386	306	386	151	4	80	0.0500000
NODE_2217_length_1524_cov_130.874386	306	386	152	1	80	0.0125000
NODE_2217_length_1524_cov_130.874386	306	386	153	2	80	0.0250000
NODE_2217_length_1524_cov_130.874386	306	386	154	1	80	0.0125000
NODE_2217_length_1524_cov_130.874386	306	386	156	1	80	0.0125000
NODE_2217_length_1524_cov_130.874386	306	386	157	1	80	0.0125000
NODE_2217_length_1524_cov_130.874386	306	386	159	2	80	0.0250000
NODE_2217_length_1524_cov_130.874386	306	386	160	3	80	0.0375000
NODE_2217_length_1524_cov_130.874386	306	386	161	3	80	0.0375000
NODE_2217_length_1524_cov_130.874386	306	386	162	1	80	0.0125000
NODE_2217_length_1524_cov_130.874386	306	386	165	1	80	0.0125000
NODE_2217_length_1524_cov_130.874386	306	386	171	2	80	0.0250000
NODE_2217_length_1524_cov_130.874386	306	386	172	2	80	0.0250000
NODE_2217_length_1524_cov_130.874386	306	386	174	1	80	0.0125000
NODE_2219_length_1523_cov_24.115169	366	446	6	64	80	0.8000000
NODE_2219_length_1523_cov_24.115169	366	446	8	1	80	0.0125000
NODE_2219_length_1523_cov_24.115169	366	446	9	2	80	0.0250000
NODE_2219_length_1523_cov_24.115169	366	446	10	1	80	0.0125000
NODE_2219_length_1523_cov_24.115169	366	446	11	12	80	0.1500000
NODE_2219_length_1523_cov_24.115169	419	499	6	11	80	0.1375000
NODE_2219_length_1523_cov_24.115169	419	499	8	1	80	0.0125000
NODE_2219_length_1523_cov_24.115169	419	499	9	2	80	0.0250000
NODE_2219_length_1523_cov_24.115169	419	499	10	10	80	0.1250000
NODE_2219_length_1523_cov_24.115169	419	499	11	32	80	0.4000000
NODE_2219_length_1523_cov_24.115169	419	499	12	22	80	0.2750000
NODE_2219_length_1523_cov_24.115169	419	499	13	1	80	0.0125000
NODE_2219_length_1523_cov_24.115169	419	499	14	1	80	0.0125000
NODE_2219_length_1523_cov_24.115169	495	575	10	61	80	0.7625000
NODE_2219_length_1523_cov_24.115169	495	575	11	12	80	0.1500000
NODE_2219_length_1523_cov_24.115169	495	575	12	7	80	0.0875000
NODE_2219_length_1523_cov_24.115169	548	628	2	16	80	0.2000000
NODE_2219_length_1523_cov_24.115169	548	628	3	21	80	0.2625000
NODE_2219_length_1523_cov_24.115169	548	628	5	7	80	0.0875000
NODE_2219_length_1523_cov_24.115169	548	628	6	1	80	0.0125000
NODE_2219_length_1523_cov_24.115169	548	628	7	2	80	0.0250000
NODE_2219_length_1523_cov_24.115169	548	628	8	1	80	0.0125000
NODE_2219_length_1523_cov_24.115169	548	628	10	32	80	0.4000000
NODE_2223_length_1522_cov_13.278988	361	441	7	6	80	0.0750000
NODE_2223_length_1522_cov_13.278988	361	441	9	18	80	0.2250000
NODE_2223_length_1522_cov_13.278988	361	441	11	46	80	0.5750000
NODE_2223_length_1522_cov_13.278988	361	441	12	10	80	0.1250000
NODE_2223_length_1522_cov_13.278988	414	494	8	11	80	0.1375000
NODE_2223_length_1522_cov_13.278988	414	494	10	30	80	0.3750000
NODE_2223_length_1522_cov_13.278988	414	494	11	39	80	0.4875000
NODE_2225_length_1521_cov_20.965541	772	852	5	13	80	0.1625000
NODE_2225_length_1521_cov_20.965541	772	852	6	7	80	0.0875000
NODE_2225_length_1521_cov_20.965541	772	852	7	3	80	0.0375000
NODE_2225_length_1521_cov_20.965541	772	852	9	19	80	0.2375000
NODE_2225_length_1521_cov_20.965541	772	852	10	37	80	0.4625000
NODE_2225_length_1521_cov_20.965541	772	852	12	1	80	0.0125000
NODE_2225_length_1521_cov_20.965541	825	905	9	31	80	0.3875000
NODE_2225_length_1521_cov_20.965541	825	905	10	19	80	0.2375000
NODE_2225_length_1521_cov_20.965541	825	905	11	16	80	0.2000000
NODE_2225_length_1521_cov_20.965541	825	905	12	14	80	0.1750000
NODE_2226_length_1521_cov_15.381153	907	987	9	7	80	0.0875000
NODE_2226_length_1521_cov_15.381153	907	987	11	1	80	0.0125000
NODE_2226_length_1521_cov_15.381153	907	987	12	1	80	0.0125000
NODE_2226_length_1521_cov_15.381153	907	987	13	12	80	0.1500000
NODE_2226_length_1521_cov_15.381153	907	987	14	2	80	0.0250000
NODE_2226_length_1521_cov_15.381153	907	987	15	6	80	0.0750000
NODE_2226_length_1521_cov_15.381153	907	987	16	15	80	0.1875000
NODE_2226_length_1521_cov_15.381153	907	987	17	20	80	0.2500000
NODE_2226_length_1521_cov_15.381153	907	987	19	16	80	0.2000000
NODE_2226_length_1521_cov_15.381153	960	1040	16	5	80	0.0625000
NODE_2226_length_1521_cov_15.381153	960	1040	17	6	80	0.0750000
NODE_2226_length_1521_cov_15.381153	960	1040	18	6	80	0.0750000
NODE_2226_length_1521_cov_15.381153	960	1040	19	37	80	0.4625000
NODE_2226_length_1521_cov_15.381153	960	1040	21	26	80	0.3250000
NODE_2226_length_1521_cov_15.381153	988	1040	18	6	52	0.1153846
NODE_2226_length_1521_cov_15.381153	988	1040	19	20	52	0.3846154
NODE_2226_length_1521_cov_15.381153	988	1040	21	26	52	0.5000000
NODE_2227_length_1521_cov_7.682138	525	605	1	11	80	0.1375000
NODE_2227_length_1521_cov_7.682138	525	605	2	69	80	0.8625000
NODE_2227_length_1521_cov_7.682138	578	658	1	41	80	0.5125000
NODE_2227_length_1521_cov_7.682138	578	658	2	39	80	0.4875000
NODE_2236_length_1519_cov_20.792958	714	794	1	14	80	0.1750000
NODE_2236_length_1519_cov_20.792958	714	794	3	20	80	0.2500000
NODE_2236_length_1519_cov_20.792958	714	794	4	46	80	0.5750000
NODE_2236_length_1519_cov_20.792958	767	847	0	25	80	0.3125000
NODE_2236_length_1519_cov_20.792958	767	847	1	42	80	0.5250000
NODE_2236_length_1519_cov_20.792958	767	847	3	13	80	0.1625000
NODE_2239_length_1517_cov_24.074048	413	450	7	37	37	1.0000000
NODE_2239_length_1517_cov_24.074048	842	922	4	6	80	0.0750000
NODE_2239_length_1517_cov_24.074048	842	922	5	21	80	0.2625000
NODE_2239_length_1517_cov_24.074048	842	922	6	10	80	0.1250000
NODE_2239_length_1517_cov_24.074048	842	922	7	3	80	0.0375000
NODE_2239_length_1517_cov_24.074048	842	922	9	4	80	0.0500000
NODE_2239_length_1517_cov_24.074048	842	922	10	1	80	0.0125000
NODE_2239_length_1517_cov_24.074048	842	922	11	6	80	0.0750000
NODE_2239_length_1517_cov_24.074048	842	922	12	8	80	0.1000000
NODE_2239_length_1517_cov_24.074048	842	922	14	21	80	0.2625000
NODE_2239_length_1517_cov_24.074048	895	975	12	36	80	0.4500000
NODE_2239_length_1517_cov_24.074048	895	975	13	11	80	0.1375000
NODE_2239_length_1517_cov_24.074048	895	975	14	31	80	0.3875000
NODE_2239_length_1517_cov_24.074048	895	975	15	2	80	0.0250000
NODE_2240_length_1517_cov_22.897743	383	463	3	19	80	0.2375000
NODE_2240_length_1517_cov_22.897743	383	463	5	36	80	0.4500000
NODE_2240_length_1517_cov_22.897743	383	463	7	2	80	0.0250000
NODE_2240_length_1517_cov_22.897743	383	463	8	23	80	0.2875000
NODE_2240_length_1517_cov_22.897743	436	516	5	2	80	0.0250000
NODE_2240_length_1517_cov_22.897743	436	516	6	3	80	0.0375000
NODE_2240_length_1517_cov_22.897743	436	516	7	16	80	0.2000000
NODE_2240_length_1517_cov_22.897743	436	516	8	59	80	0.7375000
NODE_2241_length_1517_cov_11.781382	381	461	6	12	80	0.1500000
NODE_2241_length_1517_cov_11.781382	381	461	7	58	80	0.7250000
NODE_2241_length_1517_cov_11.781382	381	461	8	10	80	0.1250000
NODE_2241_length_1517_cov_11.781382	434	514	4	6	80	0.0750000
NODE_2241_length_1517_cov_11.781382	434	514	5	15	80	0.1875000
NODE_2241_length_1517_cov_11.781382	434	514	6	12	80	0.1500000
NODE_2241_length_1517_cov_11.781382	434	514	7	47	80	0.5875000
NODE_2243_length_1517_cov_4.944993	393	473	0	48	80	0.6000000
NODE_2243_length_1517_cov_4.944993	393	473	1	32	80	0.4000000
NODE_2243_length_1517_cov_4.944993	446	526	0	39	80	0.4875000
NODE_2243_length_1517_cov_4.944993	446	526	1	41	80	0.5125000
NODE_2247_length_1516_cov_11.177135	230	310	2	4	80	0.0500000
NODE_2247_length_1516_cov_11.177135	230	310	3	14	80	0.1750000
NODE_2247_length_1516_cov_11.177135	230	310	4	62	80	0.7750000
NODE_2247_length_1516_cov_11.177135	283	363	2	2	80	0.0250000
NODE_2247_length_1516_cov_11.177135	283	363	3	46	80	0.5750000
NODE_2247_length_1516_cov_11.177135	283	363	4	32	80	0.4000000
NODE_2248_length_1516_cov_8.608327	580	660	0	4	80	0.0500000
NODE_2248_length_1516_cov_8.608327	580	660	1	5	80	0.0625000
NODE_2248_length_1516_cov_8.608327	580	660	2	71	80	0.8875000
NODE_2248_length_1516_cov_8.608327	633	713	2	80	80	1.0000000
NODE_2250_length_1515_cov_16.990819	333	413	1	79	80	0.9875000
NODE_2250_length_1515_cov_16.990819	333	413	2	1	80	0.0125000
NODE_2250_length_1515_cov_16.990819	386	448	1	62	62	1.0000000
NODE_2258_length_1512_cov_5.111819	506	560	3	14	54	0.2592593
NODE_2258_length_1512_cov_5.111819	506	560	5	1	54	0.0185185
NODE_2258_length_1512_cov_5.111819	506	560	6	39	54	0.7222222
NODE_2258_length_1512_cov_5.111819	677	698	0	21	21	1.0000000
NODE_2258_length_1512_cov_5.111819	677	698	0	21	21	1.0000000
NODE_2258_length_1512_cov_5.111819	1057	1137	0	80	80	1.0000000
NODE_2258_length_1512_cov_5.111819	1110	1190	0	80	80	1.0000000
NODE_2258_length_1512_cov_5.111819	1144	1190	0	46	46	1.0000000
NODE_2259_length_1512_cov_4.251946	132	204	0	72	72	1.0000000
NODE_2262_length_1511_cov_30.963173	787	867	2	68	80	0.8500000
NODE_2262_length_1511_cov_30.963173	787	867	3	12	80	0.1500000
NODE_2262_length_1511_cov_30.963173	840	920	2	39	80	0.4875000
NODE_2262_length_1511_cov_30.963173	840	920	3	41	80	0.5125000
NODE_2262_length_1511_cov_30.963173	916	996	2	56	80	0.7000000
NODE_2262_length_1511_cov_30.963173	916	996	3	24	80	0.3000000
NODE_2262_length_1511_cov_30.963173	969	1059	2	72	90	0.8000000
NODE_2262_length_1511_cov_30.963173	969	1059	3	18	90	0.2000000
NODE_2265_length_1510_cov_24.184975	434	514	4	34	80	0.4250000
NODE_2265_length_1510_cov_24.184975	434	514	5	10	80	0.1250000
NODE_2265_length_1510_cov_24.184975	434	514	6	36	80	0.4500000
NODE_2265_length_1510_cov_24.184975	487	567	3	13	80	0.1625000
NODE_2265_length_1510_cov_24.184975	487	567	4	14	80	0.1750000
NODE_2265_length_1510_cov_24.184975	487	567	5	36	80	0.4500000
NODE_2265_length_1510_cov_24.184975	487	567	6	17	80	0.2125000
NODE_2265_length_1510_cov_24.184975	563	643	2	2	80	0.0250000
NODE_2265_length_1510_cov_24.184975	563	643	3	17	80	0.2125000
NODE_2265_length_1510_cov_24.184975	563	643	4	13	80	0.1625000
NODE_2265_length_1510_cov_24.184975	563	643	5	25	80	0.3125000
NODE_2265_length_1510_cov_24.184975	563	643	6	4	80	0.0500000
NODE_2265_length_1510_cov_24.184975	563	643	7	19	80	0.2375000
NODE_2265_length_1510_cov_24.184975	616	696	5	22	80	0.2750000
NODE_2265_length_1510_cov_24.184975	616	696	6	57	80	0.7125000
NODE_2265_length_1510_cov_24.184975	616	696	7	1	80	0.0125000
NODE_2269_length_1509_cov_51.836170	655	735	17	18	80	0.2250000
NODE_2269_length_1509_cov_51.836170	655	735	18	10	80	0.1250000
NODE_2269_length_1509_cov_51.836170	655	735	19	8	80	0.1000000
NODE_2269_length_1509_cov_51.836170	655	735	20	8	80	0.1000000
NODE_2269_length_1509_cov_51.836170	655	735	22	19	80	0.2375000
NODE_2269_length_1509_cov_51.836170	655	735	23	15	80	0.1875000
NODE_2269_length_1509_cov_51.836170	655	735	24	2	80	0.0250000
NODE_2269_length_1509_cov_51.836170	708	788	14	4	80	0.0500000
NODE_2269_length_1509_cov_51.836170	708	788	15	4	80	0.0500000
NODE_2269_length_1509_cov_51.836170	708	788	16	14	80	0.1750000
NODE_2269_length_1509_cov_51.836170	708	788	18	8	80	0.1000000
NODE_2269_length_1509_cov_51.836170	708	788	19	10	80	0.1250000
NODE_2269_length_1509_cov_51.836170	708	788	20	9	80	0.1125000
NODE_2269_length_1509_cov_51.836170	708	788	22	1	80	0.0125000
NODE_2269_length_1509_cov_51.836170	708	788	23	22	80	0.2750000
NODE_2269_length_1509_cov_51.836170	708	788	24	8	80	0.1000000
NODE_2269_length_1509_cov_51.836170	784	864	16	10	80	0.1250000
NODE_2269_length_1509_cov_51.836170	784	864	17	1	80	0.0125000
NODE_2269_length_1509_cov_51.836170	784	864	18	2	80	0.0250000
NODE_2269_length_1509_cov_51.836170	784	864	19	14	80	0.1750000
NODE_2269_length_1509_cov_51.836170	784	864	21	24	80	0.3000000
NODE_2269_length_1509_cov_51.836170	784	864	22	13	80	0.1625000
NODE_2269_length_1509_cov_51.836170	784	864	23	4	80	0.0500000
NODE_2269_length_1509_cov_51.836170	784	864	24	4	80	0.0500000
NODE_2269_length_1509_cov_51.836170	784	864	25	5	80	0.0625000
NODE_2269_length_1509_cov_51.836170	784	864	26	3	80	0.0375000
NODE_2269_length_1509_cov_51.836170	837	917	20	4	80	0.0500000
NODE_2269_length_1509_cov_51.836170	837	917	21	36	80	0.4500000
NODE_2269_length_1509_cov_51.836170	837	917	22	17	80	0.2125000
NODE_2269_length_1509_cov_51.836170	837	917	24	12	80	0.1500000
NODE_2269_length_1509_cov_51.836170	837	917	25	7	80	0.0875000
NODE_2269_length_1509_cov_51.836170	837	917	26	4	80	0.0500000
NODE_2270_length_1509_cov_16.010638	497	577	3	2	80	0.0250000
NODE_2270_length_1509_cov_16.010638	497	577	6	29	80	0.3625000
NODE_2270_length_1509_cov_16.010638	497	577	7	42	80	0.5250000
NODE_2270_length_1509_cov_16.010638	497	577	8	7	80	0.0875000
NODE_2270_length_1509_cov_16.010638	550	630	7	42	80	0.5250000
NODE_2270_length_1509_cov_16.010638	550	630	8	8	80	0.1000000
NODE_2270_length_1509_cov_16.010638	550	630	10	20	80	0.2500000
NODE_2270_length_1509_cov_16.010638	550	630	11	10	80	0.1250000
NODE_2270_length_1509_cov_16.010638	626	706	6	27	80	0.3375000
NODE_2270_length_1509_cov_16.010638	626	706	7	8	80	0.1000000
NODE_2270_length_1509_cov_16.010638	626	706	8	22	80	0.2750000
NODE_2270_length_1509_cov_16.010638	626	706	11	23	80	0.2875000
NODE_2270_length_1509_cov_16.010638	679	759	2	9	80	0.1125000
NODE_2270_length_1509_cov_16.010638	679	759	4	2	80	0.0250000
NODE_2270_length_1509_cov_16.010638	679	759	5	21	80	0.2625000
NODE_2270_length_1509_cov_16.010638	679	759	6	43	80	0.5375000
NODE_2270_length_1509_cov_16.010638	679	759	7	5	80	0.0625000
NODE_2271_length_1509_cov_8.883688	252	332	4	51	80	0.6375000
NODE_2271_length_1509_cov_8.883688	252	332	5	29	80	0.3625000
NODE_2271_length_1509_cov_8.883688	305	385	1	14	80	0.1750000
NODE_2271_length_1509_cov_8.883688	305	385	5	66	80	0.8250000
NODE_2271_length_1509_cov_8.883688	327	385	1	14	58	0.2413793
NODE_2271_length_1509_cov_8.883688	327	385	5	44	58	0.7586207
NODE_2271_length_1509_cov_8.883688	381	461	1	20	80	0.2500000
NODE_2271_length_1509_cov_8.883688	381	461	2	39	80	0.4875000
NODE_2271_length_1509_cov_8.883688	381	461	3	21	80	0.2625000
NODE_2271_length_1509_cov_8.883688	434	514	2	61	80	0.7625000
NODE_2271_length_1509_cov_8.883688	434	514	3	19	80	0.2375000
NODE_2272_length_1509_cov_5.826950	1029	1109	0	26	80	0.3250000
NODE_2272_length_1509_cov_5.826950	1029	1109	1	54	80	0.6750000
NODE_2272_length_1509_cov_5.826950	1082	1162	1	80	80	1.0000000
NODE_2277_length_1508_cov_24.176011	765	845	12	2	80	0.0250000
NODE_2277_length_1508_cov_24.176011	765	845	13	44	80	0.5500000
NODE_2277_length_1508_cov_24.176011	765	845	14	19	80	0.2375000
NODE_2277_length_1508_cov_24.176011	765	845	15	15	80	0.1875000
NODE_2277_length_1508_cov_24.176011	818	898	5	26	80	0.3250000
NODE_2277_length_1508_cov_24.176011	818	898	9	7	80	0.0875000
NODE_2277_length_1508_cov_24.176011	818	898	10	4	80	0.0500000
NODE_2277_length_1508_cov_24.176011	818	898	11	11	80	0.1375000
NODE_2277_length_1508_cov_24.176011	818	898	12	7	80	0.0875000
NODE_2277_length_1508_cov_24.176011	818	898	13	1	80	0.0125000
NODE_2277_length_1508_cov_24.176011	818	898	14	9	80	0.1125000
NODE_2277_length_1508_cov_24.176011	818	898	15	15	80	0.1875000
NODE_2290_length_1504_cov_17.449822	596	676	4	36	80	0.4500000
NODE_2290_length_1504_cov_17.449822	596	676	5	44	80	0.5500000
NODE_2290_length_1504_cov_17.449822	649	729	3	4	80	0.0500000
NODE_2290_length_1504_cov_17.449822	649	729	4	58	80	0.7250000
NODE_2290_length_1504_cov_17.449822	649	729	5	11	80	0.1375000
NODE_2290_length_1504_cov_17.449822	649	729	6	7	80	0.0875000
NODE_2293_length_1502_cov_42.989309	559	639	12	22	80	0.2750000
NODE_2293_length_1502_cov_42.989309	559	639	13	39	80	0.4875000
NODE_2293_length_1502_cov_42.989309	559	639	14	19	80	0.2375000
NODE_2293_length_1502_cov_42.989309	612	692	12	13	80	0.1625000
NODE_2293_length_1502_cov_42.989309	612	692	13	38	80	0.4750000
NODE_2293_length_1502_cov_42.989309	612	692	14	29	80	0.3625000
NODE_2294_length_1501_cov_22.828816	421	500	3	42	79	0.5316456
NODE_2294_length_1501_cov_22.828816	421	500	4	37	79	0.4683544
NODE_2294_length_1501_cov_22.828816	473	553	3	25	80	0.3125000
NODE_2294_length_1501_cov_22.828816	473	553	4	55	80	0.6875000
NODE_2294_length_1501_cov_22.828816	549	629	2	26	80	0.3250000
NODE_2294_length_1501_cov_22.828816	549	629	3	54	80	0.6750000
NODE_2294_length_1501_cov_22.828816	602	682	2	69	80	0.8625000
NODE_2294_length_1501_cov_22.828816	602	682	3	11	80	0.1375000
NODE_2295_length_1501_cov_14.422254	973	1053	0	19	80	0.2375000
NODE_2295_length_1501_cov_14.422254	973	1053	2	61	80	0.7625000
NODE_2295_length_1501_cov_14.422254	1026	1106	2	80	80	1.0000000
NODE_2296_length_1501_cov_14.060628	225	305	2	52	80	0.6500000
NODE_2296_length_1501_cov_14.060628	225	305	6	28	80	0.3500000
NODE_2296_length_1501_cov_14.060628	278	358	6	59	80	0.7375000
NODE_2296_length_1501_cov_14.060628	278	358	7	2	80	0.0250000
NODE_2296_length_1501_cov_14.060628	278	358	8	17	80	0.2125000
NODE_2296_length_1501_cov_14.060628	278	358	10	2	80	0.0250000
NODE_2296_length_1501_cov_14.060628	986	1066	0	13	80	0.1625000
NODE_2296_length_1501_cov_14.060628	986	1066	2	20	80	0.2500000
NODE_2296_length_1501_cov_14.060628	986	1066	3	47	80	0.5875000
NODE_2296_length_1501_cov_14.060628	1039	1119	0	44	80	0.5500000
NODE_2296_length_1501_cov_14.060628	1039	1119	2	14	80	0.1750000
NODE_2296_length_1501_cov_14.060628	1039	1119	3	22	80	0.2750000
NODE_2300_length_1500_cov_40.056388	619	699	12	30	80	0.3750000
NODE_2300_length_1500_cov_40.056388	619	699	14	31	80	0.3875000
NODE_2300_length_1500_cov_40.056388	619	699	16	19	80	0.2375000
NODE_2300_length_1500_cov_40.056388	672	752	14	32	80	0.4000000
NODE_2300_length_1500_cov_40.056388	672	752	16	48	80	0.6000000
NODE_2305_length_1497_cov_38.344063	1401	1481	12	9	80	0.1125000
NODE_2305_length_1497_cov_38.344063	1401	1481	13	2	80	0.0250000
NODE_2305_length_1497_cov_38.344063	1401	1481	14	1	80	0.0125000
NODE_2305_length_1497_cov_38.344063	1401	1481	15	3	80	0.0375000
NODE_2305_length_1497_cov_38.344063	1401	1481	16	1	80	0.0125000
NODE_2305_length_1497_cov_38.344063	1401	1481	17	17	80	0.2125000
NODE_2305_length_1497_cov_38.344063	1401	1481	18	10	80	0.1250000
NODE_2305_length_1497_cov_38.344063	1401	1481	19	6	80	0.0750000
NODE_2305_length_1497_cov_38.344063	1401	1481	20	2	80	0.0250000
NODE_2305_length_1497_cov_38.344063	1401	1481	21	10	80	0.1250000
NODE_2305_length_1497_cov_38.344063	1401	1481	23	4	80	0.0500000
NODE_2305_length_1497_cov_38.344063	1401	1481	24	7	80	0.0875000
NODE_2305_length_1497_cov_38.344063	1401	1481	26	8	80	0.1000000
NODE_2308_length_1496_cov_3.936292	0	44	0	3	44	0.0681818
NODE_2308_length_1496_cov_3.936292	0	44	3	41	44	0.9318182
NODE_2308_length_1496_cov_3.936292	17	97	3	80	80	1.0000000
NODE_2311_length_1496_cov_1.103794	405	428	0	23	23	1.0000000
NODE_2313_length_1494_cov_65.437276	460	540	0	80	80	1.0000000
NODE_2313_length_1494_cov_65.437276	513	594	0	81	81	1.0000000
NODE_2313_length_1494_cov_65.437276	787	854	11	28	67	0.4179105
NODE_2313_length_1494_cov_65.437276	787	854	12	3	67	0.0447761
NODE_2313_length_1494_cov_65.437276	787	854	13	36	67	0.5373135
NODE_2313_length_1494_cov_65.437276	827	907	5	5	80	0.0625000
NODE_2313_length_1494_cov_65.437276	827	907	7	5	80	0.0625000
NODE_2313_length_1494_cov_65.437276	827	907	9	3	80	0.0375000
NODE_2313_length_1494_cov_65.437276	827	907	11	67	80	0.8375000
NODE_2316_length_1493_cov_100.467719	947	1028	26	6	81	0.0740741
NODE_2316_length_1493_cov_100.467719	947	1028	27	2	81	0.0246914
NODE_2316_length_1493_cov_100.467719	947	1028	28	2	81	0.0246914
NODE_2316_length_1493_cov_100.467719	947	1028	29	7	81	0.0864198
NODE_2316_length_1493_cov_100.467719	947	1028	30	3	81	0.0370370
NODE_2316_length_1493_cov_100.467719	947	1028	31	3	81	0.0370370
NODE_2316_length_1493_cov_100.467719	947	1028	32	2	81	0.0246914
NODE_2316_length_1493_cov_100.467719	947	1028	33	3	81	0.0370370
NODE_2316_length_1493_cov_100.467719	947	1028	34	1	81	0.0123457
NODE_2316_length_1493_cov_100.467719	947	1028	35	1	81	0.0123457
NODE_2316_length_1493_cov_100.467719	947	1028	36	5	81	0.0617284
NODE_2316_length_1493_cov_100.467719	947	1028	37	1	81	0.0123457
NODE_2316_length_1493_cov_100.467719	947	1028	44	1	81	0.0123457
NODE_2316_length_1493_cov_100.467719	947	1028	45	1	81	0.0123457
NODE_2316_length_1493_cov_100.467719	947	1028	46	8	81	0.0987654
NODE_2316_length_1493_cov_100.467719	947	1028	47	5	81	0.0617284
NODE_2316_length_1493_cov_100.467719	947	1028	48	7	81	0.0864198
NODE_2316_length_1493_cov_100.467719	947	1028	49	1	81	0.0123457
NODE_2316_length_1493_cov_100.467719	947	1028	50	1	81	0.0123457
NODE_2316_length_1493_cov_100.467719	947	1028	54	1	81	0.0123457
NODE_2316_length_1493_cov_100.467719	947	1028	55	1	81	0.0123457
NODE_2316_length_1493_cov_100.467719	947	1028	56	4	81	0.0493827
NODE_2316_length_1493_cov_100.467719	947	1028	57	3	81	0.0370370
NODE_2316_length_1493_cov_100.467719	947	1028	58	7	81	0.0864198
NODE_2316_length_1493_cov_100.467719	947	1028	59	2	81	0.0246914
NODE_2316_length_1493_cov_100.467719	947	1028	60	3	81	0.0370370
NODE_2316_length_1493_cov_100.467719	1001	1071	48	4	70	0.0571429
NODE_2316_length_1493_cov_100.467719	1001	1071	49	1	70	0.0142857
NODE_2316_length_1493_cov_100.467719	1001	1071	50	1	70	0.0142857
NODE_2316_length_1493_cov_100.467719	1001	1071	54	1	70	0.0142857
NODE_2316_length_1493_cov_100.467719	1001	1071	55	1	70	0.0142857
NODE_2316_length_1493_cov_100.467719	1001	1071	56	4	70	0.0571429
NODE_2316_length_1493_cov_100.467719	1001	1071	57	3	70	0.0428571
NODE_2316_length_1493_cov_100.467719	1001	1071	58	9	70	0.1285714
NODE_2316_length_1493_cov_100.467719	1001	1071	59	8	70	0.1142857
NODE_2316_length_1493_cov_100.467719	1001	1071	60	6	70	0.0857143
NODE_2316_length_1493_cov_100.467719	1001	1071	61	1	70	0.0142857
NODE_2316_length_1493_cov_100.467719	1001	1071	63	2	70	0.0285714
NODE_2316_length_1493_cov_100.467719	1001	1071	65	2	70	0.0285714
NODE_2316_length_1493_cov_100.467719	1001	1071	66	1	70	0.0142857
NODE_2316_length_1493_cov_100.467719	1001	1071	68	4	70	0.0571429
NODE_2316_length_1493_cov_100.467719	1001	1071	72	1	70	0.0142857
NODE_2316_length_1493_cov_100.467719	1001	1071	73	5	70	0.0714286
NODE_2316_length_1493_cov_100.467719	1001	1071	74	5	70	0.0714286
NODE_2316_length_1493_cov_100.467719	1001	1071	75	1	70	0.0142857
NODE_2316_length_1493_cov_100.467719	1001	1071	76	1	70	0.0142857
NODE_2316_length_1493_cov_100.467719	1001	1071	79	3	70	0.0428571
NODE_2316_length_1493_cov_100.467719	1001	1071	80	1	70	0.0142857
NODE_2316_length_1493_cov_100.467719	1001	1071	81	1	70	0.0142857
NODE_2316_length_1493_cov_100.467719	1001	1071	83	2	70	0.0285714
NODE_2316_length_1493_cov_100.467719	1001	1071	84	1	70	0.0142857
NODE_2316_length_1493_cov_100.467719	1001	1071	88	1	70	0.0142857
NODE_2316_length_1493_cov_100.467719	1077	1157	96	4	80	0.0500000
NODE_2316_length_1493_cov_100.467719	1077	1157	97	5	80	0.0625000
NODE_2316_length_1493_cov_100.467719	1077	1157	101	1	80	0.0125000
NODE_2316_length_1493_cov_100.467719	1077	1157	103	4	80	0.0500000
NODE_2316_length_1493_cov_100.467719	1077	1157	104	9	80	0.1125000
NODE_2316_length_1493_cov_100.467719	1077	1157	105	9	80	0.1125000
NODE_2316_length_1493_cov_100.467719	1077	1157	106	7	80	0.0875000
NODE_2316_length_1493_cov_100.467719	1077	1157	107	5	80	0.0625000
NODE_2316_length_1493_cov_100.467719	1077	1157	108	1	80	0.0125000
NODE_2316_length_1493_cov_100.467719	1077	1157	109	2	80	0.0250000
NODE_2316_length_1493_cov_100.467719	1077	1157	110	8	80	0.1000000
NODE_2316_length_1493_cov_100.467719	1077	1157	111	5	80	0.0625000
NODE_2316_length_1493_cov_100.467719	1077	1157	112	6	80	0.0750000
NODE_2316_length_1493_cov_100.467719	1077	1157	113	8	80	0.1000000
NODE_2316_length_1493_cov_100.467719	1077	1157	114	3	80	0.0375000
NODE_2316_length_1493_cov_100.467719	1077	1157	115	2	80	0.0250000
NODE_2316_length_1493_cov_100.467719	1077	1157	116	1	80	0.0125000
NODE_2316_length_1493_cov_100.467719	1130	1210	72	2	80	0.0250000
NODE_2316_length_1493_cov_100.467719	1130	1210	75	5	80	0.0625000
NODE_2316_length_1493_cov_100.467719	1130	1210	76	2	80	0.0250000
NODE_2316_length_1493_cov_100.467719	1130	1210	77	2	80	0.0250000
NODE_2316_length_1493_cov_100.467719	1130	1210	81	1	80	0.0125000
NODE_2316_length_1493_cov_100.467719	1130	1210	83	3	80	0.0375000
NODE_2316_length_1493_cov_100.467719	1130	1210	85	1	80	0.0125000
NODE_2316_length_1493_cov_100.467719	1130	1210	86	1	80	0.0125000
NODE_2316_length_1493_cov_100.467719	1130	1210	88	2	80	0.0250000
NODE_2316_length_1493_cov_100.467719	1130	1210	89	4	80	0.0500000
NODE_2316_length_1493_cov_100.467719	1130	1210	91	4	80	0.0500000
NODE_2316_length_1493_cov_100.467719	1130	1210	92	3	80	0.0375000
NODE_2316_length_1493_cov_100.467719	1130	1210	93	1	80	0.0125000
NODE_2316_length_1493_cov_100.467719	1130	1210	97	3	80	0.0375000
NODE_2316_length_1493_cov_100.467719	1130	1210	98	2	80	0.0250000
NODE_2316_length_1493_cov_100.467719	1130	1210	99	3	80	0.0375000
NODE_2316_length_1493_cov_100.467719	1130	1210	100	4	80	0.0500000
NODE_2316_length_1493_cov_100.467719	1130	1210	101	8	80	0.1000000
NODE_2316_length_1493_cov_100.467719	1130	1210	102	2	80	0.0250000
NODE_2316_length_1493_cov_100.467719	1130	1210	103	2	80	0.0250000
NODE_2316_length_1493_cov_100.467719	1130	1210	104	7	80	0.0875000
NODE_2316_length_1493_cov_100.467719	1130	1210	105	5	80	0.0625000
NODE_2316_length_1493_cov_100.467719	1130	1210	106	5	80	0.0625000
NODE_2316_length_1493_cov_100.467719	1130	1210	107	4	80	0.0500000
NODE_2316_length_1493_cov_100.467719	1130	1210	113	4	80	0.0500000
NODE_2321_length_1493_cov_1.138451	1341	1420	0	2	79	0.0253165
NODE_2321_length_1493_cov_1.138451	1341	1420	1	77	79	0.9746835
NODE_2321_length_1493_cov_1.138451	1341	1420	0	2	79	0.0253165
NODE_2321_length_1493_cov_1.138451	1341	1420	1	77	79	0.9746835
NODE_2321_length_1493_cov_1.138451	1393	1459	1	66	66	1.0000000
NODE_2332_length_1490_cov_5.726096	233	295	0	62	62	1.0000000
NODE_2332_length_1490_cov_5.726096	1065	1149	2	7	84	0.0833333
NODE_2332_length_1490_cov_5.726096	1065	1149	4	58	84	0.6904762
NODE_2332_length_1490_cov_5.726096	1065	1149	5	19	84	0.2261905
NODE_2333_length_1490_cov_4.687275	318	399	3	47	81	0.5802469
NODE_2333_length_1490_cov_4.687275	318	399	4	14	81	0.1728395
NODE_2333_length_1490_cov_4.687275	318	399	5	11	81	0.1358025
NODE_2333_length_1490_cov_4.687275	318	399	6	9	81	0.1111111
NODE_2333_length_1490_cov_4.687275	372	452	2	9	80	0.1125000
NODE_2333_length_1490_cov_4.687275	372	452	3	71	80	0.8875000
NODE_2338_length_1488_cov_3.734341	1141	1221	0	80	80	1.0000000
NODE_2340_length_1487_cov_19.332133	673	753	7	40	80	0.5000000
NODE_2340_length_1487_cov_19.332133	673	753	8	28	80	0.3500000
NODE_2340_length_1487_cov_19.332133	673	753	9	12	80	0.1500000
NODE_2340_length_1487_cov_19.332133	726	806	6	18	80	0.2250000
NODE_2340_length_1487_cov_19.332133	726	806	7	11	80	0.1375000
NODE_2340_length_1487_cov_19.332133	726	806	8	39	80	0.4875000
NODE_2340_length_1487_cov_19.332133	726	806	9	12	80	0.1500000
NODE_2348_length_1484_cov_38.342960	706	786	2	12	80	0.1500000
NODE_2348_length_1484_cov_38.342960	706	786	3	62	80	0.7750000
NODE_2348_length_1484_cov_38.342960	706	786	4	6	80	0.0750000
NODE_2348_length_1484_cov_38.342960	759	839	3	53	80	0.6625000
NODE_2348_length_1484_cov_38.342960	759	839	4	27	80	0.3375000
NODE_2349_length_1484_cov_21.260650	348	428	3	42	80	0.5250000
NODE_2349_length_1484_cov_21.260650	348	428	4	38	80	0.4750000
NODE_2349_length_1484_cov_21.260650	401	481	3	10	80	0.1250000
NODE_2349_length_1484_cov_21.260650	401	481	4	30	80	0.3750000
NODE_2349_length_1484_cov_21.260650	401	481	5	40	80	0.5000000
NODE_2349_length_1484_cov_21.260650	978	1058	9	7	80	0.0875000
NODE_2349_length_1484_cov_21.260650	978	1058	10	27	80	0.3375000
NODE_2349_length_1484_cov_21.260650	978	1058	11	45	80	0.5625000
NODE_2349_length_1484_cov_21.260650	978	1058	12	1	80	0.0125000
NODE_2349_length_1484_cov_21.260650	1031	1111	11	32	80	0.4000000
NODE_2349_length_1484_cov_21.260650	1031	1111	12	15	80	0.1875000
NODE_2349_length_1484_cov_21.260650	1031	1111	13	5	80	0.0625000
NODE_2349_length_1484_cov_21.260650	1031	1111	14	28	80	0.3500000
NODE_2350_length_1484_cov_19.243321	952	1032	11	21	80	0.2625000
NODE_2350_length_1484_cov_19.243321	952	1032	12	18	80	0.2250000
NODE_2350_length_1484_cov_19.243321	952	1032	13	9	80	0.1125000
NODE_2350_length_1484_cov_19.243321	952	1032	15	4	80	0.0500000
NODE_2350_length_1484_cov_19.243321	952	1032	16	4	80	0.0500000
NODE_2350_length_1484_cov_19.243321	952	1032	17	3	80	0.0375000
NODE_2350_length_1484_cov_19.243321	952	1032	18	20	80	0.2500000
NODE_2350_length_1484_cov_19.243321	952	1032	19	1	80	0.0125000
NODE_2350_length_1484_cov_19.243321	1005	1085	10	4	80	0.0500000
NODE_2350_length_1484_cov_19.243321	1005	1085	11	36	80	0.4500000
NODE_2350_length_1484_cov_19.243321	1005	1085	12	10	80	0.1250000
NODE_2350_length_1484_cov_19.243321	1005	1085	13	30	80	0.3750000
NODE_2351_length_1484_cov_9.085199	314	394	1	30	80	0.3750000
NODE_2351_length_1484_cov_9.085199	314	394	2	50	80	0.6250000
NODE_2351_length_1484_cov_9.085199	367	447	0	7	80	0.0875000
NODE_2351_length_1484_cov_9.085199	367	447	1	73	80	0.9125000
NODE_2353_length_1483_cov_21.207370	555	635	0	1	80	0.0125000
NODE_2353_length_1483_cov_21.207370	555	635	12	9	80	0.1125000
NODE_2353_length_1483_cov_21.207370	555	635	15	31	80	0.3875000
NODE_2353_length_1483_cov_21.207370	555	635	17	1	80	0.0125000
NODE_2353_length_1483_cov_21.207370	555	635	18	38	80	0.4750000
NODE_2353_length_1483_cov_21.207370	608	688	0	54	80	0.6750000
NODE_2353_length_1483_cov_21.207370	608	688	12	9	80	0.1125000
NODE_2353_length_1483_cov_21.207370	608	688	15	17	80	0.2125000
NODE_2359_length_1482_cov_20.177874	430	510	7	5	80	0.0625000
NODE_2359_length_1482_cov_20.177874	430	510	9	2	80	0.0250000
NODE_2359_length_1482_cov_20.177874	430	510	13	21	80	0.2625000
NODE_2359_length_1482_cov_20.177874	430	510	14	48	80	0.6000000
NODE_2359_length_1482_cov_20.177874	430	510	15	4	80	0.0500000
NODE_2359_length_1482_cov_20.177874	483	563	6	3	80	0.0375000
NODE_2359_length_1482_cov_20.177874	483	563	7	8	80	0.1000000
NODE_2359_length_1482_cov_20.177874	483	563	9	2	80	0.0250000
NODE_2359_length_1482_cov_20.177874	483	563	10	1	80	0.0125000
NODE_2359_length_1482_cov_20.177874	483	563	11	21	80	0.2625000
NODE_2359_length_1482_cov_20.177874	483	563	12	25	80	0.3125000
NODE_2359_length_1482_cov_20.177874	483	563	13	7	80	0.0875000
NODE_2359_length_1482_cov_20.177874	483	563	14	13	80	0.1625000
NODE_2359_length_1482_cov_20.177874	559	639	8	22	80	0.2750000
NODE_2359_length_1482_cov_20.177874	559	639	9	22	80	0.2750000
NODE_2359_length_1482_cov_20.177874	559	639	10	14	80	0.1750000
NODE_2359_length_1482_cov_20.177874	559	639	12	10	80	0.1250000
NODE_2359_length_1482_cov_20.177874	559	639	14	5	80	0.0625000
NODE_2359_length_1482_cov_20.177874	559	639	18	7	80	0.0875000
NODE_2359_length_1482_cov_20.177874	612	692	9	14	80	0.1750000
NODE_2359_length_1482_cov_20.177874	612	692	12	5	80	0.0625000
NODE_2359_length_1482_cov_20.177874	612	692	13	22	80	0.2750000
NODE_2359_length_1482_cov_20.177874	612	692	14	5	80	0.0625000
NODE_2359_length_1482_cov_20.177874	612	692	18	34	80	0.4250000
NODE_2360_length_1482_cov_13.644252	1000	1080	5	15	80	0.1875000
NODE_2360_length_1482_cov_13.644252	1000	1080	10	51	80	0.6375000
NODE_2360_length_1482_cov_13.644252	1000	1080	13	14	80	0.1750000
NODE_2360_length_1482_cov_13.644252	1053	1133	1	11	80	0.1375000
NODE_2360_length_1482_cov_13.644252	1053	1133	2	16	80	0.2000000
NODE_2360_length_1482_cov_13.644252	1053	1133	3	6	80	0.0750000
NODE_2360_length_1482_cov_13.644252	1053	1133	4	15	80	0.1875000
NODE_2360_length_1482_cov_13.644252	1053	1133	5	20	80	0.2500000
NODE_2360_length_1482_cov_13.644252	1053	1133	10	12	80	0.1500000
NODE_2361_length_1482_cov_6.157628	525	605	0	23	80	0.2875000
NODE_2361_length_1482_cov_6.157628	525	605	2	57	80	0.7125000
NODE_2361_length_1482_cov_6.157628	578	658	2	80	80	1.0000000
NODE_2361_length_1482_cov_6.157628	1306	1388	3	33	82	0.4024390
NODE_2361_length_1482_cov_6.157628	1306	1388	6	49	82	0.5975610
NODE_2364_length_1481_cov_19.238784	480	560	3	5	80	0.0625000
NODE_2364_length_1481_cov_19.238784	480	560	6	7	80	0.0875000
NODE_2364_length_1481_cov_19.238784	480	560	7	33	80	0.4125000
NODE_2364_length_1481_cov_19.238784	480	560	8	34	80	0.4250000
NODE_2364_length_1481_cov_19.238784	480	560	9	1	80	0.0125000
NODE_2364_length_1481_cov_19.238784	533	613	7	32	80	0.4000000
NODE_2364_length_1481_cov_19.238784	533	613	8	11	80	0.1375000
NODE_2364_length_1481_cov_19.238784	533	613	9	37	80	0.4625000
NODE_2365_length_1481_cov_18.139653	706	786	2	28	80	0.3500000
NODE_2365_length_1481_cov_18.139653	706	786	4	52	80	0.6500000
NODE_2365_length_1481_cov_18.139653	759	839	2	6	80	0.0750000
NODE_2365_length_1481_cov_18.139653	759	839	4	74	80	0.9250000
NODE_2367_length_1480_cov_27.552498	762	842	1	41	80	0.5125000
NODE_2367_length_1480_cov_27.552498	762	842	2	39	80	0.4875000
NODE_2367_length_1480_cov_27.552498	815	895	2	45	80	0.5625000
NODE_2367_length_1480_cov_27.552498	815	895	3	24	80	0.3000000
NODE_2367_length_1480_cov_27.552498	815	895	4	1	80	0.0125000
NODE_2367_length_1480_cov_27.552498	815	895	5	10	80	0.1250000
NODE_2367_length_1480_cov_27.552498	891	971	4	47	80	0.5875000
NODE_2367_length_1480_cov_27.552498	891	971	5	33	80	0.4125000
NODE_2367_length_1480_cov_27.552498	944	1024	4	40	80	0.5000000
NODE_2367_length_1480_cov_27.552498	944	1024	5	40	80	0.5000000
NODE_2367_length_1480_cov_27.552498	1171	1222	12	3	51	0.0588235
NODE_2367_length_1480_cov_27.552498	1171	1222	14	4	51	0.0784314
NODE_2367_length_1480_cov_27.552498	1171	1222	16	1	51	0.0196078
NODE_2367_length_1480_cov_27.552498	1171	1222	17	5	51	0.0980392
NODE_2367_length_1480_cov_27.552498	1171	1222	18	6	51	0.1176471
NODE_2367_length_1480_cov_27.552498	1171	1222	19	6	51	0.1176471
NODE_2367_length_1480_cov_27.552498	1171	1222	20	1	51	0.0196078
NODE_2367_length_1480_cov_27.552498	1171	1222	22	6	51	0.1176471
NODE_2367_length_1480_cov_27.552498	1171	1222	23	3	51	0.0588235
NODE_2367_length_1480_cov_27.552498	1171	1222	24	4	51	0.0784314
NODE_2367_length_1480_cov_27.552498	1171	1222	26	12	51	0.2352941
NODE_2369_length_1480_cov_12.535844	466	546	0	21	80	0.2625000
NODE_2369_length_1480_cov_12.535844	466	546	2	8	80	0.1000000
NODE_2369_length_1480_cov_12.535844	466	546	3	39	80	0.4875000
NODE_2369_length_1480_cov_12.535844	466	546	5	12	80	0.1500000
NODE_2369_length_1480_cov_12.535844	519	599	3	15	80	0.1875000
NODE_2369_length_1480_cov_12.535844	519	599	5	65	80	0.8125000
NODE_2373_length_1479_cov_17.035507	708	788	3	21	80	0.2625000
NODE_2373_length_1479_cov_17.035507	708	788	4	10	80	0.1250000
NODE_2373_length_1479_cov_17.035507	708	788	5	14	80	0.1750000
NODE_2373_length_1479_cov_17.035507	708	788	6	22	80	0.2750000
NODE_2373_length_1479_cov_17.035507	708	788	9	4	80	0.0500000
NODE_2373_length_1479_cov_17.035507	708	788	10	9	80	0.1125000
NODE_2373_length_1479_cov_17.035507	761	841	6	14	80	0.1750000
NODE_2373_length_1479_cov_17.035507	761	841	9	4	80	0.0500000
NODE_2373_length_1479_cov_17.035507	761	841	10	12	80	0.1500000
NODE_2373_length_1479_cov_17.035507	761	841	11	42	80	0.5250000
NODE_2373_length_1479_cov_17.035507	761	841	12	2	80	0.0250000
NODE_2373_length_1479_cov_17.035507	761	841	13	6	80	0.0750000
NODE_2373_length_1479_cov_17.035507	837	917	10	34	80	0.4250000
NODE_2373_length_1479_cov_17.035507	837	917	11	46	80	0.5750000
NODE_2373_length_1479_cov_17.035507	890	970	8	29	80	0.3625000
NODE_2373_length_1479_cov_17.035507	890	970	9	12	80	0.1500000
NODE_2373_length_1479_cov_17.035507	890	970	10	27	80	0.3375000
NODE_2373_length_1479_cov_17.035507	890	970	11	7	80	0.0875000
NODE_2373_length_1479_cov_17.035507	890	970	13	5	80	0.0625000
NODE_2374_length_1479_cov_16.448551	908	988	5	4	80	0.0500000
NODE_2374_length_1479_cov_16.448551	908	988	6	13	80	0.1625000
NODE_2374_length_1479_cov_16.448551	908	988	7	42	80	0.5250000
NODE_2374_length_1479_cov_16.448551	908	988	8	21	80	0.2625000
NODE_2374_length_1479_cov_16.448551	961	1041	5	10	80	0.1250000
NODE_2374_length_1479_cov_16.448551	961	1041	6	9	80	0.1125000
NODE_2374_length_1479_cov_16.448551	961	1041	7	52	80	0.6500000
NODE_2374_length_1479_cov_16.448551	961	1041	8	9	80	0.1125000
NODE_2375_length_1479_cov_5.285507	123	185	0	62	62	1.0000000
NODE_2376_length_1479_cov_2.018841	881	967	0	86	86	1.0000000
NODE_2377_length_1478_cov_32.050761	411	491	0	80	80	1.0000000
NODE_2377_length_1478_cov_32.050761	464	544	0	50	80	0.6250000
NODE_2377_length_1478_cov_32.050761	464	544	2	30	80	0.3750000
NODE_2377_length_1478_cov_32.050761	540	620	2	22	80	0.2750000
NODE_2377_length_1478_cov_32.050761	540	620	4	31	80	0.3875000
NODE_2377_length_1478_cov_32.050761	540	620	5	27	80	0.3375000
NODE_2377_length_1478_cov_32.050761	593	673	4	3	80	0.0375000
NODE_2377_length_1478_cov_32.050761	593	673	5	34	80	0.4250000
NODE_2377_length_1478_cov_32.050761	593	673	6	43	80	0.5375000
NODE_2378_length_1478_cov_27.414793	817	897	10	10	80	0.1250000
NODE_2378_length_1478_cov_27.414793	817	897	11	57	80	0.7125000
NODE_2378_length_1478_cov_27.414793	817	897	12	12	80	0.1500000
NODE_2378_length_1478_cov_27.414793	817	897	13	1	80	0.0125000
NODE_2378_length_1478_cov_27.414793	870	950	9	4	80	0.0500000
NODE_2378_length_1478_cov_27.414793	870	950	10	58	80	0.7250000
NODE_2378_length_1478_cov_27.414793	870	950	11	5	80	0.0625000
NODE_2378_length_1478_cov_27.414793	870	950	12	12	80	0.1500000
NODE_2378_length_1478_cov_27.414793	870	950	13	1	80	0.0125000
NODE_2379_length_1478_cov_23.472081	1212	1241	7	29	29	1.0000000
NODE_2380_length_1478_cov_10.746193	678	758	7	18	80	0.2250000
NODE_2380_length_1478_cov_10.746193	678	758	8	62	80	0.7750000
NODE_2380_length_1478_cov_10.746193	731	811	7	26	80	0.3250000
NODE_2380_length_1478_cov_10.746193	731	811	8	54	80	0.6750000
NODE_2380_length_1478_cov_10.746193	807	892	2	10	85	0.1176471
NODE_2380_length_1478_cov_10.746193	807	892	5	2	85	0.0235294
NODE_2380_length_1478_cov_10.746193	807	892	6	15	85	0.1764706
NODE_2380_length_1478_cov_10.746193	807	892	7	25	85	0.2941177
NODE_2380_length_1478_cov_10.746193	807	892	8	7	85	0.0823529
NODE_2380_length_1478_cov_10.746193	807	892	9	26	85	0.3058824
NODE_2380_length_1478_cov_10.746193	860	945	7	6	85	0.0705882
NODE_2380_length_1478_cov_10.746193	860	945	9	42	85	0.4941176
NODE_2380_length_1478_cov_10.746193	860	945	13	20	85	0.2352941
NODE_2380_length_1478_cov_10.746193	860	945	14	12	85	0.1411765
NODE_2380_length_1478_cov_10.746193	860	945	18	5	85	0.0588235
NODE_2384_length_1476_cov_6.522150	791	871	6	9	80	0.1125000
NODE_2384_length_1476_cov_6.522150	791	871	7	10	80	0.1250000
NODE_2384_length_1476_cov_6.522150	791	871	8	37	80	0.4625000
NODE_2384_length_1476_cov_6.522150	791	871	9	8	80	0.1000000
NODE_2384_length_1476_cov_6.522150	791	871	10	16	80	0.2000000
NODE_2384_length_1476_cov_6.522150	844	924	3	12	80	0.1500000
NODE_2384_length_1476_cov_6.522150	844	924	4	12	80	0.1500000
NODE_2384_length_1476_cov_6.522150	844	924	5	11	80	0.1375000
NODE_2384_length_1476_cov_6.522150	844	924	6	27	80	0.3375000
NODE_2384_length_1476_cov_6.522150	844	924	7	10	80	0.1250000
NODE_2384_length_1476_cov_6.522150	844	924	8	8	80	0.1000000
NODE_2392_length_1474_cov_11.209455	515	595	9	15	80	0.1875000
NODE_2392_length_1474_cov_11.209455	515	595	10	33	80	0.4125000
NODE_2392_length_1474_cov_11.209455	515	595	11	12	80	0.1500000
NODE_2392_length_1474_cov_11.209455	515	595	12	15	80	0.1875000
NODE_2392_length_1474_cov_11.209455	515	595	13	5	80	0.0625000
NODE_2392_length_1474_cov_11.209455	568	648	4	16	80	0.2000000
NODE_2392_length_1474_cov_11.209455	568	648	7	10	80	0.1250000
NODE_2392_length_1474_cov_11.209455	568	648	8	12	80	0.1500000
NODE_2392_length_1474_cov_11.209455	568	648	9	25	80	0.3125000
NODE_2392_length_1474_cov_11.209455	568	648	10	13	80	0.1625000
NODE_2392_length_1474_cov_11.209455	568	648	12	4	80	0.0500000
NODE_2397_length_1472_cov_22.159505	428	508	4	26	80	0.3250000
NODE_2397_length_1472_cov_22.159505	428	508	6	49	80	0.6125000
NODE_2397_length_1472_cov_22.159505	428	508	8	5	80	0.0625000
NODE_2397_length_1472_cov_22.159505	428	508	4	26	80	0.3250000
NODE_2397_length_1472_cov_22.159505	428	508	6	49	80	0.6125000
NODE_2397_length_1472_cov_22.159505	428	508	8	5	80	0.0625000
NODE_2397_length_1472_cov_22.159505	481	561	0	26	80	0.3250000
NODE_2397_length_1472_cov_22.159505	481	561	1	6	80	0.0750000
NODE_2397_length_1472_cov_22.159505	481	561	3	18	80	0.2250000
NODE_2397_length_1472_cov_22.159505	481	561	4	29	80	0.3625000
NODE_2397_length_1472_cov_22.159505	481	561	6	1	80	0.0125000
NODE_2397_length_1472_cov_22.159505	913	993	3	4	80	0.0500000
NODE_2397_length_1472_cov_22.159505	913	993	4	13	80	0.1625000
NODE_2397_length_1472_cov_22.159505	913	993	5	3	80	0.0375000
NODE_2397_length_1472_cov_22.159505	913	993	6	23	80	0.2875000
NODE_2397_length_1472_cov_22.159505	913	993	8	10	80	0.1250000
NODE_2397_length_1472_cov_22.159505	913	993	9	1	80	0.0125000
NODE_2397_length_1472_cov_22.159505	913	993	11	17	80	0.2125000
NODE_2397_length_1472_cov_22.159505	913	993	13	9	80	0.1125000
NODE_2397_length_1472_cov_22.159505	966	1046	9	1	80	0.0125000
NODE_2397_length_1472_cov_22.159505	966	1046	11	17	80	0.2125000
NODE_2397_length_1472_cov_22.159505	966	1046	13	15	80	0.1875000
NODE_2397_length_1472_cov_22.159505	966	1046	16	4	80	0.0500000
NODE_2397_length_1472_cov_22.159505	966	1046	17	43	80	0.5375000
NODE_2397_length_1472_cov_22.159505	1042	1122	11	5	80	0.0625000
NODE_2397_length_1472_cov_22.159505	1042	1122	12	1	80	0.0125000
NODE_2397_length_1472_cov_22.159505	1042	1122	13	10	80	0.1250000
NODE_2397_length_1472_cov_22.159505	1042	1122	15	16	80	0.2000000
NODE_2397_length_1472_cov_22.159505	1042	1122	16	8	80	0.1000000
NODE_2397_length_1472_cov_22.159505	1042	1122	17	23	80	0.2875000
NODE_2397_length_1472_cov_22.159505	1042	1122	18	12	80	0.1500000
NODE_2397_length_1472_cov_22.159505	1042	1122	19	5	80	0.0625000
NODE_2397_length_1472_cov_22.159505	1095	1175	5	22	80	0.2750000
NODE_2397_length_1472_cov_22.159505	1095	1175	6	4	80	0.0500000
NODE_2397_length_1472_cov_22.159505	1095	1175	9	15	80	0.1875000
NODE_2397_length_1472_cov_22.159505	1095	1175	11	17	80	0.2125000
NODE_2397_length_1472_cov_22.159505	1095	1175	12	1	80	0.0125000
NODE_2397_length_1472_cov_22.159505	1095	1175	13	10	80	0.1250000
NODE_2397_length_1472_cov_22.159505	1095	1175	15	11	80	0.1375000
NODE_2398_length_1472_cov_22.018208	523	590	10	18	67	0.2686567
NODE_2398_length_1472_cov_22.018208	523	590	11	15	67	0.2238806
NODE_2398_length_1472_cov_22.018208	523	590	12	34	67	0.5074627
NODE_2398_length_1472_cov_22.018208	563	643	9	12	80	0.1500000
NODE_2398_length_1472_cov_22.018208	563	643	10	14	80	0.1750000
NODE_2398_length_1472_cov_22.018208	563	643	11	15	80	0.1875000
NODE_2398_length_1472_cov_22.018208	563	643	12	20	80	0.2500000
NODE_2398_length_1472_cov_22.018208	563	643	15	4	80	0.0500000
NODE_2398_length_1472_cov_22.018208	563	643	16	14	80	0.1750000
NODE_2398_length_1472_cov_22.018208	563	643	17	1	80	0.0125000
NODE_2398_length_1472_cov_22.018208	639	719	15	2	80	0.0250000
NODE_2398_length_1472_cov_22.018208	639	719	16	19	80	0.2375000
NODE_2398_length_1472_cov_22.018208	639	719	18	3	80	0.0375000
NODE_2398_length_1472_cov_22.018208	639	719	19	5	80	0.0625000
NODE_2398_length_1472_cov_22.018208	639	719	22	18	80	0.2250000
NODE_2398_length_1472_cov_22.018208	639	719	23	2	80	0.0250000
NODE_2398_length_1472_cov_22.018208	639	719	24	10	80	0.1250000
NODE_2398_length_1472_cov_22.018208	639	719	25	3	80	0.0375000
NODE_2398_length_1472_cov_22.018208	639	719	26	8	80	0.1000000
NODE_2398_length_1472_cov_22.018208	639	719	27	10	80	0.1250000
NODE_2398_length_1472_cov_22.018208	692	772	22	5	80	0.0625000
NODE_2398_length_1472_cov_22.018208	692	772	24	8	80	0.1000000
NODE_2398_length_1472_cov_22.018208	692	772	25	13	80	0.1625000
NODE_2398_length_1472_cov_22.018208	692	772	26	9	80	0.1125000
NODE_2398_length_1472_cov_22.018208	692	772	27	33	80	0.4125000
NODE_2398_length_1472_cov_22.018208	692	772	28	12	80	0.1500000
NODE_2404_length_1470_cov_7.042305	5	57	0	52	52	1.0000000
NODE_2405_length_1470_cov_2.185266	199	245	0	46	46	1.0000000
NODE_2407_length_1469_cov_5.683942	834	914	0	30	80	0.3750000
NODE_2407_length_1469_cov_5.683942	834	914	1	1	80	0.0125000
NODE_2407_length_1469_cov_5.683942	834	914	2	1	80	0.0125000
NODE_2407_length_1469_cov_5.683942	834	914	4	48	80	0.6000000
NODE_2407_length_1469_cov_5.683942	887	967	4	28	80	0.3500000
NODE_2407_length_1469_cov_5.683942	887	967	6	35	80	0.4375000
NODE_2407_length_1469_cov_5.683942	887	967	7	4	80	0.0500000
NODE_2407_length_1469_cov_5.683942	887	967	8	13	80	0.1625000
NODE_2410_length_1467_cov_31.231725	1048	1131	0	16	83	0.1927711
NODE_2410_length_1467_cov_31.231725	1048	1131	3	67	83	0.8072289
NODE_2411_length_1467_cov_19.731725	485	565	14	27	80	0.3375000
NODE_2411_length_1467_cov_19.731725	485	565	15	22	80	0.2750000
NODE_2411_length_1467_cov_19.731725	485	565	16	27	80	0.3375000
NODE_2411_length_1467_cov_19.731725	485	565	17	4	80	0.0500000
NODE_2411_length_1467_cov_19.731725	538	618	9	15	80	0.1875000
NODE_2411_length_1467_cov_19.731725	538	618	10	3	80	0.0375000
NODE_2411_length_1467_cov_19.731725	538	618	11	14	80	0.1750000
NODE_2411_length_1467_cov_19.731725	538	618	13	5	80	0.0625000
NODE_2411_length_1467_cov_19.731725	538	618	14	39	80	0.4875000
NODE_2411_length_1467_cov_19.731725	538	618	15	4	80	0.0500000
NODE_2412_length_1467_cov_11.807749	180	242	0	62	62	1.0000000
NODE_2412_length_1467_cov_11.807749	264	293	0	29	29	1.0000000
NODE_2412_length_1467_cov_11.807749	930	1010	3	22	80	0.2750000
NODE_2412_length_1467_cov_11.807749	930	1010	4	14	80	0.1750000
NODE_2412_length_1467_cov_11.807749	930	1010	5	44	80	0.5500000
NODE_2412_length_1467_cov_11.807749	983	1063	2	22	80	0.2750000
NODE_2412_length_1467_cov_11.807749	983	1063	3	53	80	0.6625000
NODE_2412_length_1467_cov_11.807749	983	1063	4	5	80	0.0625000
NODE_2414_length_1466_cov_41.326993	664	744	7	7	80	0.0875000
NODE_2414_length_1466_cov_41.326993	664	744	10	9	80	0.1125000
NODE_2414_length_1466_cov_41.326993	664	744	11	11	80	0.1375000
NODE_2414_length_1466_cov_41.326993	664	744	12	29	80	0.3625000
NODE_2414_length_1466_cov_41.326993	664	744	13	24	80	0.3000000
NODE_2414_length_1466_cov_41.326993	717	797	4	12	80	0.1500000
NODE_2414_length_1466_cov_41.326993	717	797	5	10	80	0.1250000
NODE_2414_length_1466_cov_41.326993	717	797	6	10	80	0.1250000
NODE_2414_length_1466_cov_41.326993	717	797	7	28	80	0.3500000
NODE_2414_length_1466_cov_41.326993	717	797	10	9	80	0.1125000
NODE_2414_length_1466_cov_41.326993	717	797	11	4	80	0.0500000
NODE_2414_length_1466_cov_41.326993	717	797	12	7	80	0.0875000
NODE_2414_length_1466_cov_41.326993	793	873	6	2	80	0.0250000
NODE_2414_length_1466_cov_41.326993	793	873	7	11	80	0.1375000
NODE_2414_length_1466_cov_41.326993	793	873	8	12	80	0.1500000
NODE_2414_length_1466_cov_41.326993	793	873	9	8	80	0.1000000
NODE_2414_length_1466_cov_41.326993	793	873	11	8	80	0.1000000
NODE_2414_length_1466_cov_41.326993	793	873	12	38	80	0.4750000
NODE_2414_length_1466_cov_41.326993	793	873	13	1	80	0.0125000
NODE_2414_length_1466_cov_41.326993	846	926	12	68	80	0.8500000
NODE_2414_length_1466_cov_41.326993	846	926	13	12	80	0.1500000
NODE_2420_length_1464_cov_6.726740	137	204	2	6	67	0.0895522
NODE_2420_length_1464_cov_6.726740	137	204	4	24	67	0.3582090
NODE_2420_length_1464_cov_6.726740	137	204	6	37	67	0.5522388
NODE_2422_length_1464_cov_2.198535	1301	1363	2	62	62	1.0000000
NODE_2425_length_1463_cov_15.345308	314	394	2	37	80	0.4625000
NODE_2425_length_1463_cov_15.345308	314	394	3	43	80	0.5375000
NODE_2425_length_1463_cov_15.345308	367	447	2	18	80	0.2250000
NODE_2425_length_1463_cov_15.345308	367	447	3	11	80	0.1375000
NODE_2425_length_1463_cov_15.345308	367	447	4	45	80	0.5625000
NODE_2425_length_1463_cov_15.345308	367	447	5	6	80	0.0750000
NODE_2427_length_1462_cov_18.082172	418	498	8	20	80	0.2500000
NODE_2427_length_1462_cov_18.082172	418	498	9	36	80	0.4500000
NODE_2427_length_1462_cov_18.082172	418	498	10	24	80	0.3000000
NODE_2427_length_1462_cov_18.082172	471	551	4	18	80	0.2250000
NODE_2427_length_1462_cov_18.082172	471	551	5	1	80	0.0125000
NODE_2427_length_1462_cov_18.082172	471	551	7	3	80	0.0375000
NODE_2427_length_1462_cov_18.082172	471	551	9	24	80	0.3000000
NODE_2427_length_1462_cov_18.082172	471	551	10	26	80	0.3250000
NODE_2427_length_1462_cov_18.082172	471	551	11	8	80	0.1000000
NODE_2427_length_1462_cov_18.082172	1036	1116	4	21	80	0.2625000
NODE_2427_length_1462_cov_18.082172	1036	1116	5	44	80	0.5500000
NODE_2427_length_1462_cov_18.082172	1036	1116	6	15	80	0.1875000
NODE_2427_length_1462_cov_18.082172	1089	1169	2	27	80	0.3375000
NODE_2427_length_1462_cov_18.082172	1089	1169	4	22	80	0.2750000
NODE_2427_length_1462_cov_18.082172	1089	1169	5	27	80	0.3375000
NODE_2427_length_1462_cov_18.082172	1089	1169	6	4	80	0.0500000
NODE_2428_length_1462_cov_1.792370	1247	1319	0	72	72	1.0000000
NODE_2428_length_1462_cov_1.792370	1305	1374	0	69	69	1.0000000
NODE_2433_length_1460_cov_23.927994	852	932	4	9	80	0.1125000
NODE_2433_length_1460_cov_23.927994	852	932	5	16	80	0.2000000
NODE_2433_length_1460_cov_23.927994	852	932	6	13	80	0.1625000
NODE_2433_length_1460_cov_23.927994	852	932	7	35	80	0.4375000
NODE_2433_length_1460_cov_23.927994	852	932	8	1	80	0.0125000
NODE_2433_length_1460_cov_23.927994	852	932	9	6	80	0.0750000
NODE_2433_length_1460_cov_23.927994	905	985	7	20	80	0.2500000
NODE_2433_length_1460_cov_23.927994	905	985	8	1	80	0.0125000
NODE_2433_length_1460_cov_23.927994	905	985	9	11	80	0.1375000
NODE_2433_length_1460_cov_23.927994	905	985	10	43	80	0.5375000
NODE_2433_length_1460_cov_23.927994	905	985	11	5	80	0.0625000
NODE_2436_length_1459_cov_43.600000	535	615	22	4	80	0.0500000
NODE_2436_length_1459_cov_43.600000	535	615	23	30	80	0.3750000
NODE_2436_length_1459_cov_43.600000	535	615	24	25	80	0.3125000
NODE_2436_length_1459_cov_43.600000	535	615	25	10	80	0.1250000
NODE_2436_length_1459_cov_43.600000	535	615	26	11	80	0.1375000
NODE_2436_length_1459_cov_43.600000	588	668	19	1	80	0.0125000
NODE_2436_length_1459_cov_43.600000	588	668	20	3	80	0.0375000
NODE_2436_length_1459_cov_43.600000	588	668	21	2	80	0.0250000
NODE_2436_length_1459_cov_43.600000	588	668	22	2	80	0.0250000
NODE_2436_length_1459_cov_43.600000	588	668	23	4	80	0.0500000
NODE_2436_length_1459_cov_43.600000	588	668	24	17	80	0.2125000
NODE_2436_length_1459_cov_43.600000	588	668	25	19	80	0.2375000
NODE_2436_length_1459_cov_43.600000	588	668	26	21	80	0.2625000
NODE_2436_length_1459_cov_43.600000	588	668	27	2	80	0.0250000
NODE_2436_length_1459_cov_43.600000	588	668	28	9	80	0.1125000
NODE_2436_length_1459_cov_43.600000	664	744	18	21	80	0.2625000
NODE_2436_length_1459_cov_43.600000	664	744	19	18	80	0.2250000
NODE_2436_length_1459_cov_43.600000	664	744	20	12	80	0.1500000
NODE_2436_length_1459_cov_43.600000	664	744	21	24	80	0.3000000
NODE_2436_length_1459_cov_43.600000	664	744	22	5	80	0.0625000
NODE_2436_length_1459_cov_43.600000	717	797	8	2	80	0.0250000
NODE_2436_length_1459_cov_43.600000	717	797	10	17	80	0.2125000
NODE_2436_length_1459_cov_43.600000	717	797	12	2	80	0.0250000
NODE_2436_length_1459_cov_43.600000	717	797	13	2	80	0.0250000
NODE_2436_length_1459_cov_43.600000	717	797	15	7	80	0.0875000
NODE_2436_length_1459_cov_43.600000	717	797	16	3	80	0.0375000
NODE_2436_length_1459_cov_43.600000	717	797	18	13	80	0.1625000
NODE_2436_length_1459_cov_43.600000	717	797	19	17	80	0.2125000
NODE_2436_length_1459_cov_43.600000	717	797	21	17	80	0.2125000
NODE_2437_length_1459_cov_32.276471	865	945	10	22	80	0.2750000
NODE_2437_length_1459_cov_32.276471	865	945	12	17	80	0.2125000
NODE_2437_length_1459_cov_32.276471	865	945	13	23	80	0.2875000
NODE_2437_length_1459_cov_32.276471	865	945	15	18	80	0.2250000
NODE_2437_length_1459_cov_32.276471	918	998	9	26	80	0.3250000
NODE_2437_length_1459_cov_32.276471	918	998	10	23	80	0.2875000
NODE_2437_length_1459_cov_32.276471	918	998	12	10	80	0.1250000
NODE_2437_length_1459_cov_32.276471	918	998	13	5	80	0.0625000
NODE_2437_length_1459_cov_32.276471	918	998	15	16	80	0.2000000
NODE_2437_length_1459_cov_32.276471	994	1074	2	8	80	0.1000000
NODE_2437_length_1459_cov_32.276471	994	1074	4	1	80	0.0125000
NODE_2437_length_1459_cov_32.276471	994	1074	5	28	80	0.3500000
NODE_2437_length_1459_cov_32.276471	994	1074	6	4	80	0.0500000
NODE_2437_length_1459_cov_32.276471	994	1074	7	29	80	0.3625000
NODE_2437_length_1459_cov_32.276471	994	1074	9	10	80	0.1250000
NODE_2437_length_1459_cov_32.276471	1047	1127	2	32	80	0.4000000
NODE_2437_length_1459_cov_32.276471	1047	1127	5	47	80	0.5875000
NODE_2437_length_1459_cov_32.276471	1047	1127	9	1	80	0.0125000
NODE_2441_length_1458_cov_2.184695	1361	1441	0	80	80	1.0000000
NODE_2442_length_1457_cov_19.687040	834	914	2	19	80	0.2375000
NODE_2442_length_1457_cov_19.687040	834	914	3	14	80	0.1750000
NODE_2442_length_1457_cov_19.687040	834	914	4	47	80	0.5875000
NODE_2442_length_1457_cov_19.687040	887	967	1	12	80	0.1500000
NODE_2442_length_1457_cov_19.687040	887	967	3	55	80	0.6875000
NODE_2442_length_1457_cov_19.687040	887	967	4	13	80	0.1625000
NODE_2442_length_1457_cov_19.687040	963	1043	1	20	80	0.2500000
NODE_2442_length_1457_cov_19.687040	963	1043	2	60	80	0.7500000
NODE_2442_length_1457_cov_19.687040	1016	1096	2	44	80	0.5500000
NODE_2442_length_1457_cov_19.687040	1016	1096	3	36	80	0.4500000
NODE_2444_length_1457_cov_14.944772	754	834	8	13	80	0.1625000
NODE_2444_length_1457_cov_14.944772	754	834	11	4	80	0.0500000
NODE_2444_length_1457_cov_14.944772	754	834	12	2	80	0.0250000
NODE_2444_length_1457_cov_14.944772	754	834	13	2	80	0.0250000
NODE_2444_length_1457_cov_14.944772	754	834	14	7	80	0.0875000
NODE_2444_length_1457_cov_14.944772	754	834	15	52	80	0.6500000
NODE_2444_length_1457_cov_14.944772	807	887	9	4	80	0.0500000
NODE_2444_length_1457_cov_14.944772	807	887	11	7	80	0.0875000
NODE_2444_length_1457_cov_14.944772	807	887	12	7	80	0.0875000
NODE_2444_length_1457_cov_14.944772	807	887	13	37	80	0.4625000
NODE_2444_length_1457_cov_14.944772	807	887	15	25	80	0.3125000
NODE_2445_length_1457_cov_10.168630	827	907	0	32	80	0.4000000
NODE_2445_length_1457_cov_10.168630	827	907	1	48	80	0.6000000
NODE_2445_length_1457_cov_10.168630	880	960	1	80	80	1.0000000
NODE_2445_length_1457_cov_10.168630	956	1036	1	15	80	0.1875000
NODE_2445_length_1457_cov_10.168630	956	1036	2	19	80	0.2375000
NODE_2445_length_1457_cov_10.168630	956	1036	3	21	80	0.2625000
NODE_2445_length_1457_cov_10.168630	956	1036	4	25	80	0.3125000
NODE_2445_length_1457_cov_10.168630	1009	1089	2	2	80	0.0250000
NODE_2445_length_1457_cov_10.168630	1009	1089	4	31	80	0.3875000
NODE_2445_length_1457_cov_10.168630	1009	1089	5	47	80	0.5875000
NODE_2448_length_1456_cov_13.675755	557	637	8	22	80	0.2750000
NODE_2448_length_1456_cov_13.675755	557	637	9	26	80	0.3250000
NODE_2448_length_1456_cov_13.675755	557	637	10	32	80	0.4000000
NODE_2448_length_1456_cov_13.675755	610	690	7	18	80	0.2250000
NODE_2448_length_1456_cov_13.675755	610	690	9	4	80	0.0500000
NODE_2448_length_1456_cov_13.675755	610	690	10	58	80	0.7250000
NODE_2449_length_1456_cov_11.109064	951	1031	6	5	80	0.0625000
NODE_2449_length_1456_cov_11.109064	951	1031	8	3	80	0.0375000
NODE_2449_length_1456_cov_11.109064	951	1031	9	3	80	0.0375000
NODE_2449_length_1456_cov_11.109064	951	1031	10	2	80	0.0250000
NODE_2449_length_1456_cov_11.109064	951	1031	11	4	80	0.0500000
NODE_2449_length_1456_cov_11.109064	951	1031	12	23	80	0.2875000
NODE_2449_length_1456_cov_11.109064	951	1031	13	9	80	0.1125000
NODE_2449_length_1456_cov_11.109064	951	1031	15	22	80	0.2750000
NODE_2449_length_1456_cov_11.109064	951	1031	17	7	80	0.0875000
NODE_2449_length_1456_cov_11.109064	951	1031	18	2	80	0.0250000
NODE_2449_length_1456_cov_11.109064	1004	1084	14	3	80	0.0375000
NODE_2449_length_1456_cov_11.109064	1004	1084	15	21	80	0.2625000
NODE_2449_length_1456_cov_11.109064	1004	1084	16	14	80	0.1750000
NODE_2449_length_1456_cov_11.109064	1004	1084	17	7	80	0.0875000
NODE_2449_length_1456_cov_11.109064	1004	1084	18	22	80	0.2750000
NODE_2449_length_1456_cov_11.109064	1004	1084	19	13	80	0.1625000
NODE_2452_length_1456_cov_3.137067	374	410	0	36	36	1.0000000
NODE_2454_length_1456_cov_1.889462	35	99	0	64	64	1.0000000
NODE_2456_length_1455_cov_60.874631	369	449	2	63	80	0.7875000
NODE_2456_length_1455_cov_60.874631	369	449	4	6	80	0.0750000
NODE_2456_length_1455_cov_60.874631	369	449	5	7	80	0.0875000
NODE_2456_length_1455_cov_60.874631	369	449	7	3	80	0.0375000
NODE_2456_length_1455_cov_60.874631	369	449	8	1	80	0.0125000
NODE_2456_length_1455_cov_60.874631	422	502	2	10	80	0.1250000
NODE_2456_length_1455_cov_60.874631	422	502	4	6	80	0.0750000
NODE_2456_length_1455_cov_60.874631	422	502	5	7	80	0.0875000
NODE_2456_length_1455_cov_60.874631	422	502	6	13	80	0.1625000
NODE_2456_length_1455_cov_60.874631	422	502	7	5	80	0.0625000
NODE_2456_length_1455_cov_60.874631	422	502	8	8	80	0.1000000
NODE_2456_length_1455_cov_60.874631	422	502	9	8	80	0.1000000
NODE_2456_length_1455_cov_60.874631	422	502	11	16	80	0.2000000
NODE_2456_length_1455_cov_60.874631	422	502	12	1	80	0.0125000
NODE_2456_length_1455_cov_60.874631	422	502	14	6	80	0.0750000
NODE_2456_length_1455_cov_60.874631	498	578	14	32	80	0.4000000
NODE_2456_length_1455_cov_60.874631	498	578	16	14	80	0.1750000
NODE_2456_length_1455_cov_60.874631	498	578	17	34	80	0.4250000
NODE_2456_length_1455_cov_60.874631	551	631	5	3	80	0.0375000
NODE_2456_length_1455_cov_60.874631	551	631	6	28	80	0.3500000
NODE_2456_length_1455_cov_60.874631	551	631	7	1	80	0.0125000
NODE_2456_length_1455_cov_60.874631	551	631	8	18	80	0.2250000
NODE_2456_length_1455_cov_60.874631	551	631	17	30	80	0.3750000
NODE_2458_length_1455_cov_35.253687	615	695	18	1	80	0.0125000
NODE_2458_length_1455_cov_35.253687	615	695	19	8	80	0.1000000
NODE_2458_length_1455_cov_35.253687	615	695	20	4	80	0.0500000
NODE_2458_length_1455_cov_35.253687	615	695	21	10	80	0.1250000
NODE_2458_length_1455_cov_35.253687	615	695	22	15	80	0.1875000
NODE_2458_length_1455_cov_35.253687	615	695	23	35	80	0.4375000
NODE_2458_length_1455_cov_35.253687	615	695	24	5	80	0.0625000
NODE_2458_length_1455_cov_35.253687	615	695	25	2	80	0.0250000
NODE_2458_length_1455_cov_35.253687	668	748	16	4	80	0.0500000
NODE_2458_length_1455_cov_35.253687	668	748	18	2	80	0.0250000
NODE_2458_length_1455_cov_35.253687	668	748	19	4	80	0.0500000
NODE_2458_length_1455_cov_35.253687	668	748	21	20	80	0.2500000
NODE_2458_length_1455_cov_35.253687	668	748	22	23	80	0.2875000
NODE_2458_length_1455_cov_35.253687	668	748	23	27	80	0.3375000
NODE_2458_length_1455_cov_35.253687	744	824	7	5	80	0.0625000
NODE_2458_length_1455_cov_35.253687	744	824	9	6	80	0.0750000
NODE_2458_length_1455_cov_35.253687	744	824	11	1	80	0.0125000
NODE_2458_length_1455_cov_35.253687	744	824	12	2	80	0.0250000
NODE_2458_length_1455_cov_35.253687	744	824	13	23	80	0.2875000
NODE_2458_length_1455_cov_35.253687	744	824	14	18	80	0.2250000
NODE_2458_length_1455_cov_35.253687	744	824	15	4	80	0.0500000
NODE_2458_length_1455_cov_35.253687	744	824	16	21	80	0.2625000
NODE_2458_length_1455_cov_35.253687	797	877	5	17	80	0.2125000
NODE_2458_length_1455_cov_35.253687	797	877	6	4	80	0.0500000
NODE_2458_length_1455_cov_35.253687	797	877	7	37	80	0.4625000
NODE_2458_length_1455_cov_35.253687	797	877	9	6	80	0.0750000
NODE_2458_length_1455_cov_35.253687	797	877	11	1	80	0.0125000
NODE_2458_length_1455_cov_35.253687	797	877	12	2	80	0.0250000
NODE_2458_length_1455_cov_35.253687	797	877	13	13	80	0.1625000
NODE_2465_length_1452_cov_7.101256	976	1056	0	80	80	1.0000000
NODE_2465_length_1452_cov_7.101256	1029	1109	0	80	80	1.0000000
NODE_2465_length_1452_cov_7.101256	1105	1185	0	80	80	1.0000000
NODE_2465_length_1452_cov_7.101256	1158	1238	0	80	80	1.0000000
NODE_2470_length_1451_cov_23.880178	439	520	7	2	81	0.0246914
NODE_2470_length_1451_cov_23.880178	439	520	9	12	81	0.1481481
NODE_2470_length_1451_cov_23.880178	439	520	10	36	81	0.4444444
NODE_2470_length_1451_cov_23.880178	439	520	11	10	81	0.1234568
NODE_2470_length_1451_cov_23.880178	439	520	13	21	81	0.2592593
NODE_2470_length_1451_cov_23.880178	493	573	4	9	80	0.1125000
NODE_2470_length_1451_cov_23.880178	493	573	5	14	80	0.1750000
NODE_2470_length_1451_cov_23.880178	493	573	6	29	80	0.3625000
NODE_2470_length_1451_cov_23.880178	493	573	7	3	80	0.0375000
NODE_2470_length_1451_cov_23.880178	493	573	10	25	80	0.3125000
NODE_2471_length_1451_cov_16.249260	422	502	4	4	80	0.0500000
NODE_2471_length_1451_cov_16.249260	422	502	6	3	80	0.0375000
NODE_2471_length_1451_cov_16.249260	422	502	7	13	80	0.1625000
NODE_2471_length_1451_cov_16.249260	422	502	8	23	80	0.2875000
NODE_2471_length_1451_cov_16.249260	422	502	9	15	80	0.1875000
NODE_2471_length_1451_cov_16.249260	422	502	10	22	80	0.2750000
NODE_2471_length_1451_cov_16.249260	475	555	9	5	80	0.0625000
NODE_2471_length_1451_cov_16.249260	475	555	10	75	80	0.9375000
NODE_2472_length_1451_cov_8.663462	908	988	8	8	80	0.1000000
NODE_2472_length_1451_cov_8.663462	908	988	11	58	80	0.7250000
NODE_2472_length_1451_cov_8.663462	908	988	12	10	80	0.1250000
NODE_2472_length_1451_cov_8.663462	908	988	13	4	80	0.0500000
NODE_2472_length_1451_cov_8.663462	961	1040	8	22	79	0.2784810
NODE_2472_length_1451_cov_8.663462	961	1040	9	11	79	0.1392405
NODE_2472_length_1451_cov_8.663462	961	1040	10	5	79	0.0632911
NODE_2472_length_1451_cov_8.663462	961	1040	11	30	79	0.3797468
NODE_2472_length_1451_cov_8.663462	961	1040	12	10	79	0.1265823
NODE_2472_length_1451_cov_8.663462	961	1040	13	1	79	0.0126582
NODE_2474_length_1451_cov_5.219675	897	977	0	80	80	1.0000000
NODE_2474_length_1451_cov_5.219675	950	1030	0	80	80	1.0000000
NODE_2477_length_1450_cov_20.371577	611	691	4	3	80	0.0375000
NODE_2477_length_1450_cov_20.371577	611	691	6	33	80	0.4125000
NODE_2477_length_1450_cov_20.371577	611	691	7	3	80	0.0375000
NODE_2477_length_1450_cov_20.371577	611	691	8	4	80	0.0500000
NODE_2477_length_1450_cov_20.371577	611	691	9	34	80	0.4250000
NODE_2477_length_1450_cov_20.371577	611	691	10	3	80	0.0375000
NODE_2477_length_1450_cov_20.371577	664	744	4	14	80	0.1750000
NODE_2477_length_1450_cov_20.371577	664	744	6	10	80	0.1250000
NODE_2477_length_1450_cov_20.371577	664	744	9	24	80	0.3000000
NODE_2477_length_1450_cov_20.371577	664	744	10	32	80	0.4000000
NODE_2482_length_1449_cov_24.665926	432	512	4	10	80	0.1250000
NODE_2482_length_1449_cov_24.665926	432	512	5	7	80	0.0875000
NODE_2482_length_1449_cov_24.665926	432	512	6	16	80	0.2000000
NODE_2482_length_1449_cov_24.665926	432	512	7	47	80	0.5875000
NODE_2482_length_1449_cov_24.665926	485	565	2	22	80	0.2750000
NODE_2482_length_1449_cov_24.665926	485	565	3	22	80	0.2750000
NODE_2482_length_1449_cov_24.665926	485	565	4	19	80	0.2375000
NODE_2482_length_1449_cov_24.665926	485	565	5	7	80	0.0875000
NODE_2482_length_1449_cov_24.665926	485	565	7	10	80	0.1250000
NODE_2482_length_1449_cov_24.665926	561	643	2	4	82	0.0487805
NODE_2482_length_1449_cov_24.665926	561	643	3	78	82	0.9512195
NODE_2482_length_1449_cov_24.665926	616	696	3	80	80	1.0000000
NODE_2485_length_1448_cov_20.587102	904	984	9	6	80	0.0750000
NODE_2485_length_1448_cov_20.587102	904	984	10	2	80	0.0250000
NODE_2485_length_1448_cov_20.587102	904	984	11	26	80	0.3250000
NODE_2485_length_1448_cov_20.587102	904	984	12	5	80	0.0625000
NODE_2485_length_1448_cov_20.587102	904	984	13	29	80	0.3625000
NODE_2485_length_1448_cov_20.587102	904	984	14	6	80	0.0750000
NODE_2485_length_1448_cov_20.587102	904	984	15	6	80	0.0750000
NODE_2485_length_1448_cov_20.587102	957	1037	8	42	80	0.5250000
NODE_2485_length_1448_cov_20.587102	957	1037	9	14	80	0.1750000
NODE_2485_length_1448_cov_20.587102	957	1037	11	24	80	0.3000000
NODE_2487_length_1448_cov_8.693847	537	617	2	16	80	0.2000000
NODE_2487_length_1448_cov_8.693847	537	617	3	27	80	0.3375000
NODE_2487_length_1448_cov_8.693847	537	617	4	37	80	0.4625000
NODE_2487_length_1448_cov_8.693847	590	670	3	6	80	0.0750000
NODE_2487_length_1448_cov_8.693847	590	670	4	74	80	0.9250000
NODE_2488_length_1447_cov_21.391691	519	599	0	49	80	0.6125000
NODE_2488_length_1447_cov_21.391691	519	599	1	31	80	0.3875000
NODE_2488_length_1447_cov_21.391691	572	652	1	27	80	0.3375000
NODE_2488_length_1447_cov_21.391691	572	652	2	28	80	0.3500000
NODE_2488_length_1447_cov_21.391691	572	652	3	17	80	0.2125000
NODE_2488_length_1447_cov_21.391691	572	652	5	8	80	0.1000000
NODE_2488_length_1447_cov_21.391691	648	728	5	9	80	0.1125000
NODE_2488_length_1447_cov_21.391691	648	728	7	12	80	0.1500000
NODE_2488_length_1447_cov_21.391691	648	728	11	13	80	0.1625000
NODE_2488_length_1447_cov_21.391691	648	728	15	10	80	0.1250000
NODE_2488_length_1447_cov_21.391691	648	728	16	6	80	0.0750000
NODE_2488_length_1447_cov_21.391691	648	728	17	30	80	0.3750000
NODE_2488_length_1447_cov_21.391691	701	781	15	12	80	0.1500000
NODE_2488_length_1447_cov_21.391691	701	781	16	6	80	0.0750000
NODE_2488_length_1447_cov_21.391691	701	781	17	17	80	0.2125000
NODE_2488_length_1447_cov_21.391691	701	781	19	5	80	0.0625000
NODE_2488_length_1447_cov_21.391691	701	781	20	2	80	0.0250000
NODE_2488_length_1447_cov_21.391691	701	781	21	8	80	0.1000000
NODE_2488_length_1447_cov_21.391691	701	781	22	4	80	0.0500000
NODE_2488_length_1447_cov_21.391691	701	781	23	26	80	0.3250000
NODE_2491_length_1447_cov_2.262611	1268	1325	1	26	57	0.4561403
NODE_2491_length_1447_cov_2.262611	1268	1325	2	31	57	0.5438597
NODE_2491_length_1447_cov_2.262611	1321	1378	2	57	57	1.0000000
NODE_2494_length_1445_cov_22.052006	759	839	24	7	80	0.0875000
NODE_2494_length_1445_cov_22.052006	759	839	26	3	80	0.0375000
NODE_2494_length_1445_cov_22.052006	759	839	27	24	80	0.3000000
NODE_2494_length_1445_cov_22.052006	759	839	28	7	80	0.0875000
NODE_2494_length_1445_cov_22.052006	759	839	29	12	80	0.1500000
NODE_2494_length_1445_cov_22.052006	759	839	30	5	80	0.0625000
NODE_2494_length_1445_cov_22.052006	759	839	31	6	80	0.0750000
NODE_2494_length_1445_cov_22.052006	759	839	32	11	80	0.1375000
NODE_2494_length_1445_cov_22.052006	759	839	33	2	80	0.0250000
NODE_2494_length_1445_cov_22.052006	759	839	34	3	80	0.0375000
NODE_2494_length_1445_cov_22.052006	812	892	16	6	80	0.0750000
NODE_2494_length_1445_cov_22.052006	812	892	17	19	80	0.2375000
NODE_2494_length_1445_cov_22.052006	812	892	18	10	80	0.1250000
NODE_2494_length_1445_cov_22.052006	812	892	20	4	80	0.0500000
NODE_2494_length_1445_cov_22.052006	812	892	24	17	80	0.2125000
NODE_2494_length_1445_cov_22.052006	812	892	25	4	80	0.0500000
NODE_2494_length_1445_cov_22.052006	812	892	27	13	80	0.1625000
NODE_2494_length_1445_cov_22.052006	812	892	28	7	80	0.0875000
NODE_2494_length_1445_cov_22.052006	888	968	4	2	80	0.0250000
NODE_2494_length_1445_cov_22.052006	888	968	5	15	80	0.1875000
NODE_2494_length_1445_cov_22.052006	888	968	6	14	80	0.1750000
NODE_2494_length_1445_cov_22.052006	888	968	9	17	80	0.2125000
NODE_2494_length_1445_cov_22.052006	888	968	13	2	80	0.0250000
NODE_2494_length_1445_cov_22.052006	888	968	14	5	80	0.0625000
NODE_2494_length_1445_cov_22.052006	888	968	17	25	80	0.3125000
NODE_2494_length_1445_cov_22.052006	941	1021	2	1	80	0.0125000
NODE_2494_length_1445_cov_22.052006	941	1021	3	23	80	0.2875000
NODE_2494_length_1445_cov_22.052006	941	1021	4	31	80	0.3875000
NODE_2494_length_1445_cov_22.052006	941	1021	5	15	80	0.1875000
NODE_2494_length_1445_cov_22.052006	941	1021	6	10	80	0.1250000
NODE_2495_length_1445_cov_13.378900	584	664	5	29	80	0.3625000
NODE_2495_length_1445_cov_13.378900	584	664	7	1	80	0.0125000
NODE_2495_length_1445_cov_13.378900	584	664	8	31	80	0.3875000
NODE_2495_length_1445_cov_13.378900	584	664	9	19	80	0.2375000
NODE_2495_length_1445_cov_13.378900	637	717	8	15	80	0.1875000
NODE_2495_length_1445_cov_13.378900	637	717	9	52	80	0.6500000
NODE_2495_length_1445_cov_13.378900	637	717	10	13	80	0.1625000
NODE_2501_length_1443_cov_7.628720	480	560	0	80	80	1.0000000
NODE_2501_length_1443_cov_7.628720	533	613	0	80	80	1.0000000
NODE_2501_length_1443_cov_7.628720	609	689	0	12	80	0.1500000
NODE_2501_length_1443_cov_7.628720	609	689	1	68	80	0.8500000
NODE_2501_length_1443_cov_7.628720	662	742	1	27	80	0.3375000
NODE_2501_length_1443_cov_7.628720	662	742	2	53	80	0.6625000
NODE_2502_length_1443_cov_4.843006	924	1004	3	17	80	0.2125000
NODE_2502_length_1443_cov_4.843006	924	1004	4	63	80	0.7875000
NODE_2502_length_1443_cov_4.843006	977	1057	2	14	80	0.1750000
NODE_2502_length_1443_cov_4.843006	977	1057	3	17	80	0.2125000
NODE_2502_length_1443_cov_4.843006	977	1057	4	49	80	0.6125000
NODE_2508_length_1442_cov_24.551750	427	507	2	30	80	0.3750000
NODE_2508_length_1442_cov_24.551750	427	507	3	1	80	0.0125000
NODE_2508_length_1442_cov_24.551750	427	507	4	28	80	0.3500000
NODE_2508_length_1442_cov_24.551750	427	507	5	15	80	0.1875000
NODE_2508_length_1442_cov_24.551750	427	507	7	6	80	0.0750000
NODE_2508_length_1442_cov_24.551750	480	560	4	6	80	0.0750000
NODE_2508_length_1442_cov_24.551750	480	560	5	15	80	0.1875000
NODE_2508_length_1442_cov_24.551750	480	560	7	29	80	0.3625000
NODE_2508_length_1442_cov_24.551750	480	560	8	12	80	0.1500000
NODE_2508_length_1442_cov_24.551750	480	560	9	12	80	0.1500000
NODE_2508_length_1442_cov_24.551750	480	560	10	6	80	0.0750000
NODE_2508_length_1442_cov_24.551750	556	636	10	19	80	0.2375000
NODE_2508_length_1442_cov_24.551750	556	636	11	6	80	0.0750000
NODE_2508_length_1442_cov_24.551750	556	636	12	4	80	0.0500000
NODE_2508_length_1442_cov_24.551750	556	636	13	5	80	0.0625000
NODE_2508_length_1442_cov_24.551750	556	636	14	1	80	0.0125000
NODE_2508_length_1442_cov_24.551750	556	636	16	6	80	0.0750000
NODE_2508_length_1442_cov_24.551750	556	636	17	21	80	0.2625000
NODE_2508_length_1442_cov_24.551750	556	636	18	8	80	0.1000000
NODE_2508_length_1442_cov_24.551750	556	636	19	5	80	0.0625000
NODE_2508_length_1442_cov_24.551750	556	636	20	5	80	0.0625000
NODE_2508_length_1442_cov_24.551750	609	689	17	13	80	0.1625000
NODE_2508_length_1442_cov_24.551750	609	689	18	22	80	0.2750000
NODE_2508_length_1442_cov_24.551750	609	689	19	5	80	0.0625000
NODE_2508_length_1442_cov_24.551750	609	689	20	6	80	0.0750000
NODE_2508_length_1442_cov_24.551750	609	689	21	17	80	0.2125000
NODE_2508_length_1442_cov_24.551750	609	689	22	17	80	0.2125000
NODE_2509_length_1442_cov_24.032762	424	504	6	8	80	0.1000000
NODE_2509_length_1442_cov_24.032762	424	504	8	72	80	0.9000000
NODE_2509_length_1442_cov_24.032762	477	557	7	2	80	0.0250000
NODE_2509_length_1442_cov_24.032762	477	557	8	69	80	0.8625000
NODE_2509_length_1442_cov_24.032762	477	557	9	9	80	0.1125000
NODE_2511_length_1441_cov_16.528316	963	1043	13	3	80	0.0375000
NODE_2511_length_1441_cov_16.528316	963	1043	14	14	80	0.1750000
NODE_2511_length_1441_cov_16.528316	963	1043	15	4	80	0.0500000
NODE_2511_length_1441_cov_16.528316	963	1043	17	8	80	0.1000000
NODE_2511_length_1441_cov_16.528316	963	1043	18	3	80	0.0375000
NODE_2511_length_1441_cov_16.528316	963	1043	20	6	80	0.0750000
NODE_2511_length_1441_cov_16.528316	963	1043	21	12	80	0.1500000
NODE_2511_length_1441_cov_16.528316	963	1043	22	5	80	0.0625000
NODE_2511_length_1441_cov_16.528316	963	1043	24	11	80	0.1375000
NODE_2511_length_1441_cov_16.528316	963	1043	25	2	80	0.0250000
NODE_2511_length_1441_cov_16.528316	963	1043	26	10	80	0.1250000
NODE_2511_length_1441_cov_16.528316	963	1043	27	2	80	0.0250000
NODE_2511_length_1441_cov_16.528316	1016	1096	22	2	80	0.0250000
NODE_2511_length_1441_cov_16.528316	1016	1096	24	17	80	0.2125000
NODE_2511_length_1441_cov_16.528316	1016	1096	25	2	80	0.0250000
NODE_2511_length_1441_cov_16.528316	1016	1096	26	28	80	0.3500000
NODE_2511_length_1441_cov_16.528316	1016	1096	27	9	80	0.1125000
NODE_2511_length_1441_cov_16.528316	1016	1096	28	12	80	0.1500000
NODE_2511_length_1441_cov_16.528316	1016	1096	29	10	80	0.1250000
NODE_2512_length_1441_cov_3.781669	80	156	4	10	76	0.1315790
NODE_2512_length_1441_cov_3.781669	80	156	5	66	76	0.8684211
NODE_2512_length_1441_cov_3.781669	129	209	0	7	80	0.0875000
NODE_2512_length_1441_cov_3.781669	129	209	1	24	80	0.3000000
NODE_2512_length_1441_cov_3.781669	129	209	3	2	80	0.0250000
NODE_2512_length_1441_cov_3.781669	129	209	4	30	80	0.3750000
NODE_2512_length_1441_cov_3.781669	129	209	5	17	80	0.2125000
NODE_2515_length_1440_cov_34.523490	446	526	2	4	80	0.0500000
NODE_2515_length_1440_cov_34.523490	446	526	4	11	80	0.1375000
NODE_2515_length_1440_cov_34.523490	446	526	5	14	80	0.1750000
NODE_2515_length_1440_cov_34.523490	446	526	6	10	80	0.1250000
NODE_2515_length_1440_cov_34.523490	446	526	7	5	80	0.0625000
NODE_2515_length_1440_cov_34.523490	446	526	8	6	80	0.0750000
NODE_2515_length_1440_cov_34.523490	446	526	9	28	80	0.3500000
NODE_2515_length_1440_cov_34.523490	446	526	12	2	80	0.0250000
NODE_2515_length_1440_cov_34.523490	499	576	9	25	77	0.3246753
NODE_2515_length_1440_cov_34.523490	499	576	12	5	77	0.0649351
NODE_2515_length_1440_cov_34.523490	499	576	14	19	77	0.2467532
NODE_2515_length_1440_cov_34.523490	499	576	17	5	77	0.0649351
NODE_2515_length_1440_cov_34.523490	499	576	19	23	77	0.2987013
NODE_2515_length_1440_cov_34.523490	576	654	16	1	78	0.0128205
NODE_2515_length_1440_cov_34.523490	576	654	17	13	78	0.1666667
NODE_2515_length_1440_cov_34.523490	576	654	18	24	78	0.3076923
NODE_2515_length_1440_cov_34.523490	576	654	19	27	78	0.3461539
NODE_2515_length_1440_cov_34.523490	576	654	20	2	78	0.0256410
NODE_2515_length_1440_cov_34.523490	576	654	21	8	78	0.1025641
NODE_2515_length_1440_cov_34.523490	576	654	22	3	78	0.0384615
NODE_2515_length_1440_cov_34.523490	627	707	14	3	80	0.0375000
NODE_2515_length_1440_cov_34.523490	627	707	16	6	80	0.0750000
NODE_2515_length_1440_cov_34.523490	627	707	17	16	80	0.2000000
NODE_2515_length_1440_cov_34.523490	627	707	18	12	80	0.1500000
NODE_2515_length_1440_cov_34.523490	627	707	19	10	80	0.1250000
NODE_2515_length_1440_cov_34.523490	627	707	20	2	80	0.0250000
NODE_2515_length_1440_cov_34.523490	627	707	21	28	80	0.3500000
NODE_2515_length_1440_cov_34.523490	627	707	22	3	80	0.0375000
NODE_2516_length_1440_cov_20.372110	776	856	10	7	80	0.0875000
NODE_2516_length_1440_cov_20.372110	776	856	11	2	80	0.0250000
NODE_2516_length_1440_cov_20.372110	776	856	12	5	80	0.0625000
NODE_2516_length_1440_cov_20.372110	776	856	13	13	80	0.1625000
NODE_2516_length_1440_cov_20.372110	776	856	14	34	80	0.4250000
NODE_2516_length_1440_cov_20.372110	776	856	15	19	80	0.2375000
NODE_2516_length_1440_cov_20.372110	829	909	7	7	80	0.0875000
NODE_2516_length_1440_cov_20.372110	829	909	10	3	80	0.0375000
NODE_2516_length_1440_cov_20.372110	829	909	11	4	80	0.0500000
NODE_2516_length_1440_cov_20.372110	829	909	12	2	80	0.0250000
NODE_2516_length_1440_cov_20.372110	829	909	13	19	80	0.2375000
NODE_2516_length_1440_cov_20.372110	829	909	14	13	80	0.1625000
NODE_2516_length_1440_cov_20.372110	829	909	15	31	80	0.3875000
NODE_2516_length_1440_cov_20.372110	829	909	16	1	80	0.0125000
NODE_2516_length_1440_cov_20.372110	905	985	3	33	80	0.4125000
NODE_2516_length_1440_cov_20.372110	905	985	4	13	80	0.1625000
NODE_2516_length_1440_cov_20.372110	905	985	5	5	80	0.0625000
NODE_2516_length_1440_cov_20.372110	905	985	6	2	80	0.0250000
NODE_2516_length_1440_cov_20.372110	905	985	7	27	80	0.3375000
NODE_2516_length_1440_cov_20.372110	958	1038	0	20	80	0.2500000
NODE_2516_length_1440_cov_20.372110	958	1038	1	8	80	0.1000000
NODE_2516_length_1440_cov_20.372110	958	1038	2	23	80	0.2875000
NODE_2516_length_1440_cov_20.372110	958	1038	3	29	80	0.3625000
NODE_2517_length_1440_cov_14.476510	586	615	0	29	29	1.0000000
NODE_2517_length_1440_cov_14.476510	666	695	0	29	29	1.0000000
NODE_2517_length_1440_cov_14.476510	1295	1359	23	25	64	0.3906250
NODE_2517_length_1440_cov_14.476510	1295	1359	24	39	64	0.6093750
NODE_2518_length_1440_cov_9.049217	384	464	2	5	80	0.0625000
NODE_2518_length_1440_cov_9.049217	384	464	3	38	80	0.4750000
NODE_2518_length_1440_cov_9.049217	384	464	4	19	80	0.2375000
NODE_2518_length_1440_cov_9.049217	384	464	5	18	80	0.2250000
NODE_2518_length_1440_cov_9.049217	437	517	2	23	80	0.2875000
NODE_2518_length_1440_cov_9.049217	437	517	3	57	80	0.7125000
NODE_2520_length_1439_cov_11.784328	898	978	5	1	80	0.0125000
NODE_2520_length_1439_cov_11.784328	898	978	7	3	80	0.0375000
NODE_2520_length_1439_cov_11.784328	898	978	8	2	80	0.0250000
NODE_2520_length_1439_cov_11.784328	898	978	9	54	80	0.6750000
NODE_2520_length_1439_cov_11.784328	898	978	11	20	80	0.2500000
NODE_2520_length_1439_cov_11.784328	951	1031	8	4	80	0.0500000
NODE_2520_length_1439_cov_11.784328	951	1031	9	7	80	0.0875000
NODE_2520_length_1439_cov_11.784328	951	1031	10	4	80	0.0500000
NODE_2520_length_1439_cov_11.784328	951	1031	11	65	80	0.8125000
NODE_2525_length_1438_cov_41.481703	671	751	7	8	80	0.1000000
NODE_2525_length_1438_cov_41.481703	671	751	8	20	80	0.2500000
NODE_2525_length_1438_cov_41.481703	671	751	9	22	80	0.2750000
NODE_2525_length_1438_cov_41.481703	671	751	10	17	80	0.2125000
NODE_2525_length_1438_cov_41.481703	671	751	11	13	80	0.1625000
NODE_2525_length_1438_cov_41.481703	724	804	9	1	80	0.0125000
NODE_2525_length_1438_cov_41.481703	724	804	10	31	80	0.3875000
NODE_2525_length_1438_cov_41.481703	724	804	11	46	80	0.5750000
NODE_2525_length_1438_cov_41.481703	724	804	12	2	80	0.0250000
NODE_2529_length_1437_cov_14.449178	815	895	3	69	80	0.8625000
NODE_2529_length_1437_cov_14.449178	815	895	5	11	80	0.1375000
NODE_2529_length_1437_cov_14.449178	868	948	2	51	80	0.6375000
NODE_2529_length_1437_cov_14.449178	868	948	3	16	80	0.2000000
NODE_2529_length_1437_cov_14.449178	868	948	5	13	80	0.1625000
NODE_2529_length_1437_cov_14.449178	944	1024	2	21	80	0.2625000
NODE_2529_length_1437_cov_14.449178	944	1024	4	2	80	0.0250000
NODE_2529_length_1437_cov_14.449178	944	1024	6	57	80	0.7125000
NODE_2529_length_1437_cov_14.449178	997	1077	4	43	80	0.5375000
NODE_2529_length_1437_cov_14.449178	997	1077	6	37	80	0.4625000
NODE_2532_length_1436_cov_96.256545	1145	1225	11	11	80	0.1375000
NODE_2532_length_1436_cov_96.256545	1145	1225	12	3	80	0.0375000
NODE_2532_length_1436_cov_96.256545	1145	1225	13	25	80	0.3125000
NODE_2532_length_1436_cov_96.256545	1145	1225	14	5	80	0.0625000
NODE_2532_length_1436_cov_96.256545	1145	1225	15	29	80	0.3625000
NODE_2532_length_1436_cov_96.256545	1145	1225	17	7	80	0.0875000
NODE_2532_length_1436_cov_96.256545	1198	1278	13	10	80	0.1250000
NODE_2532_length_1436_cov_96.256545	1198	1278	14	2	80	0.0250000
NODE_2532_length_1436_cov_96.256545	1198	1278	15	22	80	0.2750000
NODE_2532_length_1436_cov_96.256545	1198	1278	16	22	80	0.2750000
NODE_2532_length_1436_cov_96.256545	1198	1278	17	24	80	0.3000000
NODE_2532_length_1436_cov_96.256545	1274	1354	12	15	80	0.1875000
NODE_2532_length_1436_cov_96.256545	1274	1354	13	5	80	0.0625000
NODE_2532_length_1436_cov_96.256545	1274	1354	14	14	80	0.1750000
NODE_2532_length_1436_cov_96.256545	1274	1354	15	26	80	0.3250000
NODE_2532_length_1436_cov_96.256545	1274	1354	16	5	80	0.0625000
NODE_2532_length_1436_cov_96.256545	1274	1354	17	15	80	0.1875000
NODE_2532_length_1436_cov_96.256545	1327	1407	5	7	80	0.0875000
NODE_2532_length_1436_cov_96.256545	1327	1407	7	2	80	0.0250000
NODE_2532_length_1436_cov_96.256545	1327	1407	9	2	80	0.0250000
NODE_2532_length_1436_cov_96.256545	1327	1407	10	28	80	0.3500000
NODE_2532_length_1436_cov_96.256545	1327	1407	12	29	80	0.3625000
NODE_2532_length_1436_cov_96.256545	1327	1407	13	5	80	0.0625000
NODE_2532_length_1436_cov_96.256545	1327	1407	14	7	80	0.0875000
NODE_2536_length_1435_cov_21.468563	783	863	1	18	80	0.2250000
NODE_2536_length_1435_cov_21.468563	783	863	2	49	80	0.6125000
NODE_2536_length_1435_cov_21.468563	783	863	3	2	80	0.0250000
NODE_2536_length_1435_cov_21.468563	783	863	4	11	80	0.1375000
NODE_2536_length_1435_cov_21.468563	836	916	1	1	80	0.0125000
NODE_2536_length_1435_cov_21.468563	836	916	2	13	80	0.1625000
NODE_2536_length_1435_cov_21.468563	836	916	3	2	80	0.0250000
NODE_2536_length_1435_cov_21.468563	836	916	4	23	80	0.2875000
NODE_2536_length_1435_cov_21.468563	836	916	6	4	80	0.0500000
NODE_2536_length_1435_cov_21.468563	836	916	7	13	80	0.1625000
NODE_2536_length_1435_cov_21.468563	836	916	8	24	80	0.3000000
NODE_2536_length_1435_cov_21.468563	912	992	7	5	80	0.0625000
NODE_2536_length_1435_cov_21.468563	912	992	8	75	80	0.9375000
NODE_2536_length_1435_cov_21.468563	965	1045	1	3	80	0.0375000
NODE_2536_length_1435_cov_21.468563	965	1045	3	16	80	0.2000000
NODE_2536_length_1435_cov_21.468563	965	1045	4	1	80	0.0125000
NODE_2536_length_1435_cov_21.468563	965	1045	6	23	80	0.2875000
NODE_2536_length_1435_cov_21.468563	965	1045	7	9	80	0.1125000
NODE_2536_length_1435_cov_21.468563	965	1045	8	28	80	0.3500000
NODE_2537_length_1435_cov_18.593563	1123	1203	2	57	80	0.7125000
NODE_2537_length_1435_cov_18.593563	1123	1203	3	2	80	0.0250000
NODE_2537_length_1435_cov_18.593563	1123	1203	4	21	80	0.2625000
NODE_2537_length_1435_cov_18.593563	1176	1256	2	34	80	0.4250000
NODE_2537_length_1435_cov_18.593563	1176	1256	3	24	80	0.3000000
NODE_2537_length_1435_cov_18.593563	1176	1256	4	22	80	0.2750000
NODE_2538_length_1435_cov_5.828593	299	379	2	18	80	0.2250000
NODE_2538_length_1435_cov_5.828593	299	379	3	42	80	0.5250000
NODE_2538_length_1435_cov_5.828593	299	379	4	20	80	0.2500000
NODE_2538_length_1435_cov_5.828593	352	432	1	52	80	0.6500000
NODE_2538_length_1435_cov_5.828593	352	432	2	19	80	0.2375000
NODE_2538_length_1435_cov_5.828593	352	432	3	9	80	0.1125000
NODE_2540_length_1434_cov_17.610487	1023	1103	13	7	80	0.0875000
NODE_2540_length_1434_cov_17.610487	1023	1103	14	20	80	0.2500000
NODE_2540_length_1434_cov_17.610487	1023	1103	16	3	80	0.0375000
NODE_2540_length_1434_cov_17.610487	1023	1103	17	11	80	0.1375000
NODE_2540_length_1434_cov_17.610487	1023	1103	18	6	80	0.0750000
NODE_2540_length_1434_cov_17.610487	1023	1103	19	19	80	0.2375000
NODE_2540_length_1434_cov_17.610487	1023	1103	20	14	80	0.1750000
NODE_2540_length_1434_cov_17.610487	1076	1156	13	2	80	0.0250000
NODE_2540_length_1434_cov_17.610487	1076	1156	14	6	80	0.0750000
NODE_2540_length_1434_cov_17.610487	1076	1156	17	5	80	0.0625000
NODE_2540_length_1434_cov_17.610487	1076	1156	18	2	80	0.0250000
NODE_2540_length_1434_cov_17.610487	1076	1156	19	13	80	0.1625000
NODE_2540_length_1434_cov_17.610487	1076	1156	20	30	80	0.3750000
NODE_2540_length_1434_cov_17.610487	1076	1156	21	16	80	0.2000000
NODE_2540_length_1434_cov_17.610487	1076	1156	22	4	80	0.0500000
NODE_2540_length_1434_cov_17.610487	1076	1156	23	2	80	0.0250000
NODE_2540_length_1434_cov_17.610487	1152	1232	14	17	80	0.2125000
NODE_2540_length_1434_cov_17.610487	1152	1232	15	26	80	0.3250000
NODE_2540_length_1434_cov_17.610487	1152	1232	16	16	80	0.2000000
NODE_2540_length_1434_cov_17.610487	1152	1232	17	6	80	0.0750000
NODE_2540_length_1434_cov_17.610487	1152	1232	18	14	80	0.1750000
NODE_2540_length_1434_cov_17.610487	1152	1232	19	1	80	0.0125000
NODE_2540_length_1434_cov_17.610487	1205	1285	11	23	80	0.2875000
NODE_2540_length_1434_cov_17.610487	1205	1285	12	4	80	0.0500000
NODE_2540_length_1434_cov_17.610487	1205	1285	13	5	80	0.0625000
NODE_2540_length_1434_cov_17.610487	1205	1285	14	8	80	0.1000000
NODE_2540_length_1434_cov_17.610487	1205	1285	15	7	80	0.0875000
NODE_2540_length_1434_cov_17.610487	1205	1285	16	18	80	0.2250000
NODE_2540_length_1434_cov_17.610487	1205	1285	17	6	80	0.0750000
NODE_2540_length_1434_cov_17.610487	1205	1285	18	9	80	0.1125000
NODE_2541_length_1434_cov_9.845693	846	926	0	80	80	1.0000000
NODE_2541_length_1434_cov_9.845693	899	978	0	79	79	1.0000000
NODE_2544_length_1433_cov_36.452774	538	618	2	16	80	0.2000000
NODE_2544_length_1433_cov_36.452774	538	618	5	27	80	0.3375000
NODE_2544_length_1433_cov_36.452774	538	618	6	6	80	0.0750000
NODE_2544_length_1433_cov_36.452774	538	618	8	24	80	0.3000000
NODE_2544_length_1433_cov_36.452774	538	618	11	7	80	0.0875000
NODE_2544_length_1433_cov_36.452774	591	671	8	20	80	0.2500000
NODE_2544_length_1433_cov_36.452774	591	671	11	12	80	0.1500000
NODE_2544_length_1433_cov_36.452774	591	671	13	4	80	0.0500000
NODE_2544_length_1433_cov_36.452774	591	671	14	5	80	0.0625000
NODE_2544_length_1433_cov_36.452774	591	671	17	20	80	0.2500000
NODE_2544_length_1433_cov_36.452774	591	671	19	1	80	0.0125000
NODE_2544_length_1433_cov_36.452774	591	671	20	2	80	0.0250000
NODE_2544_length_1433_cov_36.452774	591	671	21	6	80	0.0750000
NODE_2544_length_1433_cov_36.452774	591	671	22	10	80	0.1250000
NODE_2544_length_1433_cov_36.452774	667	747	20	8	80	0.1000000
NODE_2544_length_1433_cov_36.452774	667	747	21	22	80	0.2750000
NODE_2544_length_1433_cov_36.452774	667	747	22	33	80	0.4125000
NODE_2544_length_1433_cov_36.452774	667	747	23	1	80	0.0125000
NODE_2544_length_1433_cov_36.452774	667	747	24	4	80	0.0500000
NODE_2544_length_1433_cov_36.452774	667	747	25	10	80	0.1250000
NODE_2544_length_1433_cov_36.452774	667	747	27	2	80	0.0250000
NODE_2544_length_1433_cov_36.452774	720	800	19	18	80	0.2250000
NODE_2544_length_1433_cov_36.452774	720	800	21	6	80	0.0750000
NODE_2544_length_1433_cov_36.452774	720	800	22	20	80	0.2500000
NODE_2544_length_1433_cov_36.452774	720	800	23	4	80	0.0500000
NODE_2544_length_1433_cov_36.452774	720	800	24	4	80	0.0500000
NODE_2544_length_1433_cov_36.452774	720	800	25	12	80	0.1500000
NODE_2544_length_1433_cov_36.452774	720	800	27	11	80	0.1375000
NODE_2544_length_1433_cov_36.452774	720	800	28	5	80	0.0625000
NODE_2550_length_1431_cov_7.409159	513	593	0	30	80	0.3750000
NODE_2550_length_1431_cov_7.409159	513	593	2	50	80	0.6250000
NODE_2550_length_1431_cov_7.409159	566	646	2	80	80	1.0000000
NODE_2551_length_1431_cov_6.721471	1074	1154	1	6	80	0.0750000
NODE_2551_length_1431_cov_6.721471	1074	1154	2	17	80	0.2125000
NODE_2551_length_1431_cov_6.721471	1074	1154	3	1	80	0.0125000
NODE_2551_length_1431_cov_6.721471	1074	1154	4	56	80	0.7000000
NODE_2551_length_1431_cov_6.721471	1127	1207	3	4	80	0.0500000
NODE_2551_length_1431_cov_6.721471	1127	1207	4	76	80	0.9500000
NODE_2552_length_1430_cov_32.643877	753	833	18	26	80	0.3250000
NODE_2552_length_1430_cov_32.643877	753	833	21	5	80	0.0625000
NODE_2552_length_1430_cov_32.643877	753	833	22	18	80	0.2250000
NODE_2552_length_1430_cov_32.643877	753	833	23	2	80	0.0250000
NODE_2552_length_1430_cov_32.643877	753	833	26	7	80	0.0875000
NODE_2552_length_1430_cov_32.643877	753	833	27	1	80	0.0125000
NODE_2552_length_1430_cov_32.643877	753	833	28	9	80	0.1125000
NODE_2552_length_1430_cov_32.643877	753	833	30	12	80	0.1500000
NODE_2552_length_1430_cov_32.643877	806	886	20	2	80	0.0250000
NODE_2552_length_1430_cov_32.643877	806	886	21	1	80	0.0125000
NODE_2552_length_1430_cov_32.643877	806	886	22	23	80	0.2875000
NODE_2552_length_1430_cov_32.643877	806	886	23	8	80	0.1000000
NODE_2552_length_1430_cov_32.643877	806	886	24	1	80	0.0125000
NODE_2552_length_1430_cov_32.643877	806	886	25	16	80	0.2000000
NODE_2552_length_1430_cov_32.643877	806	886	26	15	80	0.1875000
NODE_2552_length_1430_cov_32.643877	806	886	27	6	80	0.0750000
NODE_2552_length_1430_cov_32.643877	806	886	28	8	80	0.1000000
NODE_2552_length_1430_cov_32.643877	882	962	9	18	80	0.2250000
NODE_2552_length_1430_cov_32.643877	882	962	10	3	80	0.0375000
NODE_2552_length_1430_cov_32.643877	882	962	13	6	80	0.0750000
NODE_2552_length_1430_cov_32.643877	882	962	18	6	80	0.0750000
NODE_2552_length_1430_cov_32.643877	882	962	21	28	80	0.3500000
NODE_2552_length_1430_cov_32.643877	882	962	22	19	80	0.2375000
NODE_2552_length_1430_cov_32.643877	935	1016	4	4	81	0.0493827
NODE_2552_length_1430_cov_32.643877	935	1016	6	13	81	0.1604938
NODE_2552_length_1430_cov_32.643877	935	1016	7	10	81	0.1234568
NODE_2552_length_1430_cov_32.643877	935	1016	9	35	81	0.4320988
NODE_2552_length_1430_cov_32.643877	935	1016	10	13	81	0.1604938
NODE_2552_length_1430_cov_32.643877	935	1016	13	6	81	0.0740741
NODE_2557_length_1428_cov_5.895410	340	416	6	6	76	0.0789474
NODE_2557_length_1428_cov_5.895410	340	416	8	48	76	0.6315789
NODE_2557_length_1428_cov_5.895410	340	416	10	22	76	0.2894737
NODE_2557_length_1428_cov_5.895410	393	476	5	3	83	0.0361446
NODE_2557_length_1428_cov_5.895410	393	476	6	22	83	0.2650602
NODE_2557_length_1428_cov_5.895410	393	476	8	3	83	0.0361446
NODE_2557_length_1428_cov_5.895410	393	476	9	33	83	0.3975904
NODE_2557_length_1428_cov_5.895410	393	476	10	22	83	0.2650602
NODE_2560_length_1427_cov_38.919428	707	787	12	20	80	0.2500000
NODE_2560_length_1427_cov_38.919428	707	787	13	13	80	0.1625000
NODE_2560_length_1427_cov_38.919428	707	787	14	25	80	0.3125000
NODE_2560_length_1427_cov_38.919428	707	787	15	6	80	0.0750000
NODE_2560_length_1427_cov_38.919428	707	787	16	16	80	0.2000000
NODE_2560_length_1427_cov_38.919428	760	840	11	4	80	0.0500000
NODE_2560_length_1427_cov_38.919428	760	840	12	2	80	0.0250000
NODE_2560_length_1427_cov_38.919428	760	840	13	47	80	0.5875000
NODE_2560_length_1427_cov_38.919428	760	840	14	7	80	0.0875000
NODE_2560_length_1427_cov_38.919428	760	840	15	4	80	0.0500000
NODE_2560_length_1427_cov_38.919428	760	840	16	16	80	0.2000000
NODE_2560_length_1427_cov_38.919428	836	916	5	24	80	0.3000000
NODE_2560_length_1427_cov_38.919428	836	916	7	35	80	0.4375000
NODE_2560_length_1427_cov_38.919428	836	916	10	7	80	0.0875000
NODE_2560_length_1427_cov_38.919428	836	916	12	8	80	0.1000000
NODE_2560_length_1427_cov_38.919428	836	916	13	6	80	0.0750000
NODE_2560_length_1427_cov_38.919428	889	969	4	48	80	0.6000000
NODE_2560_length_1427_cov_38.919428	889	969	5	29	80	0.3625000
NODE_2560_length_1427_cov_38.919428	889	969	7	3	80	0.0375000
NODE_2561_length_1427_cov_19.442771	808	888	2	80	80	1.0000000
NODE_2561_length_1427_cov_19.442771	861	941	2	27	80	0.3375000
NODE_2561_length_1427_cov_19.442771	861	941	6	26	80	0.3250000
NODE_2561_length_1427_cov_19.442771	861	941	7	27	80	0.3375000
NODE_2561_length_1427_cov_19.442771	937	1017	5	62	80	0.7750000
NODE_2561_length_1427_cov_19.442771	937	1017	7	18	80	0.2250000
NODE_2561_length_1427_cov_19.442771	990	1070	1	21	80	0.2625000
NODE_2561_length_1427_cov_19.442771	990	1070	3	6	80	0.0750000
NODE_2561_length_1427_cov_19.442771	990	1070	4	6	80	0.0750000
NODE_2561_length_1427_cov_19.442771	990	1070	5	47	80	0.5875000
NODE_2562_length_1427_cov_10.490964	728	808	2	80	80	1.0000000
NODE_2562_length_1427_cov_10.490964	781	861	2	48	80	0.6000000
NODE_2562_length_1427_cov_10.490964	781	861	3	32	80	0.4000000
NODE_2562_length_1427_cov_10.490964	857	937	1	4	80	0.0500000
NODE_2562_length_1427_cov_10.490964	857	937	2	76	80	0.9500000
NODE_2562_length_1427_cov_10.490964	910	990	1	31	80	0.3875000
NODE_2562_length_1427_cov_10.490964	910	990	2	49	80	0.6125000
NODE_2563_length_1427_cov_9.929217	646	726	3	13	80	0.1625000
NODE_2563_length_1427_cov_9.929217	646	726	5	36	80	0.4500000
NODE_2563_length_1427_cov_9.929217	646	726	6	31	80	0.3875000
NODE_2563_length_1427_cov_9.929217	699	779	5	17	80	0.2125000
NODE_2563_length_1427_cov_9.929217	699	779	6	25	80	0.3125000
NODE_2563_length_1427_cov_9.929217	699	779	7	32	80	0.4000000
NODE_2563_length_1427_cov_9.929217	699	779	8	6	80	0.0750000
NODE_2563_length_1427_cov_9.929217	775	855	3	26	80	0.3250000
NODE_2563_length_1427_cov_9.929217	775	855	4	20	80	0.2500000
NODE_2563_length_1427_cov_9.929217	775	855	6	34	80	0.4250000
NODE_2563_length_1427_cov_9.929217	828	908	1	9	80	0.1125000
NODE_2563_length_1427_cov_9.929217	828	908	2	13	80	0.1625000
NODE_2563_length_1427_cov_9.929217	828	908	3	57	80	0.7125000
NODE_2563_length_1427_cov_9.929217	828	908	4	1	80	0.0125000
NODE_2563_length_1427_cov_9.929217	1248	1324	0	76	76	1.0000000
NODE_2563_length_1427_cov_9.929217	1301	1376	0	75	75	1.0000000
NODE_2564_length_1427_cov_3.122741	1336	1399	0	63	63	1.0000000
NODE_2570_length_1426_cov_36.580256	422	502	1	41	80	0.5125000
NODE_2570_length_1426_cov_36.580256	422	502	2	35	80	0.4375000
NODE_2570_length_1426_cov_36.580256	422	502	4	4	80	0.0500000
NODE_2570_length_1426_cov_36.580256	475	555	2	23	80	0.2875000
NODE_2570_length_1426_cov_36.580256	475	555	3	14	80	0.1750000
NODE_2570_length_1426_cov_36.580256	475	555	4	30	80	0.3750000
NODE_2570_length_1426_cov_36.580256	475	555	6	13	80	0.1625000
NODE_2570_length_1426_cov_36.580256	551	631	5	18	80	0.2250000
NODE_2570_length_1426_cov_36.580256	551	631	6	62	80	0.7750000
NODE_2570_length_1426_cov_36.580256	604	684	3	36	80	0.4500000
NODE_2570_length_1426_cov_36.580256	604	684	5	35	80	0.4375000
NODE_2570_length_1426_cov_36.580256	604	684	6	9	80	0.1125000
NODE_2574_length_1425_cov_25.524133	561	641	11	1	80	0.0125000
NODE_2574_length_1425_cov_25.524133	561	641	12	14	80	0.1750000
NODE_2574_length_1425_cov_25.524133	561	641	14	2	80	0.0250000
NODE_2574_length_1425_cov_25.524133	561	641	15	3	80	0.0375000
NODE_2574_length_1425_cov_25.524133	561	641	16	7	80	0.0875000
NODE_2574_length_1425_cov_25.524133	561	641	18	4	80	0.0500000
NODE_2574_length_1425_cov_25.524133	561	641	20	8	80	0.1000000
NODE_2574_length_1425_cov_25.524133	561	641	22	21	80	0.2625000
NODE_2574_length_1425_cov_25.524133	561	641	23	9	80	0.1125000
NODE_2574_length_1425_cov_25.524133	561	641	26	11	80	0.1375000
NODE_2574_length_1425_cov_25.524133	614	694	21	1	80	0.0125000
NODE_2574_length_1425_cov_25.524133	614	694	22	25	80	0.3125000
NODE_2574_length_1425_cov_25.524133	614	694	23	25	80	0.3125000
NODE_2574_length_1425_cov_25.524133	614	694	24	5	80	0.0625000
NODE_2574_length_1425_cov_25.524133	614	694	25	6	80	0.0750000
NODE_2574_length_1425_cov_25.524133	614	694	26	15	80	0.1875000
NODE_2574_length_1425_cov_25.524133	614	694	27	2	80	0.0250000
NODE_2574_length_1425_cov_25.524133	614	694	28	1	80	0.0125000
NODE_2575_length_1425_cov_10.175716	361	441	6	40	80	0.5000000
NODE_2575_length_1425_cov_10.175716	361	441	7	38	80	0.4750000
NODE_2575_length_1425_cov_10.175716	361	441	8	2	80	0.0250000
NODE_2575_length_1425_cov_10.175716	414	494	6	1	80	0.0125000
NODE_2575_length_1425_cov_10.175716	414	494	7	55	80	0.6875000
NODE_2575_length_1425_cov_10.175716	414	494	8	24	80	0.3000000
NODE_2587_length_1423_cov_31.158610	862	942	0	80	80	1.0000000
NODE_2587_length_1423_cov_31.158610	915	995	0	80	80	1.0000000
NODE_2588_length_1423_cov_30.731873	764	844	4	1	80	0.0125000
NODE_2588_length_1423_cov_30.731873	764	844	5	2	80	0.0250000
NODE_2588_length_1423_cov_30.731873	764	844	6	4	80	0.0500000
NODE_2588_length_1423_cov_30.731873	764	844	8	4	80	0.0500000
NODE_2588_length_1423_cov_30.731873	764	844	10	13	80	0.1625000
NODE_2588_length_1423_cov_30.731873	764	844	11	1	80	0.0125000
NODE_2588_length_1423_cov_30.731873	764	844	12	1	80	0.0125000
NODE_2588_length_1423_cov_30.731873	764	844	13	16	80	0.2000000
NODE_2588_length_1423_cov_30.731873	764	844	15	9	80	0.1125000
NODE_2588_length_1423_cov_30.731873	764	844	16	28	80	0.3500000
NODE_2588_length_1423_cov_30.731873	764	844	17	1	80	0.0125000
NODE_2588_length_1423_cov_30.731873	817	897	14	7	80	0.0875000
NODE_2588_length_1423_cov_30.731873	817	897	15	13	80	0.1625000
NODE_2588_length_1423_cov_30.731873	817	897	16	59	80	0.7375000
NODE_2588_length_1423_cov_30.731873	817	897	17	1	80	0.0125000
NODE_2596_length_1421_cov_8.285930	136	212	5	35	76	0.4605263
NODE_2596_length_1421_cov_8.285930	136	212	6	6	76	0.0789474
NODE_2596_length_1421_cov_8.285930	136	212	8	6	76	0.0789474
NODE_2596_length_1421_cov_8.285930	136	212	10	6	76	0.0789474
NODE_2596_length_1421_cov_8.285930	136	212	11	5	76	0.0657895
NODE_2596_length_1421_cov_8.285930	136	212	13	18	76	0.2368421
NODE_2598_length_1421_cov_2.574130	22	102	0	80	80	1.0000000
NODE_2598_length_1421_cov_2.574130	75	132	0	57	57	1.0000000
NODE_2599_length_1420_cov_256.442846	60	140	15	18	80	0.2250000
NODE_2599_length_1420_cov_256.442846	60	140	16	1	80	0.0125000
NODE_2599_length_1420_cov_256.442846	60	140	18	9	80	0.1125000
NODE_2599_length_1420_cov_256.442846	60	140	19	5	80	0.0625000
NODE_2599_length_1420_cov_256.442846	60	140	21	10	80	0.1250000
NODE_2599_length_1420_cov_256.442846	60	140	22	18	80	0.2250000
NODE_2599_length_1420_cov_256.442846	60	140	23	2	80	0.0250000
NODE_2599_length_1420_cov_256.442846	60	140	24	11	80	0.1375000
NODE_2599_length_1420_cov_256.442846	60	140	25	2	80	0.0250000
NODE_2599_length_1420_cov_256.442846	60	140	26	4	80	0.0500000
NODE_2599_length_1420_cov_256.442846	1294	1360	3	4	66	0.0606061
NODE_2599_length_1420_cov_256.442846	1294	1360	4	12	66	0.1818182
NODE_2599_length_1420_cov_256.442846	1294	1360	5	50	66	0.7575758
NODE_2600_length_1420_cov_7.547313	628	708	2	17	80	0.2125000
NODE_2600_length_1420_cov_7.547313	628	708	3	19	80	0.2375000
NODE_2600_length_1420_cov_7.547313	628	708	4	9	80	0.1125000
NODE_2600_length_1420_cov_7.547313	628	708	5	35	80	0.4375000
NODE_2600_length_1420_cov_7.547313	681	761	2	1	80	0.0125000
NODE_2600_length_1420_cov_7.547313	681	761	3	27	80	0.3375000
NODE_2600_length_1420_cov_7.547313	681	761	4	27	80	0.3375000
NODE_2600_length_1420_cov_7.547313	681	761	5	5	80	0.0625000
NODE_2600_length_1420_cov_7.547313	681	761	7	20	80	0.2500000
NODE_2602_length_1420_cov_2.051476	972	1039	0	67	67	1.0000000
NODE_2604_length_1419_cov_46.997727	1230	1305	0	75	75	1.0000000
NODE_2604_length_1419_cov_46.997727	1278	1332	0	54	54	1.0000000
NODE_2609_length_1418_cov_11.373010	432	512	6	41	80	0.5125000
NODE_2609_length_1418_cov_11.373010	432	512	7	16	80	0.2000000
NODE_2609_length_1418_cov_11.373010	432	512	8	5	80	0.0625000
NODE_2609_length_1418_cov_11.373010	432	512	9	15	80	0.1875000
NODE_2609_length_1418_cov_11.373010	432	512	10	3	80	0.0375000
NODE_2609_length_1418_cov_11.373010	485	556	4	4	71	0.0563380
NODE_2609_length_1418_cov_11.373010	485	556	5	12	71	0.1690141
NODE_2609_length_1418_cov_11.373010	485	556	6	36	71	0.5070422
NODE_2609_length_1418_cov_11.373010	485	556	7	7	71	0.0985916
NODE_2609_length_1418_cov_11.373010	485	556	8	3	71	0.0422535
NODE_2609_length_1418_cov_11.373010	485	556	9	9	71	0.1267606
NODE_2615_length_1417_cov_12.477997	354	399	2	45	45	1.0000000
NODE_2616_length_1417_cov_11.120637	794	874	0	80	80	1.0000000
NODE_2616_length_1417_cov_11.120637	847	927	0	80	80	1.0000000
NODE_2625_length_1415_cov_51.375380	423	503	18	4	80	0.0500000
NODE_2625_length_1415_cov_51.375380	423	503	19	14	80	0.1750000
NODE_2625_length_1415_cov_51.375380	423	503	21	9	80	0.1125000
NODE_2625_length_1415_cov_51.375380	423	503	22	43	80	0.5375000
NODE_2625_length_1415_cov_51.375380	423	503	23	9	80	0.1125000
NODE_2625_length_1415_cov_51.375380	423	503	24	1	80	0.0125000
NODE_2625_length_1415_cov_51.375380	476	556	15	8	80	0.1000000
NODE_2625_length_1415_cov_51.375380	476	556	16	20	80	0.2500000
NODE_2625_length_1415_cov_51.375380	476	556	17	17	80	0.2125000
NODE_2625_length_1415_cov_51.375380	476	556	18	12	80	0.1500000
NODE_2625_length_1415_cov_51.375380	476	556	19	1	80	0.0125000
NODE_2625_length_1415_cov_51.375380	476	556	21	6	80	0.0750000
NODE_2625_length_1415_cov_51.375380	476	556	22	7	80	0.0875000
NODE_2625_length_1415_cov_51.375380	476	556	23	9	80	0.1125000
NODE_2625_length_1415_cov_51.375380	552	632	7	10	80	0.1250000
NODE_2625_length_1415_cov_51.375380	552	632	8	14	80	0.1750000
NODE_2625_length_1415_cov_51.375380	552	632	10	10	80	0.1250000
NODE_2625_length_1415_cov_51.375380	552	632	11	2	80	0.0250000
NODE_2625_length_1415_cov_51.375380	552	632	12	1	80	0.0125000
NODE_2625_length_1415_cov_51.375380	552	632	13	19	80	0.2375000
NODE_2625_length_1415_cov_51.375380	552	632	14	4	80	0.0500000
NODE_2625_length_1415_cov_51.375380	552	632	15	6	80	0.0750000
NODE_2625_length_1415_cov_51.375380	552	632	16	9	80	0.1125000
NODE_2625_length_1415_cov_51.375380	552	632	17	5	80	0.0625000
NODE_2625_length_1415_cov_51.375380	605	683	7	5	78	0.0641026
NODE_2625_length_1415_cov_51.375380	605	683	8	12	78	0.1538462
NODE_2625_length_1415_cov_51.375380	605	683	10	15	78	0.1923077
NODE_2625_length_1415_cov_51.375380	605	683	11	9	78	0.1153846
NODE_2625_length_1415_cov_51.375380	605	683	12	2	78	0.0256410
NODE_2625_length_1415_cov_51.375380	605	683	13	29	78	0.3717949
NODE_2625_length_1415_cov_51.375380	605	683	15	6	78	0.0769231
NODE_2626_length_1415_cov_38.272036	513	593	29	4	80	0.0500000
NODE_2626_length_1415_cov_38.272036	513	593	30	9	80	0.1125000
NODE_2626_length_1415_cov_38.272036	513	593	31	23	80	0.2875000
NODE_2626_length_1415_cov_38.272036	513	593	32	6	80	0.0750000
NODE_2626_length_1415_cov_38.272036	513	593	33	13	80	0.1625000
NODE_2626_length_1415_cov_38.272036	513	593	34	16	80	0.2000000
NODE_2626_length_1415_cov_38.272036	513	593	35	9	80	0.1125000
NODE_2626_length_1415_cov_38.272036	566	646	11	16	80	0.2000000
NODE_2626_length_1415_cov_38.272036	566	646	12	3	80	0.0375000
NODE_2626_length_1415_cov_38.272036	566	646	13	1	80	0.0125000
NODE_2626_length_1415_cov_38.272036	566	646	19	3	80	0.0375000
NODE_2626_length_1415_cov_38.272036	566	646	22	6	80	0.0750000
NODE_2626_length_1415_cov_38.272036	566	646	26	8	80	0.1000000
NODE_2626_length_1415_cov_38.272036	566	646	28	11	80	0.1375000
NODE_2626_length_1415_cov_38.272036	566	646	29	7	80	0.0875000
NODE_2626_length_1415_cov_38.272036	566	646	30	11	80	0.1375000
NODE_2626_length_1415_cov_38.272036	566	646	31	13	80	0.1625000
NODE_2626_length_1415_cov_38.272036	566	646	32	1	80	0.0125000
NODE_2627_length_1415_cov_17.232523	642	722	1	72	80	0.9000000
NODE_2627_length_1415_cov_17.232523	642	722	2	8	80	0.1000000
NODE_2627_length_1415_cov_17.232523	695	775	0	15	80	0.1875000
NODE_2627_length_1415_cov_17.232523	695	775	1	20	80	0.2500000
NODE_2627_length_1415_cov_17.232523	695	775	2	45	80	0.5625000
NODE_2629_length_1414_cov_5.307985	1026	1106	0	28	80	0.3500000
NODE_2629_length_1414_cov_5.307985	1026	1106	2	52	80	0.6500000
NODE_2629_length_1414_cov_5.307985	1079	1159	2	80	80	1.0000000
NODE_2637_length_1412_cov_17.723534	875	955	1	17	80	0.2125000
NODE_2637_length_1412_cov_17.723534	875	955	3	1	80	0.0125000
NODE_2637_length_1412_cov_17.723534	875	955	4	36	80	0.4500000
NODE_2637_length_1412_cov_17.723534	875	955	5	5	80	0.0625000
NODE_2637_length_1412_cov_17.723534	875	955	7	21	80	0.2625000
NODE_2637_length_1412_cov_17.723534	928	1008	4	1	80	0.0125000
NODE_2637_length_1412_cov_17.723534	928	1008	5	5	80	0.0625000
NODE_2637_length_1412_cov_17.723534	928	1008	7	57	80	0.7125000
NODE_2637_length_1412_cov_17.723534	928	1008	10	17	80	0.2125000
NODE_2641_length_1411_cov_34.004573	516	596	16	4	80	0.0500000
NODE_2641_length_1411_cov_34.004573	516	596	17	3	80	0.0375000
NODE_2641_length_1411_cov_34.004573	516	596	18	14	80	0.1750000
NODE_2641_length_1411_cov_34.004573	516	596	19	11	80	0.1375000
NODE_2641_length_1411_cov_34.004573	516	596	20	35	80	0.4375000
NODE_2641_length_1411_cov_34.004573	516	596	21	13	80	0.1625000
NODE_2641_length_1411_cov_34.004573	569	649	10	1	80	0.0125000
NODE_2641_length_1411_cov_34.004573	569	649	11	5	80	0.0625000
NODE_2641_length_1411_cov_34.004573	569	649	12	2	80	0.0250000
NODE_2641_length_1411_cov_34.004573	569	649	13	7	80	0.0875000
NODE_2641_length_1411_cov_34.004573	569	649	14	3	80	0.0375000
NODE_2641_length_1411_cov_34.004573	569	649	15	21	80	0.2625000
NODE_2641_length_1411_cov_34.004573	569	649	16	3	80	0.0375000
NODE_2641_length_1411_cov_34.004573	569	649	18	2	80	0.0250000
NODE_2641_length_1411_cov_34.004573	569	649	19	20	80	0.2500000
NODE_2641_length_1411_cov_34.004573	569	649	20	3	80	0.0375000
NODE_2641_length_1411_cov_34.004573	569	649	21	13	80	0.1625000
NODE_2641_length_1411_cov_34.004573	645	725	12	1	80	0.0125000
NODE_2641_length_1411_cov_34.004573	645	725	13	1	80	0.0125000
NODE_2641_length_1411_cov_34.004573	645	725	15	33	80	0.4125000
NODE_2641_length_1411_cov_34.004573	645	725	17	8	80	0.1000000
NODE_2641_length_1411_cov_34.004573	645	725	19	5	80	0.0625000
NODE_2641_length_1411_cov_34.004573	645	725	20	6	80	0.0750000
NODE_2641_length_1411_cov_34.004573	645	725	21	26	80	0.3250000
NODE_2641_length_1411_cov_34.004573	698	778	15	1	80	0.0125000
NODE_2641_length_1411_cov_34.004573	698	778	16	8	80	0.1000000
NODE_2641_length_1411_cov_34.004573	698	778	17	3	80	0.0375000
NODE_2641_length_1411_cov_34.004573	698	778	18	1	80	0.0125000
NODE_2641_length_1411_cov_34.004573	698	778	19	12	80	0.1500000
NODE_2641_length_1411_cov_34.004573	698	778	20	31	80	0.3875000
NODE_2641_length_1411_cov_34.004573	698	778	21	24	80	0.3000000
NODE_2643_length_1409_cov_25.380153	828	908	15	8	80	0.1000000
NODE_2643_length_1409_cov_25.380153	828	908	16	5	80	0.0625000
NODE_2643_length_1409_cov_25.380153	828	908	17	4	80	0.0500000
NODE_2643_length_1409_cov_25.380153	828	908	18	30	80	0.3750000
NODE_2643_length_1409_cov_25.380153	828	908	19	13	80	0.1625000
NODE_2643_length_1409_cov_25.380153	828	908	20	19	80	0.2375000
NODE_2643_length_1409_cov_25.380153	828	908	21	1	80	0.0125000
NODE_2643_length_1409_cov_25.380153	881	961	12	2	80	0.0250000
NODE_2643_length_1409_cov_25.380153	881	961	15	19	80	0.2375000
NODE_2643_length_1409_cov_25.380153	881	961	16	6	80	0.0750000
NODE_2643_length_1409_cov_25.380153	881	961	17	4	80	0.0500000
NODE_2643_length_1409_cov_25.380153	881	961	18	27	80	0.3375000
NODE_2643_length_1409_cov_25.380153	881	961	19	1	80	0.0125000
NODE_2643_length_1409_cov_25.380153	881	961	20	21	80	0.2625000
NODE_2644_length_1409_cov_13.028244	349	405	0	46	56	0.8214286
NODE_2644_length_1409_cov_13.028244	349	405	1	10	56	0.1785714
NODE_2644_length_1409_cov_13.028244	416	482	1	15	66	0.2272727
NODE_2644_length_1409_cov_13.028244	416	482	2	38	66	0.5757576
NODE_2644_length_1409_cov_13.028244	416	482	4	13	66	0.1969697
NODE_2648_length_1408_cov_6.261268	492	572	4	7	80	0.0875000
NODE_2648_length_1408_cov_6.261268	492	572	5	15	80	0.1875000
NODE_2648_length_1408_cov_6.261268	492	572	6	58	80	0.7250000
NODE_2648_length_1408_cov_6.261268	545	625	2	18	80	0.2250000
NODE_2648_length_1408_cov_6.261268	545	625	3	9	80	0.1125000
NODE_2648_length_1408_cov_6.261268	545	625	4	33	80	0.4125000
NODE_2648_length_1408_cov_6.261268	545	625	5	15	80	0.1875000
NODE_2648_length_1408_cov_6.261268	545	625	6	5	80	0.0625000
NODE_2652_length_1407_cov_27.711009	772	852	22	2	80	0.0250000
NODE_2652_length_1407_cov_27.711009	772	852	23	1	80	0.0125000
NODE_2652_length_1407_cov_27.711009	772	852	24	22	80	0.2750000
NODE_2652_length_1407_cov_27.711009	772	852	25	20	80	0.2500000
NODE_2652_length_1407_cov_27.711009	772	852	27	27	80	0.3375000
NODE_2652_length_1407_cov_27.711009	772	852	28	8	80	0.1000000
NODE_2652_length_1407_cov_27.711009	825	905	16	7	80	0.0875000
NODE_2652_length_1407_cov_27.711009	825	905	17	9	80	0.1125000
NODE_2652_length_1407_cov_27.711009	825	905	18	3	80	0.0375000
NODE_2652_length_1407_cov_27.711009	825	905	19	5	80	0.0625000
NODE_2652_length_1407_cov_27.711009	825	905	20	9	80	0.1125000
NODE_2652_length_1407_cov_27.711009	825	905	22	2	80	0.0250000
NODE_2652_length_1407_cov_27.711009	825	905	23	7	80	0.0875000
NODE_2652_length_1407_cov_27.711009	825	905	24	2	80	0.0250000
NODE_2652_length_1407_cov_27.711009	825	905	25	10	80	0.1250000
NODE_2652_length_1407_cov_27.711009	825	905	26	5	80	0.0625000
NODE_2652_length_1407_cov_27.711009	825	905	27	13	80	0.1625000
NODE_2652_length_1407_cov_27.711009	825	905	28	8	80	0.1000000
NODE_2653_length_1407_cov_24.387615	586	666	4	5	80	0.0625000
NODE_2653_length_1407_cov_24.387615	586	666	5	5	80	0.0625000
NODE_2653_length_1407_cov_24.387615	586	666	6	21	80	0.2625000
NODE_2653_length_1407_cov_24.387615	586	666	7	1	80	0.0125000
NODE_2653_length_1407_cov_24.387615	586	666	8	45	80	0.5625000
NODE_2653_length_1407_cov_24.387615	586	666	9	3	80	0.0375000
NODE_2653_length_1407_cov_24.387615	639	719	8	24	80	0.3000000
NODE_2653_length_1407_cov_24.387615	639	719	9	14	80	0.1750000
NODE_2653_length_1407_cov_24.387615	639	719	10	25	80	0.3125000
NODE_2653_length_1407_cov_24.387615	639	719	11	17	80	0.2125000
NODE_2653_length_1407_cov_24.387615	715	795	5	27	80	0.3375000
NODE_2653_length_1407_cov_24.387615	715	795	6	1	80	0.0125000
NODE_2653_length_1407_cov_24.387615	715	795	7	21	80	0.2625000
NODE_2653_length_1407_cov_24.387615	715	795	9	2	80	0.0250000
NODE_2653_length_1407_cov_24.387615	715	795	10	18	80	0.2250000
NODE_2653_length_1407_cov_24.387615	715	795	11	11	80	0.1375000
NODE_2653_length_1407_cov_24.387615	768	848	2	7	80	0.0875000
NODE_2653_length_1407_cov_24.387615	768	848	3	19	80	0.2375000
NODE_2653_length_1407_cov_24.387615	768	848	4	9	80	0.1125000
NODE_2653_length_1407_cov_24.387615	768	848	5	45	80	0.5625000
NODE_2654_length_1407_cov_19.022936	551	629	7	9	78	0.1153846
NODE_2654_length_1407_cov_19.022936	551	629	9	33	78	0.4230769
NODE_2654_length_1407_cov_19.022936	551	629	10	28	78	0.3589744
NODE_2654_length_1407_cov_19.022936	551	629	13	5	78	0.0641026
NODE_2654_length_1407_cov_19.022936	551	629	15	3	78	0.0384615
NODE_2654_length_1407_cov_19.022936	602	665	7	7	63	0.1111111
NODE_2654_length_1407_cov_19.022936	602	665	8	2	63	0.0317460
NODE_2654_length_1407_cov_19.022936	602	665	9	28	63	0.4444444
NODE_2654_length_1407_cov_19.022936	602	665	10	18	63	0.2857143
NODE_2654_length_1407_cov_19.022936	602	665	13	5	63	0.0793651
NODE_2654_length_1407_cov_19.022936	602	665	15	3	63	0.0476190
NODE_2655_length_1407_cov_11.266820	813	893	2	2	80	0.0250000
NODE_2655_length_1407_cov_11.266820	813	893	4	1	80	0.0125000
NODE_2655_length_1407_cov_11.266820	813	893	5	20	80	0.2500000
NODE_2655_length_1407_cov_11.266820	813	893	6	57	80	0.7125000
NODE_2655_length_1407_cov_11.266820	866	946	5	3	80	0.0375000
NODE_2655_length_1407_cov_11.266820	866	946	6	42	80	0.5250000
NODE_2655_length_1407_cov_11.266820	866	946	7	10	80	0.1250000
NODE_2655_length_1407_cov_11.266820	866	946	8	5	80	0.0625000
NODE_2655_length_1407_cov_11.266820	866	946	9	20	80	0.2500000
NODE_2655_length_1407_cov_11.266820	942	1022	6	11	80	0.1375000
NODE_2655_length_1407_cov_11.266820	942	1022	7	17	80	0.2125000
NODE_2655_length_1407_cov_11.266820	942	1022	8	41	80	0.5125000
NODE_2655_length_1407_cov_11.266820	942	1022	9	3	80	0.0375000
NODE_2655_length_1407_cov_11.266820	942	1022	10	8	80	0.1000000
NODE_2655_length_1407_cov_11.266820	995	1075	6	4	80	0.0500000
NODE_2655_length_1407_cov_11.266820	995	1075	8	30	80	0.3750000
NODE_2655_length_1407_cov_11.266820	995	1075	10	46	80	0.5750000
NODE_2657_length_1406_cov_7.247896	761	841	2	3	80	0.0375000
NODE_2657_length_1406_cov_7.247896	761	841	4	77	80	0.9625000
NODE_2657_length_1406_cov_7.247896	814	894	2	56	80	0.7000000
NODE_2657_length_1406_cov_7.247896	814	894	4	24	80	0.3000000
NODE_2659_length_1404_cov_23.406130	826	906	15	13	80	0.1625000
NODE_2659_length_1404_cov_23.406130	826	906	16	12	80	0.1500000
NODE_2659_length_1404_cov_23.406130	826	906	17	16	80	0.2000000
NODE_2659_length_1404_cov_23.406130	826	906	18	14	80	0.1750000
NODE_2659_length_1404_cov_23.406130	826	906	19	13	80	0.1625000
NODE_2659_length_1404_cov_23.406130	826	906	20	12	80	0.1500000
NODE_2659_length_1404_cov_23.406130	879	959	16	9	80	0.1125000
NODE_2659_length_1404_cov_23.406130	879	959	17	17	80	0.2125000
NODE_2659_length_1404_cov_23.406130	879	959	18	14	80	0.1750000
NODE_2659_length_1404_cov_23.406130	879	959	19	9	80	0.1125000
NODE_2659_length_1404_cov_23.406130	879	959	20	8	80	0.1000000
NODE_2659_length_1404_cov_23.406130	879	959	21	15	80	0.1875000
NODE_2659_length_1404_cov_23.406130	879	959	23	8	80	0.1000000
NODE_2659_length_1404_cov_23.406130	955	1035	10	5	80	0.0625000
NODE_2659_length_1404_cov_23.406130	955	1035	11	6	80	0.0750000
NODE_2659_length_1404_cov_23.406130	955	1035	12	4	80	0.0500000
NODE_2659_length_1404_cov_23.406130	955	1035	13	32	80	0.4000000
NODE_2659_length_1404_cov_23.406130	955	1035	14	5	80	0.0625000
NODE_2659_length_1404_cov_23.406130	955	1035	15	18	80	0.2250000
NODE_2659_length_1404_cov_23.406130	955	1035	17	10	80	0.1250000
NODE_2659_length_1404_cov_23.406130	1008	1088	2	16	80	0.2000000
NODE_2659_length_1404_cov_23.406130	1008	1088	3	2	80	0.0250000
NODE_2659_length_1404_cov_23.406130	1008	1088	5	8	80	0.1000000
NODE_2659_length_1404_cov_23.406130	1008	1088	7	2	80	0.0250000
NODE_2659_length_1404_cov_23.406130	1008	1088	8	3	80	0.0375000
NODE_2659_length_1404_cov_23.406130	1008	1088	9	20	80	0.2500000
NODE_2659_length_1404_cov_23.406130	1008	1088	10	7	80	0.0875000
NODE_2659_length_1404_cov_23.406130	1008	1088	11	6	80	0.0750000
NODE_2659_length_1404_cov_23.406130	1008	1088	12	4	80	0.0500000
NODE_2659_length_1404_cov_23.406130	1008	1088	13	12	80	0.1500000
NODE_2666_length_1403_cov_14.331288	325	405	7	6	80	0.0750000
NODE_2666_length_1403_cov_14.331288	325	405	9	58	80	0.7250000
NODE_2666_length_1403_cov_14.331288	325	405	10	16	80	0.2000000
NODE_2666_length_1403_cov_14.331288	378	458	4	4	80	0.0500000
NODE_2666_length_1403_cov_14.331288	378	458	5	26	80	0.3250000
NODE_2666_length_1403_cov_14.331288	378	458	6	22	80	0.2750000
NODE_2666_length_1403_cov_14.331288	378	458	7	7	80	0.0875000
NODE_2666_length_1403_cov_14.331288	378	458	9	21	80	0.2625000
NODE_2666_length_1403_cov_14.331288	454	534	0	40	80	0.5000000
NODE_2666_length_1403_cov_14.331288	454	534	1	21	80	0.2625000
NODE_2666_length_1403_cov_14.331288	454	534	2	7	80	0.0875000
NODE_2666_length_1403_cov_14.331288	454	534	3	2	80	0.0250000
NODE_2666_length_1403_cov_14.331288	454	534	4	10	80	0.1250000
NODE_2666_length_1403_cov_14.331288	454	534	0	40	80	0.5000000
NODE_2666_length_1403_cov_14.331288	454	534	1	21	80	0.2625000
NODE_2666_length_1403_cov_14.331288	454	534	2	7	80	0.0875000
NODE_2666_length_1403_cov_14.331288	454	534	3	2	80	0.0250000
NODE_2666_length_1403_cov_14.331288	454	534	4	10	80	0.1250000
NODE_2666_length_1403_cov_14.331288	454	524	0	30	70	0.4285714
NODE_2666_length_1403_cov_14.331288	454	524	1	21	70	0.3000000
NODE_2666_length_1403_cov_14.331288	454	524	2	7	70	0.1000000
NODE_2666_length_1403_cov_14.331288	454	524	3	2	70	0.0285714
NODE_2666_length_1403_cov_14.331288	454	524	4	10	70	0.1428571
NODE_2666_length_1403_cov_14.331288	507	587	0	80	80	1.0000000
NODE_2666_length_1403_cov_14.331288	507	579	0	72	72	1.0000000
NODE_2668_length_1402_cov_29.095165	610	690	5	24	80	0.3000000
NODE_2668_length_1402_cov_29.095165	610	690	6	2	80	0.0250000
NODE_2668_length_1402_cov_29.095165	610	690	7	16	80	0.2000000
NODE_2668_length_1402_cov_29.095165	610	690	8	9	80	0.1125000
NODE_2668_length_1402_cov_29.095165	610	690	9	28	80	0.3500000
NODE_2668_length_1402_cov_29.095165	610	690	10	1	80	0.0125000
NODE_2668_length_1402_cov_29.095165	663	743	6	1	80	0.0125000
NODE_2668_length_1402_cov_29.095165	663	743	7	60	80	0.7500000
NODE_2668_length_1402_cov_29.095165	663	743	9	18	80	0.2250000
NODE_2668_length_1402_cov_29.095165	663	743	10	1	80	0.0125000
NODE_2669_length_1402_cov_23.411358	528	608	4	36	80	0.4500000
NODE_2669_length_1402_cov_23.411358	528	608	5	26	80	0.3250000
NODE_2669_length_1402_cov_23.411358	528	608	6	4	80	0.0500000
NODE_2669_length_1402_cov_23.411358	528	608	7	12	80	0.1500000
NODE_2669_length_1402_cov_23.411358	528	608	8	2	80	0.0250000
NODE_2669_length_1402_cov_23.411358	581	661	5	9	80	0.1125000
NODE_2669_length_1402_cov_23.411358	581	661	6	4	80	0.0500000
NODE_2669_length_1402_cov_23.411358	581	661	7	15	80	0.1875000
NODE_2669_length_1402_cov_23.411358	581	661	8	3	80	0.0375000
NODE_2669_length_1402_cov_23.411358	581	661	9	38	80	0.4750000
NODE_2669_length_1402_cov_23.411358	581	661	10	8	80	0.1000000
NODE_2669_length_1402_cov_23.411358	581	661	11	3	80	0.0375000
NODE_2669_length_1402_cov_23.411358	657	737	8	3	80	0.0375000
NODE_2669_length_1402_cov_23.411358	657	737	9	27	80	0.3375000
NODE_2669_length_1402_cov_23.411358	657	737	10	12	80	0.1500000
NODE_2669_length_1402_cov_23.411358	657	737	11	30	80	0.3750000
NODE_2669_length_1402_cov_23.411358	657	737	12	5	80	0.0625000
NODE_2669_length_1402_cov_23.411358	657	737	13	3	80	0.0375000
NODE_2669_length_1402_cov_23.411358	710	790	6	1	80	0.0125000
NODE_2669_length_1402_cov_23.411358	710	790	7	4	80	0.0500000
NODE_2669_length_1402_cov_23.411358	710	790	8	23	80	0.2875000
NODE_2669_length_1402_cov_23.411358	710	790	10	11	80	0.1375000
NODE_2669_length_1402_cov_23.411358	710	790	11	26	80	0.3250000
NODE_2669_length_1402_cov_23.411358	710	790	12	9	80	0.1125000
NODE_2669_length_1402_cov_23.411358	710	790	13	6	80	0.0750000
NODE_2670_length_1402_cov_11.732924	661	741	2	8	80	0.1000000
NODE_2670_length_1402_cov_11.732924	661	741	3	30	80	0.3750000
NODE_2670_length_1402_cov_11.732924	661	741	4	14	80	0.1750000
NODE_2670_length_1402_cov_11.732924	661	741	5	28	80	0.3500000
NODE_2670_length_1402_cov_11.732924	714	794	5	68	80	0.8500000
NODE_2670_length_1402_cov_11.732924	714	794	6	12	80	0.1500000
NODE_2671_length_1402_cov_9.929394	766	846	7	3	80	0.0375000
NODE_2671_length_1402_cov_9.929394	766	846	8	6	80	0.0750000
NODE_2671_length_1402_cov_9.929394	766	846	10	9	80	0.1125000
NODE_2671_length_1402_cov_9.929394	766	846	11	8	80	0.1000000
NODE_2671_length_1402_cov_9.929394	766	846	12	13	80	0.1625000
NODE_2671_length_1402_cov_9.929394	766	846	13	19	80	0.2375000
NODE_2671_length_1402_cov_9.929394	766	846	14	22	80	0.2750000
NODE_2671_length_1402_cov_9.929394	819	899	11	17	80	0.2125000
NODE_2671_length_1402_cov_9.929394	819	899	12	26	80	0.3250000
NODE_2671_length_1402_cov_9.929394	819	899	13	32	80	0.4000000
NODE_2671_length_1402_cov_9.929394	819	899	14	5	80	0.0625000
NODE_2677_length_1401_cov_35.754992	825	905	31	3	80	0.0375000
NODE_2677_length_1401_cov_35.754992	825	905	32	1	80	0.0125000
NODE_2677_length_1401_cov_35.754992	825	905	33	7	80	0.0875000
NODE_2677_length_1401_cov_35.754992	825	905	34	36	80	0.4500000
NODE_2677_length_1401_cov_35.754992	825	905	36	16	80	0.2000000
NODE_2677_length_1401_cov_35.754992	825	905	37	17	80	0.2125000
NODE_2677_length_1401_cov_35.754992	878	958	21	1	80	0.0125000
NODE_2677_length_1401_cov_35.754992	878	958	32	1	80	0.0125000
NODE_2677_length_1401_cov_35.754992	878	958	33	6	80	0.0750000
NODE_2677_length_1401_cov_35.754992	878	958	34	14	80	0.1750000
NODE_2677_length_1401_cov_35.754992	878	958	36	31	80	0.3875000
NODE_2677_length_1401_cov_35.754992	878	958	37	4	80	0.0500000
NODE_2677_length_1401_cov_35.754992	878	958	38	4	80	0.0500000
NODE_2677_length_1401_cov_35.754992	878	958	39	19	80	0.2375000
NODE_2678_length_1401_cov_10.811828	539	619	5	55	80	0.6875000
NODE_2678_length_1401_cov_10.811828	539	619	6	25	80	0.3125000
NODE_2678_length_1401_cov_10.811828	592	672	1	1	80	0.0125000
NODE_2678_length_1401_cov_10.811828	592	672	2	34	80	0.4250000
NODE_2678_length_1401_cov_10.811828	592	672	4	3	80	0.0375000
NODE_2678_length_1401_cov_10.811828	592	672	5	2	80	0.0250000
NODE_2678_length_1401_cov_10.811828	592	672	6	40	80	0.5000000
NODE_2679_length_1401_cov_5.438556	241	321	8	42	80	0.5250000
NODE_2679_length_1401_cov_5.438556	241	321	9	9	80	0.1125000
NODE_2679_length_1401_cov_5.438556	241	321	10	17	80	0.2125000
NODE_2679_length_1401_cov_5.438556	241	321	11	12	80	0.1500000
NODE_2679_length_1401_cov_5.438556	294	374	4	11	80	0.1375000
NODE_2679_length_1401_cov_5.438556	294	374	7	1	80	0.0125000
NODE_2679_length_1401_cov_5.438556	294	374	8	67	80	0.8375000
NODE_2679_length_1401_cov_5.438556	294	374	11	1	80	0.0125000
NODE_2683_length_1400_cov_16.680246	813	893	6	29	80	0.3625000
NODE_2683_length_1400_cov_16.680246	813	893	8	19	80	0.2375000
NODE_2683_length_1400_cov_16.680246	813	893	10	32	80	0.4000000
NODE_2683_length_1400_cov_16.680246	866	946	5	7	80	0.0875000
NODE_2683_length_1400_cov_16.680246	866	946	7	25	80	0.3125000
NODE_2683_length_1400_cov_16.680246	866	946	8	36	80	0.4500000
NODE_2683_length_1400_cov_16.680246	866	946	10	12	80	0.1500000
NODE_2684_length_1400_cov_8.166795	53	133	6	1	80	0.0125000
NODE_2684_length_1400_cov_8.166795	53	133	8	2	80	0.0250000
NODE_2684_length_1400_cov_8.166795	53	133	9	16	80	0.2000000
NODE_2684_length_1400_cov_8.166795	53	133	11	61	80	0.7625000
NODE_2684_length_1400_cov_8.166795	106	186	6	8	80	0.1000000
NODE_2684_length_1400_cov_8.166795	106	186	8	1	80	0.0125000
NODE_2684_length_1400_cov_8.166795	106	186	10	1	80	0.0125000
NODE_2684_length_1400_cov_8.166795	106	186	11	61	80	0.7625000
NODE_2684_length_1400_cov_8.166795	106	186	12	9	80	0.1125000
NODE_2694_length_1397_cov_25.549307	869	918	15	34	49	0.6938776
NODE_2694_length_1397_cov_25.549307	869	918	16	15	49	0.3061225
NODE_2694_length_1397_cov_25.549307	891	971	6	9	80	0.1125000
NODE_2694_length_1397_cov_25.549307	891	971	8	1	80	0.0125000
NODE_2694_length_1397_cov_25.549307	891	971	10	3	80	0.0375000
NODE_2694_length_1397_cov_25.549307	891	971	11	4	80	0.0500000
NODE_2694_length_1397_cov_25.549307	891	971	12	6	80	0.0750000
NODE_2694_length_1397_cov_25.549307	891	971	13	17	80	0.2125000
NODE_2694_length_1397_cov_25.549307	891	971	15	13	80	0.1625000
NODE_2694_length_1397_cov_25.549307	891	971	16	27	80	0.3375000
NODE_2695_length_1397_cov_14.395223	672	752	6	5	80	0.0625000
NODE_2695_length_1397_cov_14.395223	672	752	8	4	80	0.0500000
NODE_2695_length_1397_cov_14.395223	672	752	9	27	80	0.3375000
NODE_2695_length_1397_cov_14.395223	672	752	10	44	80	0.5500000
NODE_2695_length_1397_cov_14.395223	725	805	8	11	80	0.1375000
NODE_2695_length_1397_cov_14.395223	725	805	9	42	80	0.5250000
NODE_2695_length_1397_cov_14.395223	725	805	10	20	80	0.2500000
NODE_2695_length_1397_cov_14.395223	725	805	11	7	80	0.0875000
NODE_2695_length_1397_cov_14.395223	801	881	3	38	80	0.4750000
NODE_2695_length_1397_cov_14.395223	801	881	4	12	80	0.1500000
NODE_2695_length_1397_cov_14.395223	801	881	5	8	80	0.1000000
NODE_2695_length_1397_cov_14.395223	801	881	7	3	80	0.0375000
NODE_2695_length_1397_cov_14.395223	801	881	8	3	80	0.0375000
NODE_2695_length_1397_cov_14.395223	801	881	9	16	80	0.2000000
NODE_2695_length_1397_cov_14.395223	854	934	1	12	80	0.1500000
NODE_2695_length_1397_cov_14.395223	854	934	3	68	80	0.8500000
NODE_2699_length_1396_cov_21.656130	825	905	7	38	80	0.4750000
NODE_2699_length_1396_cov_21.656130	825	905	8	14	80	0.1750000
NODE_2699_length_1396_cov_21.656130	825	905	9	18	80	0.2250000
NODE_2699_length_1396_cov_21.656130	825	905	10	10	80	0.1250000
NODE_2699_length_1396_cov_21.656130	878	958	6	23	80	0.2875000
NODE_2699_length_1396_cov_21.656130	878	958	7	5	80	0.0625000
NODE_2699_length_1396_cov_21.656130	878	958	8	13	80	0.1625000
NODE_2699_length_1396_cov_21.656130	878	958	9	23	80	0.2875000
NODE_2699_length_1396_cov_21.656130	878	958	10	16	80	0.2000000
NODE_2700_length_1396_cov_18.108712	560	640	9	10	80	0.1250000
NODE_2700_length_1396_cov_18.108712	560	640	10	34	80	0.4250000
NODE_2700_length_1396_cov_18.108712	560	640	11	9	80	0.1125000
NODE_2700_length_1396_cov_18.108712	560	640	13	10	80	0.1250000
NODE_2700_length_1396_cov_18.108712	560	640	16	2	80	0.0250000
NODE_2700_length_1396_cov_18.108712	560	640	17	15	80	0.1875000
NODE_2700_length_1396_cov_18.108712	613	693	13	10	80	0.1250000
NODE_2700_length_1396_cov_18.108712	613	693	14	11	80	0.1375000
NODE_2700_length_1396_cov_18.108712	613	693	15	27	80	0.3375000
NODE_2700_length_1396_cov_18.108712	613	693	16	13	80	0.1625000
NODE_2700_length_1396_cov_18.108712	613	693	17	19	80	0.2375000
NODE_2701_length_1396_cov_16.208944	136	198	0	62	62	1.0000000
NODE_2701_length_1396_cov_16.208944	848	928	0	80	80	1.0000000
NODE_2701_length_1396_cov_16.208944	901	981	0	80	80	1.0000000
NODE_2701_length_1396_cov_16.208944	977	1057	0	32	80	0.4000000
NODE_2701_length_1396_cov_16.208944	977	1057	2	13	80	0.1625000
NODE_2701_length_1396_cov_16.208944	977	1057	4	35	80	0.4375000
NODE_2701_length_1396_cov_16.208944	1030	1110	4	80	80	1.0000000
NODE_2702_length_1396_cov_9.196608	428	508	0	48	80	0.6000000
NODE_2702_length_1396_cov_9.196608	428	508	1	32	80	0.4000000
NODE_2702_length_1396_cov_9.196608	481	561	1	80	80	1.0000000
NODE_2712_length_1394_cov_29.602317	349	415	2	6	66	0.0909091
NODE_2712_length_1394_cov_29.602317	349	415	3	20	66	0.3030303
NODE_2712_length_1394_cov_29.602317	349	415	4	40	66	0.6060606
NODE_2712_length_1394_cov_29.602317	349	416	0	1	67	0.0149254
NODE_2712_length_1394_cov_29.602317	349	416	2	6	67	0.0895522
NODE_2712_length_1394_cov_29.602317	349	416	3	20	67	0.2985075
NODE_2712_length_1394_cov_29.602317	349	416	4	40	67	0.5970149
NODE_2712_length_1394_cov_29.602317	1117	1197	0	48	80	0.6000000
NODE_2712_length_1394_cov_29.602317	1117	1197	2	32	80	0.4000000
NODE_2712_length_1394_cov_29.602317	1170	1250	2	49	80	0.6125000
NODE_2712_length_1394_cov_29.602317	1170	1250	4	31	80	0.3875000
NODE_2713_length_1394_cov_6.291892	313	393	5	13	80	0.1625000
NODE_2713_length_1394_cov_6.291892	313	393	6	1	80	0.0125000
NODE_2713_length_1394_cov_6.291892	313	393	7	8	80	0.1000000
NODE_2713_length_1394_cov_6.291892	313	393	8	58	80	0.7250000
NODE_2713_length_1394_cov_6.291892	366	446	5	6	80	0.0750000
NODE_2713_length_1394_cov_6.291892	366	446	6	19	80	0.2375000
NODE_2713_length_1394_cov_6.291892	366	446	7	31	80	0.3875000
NODE_2713_length_1394_cov_6.291892	366	446	8	24	80	0.3000000
NODE_2716_length_1393_cov_14.635240	1286	1339	0	53	53	1.0000000
NODE_2717_length_1393_cov_12.032457	737	817	1	4	80	0.0500000
NODE_2717_length_1393_cov_12.032457	737	817	3	18	80	0.2250000
NODE_2717_length_1393_cov_12.032457	737	817	5	8	80	0.1000000
NODE_2717_length_1393_cov_12.032457	737	817	6	4	80	0.0500000
NODE_2717_length_1393_cov_12.032457	737	817	8	46	80	0.5750000
NODE_2717_length_1393_cov_12.032457	790	870	7	18	80	0.2250000
NODE_2717_length_1393_cov_12.032457	790	870	8	62	80	0.7750000
NODE_2720_length_1392_cov_5.898685	270	350	0	80	80	1.0000000
NODE_2720_length_1392_cov_5.898685	323	399	0	76	76	1.0000000
NODE_2723_length_1391_cov_35.921827	415	495	3	47	80	0.5875000
NODE_2723_length_1391_cov_35.921827	415	495	4	13	80	0.1625000
NODE_2723_length_1391_cov_35.921827	415	495	5	17	80	0.2125000
NODE_2723_length_1391_cov_35.921827	415	495	6	3	80	0.0375000
NODE_2723_length_1391_cov_35.921827	468	548	3	24	80	0.3000000
NODE_2723_length_1391_cov_35.921827	468	548	6	5	80	0.0625000
NODE_2723_length_1391_cov_35.921827	468	548	8	24	80	0.3000000
NODE_2723_length_1391_cov_35.921827	468	548	9	19	80	0.2375000
NODE_2723_length_1391_cov_35.921827	468	548	11	8	80	0.1000000
NODE_2723_length_1391_cov_35.921827	544	624	10	9	80	0.1125000
NODE_2723_length_1391_cov_35.921827	544	624	11	17	80	0.2125000
NODE_2723_length_1391_cov_35.921827	544	624	13	16	80	0.2000000
NODE_2723_length_1391_cov_35.921827	544	624	14	13	80	0.1625000
NODE_2723_length_1391_cov_35.921827	544	624	15	25	80	0.3125000
NODE_2723_length_1391_cov_35.921827	597	677	10	31	80	0.3875000
NODE_2723_length_1391_cov_35.921827	597	677	12	4	80	0.0500000
NODE_2723_length_1391_cov_35.921827	597	677	13	1	80	0.0125000
NODE_2723_length_1391_cov_35.921827	597	677	14	2	80	0.0250000
NODE_2723_length_1391_cov_35.921827	597	677	15	42	80	0.5250000
NODE_2729_length_1390_cov_16.326878	550	630	7	49	80	0.6125000
NODE_2729_length_1390_cov_16.326878	550	630	9	31	80	0.3875000
NODE_2729_length_1390_cov_16.326878	603	683	4	11	80	0.1375000
NODE_2729_length_1390_cov_16.326878	603	683	9	37	80	0.4625000
NODE_2729_length_1390_cov_16.326878	603	683	10	4	80	0.0500000
NODE_2729_length_1390_cov_16.326878	603	683	11	28	80	0.3500000
NODE_2731_length_1389_cov_29.772093	780	860	14	11	80	0.1375000
NODE_2731_length_1389_cov_29.772093	780	860	15	36	80	0.4500000
NODE_2731_length_1389_cov_29.772093	780	860	17	7	80	0.0875000
NODE_2731_length_1389_cov_29.772093	780	860	18	26	80	0.3250000
NODE_2731_length_1389_cov_29.772093	833	913	9	3	80	0.0375000
NODE_2731_length_1389_cov_29.772093	833	913	11	3	80	0.0375000
NODE_2731_length_1389_cov_29.772093	833	913	12	6	80	0.0750000
NODE_2731_length_1389_cov_29.772093	833	913	13	4	80	0.0500000
NODE_2731_length_1389_cov_29.772093	833	913	14	19	80	0.2375000
NODE_2731_length_1389_cov_29.772093	833	913	15	27	80	0.3375000
NODE_2731_length_1389_cov_29.772093	833	913	16	14	80	0.1750000
NODE_2731_length_1389_cov_29.772093	833	913	17	1	80	0.0125000
NODE_2731_length_1389_cov_29.772093	833	913	18	3	80	0.0375000
NODE_2732_length_1389_cov_12.858140	821	901	6	51	80	0.6375000
NODE_2732_length_1389_cov_12.858140	821	901	7	19	80	0.2375000
NODE_2732_length_1389_cov_12.858140	821	901	8	10	80	0.1250000
NODE_2732_length_1389_cov_12.858140	874	954	4	17	80	0.2125000
NODE_2732_length_1389_cov_12.858140	874	954	5	23	80	0.2875000
NODE_2732_length_1389_cov_12.858140	874	954	6	7	80	0.0875000
NODE_2732_length_1389_cov_12.858140	874	954	7	25	80	0.3125000
NODE_2732_length_1389_cov_12.858140	874	954	8	8	80	0.1000000
NODE_2735_length_1388_cov_14.641583	529	610	2	81	81	1.0000000
NODE_2735_length_1388_cov_14.641583	583	660	1	37	77	0.4805195
NODE_2735_length_1388_cov_14.641583	583	660	2	31	77	0.4025974
NODE_2735_length_1388_cov_14.641583	583	660	3	9	77	0.1168831
NODE_2736_length_1388_cov_5.168348	427	499	4	18	72	0.2500000
NODE_2736_length_1388_cov_5.168348	427	499	6	26	72	0.3611111
NODE_2736_length_1388_cov_5.168348	427	499	7	28	72	0.3888889
NODE_2742_length_1386_cov_55.384615	559	639	2	5	80	0.0625000
NODE_2742_length_1386_cov_55.384615	559	639	3	2	80	0.0250000
NODE_2742_length_1386_cov_55.384615	559	639	4	5	80	0.0625000
NODE_2742_length_1386_cov_55.384615	559	639	7	3	80	0.0375000
NODE_2742_length_1386_cov_55.384615	559	639	8	1	80	0.0125000
NODE_2742_length_1386_cov_55.384615	559	639	9	14	80	0.1750000
NODE_2742_length_1386_cov_55.384615	559	639	10	3	80	0.0375000
NODE_2742_length_1386_cov_55.384615	559	639	11	1	80	0.0125000
NODE_2742_length_1386_cov_55.384615	559	639	12	22	80	0.2750000
NODE_2742_length_1386_cov_55.384615	559	639	13	24	80	0.3000000
NODE_2742_length_1386_cov_55.384615	612	692	12	3	80	0.0375000
NODE_2742_length_1386_cov_55.384615	612	692	13	29	80	0.3625000
NODE_2742_length_1386_cov_55.384615	612	692	15	2	80	0.0250000
NODE_2742_length_1386_cov_55.384615	612	692	16	1	80	0.0125000
NODE_2742_length_1386_cov_55.384615	612	692	18	3	80	0.0375000
NODE_2742_length_1386_cov_55.384615	612	692	19	36	80	0.4500000
NODE_2742_length_1386_cov_55.384615	612	692	20	6	80	0.0750000
NODE_2742_length_1386_cov_55.384615	688	768	13	2	80	0.0250000
NODE_2742_length_1386_cov_55.384615	688	768	14	24	80	0.3000000
NODE_2742_length_1386_cov_55.384615	688	768	15	15	80	0.1875000
NODE_2742_length_1386_cov_55.384615	688	768	16	3	80	0.0375000
NODE_2742_length_1386_cov_55.384615	688	768	17	3	80	0.0375000
NODE_2742_length_1386_cov_55.384615	688	768	19	12	80	0.1500000
NODE_2742_length_1386_cov_55.384615	688	768	20	16	80	0.2000000
NODE_2742_length_1386_cov_55.384615	688	768	21	5	80	0.0625000
NODE_2742_length_1386_cov_55.384615	741	821	7	16	80	0.2000000
NODE_2742_length_1386_cov_55.384615	741	821	8	8	80	0.1000000
NODE_2742_length_1386_cov_55.384615	741	821	11	1	80	0.0125000
NODE_2742_length_1386_cov_55.384615	741	821	12	2	80	0.0250000
NODE_2742_length_1386_cov_55.384615	741	821	13	2	80	0.0250000
NODE_2742_length_1386_cov_55.384615	741	821	14	42	80	0.5250000
NODE_2742_length_1386_cov_55.384615	741	821	15	8	80	0.1000000
NODE_2742_length_1386_cov_55.384615	741	821	16	1	80	0.0125000
NODE_2744_length_1386_cov_13.181041	549	629	15	7	80	0.0875000
NODE_2744_length_1386_cov_13.181041	549	629	17	39	80	0.4875000
NODE_2744_length_1386_cov_13.181041	549	629	18	15	80	0.1875000
NODE_2744_length_1386_cov_13.181041	549	629	19	7	80	0.0875000
NODE_2744_length_1386_cov_13.181041	549	629	21	12	80	0.1500000
NODE_2744_length_1386_cov_13.181041	602	682	9	8	80	0.1000000
NODE_2744_length_1386_cov_13.181041	602	682	10	17	80	0.2125000
NODE_2744_length_1386_cov_13.181041	602	682	16	5	80	0.0625000
NODE_2744_length_1386_cov_13.181041	602	682	17	37	80	0.4625000
NODE_2744_length_1386_cov_13.181041	602	682	19	13	80	0.1625000
NODE_2748_length_1385_cov_41.636081	968	1048	9	3	80	0.0375000
NODE_2748_length_1385_cov_41.636081	968	1048	10	13	80	0.1625000
NODE_2748_length_1385_cov_41.636081	968	1048	11	9	80	0.1125000
NODE_2748_length_1385_cov_41.636081	968	1048	12	16	80	0.2000000
NODE_2748_length_1385_cov_41.636081	968	1048	13	39	80	0.4875000
NODE_2748_length_1385_cov_41.636081	1021	1101	7	10	80	0.1250000
NODE_2748_length_1385_cov_41.636081	1021	1101	8	1	80	0.0125000
NODE_2748_length_1385_cov_41.636081	1021	1101	9	22	80	0.2750000
NODE_2748_length_1385_cov_41.636081	1021	1101	10	24	80	0.3000000
NODE_2748_length_1385_cov_41.636081	1021	1101	11	17	80	0.2125000
NODE_2748_length_1385_cov_41.636081	1021	1101	12	6	80	0.0750000
NODE_2749_length_1385_cov_38.877138	707	787	4	14	80	0.1750000
NODE_2749_length_1385_cov_38.877138	707	787	5	22	80	0.2750000
NODE_2749_length_1385_cov_38.877138	707	787	6	26	80	0.3250000
NODE_2749_length_1385_cov_38.877138	707	787	8	15	80	0.1875000
NODE_2749_length_1385_cov_38.877138	707	787	9	3	80	0.0375000
NODE_2749_length_1385_cov_38.877138	760	840	4	5	80	0.0625000
NODE_2749_length_1385_cov_38.877138	760	840	5	1	80	0.0125000
NODE_2749_length_1385_cov_38.877138	760	840	6	3	80	0.0375000
NODE_2749_length_1385_cov_38.877138	760	840	8	48	80	0.6000000
NODE_2749_length_1385_cov_38.877138	760	840	9	14	80	0.1750000
NODE_2749_length_1385_cov_38.877138	760	840	15	9	80	0.1125000
NODE_2749_length_1385_cov_38.877138	836	916	11	17	80	0.2125000
NODE_2749_length_1385_cov_38.877138	836	916	12	4	80	0.0500000
NODE_2749_length_1385_cov_38.877138	836	916	13	14	80	0.1750000
NODE_2749_length_1385_cov_38.877138	836	916	14	15	80	0.1875000
NODE_2749_length_1385_cov_38.877138	836	916	15	30	80	0.3750000
NODE_2749_length_1385_cov_38.877138	889	969	9	10	80	0.1250000
NODE_2749_length_1385_cov_38.877138	889	969	10	11	80	0.1375000
NODE_2749_length_1385_cov_38.877138	889	969	11	49	80	0.6125000
NODE_2749_length_1385_cov_38.877138	889	969	12	4	80	0.0500000
NODE_2749_length_1385_cov_38.877138	889	969	13	6	80	0.0750000
NODE_2751_length_1385_cov_4.608865	844	904	0	60	60	1.0000000
NODE_2758_length_1384_cov_10.574319	865	922	7	49	57	0.8596491
NODE_2758_length_1384_cov_10.574319	865	922	9	8	57	0.1403509
NODE_2758_length_1384_cov_10.574319	933	1013	2	17	80	0.2125000
NODE_2758_length_1384_cov_10.574319	933	1013	3	56	80	0.7000000
NODE_2758_length_1384_cov_10.574319	933	1013	4	7	80	0.0875000
NODE_2758_length_1384_cov_10.574319	986	1066	1	6	80	0.0750000
NODE_2758_length_1384_cov_10.574319	986	1066	3	74	80	0.9250000
NODE_2759_length_1383_cov_10.710280	414	493	2	14	79	0.1772152
NODE_2759_length_1383_cov_10.710280	414	493	3	31	79	0.3924051
NODE_2759_length_1383_cov_10.710280	414	493	4	34	79	0.4303797
NODE_2759_length_1383_cov_10.710280	466	546	2	27	80	0.3375000
NODE_2759_length_1383_cov_10.710280	466	546	4	53	80	0.6625000
NODE_2763_length_1382_cov_12.521434	837	917	14	32	80	0.4000000
NODE_2763_length_1382_cov_12.521434	837	917	15	24	80	0.3000000
NODE_2763_length_1382_cov_12.521434	837	917	16	3	80	0.0375000
NODE_2763_length_1382_cov_12.521434	837	917	17	12	80	0.1500000
NODE_2763_length_1382_cov_12.521434	837	917	18	3	80	0.0375000
NODE_2763_length_1382_cov_12.521434	837	917	19	6	80	0.0750000
NODE_2763_length_1382_cov_12.521434	890	970	12	7	80	0.0875000
NODE_2763_length_1382_cov_12.521434	890	970	14	35	80	0.4375000
NODE_2763_length_1382_cov_12.521434	890	970	15	32	80	0.4000000
NODE_2763_length_1382_cov_12.521434	890	970	16	6	80	0.0750000
NODE_2764_length_1382_cov_5.074045	1028	1108	2	12	80	0.1500000
NODE_2764_length_1382_cov_5.074045	1028	1108	4	17	80	0.2125000
NODE_2764_length_1382_cov_5.074045	1028	1108	5	51	80	0.6375000
NODE_2764_length_1382_cov_5.074045	1081	1161	2	21	80	0.2625000
NODE_2764_length_1382_cov_5.074045	1081	1161	4	9	80	0.1125000
NODE_2764_length_1382_cov_5.074045	1081	1161	5	27	80	0.3375000
NODE_2764_length_1382_cov_5.074045	1081	1161	6	23	80	0.2875000
NODE_2771_length_1381_cov_7.796412	307	387	1	80	80	1.0000000
NODE_2771_length_1381_cov_7.796412	360	440	1	80	80	1.0000000
NODE_2775_length_1380_cov_12.804059	835	915	5	18	80	0.2250000
NODE_2775_length_1380_cov_12.804059	835	915	6	45	80	0.5625000
NODE_2775_length_1380_cov_12.804059	835	915	7	17	80	0.2125000
NODE_2775_length_1380_cov_12.804059	888	968	3	35	80	0.4375000
NODE_2775_length_1380_cov_12.804059	888	968	4	16	80	0.2000000
NODE_2775_length_1380_cov_12.804059	888	968	6	16	80	0.2000000
NODE_2775_length_1380_cov_12.804059	888	968	7	13	80	0.1625000
NODE_2782_length_1378_cov_25.362002	368	448	1	4	80	0.0500000
NODE_2782_length_1378_cov_25.362002	368	448	2	2	80	0.0250000
NODE_2782_length_1378_cov_25.362002	368	448	3	11	80	0.1375000
NODE_2782_length_1378_cov_25.362002	368	448	4	44	80	0.5500000
NODE_2782_length_1378_cov_25.362002	368	448	5	19	80	0.2375000
NODE_2782_length_1378_cov_25.362002	421	501	4	8	80	0.1000000
NODE_2782_length_1378_cov_25.362002	421	501	5	23	80	0.2875000
NODE_2782_length_1378_cov_25.362002	421	501	6	24	80	0.3000000
NODE_2782_length_1378_cov_25.362002	421	501	7	4	80	0.0500000
NODE_2782_length_1378_cov_25.362002	421	501	8	19	80	0.2375000
NODE_2782_length_1378_cov_25.362002	421	501	10	2	80	0.0250000
NODE_2782_length_1378_cov_25.362002	497	577	7	2	80	0.0250000
NODE_2782_length_1378_cov_25.362002	497	577	8	3	80	0.0375000
NODE_2782_length_1378_cov_25.362002	497	577	9	2	80	0.0250000
NODE_2782_length_1378_cov_25.362002	497	577	10	27	80	0.3375000
NODE_2782_length_1378_cov_25.362002	497	577	11	26	80	0.3250000
NODE_2782_length_1378_cov_25.362002	497	577	12	1	80	0.0125000
NODE_2782_length_1378_cov_25.362002	497	577	14	10	80	0.1250000
NODE_2782_length_1378_cov_25.362002	497	577	16	9	80	0.1125000
NODE_2782_length_1378_cov_25.362002	550	630	11	8	80	0.1000000
NODE_2782_length_1378_cov_25.362002	550	630	12	4	80	0.0500000
NODE_2782_length_1378_cov_25.362002	550	630	14	33	80	0.4125000
NODE_2782_length_1378_cov_25.362002	550	630	15	24	80	0.3000000
NODE_2782_length_1378_cov_25.362002	550	630	16	11	80	0.1375000
NODE_2783_length_1378_cov_20.508210	318	338	5	5	20	0.2500000
NODE_2783_length_1378_cov_20.508210	318	338	6	6	20	0.3000000
NODE_2783_length_1378_cov_20.508210	318	338	8	6	20	0.3000000
NODE_2783_length_1378_cov_20.508210	318	338	9	3	20	0.1500000
NODE_2783_length_1378_cov_20.508210	318	391	5	5	73	0.0684932
NODE_2783_length_1378_cov_20.508210	318	391	6	6	73	0.0821918
NODE_2783_length_1378_cov_20.508210	318	391	8	6	73	0.0821918
NODE_2783_length_1378_cov_20.508210	318	391	9	5	73	0.0684932
NODE_2783_length_1378_cov_20.508210	318	391	10	3	73	0.0410959
NODE_2783_length_1378_cov_20.508210	318	391	13	15	73	0.2054795
NODE_2783_length_1378_cov_20.508210	318	391	14	8	73	0.1095890
NODE_2783_length_1378_cov_20.508210	318	391	15	25	73	0.3424658
NODE_2785_length_1377_cov_103.832551	1259	1299	11	3	40	0.0750000
NODE_2785_length_1377_cov_103.832551	1259	1299	42	1	40	0.0250000
NODE_2785_length_1377_cov_103.832551	1259	1299	44	3	40	0.0750000
NODE_2785_length_1377_cov_103.832551	1259	1299	45	1	40	0.0250000
NODE_2785_length_1377_cov_103.832551	1259	1299	46	2	40	0.0500000
NODE_2785_length_1377_cov_103.832551	1259	1299	47	2	40	0.0500000
NODE_2785_length_1377_cov_103.832551	1259	1299	48	1	40	0.0250000
NODE_2785_length_1377_cov_103.832551	1259	1299	50	1	40	0.0250000
NODE_2785_length_1377_cov_103.832551	1259	1299	51	1	40	0.0250000
NODE_2785_length_1377_cov_103.832551	1259	1299	53	2	40	0.0500000
NODE_2785_length_1377_cov_103.832551	1259	1299	58	3	40	0.0750000
NODE_2785_length_1377_cov_103.832551	1259	1299	60	1	40	0.0250000
NODE_2785_length_1377_cov_103.832551	1259	1299	61	6	40	0.1500000
NODE_2785_length_1377_cov_103.832551	1259	1299	63	1	40	0.0250000
NODE_2785_length_1377_cov_103.832551	1259	1299	66	1	40	0.0250000
NODE_2785_length_1377_cov_103.832551	1259	1299	68	3	40	0.0750000
NODE_2785_length_1377_cov_103.832551	1259	1299	73	8	40	0.2000000
NODE_2788_length_1376_cov_7.967110	904	984	2	8	80	0.1000000
NODE_2788_length_1376_cov_7.967110	904	984	3	9	80	0.1125000
NODE_2788_length_1376_cov_7.967110	904	984	4	1	80	0.0125000
NODE_2788_length_1376_cov_7.967110	904	984	5	15	80	0.1875000
NODE_2788_length_1376_cov_7.967110	904	984	6	8	80	0.1000000
NODE_2788_length_1376_cov_7.967110	904	984	7	39	80	0.4875000
NODE_2788_length_1376_cov_7.967110	957	1037	6	13	80	0.1625000
NODE_2788_length_1376_cov_7.967110	957	1037	7	41	80	0.5125000
NODE_2788_length_1376_cov_7.967110	957	1037	8	26	80	0.3250000
NODE_2798_length_1373_cov_52.691523	524	606	34	5	82	0.0609756
NODE_2798_length_1373_cov_52.691523	524	606	39	4	82	0.0487805
NODE_2798_length_1373_cov_52.691523	524	606	40	1	82	0.0121951
NODE_2798_length_1373_cov_52.691523	524	606	45	1	82	0.0121951
NODE_2798_length_1373_cov_52.691523	524	606	46	5	82	0.0609756
NODE_2798_length_1373_cov_52.691523	524	606	47	3	82	0.0365854
NODE_2798_length_1373_cov_52.691523	524	606	49	4	82	0.0487805
NODE_2798_length_1373_cov_52.691523	524	606	50	31	82	0.3780488
NODE_2798_length_1373_cov_52.691523	524	606	51	9	82	0.1097561
NODE_2798_length_1373_cov_52.691523	524	606	52	1	82	0.0121951
NODE_2798_length_1373_cov_52.691523	524	606	54	1	82	0.0121951
NODE_2798_length_1373_cov_52.691523	524	606	55	5	82	0.0609756
NODE_2798_length_1373_cov_52.691523	524	606	56	5	82	0.0609756
NODE_2798_length_1373_cov_52.691523	524	606	57	7	82	0.0853659
NODE_2798_length_1373_cov_52.691523	579	659	33	4	80	0.0500000
NODE_2798_length_1373_cov_52.691523	579	659	34	1	80	0.0125000
NODE_2798_length_1373_cov_52.691523	579	659	35	1	80	0.0125000
NODE_2798_length_1373_cov_52.691523	579	659	36	3	80	0.0375000
NODE_2798_length_1373_cov_52.691523	579	659	37	11	80	0.1375000
NODE_2798_length_1373_cov_52.691523	579	659	39	3	80	0.0375000
NODE_2798_length_1373_cov_52.691523	579	659	40	12	80	0.1500000
NODE_2798_length_1373_cov_52.691523	579	659	41	2	80	0.0250000
NODE_2798_length_1373_cov_52.691523	579	659	42	1	80	0.0125000
NODE_2798_length_1373_cov_52.691523	579	659	44	7	80	0.0875000
NODE_2798_length_1373_cov_52.691523	579	659	45	4	80	0.0500000
NODE_2798_length_1373_cov_52.691523	579	659	50	4	80	0.0500000
NODE_2798_length_1373_cov_52.691523	579	659	51	8	80	0.1000000
NODE_2798_length_1373_cov_52.691523	579	659	52	1	80	0.0125000
NODE_2798_length_1373_cov_52.691523	579	659	54	1	80	0.0125000
NODE_2798_length_1373_cov_52.691523	579	659	55	5	80	0.0625000
NODE_2798_length_1373_cov_52.691523	579	659	56	5	80	0.0625000
NODE_2798_length_1373_cov_52.691523	579	659	57	7	80	0.0875000
NODE_2799_length_1373_cov_20.880691	987	1067	5	24	80	0.3000000
NODE_2799_length_1373_cov_20.880691	987	1067	6	17	80	0.2125000
NODE_2799_length_1373_cov_20.880691	987	1067	7	15	80	0.1875000
NODE_2799_length_1373_cov_20.880691	987	1067	8	1	80	0.0125000
NODE_2799_length_1373_cov_20.880691	987	1067	9	9	80	0.1125000
NODE_2799_length_1373_cov_20.880691	987	1067	10	14	80	0.1750000
NODE_2799_length_1373_cov_20.880691	1116	1195	16	2	79	0.0253165
NODE_2799_length_1373_cov_20.880691	1116	1195	18	1	79	0.0126582
NODE_2799_length_1373_cov_20.880691	1116	1195	20	2	79	0.0253165
NODE_2799_length_1373_cov_20.880691	1116	1195	21	3	79	0.0379747
NODE_2799_length_1373_cov_20.880691	1116	1195	22	3	79	0.0379747
NODE_2799_length_1373_cov_20.880691	1116	1195	23	3	79	0.0379747
NODE_2799_length_1373_cov_20.880691	1116	1195	24	22	79	0.2784810
NODE_2799_length_1373_cov_20.880691	1116	1195	25	3	79	0.0379747
NODE_2799_length_1373_cov_20.880691	1116	1195	27	7	79	0.0886076
NODE_2799_length_1373_cov_20.880691	1116	1195	28	8	79	0.1012658
NODE_2799_length_1373_cov_20.880691	1116	1195	29	6	79	0.0759494
NODE_2799_length_1373_cov_20.880691	1116	1195	30	17	79	0.2151899
NODE_2799_length_1373_cov_20.880691	1116	1195	31	1	79	0.0126582
NODE_2799_length_1373_cov_20.880691	1116	1195	32	1	79	0.0126582
NODE_2799_length_1373_cov_20.880691	1168	1248	24	45	80	0.5625000
NODE_2799_length_1373_cov_20.880691	1168	1248	25	9	80	0.1125000
NODE_2799_length_1373_cov_20.880691	1168	1248	27	6	80	0.0750000
NODE_2799_length_1373_cov_20.880691	1168	1248	28	8	80	0.1000000
NODE_2799_length_1373_cov_20.880691	1168	1248	30	10	80	0.1250000
NODE_2799_length_1373_cov_20.880691	1168	1248	31	1	80	0.0125000
NODE_2799_length_1373_cov_20.880691	1168	1248	32	1	80	0.0125000
NODE_2800_length_1373_cov_12.694662	94	167	3	29	73	0.3972603
NODE_2800_length_1373_cov_12.694662	94	167	4	8	73	0.1095890
NODE_2800_length_1373_cov_12.694662	94	167	7	36	73	0.4931507
NODE_2800_length_1373_cov_12.694662	140	224	4	19	84	0.2261905
NODE_2800_length_1373_cov_12.694662	140	224	7	65	84	0.7738096
NODE_2800_length_1373_cov_12.694662	1214	1286	1	16	72	0.2222222
NODE_2800_length_1373_cov_12.694662	1214	1286	2	56	72	0.7777778
NODE_2800_length_1373_cov_12.694662	1267	1339	1	9	72	0.1250000
NODE_2800_length_1373_cov_12.694662	1267	1339	2	63	72	0.8750000
NODE_2801_length_1372_cov_25.408484	665	745	24	12	80	0.1500000
NODE_2801_length_1372_cov_25.408484	665	745	25	4	80	0.0500000
NODE_2801_length_1372_cov_25.408484	665	745	26	11	80	0.1375000
NODE_2801_length_1372_cov_25.408484	665	745	27	1	80	0.0125000
NODE_2801_length_1372_cov_25.408484	665	745	28	27	80	0.3375000
NODE_2801_length_1372_cov_25.408484	665	745	29	23	80	0.2875000
NODE_2801_length_1372_cov_25.408484	665	745	30	2	80	0.0250000
NODE_2801_length_1372_cov_25.408484	718	798	24	9	80	0.1125000
NODE_2801_length_1372_cov_25.408484	718	798	25	11	80	0.1375000
NODE_2801_length_1372_cov_25.408484	718	798	26	8	80	0.1000000
NODE_2801_length_1372_cov_25.408484	718	798	27	1	80	0.0125000
NODE_2801_length_1372_cov_25.408484	718	798	28	26	80	0.3250000
NODE_2801_length_1372_cov_25.408484	718	798	29	14	80	0.1750000
NODE_2801_length_1372_cov_25.408484	718	798	30	3	80	0.0375000
NODE_2801_length_1372_cov_25.408484	718	798	31	8	80	0.1000000
NODE_2802_length_1372_cov_17.123331	647	727	7	12	80	0.1500000
NODE_2802_length_1372_cov_17.123331	647	727	8	8	80	0.1000000
NODE_2802_length_1372_cov_17.123331	647	727	9	60	80	0.7500000
NODE_2802_length_1372_cov_17.123331	700	780	1	5	80	0.0625000
NODE_2802_length_1372_cov_17.123331	700	780	2	5	80	0.0625000
NODE_2802_length_1372_cov_17.123331	700	780	3	10	80	0.1250000
NODE_2802_length_1372_cov_17.123331	700	780	4	12	80	0.1500000
NODE_2802_length_1372_cov_17.123331	700	780	5	7	80	0.0875000
NODE_2802_length_1372_cov_17.123331	700	780	6	10	80	0.1250000
NODE_2802_length_1372_cov_17.123331	700	780	7	16	80	0.2000000
NODE_2802_length_1372_cov_17.123331	700	780	8	6	80	0.0750000
NODE_2802_length_1372_cov_17.123331	700	780	9	9	80	0.1125000
NODE_2802_length_1372_cov_17.123331	776	856	0	65	80	0.8125000
NODE_2802_length_1372_cov_17.123331	776	856	1	15	80	0.1875000
NODE_2802_length_1372_cov_17.123331	829	909	0	80	80	1.0000000
NODE_2803_length_1372_cov_14.418696	211	291	5	23	80	0.2875000
NODE_2803_length_1372_cov_14.418696	211	291	7	3	80	0.0375000
NODE_2803_length_1372_cov_14.418696	211	291	8	35	80	0.4375000
NODE_2803_length_1372_cov_14.418696	211	291	10	19	80	0.2375000
NODE_2803_length_1372_cov_14.418696	264	344	6	18	80	0.2250000
NODE_2803_length_1372_cov_14.418696	264	344	7	2	80	0.0250000
NODE_2803_length_1372_cov_14.418696	264	344	8	18	80	0.2250000
NODE_2803_length_1372_cov_14.418696	264	344	10	42	80	0.5250000
NODE_2806_length_1371_cov_39.366352	715	795	16	1	80	0.0125000
NODE_2806_length_1371_cov_39.366352	715	795	17	7	80	0.0875000
NODE_2806_length_1371_cov_39.366352	715	795	18	2	80	0.0250000
NODE_2806_length_1371_cov_39.366352	715	795	19	5	80	0.0625000
NODE_2806_length_1371_cov_39.366352	715	795	20	1	80	0.0125000
NODE_2806_length_1371_cov_39.366352	715	795	21	8	80	0.1000000
NODE_2806_length_1371_cov_39.366352	715	795	23	17	80	0.2125000
NODE_2806_length_1371_cov_39.366352	715	795	24	8	80	0.1000000
NODE_2806_length_1371_cov_39.366352	715	795	25	1	80	0.0125000
NODE_2806_length_1371_cov_39.366352	715	795	26	2	80	0.0250000
NODE_2806_length_1371_cov_39.366352	715	795	27	8	80	0.1000000
NODE_2806_length_1371_cov_39.366352	715	795	28	6	80	0.0750000
NODE_2806_length_1371_cov_39.366352	715	795	29	1	80	0.0125000
NODE_2806_length_1371_cov_39.366352	715	795	30	1	80	0.0125000
NODE_2806_length_1371_cov_39.366352	715	795	33	2	80	0.0250000
NODE_2806_length_1371_cov_39.366352	715	795	34	2	80	0.0250000
NODE_2806_length_1371_cov_39.366352	715	795	36	8	80	0.1000000
NODE_2806_length_1371_cov_39.366352	768	848	27	8	80	0.1000000
NODE_2806_length_1371_cov_39.366352	768	848	28	5	80	0.0625000
NODE_2806_length_1371_cov_39.366352	768	848	29	1	80	0.0125000
NODE_2806_length_1371_cov_39.366352	768	848	30	1	80	0.0125000
NODE_2806_length_1371_cov_39.366352	768	848	33	2	80	0.0250000
NODE_2806_length_1371_cov_39.366352	768	848	34	2	80	0.0250000
NODE_2806_length_1371_cov_39.366352	768	848	36	9	80	0.1125000
NODE_2806_length_1371_cov_39.366352	768	848	38	17	80	0.2125000
NODE_2806_length_1371_cov_39.366352	768	848	39	3	80	0.0375000
NODE_2806_length_1371_cov_39.366352	768	848	40	4	80	0.0500000
NODE_2806_length_1371_cov_39.366352	768	848	41	8	80	0.1000000
NODE_2806_length_1371_cov_39.366352	768	848	42	2	80	0.0250000
NODE_2806_length_1371_cov_39.366352	768	848	44	18	80	0.2250000
NODE_2807_length_1371_cov_36.961478	371	455	0	69	84	0.8214286
NODE_2807_length_1371_cov_36.961478	371	455	3	15	84	0.1785714
NODE_2807_length_1371_cov_36.961478	424	508	0	16	84	0.1904762
NODE_2807_length_1371_cov_36.961478	424	508	3	65	84	0.7738096
NODE_2807_length_1371_cov_36.961478	424	508	5	3	84	0.0357143
NODE_2807_length_1371_cov_36.961478	504	584	3	1	80	0.0125000
NODE_2807_length_1371_cov_36.961478	504	584	5	19	80	0.2375000
NODE_2807_length_1371_cov_36.961478	504	584	6	21	80	0.2625000
NODE_2807_length_1371_cov_36.961478	504	584	8	8	80	0.1000000
NODE_2807_length_1371_cov_36.961478	504	584	10	4	80	0.0500000
NODE_2807_length_1371_cov_36.961478	504	584	11	10	80	0.1250000
NODE_2807_length_1371_cov_36.961478	504	584	12	4	80	0.0500000
NODE_2807_length_1371_cov_36.961478	504	584	13	13	80	0.1625000
NODE_2807_length_1371_cov_36.961478	557	637	11	16	80	0.2000000
NODE_2807_length_1371_cov_36.961478	557	637	12	24	80	0.3000000
NODE_2807_length_1371_cov_36.961478	557	637	13	31	80	0.3875000
NODE_2807_length_1371_cov_36.961478	557	637	14	2	80	0.0250000
NODE_2807_length_1371_cov_36.961478	557	637	15	7	80	0.0875000
NODE_2808_length_1371_cov_16.944182	459	539	7	6	80	0.0750000
NODE_2808_length_1371_cov_16.944182	459	539	8	18	80	0.2250000
NODE_2808_length_1371_cov_16.944182	459	539	9	22	80	0.2750000
NODE_2808_length_1371_cov_16.944182	459	539	10	21	80	0.2625000
NODE_2808_length_1371_cov_16.944182	459	539	12	13	80	0.1625000
NODE_2808_length_1371_cov_16.944182	512	592	10	19	80	0.2375000
NODE_2808_length_1371_cov_16.944182	512	592	11	4	80	0.0500000
NODE_2808_length_1371_cov_16.944182	512	592	12	39	80	0.4875000
NODE_2808_length_1371_cov_16.944182	512	592	13	3	80	0.0375000
NODE_2808_length_1371_cov_16.944182	512	592	14	15	80	0.1875000
NODE_2808_length_1371_cov_16.944182	588	668	10	13	80	0.1625000
NODE_2808_length_1371_cov_16.944182	588	668	11	3	80	0.0375000
NODE_2808_length_1371_cov_16.944182	588	668	12	15	80	0.1875000
NODE_2808_length_1371_cov_16.944182	588	668	13	22	80	0.2750000
NODE_2808_length_1371_cov_16.944182	588	668	14	18	80	0.2250000
NODE_2808_length_1371_cov_16.944182	588	668	15	9	80	0.1125000
NODE_2808_length_1371_cov_16.944182	641	721	5	14	80	0.1750000
NODE_2808_length_1371_cov_16.944182	641	721	7	3	80	0.0375000
NODE_2808_length_1371_cov_16.944182	641	721	8	22	80	0.2750000
NODE_2808_length_1371_cov_16.944182	641	721	9	6	80	0.0750000
NODE_2808_length_1371_cov_16.944182	641	721	10	21	80	0.2625000
NODE_2808_length_1371_cov_16.944182	641	721	11	3	80	0.0375000
NODE_2808_length_1371_cov_16.944182	641	721	13	2	80	0.0250000
NODE_2808_length_1371_cov_16.944182	641	721	15	9	80	0.1125000
NODE_2812_length_1370_cov_11.627065	502	582	0	61	80	0.7625000
NODE_2812_length_1370_cov_11.627065	502	582	2	19	80	0.2375000
NODE_2812_length_1370_cov_11.627065	555	635	0	8	80	0.1000000
NODE_2812_length_1370_cov_11.627065	555	635	2	72	80	0.9000000
NODE_2812_length_1370_cov_11.627065	631	711	2	15	80	0.1875000
NODE_2812_length_1370_cov_11.627065	631	711	4	33	80	0.4125000
NODE_2812_length_1370_cov_11.627065	631	711	6	32	80	0.4000000
NODE_2812_length_1370_cov_11.627065	684	764	4	51	80	0.6375000
NODE_2812_length_1370_cov_11.627065	684	764	6	29	80	0.3625000
NODE_2813_length_1369_cov_27.937795	597	677	6	43	80	0.5375000
NODE_2813_length_1369_cov_27.937795	597	677	9	37	80	0.4625000
NODE_2813_length_1369_cov_27.937795	650	730	3	5	80	0.0625000
NODE_2813_length_1369_cov_27.937795	650	730	6	39	80	0.4875000
NODE_2813_length_1369_cov_27.937795	650	730	9	36	80	0.4500000
NODE_2820_length_1368_cov_35.148148	546	626	5	12	80	0.1500000
NODE_2820_length_1368_cov_35.148148	546	626	6	17	80	0.2125000
NODE_2820_length_1368_cov_35.148148	546	626	7	9	80	0.1125000
NODE_2820_length_1368_cov_35.148148	546	626	8	42	80	0.5250000
NODE_2820_length_1368_cov_35.148148	599	679	3	18	80	0.2250000
NODE_2820_length_1368_cov_35.148148	599	679	4	5	80	0.0625000
NODE_2820_length_1368_cov_35.148148	599	679	5	42	80	0.5250000
NODE_2820_length_1368_cov_35.148148	599	679	6	15	80	0.1875000
NODE_2821_length_1368_cov_27.847912	486	559	5	2	73	0.0273973
NODE_2821_length_1368_cov_27.847912	486	559	6	14	73	0.1917808
NODE_2821_length_1368_cov_27.847912	486	559	8	17	73	0.2328767
NODE_2821_length_1368_cov_27.847912	486	559	10	3	73	0.0410959
NODE_2821_length_1368_cov_27.847912	486	559	12	16	73	0.2191781
NODE_2821_length_1368_cov_27.847912	486	559	14	4	73	0.0547945
NODE_2821_length_1368_cov_27.847912	486	559	16	8	73	0.1095890
NODE_2821_length_1368_cov_27.847912	486	559	17	9	73	0.1232877
NODE_2821_length_1368_cov_27.847912	532	612	12	6	80	0.0750000
NODE_2821_length_1368_cov_27.847912	532	612	14	4	80	0.0500000
NODE_2821_length_1368_cov_27.847912	532	612	16	14	80	0.1750000
NODE_2821_length_1368_cov_27.847912	532	612	17	21	80	0.2625000
NODE_2821_length_1368_cov_27.847912	532	612	18	3	80	0.0375000
NODE_2821_length_1368_cov_27.847912	532	612	20	5	80	0.0625000
NODE_2821_length_1368_cov_27.847912	532	612	22	2	80	0.0250000
NODE_2821_length_1368_cov_27.847912	532	612	23	9	80	0.1125000
NODE_2821_length_1368_cov_27.847912	532	612	24	10	80	0.1250000
NODE_2821_length_1368_cov_27.847912	532	612	26	6	80	0.0750000
NODE_2821_length_1368_cov_27.847912	608	688	26	20	80	0.2500000
NODE_2821_length_1368_cov_27.847912	608	688	27	7	80	0.0875000
NODE_2821_length_1368_cov_27.847912	608	688	28	29	80	0.3625000
NODE_2821_length_1368_cov_27.847912	608	688	29	1	80	0.0125000
NODE_2821_length_1368_cov_27.847912	608	688	30	18	80	0.2250000
NODE_2821_length_1368_cov_27.847912	608	688	31	4	80	0.0500000
NODE_2821_length_1368_cov_27.847912	608	688	32	1	80	0.0125000
NODE_2821_length_1368_cov_27.847912	661	741	23	7	80	0.0875000
NODE_2821_length_1368_cov_27.847912	661	741	24	12	80	0.1500000
NODE_2821_length_1368_cov_27.847912	661	741	25	6	80	0.0750000
NODE_2821_length_1368_cov_27.847912	661	741	26	26	80	0.3250000
NODE_2821_length_1368_cov_27.847912	661	741	28	25	80	0.3125000
NODE_2821_length_1368_cov_27.847912	661	741	29	1	80	0.0125000
NODE_2821_length_1368_cov_27.847912	661	741	30	3	80	0.0375000
NODE_2822_length_1368_cov_26.832151	458	538	8	29	80	0.3625000
NODE_2822_length_1368_cov_26.832151	458	538	9	11	80	0.1375000
NODE_2822_length_1368_cov_26.832151	458	538	11	6	80	0.0750000
NODE_2822_length_1368_cov_26.832151	458	538	12	8	80	0.1000000
NODE_2822_length_1368_cov_26.832151	458	538	14	10	80	0.1250000
NODE_2822_length_1368_cov_26.832151	458	538	16	3	80	0.0375000
NODE_2822_length_1368_cov_26.832151	458	538	17	13	80	0.1625000
NODE_2822_length_1368_cov_26.832151	511	591	11	5	80	0.0625000
NODE_2822_length_1368_cov_26.832151	511	591	12	1	80	0.0125000
NODE_2822_length_1368_cov_26.832151	511	591	14	5	80	0.0625000
NODE_2822_length_1368_cov_26.832151	511	591	16	3	80	0.0375000
NODE_2822_length_1368_cov_26.832151	511	591	17	13	80	0.1625000
NODE_2822_length_1368_cov_26.832151	511	591	18	2	80	0.0250000
NODE_2822_length_1368_cov_26.832151	511	591	19	22	80	0.2750000
NODE_2822_length_1368_cov_26.832151	511	591	20	19	80	0.2375000
NODE_2822_length_1368_cov_26.832151	511	591	21	10	80	0.1250000
NODE_2822_length_1368_cov_26.832151	587	667	18	6	80	0.0750000
NODE_2822_length_1368_cov_26.832151	587	667	19	8	80	0.1000000
NODE_2822_length_1368_cov_26.832151	587	667	21	8	80	0.1000000
NODE_2822_length_1368_cov_26.832151	587	667	22	16	80	0.2000000
NODE_2822_length_1368_cov_26.832151	587	667	23	7	80	0.0875000
NODE_2822_length_1368_cov_26.832151	587	667	24	30	80	0.3750000
NODE_2822_length_1368_cov_26.832151	587	667	26	5	80	0.0625000
NODE_2822_length_1368_cov_26.832151	640	720	19	1	80	0.0125000
NODE_2822_length_1368_cov_26.832151	640	720	20	1	80	0.0125000
NODE_2822_length_1368_cov_26.832151	640	720	21	8	80	0.1000000
NODE_2822_length_1368_cov_26.832151	640	720	22	29	80	0.3625000
NODE_2822_length_1368_cov_26.832151	640	720	23	30	80	0.3750000
NODE_2822_length_1368_cov_26.832151	640	720	24	11	80	0.1375000
NODE_2823_length_1368_cov_18.205674	603	683	6	11	80	0.1375000
NODE_2823_length_1368_cov_18.205674	603	683	8	12	80	0.1500000
NODE_2823_length_1368_cov_18.205674	603	683	9	6	80	0.0750000
NODE_2823_length_1368_cov_18.205674	603	683	10	4	80	0.0500000
NODE_2823_length_1368_cov_18.205674	603	683	11	9	80	0.1125000
NODE_2823_length_1368_cov_18.205674	603	683	12	30	80	0.3750000
NODE_2823_length_1368_cov_18.205674	603	683	13	8	80	0.1000000
NODE_2823_length_1368_cov_18.205674	656	736	7	24	80	0.3000000
NODE_2823_length_1368_cov_18.205674	656	736	8	22	80	0.2750000
NODE_2823_length_1368_cov_18.205674	656	736	9	13	80	0.1625000
NODE_2823_length_1368_cov_18.205674	656	736	11	1	80	0.0125000
NODE_2823_length_1368_cov_18.205674	656	736	12	18	80	0.2250000
NODE_2823_length_1368_cov_18.205674	656	736	13	2	80	0.0250000
NODE_2826_length_1367_cov_576.769716	799	879	514	1	80	0.0125000
NODE_2826_length_1367_cov_576.769716	799	879	516	1	80	0.0125000
NODE_2826_length_1367_cov_576.769716	799	879	517	1	80	0.0125000
NODE_2826_length_1367_cov_576.769716	799	879	528	1	80	0.0125000
NODE_2826_length_1367_cov_576.769716	799	879	535	1	80	0.0125000
NODE_2826_length_1367_cov_576.769716	799	879	539	1	80	0.0125000
NODE_2826_length_1367_cov_576.769716	799	879	553	1	80	0.0125000
NODE_2826_length_1367_cov_576.769716	799	879	556	1	80	0.0125000
NODE_2826_length_1367_cov_576.769716	799	879	559	1	80	0.0125000
NODE_2826_length_1367_cov_576.769716	799	879	561	1	80	0.0125000
NODE_2826_length_1367_cov_576.769716	799	879	562	1	80	0.0125000
NODE_2826_length_1367_cov_576.769716	799	879	563	2	80	0.0250000
NODE_2826_length_1367_cov_576.769716	799	879	564	3	80	0.0375000
NODE_2826_length_1367_cov_576.769716	799	879	565	2	80	0.0250000
NODE_2826_length_1367_cov_576.769716	799	879	566	1	80	0.0125000
NODE_2826_length_1367_cov_576.769716	799	879	568	2	80	0.0250000
NODE_2826_length_1367_cov_576.769716	799	879	569	2	80	0.0250000
NODE_2826_length_1367_cov_576.769716	799	879	584	1	80	0.0125000
NODE_2826_length_1367_cov_576.769716	799	879	592	1	80	0.0125000
NODE_2826_length_1367_cov_576.769716	799	879	595	1	80	0.0125000
NODE_2826_length_1367_cov_576.769716	799	879	596	1	80	0.0125000
NODE_2826_length_1367_cov_576.769716	799	879	608	1	80	0.0125000
NODE_2826_length_1367_cov_576.769716	799	879	626	1	80	0.0125000
NODE_2826_length_1367_cov_576.769716	799	879	630	2	80	0.0250000
NODE_2826_length_1367_cov_576.769716	799	879	663	1	80	0.0125000
NODE_2826_length_1367_cov_576.769716	799	879	674	1	80	0.0125000
NODE_2826_length_1367_cov_576.769716	799	879	684	1	80	0.0125000
NODE_2826_length_1367_cov_576.769716	799	879	691	1	80	0.0125000
NODE_2826_length_1367_cov_576.769716	799	879	694	1	80	0.0125000
NODE_2826_length_1367_cov_576.769716	799	879	709	1	80	0.0125000
NODE_2826_length_1367_cov_576.769716	799	879	718	1	80	0.0125000
NODE_2826_length_1367_cov_576.769716	799	879	724	1	80	0.0125000
NODE_2826_length_1367_cov_576.769716	799	879	753	1	80	0.0125000
NODE_2826_length_1367_cov_576.769716	799	879	764	1	80	0.0125000
NODE_2826_length_1367_cov_576.769716	799	879	771	1	80	0.0125000
NODE_2826_length_1367_cov_576.769716	799	879	774	1	80	0.0125000
NODE_2826_length_1367_cov_576.769716	799	879	775	1	80	0.0125000
NODE_2826_length_1367_cov_576.769716	799	879	779	1	80	0.0125000
NODE_2826_length_1367_cov_576.769716	799	879	780	1	80	0.0125000
NODE_2826_length_1367_cov_576.769716	799	879	781	1	80	0.0125000
NODE_2826_length_1367_cov_576.769716	799	879	783	1	80	0.0125000
NODE_2826_length_1367_cov_576.769716	799	879	784	1	80	0.0125000
NODE_2826_length_1367_cov_576.769716	799	879	786	1	80	0.0125000
NODE_2826_length_1367_cov_576.769716	799	879	789	1	80	0.0125000
NODE_2826_length_1367_cov_576.769716	799	879	790	1	80	0.0125000
NODE_2826_length_1367_cov_576.769716	799	879	794	1	80	0.0125000
NODE_2826_length_1367_cov_576.769716	799	879	798	1	80	0.0125000
NODE_2826_length_1367_cov_576.769716	799	879	814	1	80	0.0125000
NODE_2826_length_1367_cov_576.769716	799	879	817	1	80	0.0125000
NODE_2826_length_1367_cov_576.769716	799	879	823	1	80	0.0125000
NODE_2826_length_1367_cov_576.769716	799	879	825	2	80	0.0250000
NODE_2826_length_1367_cov_576.769716	799	879	828	1	80	0.0125000
NODE_2826_length_1367_cov_576.769716	799	879	829	1	80	0.0125000
NODE_2826_length_1367_cov_576.769716	799	879	830	1	80	0.0125000
NODE_2826_length_1367_cov_576.769716	799	879	834	1	80	0.0125000
NODE_2826_length_1367_cov_576.769716	799	879	837	1	80	0.0125000
NODE_2826_length_1367_cov_576.769716	799	879	844	1	80	0.0125000
NODE_2826_length_1367_cov_576.769716	799	879	850	1	80	0.0125000
NODE_2826_length_1367_cov_576.769716	799	879	857	1	80	0.0125000
NODE_2826_length_1367_cov_576.769716	799	879	860	1	80	0.0125000
NODE_2826_length_1367_cov_576.769716	799	879	863	1	80	0.0125000
NODE_2826_length_1367_cov_576.769716	799	879	865	1	80	0.0125000
NODE_2826_length_1367_cov_576.769716	799	879	871	1	80	0.0125000
NODE_2826_length_1367_cov_576.769716	799	879	880	1	80	0.0125000
NODE_2826_length_1367_cov_576.769716	799	879	881	1	80	0.0125000
NODE_2826_length_1367_cov_576.769716	799	879	883	1	80	0.0125000
NODE_2826_length_1367_cov_576.769716	799	879	889	1	80	0.0125000
NODE_2826_length_1367_cov_576.769716	799	879	898	1	80	0.0125000
NODE_2826_length_1367_cov_576.769716	799	879	899	1	80	0.0125000
NODE_2826_length_1367_cov_576.769716	799	879	901	1	80	0.0125000
NODE_2826_length_1367_cov_576.769716	799	879	902	2	80	0.0250000
NODE_2826_length_1367_cov_576.769716	852	932	796	1	80	0.0125000
NODE_2826_length_1367_cov_576.769716	852	932	798	1	80	0.0125000
NODE_2826_length_1367_cov_576.769716	852	932	814	1	80	0.0125000
NODE_2826_length_1367_cov_576.769716	852	932	817	1	80	0.0125000
NODE_2826_length_1367_cov_576.769716	852	932	823	2	80	0.0250000
NODE_2826_length_1367_cov_576.769716	852	932	825	2	80	0.0250000
NODE_2826_length_1367_cov_576.769716	852	932	828	1	80	0.0125000
NODE_2826_length_1367_cov_576.769716	852	932	829	1	80	0.0125000
NODE_2826_length_1367_cov_576.769716	852	932	830	1	80	0.0125000
NODE_2826_length_1367_cov_576.769716	852	932	834	1	80	0.0125000
NODE_2826_length_1367_cov_576.769716	852	932	836	1	80	0.0125000
NODE_2826_length_1367_cov_576.769716	852	932	837	2	80	0.0250000
NODE_2826_length_1367_cov_576.769716	852	932	843	1	80	0.0125000
NODE_2826_length_1367_cov_576.769716	852	932	844	1	80	0.0125000
NODE_2826_length_1367_cov_576.769716	852	932	850	1	80	0.0125000
NODE_2826_length_1367_cov_576.769716	852	932	855	3	80	0.0375000
NODE_2826_length_1367_cov_576.769716	852	932	857	2	80	0.0250000
NODE_2826_length_1367_cov_576.769716	852	932	860	2	80	0.0250000
NODE_2826_length_1367_cov_576.769716	852	932	861	1	80	0.0125000
NODE_2826_length_1367_cov_576.769716	852	932	863	2	80	0.0250000
NODE_2826_length_1367_cov_576.769716	852	932	864	2	80	0.0250000
NODE_2826_length_1367_cov_576.769716	852	932	865	1	80	0.0125000
NODE_2826_length_1367_cov_576.769716	852	932	866	1	80	0.0125000
NODE_2826_length_1367_cov_576.769716	852	932	868	2	80	0.0250000
NODE_2826_length_1367_cov_576.769716	852	932	869	1	80	0.0125000
NODE_2826_length_1367_cov_576.769716	852	932	870	2	80	0.0250000
NODE_2826_length_1367_cov_576.769716	852	932	871	1	80	0.0125000
NODE_2826_length_1367_cov_576.769716	852	932	873	4	80	0.0500000
NODE_2826_length_1367_cov_576.769716	852	932	874	1	80	0.0125000
NODE_2826_length_1367_cov_576.769716	852	932	876	1	80	0.0125000
NODE_2826_length_1367_cov_576.769716	852	932	877	1	80	0.0125000
NODE_2826_length_1367_cov_576.769716	852	932	880	1	80	0.0125000
NODE_2826_length_1367_cov_576.769716	852	932	881	1	80	0.0125000
NODE_2826_length_1367_cov_576.769716	852	932	883	1	80	0.0125000
NODE_2826_length_1367_cov_576.769716	852	932	885	1	80	0.0125000
NODE_2826_length_1367_cov_576.769716	852	932	889	2	80	0.0250000
NODE_2826_length_1367_cov_576.769716	852	932	892	1	80	0.0125000
NODE_2826_length_1367_cov_576.769716	852	932	894	2	80	0.0250000
NODE_2826_length_1367_cov_576.769716	852	932	895	2	80	0.0250000
NODE_2826_length_1367_cov_576.769716	852	932	897	4	80	0.0500000
NODE_2826_length_1367_cov_576.769716	852	932	898	1	80	0.0125000
NODE_2826_length_1367_cov_576.769716	852	932	899	2	80	0.0250000
NODE_2826_length_1367_cov_576.769716	852	932	901	2	80	0.0250000
NODE_2826_length_1367_cov_576.769716	852	932	902	3	80	0.0375000
NODE_2826_length_1367_cov_576.769716	852	932	903	2	80	0.0250000
NODE_2826_length_1367_cov_576.769716	852	932	904	1	80	0.0125000
NODE_2826_length_1367_cov_576.769716	852	932	906	1	80	0.0125000
NODE_2826_length_1367_cov_576.769716	852	932	909	1	80	0.0125000
NODE_2826_length_1367_cov_576.769716	852	932	910	1	80	0.0125000
NODE_2826_length_1367_cov_576.769716	852	932	911	1	80	0.0125000
NODE_2826_length_1367_cov_576.769716	852	932	912	1	80	0.0125000
NODE_2826_length_1367_cov_576.769716	852	932	913	1	80	0.0125000
NODE_2826_length_1367_cov_576.769716	852	932	915	1	80	0.0125000
NODE_2826_length_1367_cov_576.769716	852	932	917	1	80	0.0125000
NODE_2826_length_1367_cov_576.769716	852	932	920	1	80	0.0125000
NODE_2826_length_1367_cov_576.769716	900	980	643	2	80	0.0250000
NODE_2826_length_1367_cov_576.769716	900	980	648	1	80	0.0125000
NODE_2826_length_1367_cov_576.769716	900	980	665	1	80	0.0125000
NODE_2826_length_1367_cov_576.769716	900	980	680	1	80	0.0125000
NODE_2826_length_1367_cov_576.769716	900	980	681	1	80	0.0125000
NODE_2826_length_1367_cov_576.769716	900	980	682	1	80	0.0125000
NODE_2826_length_1367_cov_576.769716	900	980	686	1	80	0.0125000
NODE_2826_length_1367_cov_576.769716	900	980	690	1	80	0.0125000
NODE_2826_length_1367_cov_576.769716	900	980	691	1	80	0.0125000
NODE_2826_length_1367_cov_576.769716	900	980	692	1	80	0.0125000
NODE_2826_length_1367_cov_576.769716	900	980	693	3	80	0.0375000
NODE_2826_length_1367_cov_576.769716	900	980	694	2	80	0.0250000
NODE_2826_length_1367_cov_576.769716	900	980	698	1	80	0.0125000
NODE_2826_length_1367_cov_576.769716	900	980	699	1	80	0.0125000
NODE_2826_length_1367_cov_576.769716	900	980	700	1	80	0.0125000
NODE_2826_length_1367_cov_576.769716	900	980	702	2	80	0.0250000
NODE_2826_length_1367_cov_576.769716	900	980	703	1	80	0.0125000
NODE_2826_length_1367_cov_576.769716	900	980	704	2	80	0.0250000
NODE_2826_length_1367_cov_576.769716	900	980	705	1	80	0.0125000
NODE_2826_length_1367_cov_576.769716	900	980	718	1	80	0.0125000
NODE_2826_length_1367_cov_576.769716	900	980	720	1	80	0.0125000
NODE_2826_length_1367_cov_576.769716	900	980	722	1	80	0.0125000
NODE_2826_length_1367_cov_576.769716	900	980	730	2	80	0.0250000
NODE_2826_length_1367_cov_576.769716	900	980	731	4	80	0.0500000
NODE_2826_length_1367_cov_576.769716	900	980	732	1	80	0.0125000
NODE_2826_length_1367_cov_576.769716	900	980	736	1	80	0.0125000
NODE_2826_length_1367_cov_576.769716	900	980	737	1	80	0.0125000
NODE_2826_length_1367_cov_576.769716	900	980	741	2	80	0.0250000
NODE_2826_length_1367_cov_576.769716	900	980	742	1	80	0.0125000
NODE_2826_length_1367_cov_576.769716	900	980	743	1	80	0.0125000
NODE_2826_length_1367_cov_576.769716	900	980	744	2	80	0.0250000
NODE_2826_length_1367_cov_576.769716	900	980	748	1	80	0.0125000
NODE_2826_length_1367_cov_576.769716	900	980	754	1	80	0.0125000
NODE_2826_length_1367_cov_576.769716	900	980	771	1	80	0.0125000
NODE_2826_length_1367_cov_576.769716	900	980	781	1	80	0.0125000
NODE_2826_length_1367_cov_576.769716	900	980	790	1	80	0.0125000
NODE_2826_length_1367_cov_576.769716	900	980	796	1	80	0.0125000
NODE_2826_length_1367_cov_576.769716	900	980	823	1	80	0.0125000
NODE_2826_length_1367_cov_576.769716	900	980	836	1	80	0.0125000
NODE_2826_length_1367_cov_576.769716	900	980	837	1	80	0.0125000
NODE_2826_length_1367_cov_576.769716	900	980	843	1	80	0.0125000
NODE_2826_length_1367_cov_576.769716	900	980	855	3	80	0.0375000
NODE_2826_length_1367_cov_576.769716	900	980	857	1	80	0.0125000
NODE_2826_length_1367_cov_576.769716	900	980	860	1	80	0.0125000
NODE_2826_length_1367_cov_576.769716	900	980	861	1	80	0.0125000
NODE_2826_length_1367_cov_576.769716	900	980	863	1	80	0.0125000
NODE_2826_length_1367_cov_576.769716	900	980	864	2	80	0.0250000
NODE_2826_length_1367_cov_576.769716	900	980	866	1	80	0.0125000
NODE_2826_length_1367_cov_576.769716	900	980	868	2	80	0.0250000
NODE_2826_length_1367_cov_576.769716	900	980	869	1	80	0.0125000
NODE_2826_length_1367_cov_576.769716	900	980	870	2	80	0.0250000
NODE_2826_length_1367_cov_576.769716	900	980	873	4	80	0.0500000
NODE_2826_length_1367_cov_576.769716	900	980	874	1	80	0.0125000
NODE_2826_length_1367_cov_576.769716	900	980	876	1	80	0.0125000
NODE_2826_length_1367_cov_576.769716	900	980	877	1	80	0.0125000
NODE_2826_length_1367_cov_576.769716	900	980	885	1	80	0.0125000
NODE_2826_length_1367_cov_576.769716	900	980	889	1	80	0.0125000
NODE_2826_length_1367_cov_576.769716	900	980	894	1	80	0.0125000
NODE_2826_length_1367_cov_576.769716	900	980	909	1	80	0.0125000
NODE_2826_length_1367_cov_576.769716	900	980	911	1	80	0.0125000
NODE_2826_length_1367_cov_576.769716	905	927	855	3	22	0.1363636
NODE_2826_length_1367_cov_576.769716	905	927	857	1	22	0.0454545
NODE_2826_length_1367_cov_576.769716	905	927	860	1	22	0.0454545
NODE_2826_length_1367_cov_576.769716	905	927	861	1	22	0.0454545
NODE_2826_length_1367_cov_576.769716	905	927	863	1	22	0.0454545
NODE_2826_length_1367_cov_576.769716	905	927	864	2	22	0.0909091
NODE_2826_length_1367_cov_576.769716	905	927	866	1	22	0.0454545
NODE_2826_length_1367_cov_576.769716	905	927	868	2	22	0.0909091
NODE_2826_length_1367_cov_576.769716	905	927	869	1	22	0.0454545
NODE_2826_length_1367_cov_576.769716	905	927	870	2	22	0.0909091
NODE_2826_length_1367_cov_576.769716	905	927	873	4	22	0.1818182
NODE_2826_length_1367_cov_576.769716	905	927	874	1	22	0.0454545
NODE_2826_length_1367_cov_576.769716	905	927	876	1	22	0.0454545
NODE_2826_length_1367_cov_576.769716	905	927	877	1	22	0.0454545
NODE_2826_length_1367_cov_576.769716	1051	1131	238	2	80	0.0250000
NODE_2826_length_1367_cov_576.769716	1051	1131	239	2	80	0.0250000
NODE_2826_length_1367_cov_576.769716	1051	1131	241	2	80	0.0250000
NODE_2826_length_1367_cov_576.769716	1051	1131	243	1	80	0.0125000
NODE_2826_length_1367_cov_576.769716	1051	1131	245	2	80	0.0250000
NODE_2826_length_1367_cov_576.769716	1051	1131	246	1	80	0.0125000
NODE_2826_length_1367_cov_576.769716	1051	1131	247	2	80	0.0250000
NODE_2826_length_1367_cov_576.769716	1051	1131	251	1	80	0.0125000
NODE_2826_length_1367_cov_576.769716	1051	1131	252	1	80	0.0125000
NODE_2826_length_1367_cov_576.769716	1051	1131	257	1	80	0.0125000
NODE_2826_length_1367_cov_576.769716	1051	1131	258	1	80	0.0125000
NODE_2826_length_1367_cov_576.769716	1051	1131	261	1	80	0.0125000
NODE_2826_length_1367_cov_576.769716	1051	1131	262	1	80	0.0125000
NODE_2826_length_1367_cov_576.769716	1051	1131	263	1	80	0.0125000
NODE_2826_length_1367_cov_576.769716	1051	1131	264	2	80	0.0250000
NODE_2826_length_1367_cov_576.769716	1051	1131	266	1	80	0.0125000
NODE_2826_length_1367_cov_576.769716	1051	1131	269	5	80	0.0625000
NODE_2826_length_1367_cov_576.769716	1051	1131	270	4	80	0.0500000
NODE_2826_length_1367_cov_576.769716	1051	1131	271	4	80	0.0500000
NODE_2826_length_1367_cov_576.769716	1051	1131	272	3	80	0.0375000
NODE_2826_length_1367_cov_576.769716	1051	1131	274	1	80	0.0125000
NODE_2826_length_1367_cov_576.769716	1051	1131	275	2	80	0.0250000
NODE_2826_length_1367_cov_576.769716	1051	1131	276	2	80	0.0250000
NODE_2826_length_1367_cov_576.769716	1051	1131	277	3	80	0.0375000
NODE_2826_length_1367_cov_576.769716	1051	1131	278	1	80	0.0125000
NODE_2826_length_1367_cov_576.769716	1051	1131	279	5	80	0.0625000
NODE_2826_length_1367_cov_576.769716	1051	1131	280	1	80	0.0125000
NODE_2826_length_1367_cov_576.769716	1051	1131	281	1	80	0.0125000
NODE_2826_length_1367_cov_576.769716	1051	1131	283	1	80	0.0125000
NODE_2826_length_1367_cov_576.769716	1051	1131	285	1	80	0.0125000
NODE_2826_length_1367_cov_576.769716	1051	1131	291	1	80	0.0125000
NODE_2826_length_1367_cov_576.769716	1051	1131	292	1	80	0.0125000
NODE_2826_length_1367_cov_576.769716	1051	1131	293	1	80	0.0125000
NODE_2826_length_1367_cov_576.769716	1051	1131	297	2	80	0.0250000
NODE_2826_length_1367_cov_576.769716	1051	1131	303	2	80	0.0250000
NODE_2826_length_1367_cov_576.769716	1051	1131	310	1	80	0.0125000
NODE_2826_length_1367_cov_576.769716	1051	1131	311	3	80	0.0375000
NODE_2826_length_1367_cov_576.769716	1051	1131	312	2	80	0.0250000
NODE_2826_length_1367_cov_576.769716	1051	1131	313	3	80	0.0375000
NODE_2826_length_1367_cov_576.769716	1051	1131	315	1	80	0.0125000
NODE_2826_length_1367_cov_576.769716	1051	1131	316	1	80	0.0125000
NODE_2826_length_1367_cov_576.769716	1051	1131	318	1	80	0.0125000
NODE_2826_length_1367_cov_576.769716	1051	1131	319	1	80	0.0125000
NODE_2826_length_1367_cov_576.769716	1051	1131	320	1	80	0.0125000
NODE_2826_length_1367_cov_576.769716	1051	1131	321	2	80	0.0250000
NODE_2826_length_1367_cov_576.769716	1051	1131	324	1	80	0.0125000
NODE_2826_length_1367_cov_576.769716	1104	1184	196	2	80	0.0250000
NODE_2826_length_1367_cov_576.769716	1104	1184	197	2	80	0.0250000
NODE_2826_length_1367_cov_576.769716	1104	1184	200	2	80	0.0250000
NODE_2826_length_1367_cov_576.769716	1104	1184	202	2	80	0.0250000
NODE_2826_length_1367_cov_576.769716	1104	1184	203	1	80	0.0125000
NODE_2826_length_1367_cov_576.769716	1104	1184	204	4	80	0.0500000
NODE_2826_length_1367_cov_576.769716	1104	1184	205	2	80	0.0250000
NODE_2826_length_1367_cov_576.769716	1104	1184	207	1	80	0.0125000
NODE_2826_length_1367_cov_576.769716	1104	1184	208	3	80	0.0375000
NODE_2826_length_1367_cov_576.769716	1104	1184	209	1	80	0.0125000
NODE_2826_length_1367_cov_576.769716	1104	1184	210	4	80	0.0500000
NODE_2826_length_1367_cov_576.769716	1104	1184	211	4	80	0.0500000
NODE_2826_length_1367_cov_576.769716	1104	1184	212	9	80	0.1125000
NODE_2826_length_1367_cov_576.769716	1104	1184	213	1	80	0.0125000
NODE_2826_length_1367_cov_576.769716	1104	1184	218	1	80	0.0125000
NODE_2826_length_1367_cov_576.769716	1104	1184	219	2	80	0.0250000
NODE_2826_length_1367_cov_576.769716	1104	1184	221	1	80	0.0125000
NODE_2826_length_1367_cov_576.769716	1104	1184	222	2	80	0.0250000
NODE_2826_length_1367_cov_576.769716	1104	1184	223	2	80	0.0250000
NODE_2826_length_1367_cov_576.769716	1104	1184	226	1	80	0.0125000
NODE_2826_length_1367_cov_576.769716	1104	1184	228	1	80	0.0125000
NODE_2826_length_1367_cov_576.769716	1104	1184	229	3	80	0.0375000
NODE_2826_length_1367_cov_576.769716	1104	1184	230	1	80	0.0125000
NODE_2826_length_1367_cov_576.769716	1104	1184	233	1	80	0.0125000
NODE_2826_length_1367_cov_576.769716	1104	1184	238	2	80	0.0250000
NODE_2826_length_1367_cov_576.769716	1104	1184	239	2	80	0.0250000
NODE_2826_length_1367_cov_576.769716	1104	1184	241	2	80	0.0250000
NODE_2826_length_1367_cov_576.769716	1104	1184	243	1	80	0.0125000
NODE_2826_length_1367_cov_576.769716	1104	1184	245	2	80	0.0250000
NODE_2826_length_1367_cov_576.769716	1104	1184	246	1	80	0.0125000
NODE_2826_length_1367_cov_576.769716	1104	1184	247	2	80	0.0250000
NODE_2826_length_1367_cov_576.769716	1104	1184	251	1	80	0.0125000
NODE_2826_length_1367_cov_576.769716	1104	1184	252	1	80	0.0125000
NODE_2826_length_1367_cov_576.769716	1104	1184	257	1	80	0.0125000
NODE_2826_length_1367_cov_576.769716	1104	1184	258	1	80	0.0125000
NODE_2826_length_1367_cov_576.769716	1104	1184	262	1	80	0.0125000
NODE_2826_length_1367_cov_576.769716	1104	1184	270	4	80	0.0500000
NODE_2826_length_1367_cov_576.769716	1104	1184	271	1	80	0.0125000
NODE_2826_length_1367_cov_576.769716	1104	1184	272	1	80	0.0125000
NODE_2826_length_1367_cov_576.769716	1104	1184	274	1	80	0.0125000
NODE_2826_length_1367_cov_576.769716	1104	1184	276	1	80	0.0125000
NODE_2826_length_1367_cov_576.769716	1104	1184	277	1	80	0.0125000
NODE_2826_length_1367_cov_576.769716	1104	1184	279	1	80	0.0125000
NODE_2827_length_1367_cov_152.824921	513	593	33	3	80	0.0375000
NODE_2827_length_1367_cov_152.824921	513	593	42	1	80	0.0125000
NODE_2827_length_1367_cov_152.824921	513	593	44	1	80	0.0125000
NODE_2827_length_1367_cov_152.824921	513	593	45	8	80	0.1000000
NODE_2827_length_1367_cov_152.824921	513	593	50	1	80	0.0125000
NODE_2827_length_1367_cov_152.824921	513	593	51	10	80	0.1250000
NODE_2827_length_1367_cov_152.824921	513	593	52	8	80	0.1000000
NODE_2827_length_1367_cov_152.824921	513	593	53	2	80	0.0250000
NODE_2827_length_1367_cov_152.824921	513	593	62	1	80	0.0125000
NODE_2827_length_1367_cov_152.824921	513	593	63	12	80	0.1500000
NODE_2827_length_1367_cov_152.824921	513	593	65	8	80	0.1000000
NODE_2827_length_1367_cov_152.824921	513	593	66	1	80	0.0125000
NODE_2827_length_1367_cov_152.824921	513	593	67	1	80	0.0125000
NODE_2827_length_1367_cov_152.824921	513	593	69	7	80	0.0875000
NODE_2827_length_1367_cov_152.824921	513	593	81	4	80	0.0500000
NODE_2827_length_1367_cov_152.824921	513	593	82	11	80	0.1375000
NODE_2827_length_1367_cov_152.824921	513	593	83	1	80	0.0125000
NODE_2827_length_1367_cov_152.824921	566	646	63	3	80	0.0375000
NODE_2827_length_1367_cov_152.824921	566	646	64	1	80	0.0125000
NODE_2827_length_1367_cov_152.824921	566	646	66	5	80	0.0625000
NODE_2827_length_1367_cov_152.824921	566	646	67	4	80	0.0500000
NODE_2827_length_1367_cov_152.824921	566	646	68	3	80	0.0375000
NODE_2827_length_1367_cov_152.824921	566	646	69	9	80	0.1125000
NODE_2827_length_1367_cov_152.824921	566	646	70	1	80	0.0125000
NODE_2827_length_1367_cov_152.824921	566	646	71	1	80	0.0125000
NODE_2827_length_1367_cov_152.824921	566	646	72	7	80	0.0875000
NODE_2827_length_1367_cov_152.824921	566	646	73	1	80	0.0125000
NODE_2827_length_1367_cov_152.824921	566	646	74	2	80	0.0250000
NODE_2827_length_1367_cov_152.824921	566	646	76	13	80	0.1625000
NODE_2827_length_1367_cov_152.824921	566	646	77	2	80	0.0250000
NODE_2827_length_1367_cov_152.824921	566	646	78	2	80	0.0250000
NODE_2827_length_1367_cov_152.824921	566	646	81	14	80	0.1750000
NODE_2827_length_1367_cov_152.824921	566	646	82	11	80	0.1375000
NODE_2827_length_1367_cov_152.824921	566	646	83	1	80	0.0125000
NODE_2827_length_1367_cov_152.824921	642	722	46	2	80	0.0250000
NODE_2827_length_1367_cov_152.824921	642	722	48	1	80	0.0125000
NODE_2827_length_1367_cov_152.824921	642	722	53	4	80	0.0500000
NODE_2827_length_1367_cov_152.824921	642	722	54	3	80	0.0375000
NODE_2827_length_1367_cov_152.824921	642	722	57	1	80	0.0125000
NODE_2827_length_1367_cov_152.824921	642	722	58	8	80	0.1000000
NODE_2827_length_1367_cov_152.824921	642	722	59	17	80	0.2125000
NODE_2827_length_1367_cov_152.824921	642	722	60	1	80	0.0125000
NODE_2827_length_1367_cov_152.824921	642	722	63	1	80	0.0125000
NODE_2827_length_1367_cov_152.824921	642	722	66	3	80	0.0375000
NODE_2827_length_1367_cov_152.824921	642	722	67	15	80	0.1875000
NODE_2827_length_1367_cov_152.824921	642	722	68	12	80	0.1500000
NODE_2827_length_1367_cov_152.824921	642	722	69	1	80	0.0125000
NODE_2827_length_1367_cov_152.824921	642	722	70	8	80	0.1000000
NODE_2827_length_1367_cov_152.824921	642	722	72	2	80	0.0250000
NODE_2827_length_1367_cov_152.824921	642	722	76	1	80	0.0125000
NODE_2827_length_1367_cov_152.824921	695	775	34	1	80	0.0125000
NODE_2827_length_1367_cov_152.824921	695	775	46	2	80	0.0250000
NODE_2827_length_1367_cov_152.824921	695	775	48	27	80	0.3375000
NODE_2827_length_1367_cov_152.824921	695	775	50	18	80	0.2250000
NODE_2827_length_1367_cov_152.824921	695	775	51	1	80	0.0125000
NODE_2827_length_1367_cov_152.824921	695	775	52	2	80	0.0250000
NODE_2827_length_1367_cov_152.824921	695	775	57	1	80	0.0125000
NODE_2827_length_1367_cov_152.824921	695	775	58	3	80	0.0375000
NODE_2827_length_1367_cov_152.824921	695	775	59	7	80	0.0875000
NODE_2827_length_1367_cov_152.824921	695	775	63	1	80	0.0125000
NODE_2827_length_1367_cov_152.824921	695	775	66	3	80	0.0375000
NODE_2827_length_1367_cov_152.824921	695	775	67	14	80	0.1750000
NODE_2829_length_1367_cov_2.947161	250	326	1	26	76	0.3421053
NODE_2829_length_1367_cov_2.947161	250	326	2	29	76	0.3815790
NODE_2829_length_1367_cov_2.947161	250	326	3	21	76	0.2763158
NODE_2831_length_1366_cov_82.742699	198	278	10	16	80	0.2000000
NODE_2831_length_1366_cov_82.742699	198	278	11	2	80	0.0250000
NODE_2831_length_1366_cov_82.742699	198	278	14	2	80	0.0250000
NODE_2831_length_1366_cov_82.742699	198	278	15	7	80	0.0875000
NODE_2831_length_1366_cov_82.742699	198	278	16	1	80	0.0125000
NODE_2831_length_1366_cov_82.742699	198	278	17	5	80	0.0625000
NODE_2831_length_1366_cov_82.742699	198	278	18	2	80	0.0250000
NODE_2831_length_1366_cov_82.742699	198	278	19	32	80	0.4000000
NODE_2831_length_1366_cov_82.742699	198	278	20	12	80	0.1500000
NODE_2831_length_1366_cov_82.742699	198	278	21	1	80	0.0125000
NODE_2831_length_1366_cov_82.742699	251	331	18	1	80	0.0125000
NODE_2831_length_1366_cov_82.742699	251	331	19	19	80	0.2375000
NODE_2831_length_1366_cov_82.742699	251	331	20	12	80	0.1500000
NODE_2831_length_1366_cov_82.742699	251	331	21	1	80	0.0125000
NODE_2831_length_1366_cov_82.742699	251	331	22	3	80	0.0375000
NODE_2831_length_1366_cov_82.742699	251	331	23	19	80	0.2375000
NODE_2831_length_1366_cov_82.742699	251	331	24	20	80	0.2500000
NODE_2831_length_1366_cov_82.742699	251	331	25	5	80	0.0625000
NODE_2832_length_1366_cov_36.659037	577	657	15	26	80	0.3250000
NODE_2832_length_1366_cov_36.659037	577	657	16	5	80	0.0625000
NODE_2832_length_1366_cov_36.659037	577	657	17	3	80	0.0375000
NODE_2832_length_1366_cov_36.659037	577	657	18	20	80	0.2500000
NODE_2832_length_1366_cov_36.659037	577	657	19	8	80	0.1000000
NODE_2832_length_1366_cov_36.659037	577	657	20	11	80	0.1375000
NODE_2832_length_1366_cov_36.659037	577	657	21	7	80	0.0875000
NODE_2832_length_1366_cov_36.659037	630	710	10	2	80	0.0250000
NODE_2832_length_1366_cov_36.659037	630	710	11	4	80	0.0500000
NODE_2832_length_1366_cov_36.659037	630	710	12	5	80	0.0625000
NODE_2832_length_1366_cov_36.659037	630	710	13	1	80	0.0125000
NODE_2832_length_1366_cov_36.659037	630	710	14	6	80	0.0750000
NODE_2832_length_1366_cov_36.659037	630	710	15	40	80	0.5000000
NODE_2832_length_1366_cov_36.659037	630	710	16	16	80	0.2000000
NODE_2832_length_1366_cov_36.659037	630	710	17	6	80	0.0750000
NODE_2834_length_1366_cov_2.320442	47	116	0	69	69	1.0000000
NODE_2834_length_1366_cov_2.320442	1122	1202	0	26	80	0.3250000
NODE_2834_length_1366_cov_2.320442	1122	1202	3	3	80	0.0375000
NODE_2834_length_1366_cov_2.320442	1122	1202	4	44	80	0.5500000
NODE_2834_length_1366_cov_2.320442	1122	1202	7	7	80	0.0875000
NODE_2834_length_1366_cov_2.320442	1175	1255	4	20	80	0.2500000
NODE_2834_length_1366_cov_2.320442	1175	1255	7	50	80	0.6250000
NODE_2834_length_1366_cov_2.320442	1175	1255	8	5	80	0.0625000
NODE_2834_length_1366_cov_2.320442	1175	1255	9	5	80	0.0625000
NODE_2834_length_1366_cov_2.320442	1251	1331	6	35	80	0.4375000
NODE_2834_length_1366_cov_2.320442	1251	1331	7	5	80	0.0625000
NODE_2834_length_1366_cov_2.320442	1251	1331	9	40	80	0.5000000
NODE_2835_length_1365_cov_25.540284	432	509	3	2	77	0.0259740
NODE_2835_length_1365_cov_25.540284	432	509	4	18	77	0.2337662
NODE_2835_length_1365_cov_25.540284	432	509	6	40	77	0.5194805
NODE_2835_length_1365_cov_25.540284	432	509	7	9	77	0.1168831
NODE_2835_length_1365_cov_25.540284	432	509	9	8	77	0.1038961
NODE_2835_length_1365_cov_25.540284	482	562	6	10	80	0.1250000
NODE_2835_length_1365_cov_25.540284	482	562	7	9	80	0.1125000
NODE_2835_length_1365_cov_25.540284	482	562	9	23	80	0.2875000
NODE_2835_length_1365_cov_25.540284	482	562	10	1	80	0.0125000
NODE_2835_length_1365_cov_25.540284	482	562	11	20	80	0.2500000
NODE_2835_length_1365_cov_25.540284	482	562	12	17	80	0.2125000
NODE_2835_length_1365_cov_25.540284	558	635	11	31	77	0.4025974
NODE_2835_length_1365_cov_25.540284	558	635	12	40	77	0.5194805
NODE_2835_length_1365_cov_25.540284	558	635	13	6	77	0.0779221
NODE_2835_length_1365_cov_25.540284	625	688	7	14	63	0.2222222
NODE_2835_length_1365_cov_25.540284	625	688	8	2	63	0.0317460
NODE_2835_length_1365_cov_25.540284	625	688	9	21	63	0.3333333
NODE_2835_length_1365_cov_25.540284	625	688	11	9	63	0.1428571
NODE_2835_length_1365_cov_25.540284	625	688	12	17	63	0.2698413
NODE_2838_length_1364_cov_15.222134	120	191	2	38	71	0.5352113
NODE_2838_length_1364_cov_15.222134	120	191	3	9	71	0.1267606
NODE_2838_length_1364_cov_15.222134	120	191	4	24	71	0.3380282
NODE_2839_length_1364_cov_7.456917	843	923	2	43	80	0.5375000
NODE_2839_length_1364_cov_7.456917	843	923	3	3	80	0.0375000
NODE_2839_length_1364_cov_7.456917	843	923	4	3	80	0.0375000
NODE_2839_length_1364_cov_7.456917	843	923	6	31	80	0.3875000
NODE_2839_length_1364_cov_7.456917	896	976	5	38	80	0.4750000
NODE_2839_length_1364_cov_7.456917	896	976	6	42	80	0.5250000
NODE_2840_length_1364_cov_5.055336	239	290	0	51	51	1.0000000
NODE_2840_length_1364_cov_5.055336	263	343	0	80	80	1.0000000
NODE_2846_length_1363_cov_19.442247	615	695	1	24	80	0.3000000
NODE_2846_length_1363_cov_19.442247	615	695	2	41	80	0.5125000
NODE_2846_length_1363_cov_19.442247	615	695	3	15	80	0.1875000
NODE_2846_length_1363_cov_19.442247	668	748	2	12	80	0.1500000
NODE_2846_length_1363_cov_19.442247	668	748	3	40	80	0.5000000
NODE_2846_length_1363_cov_19.442247	668	748	4	28	80	0.3500000
NODE_2847_length_1363_cov_13.575949	619	699	9	1	80	0.0125000
NODE_2847_length_1363_cov_13.575949	619	699	11	8	80	0.1000000
NODE_2847_length_1363_cov_13.575949	619	699	12	22	80	0.2750000
NODE_2847_length_1363_cov_13.575949	619	699	13	5	80	0.0625000
NODE_2847_length_1363_cov_13.575949	619	699	14	42	80	0.5250000
NODE_2847_length_1363_cov_13.575949	619	699	15	2	80	0.0250000
NODE_2847_length_1363_cov_13.575949	672	752	10	1	80	0.0125000
NODE_2847_length_1363_cov_13.575949	672	752	11	10	80	0.1250000
NODE_2847_length_1363_cov_13.575949	672	752	12	1	80	0.0125000
NODE_2847_length_1363_cov_13.575949	672	752	13	13	80	0.1625000
NODE_2847_length_1363_cov_13.575949	672	752	14	35	80	0.4375000
NODE_2847_length_1363_cov_13.575949	672	752	15	20	80	0.2500000
NODE_2850_length_1362_cov_15.796516	898	978	6	2	80	0.0250000
NODE_2850_length_1362_cov_15.796516	898	978	8	49	80	0.6125000
NODE_2850_length_1362_cov_15.796516	898	978	9	8	80	0.1000000
NODE_2850_length_1362_cov_15.796516	898	978	11	21	80	0.2625000
NODE_2850_length_1362_cov_15.796516	951	1031	8	24	80	0.3000000
NODE_2850_length_1362_cov_15.796516	951	1031	9	8	80	0.1000000
NODE_2850_length_1362_cov_15.796516	951	1031	10	8	80	0.1000000
NODE_2850_length_1362_cov_15.796516	951	1031	11	40	80	0.5000000
NODE_2855_length_1361_cov_24.574485	528	608	13	6	80	0.0750000
NODE_2855_length_1361_cov_24.574485	528	608	14	4	80	0.0500000
NODE_2855_length_1361_cov_24.574485	528	608	15	1	80	0.0125000
NODE_2855_length_1361_cov_24.574485	528	608	16	21	80	0.2625000
NODE_2855_length_1361_cov_24.574485	528	608	18	1	80	0.0125000
NODE_2855_length_1361_cov_24.574485	528	608	20	1	80	0.0125000
NODE_2855_length_1361_cov_24.574485	528	608	22	1	80	0.0125000
NODE_2855_length_1361_cov_24.574485	528	608	24	20	80	0.2500000
NODE_2855_length_1361_cov_24.574485	528	608	25	18	80	0.2250000
NODE_2855_length_1361_cov_24.574485	528	608	26	7	80	0.0875000
NODE_2855_length_1361_cov_24.574485	581	661	21	22	80	0.2750000
NODE_2855_length_1361_cov_24.574485	581	661	22	1	80	0.0125000
NODE_2855_length_1361_cov_24.574485	581	661	23	7	80	0.0875000
NODE_2855_length_1361_cov_24.574485	581	661	24	23	80	0.2875000
NODE_2855_length_1361_cov_24.574485	581	661	25	16	80	0.2000000
NODE_2855_length_1361_cov_24.574485	581	661	26	11	80	0.1375000
NODE_2856_length_1361_cov_20.148970	866	946	1	5	80	0.0625000
NODE_2856_length_1361_cov_20.148970	866	946	2	4	80	0.0500000
NODE_2856_length_1361_cov_20.148970	866	946	3	9	80	0.1125000
NODE_2856_length_1361_cov_20.148970	866	946	4	6	80	0.0750000
NODE_2856_length_1361_cov_20.148970	866	946	5	26	80	0.3250000
NODE_2856_length_1361_cov_20.148970	866	946	6	30	80	0.3750000
NODE_2856_length_1361_cov_20.148970	919	999	5	46	80	0.5750000
NODE_2856_length_1361_cov_20.148970	919	999	6	34	80	0.4250000
NODE_2858_length_1361_cov_10.530903	1139	1219	5	46	80	0.5750000
NODE_2858_length_1361_cov_10.530903	1139	1219	6	10	80	0.1250000
NODE_2858_length_1361_cov_10.530903	1139	1219	8	1	80	0.0125000
NODE_2858_length_1361_cov_10.530903	1139	1219	9	23	80	0.2875000
NODE_2858_length_1361_cov_10.530903	1139	1219	5	46	80	0.5750000
NODE_2858_length_1361_cov_10.530903	1139	1219	6	10	80	0.1250000
NODE_2858_length_1361_cov_10.530903	1139	1219	8	1	80	0.0125000
NODE_2858_length_1361_cov_10.530903	1139	1219	9	23	80	0.2875000
NODE_2858_length_1361_cov_10.530903	1192	1277	4	45	85	0.5294118
NODE_2858_length_1361_cov_10.530903	1192	1277	5	6	85	0.0705882
NODE_2858_length_1361_cov_10.530903	1192	1277	6	3	85	0.0352941
NODE_2858_length_1361_cov_10.530903	1192	1277	8	1	85	0.0117647
NODE_2858_length_1361_cov_10.530903	1192	1277	9	30	85	0.3529412
NODE_2858_length_1361_cov_10.530903	1273	1353	0	8	80	0.1000000
NODE_2858_length_1361_cov_10.530903	1273	1353	2	10	80	0.1250000
NODE_2858_length_1361_cov_10.530903	1273	1353	3	48	80	0.6000000
NODE_2858_length_1361_cov_10.530903	1273	1353	4	14	80	0.1750000
NODE_2858_length_1361_cov_10.530903	1273	1353	0	8	80	0.1000000
NODE_2858_length_1361_cov_10.530903	1273	1353	2	10	80	0.1250000
NODE_2858_length_1361_cov_10.530903	1273	1353	3	48	80	0.6000000
NODE_2858_length_1361_cov_10.530903	1273	1353	4	14	80	0.1750000
NODE_2858_length_1361_cov_10.530903	1273	1353	0	8	80	0.1000000
NODE_2858_length_1361_cov_10.530903	1273	1353	2	10	80	0.1250000
NODE_2858_length_1361_cov_10.530903	1273	1353	3	48	80	0.6000000
NODE_2858_length_1361_cov_10.530903	1273	1353	4	14	80	0.1750000
NODE_2858_length_1361_cov_10.530903	1273	1353	0	8	80	0.1000000
NODE_2858_length_1361_cov_10.530903	1273	1353	2	10	80	0.1250000
NODE_2858_length_1361_cov_10.530903	1273	1353	3	48	80	0.6000000
NODE_2858_length_1361_cov_10.530903	1273	1353	4	14	80	0.1750000
NODE_2858_length_1361_cov_10.530903	1273	1353	0	8	80	0.1000000
NODE_2858_length_1361_cov_10.530903	1273	1353	2	10	80	0.1250000
NODE_2858_length_1361_cov_10.530903	1273	1353	3	48	80	0.6000000
NODE_2858_length_1361_cov_10.530903	1273	1353	4	14	80	0.1750000
NODE_2858_length_1361_cov_10.530903	1273	1353	0	8	80	0.1000000
NODE_2858_length_1361_cov_10.530903	1273	1353	2	10	80	0.1250000
NODE_2858_length_1361_cov_10.530903	1273	1353	3	48	80	0.6000000
NODE_2858_length_1361_cov_10.530903	1273	1353	4	14	80	0.1750000
NODE_2859_length_1360_cov_42.789056	351	431	24	2	80	0.0250000
NODE_2859_length_1360_cov_42.789056	351	431	25	17	80	0.2125000
NODE_2859_length_1360_cov_42.789056	351	431	26	1	80	0.0125000
NODE_2859_length_1360_cov_42.789056	351	431	27	3	80	0.0375000
NODE_2859_length_1360_cov_42.789056	351	431	28	3	80	0.0375000
NODE_2859_length_1360_cov_42.789056	351	431	30	1	80	0.0125000
NODE_2859_length_1360_cov_42.789056	351	431	36	1	80	0.0125000
NODE_2859_length_1360_cov_42.789056	351	431	37	10	80	0.1250000
NODE_2859_length_1360_cov_42.789056	351	431	39	1	80	0.0125000
NODE_2859_length_1360_cov_42.789056	351	431	40	1	80	0.0125000
NODE_2859_length_1360_cov_42.789056	351	431	41	2	80	0.0250000
NODE_2859_length_1360_cov_42.789056	351	431	42	35	80	0.4375000
NODE_2859_length_1360_cov_42.789056	351	431	43	3	80	0.0375000
NODE_2859_length_1360_cov_42.789056	404	484	29	6	80	0.0750000
NODE_2859_length_1360_cov_42.789056	404	484	31	4	80	0.0500000
NODE_2859_length_1360_cov_42.789056	404	484	32	1	80	0.0125000
NODE_2859_length_1360_cov_42.789056	404	484	33	5	80	0.0625000
NODE_2859_length_1360_cov_42.789056	404	484	34	6	80	0.0750000
NODE_2859_length_1360_cov_42.789056	404	484	35	16	80	0.2000000
NODE_2859_length_1360_cov_42.789056	404	484	36	3	80	0.0375000
NODE_2859_length_1360_cov_42.789056	404	484	37	9	80	0.1125000
NODE_2859_length_1360_cov_42.789056	404	484	38	6	80	0.0750000
NODE_2859_length_1360_cov_42.789056	404	484	40	1	80	0.0125000
NODE_2859_length_1360_cov_42.789056	404	484	41	1	80	0.0125000
NODE_2859_length_1360_cov_42.789056	404	484	42	19	80	0.2375000
NODE_2859_length_1360_cov_42.789056	404	484	43	3	80	0.0375000
NODE_2860_length_1360_cov_26.407613	531	611	19	1	80	0.0125000
NODE_2860_length_1360_cov_26.407613	531	611	20	15	80	0.1875000
NODE_2860_length_1360_cov_26.407613	531	611	22	22	80	0.2750000
NODE_2860_length_1360_cov_26.407613	531	611	23	23	80	0.2875000
NODE_2860_length_1360_cov_26.407613	531	611	24	18	80	0.2250000
NODE_2860_length_1360_cov_26.407613	531	611	25	1	80	0.0125000
NODE_2860_length_1360_cov_26.407613	584	669	15	2	85	0.0235294
NODE_2860_length_1360_cov_26.407613	584	669	17	29	85	0.3411765
NODE_2860_length_1360_cov_26.407613	584	669	19	20	85	0.2352941
NODE_2860_length_1360_cov_26.407613	584	669	22	2	85	0.0235294
NODE_2860_length_1360_cov_26.407613	584	669	23	12	85	0.1411765
NODE_2860_length_1360_cov_26.407613	584	669	24	12	85	0.1411765
NODE_2860_length_1360_cov_26.407613	584	669	25	8	85	0.0941176
NODE_2861_length_1360_cov_16.182395	796	876	8	35	80	0.4375000
NODE_2861_length_1360_cov_16.182395	796	876	9	14	80	0.1750000
NODE_2861_length_1360_cov_16.182395	796	876	10	2	80	0.0250000
NODE_2861_length_1360_cov_16.182395	796	876	11	29	80	0.3625000
NODE_2861_length_1360_cov_16.182395	849	929	5	15	80	0.1875000
NODE_2861_length_1360_cov_16.182395	849	929	7	4	80	0.0500000
NODE_2861_length_1360_cov_16.182395	849	929	8	13	80	0.1625000
NODE_2861_length_1360_cov_16.182395	849	929	9	44	80	0.5500000
NODE_2861_length_1360_cov_16.182395	849	929	10	4	80	0.0500000
NODE_2861_length_1360_cov_16.182395	925	1005	4	19	80	0.2375000
NODE_2861_length_1360_cov_16.182395	925	1005	5	28	80	0.3500000
NODE_2861_length_1360_cov_16.182395	925	1005	6	8	80	0.1000000
NODE_2861_length_1360_cov_16.182395	925	1005	7	25	80	0.3125000
NODE_2861_length_1360_cov_16.182395	978	1058	4	26	80	0.3250000
NODE_2861_length_1360_cov_16.182395	978	1058	5	47	80	0.5875000
NODE_2861_length_1360_cov_16.182395	978	1058	6	7	80	0.0875000
NODE_2862_length_1360_cov_12.763680	582	662	3	4	80	0.0500000
NODE_2862_length_1360_cov_12.763680	582	662	4	6	80	0.0750000
NODE_2862_length_1360_cov_12.763680	582	662	5	20	80	0.2500000
NODE_2862_length_1360_cov_12.763680	582	662	6	1	80	0.0125000
NODE_2862_length_1360_cov_12.763680	582	662	7	7	80	0.0875000
NODE_2862_length_1360_cov_12.763680	582	662	8	42	80	0.5250000
NODE_2862_length_1360_cov_12.763680	635	715	1	9	80	0.1125000
NODE_2862_length_1360_cov_12.763680	635	715	2	22	80	0.2750000
NODE_2862_length_1360_cov_12.763680	635	715	3	23	80	0.2875000
NODE_2862_length_1360_cov_12.763680	635	715	4	9	80	0.1125000
NODE_2862_length_1360_cov_12.763680	635	715	5	17	80	0.2125000
NODE_2866_length_1359_cov_41.324603	674	754	5	30	80	0.3750000
NODE_2866_length_1359_cov_41.324603	674	754	6	16	80	0.2000000
NODE_2866_length_1359_cov_41.324603	674	754	7	20	80	0.2500000
NODE_2866_length_1359_cov_41.324603	674	754	9	10	80	0.1250000
NODE_2866_length_1359_cov_41.324603	674	754	10	4	80	0.0500000
NODE_2866_length_1359_cov_41.324603	727	807	7	13	80	0.1625000
NODE_2866_length_1359_cov_41.324603	727	807	8	10	80	0.1250000
NODE_2866_length_1359_cov_41.324603	727	807	9	26	80	0.3250000
NODE_2866_length_1359_cov_41.324603	727	807	10	31	80	0.3875000
NODE_2866_length_1359_cov_41.324603	803	883	5	7	80	0.0875000
NODE_2866_length_1359_cov_41.324603	803	883	6	1	80	0.0125000
NODE_2866_length_1359_cov_41.324603	803	883	7	49	80	0.6125000
NODE_2866_length_1359_cov_41.324603	803	883	8	18	80	0.2250000
NODE_2866_length_1359_cov_41.324603	803	883	10	5	80	0.0625000
NODE_2866_length_1359_cov_41.324603	856	936	2	2	80	0.0250000
NODE_2866_length_1359_cov_41.324603	856	936	3	16	80	0.2000000
NODE_2866_length_1359_cov_41.324603	856	936	4	18	80	0.2250000
NODE_2866_length_1359_cov_41.324603	856	936	5	24	80	0.3000000
NODE_2866_length_1359_cov_41.324603	856	936	6	1	80	0.0125000
NODE_2866_length_1359_cov_41.324603	856	936	7	19	80	0.2375000
NODE_2871_length_1358_cov_23.427323	292	372	3	16	80	0.2000000
NODE_2871_length_1358_cov_23.427323	292	372	4	64	80	0.8000000
NODE_2871_length_1358_cov_23.427323	345	425	1	2	80	0.0250000
NODE_2871_length_1358_cov_23.427323	345	425	2	40	80	0.5000000
NODE_2871_length_1358_cov_23.427323	345	425	3	14	80	0.1750000
NODE_2871_length_1358_cov_23.427323	345	425	4	24	80	0.3000000
NODE_2872_length_1358_cov_19.489277	411	491	11	4	80	0.0500000
NODE_2872_length_1358_cov_19.489277	411	491	12	5	80	0.0625000
NODE_2872_length_1358_cov_19.489277	411	491	16	11	80	0.1375000
NODE_2872_length_1358_cov_19.489277	411	491	17	1	80	0.0125000
NODE_2872_length_1358_cov_19.489277	411	491	19	24	80	0.3000000
NODE_2872_length_1358_cov_19.489277	411	491	23	13	80	0.1625000
NODE_2872_length_1358_cov_19.489277	411	491	24	1	80	0.0125000
NODE_2872_length_1358_cov_19.489277	411	491	25	21	80	0.2625000
NODE_2872_length_1358_cov_19.489277	464	544	20	6	80	0.0750000
NODE_2872_length_1358_cov_19.489277	464	544	22	18	80	0.2250000
NODE_2872_length_1358_cov_19.489277	464	544	23	7	80	0.0875000
NODE_2872_length_1358_cov_19.489277	464	544	24	5	80	0.0625000
NODE_2872_length_1358_cov_19.489277	464	544	25	30	80	0.3750000
NODE_2872_length_1358_cov_19.489277	464	544	26	11	80	0.1375000
NODE_2872_length_1358_cov_19.489277	464	544	27	3	80	0.0375000
NODE_2875_length_1357_cov_15.962639	732	812	7	16	80	0.2000000
NODE_2875_length_1357_cov_15.962639	732	812	8	5	80	0.0625000
NODE_2875_length_1357_cov_15.962639	732	812	9	32	80	0.4000000
NODE_2875_length_1357_cov_15.962639	732	812	10	7	80	0.0875000
NODE_2875_length_1357_cov_15.962639	732	812	11	20	80	0.2500000
NODE_2875_length_1357_cov_15.962639	785	865	6	2	80	0.0250000
NODE_2875_length_1357_cov_15.962639	785	865	7	6	80	0.0750000
NODE_2875_length_1357_cov_15.962639	785	865	9	44	80	0.5500000
NODE_2875_length_1357_cov_15.962639	785	865	10	8	80	0.1000000
NODE_2875_length_1357_cov_15.962639	785	865	11	20	80	0.2500000
NODE_2879_length_1354_cov_9.854980	735	815	3	17	80	0.2125000
NODE_2879_length_1354_cov_9.854980	735	815	5	55	80	0.6875000
NODE_2879_length_1354_cov_9.854980	735	815	8	8	80	0.1000000
NODE_2879_length_1354_cov_9.854980	788	868	5	29	80	0.3625000
NODE_2879_length_1354_cov_9.854980	788	868	8	51	80	0.6375000
NODE_2882_length_1353_cov_32.982456	708	788	31	22	80	0.2750000
NODE_2882_length_1353_cov_32.982456	708	788	32	31	80	0.3875000
NODE_2882_length_1353_cov_32.982456	708	788	33	15	80	0.1875000
NODE_2882_length_1353_cov_32.982456	708	788	34	12	80	0.1500000
NODE_2882_length_1353_cov_32.982456	761	841	14	9	80	0.1125000
NODE_2882_length_1353_cov_32.982456	761	841	17	1	80	0.0125000
NODE_2882_length_1353_cov_32.982456	761	841	18	10	80	0.1250000
NODE_2882_length_1353_cov_32.982456	761	841	20	3	80	0.0375000
NODE_2882_length_1353_cov_32.982456	761	841	21	4	80	0.0500000
NODE_2882_length_1353_cov_32.982456	761	841	22	7	80	0.0875000
NODE_2882_length_1353_cov_32.982456	761	841	23	4	80	0.0500000
NODE_2882_length_1353_cov_32.982456	761	841	24	3	80	0.0375000
NODE_2882_length_1353_cov_32.982456	761	841	25	3	80	0.0375000
NODE_2882_length_1353_cov_32.982456	761	841	29	3	80	0.0375000
NODE_2882_length_1353_cov_32.982456	761	841	30	1	80	0.0125000
NODE_2882_length_1353_cov_32.982456	761	841	31	4	80	0.0500000
NODE_2882_length_1353_cov_32.982456	761	841	32	6	80	0.0750000
NODE_2882_length_1353_cov_32.982456	761	841	33	17	80	0.2125000
NODE_2882_length_1353_cov_32.982456	761	841	34	5	80	0.0625000
NODE_2883_length_1353_cov_21.775120	493	573	26	15	80	0.1875000
NODE_2883_length_1353_cov_21.775120	493	573	27	10	80	0.1250000
NODE_2883_length_1353_cov_21.775120	493	573	28	1	80	0.0125000
NODE_2883_length_1353_cov_21.775120	493	573	29	17	80	0.2125000
NODE_2883_length_1353_cov_21.775120	493	573	30	4	80	0.0500000
NODE_2883_length_1353_cov_21.775120	493	573	31	2	80	0.0250000
NODE_2883_length_1353_cov_21.775120	493	573	33	7	80	0.0875000
NODE_2883_length_1353_cov_21.775120	493	573	34	14	80	0.1750000
NODE_2883_length_1353_cov_21.775120	493	573	35	3	80	0.0375000
NODE_2883_length_1353_cov_21.775120	493	573	36	7	80	0.0875000
NODE_2883_length_1353_cov_21.775120	546	626	21	4	80	0.0500000
NODE_2883_length_1353_cov_21.775120	546	626	22	11	80	0.1375000
NODE_2883_length_1353_cov_21.775120	546	626	23	10	80	0.1250000
NODE_2883_length_1353_cov_21.775120	546	626	25	4	80	0.0500000
NODE_2883_length_1353_cov_21.775120	546	626	26	1	80	0.0125000
NODE_2883_length_1353_cov_21.775120	546	626	31	2	80	0.0250000
NODE_2883_length_1353_cov_21.775120	546	626	33	13	80	0.1625000
NODE_2883_length_1353_cov_21.775120	546	626	34	14	80	0.1750000
NODE_2883_length_1353_cov_21.775120	546	626	35	3	80	0.0375000
NODE_2883_length_1353_cov_21.775120	546	626	36	18	80	0.2250000
NODE_2884_length_1353_cov_18.201754	696	776	9	9	80	0.1125000
NODE_2884_length_1353_cov_18.201754	696	776	11	4	80	0.0500000
NODE_2884_length_1353_cov_18.201754	696	776	12	10	80	0.1250000
NODE_2884_length_1353_cov_18.201754	696	776	13	18	80	0.2250000
NODE_2884_length_1353_cov_18.201754	696	776	14	11	80	0.1375000
NODE_2884_length_1353_cov_18.201754	696	776	15	14	80	0.1750000
NODE_2884_length_1353_cov_18.201754	696	776	16	14	80	0.1750000
NODE_2884_length_1353_cov_18.201754	749	829	9	16	80	0.2000000
NODE_2884_length_1353_cov_18.201754	749	829	11	5	80	0.0625000
NODE_2884_length_1353_cov_18.201754	749	829	12	13	80	0.1625000
NODE_2884_length_1353_cov_18.201754	749	829	13	23	80	0.2875000
NODE_2884_length_1353_cov_18.201754	749	829	14	12	80	0.1500000
NODE_2884_length_1353_cov_18.201754	749	829	15	11	80	0.1375000
NODE_2888_length_1352_cov_26.942538	455	535	13	16	80	0.2000000
NODE_2888_length_1352_cov_26.942538	455	535	14	33	80	0.4125000
NODE_2888_length_1352_cov_26.942538	455	535	15	16	80	0.2000000
NODE_2888_length_1352_cov_26.942538	455	535	16	10	80	0.1250000
NODE_2888_length_1352_cov_26.942538	455	535	17	5	80	0.0625000
NODE_2888_length_1352_cov_26.942538	508	588	10	7	80	0.0875000
NODE_2888_length_1352_cov_26.942538	508	588	12	6	80	0.0750000
NODE_2888_length_1352_cov_26.942538	508	588	14	17	80	0.2125000
NODE_2888_length_1352_cov_26.942538	508	588	15	24	80	0.3000000
NODE_2888_length_1352_cov_26.942538	508	588	16	10	80	0.1250000
NODE_2888_length_1352_cov_26.942538	508	588	17	16	80	0.2000000
NODE_2889_length_1352_cov_17.189944	717	797	3	6	80	0.0750000
NODE_2889_length_1352_cov_17.189944	717	797	4	10	80	0.1250000
NODE_2889_length_1352_cov_17.189944	717	797	5	37	80	0.4625000
NODE_2889_length_1352_cov_17.189944	717	797	7	3	80	0.0375000
NODE_2889_length_1352_cov_17.189944	717	797	8	2	80	0.0250000
NODE_2889_length_1352_cov_17.189944	717	797	9	22	80	0.2750000
NODE_2889_length_1352_cov_17.189944	770	850	7	3	80	0.0375000
NODE_2889_length_1352_cov_17.189944	770	850	8	17	80	0.2125000
NODE_2889_length_1352_cov_17.189944	770	850	9	47	80	0.5875000
NODE_2889_length_1352_cov_17.189944	770	850	10	13	80	0.1625000
NODE_2890_length_1352_cov_15.752594	640	720	4	9	80	0.1125000
NODE_2890_length_1352_cov_15.752594	640	720	5	48	80	0.6000000
NODE_2890_length_1352_cov_15.752594	640	720	7	7	80	0.0875000
NODE_2890_length_1352_cov_15.752594	640	720	8	16	80	0.2000000
NODE_2890_length_1352_cov_15.752594	693	773	4	4	80	0.0500000
NODE_2890_length_1352_cov_15.752594	693	773	5	48	80	0.6000000
NODE_2890_length_1352_cov_15.752594	693	773	7	7	80	0.0875000
NODE_2890_length_1352_cov_15.752594	693	773	8	21	80	0.2625000
NODE_2891_length_1352_cov_10.699920	237	317	2	80	80	1.0000000
NODE_2891_length_1352_cov_10.699920	290	370	2	80	80	1.0000000
NODE_2894_length_1351_cov_32.325879	561	641	18	7	80	0.0875000
NODE_2894_length_1351_cov_32.325879	561	641	20	5	80	0.0625000
NODE_2894_length_1351_cov_32.325879	561	641	21	5	80	0.0625000
NODE_2894_length_1351_cov_32.325879	561	641	22	20	80	0.2500000
NODE_2894_length_1351_cov_32.325879	561	641	23	18	80	0.2250000
NODE_2894_length_1351_cov_32.325879	561	641	24	9	80	0.1125000
NODE_2894_length_1351_cov_32.325879	561	641	25	4	80	0.0500000
NODE_2894_length_1351_cov_32.325879	561	641	26	12	80	0.1500000
NODE_2894_length_1351_cov_32.325879	614	694	18	1	80	0.0125000
NODE_2894_length_1351_cov_32.325879	614	694	19	11	80	0.1375000
NODE_2894_length_1351_cov_32.325879	614	694	20	22	80	0.2750000
NODE_2894_length_1351_cov_32.325879	614	694	22	23	80	0.2875000
NODE_2894_length_1351_cov_32.325879	614	694	23	7	80	0.0875000
NODE_2894_length_1351_cov_32.325879	614	694	25	4	80	0.0500000
NODE_2894_length_1351_cov_32.325879	614	694	26	12	80	0.1500000
NODE_2895_length_1351_cov_16.861022	97	162	5	2	65	0.0307692
NODE_2895_length_1351_cov_16.861022	97	162	7	13	65	0.2000000
NODE_2895_length_1351_cov_16.861022	97	162	9	7	65	0.1076923
NODE_2895_length_1351_cov_16.861022	97	162	10	43	65	0.6615385
NODE_2896_length_1351_cov_9.894569	331	411	8	7	80	0.0875000
NODE_2896_length_1351_cov_9.894569	331	411	10	6	80	0.0750000
NODE_2896_length_1351_cov_9.894569	331	411	11	16	80	0.2000000
NODE_2896_length_1351_cov_9.894569	331	411	13	4	80	0.0500000
NODE_2896_length_1351_cov_9.894569	331	411	14	1	80	0.0125000
NODE_2896_length_1351_cov_9.894569	331	411	15	10	80	0.1250000
NODE_2896_length_1351_cov_9.894569	331	411	17	36	80	0.4500000
NODE_2896_length_1351_cov_9.894569	384	464	13	8	80	0.1000000
NODE_2896_length_1351_cov_9.894569	384	464	14	12	80	0.1500000
NODE_2896_length_1351_cov_9.894569	384	464	15	8	80	0.1000000
NODE_2896_length_1351_cov_9.894569	384	464	16	13	80	0.1625000
NODE_2896_length_1351_cov_9.894569	384	464	17	39	80	0.4875000
NODE_2897_length_1351_cov_8.699681	1055	1137	0	82	82	1.0000000
NODE_2897_length_1351_cov_8.699681	1110	1175	0	65	65	1.0000000
NODE_2898_length_1351_cov_2.931310	68	148	0	11	80	0.1375000
NODE_2898_length_1351_cov_2.931310	68	148	2	40	80	0.5000000
NODE_2898_length_1351_cov_2.931310	68	148	5	29	80	0.3625000
NODE_2898_length_1351_cov_2.931310	495	528	0	33	33	1.0000000
NODE_2899_length_1350_cov_18.274181	424	504	1	8	80	0.1000000
NODE_2899_length_1350_cov_18.274181	424	504	2	41	80	0.5125000
NODE_2899_length_1350_cov_18.274181	424	504	3	31	80	0.3875000
NODE_2899_length_1350_cov_18.274181	477	557	3	34	80	0.4250000
NODE_2899_length_1350_cov_18.274181	477	557	4	15	80	0.1875000
NODE_2899_length_1350_cov_18.274181	477	557	6	22	80	0.2750000
NODE_2899_length_1350_cov_18.274181	477	557	7	9	80	0.1125000
NODE_2899_length_1350_cov_18.274181	553	633	6	5	80	0.0625000
NODE_2899_length_1350_cov_18.274181	553	633	8	11	80	0.1375000
NODE_2899_length_1350_cov_18.274181	553	633	9	18	80	0.2250000
NODE_2899_length_1350_cov_18.274181	553	633	10	1	80	0.0125000
NODE_2899_length_1350_cov_18.274181	553	633	11	16	80	0.2000000
NODE_2899_length_1350_cov_18.274181	553	633	12	23	80	0.2875000
NODE_2899_length_1350_cov_18.274181	553	633	13	6	80	0.0750000
NODE_2899_length_1350_cov_18.274181	606	686	9	1	80	0.0125000
NODE_2899_length_1350_cov_18.274181	606	686	10	9	80	0.1125000
NODE_2899_length_1350_cov_18.274181	606	686	11	11	80	0.1375000
NODE_2899_length_1350_cov_18.274181	606	686	12	50	80	0.6250000
NODE_2899_length_1350_cov_18.274181	606	686	13	9	80	0.1125000
NODE_2900_length_1350_cov_8.053557	737	817	17	14	80	0.1750000
NODE_2900_length_1350_cov_8.053557	737	817	18	27	80	0.3375000
NODE_2900_length_1350_cov_8.053557	737	817	19	5	80	0.0625000
NODE_2900_length_1350_cov_8.053557	737	817	20	18	80	0.2250000
NODE_2900_length_1350_cov_8.053557	737	817	21	13	80	0.1625000
NODE_2900_length_1350_cov_8.053557	737	817	22	3	80	0.0375000
NODE_2900_length_1350_cov_8.053557	790	870	3	16	80	0.2000000
NODE_2900_length_1350_cov_8.053557	790	870	4	11	80	0.1375000
NODE_2900_length_1350_cov_8.053557	790	870	5	4	80	0.0500000
NODE_2900_length_1350_cov_8.053557	790	870	13	8	80	0.1000000
NODE_2900_length_1350_cov_8.053557	790	870	15	5	80	0.0625000
NODE_2900_length_1350_cov_8.053557	790	870	16	3	80	0.0375000
NODE_2900_length_1350_cov_8.053557	790	870	17	10	80	0.1250000
NODE_2900_length_1350_cov_8.053557	790	870	18	23	80	0.2875000
NODE_2903_length_1349_cov_23.782400	839	919	7	23	80	0.2875000
NODE_2903_length_1349_cov_23.782400	839	919	8	1	80	0.0125000
NODE_2903_length_1349_cov_23.782400	839	919	9	53	80	0.6625000
NODE_2903_length_1349_cov_23.782400	839	919	10	3	80	0.0375000
NODE_2903_length_1349_cov_23.782400	892	972	4	7	80	0.0875000
NODE_2903_length_1349_cov_23.782400	892	972	6	28	80	0.3500000
NODE_2903_length_1349_cov_23.782400	892	972	8	13	80	0.1625000
NODE_2903_length_1349_cov_23.782400	892	972	9	32	80	0.4000000
NODE_2903_length_1349_cov_23.782400	968	1048	2	33	80	0.4125000
NODE_2903_length_1349_cov_23.782400	968	1048	3	1	80	0.0125000
NODE_2903_length_1349_cov_23.782400	968	1048	4	46	80	0.5750000
NODE_2903_length_1349_cov_23.782400	1021	1101	0	11	80	0.1375000
NODE_2903_length_1349_cov_23.782400	1021	1101	2	69	80	0.8625000
NODE_2904_length_1349_cov_17.776800	811	891	9	23	80	0.2875000
NODE_2904_length_1349_cov_17.776800	811	891	10	35	80	0.4375000
NODE_2904_length_1349_cov_17.776800	811	891	12	20	80	0.2500000
NODE_2904_length_1349_cov_17.776800	811	891	13	2	80	0.0250000
NODE_2904_length_1349_cov_17.776800	864	944	0	3	80	0.0375000
NODE_2904_length_1349_cov_17.776800	864	944	3	13	80	0.1625000
NODE_2904_length_1349_cov_17.776800	864	944	4	15	80	0.1875000
NODE_2904_length_1349_cov_17.776800	864	944	5	1	80	0.0125000
NODE_2904_length_1349_cov_17.776800	864	944	7	16	80	0.2000000
NODE_2904_length_1349_cov_17.776800	864	944	9	28	80	0.3500000
NODE_2904_length_1349_cov_17.776800	864	944	10	4	80	0.0500000
NODE_2905_length_1349_cov_16.468800	828	908	2	80	80	1.0000000
NODE_2905_length_1349_cov_16.468800	881	961	0	42	80	0.5250000
NODE_2905_length_1349_cov_16.468800	881	961	1	4	80	0.0500000
NODE_2905_length_1349_cov_16.468800	881	961	2	34	80	0.4250000
NODE_2908_length_1348_cov_22.731785	468	548	0	12	80	0.1500000
NODE_2908_length_1348_cov_22.731785	468	548	2	68	80	0.8500000
NODE_2908_length_1348_cov_22.731785	521	601	0	65	80	0.8125000
NODE_2908_length_1348_cov_22.731785	521	601	2	15	80	0.1875000
NODE_2909_length_1348_cov_20.778223	517	597	6	19	80	0.2375000
NODE_2909_length_1348_cov_20.778223	517	597	7	1	80	0.0125000
NODE_2909_length_1348_cov_20.778223	517	597	8	17	80	0.2125000
NODE_2909_length_1348_cov_20.778223	517	597	9	43	80	0.5375000
NODE_2909_length_1348_cov_20.778223	570	650	5	30	80	0.3750000
NODE_2909_length_1348_cov_20.778223	570	650	7	21	80	0.2625000
NODE_2909_length_1348_cov_20.778223	570	650	8	3	80	0.0375000
NODE_2909_length_1348_cov_20.778223	570	650	9	26	80	0.3250000
NODE_2910_length_1348_cov_11.180144	673	753	1	80	80	1.0000000
NODE_2910_length_1348_cov_11.180144	726	806	0	14	80	0.1750000
NODE_2910_length_1348_cov_11.180144	726	806	1	66	80	0.8250000
NODE_2916_length_1347_cov_45.906250	683	763	7	56	80	0.7000000
NODE_2916_length_1347_cov_45.906250	683	763	8	24	80	0.3000000
NODE_2916_length_1347_cov_45.906250	736	816	5	3	80	0.0375000
NODE_2916_length_1347_cov_45.906250	736	816	6	10	80	0.1250000
NODE_2916_length_1347_cov_45.906250	736	816	7	14	80	0.1750000
NODE_2916_length_1347_cov_45.906250	736	816	8	41	80	0.5125000
NODE_2916_length_1347_cov_45.906250	736	816	9	12	80	0.1500000
NODE_2916_length_1347_cov_45.906250	812	892	6	27	80	0.3375000
NODE_2916_length_1347_cov_45.906250	812	892	7	30	80	0.3750000
NODE_2916_length_1347_cov_45.906250	812	892	8	23	80	0.2875000
NODE_2916_length_1347_cov_45.906250	865	945	7	35	80	0.4375000
NODE_2916_length_1347_cov_45.906250	865	945	8	45	80	0.5625000
NODE_2917_length_1347_cov_41.643429	439	519	63	5	80	0.0625000
NODE_2917_length_1347_cov_41.643429	439	519	66	1	80	0.0125000
NODE_2917_length_1347_cov_41.643429	439	519	67	12	80	0.1500000
NODE_2917_length_1347_cov_41.643429	439	519	68	6	80	0.0750000
NODE_2917_length_1347_cov_41.643429	439	519	69	12	80	0.1500000
NODE_2917_length_1347_cov_41.643429	439	519	70	10	80	0.1250000
NODE_2917_length_1347_cov_41.643429	439	519	71	3	80	0.0375000
NODE_2917_length_1347_cov_41.643429	439	519	74	1	80	0.0125000
NODE_2917_length_1347_cov_41.643429	439	519	79	1	80	0.0125000
NODE_2917_length_1347_cov_41.643429	439	519	80	1	80	0.0125000
NODE_2917_length_1347_cov_41.643429	439	519	81	2	80	0.0250000
NODE_2917_length_1347_cov_41.643429	439	519	82	2	80	0.0250000
NODE_2917_length_1347_cov_41.643429	439	519	89	2	80	0.0250000
NODE_2917_length_1347_cov_41.643429	439	519	92	13	80	0.1625000
NODE_2917_length_1347_cov_41.643429	439	519	93	7	80	0.0875000
NODE_2917_length_1347_cov_41.643429	439	519	94	2	80	0.0250000
NODE_2917_length_1347_cov_41.643429	492	572	54	6	80	0.0750000
NODE_2917_length_1347_cov_41.643429	492	572	60	14	80	0.1750000
NODE_2917_length_1347_cov_41.643429	492	572	61	17	80	0.2125000
NODE_2917_length_1347_cov_41.643429	492	572	62	12	80	0.1500000
NODE_2917_length_1347_cov_41.643429	492	572	63	5	80	0.0625000
NODE_2917_length_1347_cov_41.643429	492	572	64	2	80	0.0250000
NODE_2917_length_1347_cov_41.643429	492	572	66	1	80	0.0125000
NODE_2917_length_1347_cov_41.643429	492	572	67	8	80	0.1000000
NODE_2917_length_1347_cov_41.643429	492	572	68	8	80	0.1000000
NODE_2917_length_1347_cov_41.643429	492	572	69	4	80	0.0500000
NODE_2917_length_1347_cov_41.643429	492	572	79	1	80	0.0125000
NODE_2917_length_1347_cov_41.643429	492	572	80	1	80	0.0125000
NODE_2917_length_1347_cov_41.643429	492	572	81	1	80	0.0125000
NODE_2918_length_1347_cov_19.941506	458	538	0	80	80	1.0000000
NODE_2918_length_1347_cov_19.941506	511	591	0	35	80	0.4375000
NODE_2918_length_1347_cov_19.941506	511	591	3	30	80	0.3750000
NODE_2918_length_1347_cov_19.941506	511	591	4	1	80	0.0125000
NODE_2918_length_1347_cov_19.941506	511	591	5	14	80	0.1750000
NODE_2918_length_1347_cov_19.941506	587	667	5	9	80	0.1125000
NODE_2918_length_1347_cov_19.941506	587	667	6	8	80	0.1000000
NODE_2918_length_1347_cov_19.941506	587	667	7	4	80	0.0500000
NODE_2918_length_1347_cov_19.941506	587	667	8	4	80	0.0500000
NODE_2918_length_1347_cov_19.941506	587	667	9	6	80	0.0750000
NODE_2918_length_1347_cov_19.941506	587	667	11	7	80	0.0875000
NODE_2918_length_1347_cov_19.941506	587	667	12	27	80	0.3375000
NODE_2918_length_1347_cov_19.941506	587	667	16	15	80	0.1875000
NODE_2918_length_1347_cov_19.941506	640	720	12	12	80	0.1500000
NODE_2918_length_1347_cov_19.941506	640	720	15	24	80	0.3000000
NODE_2918_length_1347_cov_19.941506	640	720	16	17	80	0.2125000
NODE_2918_length_1347_cov_19.941506	640	720	17	25	80	0.3125000
NODE_2918_length_1347_cov_19.941506	640	720	18	2	80	0.0250000
NODE_2919_length_1347_cov_16.520833	713	793	9	22	80	0.2750000
NODE_2919_length_1347_cov_16.520833	713	793	10	9	80	0.1125000
NODE_2919_length_1347_cov_16.520833	713	793	11	49	80	0.6125000
NODE_2919_length_1347_cov_16.520833	766	846	4	15	80	0.1875000
NODE_2919_length_1347_cov_16.520833	766	846	5	4	80	0.0500000
NODE_2919_length_1347_cov_16.520833	766	846	6	1	80	0.0125000
NODE_2919_length_1347_cov_16.520833	766	846	7	13	80	0.1625000
NODE_2919_length_1347_cov_16.520833	766	846	9	36	80	0.4500000
NODE_2919_length_1347_cov_16.520833	766	846	10	2	80	0.0250000
NODE_2919_length_1347_cov_16.520833	766	846	11	9	80	0.1125000
NODE_2920_length_1347_cov_15.967147	638	718	6	4	80	0.0500000
NODE_2920_length_1347_cov_15.967147	638	718	7	25	80	0.3125000
NODE_2920_length_1347_cov_15.967147	638	718	8	7	80	0.0875000
NODE_2920_length_1347_cov_15.967147	638	718	9	2	80	0.0250000
NODE_2920_length_1347_cov_15.967147	638	718	10	23	80	0.2875000
NODE_2920_length_1347_cov_15.967147	638	718	11	19	80	0.2375000
NODE_2920_length_1347_cov_15.967147	691	771	8	47	80	0.5875000
NODE_2920_length_1347_cov_15.967147	691	771	10	29	80	0.3625000
NODE_2920_length_1347_cov_15.967147	691	771	11	4	80	0.0500000
NODE_2925_length_1346_cov_13.112269	429	509	0	10	80	0.1250000
NODE_2925_length_1346_cov_13.112269	429	509	1	70	80	0.8750000
NODE_2925_length_1346_cov_13.112269	482	562	1	43	80	0.5375000
NODE_2925_length_1346_cov_13.112269	482	562	2	37	80	0.4625000
NODE_2928_length_1345_cov_32.099518	629	709	10	10	80	0.1250000
NODE_2928_length_1345_cov_32.099518	629	709	11	5	80	0.0625000
NODE_2928_length_1345_cov_32.099518	629	709	12	7	80	0.0875000
NODE_2928_length_1345_cov_32.099518	629	709	13	45	80	0.5625000
NODE_2928_length_1345_cov_32.099518	629	709	14	10	80	0.1250000
NODE_2928_length_1345_cov_32.099518	629	709	15	3	80	0.0375000
NODE_2928_length_1345_cov_32.099518	682	762	4	4	80	0.0500000
NODE_2928_length_1345_cov_32.099518	682	762	5	14	80	0.1750000
NODE_2928_length_1345_cov_32.099518	682	762	6	3	80	0.0375000
NODE_2928_length_1345_cov_32.099518	682	762	7	24	80	0.3000000
NODE_2928_length_1345_cov_32.099518	682	762	8	5	80	0.0625000
NODE_2928_length_1345_cov_32.099518	682	762	9	1	80	0.0125000
NODE_2928_length_1345_cov_32.099518	682	762	10	12	80	0.1500000
NODE_2928_length_1345_cov_32.099518	682	762	11	5	80	0.0625000
NODE_2928_length_1345_cov_32.099518	682	762	13	4	80	0.0500000
NODE_2928_length_1345_cov_32.099518	682	762	14	8	80	0.1000000
NODE_2929_length_1345_cov_19.837881	723	803	4	2	80	0.0250000
NODE_2929_length_1345_cov_19.837881	723	803	6	14	80	0.1750000
NODE_2929_length_1345_cov_19.837881	723	803	8	47	80	0.5875000
NODE_2929_length_1345_cov_19.837881	723	803	9	17	80	0.2125000
NODE_2929_length_1345_cov_19.837881	776	856	6	10	80	0.1250000
NODE_2929_length_1345_cov_19.837881	776	856	7	8	80	0.1000000
NODE_2929_length_1345_cov_19.837881	776	856	8	53	80	0.6625000
NODE_2929_length_1345_cov_19.837881	776	856	9	9	80	0.1125000
NODE_2930_length_1345_cov_14.262440	361	441	3	5	80	0.0625000
NODE_2930_length_1345_cov_14.262440	361	441	4	9	80	0.1125000
NODE_2930_length_1345_cov_14.262440	361	441	6	66	80	0.8250000
NODE_2930_length_1345_cov_14.262440	414	494	1	13	80	0.1625000
NODE_2930_length_1345_cov_14.262440	414	494	2	33	80	0.4125000
NODE_2930_length_1345_cov_14.262440	414	494	3	12	80	0.1500000
NODE_2930_length_1345_cov_14.262440	414	494	4	9	80	0.1125000
NODE_2930_length_1345_cov_14.262440	414	494	6	13	80	0.1625000
NODE_2930_length_1345_cov_14.262440	490	570	2	2	80	0.0250000
NODE_2930_length_1345_cov_14.262440	490	570	3	10	80	0.1250000
NODE_2930_length_1345_cov_14.262440	490	570	5	1	80	0.0125000
NODE_2930_length_1345_cov_14.262440	490	570	6	1	80	0.0125000
NODE_2930_length_1345_cov_14.262440	490	570	7	22	80	0.2750000
NODE_2930_length_1345_cov_14.262440	490	570	9	6	80	0.0750000
NODE_2930_length_1345_cov_14.262440	490	570	10	2	80	0.0250000
NODE_2930_length_1345_cov_14.262440	490	570	11	36	80	0.4500000
NODE_2930_length_1345_cov_14.262440	543	623	9	5	80	0.0625000
NODE_2930_length_1345_cov_14.262440	543	623	11	75	80	0.9375000
NODE_2931_length_1345_cov_14.103531	950	1030	6	17	80	0.2125000
NODE_2931_length_1345_cov_14.103531	950	1030	8	63	80	0.7875000
NODE_2931_length_1345_cov_14.103531	1003	1083	6	12	80	0.1500000
NODE_2931_length_1345_cov_14.103531	1003	1083	7	30	80	0.3750000
NODE_2931_length_1345_cov_14.103531	1003	1083	8	38	80	0.4750000
NODE_2934_length_1344_cov_15.013655	345	425	3	9	80	0.1125000
NODE_2934_length_1344_cov_15.013655	345	425	5	12	80	0.1500000
NODE_2934_length_1344_cov_15.013655	345	425	7	10	80	0.1250000
NODE_2934_length_1344_cov_15.013655	345	425	12	6	80	0.0750000
NODE_2934_length_1344_cov_15.013655	345	425	13	5	80	0.0625000
NODE_2934_length_1344_cov_15.013655	345	425	15	8	80	0.1000000
NODE_2934_length_1344_cov_15.013655	345	425	16	7	80	0.0875000
NODE_2934_length_1344_cov_15.013655	345	425	19	3	80	0.0375000
NODE_2934_length_1344_cov_15.013655	345	425	20	7	80	0.0875000
NODE_2934_length_1344_cov_15.013655	345	425	21	13	80	0.1625000
NODE_2934_length_1344_cov_15.013655	398	478	16	4	80	0.0500000
NODE_2934_length_1344_cov_15.013655	398	478	19	3	80	0.0375000
NODE_2934_length_1344_cov_15.013655	398	478	20	7	80	0.0875000
NODE_2934_length_1344_cov_15.013655	398	478	21	25	80	0.3125000
NODE_2934_length_1344_cov_15.013655	398	478	24	3	80	0.0375000
NODE_2934_length_1344_cov_15.013655	398	478	25	1	80	0.0125000
NODE_2934_length_1344_cov_15.013655	398	478	26	7	80	0.0875000
NODE_2934_length_1344_cov_15.013655	398	478	28	4	80	0.0500000
NODE_2934_length_1344_cov_15.013655	398	478	29	8	80	0.1000000
NODE_2934_length_1344_cov_15.013655	398	478	30	10	80	0.1250000
NODE_2934_length_1344_cov_15.013655	398	478	31	8	80	0.1000000
NODE_2935_length_1344_cov_11.383133	519	599	0	80	80	1.0000000
NODE_2935_length_1344_cov_11.383133	572	652	0	74	80	0.9250000
NODE_2935_length_1344_cov_11.383133	572	652	2	1	80	0.0125000
NODE_2935_length_1344_cov_11.383133	572	652	3	1	80	0.0125000
NODE_2935_length_1344_cov_11.383133	572	652	4	4	80	0.0500000
NODE_2935_length_1344_cov_11.383133	648	728	4	80	80	1.0000000
NODE_2935_length_1344_cov_11.383133	701	781	4	80	80	1.0000000
NODE_2936_length_1344_cov_10.924498	529	609	6	41	80	0.5125000
NODE_2936_length_1344_cov_10.924498	529	609	9	35	80	0.4375000
NODE_2936_length_1344_cov_10.924498	529	609	10	4	80	0.0500000
NODE_2936_length_1344_cov_10.924498	582	662	2	4	80	0.0500000
NODE_2936_length_1344_cov_10.924498	582	662	3	19	80	0.2375000
NODE_2936_length_1344_cov_10.924498	582	662	4	19	80	0.2375000
NODE_2936_length_1344_cov_10.924498	582	662	5	1	80	0.0125000
NODE_2936_length_1344_cov_10.924498	582	662	6	37	80	0.4625000
NODE_2937_length_1344_cov_5.531727	920	975	0	55	55	1.0000000
NODE_2942_length_1343_cov_36.005627	150	230	11	2	80	0.0250000
NODE_2942_length_1343_cov_36.005627	150	230	12	7	80	0.0875000
NODE_2942_length_1343_cov_36.005627	150	230	13	18	80	0.2250000
NODE_2942_length_1343_cov_36.005627	150	230	14	20	80	0.2500000
NODE_2942_length_1343_cov_36.005627	150	230	16	6	80	0.0750000
NODE_2942_length_1343_cov_36.005627	150	230	18	11	80	0.1375000
NODE_2942_length_1343_cov_36.005627	150	230	19	12	80	0.1500000
NODE_2942_length_1343_cov_36.005627	150	230	22	4	80	0.0500000
NODE_2942_length_1343_cov_36.005627	286	366	3	37	80	0.4625000
NODE_2942_length_1343_cov_36.005627	286	366	7	1	80	0.0125000
NODE_2942_length_1343_cov_36.005627	286	366	8	2	80	0.0250000
NODE_2942_length_1343_cov_36.005627	286	366	9	26	80	0.3250000
NODE_2942_length_1343_cov_36.005627	286	366	10	5	80	0.0625000
NODE_2942_length_1343_cov_36.005627	286	366	11	9	80	0.1125000
NODE_2942_length_1343_cov_36.005627	339	419	3	80	80	1.0000000
NODE_2942_length_1343_cov_36.005627	415	495	1	25	80	0.3125000
NODE_2942_length_1343_cov_36.005627	415	495	2	18	80	0.2250000
NODE_2942_length_1343_cov_36.005627	415	495	3	37	80	0.4625000
NODE_2942_length_1343_cov_36.005627	468	548	1	78	80	0.9750000
NODE_2942_length_1343_cov_36.005627	468	548	2	2	80	0.0250000
NODE_2943_length_1343_cov_26.826367	782	862	5	27	80	0.3375000
NODE_2943_length_1343_cov_26.826367	782	862	7	16	80	0.2000000
NODE_2943_length_1343_cov_26.826367	782	862	8	8	80	0.1000000
NODE_2943_length_1343_cov_26.826367	782	862	9	16	80	0.2000000
NODE_2943_length_1343_cov_26.826367	782	862	13	13	80	0.1625000
NODE_2943_length_1343_cov_26.826367	835	915	8	8	80	0.1000000
NODE_2943_length_1343_cov_26.826367	835	915	9	6	80	0.0750000
NODE_2943_length_1343_cov_26.826367	835	915	11	16	80	0.2000000
NODE_2943_length_1343_cov_26.826367	835	915	12	21	80	0.2625000
NODE_2943_length_1343_cov_26.826367	835	915	13	26	80	0.3250000
NODE_2943_length_1343_cov_26.826367	835	915	15	1	80	0.0125000
NODE_2943_length_1343_cov_26.826367	835	915	17	2	80	0.0250000
NODE_2944_length_1343_cov_19.353698	799	879	0	49	80	0.6125000
NODE_2944_length_1343_cov_19.353698	799	879	1	31	80	0.3875000
NODE_2944_length_1343_cov_19.353698	852	932	1	29	80	0.3625000
NODE_2944_length_1343_cov_19.353698	852	932	2	35	80	0.4375000
NODE_2944_length_1343_cov_19.353698	852	932	3	1	80	0.0125000
NODE_2944_length_1343_cov_19.353698	852	932	4	12	80	0.1500000
NODE_2944_length_1343_cov_19.353698	852	932	6	3	80	0.0375000
NODE_2944_length_1343_cov_19.353698	928	1008	4	1	80	0.0125000
NODE_2944_length_1343_cov_19.353698	928	1008	6	4	80	0.0500000
NODE_2944_length_1343_cov_19.353698	928	1008	7	7	80	0.0875000
NODE_2944_length_1343_cov_19.353698	928	1008	8	9	80	0.1125000
NODE_2944_length_1343_cov_19.353698	928	1008	11	1	80	0.0125000
NODE_2944_length_1343_cov_19.353698	928	1008	12	19	80	0.2375000
NODE_2944_length_1343_cov_19.353698	928	1008	14	10	80	0.1250000
NODE_2944_length_1343_cov_19.353698	928	1008	15	10	80	0.1250000
NODE_2944_length_1343_cov_19.353698	928	1008	16	19	80	0.2375000
NODE_2944_length_1343_cov_19.353698	981	1061	14	10	80	0.1250000
NODE_2944_length_1343_cov_19.353698	981	1061	15	34	80	0.4250000
NODE_2944_length_1343_cov_19.353698	981	1061	16	17	80	0.2125000
NODE_2944_length_1343_cov_19.353698	981	1061	17	19	80	0.2375000
NODE_2945_length_1343_cov_15.717846	745	825	7	39	80	0.4875000
NODE_2945_length_1343_cov_15.717846	745	825	8	7	80	0.0875000
NODE_2945_length_1343_cov_15.717846	745	825	9	6	80	0.0750000
NODE_2945_length_1343_cov_15.717846	745	825	10	13	80	0.1625000
NODE_2945_length_1343_cov_15.717846	745	825	11	8	80	0.1000000
NODE_2945_length_1343_cov_15.717846	745	825	12	7	80	0.0875000
NODE_2945_length_1343_cov_15.717846	798	878	6	29	80	0.3625000
NODE_2945_length_1343_cov_15.717846	798	878	7	18	80	0.2250000
NODE_2945_length_1343_cov_15.717846	798	878	8	23	80	0.2875000
NODE_2945_length_1343_cov_15.717846	798	878	9	10	80	0.1250000
NODE_2949_length_1342_cov_30.491553	456	536	2	12	80	0.1500000
NODE_2949_length_1342_cov_30.491553	456	536	3	16	80	0.2000000
NODE_2949_length_1342_cov_30.491553	456	536	4	29	80	0.3625000
NODE_2949_length_1342_cov_30.491553	456	536	5	23	80	0.2875000
NODE_2949_length_1342_cov_30.491553	509	589	4	35	80	0.4375000
NODE_2949_length_1342_cov_30.491553	509	589	5	10	80	0.1250000
NODE_2949_length_1342_cov_30.491553	509	589	6	35	80	0.4375000
NODE_2949_length_1342_cov_30.491553	585	665	3	20	80	0.2500000
NODE_2949_length_1342_cov_30.491553	585	665	4	2	80	0.0250000
NODE_2949_length_1342_cov_30.491553	585	665	5	25	80	0.3125000
NODE_2949_length_1342_cov_30.491553	585	665	6	33	80	0.4125000
NODE_2949_length_1342_cov_30.491553	638	718	3	43	80	0.5375000
NODE_2949_length_1342_cov_30.491553	638	718	5	27	80	0.3375000
NODE_2949_length_1342_cov_30.491553	638	718	6	10	80	0.1250000
NODE_2950_length_1342_cov_26.796460	538	618	15	2	80	0.0250000
NODE_2950_length_1342_cov_26.796460	538	618	16	5	80	0.0625000
NODE_2950_length_1342_cov_26.796460	538	618	18	24	80	0.3000000
NODE_2950_length_1342_cov_26.796460	538	618	19	14	80	0.1750000
NODE_2950_length_1342_cov_26.796460	538	618	20	15	80	0.1875000
NODE_2950_length_1342_cov_26.796460	538	618	21	18	80	0.2250000
NODE_2950_length_1342_cov_26.796460	538	618	22	2	80	0.0250000
NODE_2950_length_1342_cov_26.796460	591	671	14	12	80	0.1500000
NODE_2950_length_1342_cov_26.796460	591	671	15	4	80	0.0500000
NODE_2950_length_1342_cov_26.796460	591	671	16	8	80	0.1000000
NODE_2950_length_1342_cov_26.796460	591	671	17	2	80	0.0250000
NODE_2950_length_1342_cov_26.796460	591	671	19	18	80	0.2250000
NODE_2950_length_1342_cov_26.796460	591	671	20	16	80	0.2000000
NODE_2950_length_1342_cov_26.796460	591	671	21	18	80	0.2250000
NODE_2950_length_1342_cov_26.796460	591	671	22	2	80	0.0250000
NODE_2950_length_1342_cov_26.796460	667	747	3	5	80	0.0625000
NODE_2950_length_1342_cov_26.796460	667	747	4	9	80	0.1125000
NODE_2950_length_1342_cov_26.796460	667	747	6	13	80	0.1625000
NODE_2950_length_1342_cov_26.796460	667	747	7	13	80	0.1625000
NODE_2950_length_1342_cov_26.796460	667	747	8	12	80	0.1500000
NODE_2950_length_1342_cov_26.796460	667	747	10	5	80	0.0625000
NODE_2950_length_1342_cov_26.796460	667	747	11	9	80	0.1125000
NODE_2950_length_1342_cov_26.796460	667	747	13	3	80	0.0375000
NODE_2950_length_1342_cov_26.796460	667	747	14	11	80	0.1375000
NODE_2950_length_1342_cov_26.796460	720	800	0	45	80	0.5625000
NODE_2950_length_1342_cov_26.796460	720	800	1	6	80	0.0750000
NODE_2950_length_1342_cov_26.796460	720	800	3	7	80	0.0875000
NODE_2950_length_1342_cov_26.796460	720	800	4	9	80	0.1125000
NODE_2950_length_1342_cov_26.796460	720	800	6	13	80	0.1625000
NODE_2951_length_1342_cov_22.769912	298	378	12	5	80	0.0625000
NODE_2951_length_1342_cov_22.769912	298	378	13	3	80	0.0375000
NODE_2951_length_1342_cov_22.769912	298	378	15	4	80	0.0500000
NODE_2951_length_1342_cov_22.769912	298	378	16	32	80	0.4000000
NODE_2951_length_1342_cov_22.769912	298	378	17	8	80	0.1000000
NODE_2951_length_1342_cov_22.769912	298	378	18	3	80	0.0375000
NODE_2951_length_1342_cov_22.769912	298	378	19	25	80	0.3125000
NODE_2951_length_1342_cov_22.769912	351	431	9	5	80	0.0625000
NODE_2951_length_1342_cov_22.769912	351	431	10	31	80	0.3875000
NODE_2951_length_1342_cov_22.769912	351	431	12	11	80	0.1375000
NODE_2951_length_1342_cov_22.769912	351	431	13	6	80	0.0750000
NODE_2951_length_1342_cov_22.769912	351	431	14	8	80	0.1000000
NODE_2951_length_1342_cov_22.769912	351	431	15	4	80	0.0500000
NODE_2951_length_1342_cov_22.769912	351	431	17	5	80	0.0625000
NODE_2951_length_1342_cov_22.769912	351	431	18	3	80	0.0375000
NODE_2951_length_1342_cov_22.769912	351	431	19	7	80	0.0875000
NODE_2951_length_1342_cov_22.769912	427	507	5	8	80	0.1000000
NODE_2951_length_1342_cov_22.769912	427	507	7	3	80	0.0375000
NODE_2951_length_1342_cov_22.769912	427	507	8	35	80	0.4375000
NODE_2951_length_1342_cov_22.769912	427	507	9	18	80	0.2250000
NODE_2951_length_1342_cov_22.769912	427	507	11	1	80	0.0125000
NODE_2951_length_1342_cov_22.769912	427	507	12	9	80	0.1125000
NODE_2951_length_1342_cov_22.769912	427	507	13	5	80	0.0625000
NODE_2951_length_1342_cov_22.769912	427	507	14	1	80	0.0125000
NODE_2951_length_1342_cov_22.769912	480	560	5	8	80	0.1000000
NODE_2951_length_1342_cov_22.769912	480	560	7	3	80	0.0375000
NODE_2951_length_1342_cov_22.769912	480	560	8	14	80	0.1750000
NODE_2951_length_1342_cov_22.769912	480	560	9	55	80	0.6875000
NODE_2953_length_1341_cov_22.449275	494	574	7	3	80	0.0375000
NODE_2953_length_1341_cov_22.449275	494	574	8	3	80	0.0375000
NODE_2953_length_1341_cov_22.449275	494	574	9	13	80	0.1625000
NODE_2953_length_1341_cov_22.449275	494	574	10	3	80	0.0375000
NODE_2953_length_1341_cov_22.449275	494	574	11	19	80	0.2375000
NODE_2953_length_1341_cov_22.449275	494	574	12	21	80	0.2625000
NODE_2953_length_1341_cov_22.449275	494	574	16	17	80	0.2125000
NODE_2953_length_1341_cov_22.449275	494	574	17	1	80	0.0125000
NODE_2953_length_1341_cov_22.449275	547	627	11	1	80	0.0125000
NODE_2953_length_1341_cov_22.449275	547	627	12	9	80	0.1125000
NODE_2953_length_1341_cov_22.449275	547	627	14	1	80	0.0125000
NODE_2953_length_1341_cov_22.449275	547	627	15	15	80	0.1875000
NODE_2953_length_1341_cov_22.449275	547	627	16	17	80	0.2125000
NODE_2953_length_1341_cov_22.449275	547	627	17	21	80	0.2625000
NODE_2953_length_1341_cov_22.449275	547	627	18	15	80	0.1875000
NODE_2953_length_1341_cov_22.449275	547	627	19	1	80	0.0125000
NODE_2953_length_1341_cov_22.449275	623	703	14	19	80	0.2375000
NODE_2953_length_1341_cov_22.449275	623	703	15	18	80	0.2250000
NODE_2953_length_1341_cov_22.449275	623	703	16	3	80	0.0375000
NODE_2953_length_1341_cov_22.449275	623	703	17	35	80	0.4375000
NODE_2953_length_1341_cov_22.449275	623	703	19	5	80	0.0625000
NODE_2953_length_1341_cov_22.449275	676	755	8	25	79	0.3164557
NODE_2953_length_1341_cov_22.449275	676	755	9	24	79	0.3037975
NODE_2953_length_1341_cov_22.449275	676	755	14	22	79	0.2784810
NODE_2953_length_1341_cov_22.449275	676	755	15	8	79	0.1012658
NODE_2954_length_1341_cov_14.497585	415	495	2	72	80	0.9000000
NODE_2954_length_1341_cov_14.497585	415	495	3	8	80	0.1000000
NODE_2954_length_1341_cov_14.497585	468	548	2	71	80	0.8875000
NODE_2954_length_1341_cov_14.497585	468	548	3	9	80	0.1125000
NODE_2954_length_1341_cov_14.497585	544	624	1	75	80	0.9375000
NODE_2954_length_1341_cov_14.497585	544	624	2	5	80	0.0625000
NODE_2954_length_1341_cov_14.497585	597	677	1	66	80	0.8250000
NODE_2954_length_1341_cov_14.497585	597	677	2	14	80	0.1750000
NODE_2960_length_1340_cov_9.460113	531	611	8	46	80	0.5750000
NODE_2960_length_1340_cov_9.460113	531	611	9	34	80	0.4250000
NODE_2960_length_1340_cov_9.460113	584	664	7	6	80	0.0750000
NODE_2960_length_1340_cov_9.460113	584	664	8	2	80	0.0250000
NODE_2960_length_1340_cov_9.460113	584	664	9	40	80	0.5000000
NODE_2960_length_1340_cov_9.460113	584	664	10	17	80	0.2125000
NODE_2960_length_1340_cov_9.460113	584	664	11	15	80	0.1875000
NODE_2961_length_1340_cov_6.511684	735	815	0	80	80	1.0000000
NODE_2961_length_1340_cov_6.511684	788	868	0	80	80	1.0000000
NODE_2966_length_1339_cov_22.725000	751	831	3	4	80	0.0500000
NODE_2966_length_1339_cov_22.725000	751	831	4	1	80	0.0125000
NODE_2966_length_1339_cov_22.725000	751	831	5	5	80	0.0625000
NODE_2966_length_1339_cov_22.725000	751	831	6	3	80	0.0375000
NODE_2966_length_1339_cov_22.725000	751	831	7	3	80	0.0375000
NODE_2966_length_1339_cov_22.725000	751	831	8	22	80	0.2750000
NODE_2966_length_1339_cov_22.725000	751	831	10	14	80	0.1750000
NODE_2966_length_1339_cov_22.725000	751	831	15	28	80	0.3500000
NODE_2966_length_1339_cov_22.725000	804	884	12	15	80	0.1875000
NODE_2966_length_1339_cov_22.725000	804	884	14	8	80	0.1000000
NODE_2966_length_1339_cov_22.725000	804	884	15	57	80	0.7125000
NODE_2967_length_1339_cov_9.322581	329	409	2	12	80	0.1500000
NODE_2967_length_1339_cov_9.322581	329	409	3	1	80	0.0125000
NODE_2967_length_1339_cov_9.322581	329	409	4	67	80	0.8375000
NODE_2967_length_1339_cov_9.322581	382	462	2	29	80	0.3625000
NODE_2967_length_1339_cov_9.322581	382	462	3	19	80	0.2375000
NODE_2967_length_1339_cov_9.322581	382	462	4	32	80	0.4000000
NODE_2970_length_1338_cov_31.740920	527	607	7	4	80	0.0500000
NODE_2970_length_1338_cov_31.740920	527	607	8	14	80	0.1750000
NODE_2970_length_1338_cov_31.740920	527	607	9	3	80	0.0375000
NODE_2970_length_1338_cov_31.740920	527	607	11	10	80	0.1250000
NODE_2970_length_1338_cov_31.740920	527	607	12	4	80	0.0500000
NODE_2970_length_1338_cov_31.740920	527	607	13	6	80	0.0750000
NODE_2970_length_1338_cov_31.740920	527	607	15	15	80	0.1875000
NODE_2970_length_1338_cov_31.740920	527	607	16	4	80	0.0500000
NODE_2970_length_1338_cov_31.740920	527	607	17	1	80	0.0125000
NODE_2970_length_1338_cov_31.740920	527	607	18	7	80	0.0875000
NODE_2970_length_1338_cov_31.740920	527	607	19	12	80	0.1500000
NODE_2970_length_1338_cov_31.740920	580	660	15	6	80	0.0750000
NODE_2970_length_1338_cov_31.740920	580	660	16	9	80	0.1125000
NODE_2970_length_1338_cov_31.740920	580	660	17	3	80	0.0375000
NODE_2970_length_1338_cov_31.740920	580	660	18	9	80	0.1125000
NODE_2970_length_1338_cov_31.740920	580	660	19	12	80	0.1500000
NODE_2970_length_1338_cov_31.740920	580	660	20	15	80	0.1875000
NODE_2970_length_1338_cov_31.740920	580	660	21	5	80	0.0625000
NODE_2970_length_1338_cov_31.740920	580	660	23	1	80	0.0125000
NODE_2970_length_1338_cov_31.740920	580	660	24	2	80	0.0250000
NODE_2970_length_1338_cov_31.740920	580	660	26	18	80	0.2250000
NODE_2970_length_1338_cov_31.740920	656	736	16	1	80	0.0125000
NODE_2970_length_1338_cov_31.740920	656	736	19	17	80	0.2125000
NODE_2970_length_1338_cov_31.740920	656	736	22	6	80	0.0750000
NODE_2970_length_1338_cov_31.740920	656	736	23	4	80	0.0500000
NODE_2970_length_1338_cov_31.740920	656	736	24	10	80	0.1250000
NODE_2970_length_1338_cov_31.740920	656	736	26	18	80	0.2250000
NODE_2970_length_1338_cov_31.740920	656	736	27	24	80	0.3000000
NODE_2970_length_1338_cov_31.740920	709	789	11	8	80	0.1000000
NODE_2970_length_1338_cov_31.740920	709	789	12	14	80	0.1750000
NODE_2970_length_1338_cov_31.740920	709	789	15	1	80	0.0125000
NODE_2970_length_1338_cov_31.740920	709	789	16	4	80	0.0500000
NODE_2970_length_1338_cov_31.740920	709	789	17	11	80	0.1375000
NODE_2970_length_1338_cov_31.740920	709	789	18	16	80	0.2000000
NODE_2970_length_1338_cov_31.740920	709	789	19	17	80	0.2125000
NODE_2970_length_1338_cov_31.740920	709	789	22	6	80	0.0750000
NODE_2970_length_1338_cov_31.740920	709	789	23	3	80	0.0375000
NODE_2971_length_1338_cov_21.254237	639	719	6	6	80	0.0750000
NODE_2971_length_1338_cov_21.254237	639	719	7	33	80	0.4125000
NODE_2971_length_1338_cov_21.254237	639	719	8	41	80	0.5125000
NODE_2971_length_1338_cov_21.254237	692	772	6	29	80	0.3625000
NODE_2971_length_1338_cov_21.254237	692	772	7	45	80	0.5625000
NODE_2971_length_1338_cov_21.254237	692	772	8	6	80	0.0750000
NODE_2974_length_1337_cov_32.307754	739	819	3	11	80	0.1375000
NODE_2974_length_1337_cov_32.307754	739	819	4	27	80	0.3375000
NODE_2974_length_1337_cov_32.307754	739	819	5	27	80	0.3375000
NODE_2974_length_1337_cov_32.307754	739	819	6	15	80	0.1875000
NODE_2974_length_1337_cov_32.307754	792	872	1	14	80	0.1750000
NODE_2974_length_1337_cov_32.307754	792	872	2	32	80	0.4000000
NODE_2974_length_1337_cov_32.307754	792	872	3	18	80	0.2250000
NODE_2974_length_1337_cov_32.307754	792	872	4	16	80	0.2000000
NODE_2975_length_1337_cov_30.412763	465	545	0	11	80	0.1375000
NODE_2975_length_1337_cov_30.412763	465	545	3	7	80	0.0875000
NODE_2975_length_1337_cov_30.412763	465	545	5	62	80	0.7750000
NODE_2975_length_1337_cov_30.412763	518	598	0	14	80	0.1750000
NODE_2975_length_1337_cov_30.412763	518	598	5	66	80	0.8250000
NODE_2976_length_1337_cov_12.760905	560	640	2	48	80	0.6000000
NODE_2976_length_1337_cov_12.760905	560	640	3	32	80	0.4000000
NODE_2976_length_1337_cov_12.760905	613	693	1	29	80	0.3625000
NODE_2976_length_1337_cov_12.760905	613	693	2	51	80	0.6375000
NODE_2977_length_1337_cov_9.463651	724	804	2	80	80	1.0000000
NODE_2977_length_1337_cov_9.463651	777	857	0	26	80	0.3250000
NODE_2977_length_1337_cov_9.463651	777	857	2	54	80	0.6750000
NODE_2979_length_1337_cov_4.540388	216	296	5	6	80	0.0750000
NODE_2979_length_1337_cov_4.540388	216	296	6	19	80	0.2375000
NODE_2979_length_1337_cov_4.540388	216	296	7	31	80	0.3875000
NODE_2979_length_1337_cov_4.540388	216	296	10	24	80	0.3000000
NODE_2979_length_1337_cov_4.540388	272	349	7	37	77	0.4805195
NODE_2979_length_1337_cov_4.540388	272	349	10	40	77	0.5194805
NODE_2981_length_1336_cov_28.161681	394	474	6	10	80	0.1250000
NODE_2981_length_1336_cov_28.161681	394	474	7	16	80	0.2000000
NODE_2981_length_1336_cov_28.161681	394	474	8	32	80	0.4000000
NODE_2981_length_1336_cov_28.161681	394	474	9	22	80	0.2750000
NODE_2981_length_1336_cov_28.161681	447	527	6	7	80	0.0875000
NODE_2981_length_1336_cov_28.161681	447	527	7	1	80	0.0125000
NODE_2981_length_1336_cov_28.161681	447	527	8	8	80	0.1000000
NODE_2981_length_1336_cov_28.161681	447	527	9	18	80	0.2250000
NODE_2981_length_1336_cov_28.161681	447	527	10	31	80	0.3875000
NODE_2981_length_1336_cov_28.161681	447	527	11	15	80	0.1875000
NODE_2981_length_1336_cov_28.161681	523	603	10	19	80	0.2375000
NODE_2981_length_1336_cov_28.161681	523	603	11	30	80	0.3750000
NODE_2981_length_1336_cov_28.161681	523	603	12	31	80	0.3875000
NODE_2981_length_1336_cov_28.161681	576	656	5	14	80	0.1750000
NODE_2981_length_1336_cov_28.161681	576	656	6	7	80	0.0875000
NODE_2981_length_1336_cov_28.161681	576	656	7	11	80	0.1375000
NODE_2981_length_1336_cov_28.161681	576	656	8	7	80	0.0875000
NODE_2981_length_1336_cov_28.161681	576	656	10	1	80	0.0125000
NODE_2981_length_1336_cov_28.161681	576	656	11	30	80	0.3750000
NODE_2981_length_1336_cov_28.161681	576	656	12	10	80	0.1250000
NODE_2982_length_1336_cov_7.860954	17	98	2	81	81	1.0000000
NODE_2984_length_1336_cov_1.689572	1229	1289	0	60	60	1.0000000
NODE_2984_length_1336_cov_1.689572	1262	1336	0	74	74	1.0000000
NODE_2985_length_1335_cov_19.547735	530	607	2	4	77	0.0519481
NODE_2985_length_1335_cov_19.547735	530	607	3	73	77	0.9480519
NODE_2985_length_1335_cov_19.547735	582	660	2	4	78	0.0512821
NODE_2985_length_1335_cov_19.547735	582	660	3	74	78	0.9487180
NODE_2985_length_1335_cov_19.547735	656	736	1	5	80	0.0625000
NODE_2985_length_1335_cov_19.547735	656	736	2	27	80	0.3375000
NODE_2985_length_1335_cov_19.547735	656	736	3	2	80	0.0250000
NODE_2985_length_1335_cov_19.547735	656	736	4	5	80	0.0625000
NODE_2985_length_1335_cov_19.547735	656	736	5	41	80	0.5125000
NODE_2985_length_1335_cov_19.547735	709	789	5	65	80	0.8125000
NODE_2985_length_1335_cov_19.547735	709	789	7	15	80	0.1875000
NODE_2986_length_1335_cov_15.383495	419	499	5	10	80	0.1250000
NODE_2986_length_1335_cov_15.383495	419	499	6	36	80	0.4500000
NODE_2986_length_1335_cov_15.383495	419	499	7	34	80	0.4250000
NODE_2986_length_1335_cov_15.383495	472	552	3	19	80	0.2375000
NODE_2986_length_1335_cov_15.383495	472	552	4	21	80	0.2625000
NODE_2986_length_1335_cov_15.383495	472	552	5	23	80	0.2875000
NODE_2986_length_1335_cov_15.383495	472	552	6	17	80	0.2125000
NODE_2986_length_1335_cov_15.383495	548	628	0	53	80	0.6625000
NODE_2986_length_1335_cov_15.383495	548	628	1	19	80	0.2375000
NODE_2986_length_1335_cov_15.383495	548	628	2	1	80	0.0125000
NODE_2986_length_1335_cov_15.383495	548	628	3	7	80	0.0875000
NODE_2986_length_1335_cov_15.383495	601	681	0	80	80	1.0000000
NODE_2991_length_1333_cov_27.372771	493	573	8	25	80	0.3125000
NODE_2991_length_1333_cov_27.372771	493	573	9	47	80	0.5875000
NODE_2991_length_1333_cov_27.372771	493	573	10	7	80	0.0875000
NODE_2991_length_1333_cov_27.372771	493	573	12	1	80	0.0125000
NODE_2991_length_1333_cov_27.372771	546	626	7	36	80	0.4500000
NODE_2991_length_1333_cov_27.372771	546	626	8	42	80	0.5250000
NODE_2991_length_1333_cov_27.372771	546	626	10	2	80	0.0250000
NODE_2996_length_1332_cov_18.978913	648	728	1	12	80	0.1500000
NODE_2996_length_1332_cov_18.978913	648	728	2	53	80	0.6625000
NODE_2996_length_1332_cov_18.978913	648	728	4	15	80	0.1875000
NODE_2996_length_1332_cov_18.978913	701	781	2	12	80	0.1500000
NODE_2996_length_1332_cov_18.978913	701	781	3	17	80	0.2125000
NODE_2996_length_1332_cov_18.978913	701	781	4	51	80	0.6375000
NODE_2996_length_1332_cov_18.978913	777	857	3	6	80	0.0750000
NODE_2996_length_1332_cov_18.978913	777	857	4	47	80	0.5875000
NODE_2996_length_1332_cov_18.978913	777	857	5	27	80	0.3375000
NODE_2996_length_1332_cov_18.978913	830	910	2	47	80	0.5875000
NODE_2996_length_1332_cov_18.978913	830	910	4	33	80	0.4125000
NODE_2997_length_1332_cov_3.112733	87	151	0	64	64	1.0000000
NODE_3000_length_1331_cov_16.831981	392	472	5	50	80	0.6250000
NODE_3000_length_1331_cov_16.831981	392	472	6	19	80	0.2375000
NODE_3000_length_1331_cov_16.831981	392	472	7	7	80	0.0875000
NODE_3000_length_1331_cov_16.831981	392	472	8	4	80	0.0500000
NODE_3000_length_1331_cov_16.831981	445	525	6	19	80	0.2375000
NODE_3000_length_1331_cov_16.831981	445	525	7	4	80	0.0500000
NODE_3000_length_1331_cov_16.831981	445	525	8	41	80	0.5125000
NODE_3000_length_1331_cov_16.831981	445	525	9	10	80	0.1250000
NODE_3000_length_1331_cov_16.831981	445	525	10	6	80	0.0750000
NODE_3000_length_1331_cov_16.831981	521	601	5	3	80	0.0375000
NODE_3000_length_1331_cov_16.831981	521	601	6	7	80	0.0875000
NODE_3000_length_1331_cov_16.831981	521	601	7	55	80	0.6875000
NODE_3000_length_1331_cov_16.831981	521	601	8	10	80	0.1250000
NODE_3000_length_1331_cov_16.831981	521	601	9	5	80	0.0625000
NODE_3000_length_1331_cov_16.831981	574	654	5	3	80	0.0375000
NODE_3000_length_1331_cov_16.831981	574	654	6	36	80	0.4500000
NODE_3000_length_1331_cov_16.831981	574	654	7	27	80	0.3375000
NODE_3000_length_1331_cov_16.831981	574	654	8	14	80	0.1750000
NODE_3001_length_1331_cov_12.841721	871	951	1	14	80	0.1750000
NODE_3001_length_1331_cov_12.841721	871	951	2	66	80	0.8250000
NODE_3001_length_1331_cov_12.841721	924	1004	1	32	80	0.4000000
NODE_3001_length_1331_cov_12.841721	924	1004	2	48	80	0.6000000
NODE_3004_length_1331_cov_2.090097	0	76	0	76	76	1.0000000
NODE_3004_length_1331_cov_2.090097	49	98	0	49	49	1.0000000
NODE_3007_length_1330_cov_48.993501	278	358	10	18	80	0.2250000
NODE_3007_length_1330_cov_48.993501	278	358	11	32	80	0.4000000
NODE_3007_length_1330_cov_48.993501	278	358	12	7	80	0.0875000
NODE_3007_length_1330_cov_48.993501	278	358	14	8	80	0.1000000
NODE_3007_length_1330_cov_48.993501	278	358	15	15	80	0.1875000
NODE_3007_length_1330_cov_48.993501	331	411	6	1	80	0.0125000
NODE_3007_length_1330_cov_48.993501	331	411	7	1	80	0.0125000
NODE_3007_length_1330_cov_48.993501	331	411	8	5	80	0.0625000
NODE_3007_length_1330_cov_48.993501	331	411	10	24	80	0.3000000
NODE_3007_length_1330_cov_48.993501	331	411	11	49	80	0.6125000
NODE_3007_length_1330_cov_48.993501	742	822	5	5	80	0.0625000
NODE_3007_length_1330_cov_48.993501	742	822	6	1	80	0.0125000
NODE_3007_length_1330_cov_48.993501	742	822	7	3	80	0.0375000
NODE_3007_length_1330_cov_48.993501	742	822	8	28	80	0.3500000
NODE_3007_length_1330_cov_48.993501	742	822	10	10	80	0.1250000
NODE_3007_length_1330_cov_48.993501	742	822	11	3	80	0.0375000
NODE_3007_length_1330_cov_48.993501	742	822	13	22	80	0.2750000
NODE_3007_length_1330_cov_48.993501	742	822	14	8	80	0.1000000
NODE_3007_length_1330_cov_48.993501	795	875	13	19	80	0.2375000
NODE_3007_length_1330_cov_48.993501	795	875	14	32	80	0.4000000
NODE_3007_length_1330_cov_48.993501	795	875	16	12	80	0.1500000
NODE_3007_length_1330_cov_48.993501	795	875	19	17	80	0.2125000
NODE_3008_length_1330_cov_11.037368	407	487	2	4	80	0.0500000
NODE_3008_length_1330_cov_11.037368	407	487	4	37	80	0.4625000
NODE_3008_length_1330_cov_11.037368	407	487	6	39	80	0.4875000
NODE_3008_length_1330_cov_11.037368	460	540	4	80	80	1.0000000
NODE_3008_length_1330_cov_11.037368	536	617	0	56	81	0.6913580
NODE_3008_length_1330_cov_11.037368	536	617	2	17	81	0.2098765
NODE_3008_length_1330_cov_11.037368	536	617	4	8	81	0.0987654
NODE_3008_length_1330_cov_11.037368	590	670	0	80	80	1.0000000
NODE_3009_length_1330_cov_9.026807	551	631	1	9	80	0.1125000
NODE_3009_length_1330_cov_9.026807	551	631	2	17	80	0.2125000
NODE_3009_length_1330_cov_9.026807	551	631	4	9	80	0.1125000
NODE_3009_length_1330_cov_9.026807	551	631	5	37	80	0.4625000
NODE_3009_length_1330_cov_9.026807	551	631	6	8	80	0.1000000
NODE_3009_length_1330_cov_9.026807	604	684	1	9	80	0.1125000
NODE_3009_length_1330_cov_9.026807	604	684	2	70	80	0.8750000
NODE_3009_length_1330_cov_9.026807	604	684	4	1	80	0.0125000
NODE_3011_length_1329_cov_17.036585	691	771	1	15	80	0.1875000
NODE_3011_length_1329_cov_17.036585	691	771	2	34	80	0.4250000
NODE_3011_length_1329_cov_17.036585	691	771	5	31	80	0.3875000
NODE_3011_length_1329_cov_17.036585	744	824	0	52	80	0.6500000
NODE_3011_length_1329_cov_17.036585	744	824	1	16	80	0.2000000
NODE_3011_length_1329_cov_17.036585	744	824	2	12	80	0.1500000
NODE_3011_length_1329_cov_17.036585	820	900	0	80	80	1.0000000
NODE_3011_length_1329_cov_17.036585	873	953	0	80	80	1.0000000
NODE_3012_length_1329_cov_16.341463	428	476	2	11	48	0.2291667
NODE_3012_length_1329_cov_16.341463	428	476	4	16	48	0.3333333
NODE_3012_length_1329_cov_16.341463	428	476	5	9	48	0.1875000
NODE_3012_length_1329_cov_16.341463	428	476	6	7	48	0.1458333
NODE_3012_length_1329_cov_16.341463	428	476	7	5	48	0.1041667
NODE_3013_length_1329_cov_5.620325	888	955	4	67	67	1.0000000
NODE_3013_length_1329_cov_5.620325	941	999	0	15	58	0.2586207
NODE_3013_length_1329_cov_5.620325	941	999	3	5	58	0.0862069
NODE_3013_length_1329_cov_5.620325	941	999	4	38	58	0.6551724
NODE_3017_length_1328_cov_12.954434	794	874	1	59	80	0.7375000
NODE_3017_length_1328_cov_12.954434	794	874	2	21	80	0.2625000
NODE_3017_length_1328_cov_12.954434	847	927	1	6	80	0.0750000
NODE_3017_length_1328_cov_12.954434	847	927	2	26	80	0.3250000
NODE_3017_length_1328_cov_12.954434	847	927	3	30	80	0.3750000
NODE_3017_length_1328_cov_12.954434	847	927	4	18	80	0.2250000
NODE_3018_length_1328_cov_8.810415	762	842	2	21	80	0.2625000
NODE_3018_length_1328_cov_8.810415	762	842	3	59	80	0.7375000
NODE_3018_length_1328_cov_8.810415	815	895	2	37	80	0.4625000
NODE_3018_length_1328_cov_8.810415	815	895	3	28	80	0.3500000
NODE_3018_length_1328_cov_8.810415	815	895	4	15	80	0.1875000
NODE_3021_length_1327_cov_15.938925	260	340	24	3	80	0.0375000
NODE_3021_length_1327_cov_15.938925	260	340	26	15	80	0.1875000
NODE_3021_length_1327_cov_15.938925	260	340	27	6	80	0.0750000
NODE_3021_length_1327_cov_15.938925	260	340	28	2	80	0.0250000
NODE_3021_length_1327_cov_15.938925	260	340	29	15	80	0.1875000
NODE_3021_length_1327_cov_15.938925	260	340	30	7	80	0.0875000
NODE_3021_length_1327_cov_15.938925	260	340	31	6	80	0.0750000
NODE_3021_length_1327_cov_15.938925	260	340	32	22	80	0.2750000
NODE_3021_length_1327_cov_15.938925	260	340	33	4	80	0.0500000
NODE_3021_length_1327_cov_15.938925	313	393	24	7	80	0.0875000
NODE_3021_length_1327_cov_15.938925	313	393	25	4	80	0.0500000
NODE_3021_length_1327_cov_15.938925	313	393	26	8	80	0.1000000
NODE_3021_length_1327_cov_15.938925	313	393	27	8	80	0.1000000
NODE_3021_length_1327_cov_15.938925	313	393	28	19	80	0.2375000
NODE_3021_length_1327_cov_15.938925	313	393	29	4	80	0.0500000
NODE_3021_length_1327_cov_15.938925	313	393	30	7	80	0.0875000
NODE_3021_length_1327_cov_15.938925	313	393	31	2	80	0.0250000
NODE_3021_length_1327_cov_15.938925	313	393	32	17	80	0.2125000
NODE_3021_length_1327_cov_15.938925	313	393	33	4	80	0.0500000
NODE_3022_length_1327_cov_7.274430	159	235	1	74	76	0.9736842
NODE_3022_length_1327_cov_7.274430	159	235	2	2	76	0.0263158
NODE_3022_length_1327_cov_7.274430	774	854	2	80	80	1.0000000
NODE_3022_length_1327_cov_7.274430	827	890	2	63	63	1.0000000
NODE_3023_length_1327_cov_6.486156	896	976	4	58	80	0.7250000
NODE_3023_length_1327_cov_6.486156	896	976	5	20	80	0.2500000
NODE_3023_length_1327_cov_6.486156	896	976	7	2	80	0.0250000
NODE_3023_length_1327_cov_6.486156	949	1029	4	80	80	1.0000000
NODE_3029_length_1326_cov_32.382233	571	651	4	56	80	0.7000000
NODE_3029_length_1326_cov_32.382233	571	651	6	1	80	0.0125000
NODE_3029_length_1326_cov_32.382233	571	651	8	23	80	0.2875000
NODE_3029_length_1326_cov_32.382233	624	704	4	56	80	0.7000000
NODE_3029_length_1326_cov_32.382233	624	704	6	1	80	0.0125000
NODE_3029_length_1326_cov_32.382233	624	704	8	23	80	0.2875000
NODE_3030_length_1326_cov_30.614507	760	840	3	7	80	0.0875000
NODE_3030_length_1326_cov_30.614507	760	840	4	28	80	0.3500000
NODE_3030_length_1326_cov_30.614507	760	840	5	2	80	0.0250000
NODE_3030_length_1326_cov_30.614507	760	840	6	14	80	0.1750000
NODE_3030_length_1326_cov_30.614507	760	840	9	6	80	0.0750000
NODE_3030_length_1326_cov_30.614507	760	840	10	16	80	0.2000000
NODE_3030_length_1326_cov_30.614507	760	840	12	7	80	0.0875000
NODE_3030_length_1326_cov_30.614507	813	893	9	4	80	0.0500000
NODE_3030_length_1326_cov_30.614507	813	893	10	16	80	0.2000000
NODE_3030_length_1326_cov_30.614507	813	893	12	33	80	0.4125000
NODE_3030_length_1326_cov_30.614507	813	893	14	4	80	0.0500000
NODE_3030_length_1326_cov_30.614507	813	893	15	19	80	0.2375000
NODE_3030_length_1326_cov_30.614507	813	893	16	4	80	0.0500000
NODE_3031_length_1326_cov_30.304808	488	568	3	1	80	0.0125000
NODE_3031_length_1326_cov_30.304808	488	568	4	52	80	0.6500000
NODE_3031_length_1326_cov_30.304808	488	568	5	8	80	0.1000000
NODE_3031_length_1326_cov_30.304808	488	568	6	19	80	0.2375000
NODE_3031_length_1326_cov_30.304808	541	621	5	8	80	0.1000000
NODE_3031_length_1326_cov_30.304808	541	621	6	45	80	0.5625000
NODE_3031_length_1326_cov_30.304808	541	621	7	6	80	0.0750000
NODE_3031_length_1326_cov_30.304808	541	621	8	17	80	0.2125000
NODE_3031_length_1326_cov_30.304808	541	621	10	3	80	0.0375000
NODE_3031_length_1326_cov_30.304808	541	621	11	1	80	0.0125000
NODE_3031_length_1326_cov_30.304808	617	697	8	2	80	0.0250000
NODE_3031_length_1326_cov_30.304808	617	697	9	6	80	0.0750000
NODE_3031_length_1326_cov_30.304808	617	697	10	11	80	0.1375000
NODE_3031_length_1326_cov_30.304808	617	697	11	13	80	0.1625000
NODE_3031_length_1326_cov_30.304808	617	697	12	21	80	0.2625000
NODE_3031_length_1326_cov_30.304808	617	697	13	5	80	0.0625000
NODE_3031_length_1326_cov_30.304808	617	697	14	6	80	0.0750000
NODE_3031_length_1326_cov_30.304808	617	697	15	8	80	0.1000000
NODE_3031_length_1326_cov_30.304808	617	697	16	1	80	0.0125000
NODE_3031_length_1326_cov_30.304808	617	697	17	6	80	0.0750000
NODE_3031_length_1326_cov_30.304808	617	697	18	1	80	0.0125000
NODE_3031_length_1326_cov_30.304808	670	750	13	5	80	0.0625000
NODE_3031_length_1326_cov_30.304808	670	750	14	6	80	0.0750000
NODE_3031_length_1326_cov_30.304808	670	750	15	8	80	0.1000000
NODE_3031_length_1326_cov_30.304808	670	750	16	4	80	0.0500000
NODE_3031_length_1326_cov_30.304808	670	750	17	10	80	0.1250000
NODE_3031_length_1326_cov_30.304808	670	750	18	1	80	0.0125000
NODE_3031_length_1326_cov_30.304808	670	750	19	27	80	0.3375000
NODE_3031_length_1326_cov_30.304808	670	750	20	19	80	0.2375000
NODE_3032_length_1326_cov_10.913610	238	318	0	35	80	0.4375000
NODE_3032_length_1326_cov_10.913610	238	318	1	7	80	0.0875000
NODE_3032_length_1326_cov_10.913610	238	318	3	18	80	0.2250000
NODE_3032_length_1326_cov_10.913610	238	318	4	20	80	0.2500000
NODE_3032_length_1326_cov_10.913610	291	371	3	7	80	0.0875000
NODE_3032_length_1326_cov_10.913610	291	371	4	73	80	0.9125000
NODE_3036_length_1325_cov_38.136215	0	46	3	46	46	1.0000000
NODE_3036_length_1325_cov_38.136215	19	99	3	30	80	0.3750000
NODE_3036_length_1325_cov_38.136215	19	99	4	26	80	0.3250000
NODE_3036_length_1325_cov_38.136215	19	99	5	24	80	0.3000000
NODE_3036_length_1325_cov_38.136215	948	1022	16	4	74	0.0540541
NODE_3036_length_1325_cov_38.136215	948	1022	17	9	74	0.1216216
NODE_3036_length_1325_cov_38.136215	948	1022	18	4	74	0.0540541
NODE_3036_length_1325_cov_38.136215	948	1022	20	8	74	0.1081081
NODE_3036_length_1325_cov_38.136215	948	1022	22	4	74	0.0540541
NODE_3036_length_1325_cov_38.136215	948	1022	23	13	74	0.1756757
NODE_3036_length_1325_cov_38.136215	948	1022	25	11	74	0.1486486
NODE_3036_length_1325_cov_38.136215	948	1022	26	3	74	0.0405405
NODE_3036_length_1325_cov_38.136215	948	1022	27	14	74	0.1891892
NODE_3036_length_1325_cov_38.136215	948	1022	29	4	74	0.0540541
NODE_3036_length_1325_cov_38.136215	1001	1063	19	9	62	0.1451613
NODE_3036_length_1325_cov_38.136215	1001	1063	21	1	62	0.0161290
NODE_3036_length_1325_cov_38.136215	1001	1063	22	13	62	0.2096774
NODE_3036_length_1325_cov_38.136215	1001	1063	25	33	62	0.5322581
NODE_3036_length_1325_cov_38.136215	1001	1063	26	3	62	0.0483871
NODE_3036_length_1325_cov_38.136215	1001	1063	27	3	62	0.0483871
NODE_3037_length_1325_cov_29.201468	613	693	1	12	80	0.1500000
NODE_3037_length_1325_cov_29.201468	613	693	3	13	80	0.1625000
NODE_3037_length_1325_cov_29.201468	613	693	4	55	80	0.6875000
NODE_3037_length_1325_cov_29.201468	666	746	0	8	80	0.1000000
NODE_3037_length_1325_cov_29.201468	666	746	1	57	80	0.7125000
NODE_3037_length_1325_cov_29.201468	666	746	3	13	80	0.1625000
NODE_3037_length_1325_cov_29.201468	666	746	4	2	80	0.0250000
NODE_3038_length_1325_cov_11.902121	697	777	1	20	80	0.2500000
NODE_3038_length_1325_cov_11.902121	697	777	2	60	80	0.7500000
NODE_3038_length_1325_cov_11.902121	750	830	0	40	80	0.5000000
NODE_3038_length_1325_cov_11.902121	750	830	1	33	80	0.4125000
NODE_3038_length_1325_cov_11.902121	750	830	2	7	80	0.0875000
NODE_3039_length_1325_cov_7.876835	645	725	0	2	80	0.0250000
NODE_3039_length_1325_cov_7.876835	645	725	4	54	80	0.6750000
NODE_3039_length_1325_cov_7.876835	645	725	6	24	80	0.3000000
NODE_3039_length_1325_cov_7.876835	698	778	4	3	80	0.0375000
NODE_3039_length_1325_cov_7.876835	698	778	6	59	80	0.7375000
NODE_3039_length_1325_cov_7.876835	698	778	7	18	80	0.2250000
NODE_3040_length_1325_cov_3.774062	1157	1218	0	61	61	1.0000000
NODE_3040_length_1325_cov_3.774062	1191	1271	0	80	80	1.0000000
NODE_3041_length_1325_cov_2.896411	0	58	0	58	58	1.0000000
NODE_3041_length_1325_cov_2.896411	8	67	0	59	59	1.0000000
NODE_3046_length_1324_cov_30.340408	939	1019	4	56	80	0.7000000
NODE_3046_length_1324_cov_30.340408	939	1019	5	20	80	0.2500000
NODE_3046_length_1324_cov_30.340408	939	1019	6	4	80	0.0500000
NODE_3046_length_1324_cov_30.340408	992	1072	4	20	80	0.2500000
NODE_3046_length_1324_cov_30.340408	992	1072	5	56	80	0.7000000
NODE_3046_length_1324_cov_30.340408	992	1072	6	4	80	0.0500000
NODE_3047_length_1324_cov_7.391020	742	822	1	1	80	0.0125000
NODE_3047_length_1324_cov_7.391020	742	822	2	79	80	0.9875000
NODE_3047_length_1324_cov_7.391020	795	875	1	7	80	0.0875000
NODE_3047_length_1324_cov_7.391020	795	875	2	73	80	0.9125000
NODE_3053_length_1323_cov_30.600490	392	472	6	7	80	0.0875000
NODE_3053_length_1323_cov_30.600490	392	472	7	47	80	0.5875000
NODE_3053_length_1323_cov_30.600490	392	472	9	24	80	0.3000000
NODE_3053_length_1323_cov_30.600490	392	472	10	2	80	0.0250000
NODE_3053_length_1323_cov_30.600490	445	525	7	32	80	0.4000000
NODE_3053_length_1323_cov_30.600490	445	525	8	12	80	0.1500000
NODE_3053_length_1323_cov_30.600490	445	525	9	15	80	0.1875000
NODE_3053_length_1323_cov_30.600490	445	525	12	21	80	0.2625000
NODE_3053_length_1323_cov_30.600490	521	601	6	2	80	0.0250000
NODE_3053_length_1323_cov_30.600490	521	601	7	14	80	0.1750000
NODE_3053_length_1323_cov_30.600490	521	601	8	8	80	0.1000000
NODE_3053_length_1323_cov_30.600490	521	601	9	36	80	0.4500000
NODE_3053_length_1323_cov_30.600490	521	601	10	1	80	0.0125000
NODE_3053_length_1323_cov_30.600490	521	601	12	19	80	0.2375000
NODE_3053_length_1323_cov_30.600490	574	654	7	10	80	0.1250000
NODE_3053_length_1323_cov_30.600490	574	654	8	7	80	0.0875000
NODE_3053_length_1323_cov_30.600490	574	654	9	1	80	0.0125000
NODE_3053_length_1323_cov_30.600490	574	654	10	5	80	0.0625000
NODE_3053_length_1323_cov_30.600490	574	654	11	12	80	0.1500000
NODE_3053_length_1323_cov_30.600490	574	654	12	45	80	0.5625000
NODE_3054_length_1323_cov_20.888889	758	838	9	17	80	0.2125000
NODE_3054_length_1323_cov_20.888889	758	838	10	7	80	0.0875000
NODE_3054_length_1323_cov_20.888889	758	838	11	11	80	0.1375000
NODE_3054_length_1323_cov_20.888889	758	838	12	2	80	0.0250000
NODE_3054_length_1323_cov_20.888889	758	838	13	20	80	0.2500000
NODE_3054_length_1323_cov_20.888889	758	838	14	19	80	0.2375000
NODE_3054_length_1323_cov_20.888889	758	838	19	4	80	0.0500000
NODE_3054_length_1323_cov_20.888889	811	891	8	2	80	0.0250000
NODE_3054_length_1323_cov_20.888889	811	891	11	2	80	0.0250000
NODE_3054_length_1323_cov_20.888889	811	891	12	1	80	0.0125000
NODE_3054_length_1323_cov_20.888889	811	891	13	14	80	0.1750000
NODE_3054_length_1323_cov_20.888889	811	891	14	47	80	0.5875000
NODE_3054_length_1323_cov_20.888889	811	891	15	14	80	0.1750000
NODE_3061_length_1322_cov_8.988553	287	368	4	73	81	0.9012346
NODE_3061_length_1322_cov_8.988553	287	368	5	8	81	0.0987654
NODE_3061_length_1322_cov_8.988553	341	421	1	21	80	0.2625000
NODE_3061_length_1322_cov_8.988553	341	421	4	57	80	0.7125000
NODE_3061_length_1322_cov_8.988553	341	421	5	2	80	0.0250000
NODE_3061_length_1322_cov_8.988553	417	497	1	62	80	0.7750000
NODE_3061_length_1322_cov_8.988553	417	497	2	18	80	0.2250000
NODE_3061_length_1322_cov_8.988553	470	550	1	9	80	0.1125000
NODE_3061_length_1322_cov_8.988553	470	550	2	66	80	0.8250000
NODE_3061_length_1322_cov_8.988553	470	550	3	5	80	0.0625000
NODE_3068_length_1321_cov_57.885434	359	439	2	14	80	0.1750000
NODE_3068_length_1321_cov_57.885434	359	439	3	8	80	0.1000000
NODE_3068_length_1321_cov_57.885434	359	439	5	51	80	0.6375000
NODE_3068_length_1321_cov_57.885434	359	439	8	7	80	0.0875000
NODE_3068_length_1321_cov_57.885434	412	492	5	20	80	0.2500000
NODE_3068_length_1321_cov_57.885434	412	492	8	9	80	0.1125000
NODE_3068_length_1321_cov_57.885434	412	492	9	11	80	0.1375000
NODE_3068_length_1321_cov_57.885434	412	492	10	6	80	0.0750000
NODE_3068_length_1321_cov_57.885434	412	492	11	34	80	0.4250000
NODE_3068_length_1321_cov_57.885434	488	568	11	4	80	0.0500000
NODE_3068_length_1321_cov_57.885434	488	568	15	16	80	0.2000000
NODE_3068_length_1321_cov_57.885434	488	568	16	14	80	0.1750000
NODE_3068_length_1321_cov_57.885434	488	568	17	26	80	0.3250000
NODE_3068_length_1321_cov_57.885434	488	568	18	17	80	0.2125000
NODE_3068_length_1321_cov_57.885434	488	568	19	3	80	0.0375000
NODE_3068_length_1321_cov_57.885434	541	621	10	13	80	0.1625000
NODE_3068_length_1321_cov_57.885434	541	621	11	6	80	0.0750000
NODE_3068_length_1321_cov_57.885434	541	621	12	7	80	0.0875000
NODE_3068_length_1321_cov_57.885434	541	621	13	1	80	0.0125000
NODE_3068_length_1321_cov_57.885434	541	621	14	5	80	0.0625000
NODE_3068_length_1321_cov_57.885434	541	621	15	9	80	0.1125000
NODE_3068_length_1321_cov_57.885434	541	621	17	38	80	0.4750000
NODE_3068_length_1321_cov_57.885434	541	621	18	1	80	0.0125000
NODE_3071_length_1320_cov_70.753481	432	512	13	6	80	0.0750000
NODE_3071_length_1320_cov_70.753481	432	512	14	11	80	0.1375000
NODE_3071_length_1320_cov_70.753481	432	512	15	10	80	0.1250000
NODE_3071_length_1320_cov_70.753481	432	512	16	2	80	0.0250000
NODE_3071_length_1320_cov_70.753481	432	512	17	5	80	0.0625000
NODE_3071_length_1320_cov_70.753481	432	512	18	4	80	0.0500000
NODE_3071_length_1320_cov_70.753481	432	512	19	16	80	0.2000000
NODE_3071_length_1320_cov_70.753481	432	512	20	17	80	0.2125000
NODE_3071_length_1320_cov_70.753481	432	512	21	9	80	0.1125000
NODE_3071_length_1320_cov_70.753481	485	565	16	16	80	0.2000000
NODE_3071_length_1320_cov_70.753481	485	565	17	30	80	0.3750000
NODE_3071_length_1320_cov_70.753481	485	565	18	3	80	0.0375000
NODE_3071_length_1320_cov_70.753481	485	565	19	13	80	0.1625000
NODE_3071_length_1320_cov_70.753481	485	565	20	9	80	0.1125000
NODE_3071_length_1320_cov_70.753481	485	565	21	9	80	0.1125000
NODE_3071_length_1320_cov_70.753481	561	641	10	6	80	0.0750000
NODE_3071_length_1320_cov_70.753481	561	641	11	8	80	0.1000000
NODE_3071_length_1320_cov_70.753481	561	641	12	11	80	0.1375000
NODE_3071_length_1320_cov_70.753481	561	641	15	6	80	0.0750000
NODE_3071_length_1320_cov_70.753481	561	641	16	5	80	0.0625000
NODE_3071_length_1320_cov_70.753481	561	641	17	27	80	0.3375000
NODE_3071_length_1320_cov_70.753481	561	641	18	8	80	0.1000000
NODE_3071_length_1320_cov_70.753481	561	641	19	9	80	0.1125000
NODE_3071_length_1320_cov_70.753481	614	694	7	8	80	0.1000000
NODE_3071_length_1320_cov_70.753481	614	694	8	4	80	0.0500000
NODE_3071_length_1320_cov_70.753481	614	694	9	8	80	0.1000000
NODE_3071_length_1320_cov_70.753481	614	694	10	39	80	0.4875000
NODE_3071_length_1320_cov_70.753481	614	694	11	8	80	0.1000000
NODE_3071_length_1320_cov_70.753481	614	694	12	11	80	0.1375000
NODE_3071_length_1320_cov_70.753481	614	694	15	2	80	0.0250000
NODE_3072_length_1320_cov_39.149058	715	795	5	15	80	0.1875000
NODE_3072_length_1320_cov_39.149058	715	795	6	7	80	0.0875000
NODE_3072_length_1320_cov_39.149058	715	795	8	5	80	0.0625000
NODE_3072_length_1320_cov_39.149058	715	795	10	31	80	0.3875000
NODE_3072_length_1320_cov_39.149058	715	795	11	5	80	0.0625000
NODE_3072_length_1320_cov_39.149058	715	795	12	4	80	0.0500000
NODE_3072_length_1320_cov_39.149058	715	795	15	13	80	0.1625000
NODE_3072_length_1320_cov_39.149058	768	848	10	5	80	0.0625000
NODE_3072_length_1320_cov_39.149058	768	848	11	5	80	0.0625000
NODE_3072_length_1320_cov_39.149058	768	848	12	4	80	0.0500000
NODE_3072_length_1320_cov_39.149058	768	848	15	22	80	0.2750000
NODE_3072_length_1320_cov_39.149058	768	848	17	18	80	0.2250000
NODE_3072_length_1320_cov_39.149058	768	848	18	11	80	0.1375000
NODE_3072_length_1320_cov_39.149058	768	848	20	12	80	0.1500000
NODE_3072_length_1320_cov_39.149058	768	848	21	3	80	0.0375000
NODE_3072_length_1320_cov_39.149058	844	924	15	3	80	0.0375000
NODE_3072_length_1320_cov_39.149058	844	924	16	8	80	0.1000000
NODE_3072_length_1320_cov_39.149058	844	924	17	11	80	0.1375000
NODE_3072_length_1320_cov_39.149058	844	924	18	9	80	0.1125000
NODE_3072_length_1320_cov_39.149058	844	924	19	14	80	0.1750000
NODE_3072_length_1320_cov_39.149058	844	924	20	18	80	0.2250000
NODE_3072_length_1320_cov_39.149058	844	924	22	1	80	0.0125000
NODE_3072_length_1320_cov_39.149058	844	924	24	16	80	0.2000000
NODE_3072_length_1320_cov_39.149058	897	977	15	5	80	0.0625000
NODE_3072_length_1320_cov_39.149058	897	977	16	23	80	0.2875000
NODE_3072_length_1320_cov_39.149058	897	977	17	5	80	0.0625000
NODE_3072_length_1320_cov_39.149058	897	977	18	22	80	0.2750000
NODE_3072_length_1320_cov_39.149058	897	977	20	2	80	0.0250000
NODE_3072_length_1320_cov_39.149058	897	977	22	7	80	0.0875000
NODE_3072_length_1320_cov_39.149058	897	977	24	16	80	0.2000000
NODE_3073_length_1320_cov_19.175266	707	783	0	39	76	0.5131579
NODE_3073_length_1320_cov_19.175266	707	783	2	37	76	0.4868421
NODE_3073_length_1320_cov_19.175266	760	840	1	11	80	0.1375000
NODE_3073_length_1320_cov_19.175266	760	840	2	44	80	0.5500000
NODE_3073_length_1320_cov_19.175266	760	840	3	25	80	0.3125000
NODE_3074_length_1320_cov_11.224406	860	940	0	80	80	1.0000000
NODE_3074_length_1320_cov_11.224406	913	993	0	80	80	1.0000000
NODE_3075_length_1320_cov_11.036036	760	840	8	24	80	0.3000000
NODE_3075_length_1320_cov_11.036036	760	840	9	27	80	0.3375000
NODE_3075_length_1320_cov_11.036036	760	840	10	13	80	0.1625000
NODE_3075_length_1320_cov_11.036036	760	840	11	16	80	0.2000000
NODE_3075_length_1320_cov_11.036036	813	893	4	24	80	0.3000000
NODE_3075_length_1320_cov_11.036036	813	893	7	24	80	0.3000000
NODE_3075_length_1320_cov_11.036036	813	893	8	11	80	0.1375000
NODE_3075_length_1320_cov_11.036036	813	893	9	1	80	0.0125000
NODE_3075_length_1320_cov_11.036036	813	893	11	20	80	0.2500000
NODE_3076_length_1320_cov_8.357084	800	880	3	34	80	0.4250000
NODE_3076_length_1320_cov_8.357084	800	880	4	12	80	0.1500000
NODE_3076_length_1320_cov_8.357084	800	880	5	34	80	0.4250000
NODE_3076_length_1320_cov_8.357084	853	933	2	17	80	0.2125000
NODE_3076_length_1320_cov_8.357084	853	933	3	63	80	0.7875000
NODE_3080_length_1319_cov_27.098361	630	710	12	1	80	0.0125000
NODE_3080_length_1319_cov_27.098361	630	710	13	21	80	0.2625000
NODE_3080_length_1319_cov_27.098361	630	710	14	21	80	0.2625000
NODE_3080_length_1319_cov_27.098361	630	710	18	15	80	0.1875000
NODE_3080_length_1319_cov_27.098361	630	710	19	15	80	0.1875000
NODE_3080_length_1319_cov_27.098361	630	710	20	7	80	0.0875000
NODE_3080_length_1319_cov_27.098361	683	763	9	9	80	0.1125000
NODE_3080_length_1319_cov_27.098361	683	763	10	1	80	0.0125000
NODE_3080_length_1319_cov_27.098361	683	763	11	8	80	0.1000000
NODE_3080_length_1319_cov_27.098361	683	763	13	1	80	0.0125000
NODE_3080_length_1319_cov_27.098361	683	763	14	2	80	0.0250000
NODE_3080_length_1319_cov_27.098361	683	763	15	9	80	0.1125000
NODE_3080_length_1319_cov_27.098361	683	763	17	8	80	0.1000000
NODE_3080_length_1319_cov_27.098361	683	763	18	12	80	0.1500000
NODE_3080_length_1319_cov_27.098361	683	763	19	23	80	0.2875000
NODE_3080_length_1319_cov_27.098361	683	763	20	7	80	0.0875000
NODE_3081_length_1319_cov_22.992623	490	570	3	10	80	0.1250000
NODE_3081_length_1319_cov_22.992623	490	570	4	5	80	0.0625000
NODE_3081_length_1319_cov_22.992623	490	570	5	10	80	0.1250000
NODE_3081_length_1319_cov_22.992623	490	570	6	53	80	0.6625000
NODE_3081_length_1319_cov_22.992623	490	570	7	2	80	0.0250000
NODE_3081_length_1319_cov_22.992623	543	623	5	24	80	0.3000000
NODE_3081_length_1319_cov_22.992623	543	623	6	54	80	0.6750000
NODE_3081_length_1319_cov_22.992623	543	623	7	2	80	0.0250000
NODE_3086_length_1318_cov_13.624282	642	722	0	80	80	1.0000000
NODE_3086_length_1318_cov_13.624282	695	775	0	80	80	1.0000000
NODE_3086_length_1318_cov_13.624282	771	851	0	76	80	0.9500000
NODE_3086_length_1318_cov_13.624282	771	851	3	4	80	0.0500000
NODE_3086_length_1318_cov_13.624282	824	904	0	23	80	0.2875000
NODE_3086_length_1318_cov_13.624282	824	904	3	57	80	0.7125000
NODE_3089_length_1317_cov_162.041872	66	143	0	74	77	0.9610389
NODE_3089_length_1317_cov_162.041872	66	143	1	1	77	0.0129870
NODE_3089_length_1317_cov_162.041872	66	143	3	2	77	0.0259740
NODE_3090_length_1317_cov_19.736453	675	755	8	22	80	0.2750000
NODE_3090_length_1317_cov_19.736453	675	755	10	32	80	0.4000000
NODE_3090_length_1317_cov_19.736453	675	755	11	14	80	0.1750000
NODE_3090_length_1317_cov_19.736453	675	755	13	12	80	0.1500000
NODE_3090_length_1317_cov_19.736453	728	808	10	14	80	0.1750000
NODE_3090_length_1317_cov_19.736453	728	808	11	25	80	0.3125000
NODE_3090_length_1317_cov_19.736453	728	808	12	3	80	0.0375000
NODE_3090_length_1317_cov_19.736453	728	808	13	38	80	0.4750000
NODE_3090_length_1317_cov_19.736453	804	884	6	3	80	0.0375000
NODE_3090_length_1317_cov_19.736453	804	884	7	5	80	0.0625000
NODE_3090_length_1317_cov_19.736453	804	884	8	11	80	0.1375000
NODE_3090_length_1317_cov_19.736453	804	884	9	42	80	0.5250000
NODE_3090_length_1317_cov_19.736453	804	884	11	2	80	0.0250000
NODE_3090_length_1317_cov_19.736453	804	884	12	16	80	0.2000000
NODE_3090_length_1317_cov_19.736453	804	884	13	1	80	0.0125000
NODE_3090_length_1317_cov_19.736453	857	937	3	8	80	0.1000000
NODE_3090_length_1317_cov_19.736453	857	937	6	48	80	0.6000000
NODE_3090_length_1317_cov_19.736453	857	937	8	2	80	0.0250000
NODE_3090_length_1317_cov_19.736453	857	937	9	22	80	0.2750000
NODE_3092_length_1317_cov_2.203612	779	859	0	18	80	0.2250000
NODE_3092_length_1317_cov_2.203612	779	859	5	62	80	0.7750000
NODE_3095_length_1316_cov_25.377157	557	637	2	80	80	1.0000000
NODE_3095_length_1316_cov_25.377157	610	690	2	44	80	0.5500000
NODE_3095_length_1316_cov_25.377157	610	690	4	36	80	0.4500000
NODE_3096_length_1316_cov_15.891537	446	526	9	19	80	0.2375000
NODE_3096_length_1316_cov_15.891537	446	526	10	1	80	0.0125000
NODE_3096_length_1316_cov_15.891537	446	526	11	12	80	0.1500000
NODE_3096_length_1316_cov_15.891537	446	526	12	48	80	0.6000000
NODE_3096_length_1316_cov_15.891537	499	579	7	35	80	0.4375000
NODE_3096_length_1316_cov_15.891537	499	579	8	6	80	0.0750000
NODE_3096_length_1316_cov_15.891537	499	579	9	31	80	0.3875000
NODE_3096_length_1316_cov_15.891537	499	579	10	1	80	0.0125000
NODE_3096_length_1316_cov_15.891537	499	579	12	7	80	0.0875000
NODE_3096_length_1316_cov_15.891537	575	655	1	50	80	0.6250000
NODE_3096_length_1316_cov_15.891537	575	655	2	23	80	0.2875000
NODE_3096_length_1316_cov_15.891537	575	655	4	1	80	0.0125000
NODE_3096_length_1316_cov_15.891537	575	655	5	1	80	0.0125000
NODE_3096_length_1316_cov_15.891537	575	655	6	1	80	0.0125000
NODE_3096_length_1316_cov_15.891537	575	655	7	4	80	0.0500000
NODE_3096_length_1316_cov_15.891537	628	708	1	50	80	0.6250000
NODE_3096_length_1316_cov_15.891537	628	708	2	30	80	0.3750000
NODE_3101_length_1315_cov_24.136513	592	672	12	4	80	0.0500000
NODE_3101_length_1315_cov_24.136513	592	672	13	1	80	0.0125000
NODE_3101_length_1315_cov_24.136513	592	672	14	22	80	0.2750000
NODE_3101_length_1315_cov_24.136513	592	672	15	17	80	0.2125000
NODE_3101_length_1315_cov_24.136513	592	672	17	25	80	0.3125000
NODE_3101_length_1315_cov_24.136513	592	672	18	10	80	0.1250000
NODE_3101_length_1315_cov_24.136513	592	672	19	1	80	0.0125000
NODE_3101_length_1315_cov_24.136513	645	725	13	34	80	0.4250000
NODE_3101_length_1315_cov_24.136513	645	725	14	24	80	0.3000000
NODE_3101_length_1315_cov_24.136513	645	725	15	22	80	0.2750000
NODE_3105_length_1314_cov_38.391770	647	727	12	1	80	0.0125000
NODE_3105_length_1314_cov_38.391770	647	727	13	6	80	0.0750000
NODE_3105_length_1314_cov_38.391770	647	727	14	9	80	0.1125000
NODE_3105_length_1314_cov_38.391770	647	727	15	7	80	0.0875000
NODE_3105_length_1314_cov_38.391770	647	727	16	1	80	0.0125000
NODE_3105_length_1314_cov_38.391770	647	727	20	3	80	0.0375000
NODE_3105_length_1314_cov_38.391770	647	727	23	4	80	0.0500000
NODE_3105_length_1314_cov_38.391770	647	727	24	2	80	0.0250000
NODE_3105_length_1314_cov_38.391770	647	727	25	4	80	0.0500000
NODE_3105_length_1314_cov_38.391770	647	727	26	8	80	0.1000000
NODE_3105_length_1314_cov_38.391770	647	727	27	2	80	0.0250000
NODE_3105_length_1314_cov_38.391770	647	727	28	28	80	0.3500000
NODE_3105_length_1314_cov_38.391770	647	727	29	1	80	0.0125000
NODE_3105_length_1314_cov_38.391770	647	727	30	4	80	0.0500000
NODE_3105_length_1314_cov_38.391770	700	780	27	3	80	0.0375000
NODE_3105_length_1314_cov_38.391770	700	780	28	38	80	0.4750000
NODE_3105_length_1314_cov_38.391770	700	780	29	12	80	0.1500000
NODE_3105_length_1314_cov_38.391770	700	780	30	4	80	0.0500000
NODE_3105_length_1314_cov_38.391770	700	780	31	7	80	0.0875000
NODE_3105_length_1314_cov_38.391770	700	780	32	2	80	0.0250000
NODE_3105_length_1314_cov_38.391770	700	780	33	11	80	0.1375000
NODE_3105_length_1314_cov_38.391770	700	780	35	3	80	0.0375000
NODE_3105_length_1314_cov_38.391770	776	856	16	7	80	0.0875000
NODE_3105_length_1314_cov_38.391770	776	856	18	7	80	0.0875000
NODE_3105_length_1314_cov_38.391770	776	856	20	9	80	0.1125000
NODE_3105_length_1314_cov_38.391770	776	856	21	3	80	0.0375000
NODE_3105_length_1314_cov_38.391770	776	856	22	2	80	0.0250000
NODE_3105_length_1314_cov_38.391770	776	856	23	4	80	0.0500000
NODE_3105_length_1314_cov_38.391770	776	856	26	3	80	0.0375000
NODE_3105_length_1314_cov_38.391770	776	856	28	1	80	0.0125000
NODE_3105_length_1314_cov_38.391770	776	856	29	7	80	0.0875000
NODE_3105_length_1314_cov_38.391770	776	856	31	9	80	0.1125000
NODE_3105_length_1314_cov_38.391770	776	856	32	12	80	0.1500000
NODE_3105_length_1314_cov_38.391770	776	856	33	16	80	0.2000000
NODE_3105_length_1314_cov_38.391770	829	909	11	2	80	0.0250000
NODE_3105_length_1314_cov_38.391770	829	909	14	26	80	0.3250000
NODE_3105_length_1314_cov_38.391770	829	909	15	2	80	0.0250000
NODE_3105_length_1314_cov_38.391770	829	909	16	30	80	0.3750000
NODE_3105_length_1314_cov_38.391770	829	909	18	7	80	0.0875000
NODE_3105_length_1314_cov_38.391770	829	909	20	9	80	0.1125000
NODE_3105_length_1314_cov_38.391770	829	909	21	3	80	0.0375000
NODE_3105_length_1314_cov_38.391770	829	909	22	1	80	0.0125000
NODE_3106_length_1314_cov_30.167078	736	816	34	2	80	0.0250000
NODE_3106_length_1314_cov_30.167078	736	816	36	19	80	0.2375000
NODE_3106_length_1314_cov_30.167078	736	816	37	6	80	0.0750000
NODE_3106_length_1314_cov_30.167078	736	816	38	8	80	0.1000000
NODE_3106_length_1314_cov_30.167078	736	816	39	6	80	0.0750000
NODE_3106_length_1314_cov_30.167078	736	816	40	1	80	0.0125000
NODE_3106_length_1314_cov_30.167078	736	816	41	28	80	0.3500000
NODE_3106_length_1314_cov_30.167078	736	816	42	4	80	0.0500000
NODE_3106_length_1314_cov_30.167078	736	816	43	6	80	0.0750000
NODE_3106_length_1314_cov_30.167078	789	869	11	7	80	0.0875000
NODE_3106_length_1314_cov_30.167078	789	869	14	21	80	0.2625000
NODE_3106_length_1314_cov_30.167078	789	869	26	2	80	0.0250000
NODE_3106_length_1314_cov_30.167078	789	869	27	1	80	0.0125000
NODE_3106_length_1314_cov_30.167078	789	869	31	1	80	0.0125000
NODE_3106_length_1314_cov_30.167078	789	869	34	5	80	0.0625000
NODE_3106_length_1314_cov_30.167078	789	869	35	7	80	0.0875000
NODE_3106_length_1314_cov_30.167078	789	869	36	22	80	0.2750000
NODE_3106_length_1314_cov_30.167078	789	869	37	5	80	0.0625000
NODE_3106_length_1314_cov_30.167078	789	869	38	8	80	0.1000000
NODE_3106_length_1314_cov_30.167078	789	869	41	1	80	0.0125000
NODE_3107_length_1314_cov_11.221399	523	603	5	80	80	1.0000000
NODE_3107_length_1314_cov_11.221399	576	656	3	6	80	0.0750000
NODE_3107_length_1314_cov_11.221399	576	656	4	16	80	0.2000000
NODE_3107_length_1314_cov_11.221399	576	656	5	53	80	0.6625000
NODE_3107_length_1314_cov_11.221399	576	656	6	5	80	0.0625000
NODE_3114_length_1313_cov_29.315486	463	543	16	25	80	0.3125000
NODE_3114_length_1313_cov_29.315486	463	543	17	7	80	0.0875000
NODE_3114_length_1313_cov_29.315486	463	543	18	4	80	0.0500000
NODE_3114_length_1313_cov_29.315486	463	543	19	26	80	0.3250000
NODE_3114_length_1313_cov_29.315486	463	543	20	10	80	0.1250000
NODE_3114_length_1313_cov_29.315486	463	543	21	8	80	0.1000000
NODE_3114_length_1313_cov_29.315486	516	596	9	11	80	0.1375000
NODE_3114_length_1313_cov_29.315486	516	596	12	2	80	0.0250000
NODE_3114_length_1313_cov_29.315486	516	596	14	7	80	0.0875000
NODE_3114_length_1313_cov_29.315486	516	596	15	14	80	0.1750000
NODE_3114_length_1313_cov_29.315486	516	596	17	7	80	0.0875000
NODE_3114_length_1313_cov_29.315486	516	596	18	5	80	0.0625000
NODE_3114_length_1313_cov_29.315486	516	596	19	23	80	0.2875000
NODE_3114_length_1313_cov_29.315486	516	596	20	11	80	0.1375000
NODE_3115_length_1313_cov_25.144975	709	789	16	7	80	0.0875000
NODE_3115_length_1313_cov_25.144975	709	789	17	52	80	0.6500000
NODE_3115_length_1313_cov_25.144975	709	789	18	6	80	0.0750000
NODE_3115_length_1313_cov_25.144975	709	789	19	4	80	0.0500000
NODE_3115_length_1313_cov_25.144975	709	789	20	11	80	0.1375000
NODE_3115_length_1313_cov_25.144975	762	842	10	17	80	0.2125000
NODE_3115_length_1313_cov_25.144975	762	842	11	18	80	0.2250000
NODE_3115_length_1313_cov_25.144975	762	842	14	4	80	0.0500000
NODE_3115_length_1313_cov_25.144975	762	842	15	2	80	0.0250000
NODE_3115_length_1313_cov_25.144975	762	842	16	8	80	0.1000000
NODE_3115_length_1313_cov_25.144975	762	842	17	29	80	0.3625000
NODE_3115_length_1313_cov_25.144975	762	842	18	2	80	0.0250000
NODE_3115_length_1313_cov_25.144975	838	918	7	5	80	0.0625000
NODE_3115_length_1313_cov_25.144975	838	918	8	25	80	0.3125000
NODE_3115_length_1313_cov_25.144975	838	918	9	4	80	0.0500000
NODE_3115_length_1313_cov_25.144975	838	918	10	6	80	0.0750000
NODE_3115_length_1313_cov_25.144975	838	918	11	6	80	0.0750000
NODE_3115_length_1313_cov_25.144975	838	918	12	28	80	0.3500000
NODE_3115_length_1313_cov_25.144975	838	918	13	6	80	0.0750000
NODE_3115_length_1313_cov_25.144975	891	971	7	58	80	0.7250000
NODE_3115_length_1313_cov_25.144975	891	971	8	18	80	0.2250000
NODE_3115_length_1313_cov_25.144975	891	971	9	4	80	0.0500000
NODE_3118_length_1312_cov_20.378401	138	218	29	2	80	0.0250000
NODE_3118_length_1312_cov_20.378401	138	218	31	7	80	0.0875000
NODE_3118_length_1312_cov_20.378401	138	218	32	5	80	0.0625000
NODE_3118_length_1312_cov_20.378401	138	218	33	8	80	0.1000000
NODE_3118_length_1312_cov_20.378401	138	218	35	2	80	0.0250000
NODE_3118_length_1312_cov_20.378401	138	218	37	9	80	0.1125000
NODE_3118_length_1312_cov_20.378401	138	218	38	11	80	0.1375000
NODE_3118_length_1312_cov_20.378401	138	218	39	11	80	0.1375000
NODE_3118_length_1312_cov_20.378401	138	218	40	9	80	0.1125000
NODE_3118_length_1312_cov_20.378401	138	218	41	2	80	0.0250000
NODE_3118_length_1312_cov_20.378401	138	218	42	1	80	0.0125000
NODE_3118_length_1312_cov_20.378401	138	218	43	8	80	0.1000000
NODE_3118_length_1312_cov_20.378401	138	218	44	1	80	0.0125000
NODE_3118_length_1312_cov_20.378401	138	218	45	4	80	0.0500000
NODE_3118_length_1312_cov_20.378401	191	271	33	1	80	0.0125000
NODE_3118_length_1312_cov_20.378401	191	271	34	2	80	0.0250000
NODE_3118_length_1312_cov_20.378401	191	271	35	1	80	0.0125000
NODE_3118_length_1312_cov_20.378401	191	271	36	1	80	0.0125000
NODE_3118_length_1312_cov_20.378401	191	271	38	9	80	0.1125000
NODE_3118_length_1312_cov_20.378401	191	271	39	8	80	0.1000000
NODE_3118_length_1312_cov_20.378401	191	271	40	26	80	0.3250000
NODE_3118_length_1312_cov_20.378401	191	271	41	7	80	0.0875000
NODE_3118_length_1312_cov_20.378401	191	271	42	12	80	0.1500000
NODE_3118_length_1312_cov_20.378401	191	271	43	8	80	0.1000000
NODE_3118_length_1312_cov_20.378401	191	271	44	1	80	0.0125000
NODE_3118_length_1312_cov_20.378401	191	271	45	4	80	0.0500000
NODE_3121_length_1311_cov_38.468647	584	664	18	3	80	0.0375000
NODE_3121_length_1311_cov_38.468647	584	664	20	30	80	0.3750000
NODE_3121_length_1311_cov_38.468647	584	664	21	28	80	0.3500000
NODE_3121_length_1311_cov_38.468647	584	664	22	11	80	0.1375000
NODE_3121_length_1311_cov_38.468647	584	664	23	8	80	0.1000000
NODE_3121_length_1311_cov_38.468647	637	717	20	7	80	0.0875000
NODE_3121_length_1311_cov_38.468647	637	717	21	26	80	0.3250000
NODE_3121_length_1311_cov_38.468647	637	717	22	30	80	0.3750000
NODE_3121_length_1311_cov_38.468647	637	717	23	17	80	0.2125000
NODE_3121_length_1311_cov_38.468647	713	793	11	12	80	0.1500000
NODE_3121_length_1311_cov_38.468647	713	793	12	5	80	0.0625000
NODE_3121_length_1311_cov_38.468647	713	793	13	31	80	0.3875000
NODE_3121_length_1311_cov_38.468647	713	793	14	11	80	0.1375000
NODE_3121_length_1311_cov_38.468647	713	793	15	4	80	0.0500000
NODE_3121_length_1311_cov_38.468647	713	793	17	2	80	0.0250000
NODE_3121_length_1311_cov_38.468647	713	793	18	3	80	0.0375000
NODE_3121_length_1311_cov_38.468647	713	793	19	2	80	0.0250000
NODE_3121_length_1311_cov_38.468647	713	793	21	10	80	0.1250000
NODE_3121_length_1311_cov_38.468647	766	846	4	6	80	0.0750000
NODE_3121_length_1311_cov_38.468647	766	846	6	9	80	0.1125000
NODE_3121_length_1311_cov_38.468647	766	846	7	11	80	0.1375000
NODE_3121_length_1311_cov_38.468647	766	846	9	18	80	0.2250000
NODE_3121_length_1311_cov_38.468647	766	846	10	1	80	0.0125000
NODE_3121_length_1311_cov_38.468647	766	846	11	20	80	0.2500000
NODE_3121_length_1311_cov_38.468647	766	846	12	5	80	0.0625000
NODE_3121_length_1311_cov_38.468647	766	846	13	10	80	0.1250000
NODE_3125_length_1310_cov_37.739884	679	759	4	21	80	0.2625000
NODE_3125_length_1310_cov_37.739884	679	759	5	28	80	0.3500000
NODE_3125_length_1310_cov_37.739884	679	759	6	31	80	0.3875000
NODE_3125_length_1310_cov_37.739884	683	763	4	21	80	0.2625000
NODE_3125_length_1310_cov_37.739884	683	763	5	28	80	0.3500000
NODE_3125_length_1310_cov_37.739884	683	763	6	31	80	0.3875000
NODE_3125_length_1310_cov_37.739884	732	816	4	57	84	0.6785714
NODE_3125_length_1310_cov_37.739884	732	816	5	11	84	0.1309524
NODE_3125_length_1310_cov_37.739884	732	816	6	16	84	0.1904762
NODE_3125_length_1310_cov_37.739884	736	816	4	57	80	0.7125000
NODE_3125_length_1310_cov_37.739884	736	816	5	11	80	0.1375000
NODE_3125_length_1310_cov_37.739884	736	816	6	12	80	0.1500000
NODE_3125_length_1310_cov_37.739884	812	892	5	4	80	0.0500000
NODE_3125_length_1310_cov_37.739884	812	892	6	19	80	0.2375000
NODE_3125_length_1310_cov_37.739884	812	892	7	4	80	0.0500000
NODE_3125_length_1310_cov_37.739884	812	892	8	6	80	0.0750000
NODE_3125_length_1310_cov_37.739884	812	892	9	45	80	0.5625000
NODE_3125_length_1310_cov_37.739884	812	892	10	2	80	0.0250000
NODE_3125_length_1310_cov_37.739884	865	945	7	4	80	0.0500000
NODE_3125_length_1310_cov_37.739884	865	945	8	6	80	0.0750000
NODE_3125_length_1310_cov_37.739884	865	945	9	57	80	0.7125000
NODE_3125_length_1310_cov_37.739884	865	945	10	11	80	0.1375000
NODE_3125_length_1310_cov_37.739884	865	945	11	2	80	0.0250000
NODE_3126_length_1310_cov_12.245252	615	695	9	23	80	0.2875000
NODE_3126_length_1310_cov_12.245252	615	695	11	1	80	0.0125000
NODE_3126_length_1310_cov_12.245252	615	695	12	11	80	0.1375000
NODE_3126_length_1310_cov_12.245252	615	695	13	36	80	0.4500000
NODE_3126_length_1310_cov_12.245252	615	695	14	5	80	0.0625000
NODE_3126_length_1310_cov_12.245252	615	695	15	4	80	0.0500000
NODE_3126_length_1310_cov_12.245252	668	748	8	3	80	0.0375000
NODE_3126_length_1310_cov_12.245252	668	748	9	18	80	0.2250000
NODE_3126_length_1310_cov_12.245252	668	748	12	6	80	0.0750000
NODE_3126_length_1310_cov_12.245252	668	748	13	53	80	0.6625000
NODE_3127_length_1310_cov_10.184971	422	502	5	25	80	0.3125000
NODE_3127_length_1310_cov_10.184971	422	502	6	55	80	0.6875000
NODE_3127_length_1310_cov_10.184971	475	555	2	1	80	0.0125000
NODE_3127_length_1310_cov_10.184971	475	555	3	13	80	0.1625000
NODE_3127_length_1310_cov_10.184971	475	555	4	32	80	0.4000000
NODE_3127_length_1310_cov_10.184971	475	555	5	32	80	0.4000000
NODE_3127_length_1310_cov_10.184971	475	555	6	2	80	0.0250000
NODE_3128_length_1310_cov_3.186623	876	956	0	57	80	0.7125000
NODE_3128_length_1310_cov_3.186623	876	956	1	23	80	0.2875000
NODE_3128_length_1310_cov_3.186623	929	1009	0	4	80	0.0500000
NODE_3128_length_1310_cov_3.186623	929	1009	1	28	80	0.3500000
NODE_3128_length_1310_cov_3.186623	929	1009	2	48	80	0.6000000
NODE_3131_length_1310_cov_0.757225	1255	1310	0	55	55	1.0000000
NODE_3132_length_1309_cov_34.942149	474	554	12	28	80	0.3500000
NODE_3132_length_1309_cov_34.942149	474	554	13	19	80	0.2375000
NODE_3132_length_1309_cov_34.942149	474	554	14	20	80	0.2500000
NODE_3132_length_1309_cov_34.942149	474	554	15	10	80	0.1250000
NODE_3132_length_1309_cov_34.942149	474	554	16	3	80	0.0375000
NODE_3132_length_1309_cov_34.942149	527	607	10	13	80	0.1625000
NODE_3132_length_1309_cov_34.942149	527	607	11	6	80	0.0750000
NODE_3132_length_1309_cov_34.942149	527	607	12	4	80	0.0500000
NODE_3132_length_1309_cov_34.942149	527	607	13	21	80	0.2625000
NODE_3132_length_1309_cov_34.942149	527	607	14	29	80	0.3625000
NODE_3132_length_1309_cov_34.942149	527	607	15	4	80	0.0500000
NODE_3132_length_1309_cov_34.942149	527	607	16	3	80	0.0375000
NODE_3132_length_1309_cov_34.942149	603	683	7	9	80	0.1125000
NODE_3132_length_1309_cov_34.942149	603	683	9	22	80	0.2750000
NODE_3132_length_1309_cov_34.942149	603	683	10	31	80	0.3875000
NODE_3132_length_1309_cov_34.942149	603	683	12	14	80	0.1750000
NODE_3132_length_1309_cov_34.942149	603	683	13	4	80	0.0500000
NODE_3132_length_1309_cov_34.942149	656	736	6	8	80	0.1000000
NODE_3132_length_1309_cov_34.942149	656	736	7	44	80	0.5500000
NODE_3132_length_1309_cov_34.942149	656	736	9	28	80	0.3500000
NODE_3133_length_1309_cov_10.571074	839	921	0	82	82	1.0000000
NODE_3133_length_1309_cov_10.571074	894	974	0	80	80	1.0000000
NODE_3135_length_1308_cov_43.461538	330	410	61	1	80	0.0125000
NODE_3135_length_1308_cov_43.461538	330	410	63	1	80	0.0125000
NODE_3135_length_1308_cov_43.461538	330	410	64	19	80	0.2375000
NODE_3135_length_1308_cov_43.461538	330	410	65	3	80	0.0375000
NODE_3135_length_1308_cov_43.461538	330	410	66	12	80	0.1500000
NODE_3135_length_1308_cov_43.461538	330	410	67	11	80	0.1375000
NODE_3135_length_1308_cov_43.461538	330	410	68	1	80	0.0125000
NODE_3135_length_1308_cov_43.461538	330	410	69	3	80	0.0375000
NODE_3135_length_1308_cov_43.461538	330	410	70	6	80	0.0750000
NODE_3135_length_1308_cov_43.461538	330	410	72	14	80	0.1750000
NODE_3135_length_1308_cov_43.461538	330	410	73	3	80	0.0375000
NODE_3135_length_1308_cov_43.461538	330	410	74	6	80	0.0750000
NODE_3135_length_1308_cov_43.461538	383	463	63	3	80	0.0375000
NODE_3135_length_1308_cov_43.461538	383	463	64	9	80	0.1125000
NODE_3135_length_1308_cov_43.461538	383	463	65	14	80	0.1750000
NODE_3135_length_1308_cov_43.461538	383	463	66	10	80	0.1250000
NODE_3135_length_1308_cov_43.461538	383	463	67	22	80	0.2750000
NODE_3135_length_1308_cov_43.461538	383	463	68	2	80	0.0250000
NODE_3135_length_1308_cov_43.461538	383	463	69	9	80	0.1125000
NODE_3135_length_1308_cov_43.461538	383	463	71	1	80	0.0125000
NODE_3135_length_1308_cov_43.461538	383	463	72	3	80	0.0375000
NODE_3135_length_1308_cov_43.461538	383	463	73	1	80	0.0125000
NODE_3135_length_1308_cov_43.461538	383	463	74	6	80	0.0750000
NODE_3145_length_1307_cov_11.290563	595	673	2	78	78	1.0000000
NODE_3145_length_1307_cov_11.290563	646	726	1	8	80	0.1000000
NODE_3145_length_1307_cov_11.290563	646	726	2	72	80	0.9000000
NODE_3146_length_1307_cov_8.653146	430	510	5	9	80	0.1125000
NODE_3146_length_1307_cov_8.653146	430	510	7	12	80	0.1500000
NODE_3146_length_1307_cov_8.653146	430	510	8	10	80	0.1250000
NODE_3146_length_1307_cov_8.653146	430	510	12	20	80	0.2500000
NODE_3146_length_1307_cov_8.653146	430	510	13	1	80	0.0125000
NODE_3146_length_1307_cov_8.653146	430	510	14	12	80	0.1500000
NODE_3146_length_1307_cov_8.653146	430	510	15	13	80	0.1625000
NODE_3146_length_1307_cov_8.653146	430	510	16	3	80	0.0375000
NODE_3146_length_1307_cov_8.653146	483	563	14	13	80	0.1625000
NODE_3146_length_1307_cov_8.653146	483	563	15	36	80	0.4500000
NODE_3146_length_1307_cov_8.653146	483	563	16	20	80	0.2500000
NODE_3146_length_1307_cov_8.653146	483	563	17	6	80	0.0750000
NODE_3146_length_1307_cov_8.653146	483	563	18	5	80	0.0625000
NODE_3153_length_1306_cov_26.813587	369	449	14	2	80	0.0250000
NODE_3153_length_1306_cov_26.813587	369	449	15	18	80	0.2250000
NODE_3153_length_1306_cov_26.813587	369	449	16	3	80	0.0375000
NODE_3153_length_1306_cov_26.813587	369	449	18	7	80	0.0875000
NODE_3153_length_1306_cov_26.813587	369	449	19	6	80	0.0750000
NODE_3153_length_1306_cov_26.813587	369	449	20	2	80	0.0250000
NODE_3153_length_1306_cov_26.813587	369	449	22	7	80	0.0875000
NODE_3153_length_1306_cov_26.813587	369	449	23	8	80	0.1000000
NODE_3153_length_1306_cov_26.813587	369	449	24	1	80	0.0125000
NODE_3153_length_1306_cov_26.813587	369	449	25	10	80	0.1250000
NODE_3153_length_1306_cov_26.813587	369	449	26	16	80	0.2000000
NODE_3153_length_1306_cov_26.813587	422	502	20	2	80	0.0250000
NODE_3153_length_1306_cov_26.813587	422	502	22	9	80	0.1125000
NODE_3153_length_1306_cov_26.813587	422	502	23	9	80	0.1125000
NODE_3153_length_1306_cov_26.813587	422	502	24	20	80	0.2500000
NODE_3153_length_1306_cov_26.813587	422	502	25	24	80	0.3000000
NODE_3153_length_1306_cov_26.813587	422	502	26	16	80	0.2000000
NODE_3153_length_1306_cov_26.813587	498	578	10	8	80	0.1000000
NODE_3153_length_1306_cov_26.813587	498	578	11	4	80	0.0500000
NODE_3153_length_1306_cov_26.813587	498	578	13	9	80	0.1125000
NODE_3153_length_1306_cov_26.813587	498	578	16	2	80	0.0250000
NODE_3153_length_1306_cov_26.813587	498	578	18	13	80	0.1625000
NODE_3153_length_1306_cov_26.813587	498	578	19	18	80	0.2250000
NODE_3153_length_1306_cov_26.813587	498	578	20	14	80	0.1750000
NODE_3153_length_1306_cov_26.813587	498	578	21	3	80	0.0375000
NODE_3153_length_1306_cov_26.813587	498	578	22	9	80	0.1125000
NODE_3153_length_1306_cov_26.813587	551	631	5	12	80	0.1500000
NODE_3153_length_1306_cov_26.813587	551	631	7	11	80	0.1375000
NODE_3153_length_1306_cov_26.813587	551	631	10	17	80	0.2125000
NODE_3153_length_1306_cov_26.813587	551	631	11	25	80	0.3125000
NODE_3153_length_1306_cov_26.813587	551	631	13	9	80	0.1125000
NODE_3153_length_1306_cov_26.813587	551	631	16	2	80	0.0250000
NODE_3153_length_1306_cov_26.813587	551	631	18	4	80	0.0500000
NODE_3154_length_1306_cov_24.904722	634	714	4	15	80	0.1875000
NODE_3154_length_1306_cov_24.904722	634	714	5	5	80	0.0625000
NODE_3154_length_1306_cov_24.904722	634	714	6	48	80	0.6000000
NODE_3154_length_1306_cov_24.904722	634	714	7	12	80	0.1500000
NODE_3154_length_1306_cov_24.904722	687	767	3	21	80	0.2625000
NODE_3154_length_1306_cov_24.904722	687	767	4	47	80	0.5875000
NODE_3154_length_1306_cov_24.904722	687	767	5	5	80	0.0625000
NODE_3154_length_1306_cov_24.904722	687	767	6	4	80	0.0500000
NODE_3154_length_1306_cov_24.904722	687	767	7	3	80	0.0375000
NODE_3155_length_1306_cov_18.274234	388	468	2	19	80	0.2375000
NODE_3155_length_1306_cov_18.274234	388	468	3	35	80	0.4375000
NODE_3155_length_1306_cov_18.274234	388	468	5	2	80	0.0250000
NODE_3155_length_1306_cov_18.274234	388	468	7	17	80	0.2125000
NODE_3155_length_1306_cov_18.274234	388	468	9	7	80	0.0875000
NODE_3155_length_1306_cov_18.274234	441	521	3	1	80	0.0125000
NODE_3155_length_1306_cov_18.274234	441	521	5	2	80	0.0250000
NODE_3155_length_1306_cov_18.274234	441	521	7	24	80	0.3000000
NODE_3155_length_1306_cov_18.274234	441	521	8	6	80	0.0750000
NODE_3155_length_1306_cov_18.274234	441	521	9	32	80	0.4000000
NODE_3155_length_1306_cov_18.274234	441	521	10	15	80	0.1875000
NODE_3156_length_1306_cov_15.176471	1214	1294	4	80	80	1.0000000
NODE_3157_length_1306_cov_12.699254	458	538	0	4	80	0.0500000
NODE_3157_length_1306_cov_12.699254	458	538	2	76	80	0.9500000
NODE_3157_length_1306_cov_12.699254	511	591	0	57	80	0.7125000
NODE_3157_length_1306_cov_12.699254	511	591	2	23	80	0.2875000
NODE_3158_length_1306_cov_9.958575	630	710	8	16	80	0.2000000
NODE_3158_length_1306_cov_9.958575	630	710	10	54	80	0.6750000
NODE_3158_length_1306_cov_9.958575	630	710	11	10	80	0.1250000
NODE_3158_length_1306_cov_9.958575	683	764	4	9	81	0.1111111
NODE_3158_length_1306_cov_9.958575	683	764	5	3	81	0.0370370
NODE_3158_length_1306_cov_9.958575	683	764	7	6	81	0.0740741
NODE_3158_length_1306_cov_9.958575	683	764	8	52	81	0.6419753
NODE_3158_length_1306_cov_9.958575	683	764	10	11	81	0.1358025
NODE_3159_length_1306_cov_2.739851	1206	1246	0	40	40	1.0000000
NODE_3168_length_1304_cov_28.444813	511	591	4	66	80	0.8250000
NODE_3168_length_1304_cov_28.444813	511	591	5	14	80	0.1750000
NODE_3168_length_1304_cov_28.444813	564	644	1	3	80	0.0375000
NODE_3168_length_1304_cov_28.444813	564	644	3	2	80	0.0250000
NODE_3168_length_1304_cov_28.444813	564	644	4	21	80	0.2625000
NODE_3168_length_1304_cov_28.444813	564	644	5	54	80	0.6750000
NODE_3168_length_1304_cov_28.444813	640	720	1	7	80	0.0875000
NODE_3168_length_1304_cov_28.444813	640	720	2	71	80	0.8875000
NODE_3168_length_1304_cov_28.444813	640	720	3	1	80	0.0125000
NODE_3168_length_1304_cov_28.444813	640	720	8	1	80	0.0125000
NODE_3168_length_1304_cov_28.444813	693	773	2	26	80	0.3250000
NODE_3168_length_1304_cov_28.444813	693	773	7	46	80	0.5750000
NODE_3168_length_1304_cov_28.444813	693	773	8	8	80	0.1000000
NODE_3169_length_1304_cov_27.137759	575	655	0	30	80	0.3750000
NODE_3169_length_1304_cov_27.137759	575	655	1	1	80	0.0125000
NODE_3169_length_1304_cov_27.137759	575	655	3	15	80	0.1875000
NODE_3169_length_1304_cov_27.137759	575	655	4	5	80	0.0625000
NODE_3169_length_1304_cov_27.137759	575	655	5	7	80	0.0875000
NODE_3169_length_1304_cov_27.137759	575	655	6	4	80	0.0500000
NODE_3169_length_1304_cov_27.137759	575	655	8	14	80	0.1750000
NODE_3169_length_1304_cov_27.137759	575	655	9	2	80	0.0250000
NODE_3169_length_1304_cov_27.137759	575	655	10	2	80	0.0250000
NODE_3169_length_1304_cov_27.137759	628	708	5	5	80	0.0625000
NODE_3169_length_1304_cov_27.137759	628	708	6	4	80	0.0500000
NODE_3169_length_1304_cov_27.137759	628	708	8	14	80	0.1750000
NODE_3169_length_1304_cov_27.137759	628	708	9	2	80	0.0250000
NODE_3169_length_1304_cov_27.137759	628	708	10	2	80	0.0250000
NODE_3169_length_1304_cov_27.137759	628	708	12	5	80	0.0625000
NODE_3169_length_1304_cov_27.137759	628	708	14	5	80	0.0625000
NODE_3169_length_1304_cov_27.137759	628	708	15	33	80	0.4125000
NODE_3169_length_1304_cov_27.137759	628	708	16	1	80	0.0125000
NODE_3169_length_1304_cov_27.137759	628	708	18	1	80	0.0125000
NODE_3169_length_1304_cov_27.137759	628	708	21	8	80	0.1000000
NODE_3169_length_1304_cov_27.137759	704	784	21	12	80	0.1500000
NODE_3169_length_1304_cov_27.137759	704	784	22	11	80	0.1375000
NODE_3169_length_1304_cov_27.137759	704	784	24	3	80	0.0375000
NODE_3169_length_1304_cov_27.137759	704	784	25	6	80	0.0750000
NODE_3169_length_1304_cov_27.137759	704	784	26	11	80	0.1375000
NODE_3169_length_1304_cov_27.137759	704	784	27	29	80	0.3625000
NODE_3169_length_1304_cov_27.137759	704	784	28	1	80	0.0125000
NODE_3169_length_1304_cov_27.137759	704	784	30	7	80	0.0875000
NODE_3169_length_1304_cov_27.137759	757	837	17	22	80	0.2750000
NODE_3169_length_1304_cov_27.137759	757	837	18	5	80	0.0625000
NODE_3169_length_1304_cov_27.137759	757	837	20	7	80	0.0875000
NODE_3169_length_1304_cov_27.137759	757	837	21	1	80	0.0125000
NODE_3169_length_1304_cov_27.137759	757	837	22	1	80	0.0125000
NODE_3169_length_1304_cov_27.137759	757	837	23	14	80	0.1750000
NODE_3169_length_1304_cov_27.137759	757	837	25	9	80	0.1125000
NODE_3169_length_1304_cov_27.137759	757	837	26	7	80	0.0875000
NODE_3169_length_1304_cov_27.137759	757	837	27	14	80	0.1750000
NODE_3171_length_1303_cov_36.546512	458	538	2	24	80	0.3000000
NODE_3171_length_1303_cov_36.546512	458	538	3	56	80	0.7000000
NODE_3171_length_1303_cov_36.546512	511	591	2	1	80	0.0125000
NODE_3171_length_1303_cov_36.546512	511	591	3	51	80	0.6375000
NODE_3171_length_1303_cov_36.546512	511	591	4	4	80	0.0500000
NODE_3171_length_1303_cov_36.546512	511	591	5	24	80	0.3000000
NODE_3171_length_1303_cov_36.546512	587	667	2	5	80	0.0625000
NODE_3171_length_1303_cov_36.546512	587	667	3	39	80	0.4875000
NODE_3171_length_1303_cov_36.546512	587	667	4	31	80	0.3875000
NODE_3171_length_1303_cov_36.546512	587	667	5	5	80	0.0625000
NODE_3171_length_1303_cov_36.546512	640	720	2	14	80	0.1750000
NODE_3171_length_1303_cov_36.546512	640	720	3	25	80	0.3125000
NODE_3171_length_1303_cov_36.546512	640	720	4	4	80	0.0500000
NODE_3171_length_1303_cov_36.546512	640	720	5	37	80	0.4625000
NODE_3174_length_1302_cov_22.265170	747	827	12	26	80	0.3250000
NODE_3174_length_1302_cov_22.265170	747	827	13	38	80	0.4750000
NODE_3174_length_1302_cov_22.265170	747	827	14	16	80	0.2000000
NODE_3174_length_1302_cov_22.265170	800	880	7	29	80	0.3625000
NODE_3174_length_1302_cov_22.265170	800	880	9	18	80	0.2250000
NODE_3174_length_1302_cov_22.265170	800	880	12	20	80	0.2500000
NODE_3174_length_1302_cov_22.265170	800	880	14	13	80	0.1625000
NODE_3175_length_1302_cov_16.199501	480	560	6	5	80	0.0625000
NODE_3175_length_1302_cov_16.199501	480	560	7	41	80	0.5125000
NODE_3175_length_1302_cov_16.199501	480	560	8	34	80	0.4250000
NODE_3175_length_1302_cov_16.199501	533	613	3	26	80	0.3250000
NODE_3175_length_1302_cov_16.199501	533	613	4	26	80	0.3250000
NODE_3175_length_1302_cov_16.199501	533	613	6	1	80	0.0125000
NODE_3175_length_1302_cov_16.199501	533	613	7	27	80	0.3375000
NODE_3176_length_1302_cov_6.953450	687	767	2	8	80	0.1000000
NODE_3176_length_1302_cov_6.953450	687	767	3	62	80	0.7750000
NODE_3176_length_1302_cov_6.953450	687	767	5	10	80	0.1250000
NODE_3176_length_1302_cov_6.953450	740	820	2	8	80	0.1000000
NODE_3176_length_1302_cov_6.953450	740	820	3	9	80	0.1125000
NODE_3176_length_1302_cov_6.953450	740	820	5	21	80	0.2625000
NODE_3176_length_1302_cov_6.953450	740	820	6	7	80	0.0875000
NODE_3176_length_1302_cov_6.953450	740	820	7	35	80	0.4375000
NODE_3179_length_1301_cov_31.711314	401	481	4	19	80	0.2375000
NODE_3179_length_1301_cov_31.711314	401	481	6	22	80	0.2750000
NODE_3179_length_1301_cov_31.711314	401	481	7	11	80	0.1375000
NODE_3179_length_1301_cov_31.711314	401	481	9	28	80	0.3500000
NODE_3179_length_1301_cov_31.711314	454	534	9	44	80	0.5500000
NODE_3179_length_1301_cov_31.711314	454	534	11	5	80	0.0625000
NODE_3179_length_1301_cov_31.711314	454	534	12	6	80	0.0750000
NODE_3179_length_1301_cov_31.711314	454	534	13	14	80	0.1750000
NODE_3179_length_1301_cov_31.711314	454	534	14	11	80	0.1375000
NODE_3181_length_1301_cov_5.529950	246	326	4	11	80	0.1375000
NODE_3181_length_1301_cov_5.529950	246	326	6	69	80	0.8625000
NODE_3181_length_1301_cov_5.529950	299	379	4	28	80	0.3500000
NODE_3181_length_1301_cov_5.529950	299	379	6	49	80	0.6125000
NODE_3181_length_1301_cov_5.529950	299	379	8	3	80	0.0375000
NODE_3186_length_1300_cov_39.109908	602	682	26	5	80	0.0625000
NODE_3186_length_1300_cov_39.109908	602	682	27	16	80	0.2000000
NODE_3186_length_1300_cov_39.109908	602	682	28	5	80	0.0625000
NODE_3186_length_1300_cov_39.109908	602	682	29	12	80	0.1500000
NODE_3186_length_1300_cov_39.109908	602	682	30	24	80	0.3000000
NODE_3186_length_1300_cov_39.109908	602	682	31	7	80	0.0875000
NODE_3186_length_1300_cov_39.109908	602	682	32	2	80	0.0250000
NODE_3186_length_1300_cov_39.109908	602	682	33	6	80	0.0750000
NODE_3186_length_1300_cov_39.109908	602	682	34	3	80	0.0375000
NODE_3186_length_1300_cov_39.109908	655	735	21	1	80	0.0125000
NODE_3186_length_1300_cov_39.109908	655	735	23	3	80	0.0375000
NODE_3186_length_1300_cov_39.109908	655	735	24	1	80	0.0125000
NODE_3186_length_1300_cov_39.109908	655	735	25	4	80	0.0500000
NODE_3186_length_1300_cov_39.109908	655	735	26	6	80	0.0750000
NODE_3186_length_1300_cov_39.109908	655	735	28	1	80	0.0125000
NODE_3186_length_1300_cov_39.109908	655	735	29	14	80	0.1750000
NODE_3186_length_1300_cov_39.109908	655	735	30	13	80	0.1625000
NODE_3186_length_1300_cov_39.109908	655	735	31	12	80	0.1500000
NODE_3186_length_1300_cov_39.109908	655	735	32	14	80	0.1750000
NODE_3186_length_1300_cov_39.109908	655	735	33	8	80	0.1000000
NODE_3186_length_1300_cov_39.109908	655	735	34	3	80	0.0375000
NODE_3187_length_1300_cov_34.360533	586	666	6	1	80	0.0125000
NODE_3187_length_1300_cov_34.360533	586	666	7	60	80	0.7500000
NODE_3187_length_1300_cov_34.360533	586	666	8	19	80	0.2375000
NODE_3187_length_1300_cov_34.360533	639	719	2	22	80	0.2750000
NODE_3187_length_1300_cov_34.360533	639	719	4	6	80	0.0750000
NODE_3187_length_1300_cov_34.360533	639	719	5	9	80	0.1125000
NODE_3187_length_1300_cov_34.360533	639	719	6	17	80	0.2125000
NODE_3187_length_1300_cov_34.360533	639	719	7	26	80	0.3250000
NODE_3188_length_1300_cov_4.659450	454	535	6	38	81	0.4691358
NODE_3188_length_1300_cov_4.659450	454	535	7	22	81	0.2716049
NODE_3188_length_1300_cov_4.659450	454	535	8	2	81	0.0246914
NODE_3188_length_1300_cov_4.659450	454	535	9	11	81	0.1358025
NODE_3188_length_1300_cov_4.659450	454	535	11	4	81	0.0493827
NODE_3188_length_1300_cov_4.659450	454	535	12	4	81	0.0493827
NODE_3188_length_1300_cov_4.659450	508	588	6	28	80	0.3500000
NODE_3188_length_1300_cov_4.659450	508	588	7	47	80	0.5875000
NODE_3188_length_1300_cov_4.659450	508	588	9	5	80	0.0625000
NODE_3189_length_1299_cov_29.071667	452	532	0	80	80	1.0000000
NODE_3190_length_1299_cov_23.600833	818	898	2	9	80	0.1125000
NODE_3190_length_1299_cov_23.600833	818	898	3	43	80	0.5375000
NODE_3190_length_1299_cov_23.600833	818	898	4	28	80	0.3500000
NODE_3190_length_1299_cov_23.600833	871	951	1	5	80	0.0625000
NODE_3190_length_1299_cov_23.600833	871	951	2	57	80	0.7125000
NODE_3190_length_1299_cov_23.600833	871	951	3	1	80	0.0125000
NODE_3190_length_1299_cov_23.600833	871	951	4	17	80	0.2125000
NODE_3191_length_1299_cov_23.169167	625	705	4	3	80	0.0375000
NODE_3191_length_1299_cov_23.169167	625	705	6	16	80	0.2000000
NODE_3191_length_1299_cov_23.169167	625	705	7	4	80	0.0500000
NODE_3191_length_1299_cov_23.169167	625	705	8	33	80	0.4125000
NODE_3191_length_1299_cov_23.169167	625	705	15	24	80	0.3000000
NODE_3191_length_1299_cov_23.169167	678	758	4	3	80	0.0375000
NODE_3191_length_1299_cov_23.169167	678	758	15	57	80	0.7125000
NODE_3191_length_1299_cov_23.169167	678	758	17	2	80	0.0250000
NODE_3191_length_1299_cov_23.169167	678	758	18	6	80	0.0750000
NODE_3191_length_1299_cov_23.169167	678	758	19	12	80	0.1500000
NODE_3191_length_1299_cov_23.169167	754	834	7	3	80	0.0375000
NODE_3191_length_1299_cov_23.169167	754	834	16	39	80	0.4875000
NODE_3191_length_1299_cov_23.169167	754	834	18	17	80	0.2125000
NODE_3191_length_1299_cov_23.169167	754	834	19	21	80	0.2625000
NODE_3191_length_1299_cov_23.169167	807	887	7	56	80	0.7000000
NODE_3191_length_1299_cov_23.169167	807	887	16	7	80	0.0875000
NODE_3191_length_1299_cov_23.169167	807	887	18	17	80	0.2125000
NODE_3192_length_1299_cov_19.315000	306	386	8	7	80	0.0875000
NODE_3192_length_1299_cov_19.315000	306	386	9	19	80	0.2375000
NODE_3192_length_1299_cov_19.315000	306	386	11	9	80	0.1125000
NODE_3192_length_1299_cov_19.315000	306	386	12	45	80	0.5625000
NODE_3192_length_1299_cov_19.315000	359	439	4	1	80	0.0125000
NODE_3192_length_1299_cov_19.315000	359	439	5	5	80	0.0625000
NODE_3192_length_1299_cov_19.315000	359	439	6	23	80	0.2875000
NODE_3192_length_1299_cov_19.315000	359	439	7	14	80	0.1750000
NODE_3192_length_1299_cov_19.315000	359	439	8	17	80	0.2125000
NODE_3192_length_1299_cov_19.315000	359	439	9	19	80	0.2375000
NODE_3192_length_1299_cov_19.315000	359	439	12	1	80	0.0125000
NODE_3192_length_1299_cov_19.315000	435	515	3	50	80	0.6250000
NODE_3192_length_1299_cov_19.315000	435	515	4	19	80	0.2375000
NODE_3192_length_1299_cov_19.315000	435	515	5	1	80	0.0125000
NODE_3192_length_1299_cov_19.315000	435	515	6	10	80	0.1250000
NODE_3192_length_1299_cov_19.315000	488	568	3	80	80	1.0000000
NODE_3193_length_1299_cov_13.691667	540	620	2	24	80	0.3000000
NODE_3193_length_1299_cov_13.691667	540	620	4	13	80	0.1625000
NODE_3193_length_1299_cov_13.691667	540	620	5	43	80	0.5375000
NODE_3193_length_1299_cov_13.691667	593	673	2	4	80	0.0500000
NODE_3193_length_1299_cov_13.691667	593	673	4	20	80	0.2500000
NODE_3193_length_1299_cov_13.691667	593	673	5	56	80	0.7000000
NODE_3195_length_1298_cov_58.277731	679	759	9	20	80	0.2500000
NODE_3195_length_1298_cov_58.277731	679	759	10	39	80	0.4875000
NODE_3195_length_1298_cov_58.277731	679	759	11	12	80	0.1500000
NODE_3195_length_1298_cov_58.277731	679	759	13	9	80	0.1125000
NODE_3195_length_1298_cov_58.277731	732	812	8	12	80	0.1500000
NODE_3195_length_1298_cov_58.277731	732	812	9	23	80	0.2875000
NODE_3195_length_1298_cov_58.277731	732	812	10	15	80	0.1875000
NODE_3195_length_1298_cov_58.277731	732	812	11	20	80	0.2500000
NODE_3195_length_1298_cov_58.277731	732	812	12	1	80	0.0125000
NODE_3195_length_1298_cov_58.277731	732	812	13	9	80	0.1125000
NODE_3195_length_1298_cov_58.277731	808	888	7	14	80	0.1750000
NODE_3195_length_1298_cov_58.277731	808	888	8	9	80	0.1125000
NODE_3195_length_1298_cov_58.277731	808	888	10	26	80	0.3250000
NODE_3195_length_1298_cov_58.277731	808	888	11	31	80	0.3875000
NODE_3195_length_1298_cov_58.277731	861	941	2	22	80	0.2750000
NODE_3195_length_1298_cov_58.277731	861	941	3	7	80	0.0875000
NODE_3195_length_1298_cov_58.277731	861	941	4	14	80	0.1750000
NODE_3195_length_1298_cov_58.277731	861	941	7	24	80	0.3000000
NODE_3195_length_1298_cov_58.277731	861	941	8	9	80	0.1125000
NODE_3195_length_1298_cov_58.277731	861	941	10	4	80	0.0500000
NODE_3196_length_1298_cov_31.319433	375	455	1	6	80	0.0750000
NODE_3196_length_1298_cov_31.319433	375	455	3	1	80	0.0125000
NODE_3196_length_1298_cov_31.319433	375	455	4	9	80	0.1125000
NODE_3196_length_1298_cov_31.319433	375	455	11	1	80	0.0125000
NODE_3196_length_1298_cov_31.319433	375	455	12	19	80	0.2375000
NODE_3196_length_1298_cov_31.319433	375	455	13	6	80	0.0750000
NODE_3196_length_1298_cov_31.319433	375	455	14	38	80	0.4750000
NODE_3196_length_1298_cov_31.319433	428	508	14	67	80	0.8375000
NODE_3196_length_1298_cov_31.319433	428	508	18	5	80	0.0625000
NODE_3196_length_1298_cov_31.319433	428	508	24	7	80	0.0875000
NODE_3196_length_1298_cov_31.319433	428	508	25	1	80	0.0125000
NODE_3196_length_1298_cov_31.319433	504	584	21	17	80	0.2125000
NODE_3196_length_1298_cov_31.319433	504	584	22	14	80	0.1750000
NODE_3196_length_1298_cov_31.319433	504	584	23	14	80	0.1750000
NODE_3196_length_1298_cov_31.319433	504	584	24	3	80	0.0375000
NODE_3196_length_1298_cov_31.319433	504	584	25	5	80	0.0625000
NODE_3196_length_1298_cov_31.319433	504	584	27	9	80	0.1125000
NODE_3196_length_1298_cov_31.319433	504	584	29	1	80	0.0125000
NODE_3196_length_1298_cov_31.319433	504	584	30	14	80	0.1750000
NODE_3196_length_1298_cov_31.319433	504	584	31	3	80	0.0375000
NODE_3196_length_1298_cov_31.319433	557	637	21	19	80	0.2375000
NODE_3196_length_1298_cov_31.319433	557	637	22	6	80	0.0750000
NODE_3196_length_1298_cov_31.319433	557	637	23	4	80	0.0500000
NODE_3196_length_1298_cov_31.319433	557	637	24	4	80	0.0500000
NODE_3196_length_1298_cov_31.319433	557	637	25	1	80	0.0125000
NODE_3196_length_1298_cov_31.319433	557	637	26	3	80	0.0375000
NODE_3196_length_1298_cov_31.319433	557	637	33	1	80	0.0125000
NODE_3196_length_1298_cov_31.319433	557	637	34	4	80	0.0500000
NODE_3196_length_1298_cov_31.319433	557	637	36	7	80	0.0875000
NODE_3196_length_1298_cov_31.319433	557	637	37	6	80	0.0750000
NODE_3196_length_1298_cov_31.319433	557	637	38	3	80	0.0375000
NODE_3196_length_1298_cov_31.319433	557	637	39	16	80	0.2000000
NODE_3196_length_1298_cov_31.319433	557	637	47	6	80	0.0750000
NODE_3197_length_1298_cov_2.158465	294	360	0	66	66	1.0000000
NODE_3201_length_1296_cov_34.778613	620	700	4	5	80	0.0625000
NODE_3201_length_1296_cov_34.778613	620	700	5	26	80	0.3250000
NODE_3201_length_1296_cov_34.778613	620	700	7	2	80	0.0250000
NODE_3201_length_1296_cov_34.778613	620	700	8	45	80	0.5625000
NODE_3201_length_1296_cov_34.778613	620	700	9	2	80	0.0250000
NODE_3201_length_1296_cov_34.778613	673	753	8	78	80	0.9750000
NODE_3201_length_1296_cov_34.778613	673	753	9	2	80	0.0250000
NODE_3202_length_1296_cov_28.726817	671	751	6	9	80	0.1125000
NODE_3202_length_1296_cov_28.726817	671	751	10	60	80	0.7500000
NODE_3202_length_1296_cov_28.726817	671	751	11	11	80	0.1375000
NODE_3202_length_1296_cov_28.726817	724	804	6	14	80	0.1750000
NODE_3202_length_1296_cov_28.726817	724	804	7	5	80	0.0625000
NODE_3202_length_1296_cov_28.726817	724	804	8	16	80	0.2000000
NODE_3202_length_1296_cov_28.726817	724	804	9	27	80	0.3375000
NODE_3202_length_1296_cov_28.726817	724	804	10	18	80	0.2250000
NODE_3202_length_1296_cov_28.726817	800	880	3	10	80	0.1250000
NODE_3202_length_1296_cov_28.726817	800	880	4	55	80	0.6875000
NODE_3202_length_1296_cov_28.726817	800	880	8	4	80	0.0500000
NODE_3202_length_1296_cov_28.726817	800	880	9	11	80	0.1375000
NODE_3202_length_1296_cov_28.726817	853	933	1	6	80	0.0750000
NODE_3202_length_1296_cov_28.726817	853	933	2	16	80	0.2000000
NODE_3202_length_1296_cov_28.726817	853	933	3	14	80	0.1750000
NODE_3202_length_1296_cov_28.726817	853	933	4	44	80	0.5500000
NODE_3205_length_1295_cov_10.661371	818	898	4	1	80	0.0125000
NODE_3205_length_1295_cov_10.661371	818	898	5	45	80	0.5625000
NODE_3205_length_1295_cov_10.661371	818	898	8	24	80	0.3000000
NODE_3205_length_1295_cov_10.661371	818	898	9	8	80	0.1000000
NODE_3205_length_1295_cov_10.661371	818	898	15	2	80	0.0250000
NODE_3205_length_1295_cov_10.661371	871	951	4	1	80	0.0125000
NODE_3205_length_1295_cov_10.661371	871	951	5	23	80	0.2875000
NODE_3205_length_1295_cov_10.661371	871	951	7	2	80	0.0250000
NODE_3205_length_1295_cov_10.661371	871	951	8	54	80	0.6750000
NODE_3211_length_1294_cov_15.098745	353	433	0	40	80	0.5000000
NODE_3211_length_1294_cov_15.098745	353	433	2	40	80	0.5000000
NODE_3211_length_1294_cov_15.098745	406	486	2	72	80	0.9000000
NODE_3211_length_1294_cov_15.098745	406	486	4	8	80	0.1000000
NODE_3216_length_1293_cov_26.580402	595	675	12	3	80	0.0375000
NODE_3216_length_1293_cov_26.580402	595	675	14	12	80	0.1500000
NODE_3216_length_1293_cov_26.580402	595	675	15	29	80	0.3625000
NODE_3216_length_1293_cov_26.580402	595	675	16	1	80	0.0125000
NODE_3216_length_1293_cov_26.580402	595	675	17	13	80	0.1625000
NODE_3216_length_1293_cov_26.580402	595	675	19	8	80	0.1000000
NODE_3216_length_1293_cov_26.580402	595	675	20	14	80	0.1750000
NODE_3216_length_1293_cov_26.580402	648	728	11	16	80	0.2000000
NODE_3216_length_1293_cov_26.580402	648	728	12	7	80	0.0875000
NODE_3216_length_1293_cov_26.580402	648	728	13	15	80	0.1875000
NODE_3216_length_1293_cov_26.580402	648	728	14	13	80	0.1625000
NODE_3216_length_1293_cov_26.580402	648	728	15	8	80	0.1000000
NODE_3216_length_1293_cov_26.580402	648	728	16	1	80	0.0125000
NODE_3216_length_1293_cov_26.580402	648	728	17	3	80	0.0375000
NODE_3216_length_1293_cov_26.580402	648	728	18	10	80	0.1250000
NODE_3216_length_1293_cov_26.580402	648	728	19	7	80	0.0875000
NODE_3216_length_1293_cov_26.580402	724	804	8	21	80	0.2625000
NODE_3216_length_1293_cov_26.580402	724	804	9	1	80	0.0125000
NODE_3216_length_1293_cov_26.580402	724	804	10	9	80	0.1125000
NODE_3216_length_1293_cov_26.580402	724	804	11	1	80	0.0125000
NODE_3216_length_1293_cov_26.580402	724	804	12	37	80	0.4625000
NODE_3216_length_1293_cov_26.580402	724	804	13	11	80	0.1375000
NODE_3216_length_1293_cov_26.580402	777	857	0	5	80	0.0625000
NODE_3216_length_1293_cov_26.580402	777	857	3	7	80	0.0875000
NODE_3216_length_1293_cov_26.580402	777	857	7	36	80	0.4500000
NODE_3216_length_1293_cov_26.580402	777	857	8	26	80	0.3250000
NODE_3216_length_1293_cov_26.580402	777	857	9	1	80	0.0125000
NODE_3216_length_1293_cov_26.580402	777	857	10	5	80	0.0625000
NODE_3217_length_1293_cov_9.252094	1187	1207	0	20	20	1.0000000
NODE_3220_length_1293_cov_2.118090	1131	1195	0	64	64	1.0000000
NODE_3220_length_1293_cov_2.118090	1184	1248	0	64	64	1.0000000
NODE_3224_length_1292_cov_50.158424	402	482	15	1	80	0.0125000
NODE_3224_length_1292_cov_50.158424	402	482	16	44	80	0.5500000
NODE_3224_length_1292_cov_50.158424	402	482	17	24	80	0.3000000
NODE_3224_length_1292_cov_50.158424	402	482	18	11	80	0.1375000
NODE_3224_length_1292_cov_50.158424	455	535	12	7	80	0.0875000
NODE_3224_length_1292_cov_50.158424	455	535	13	1	80	0.0125000
NODE_3224_length_1292_cov_50.158424	455	535	15	12	80	0.1500000
NODE_3224_length_1292_cov_50.158424	455	535	16	33	80	0.4125000
NODE_3224_length_1292_cov_50.158424	455	535	17	15	80	0.1875000
NODE_3224_length_1292_cov_50.158424	455	535	18	12	80	0.1500000
NODE_3224_length_1292_cov_50.158424	531	611	9	2	80	0.0250000
NODE_3224_length_1292_cov_50.158424	531	611	10	6	80	0.0750000
NODE_3224_length_1292_cov_50.158424	531	611	12	20	80	0.2500000
NODE_3224_length_1292_cov_50.158424	531	611	13	11	80	0.1375000
NODE_3224_length_1292_cov_50.158424	531	611	14	7	80	0.0875000
NODE_3224_length_1292_cov_50.158424	531	611	15	29	80	0.3625000
NODE_3224_length_1292_cov_50.158424	531	611	16	5	80	0.0625000
NODE_3224_length_1292_cov_50.158424	584	664	10	10	80	0.1250000
NODE_3224_length_1292_cov_50.158424	584	664	12	37	80	0.4625000
NODE_3224_length_1292_cov_50.158424	584	664	13	10	80	0.1250000
NODE_3224_length_1292_cov_50.158424	584	664	14	1	80	0.0125000
NODE_3224_length_1292_cov_50.158424	584	664	15	22	80	0.2750000
NODE_3225_length_1292_cov_36.535624	670	750	12	9	80	0.1125000
NODE_3225_length_1292_cov_36.535624	670	750	16	3	80	0.0375000
NODE_3225_length_1292_cov_36.535624	670	750	17	21	80	0.2625000
NODE_3225_length_1292_cov_36.535624	670	750	18	25	80	0.3125000
NODE_3225_length_1292_cov_36.535624	670	750	20	4	80	0.0500000
NODE_3225_length_1292_cov_36.535624	670	750	22	2	80	0.0250000
NODE_3225_length_1292_cov_36.535624	670	750	24	4	80	0.0500000
NODE_3225_length_1292_cov_36.535624	670	750	26	12	80	0.1500000
NODE_3225_length_1292_cov_36.535624	723	803	18	5	80	0.0625000
NODE_3225_length_1292_cov_36.535624	723	803	19	4	80	0.0500000
NODE_3225_length_1292_cov_36.535624	723	803	20	9	80	0.1125000
NODE_3225_length_1292_cov_36.535624	723	803	22	8	80	0.1000000
NODE_3225_length_1292_cov_36.535624	723	803	23	1	80	0.0125000
NODE_3225_length_1292_cov_36.535624	723	803	24	33	80	0.4125000
NODE_3225_length_1292_cov_36.535624	723	803	25	3	80	0.0375000
NODE_3225_length_1292_cov_36.535624	723	803	26	16	80	0.2000000
NODE_3225_length_1292_cov_36.535624	723	803	28	1	80	0.0125000
NODE_3226_length_1292_cov_24.523889	420	500	2	80	80	1.0000000
NODE_3226_length_1292_cov_24.523889	473	553	0	20	80	0.2500000
NODE_3226_length_1292_cov_24.523889	473	553	2	60	80	0.7500000
NODE_3232_length_1291_cov_8.734060	623	703	0	80	80	1.0000000
NODE_3232_length_1291_cov_8.734060	676	756	0	80	80	1.0000000
NODE_3233_length_1291_cov_8.625839	756	836	5	45	80	0.5625000
NODE_3233_length_1291_cov_8.625839	756	836	6	1	80	0.0125000
NODE_3233_length_1291_cov_8.625839	756	836	7	17	80	0.2125000
NODE_3233_length_1291_cov_8.625839	756	836	8	6	80	0.0750000
NODE_3233_length_1291_cov_8.625839	756	836	9	11	80	0.1375000
NODE_3233_length_1291_cov_8.625839	809	889	5	15	80	0.1875000
NODE_3233_length_1291_cov_8.625839	809	889	6	1	80	0.0125000
NODE_3233_length_1291_cov_8.625839	809	889	7	16	80	0.2000000
NODE_3233_length_1291_cov_8.625839	809	889	8	27	80	0.3375000
NODE_3233_length_1291_cov_8.625839	809	889	9	21	80	0.2625000
NODE_3236_length_1290_cov_24.120067	497	577	2	22	80	0.2750000
NODE_3236_length_1290_cov_24.120067	497	577	4	12	80	0.1500000
NODE_3236_length_1290_cov_24.120067	497	577	6	46	80	0.5750000
NODE_3236_length_1290_cov_24.120067	550	630	4	1	80	0.0125000
NODE_3236_length_1290_cov_24.120067	550	630	5	26	80	0.3250000
NODE_3236_length_1290_cov_24.120067	550	630	6	29	80	0.3625000
NODE_3236_length_1290_cov_24.120067	550	630	7	24	80	0.3000000
NODE_3236_length_1290_cov_24.120067	626	706	5	20	80	0.2500000
NODE_3236_length_1290_cov_24.120067	626	706	6	5	80	0.0625000
NODE_3236_length_1290_cov_24.120067	626	706	7	44	80	0.5500000
NODE_3236_length_1290_cov_24.120067	626	706	8	3	80	0.0375000
NODE_3236_length_1290_cov_24.120067	626	706	9	8	80	0.1000000
NODE_3236_length_1290_cov_24.120067	679	759	4	3	80	0.0375000
NODE_3236_length_1290_cov_24.120067	679	759	5	20	80	0.2500000
NODE_3236_length_1290_cov_24.120067	679	759	6	34	80	0.4250000
NODE_3236_length_1290_cov_24.120067	679	759	7	23	80	0.2875000
NODE_3237_length_1290_cov_18.874895	671	751	3	26	80	0.3250000
NODE_3237_length_1290_cov_18.874895	671	751	4	22	80	0.2750000
NODE_3237_length_1290_cov_18.874895	671	751	5	6	80	0.0750000
NODE_3237_length_1290_cov_18.874895	671	751	6	8	80	0.1000000
NODE_3237_length_1290_cov_18.874895	671	751	7	18	80	0.2250000
NODE_3237_length_1290_cov_18.874895	724	804	5	21	80	0.2625000
NODE_3237_length_1290_cov_18.874895	724	804	6	39	80	0.4875000
NODE_3237_length_1290_cov_18.874895	724	804	7	20	80	0.2500000
NODE_3238_length_1290_cov_11.627204	573	653	3	28	80	0.3500000
NODE_3238_length_1290_cov_11.627204	573	653	4	12	80	0.1500000
NODE_3238_length_1290_cov_11.627204	573	653	5	9	80	0.1125000
NODE_3238_length_1290_cov_11.627204	573	653	7	10	80	0.1250000
NODE_3238_length_1290_cov_11.627204	573	653	10	9	80	0.1125000
NODE_3238_length_1290_cov_11.627204	573	653	11	2	80	0.0250000
NODE_3238_length_1290_cov_11.627204	573	653	12	10	80	0.1250000
NODE_3238_length_1290_cov_11.627204	626	706	7	6	80	0.0750000
NODE_3238_length_1290_cov_11.627204	626	706	10	19	80	0.2375000
NODE_3238_length_1290_cov_11.627204	626	706	11	28	80	0.3500000
NODE_3238_length_1290_cov_11.627204	626	706	12	10	80	0.1250000
NODE_3238_length_1290_cov_11.627204	626	706	13	17	80	0.2125000
NODE_3239_length_1290_cov_11.215785	373	453	3	19	80	0.2375000
NODE_3239_length_1290_cov_11.215785	373	453	4	27	80	0.3375000
NODE_3239_length_1290_cov_11.215785	373	453	6	34	80	0.4250000
NODE_3239_length_1290_cov_11.215785	426	506	4	57	80	0.7125000
NODE_3239_length_1290_cov_11.215785	426	506	6	23	80	0.2875000
NODE_3240_length_1290_cov_8.752309	788	868	3	3	80	0.0375000
NODE_3240_length_1290_cov_8.752309	788	868	5	43	80	0.5375000
NODE_3240_length_1290_cov_8.752309	788	868	6	34	80	0.4250000
NODE_3240_length_1290_cov_8.752309	841	921	4	5	80	0.0625000
NODE_3240_length_1290_cov_8.752309	841	921	5	75	80	0.9375000
NODE_3242_length_1289_cov_47.476471	919	999	12	18	80	0.2250000
NODE_3242_length_1289_cov_47.476471	919	999	14	2	80	0.0250000
NODE_3242_length_1289_cov_47.476471	919	999	16	7	80	0.0875000
NODE_3242_length_1289_cov_47.476471	919	999	18	8	80	0.1000000
NODE_3242_length_1289_cov_47.476471	919	999	19	10	80	0.1250000
NODE_3242_length_1289_cov_47.476471	919	999	20	1	80	0.0125000
NODE_3242_length_1289_cov_47.476471	919	999	21	6	80	0.0750000
NODE_3242_length_1289_cov_47.476471	919	999	23	26	80	0.3250000
NODE_3242_length_1289_cov_47.476471	919	999	24	2	80	0.0250000
NODE_3242_length_1289_cov_47.476471	972	1052	16	3	80	0.0375000
NODE_3242_length_1289_cov_47.476471	972	1052	17	7	80	0.0875000
NODE_3242_length_1289_cov_47.476471	972	1052	18	2	80	0.0250000
NODE_3242_length_1289_cov_47.476471	972	1052	19	10	80	0.1250000
NODE_3242_length_1289_cov_47.476471	972	1052	21	7	80	0.0875000
NODE_3242_length_1289_cov_47.476471	972	1052	22	12	80	0.1500000
NODE_3242_length_1289_cov_47.476471	972	1052	23	25	80	0.3125000
NODE_3242_length_1289_cov_47.476471	972	1052	24	14	80	0.1750000
NODE_3243_length_1289_cov_18.497479	688	768	20	8	80	0.1000000
NODE_3243_length_1289_cov_18.497479	688	768	22	21	80	0.2625000
NODE_3243_length_1289_cov_18.497479	688	768	23	15	80	0.1875000
NODE_3243_length_1289_cov_18.497479	688	768	25	10	80	0.1250000
NODE_3243_length_1289_cov_18.497479	688	768	26	26	80	0.3250000
NODE_3243_length_1289_cov_18.497479	741	821	20	4	80	0.0500000
NODE_3243_length_1289_cov_18.497479	741	821	21	4	80	0.0500000
NODE_3243_length_1289_cov_18.497479	741	821	22	22	80	0.2750000
NODE_3243_length_1289_cov_18.497479	741	821	23	41	80	0.5125000
NODE_3243_length_1289_cov_18.497479	741	821	25	7	80	0.0875000
NODE_3243_length_1289_cov_18.497479	741	821	26	2	80	0.0250000
NODE_3243_length_1289_cov_18.497479	817	893	6	8	76	0.1052632
NODE_3243_length_1289_cov_18.497479	817	893	7	3	76	0.0394737
NODE_3243_length_1289_cov_18.497479	817	893	9	16	76	0.2105263
NODE_3243_length_1289_cov_18.497479	817	893	10	8	76	0.1052632
NODE_3243_length_1289_cov_18.497479	817	893	11	14	76	0.1842105
NODE_3243_length_1289_cov_18.497479	817	893	12	4	76	0.0526316
NODE_3243_length_1289_cov_18.497479	817	893	13	4	76	0.0526316
NODE_3243_length_1289_cov_18.497479	817	893	14	1	76	0.0131579
NODE_3243_length_1289_cov_18.497479	817	893	15	7	76	0.0921053
NODE_3243_length_1289_cov_18.497479	817	893	19	1	76	0.0131579
NODE_3243_length_1289_cov_18.497479	817	893	21	4	76	0.0526316
NODE_3243_length_1289_cov_18.497479	817	893	23	6	76	0.0789474
NODE_3243_length_1289_cov_18.497479	878	958	9	1	80	0.0125000
NODE_3243_length_1289_cov_18.497479	878	958	10	2	80	0.0250000
NODE_3243_length_1289_cov_18.497479	878	958	11	5	80	0.0625000
NODE_3243_length_1289_cov_18.497479	878	958	12	4	80	0.0500000
NODE_3243_length_1289_cov_18.497479	878	958	13	2	80	0.0250000
NODE_3243_length_1289_cov_18.497479	878	958	14	11	80	0.1375000
NODE_3243_length_1289_cov_18.497479	878	958	16	23	80	0.2875000
NODE_3243_length_1289_cov_18.497479	878	958	17	5	80	0.0625000
NODE_3243_length_1289_cov_18.497479	878	958	18	27	80	0.3375000
NODE_3244_length_1289_cov_11.692437	574	654	5	23	80	0.2875000
NODE_3244_length_1289_cov_11.692437	574	654	6	57	80	0.7125000
NODE_3244_length_1289_cov_11.692437	627	707	4	13	80	0.1625000
NODE_3244_length_1289_cov_11.692437	627	707	5	9	80	0.1125000
NODE_3244_length_1289_cov_11.692437	627	707	6	58	80	0.7250000
NODE_3244_length_1289_cov_11.692437	703	783	2	3	80	0.0375000
NODE_3244_length_1289_cov_11.692437	703	783	3	67	80	0.8375000
NODE_3244_length_1289_cov_11.692437	703	783	4	10	80	0.1250000
NODE_3244_length_1289_cov_11.692437	756	836	3	23	80	0.2875000
NODE_3244_length_1289_cov_11.692437	756	836	4	57	80	0.7125000
NODE_3249_length_1288_cov_29.369218	711	791	30	3	80	0.0375000
NODE_3249_length_1288_cov_29.369218	711	791	31	7	80	0.0875000
NODE_3249_length_1288_cov_29.369218	711	791	32	7	80	0.0875000
NODE_3249_length_1288_cov_29.369218	711	791	33	12	80	0.1500000
NODE_3249_length_1288_cov_29.369218	711	791	34	15	80	0.1875000
NODE_3249_length_1288_cov_29.369218	711	791	35	19	80	0.2375000
NODE_3249_length_1288_cov_29.369218	711	791	36	7	80	0.0875000
NODE_3249_length_1288_cov_29.369218	711	791	37	10	80	0.1250000
NODE_3249_length_1288_cov_29.369218	764	844	16	4	80	0.0500000
NODE_3249_length_1288_cov_29.369218	764	844	17	5	80	0.0625000
NODE_3249_length_1288_cov_29.369218	764	844	18	6	80	0.0750000
NODE_3249_length_1288_cov_29.369218	764	844	20	1	80	0.0125000
NODE_3249_length_1288_cov_29.369218	764	844	21	1	80	0.0125000
NODE_3249_length_1288_cov_29.369218	764	844	22	3	80	0.0375000
NODE_3249_length_1288_cov_29.369218	764	844	24	3	80	0.0375000
NODE_3249_length_1288_cov_29.369218	764	844	25	13	80	0.1625000
NODE_3249_length_1288_cov_29.369218	764	844	28	9	80	0.1125000
NODE_3249_length_1288_cov_29.369218	764	844	32	10	80	0.1250000
NODE_3249_length_1288_cov_29.369218	764	844	33	12	80	0.1500000
NODE_3249_length_1288_cov_29.369218	764	844	34	2	80	0.0250000
NODE_3249_length_1288_cov_29.369218	764	844	35	8	80	0.1000000
NODE_3249_length_1288_cov_29.369218	764	844	36	3	80	0.0375000
NODE_3250_length_1288_cov_6.207738	735	815	5	1	80	0.0125000
NODE_3250_length_1288_cov_6.207738	735	815	7	1	80	0.0125000
NODE_3250_length_1288_cov_6.207738	735	815	8	78	80	0.9750000
NODE_3250_length_1288_cov_6.207738	788	868	4	9	80	0.1125000
NODE_3250_length_1288_cov_6.207738	788	868	5	23	80	0.2875000
NODE_3250_length_1288_cov_6.207738	788	868	8	48	80	0.6000000
NODE_3255_length_1288_cov_1.731707	1017	1095	0	78	78	1.0000000
NODE_3261_length_1287_cov_29.186027	730	810	25	3	80	0.0375000
NODE_3261_length_1287_cov_29.186027	730	810	26	1	80	0.0125000
NODE_3261_length_1287_cov_29.186027	730	810	30	8	80	0.1000000
NODE_3261_length_1287_cov_29.186027	730	810	31	62	80	0.7750000
NODE_3261_length_1287_cov_29.186027	730	810	33	6	80	0.0750000
NODE_3261_length_1287_cov_29.186027	783	863	15	3	80	0.0375000
NODE_3261_length_1287_cov_29.186027	783	863	16	8	80	0.1000000
NODE_3261_length_1287_cov_29.186027	783	863	18	7	80	0.0875000
NODE_3261_length_1287_cov_29.186027	783	863	19	9	80	0.1125000
NODE_3261_length_1287_cov_29.186027	783	863	20	2	80	0.0250000
NODE_3261_length_1287_cov_29.186027	783	863	22	6	80	0.0750000
NODE_3261_length_1287_cov_29.186027	783	863	23	9	80	0.1125000
NODE_3261_length_1287_cov_29.186027	783	863	27	4	80	0.0500000
NODE_3261_length_1287_cov_29.186027	783	863	28	4	80	0.0500000
NODE_3261_length_1287_cov_29.186027	783	863	30	2	80	0.0250000
NODE_3261_length_1287_cov_29.186027	783	863	31	26	80	0.3250000
NODE_3262_length_1287_cov_22.747475	168	248	2	3	80	0.0375000
NODE_3262_length_1287_cov_22.747475	168	248	3	39	80	0.4875000
NODE_3262_length_1287_cov_22.747475	168	248	4	19	80	0.2375000
NODE_3262_length_1287_cov_22.747475	168	248	5	19	80	0.2375000
NODE_3262_length_1287_cov_22.747475	221	301	4	68	80	0.8500000
NODE_3262_length_1287_cov_22.747475	221	301	5	12	80	0.1500000
NODE_3263_length_1287_cov_19.478956	575	655	16	15	80	0.1875000
NODE_3263_length_1287_cov_19.478956	575	655	17	7	80	0.0875000
NODE_3263_length_1287_cov_19.478956	575	655	18	6	80	0.0750000
NODE_3263_length_1287_cov_19.478956	575	655	20	33	80	0.4125000
NODE_3263_length_1287_cov_19.478956	575	655	21	1	80	0.0125000
NODE_3263_length_1287_cov_19.478956	575	655	22	18	80	0.2250000
NODE_3263_length_1287_cov_19.478956	628	708	16	6	80	0.0750000
NODE_3263_length_1287_cov_19.478956	628	708	17	22	80	0.2750000
NODE_3263_length_1287_cov_19.478956	628	708	18	11	80	0.1375000
NODE_3263_length_1287_cov_19.478956	628	708	19	5	80	0.0625000
NODE_3263_length_1287_cov_19.478956	628	708	20	28	80	0.3500000
NODE_3263_length_1287_cov_19.478956	628	708	21	1	80	0.0125000
NODE_3263_length_1287_cov_19.478956	628	708	22	7	80	0.0875000
NODE_3266_length_1286_cov_27.128054	428	508	4	66	80	0.8250000
NODE_3266_length_1286_cov_27.128054	428	508	7	14	80	0.1750000
NODE_3266_length_1286_cov_27.128054	481	561	3	5	80	0.0625000
NODE_3266_length_1286_cov_27.128054	481	561	4	61	80	0.7625000
NODE_3266_length_1286_cov_27.128054	481	561	7	14	80	0.1750000
NODE_3266_length_1286_cov_27.128054	557	637	1	2	80	0.0250000
NODE_3266_length_1286_cov_27.128054	557	637	4	78	80	0.9750000
NODE_3266_length_1286_cov_27.128054	610	690	1	18	80	0.2250000
NODE_3266_length_1286_cov_27.128054	610	690	2	37	80	0.4625000
NODE_3266_length_1286_cov_27.128054	610	690	4	25	80	0.3125000
NODE_3267_length_1286_cov_12.192081	647	727	0	80	80	1.0000000
NODE_3267_length_1286_cov_12.192081	700	780	0	80	80	1.0000000
NODE_3267_length_1286_cov_12.192081	776	856	0	56	80	0.7000000
NODE_3267_length_1286_cov_12.192081	776	856	3	1	80	0.0125000
NODE_3267_length_1286_cov_12.192081	776	856	4	23	80	0.2875000
NODE_3267_length_1286_cov_12.192081	829	909	0	3	80	0.0375000
NODE_3267_length_1286_cov_12.192081	829	909	3	1	80	0.0125000
NODE_3267_length_1286_cov_12.192081	829	909	4	76	80	0.9500000
NODE_3268_length_1286_cov_8.338669	577	657	6	20	80	0.2500000
NODE_3268_length_1286_cov_8.338669	577	657	7	1	80	0.0125000
NODE_3268_length_1286_cov_8.338669	577	657	9	59	80	0.7375000
NODE_3268_length_1286_cov_8.338669	630	710	4	24	80	0.3000000
NODE_3268_length_1286_cov_8.338669	630	710	5	22	80	0.2750000
NODE_3268_length_1286_cov_8.338669	630	710	6	11	80	0.1375000
NODE_3268_length_1286_cov_8.338669	630	710	9	23	80	0.2875000
NODE_3273_length_1285_cov_40.282462	751	831	3	22	80	0.2750000
NODE_3273_length_1285_cov_40.282462	751	831	6	58	80	0.7250000
NODE_3273_length_1285_cov_40.282462	804	884	3	39	80	0.4875000
NODE_3273_length_1285_cov_40.282462	804	884	6	41	80	0.5125000
NODE_3274_length_1285_cov_15.422428	647	727	2	16	80	0.2000000
NODE_3274_length_1285_cov_15.422428	647	727	6	6	80	0.0750000
NODE_3274_length_1285_cov_15.422428	647	727	7	23	80	0.2875000
NODE_3274_length_1285_cov_15.422428	647	727	8	35	80	0.4375000
NODE_3274_length_1285_cov_15.422428	700	780	6	11	80	0.1375000
NODE_3274_length_1285_cov_15.422428	700	780	7	1	80	0.0125000
NODE_3274_length_1285_cov_15.422428	700	780	8	47	80	0.5875000
NODE_3274_length_1285_cov_15.422428	700	780	10	21	80	0.2625000
NODE_3275_length_1285_cov_6.620573	589	669	2	15	80	0.1875000
NODE_3275_length_1285_cov_6.620573	589	669	3	29	80	0.3625000
NODE_3275_length_1285_cov_6.620573	589	669	4	36	80	0.4500000
NODE_3275_length_1285_cov_6.620573	642	722	2	6	80	0.0750000
NODE_3275_length_1285_cov_6.620573	642	722	3	25	80	0.3125000
NODE_3275_length_1285_cov_6.620573	642	722	4	49	80	0.6125000
NODE_3279_length_1284_cov_5.637975	294	374	5	19	80	0.2375000
NODE_3279_length_1284_cov_5.637975	294	374	7	61	80	0.7625000
NODE_3279_length_1284_cov_5.637975	347	427	0	4	80	0.0500000
NODE_3279_length_1284_cov_5.637975	347	427	2	19	80	0.2375000
NODE_3279_length_1284_cov_5.637975	347	427	3	9	80	0.1125000
NODE_3279_length_1284_cov_5.637975	347	427	4	8	80	0.1000000
NODE_3279_length_1284_cov_5.637975	347	427	5	32	80	0.4000000
NODE_3279_length_1284_cov_5.637975	347	427	7	8	80	0.1000000
NODE_3283_length_1283_cov_10.070101	408	488	5	3	80	0.0375000
NODE_3283_length_1283_cov_10.070101	408	488	6	19	80	0.2375000
NODE_3283_length_1283_cov_10.070101	408	488	7	39	80	0.4875000
NODE_3283_length_1283_cov_10.070101	408	488	8	19	80	0.2375000
NODE_3283_length_1283_cov_10.070101	461	541	5	22	80	0.2750000
NODE_3283_length_1283_cov_10.070101	461	541	6	42	80	0.5250000
NODE_3283_length_1283_cov_10.070101	461	541	7	16	80	0.2000000
NODE_3288_length_1282_cov_37.786137	649	729	5	10	80	0.1250000
NODE_3288_length_1282_cov_37.786137	649	729	6	19	80	0.2375000
NODE_3288_length_1282_cov_37.786137	649	729	10	1	80	0.0125000
NODE_3288_length_1282_cov_37.786137	649	729	11	8	80	0.1000000
NODE_3288_length_1282_cov_37.786137	649	729	12	3	80	0.0375000
NODE_3288_length_1282_cov_37.786137	649	729	14	5	80	0.0625000
NODE_3288_length_1282_cov_37.786137	649	729	15	12	80	0.1500000
NODE_3288_length_1282_cov_37.786137	649	729	16	22	80	0.2750000
NODE_3288_length_1282_cov_37.786137	702	782	11	2	80	0.0250000
NODE_3288_length_1282_cov_37.786137	702	782	12	7	80	0.0875000
NODE_3288_length_1282_cov_37.786137	702	782	13	13	80	0.1625000
NODE_3288_length_1282_cov_37.786137	702	782	14	13	80	0.1625000
NODE_3288_length_1282_cov_37.786137	702	782	15	8	80	0.1000000
NODE_3288_length_1282_cov_37.786137	702	782	16	21	80	0.2625000
NODE_3288_length_1282_cov_37.786137	702	782	18	2	80	0.0250000
NODE_3288_length_1282_cov_37.786137	702	782	19	5	80	0.0625000
NODE_3288_length_1282_cov_37.786137	702	782	24	3	80	0.0375000
NODE_3288_length_1282_cov_37.786137	702	782	25	4	80	0.0500000
NODE_3288_length_1282_cov_37.786137	702	782	28	2	80	0.0250000
NODE_3288_length_1282_cov_37.786137	778	858	25	13	80	0.1625000
NODE_3288_length_1282_cov_37.786137	778	858	26	4	80	0.0500000
NODE_3288_length_1282_cov_37.786137	778	858	27	6	80	0.0750000
NODE_3288_length_1282_cov_37.786137	778	858	28	22	80	0.2750000
NODE_3288_length_1282_cov_37.786137	778	858	29	16	80	0.2000000
NODE_3288_length_1282_cov_37.786137	778	858	30	2	80	0.0250000
NODE_3288_length_1282_cov_37.786137	778	858	31	4	80	0.0500000
NODE_3288_length_1282_cov_37.786137	778	858	32	8	80	0.1000000
NODE_3288_length_1282_cov_37.786137	778	858	33	5	80	0.0625000
NODE_3288_length_1282_cov_37.786137	831	911	24	11	80	0.1375000
NODE_3288_length_1282_cov_37.786137	831	911	25	53	80	0.6625000
NODE_3288_length_1282_cov_37.786137	831	911	26	4	80	0.0500000
NODE_3288_length_1282_cov_37.786137	831	911	27	6	80	0.0750000
NODE_3288_length_1282_cov_37.786137	831	911	28	6	80	0.0750000
NODE_3289_length_1282_cov_25.900254	85	167	0	82	82	1.0000000
NODE_3289_length_1282_cov_25.900254	140	183	0	43	43	1.0000000
NODE_3289_length_1282_cov_25.900254	1006	1086	8	5	80	0.0625000
NODE_3289_length_1282_cov_25.900254	1006	1086	9	2	80	0.0250000
NODE_3289_length_1282_cov_25.900254	1006	1086	10	16	80	0.2000000
NODE_3289_length_1282_cov_25.900254	1006	1086	12	2	80	0.0250000
NODE_3289_length_1282_cov_25.900254	1006	1086	13	33	80	0.4125000
NODE_3289_length_1282_cov_25.900254	1006	1086	14	22	80	0.2750000
NODE_3289_length_1282_cov_25.900254	1006	1086	8	5	80	0.0625000
NODE_3289_length_1282_cov_25.900254	1006	1086	9	2	80	0.0250000
NODE_3289_length_1282_cov_25.900254	1006	1086	10	16	80	0.2000000
NODE_3289_length_1282_cov_25.900254	1006	1086	12	2	80	0.0250000
NODE_3289_length_1282_cov_25.900254	1006	1086	13	33	80	0.4125000
NODE_3289_length_1282_cov_25.900254	1006	1086	14	22	80	0.2750000
NODE_3289_length_1282_cov_25.900254	1015	1086	9	2	71	0.0281690
NODE_3289_length_1282_cov_25.900254	1015	1086	10	16	71	0.2253521
NODE_3289_length_1282_cov_25.900254	1015	1086	12	2	71	0.0281690
NODE_3289_length_1282_cov_25.900254	1015	1086	13	29	71	0.4084507
NODE_3289_length_1282_cov_25.900254	1015	1086	14	22	71	0.3098592
NODE_3290_length_1282_cov_14.600169	429	477	0	48	48	1.0000000
NODE_3290_length_1282_cov_14.600169	708	788	4	80	80	1.0000000
NODE_3291_length_1282_cov_8.017751	343	420	5	48	77	0.6233766
NODE_3291_length_1282_cov_8.017751	343	420	6	29	77	0.3766234
NODE_3292_length_1282_cov_5.092984	239	319	3	8	80	0.1000000
NODE_3292_length_1282_cov_5.092984	239	319	5	41	80	0.5125000
NODE_3292_length_1282_cov_5.092984	239	319	7	6	80	0.0750000
NODE_3292_length_1282_cov_5.092984	239	319	8	21	80	0.2625000
NODE_3292_length_1282_cov_5.092984	239	319	9	4	80	0.0500000
NODE_3292_length_1282_cov_5.092984	292	372	6	39	80	0.4875000
NODE_3292_length_1282_cov_5.092984	292	372	7	15	80	0.1875000
NODE_3292_length_1282_cov_5.092984	292	372	8	22	80	0.2750000
NODE_3292_length_1282_cov_5.092984	292	372	9	4	80	0.0500000
NODE_3295_length_1281_cov_31.342640	470	550	0	80	80	1.0000000
NODE_3295_length_1281_cov_31.342640	523	603	0	80	80	1.0000000
NODE_3295_length_1281_cov_31.342640	599	679	0	80	80	1.0000000
NODE_3295_length_1281_cov_31.342640	652	732	0	80	80	1.0000000
NODE_3296_length_1281_cov_25.482234	474	554	29	18	80	0.2250000
NODE_3296_length_1281_cov_25.482234	474	554	30	2	80	0.0250000
NODE_3296_length_1281_cov_25.482234	474	554	31	11	80	0.1375000
NODE_3296_length_1281_cov_25.482234	474	554	32	15	80	0.1875000
NODE_3296_length_1281_cov_25.482234	474	554	33	17	80	0.2125000
NODE_3296_length_1281_cov_25.482234	474	554	34	17	80	0.2125000
NODE_3296_length_1281_cov_25.482234	527	607	16	1	80	0.0125000
NODE_3296_length_1281_cov_25.482234	527	607	18	2	80	0.0250000
NODE_3296_length_1281_cov_25.482234	527	607	21	1	80	0.0125000
NODE_3296_length_1281_cov_25.482234	527	607	23	15	80	0.1875000
NODE_3296_length_1281_cov_25.482234	527	607	25	10	80	0.1250000
NODE_3296_length_1281_cov_25.482234	527	607	26	3	80	0.0375000
NODE_3296_length_1281_cov_25.482234	527	607	27	5	80	0.0625000
NODE_3296_length_1281_cov_25.482234	527	607	28	7	80	0.0875000
NODE_3296_length_1281_cov_25.482234	527	607	29	24	80	0.3000000
NODE_3296_length_1281_cov_25.482234	527	607	30	1	80	0.0125000
NODE_3296_length_1281_cov_25.482234	527	607	31	2	80	0.0250000
NODE_3296_length_1281_cov_25.482234	527	607	32	1	80	0.0125000
NODE_3296_length_1281_cov_25.482234	527	607	33	4	80	0.0500000
NODE_3296_length_1281_cov_25.482234	527	607	34	4	80	0.0500000
NODE_3297_length_1281_cov_14.617597	809	887	3	2	78	0.0256410
NODE_3297_length_1281_cov_14.617597	809	887	4	54	78	0.6923077
NODE_3297_length_1281_cov_14.617597	809	887	6	1	78	0.0128205
NODE_3297_length_1281_cov_14.617597	809	887	7	21	78	0.2692308
NODE_3297_length_1281_cov_14.617597	860	940	0	10	80	0.1250000
NODE_3297_length_1281_cov_14.617597	860	940	1	27	80	0.3375000
NODE_3297_length_1281_cov_14.617597	860	940	3	18	80	0.2250000
NODE_3297_length_1281_cov_14.617597	860	940	4	25	80	0.3125000
NODE_3298_length_1281_cov_12.065144	655	735	2	20	80	0.2500000
NODE_3298_length_1281_cov_12.065144	655	735	3	7	80	0.0875000
NODE_3298_length_1281_cov_12.065144	655	735	4	2	80	0.0250000
NODE_3298_length_1281_cov_12.065144	655	735	6	5	80	0.0625000
NODE_3298_length_1281_cov_12.065144	655	735	7	46	80	0.5750000
NODE_3298_length_1281_cov_12.065144	708	788	6	19	80	0.2375000
NODE_3298_length_1281_cov_12.065144	708	788	7	61	80	0.7625000
NODE_3299_length_1281_cov_9.235195	408	488	3	65	80	0.8125000
NODE_3299_length_1281_cov_9.235195	408	488	4	15	80	0.1875000
NODE_3299_length_1281_cov_9.235195	461	541	2	22	80	0.2750000
NODE_3299_length_1281_cov_9.235195	461	541	3	40	80	0.5000000
NODE_3299_length_1281_cov_9.235195	461	541	4	18	80	0.2250000
NODE_3300_length_1281_cov_7.153976	469	549	8	12	80	0.1500000
NODE_3300_length_1281_cov_7.153976	469	549	9	53	80	0.6625000
NODE_3300_length_1281_cov_7.153976	469	549	10	2	80	0.0250000
NODE_3300_length_1281_cov_7.153976	469	549	11	13	80	0.1625000
NODE_3300_length_1281_cov_7.153976	522	602	4	4	80	0.0500000
NODE_3300_length_1281_cov_7.153976	522	602	6	3	80	0.0375000
NODE_3300_length_1281_cov_7.153976	522	602	7	28	80	0.3500000
NODE_3300_length_1281_cov_7.153976	522	602	8	30	80	0.3750000
NODE_3300_length_1281_cov_7.153976	522	602	9	15	80	0.1875000
NODE_3307_length_1280_cov_24.231160	418	498	3	67	80	0.8375000
NODE_3307_length_1280_cov_24.231160	418	498	6	13	80	0.1625000
NODE_3307_length_1280_cov_24.231160	471	551	3	14	80	0.1750000
NODE_3307_length_1280_cov_24.231160	471	551	6	66	80	0.8250000
NODE_3307_length_1280_cov_24.231160	547	627	3	21	80	0.2625000
NODE_3307_length_1280_cov_24.231160	547	627	4	1	80	0.0125000
NODE_3307_length_1280_cov_24.231160	547	627	5	2	80	0.0250000
NODE_3307_length_1280_cov_24.231160	547	627	6	35	80	0.4375000
NODE_3307_length_1280_cov_24.231160	547	627	7	21	80	0.2625000
NODE_3307_length_1280_cov_24.231160	600	680	6	39	80	0.4875000
NODE_3307_length_1280_cov_24.231160	600	680	7	32	80	0.4000000
NODE_3307_length_1280_cov_24.231160	600	680	8	2	80	0.0250000
NODE_3307_length_1280_cov_24.231160	600	680	9	7	80	0.0875000
NODE_3308_length_1280_cov_5.908552	1077	1138	0	32	61	0.5245901
NODE_3308_length_1280_cov_5.908552	1077	1138	1	29	61	0.4754098
NODE_3311_length_1279_cov_16.840678	749	829	1	5	80	0.0625000
NODE_3311_length_1279_cov_16.840678	749	829	2	4	80	0.0500000
NODE_3311_length_1279_cov_16.840678	749	829	3	6	80	0.0750000
NODE_3311_length_1279_cov_16.840678	749	829	4	25	80	0.3125000
NODE_3311_length_1279_cov_16.840678	749	829	5	10	80	0.1250000
NODE_3311_length_1279_cov_16.840678	749	829	6	2	80	0.0250000
NODE_3311_length_1279_cov_16.840678	749	829	7	23	80	0.2875000
NODE_3311_length_1279_cov_16.840678	749	829	9	5	80	0.0625000
NODE_3311_length_1279_cov_16.840678	802	882	7	22	80	0.2750000
NODE_3311_length_1279_cov_16.840678	802	882	8	9	80	0.1125000
NODE_3311_length_1279_cov_16.840678	802	882	9	49	80	0.6125000
NODE_3312_length_1279_cov_3.772881	951	981	2	30	30	1.0000000
NODE_3317_length_1278_cov_45.991518	411	491	6	25	80	0.3125000
NODE_3317_length_1278_cov_45.991518	411	491	7	8	80	0.1000000
NODE_3317_length_1278_cov_45.991518	411	491	8	39	80	0.4875000
NODE_3317_length_1278_cov_45.991518	411	491	9	8	80	0.1000000
NODE_3317_length_1278_cov_45.991518	464	530	5	11	66	0.1666667
NODE_3317_length_1278_cov_45.991518	464	530	6	13	66	0.1969697
NODE_3317_length_1278_cov_45.991518	464	530	7	19	66	0.2878788
NODE_3317_length_1278_cov_45.991518	464	530	8	23	66	0.3484848
NODE_3318_length_1278_cov_37.164546	447	527	4	4	80	0.0500000
NODE_3318_length_1278_cov_37.164546	447	527	6	12	80	0.1500000
NODE_3318_length_1278_cov_37.164546	447	527	9	11	80	0.1375000
NODE_3318_length_1278_cov_37.164546	447	527	10	11	80	0.1375000
NODE_3318_length_1278_cov_37.164546	447	527	11	14	80	0.1750000
NODE_3318_length_1278_cov_37.164546	447	527	12	2	80	0.0250000
NODE_3318_length_1278_cov_37.164546	447	527	13	13	80	0.1625000
NODE_3318_length_1278_cov_37.164546	447	527	14	6	80	0.0750000
NODE_3318_length_1278_cov_37.164546	447	527	16	6	80	0.0750000
NODE_3318_length_1278_cov_37.164546	447	527	19	1	80	0.0125000
NODE_3318_length_1278_cov_37.164546	500	580	12	1	80	0.0125000
NODE_3318_length_1278_cov_37.164546	500	580	13	13	80	0.1625000
NODE_3318_length_1278_cov_37.164546	500	580	14	6	80	0.0750000
NODE_3318_length_1278_cov_37.164546	500	580	16	6	80	0.0750000
NODE_3318_length_1278_cov_37.164546	500	580	18	13	80	0.1625000
NODE_3318_length_1278_cov_37.164546	500	580	19	34	80	0.4250000
NODE_3318_length_1278_cov_37.164546	500	580	22	7	80	0.0875000
NODE_3318_length_1278_cov_37.164546	576	656	13	6	80	0.0750000
NODE_3318_length_1278_cov_37.164546	576	656	15	2	80	0.0250000
NODE_3318_length_1278_cov_37.164546	576	656	16	13	80	0.1625000
NODE_3318_length_1278_cov_37.164546	576	656	17	16	80	0.2000000
NODE_3318_length_1278_cov_37.164546	576	656	19	6	80	0.0750000
NODE_3318_length_1278_cov_37.164546	576	656	20	12	80	0.1500000
NODE_3318_length_1278_cov_37.164546	576	656	21	14	80	0.1750000
NODE_3318_length_1278_cov_37.164546	576	656	22	11	80	0.1375000
NODE_3318_length_1278_cov_37.164546	629	709	6	7	80	0.0875000
NODE_3318_length_1278_cov_37.164546	629	709	7	26	80	0.3250000
NODE_3318_length_1278_cov_37.164546	629	709	10	12	80	0.1500000
NODE_3318_length_1278_cov_37.164546	629	709	11	8	80	0.1000000
NODE_3318_length_1278_cov_37.164546	629	709	13	6	80	0.0750000
NODE_3318_length_1278_cov_37.164546	629	709	15	2	80	0.0250000
NODE_3318_length_1278_cov_37.164546	629	709	16	13	80	0.1625000
NODE_3318_length_1278_cov_37.164546	629	709	17	6	80	0.0750000
NODE_3319_length_1278_cov_12.505513	522	602	10	10	80	0.1250000
NODE_3319_length_1278_cov_12.505513	522	602	11	9	80	0.1125000
NODE_3319_length_1278_cov_12.505513	522	602	12	22	80	0.2750000
NODE_3319_length_1278_cov_12.505513	522	602	13	4	80	0.0500000
NODE_3319_length_1278_cov_12.505513	522	602	15	9	80	0.1125000
NODE_3319_length_1278_cov_12.505513	522	602	16	2	80	0.0250000
NODE_3319_length_1278_cov_12.505513	522	602	18	15	80	0.1875000
NODE_3319_length_1278_cov_12.505513	522	602	19	9	80	0.1125000
NODE_3319_length_1278_cov_12.505513	575	655	12	15	80	0.1875000
NODE_3319_length_1278_cov_12.505513	575	655	13	13	80	0.1625000
NODE_3319_length_1278_cov_12.505513	575	655	14	12	80	0.1500000
NODE_3319_length_1278_cov_12.505513	575	655	15	3	80	0.0375000
NODE_3319_length_1278_cov_12.505513	575	655	16	3	80	0.0375000
NODE_3319_length_1278_cov_12.505513	575	655	17	2	80	0.0250000
NODE_3319_length_1278_cov_12.505513	575	655	18	15	80	0.1875000
NODE_3319_length_1278_cov_12.505513	575	655	19	17	80	0.2125000
NODE_3320_length_1278_cov_12.171332	212	292	2	67	80	0.8375000
NODE_3320_length_1278_cov_12.171332	212	292	3	3	80	0.0375000
NODE_3320_length_1278_cov_12.171332	212	292	4	10	80	0.1250000
NODE_3320_length_1278_cov_12.171332	265	344	2	24	79	0.3037975
NODE_3320_length_1278_cov_12.171332	265	344	3	3	79	0.0379747
NODE_3320_length_1278_cov_12.171332	265	344	4	52	79	0.6582279
NODE_3329_length_1277_cov_21.407470	667	717	2	50	50	1.0000000
NODE_3329_length_1277_cov_21.407470	690	770	0	5	80	0.0625000
NODE_3329_length_1277_cov_21.407470	690	770	1	35	80	0.4375000
NODE_3329_length_1277_cov_21.407470	690	770	2	40	80	0.5000000
NODE_3330_length_1277_cov_18.111205	834	914	4	1	80	0.0125000
NODE_3330_length_1277_cov_18.111205	834	914	5	79	80	0.9875000
NODE_3330_length_1277_cov_18.111205	887	967	1	9	80	0.1125000
NODE_3330_length_1277_cov_18.111205	887	967	2	36	80	0.4500000
NODE_3330_length_1277_cov_18.111205	887	967	3	6	80	0.0750000
NODE_3330_length_1277_cov_18.111205	887	967	4	3	80	0.0375000
NODE_3330_length_1277_cov_18.111205	887	967	5	26	80	0.3250000
NODE_3331_length_1277_cov_12.449066	276	356	1	42	80	0.5250000
NODE_3331_length_1277_cov_12.449066	276	356	3	38	80	0.4750000
NODE_3331_length_1277_cov_12.449066	329	409	2	12	80	0.1500000
NODE_3331_length_1277_cov_12.449066	329	409	3	37	80	0.4625000
NODE_3331_length_1277_cov_12.449066	329	409	4	3	80	0.0375000
NODE_3331_length_1277_cov_12.449066	329	409	5	28	80	0.3500000
NODE_3331_length_1277_cov_12.449066	405	485	5	10	80	0.1250000
NODE_3331_length_1277_cov_12.449066	405	485	8	17	80	0.2125000
NODE_3331_length_1277_cov_12.449066	405	485	9	40	80	0.5000000
NODE_3331_length_1277_cov_12.449066	405	485	10	13	80	0.1625000
NODE_3331_length_1277_cov_12.449066	458	538	8	20	80	0.2500000
NODE_3331_length_1277_cov_12.449066	458	538	9	41	80	0.5125000
NODE_3331_length_1277_cov_12.449066	458	538	10	13	80	0.1625000
NODE_3331_length_1277_cov_12.449066	458	538	12	6	80	0.0750000
NODE_3337_length_1276_cov_21.446899	526	606	1	48	80	0.6000000
NODE_3337_length_1276_cov_21.446899	526	606	2	1	80	0.0125000
NODE_3337_length_1276_cov_21.446899	526	606	3	31	80	0.3875000
NODE_3337_length_1276_cov_21.446899	579	659	3	38	80	0.4750000
NODE_3337_length_1276_cov_21.446899	579	659	5	12	80	0.1500000
NODE_3337_length_1276_cov_21.446899	579	659	7	16	80	0.2000000
NODE_3337_length_1276_cov_21.446899	579	659	8	13	80	0.1625000
NODE_3337_length_1276_cov_21.446899	579	659	9	1	80	0.0125000
NODE_3337_length_1276_cov_21.446899	655	735	8	3	80	0.0375000
NODE_3337_length_1276_cov_21.446899	655	735	9	10	80	0.1250000
NODE_3337_length_1276_cov_21.446899	655	735	10	16	80	0.2000000
NODE_3337_length_1276_cov_21.446899	655	735	11	5	80	0.0625000
NODE_3337_length_1276_cov_21.446899	655	735	12	46	80	0.5750000
NODE_3337_length_1276_cov_21.446899	708	788	7	9	80	0.1125000
NODE_3337_length_1276_cov_21.446899	708	788	9	17	80	0.2125000
NODE_3337_length_1276_cov_21.446899	708	788	10	7	80	0.0875000
NODE_3337_length_1276_cov_21.446899	708	788	11	31	80	0.3875000
NODE_3337_length_1276_cov_21.446899	708	788	12	16	80	0.2000000
NODE_3346_length_1275_cov_35.471939	632	712	7	13	80	0.1625000
NODE_3346_length_1275_cov_35.471939	632	712	10	27	80	0.3375000
NODE_3346_length_1275_cov_35.471939	632	712	11	17	80	0.2125000
NODE_3346_length_1275_cov_35.471939	632	712	12	23	80	0.2875000
NODE_3346_length_1275_cov_35.471939	685	765	5	7	80	0.0875000
NODE_3346_length_1275_cov_35.471939	685	765	6	46	80	0.5750000
NODE_3346_length_1275_cov_35.471939	685	765	7	13	80	0.1625000
NODE_3346_length_1275_cov_35.471939	685	765	11	11	80	0.1375000
NODE_3346_length_1275_cov_35.471939	685	765	12	3	80	0.0375000
NODE_3347_length_1275_cov_19.910714	361	441	11	37	80	0.4625000
NODE_3347_length_1275_cov_19.910714	361	441	12	43	80	0.5375000
NODE_3347_length_1275_cov_19.910714	414	494	8	31	80	0.3875000
NODE_3347_length_1275_cov_19.910714	414	494	9	2	80	0.0250000
NODE_3347_length_1275_cov_19.910714	414	494	10	19	80	0.2375000
NODE_3347_length_1275_cov_19.910714	414	494	11	1	80	0.0125000
NODE_3347_length_1275_cov_19.910714	414	494	12	27	80	0.3375000
NODE_3347_length_1275_cov_19.910714	879	949	1	70	70	1.0000000
NODE_3351_length_1274_cov_23.404255	427	507	3	80	80	1.0000000
NODE_3351_length_1274_cov_23.404255	480	560	0	5	80	0.0625000
NODE_3351_length_1274_cov_23.404255	480	560	1	30	80	0.3750000
NODE_3351_length_1274_cov_23.404255	480	560	2	13	80	0.1625000
NODE_3351_length_1274_cov_23.404255	480	560	3	32	80	0.4000000
NODE_3351_length_1274_cov_23.404255	556	636	1	80	80	1.0000000
NODE_3351_length_1274_cov_23.404255	609	689	0	9	80	0.1125000
NODE_3351_length_1274_cov_23.404255	609	689	1	71	80	0.8875000
NODE_3352_length_1274_cov_20.178723	545	625	7	21	80	0.2625000
NODE_3352_length_1274_cov_20.178723	545	625	8	34	80	0.4250000
NODE_3352_length_1274_cov_20.178723	545	625	9	9	80	0.1125000
NODE_3352_length_1274_cov_20.178723	545	625	10	16	80	0.2000000
NODE_3352_length_1274_cov_20.178723	598	678	6	8	80	0.1000000
NODE_3352_length_1274_cov_20.178723	598	678	7	10	80	0.1250000
NODE_3352_length_1274_cov_20.178723	598	678	8	33	80	0.4125000
NODE_3352_length_1274_cov_20.178723	598	678	9	1	80	0.0125000
NODE_3352_length_1274_cov_20.178723	598	678	10	28	80	0.3500000
NODE_3354_length_1274_cov_2.019574	841	907	1	59	66	0.8939394
NODE_3354_length_1274_cov_2.019574	841	907	2	7	66	0.1060606
NODE_3354_length_1274_cov_2.019574	894	961	1	6	67	0.0895522
NODE_3354_length_1274_cov_2.019574	894	961	2	61	67	0.9104478
NODE_3361_length_1273_cov_42.349233	337	417	15	4	80	0.0500000
NODE_3361_length_1273_cov_42.349233	337	417	19	29	80	0.3625000
NODE_3361_length_1273_cov_42.349233	337	417	20	7	80	0.0875000
NODE_3361_length_1273_cov_42.349233	337	417	21	15	80	0.1875000
NODE_3361_length_1273_cov_42.349233	337	417	23	25	80	0.3125000
NODE_3361_length_1273_cov_42.349233	390	470	16	13	80	0.1625000
NODE_3361_length_1273_cov_42.349233	390	470	17	21	80	0.2625000
NODE_3361_length_1273_cov_42.349233	390	470	19	32	80	0.4000000
NODE_3361_length_1273_cov_42.349233	390	470	21	2	80	0.0250000
NODE_3361_length_1273_cov_42.349233	390	470	22	12	80	0.1500000
NODE_3361_length_1273_cov_42.349233	466	546	12	10	80	0.1250000
NODE_3361_length_1273_cov_42.349233	466	546	13	4	80	0.0500000
NODE_3361_length_1273_cov_42.349233	466	546	17	10	80	0.1250000
NODE_3361_length_1273_cov_42.349233	466	546	18	50	80	0.6250000
NODE_3361_length_1273_cov_42.349233	466	546	19	1	80	0.0125000
NODE_3361_length_1273_cov_42.349233	466	546	20	5	80	0.0625000
NODE_3361_length_1273_cov_42.349233	519	599	8	20	80	0.2500000
NODE_3361_length_1273_cov_42.349233	519	599	12	23	80	0.2875000
NODE_3361_length_1273_cov_42.349233	519	599	13	24	80	0.3000000
NODE_3361_length_1273_cov_42.349233	519	599	17	1	80	0.0125000
NODE_3361_length_1273_cov_42.349233	519	599	18	12	80	0.1500000
NODE_3364_length_1273_cov_4.404600	407	487	0	36	80	0.4500000
NODE_3364_length_1273_cov_4.404600	407	487	2	44	80	0.5500000
NODE_3364_length_1273_cov_4.404600	460	540	2	80	80	1.0000000
NODE_3368_length_1272_cov_28.887468	588	668	3	6	80	0.0750000
NODE_3368_length_1272_cov_28.887468	588	668	4	1	80	0.0125000
NODE_3368_length_1272_cov_28.887468	588	668	5	18	80	0.2250000
NODE_3368_length_1272_cov_28.887468	588	668	7	3	80	0.0375000
NODE_3368_length_1272_cov_28.887468	588	668	9	8	80	0.1000000
NODE_3368_length_1272_cov_28.887468	588	668	10	1	80	0.0125000
NODE_3368_length_1272_cov_28.887468	588	668	11	20	80	0.2500000
NODE_3368_length_1272_cov_28.887468	588	668	13	9	80	0.1125000
NODE_3368_length_1272_cov_28.887468	588	668	14	8	80	0.1000000
NODE_3368_length_1272_cov_28.887468	588	668	15	6	80	0.0750000
NODE_3368_length_1272_cov_28.887468	641	721	11	4	80	0.0500000
NODE_3368_length_1272_cov_28.887468	641	721	13	9	80	0.1125000
NODE_3368_length_1272_cov_28.887468	641	721	14	54	80	0.6750000
NODE_3368_length_1272_cov_28.887468	641	721	15	11	80	0.1375000
NODE_3368_length_1272_cov_28.887468	641	721	16	2	80	0.0250000
NODE_3369_length_1272_cov_11.290708	366	447	4	4	81	0.0493827
NODE_3369_length_1272_cov_11.290708	366	447	5	77	81	0.9506173
NODE_3375_length_1270_cov_13.617421	365	445	12	10	80	0.1250000
NODE_3375_length_1270_cov_13.617421	365	445	13	11	80	0.1375000
NODE_3375_length_1270_cov_13.617421	365	445	14	9	80	0.1125000
NODE_3375_length_1270_cov_13.617421	365	445	15	29	80	0.3625000
NODE_3375_length_1270_cov_13.617421	365	445	16	4	80	0.0500000
NODE_3375_length_1270_cov_13.617421	365	445	17	17	80	0.2125000
NODE_3375_length_1270_cov_13.617421	396	473	8	9	77	0.1168831
NODE_3375_length_1270_cov_13.617421	396	473	10	8	77	0.1038961
NODE_3375_length_1270_cov_13.617421	396	473	12	16	77	0.2077922
NODE_3375_length_1270_cov_13.617421	396	473	13	16	77	0.2077922
NODE_3375_length_1270_cov_13.617421	396	473	14	9	77	0.1168831
NODE_3375_length_1270_cov_13.617421	396	473	15	19	77	0.2467532
NODE_3375_length_1270_cov_13.617421	418	498	7	11	80	0.1375000
NODE_3375_length_1270_cov_13.617421	418	498	8	23	80	0.2875000
NODE_3375_length_1270_cov_13.617421	418	498	10	8	80	0.1000000
NODE_3375_length_1270_cov_13.617421	418	498	12	16	80	0.2000000
NODE_3375_length_1270_cov_13.617421	418	498	13	13	80	0.1625000
NODE_3375_length_1270_cov_13.617421	418	498	14	9	80	0.1125000
NODE_3375_length_1270_cov_13.617421	449	473	8	9	24	0.3750000
NODE_3375_length_1270_cov_13.617421	449	473	10	8	24	0.3333333
NODE_3375_length_1270_cov_13.617421	449	473	12	6	24	0.2500000
NODE_3375_length_1270_cov_13.617421	449	473	13	1	24	0.0416667
NODE_3375_length_1270_cov_13.617421	465	498	7	11	33	0.3333333
NODE_3375_length_1270_cov_13.617421	465	498	8	22	33	0.6666667
NODE_3376_length_1270_cov_11.645602	294	374	4	25	80	0.3125000
NODE_3376_length_1270_cov_11.645602	294	374	5	5	80	0.0625000
NODE_3376_length_1270_cov_11.645602	294	374	6	23	80	0.2875000
NODE_3376_length_1270_cov_11.645602	294	374	7	27	80	0.3375000
NODE_3376_length_1270_cov_11.645602	347	427	7	48	80	0.6000000
NODE_3376_length_1270_cov_11.645602	347	427	8	32	80	0.4000000
NODE_3377_length_1270_cov_2.495303	74	131	1	6	57	0.1052632
NODE_3377_length_1270_cov_2.495303	74	131	2	51	57	0.8947368
NODE_3378_length_1269_cov_55.070940	492	569	10	14	77	0.1818182
NODE_3378_length_1269_cov_55.070940	492	569	11	29	77	0.3766234
NODE_3378_length_1269_cov_55.070940	492	569	12	3	77	0.0389610
NODE_3378_length_1269_cov_55.070940	492	569	15	2	77	0.0259740
NODE_3378_length_1269_cov_55.070940	492	569	16	5	77	0.0649351
NODE_3378_length_1269_cov_55.070940	492	569	17	7	77	0.0909091
NODE_3378_length_1269_cov_55.070940	492	569	18	9	77	0.1168831
NODE_3378_length_1269_cov_55.070940	492	569	19	3	77	0.0389610
NODE_3378_length_1269_cov_55.070940	492	569	20	5	77	0.0649351
NODE_3378_length_1269_cov_55.070940	545	625	15	1	80	0.0125000
NODE_3378_length_1269_cov_55.070940	545	625	16	4	80	0.0500000
NODE_3378_length_1269_cov_55.070940	545	625	17	24	80	0.3000000
NODE_3378_length_1269_cov_55.070940	545	625	18	26	80	0.3250000
NODE_3378_length_1269_cov_55.070940	545	625	19	13	80	0.1625000
NODE_3378_length_1269_cov_55.070940	545	625	20	12	80	0.1500000
NODE_3378_length_1269_cov_55.070940	621	701	7	5	80	0.0625000
NODE_3378_length_1269_cov_55.070940	621	701	8	1	80	0.0125000
NODE_3378_length_1269_cov_55.070940	621	701	10	6	80	0.0750000
NODE_3378_length_1269_cov_55.070940	621	701	11	1	80	0.0125000
NODE_3378_length_1269_cov_55.070940	621	701	13	1	80	0.0125000
NODE_3378_length_1269_cov_55.070940	621	701	14	1	80	0.0125000
NODE_3378_length_1269_cov_55.070940	621	701	15	29	80	0.3625000
NODE_3378_length_1269_cov_55.070940	621	701	16	21	80	0.2625000
NODE_3378_length_1269_cov_55.070940	621	701	17	15	80	0.1875000
NODE_3378_length_1269_cov_55.070940	674	754	2	8	80	0.1000000
NODE_3378_length_1269_cov_55.070940	674	754	3	15	80	0.1875000
NODE_3378_length_1269_cov_55.070940	674	754	4	16	80	0.2000000
NODE_3378_length_1269_cov_55.070940	674	754	5	3	80	0.0375000
NODE_3378_length_1269_cov_55.070940	674	754	6	9	80	0.1125000
NODE_3378_length_1269_cov_55.070940	674	754	7	7	80	0.0875000
NODE_3378_length_1269_cov_55.070940	674	754	8	1	80	0.0125000
NODE_3378_length_1269_cov_55.070940	674	754	10	6	80	0.0750000
NODE_3378_length_1269_cov_55.070940	674	754	11	1	80	0.0125000
NODE_3378_length_1269_cov_55.070940	674	754	13	1	80	0.0125000
NODE_3378_length_1269_cov_55.070940	674	754	14	1	80	0.0125000
NODE_3378_length_1269_cov_55.070940	674	754	15	12	80	0.1500000
NODE_3379_length_1269_cov_22.154701	1152	1216	0	64	64	1.0000000
NODE_3379_length_1269_cov_22.154701	1152	1216	0	64	64	1.0000000
NODE_3379_length_1269_cov_22.154701	1152	1216	0	64	64	1.0000000
NODE_3379_length_1269_cov_22.154701	1189	1269	0	80	80	1.0000000
NODE_3379_length_1269_cov_22.154701	1189	1269	0	80	80	1.0000000
NODE_3380_length_1269_cov_18.753846	317	398	2	41	81	0.5061728
NODE_3380_length_1269_cov_18.753846	317	398	4	3	81	0.0370370
NODE_3380_length_1269_cov_18.753846	317	398	5	37	81	0.4567901
NODE_3381_length_1269_cov_12.637607	580	660	0	80	80	1.0000000
NODE_3381_length_1269_cov_12.637607	633	713	0	80	80	1.0000000
NODE_3381_length_1269_cov_12.637607	709	729	0	20	20	1.0000000
NODE_3381_length_1269_cov_12.637607	709	789	0	34	80	0.4250000
NODE_3381_length_1269_cov_12.637607	709	789	1	30	80	0.3750000
NODE_3381_length_1269_cov_12.637607	709	789	2	16	80	0.2000000
NODE_3381_length_1269_cov_12.637607	762	842	1	11	80	0.1375000
NODE_3381_length_1269_cov_12.637607	762	842	2	69	80	0.8625000
NODE_3382_length_1269_cov_10.552137	765	845	4	3	80	0.0375000
NODE_3382_length_1269_cov_10.552137	765	845	5	28	80	0.3500000
NODE_3382_length_1269_cov_10.552137	765	845	6	49	80	0.6125000
NODE_3382_length_1269_cov_10.552137	818	898	4	3	80	0.0375000
NODE_3382_length_1269_cov_10.552137	818	898	5	28	80	0.3500000
NODE_3382_length_1269_cov_10.552137	818	898	6	39	80	0.4875000
NODE_3382_length_1269_cov_10.552137	818	898	7	10	80	0.1250000
NODE_3391_length_1268_cov_12.862275	300	350	0	3	50	0.0600000
NODE_3391_length_1268_cov_12.862275	300	350	1	3	50	0.0600000
NODE_3391_length_1268_cov_12.862275	300	350	2	13	50	0.2600000
NODE_3391_length_1268_cov_12.862275	300	350	4	1	50	0.0200000
NODE_3391_length_1268_cov_12.862275	300	350	5	9	50	0.1800000
NODE_3391_length_1268_cov_12.862275	300	350	6	17	50	0.3400000
NODE_3391_length_1268_cov_12.862275	300	350	7	4	50	0.0800000
NODE_3392_length_1268_cov_9.523524	265	345	5	10	80	0.1250000
NODE_3392_length_1268_cov_9.523524	265	345	6	30	80	0.3750000
NODE_3392_length_1268_cov_9.523524	265	345	7	40	80	0.5000000
NODE_3392_length_1268_cov_9.523524	318	398	2	21	80	0.2625000
NODE_3392_length_1268_cov_9.523524	318	398	5	42	80	0.5250000
NODE_3392_length_1268_cov_9.523524	318	398	6	17	80	0.2125000
NODE_3393_length_1267_cov_21.315068	299	379	10	30	80	0.3750000
NODE_3393_length_1267_cov_21.315068	299	379	11	18	80	0.2250000
NODE_3393_length_1267_cov_21.315068	299	379	12	22	80	0.2750000
NODE_3393_length_1267_cov_21.315068	299	379	13	10	80	0.1250000
NODE_3393_length_1267_cov_21.315068	352	432	4	20	80	0.2500000
NODE_3393_length_1267_cov_21.315068	352	432	5	24	80	0.3000000
NODE_3393_length_1267_cov_21.315068	352	432	9	1	80	0.0125000
NODE_3393_length_1267_cov_21.315068	352	432	11	1	80	0.0125000
NODE_3393_length_1267_cov_21.315068	352	432	12	25	80	0.3125000
NODE_3393_length_1267_cov_21.315068	352	432	13	9	80	0.1125000
NODE_3393_length_1267_cov_21.315068	698	778	2	44	80	0.5500000
NODE_3393_length_1267_cov_21.315068	698	778	3	36	80	0.4500000
NODE_3393_length_1267_cov_21.315068	751	831	3	80	80	1.0000000
NODE_3394_length_1267_cov_14.880137	606	686	5	5	80	0.0625000
NODE_3394_length_1267_cov_14.880137	606	686	6	4	80	0.0500000
NODE_3394_length_1267_cov_14.880137	606	686	7	2	80	0.0250000
NODE_3394_length_1267_cov_14.880137	606	686	8	23	80	0.2875000
NODE_3394_length_1267_cov_14.880137	606	686	9	17	80	0.2125000
NODE_3394_length_1267_cov_14.880137	606	686	10	23	80	0.2875000
NODE_3394_length_1267_cov_14.880137	606	686	11	6	80	0.0750000
NODE_3394_length_1267_cov_14.880137	659	739	9	21	80	0.2625000
NODE_3394_length_1267_cov_14.880137	659	739	10	36	80	0.4500000
NODE_3394_length_1267_cov_14.880137	659	739	11	23	80	0.2875000
NODE_3397_length_1266_cov_20.584404	357	437	5	20	80	0.2500000
NODE_3397_length_1266_cov_20.584404	357	437	6	18	80	0.2250000
NODE_3397_length_1266_cov_20.584404	357	437	7	17	80	0.2125000
NODE_3397_length_1266_cov_20.584404	357	437	8	25	80	0.3125000
NODE_3397_length_1266_cov_20.584404	410	490	1	5	80	0.0625000
NODE_3397_length_1266_cov_20.584404	410	490	2	12	80	0.1500000
NODE_3397_length_1266_cov_20.584404	410	490	3	11	80	0.1375000
NODE_3397_length_1266_cov_20.584404	410	490	4	10	80	0.1250000
NODE_3397_length_1266_cov_20.584404	410	490	5	35	80	0.4375000
NODE_3397_length_1266_cov_20.584404	410	490	6	7	80	0.0875000
NODE_3398_length_1266_cov_16.571551	359	435	16	5	76	0.0657895
NODE_3398_length_1266_cov_16.571551	359	435	17	6	76	0.0789474
NODE_3398_length_1266_cov_16.571551	359	435	19	3	76	0.0394737
NODE_3398_length_1266_cov_16.571551	359	435	20	15	76	0.1973684
NODE_3398_length_1266_cov_16.571551	359	435	22	14	76	0.1842105
NODE_3398_length_1266_cov_16.571551	359	435	26	1	76	0.0131579
NODE_3398_length_1266_cov_16.571551	359	435	28	11	76	0.1447368
NODE_3398_length_1266_cov_16.571551	359	435	29	5	76	0.0657895
NODE_3398_length_1266_cov_16.571551	359	435	30	9	76	0.1184211
NODE_3398_length_1266_cov_16.571551	359	435	31	4	76	0.0526316
NODE_3398_length_1266_cov_16.571551	359	435	33	3	76	0.0394737
NODE_3398_length_1266_cov_16.571551	408	488	28	6	80	0.0750000
NODE_3398_length_1266_cov_16.571551	408	488	29	11	80	0.1375000
NODE_3398_length_1266_cov_16.571551	408	488	30	10	80	0.1250000
NODE_3398_length_1266_cov_16.571551	408	488	31	7	80	0.0875000
NODE_3398_length_1266_cov_16.571551	408	488	32	16	80	0.2000000
NODE_3398_length_1266_cov_16.571551	408	488	33	30	80	0.3750000
NODE_3399_length_1266_cov_14.218509	517	595	15	8	78	0.1025641
NODE_3399_length_1266_cov_14.218509	517	595	16	10	78	0.1282051
NODE_3399_length_1266_cov_14.218509	517	595	17	29	78	0.3717949
NODE_3399_length_1266_cov_14.218509	517	595	18	6	78	0.0769231
NODE_3399_length_1266_cov_14.218509	517	595	20	15	78	0.1923077
NODE_3399_length_1266_cov_14.218509	517	595	21	2	78	0.0256410
NODE_3399_length_1266_cov_14.218509	517	595	22	3	78	0.0384615
NODE_3399_length_1266_cov_14.218509	517	595	24	5	78	0.0641026
NODE_3399_length_1266_cov_14.218509	568	648	15	8	80	0.1000000
NODE_3399_length_1266_cov_14.218509	568	648	16	18	80	0.2250000
NODE_3399_length_1266_cov_14.218509	568	648	17	7	80	0.0875000
NODE_3399_length_1266_cov_14.218509	568	648	18	1	80	0.0125000
NODE_3399_length_1266_cov_14.218509	568	648	20	18	80	0.2250000
NODE_3399_length_1266_cov_14.218509	568	648	21	9	80	0.1125000
NODE_3399_length_1266_cov_14.218509	568	648	22	7	80	0.0875000
NODE_3399_length_1266_cov_14.218509	568	648	23	2	80	0.0250000
NODE_3399_length_1266_cov_14.218509	568	648	24	10	80	0.1250000
NODE_3399_length_1266_cov_14.218509	644	724	15	25	80	0.3125000
NODE_3399_length_1266_cov_14.218509	644	724	16	4	80	0.0500000
NODE_3399_length_1266_cov_14.218509	644	724	17	5	80	0.0625000
NODE_3399_length_1266_cov_14.218509	644	724	18	23	80	0.2875000
NODE_3399_length_1266_cov_14.218509	644	724	19	8	80	0.1000000
NODE_3399_length_1266_cov_14.218509	644	724	20	11	80	0.1375000
NODE_3399_length_1266_cov_14.218509	644	724	21	3	80	0.0375000
NODE_3399_length_1266_cov_14.218509	644	724	22	1	80	0.0125000
NODE_3399_length_1266_cov_14.218509	697	777	12	9	80	0.1125000
NODE_3399_length_1266_cov_14.218509	697	777	13	23	80	0.2875000
NODE_3399_length_1266_cov_14.218509	697	777	14	3	80	0.0375000
NODE_3399_length_1266_cov_14.218509	697	777	15	5	80	0.0625000
NODE_3399_length_1266_cov_14.218509	697	777	16	17	80	0.2125000
NODE_3399_length_1266_cov_14.218509	697	777	19	8	80	0.1000000
NODE_3399_length_1266_cov_14.218509	697	777	20	11	80	0.1375000
NODE_3399_length_1266_cov_14.218509	697	777	21	3	80	0.0375000
NODE_3399_length_1266_cov_14.218509	697	777	22	1	80	0.0125000
NODE_3403_length_1265_cov_9.807890	429	509	0	80	80	1.0000000
NODE_3403_length_1265_cov_9.807890	482	562	0	80	80	1.0000000
NODE_3404_length_1265_cov_8.233276	160	207	2	47	47	1.0000000
NODE_3404_length_1265_cov_8.233276	1004	1058	4	26	54	0.4814815
NODE_3404_length_1265_cov_8.233276	1004	1058	5	21	54	0.3888889
NODE_3404_length_1265_cov_8.233276	1004	1058	6	7	54	0.1296296
NODE_3406_length_1265_cov_3.941681	503	583	2	79	80	0.9875000
NODE_3406_length_1265_cov_3.941681	503	583	3	1	80	0.0125000
NODE_3406_length_1265_cov_3.941681	556	636	2	80	80	1.0000000
NODE_3408_length_1264_cov_8.024034	290	370	3	71	80	0.8875000
NODE_3408_length_1264_cov_8.024034	290	370	5	9	80	0.1125000
NODE_3408_length_1264_cov_8.024034	343	423	2	14	80	0.1750000
NODE_3408_length_1264_cov_8.024034	343	423	3	52	80	0.6500000
NODE_3408_length_1264_cov_8.024034	343	423	4	14	80	0.1750000
NODE_3413_length_1263_cov_8.566151	698	778	2	1	80	0.0125000
NODE_3413_length_1263_cov_8.566151	698	778	3	55	80	0.6875000
NODE_3413_length_1263_cov_8.566151	698	778	4	24	80	0.3000000
NODE_3413_length_1263_cov_8.566151	751	831	2	54	80	0.6750000
NODE_3413_length_1263_cov_8.566151	751	831	3	26	80	0.3250000
NODE_3413_length_1263_cov_8.566151	833	910	1	12	77	0.1558442
NODE_3413_length_1263_cov_8.566151	833	910	2	33	77	0.4285714
NODE_3413_length_1263_cov_8.566151	833	910	3	32	77	0.4155844
NODE_3413_length_1263_cov_8.566151	883	963	2	75	80	0.9375000
NODE_3413_length_1263_cov_8.566151	883	963	3	1	80	0.0125000
NODE_3413_length_1263_cov_8.566151	883	963	4	4	80	0.0500000
NODE_3414_length_1263_cov_7.376289	1060	1140	10	3	80	0.0375000
NODE_3414_length_1263_cov_7.376289	1060	1140	11	2	80	0.0250000
NODE_3414_length_1263_cov_7.376289	1060	1140	12	27	80	0.3375000
NODE_3414_length_1263_cov_7.376289	1060	1140	14	35	80	0.4375000
NODE_3414_length_1263_cov_7.376289	1060	1140	15	4	80	0.0500000
NODE_3414_length_1263_cov_7.376289	1060	1140	18	5	80	0.0625000
NODE_3414_length_1263_cov_7.376289	1060	1140	19	2	80	0.0250000
NODE_3414_length_1263_cov_7.376289	1060	1140	20	2	80	0.0250000
NODE_3414_length_1263_cov_7.376289	1113	1213	2	28	100	0.2800000
NODE_3414_length_1263_cov_7.376289	1113	1213	10	3	100	0.0300000
NODE_3414_length_1263_cov_7.376289	1113	1213	11	2	100	0.0200000
NODE_3414_length_1263_cov_7.376289	1113	1213	12	2	100	0.0200000
NODE_3414_length_1263_cov_7.376289	1113	1213	14	55	100	0.5500000
NODE_3414_length_1263_cov_7.376289	1113	1213	15	1	100	0.0100000
NODE_3414_length_1263_cov_7.376289	1113	1213	18	5	100	0.0500000
NODE_3414_length_1263_cov_7.376289	1113	1213	19	2	100	0.0200000
NODE_3414_length_1263_cov_7.376289	1113	1213	20	2	100	0.0200000
NODE_3416_length_1263_cov_1.827320	227	307	2	80	80	1.0000000
NODE_3416_length_1263_cov_1.827320	280	360	0	5	80	0.0625000
NODE_3416_length_1263_cov_1.827320	280	360	1	35	80	0.4375000
NODE_3416_length_1263_cov_1.827320	280	360	2	40	80	0.5000000
NODE_3418_length_1262_cov_17.416165	404	484	7	17	80	0.2125000
NODE_3418_length_1262_cov_17.416165	404	484	8	23	80	0.2875000
NODE_3418_length_1262_cov_17.416165	404	484	9	40	80	0.5000000
NODE_3418_length_1262_cov_17.416165	457	537	6	2	80	0.0250000
NODE_3418_length_1262_cov_17.416165	457	537	7	9	80	0.1125000
NODE_3418_length_1262_cov_17.416165	457	537	8	29	80	0.3625000
NODE_3418_length_1262_cov_17.416165	457	537	9	40	80	0.5000000
NODE_3419_length_1262_cov_15.268272	648	728	2	48	80	0.6000000
NODE_3419_length_1262_cov_15.268272	648	728	3	9	80	0.1125000
NODE_3419_length_1262_cov_15.268272	648	728	4	23	80	0.2875000
NODE_3419_length_1262_cov_15.268272	701	781	2	22	80	0.2750000
NODE_3419_length_1262_cov_15.268272	701	781	3	58	80	0.7250000
NODE_3419_length_1262_cov_15.268272	777	857	3	17	80	0.2125000
NODE_3419_length_1262_cov_15.268272	777	857	4	56	80	0.7000000
NODE_3419_length_1262_cov_15.268272	777	857	5	4	80	0.0500000
NODE_3419_length_1262_cov_15.268272	777	857	6	3	80	0.0375000
NODE_3419_length_1262_cov_15.268272	830	910	3	37	80	0.4625000
NODE_3419_length_1262_cov_15.268272	830	910	4	43	80	0.5375000
NODE_3424_length_1261_cov_1.777969	272	318	0	46	46	1.0000000
NODE_3425_length_1260_cov_55.640827	499	579	7	75	80	0.9375000
NODE_3425_length_1260_cov_55.640827	499	579	9	5	80	0.0625000
NODE_3425_length_1260_cov_55.640827	552	632	5	4	80	0.0500000
NODE_3425_length_1260_cov_55.640827	552	632	6	17	80	0.2125000
NODE_3425_length_1260_cov_55.640827	552	632	7	22	80	0.2750000
NODE_3425_length_1260_cov_55.640827	552	632	9	24	80	0.3000000
NODE_3425_length_1260_cov_55.640827	552	632	11	10	80	0.1250000
NODE_3425_length_1260_cov_55.640827	552	632	12	3	80	0.0375000
NODE_3425_length_1260_cov_55.640827	628	708	9	10	80	0.1250000
NODE_3425_length_1260_cov_55.640827	628	708	11	11	80	0.1375000
NODE_3425_length_1260_cov_55.640827	628	708	12	20	80	0.2500000
NODE_3425_length_1260_cov_55.640827	628	708	13	4	80	0.0500000
NODE_3425_length_1260_cov_55.640827	628	708	15	13	80	0.1625000
NODE_3425_length_1260_cov_55.640827	628	708	18	22	80	0.2750000
NODE_3425_length_1260_cov_55.640827	681	761	15	5	80	0.0625000
NODE_3425_length_1260_cov_55.640827	681	761	17	9	80	0.1125000
NODE_3425_length_1260_cov_55.640827	681	761	18	63	80	0.7875000
NODE_3425_length_1260_cov_55.640827	681	761	20	3	80	0.0375000
NODE_3426_length_1260_cov_12.242894	427	507	2	24	80	0.3000000
NODE_3426_length_1260_cov_12.242894	427	507	3	26	80	0.3250000
NODE_3426_length_1260_cov_12.242894	427	507	4	10	80	0.1250000
NODE_3426_length_1260_cov_12.242894	427	507	5	20	80	0.2500000
NODE_3426_length_1260_cov_12.242894	480	560	3	27	80	0.3375000
NODE_3426_length_1260_cov_12.242894	480	560	4	16	80	0.2000000
NODE_3426_length_1260_cov_12.242894	480	560	5	2	80	0.0250000
NODE_3426_length_1260_cov_12.242894	480	560	6	35	80	0.4375000
NODE_3436_length_1259_cov_15.381897	509	589	3	14	80	0.1750000
NODE_3436_length_1259_cov_15.381897	509	589	5	66	80	0.8250000
NODE_3436_length_1259_cov_15.381897	562	642	3	28	80	0.3500000
NODE_3436_length_1259_cov_15.381897	562	642	4	8	80	0.1000000
NODE_3436_length_1259_cov_15.381897	562	642	5	44	80	0.5500000
NODE_3439_length_1258_cov_33.519413	608	688	20	10	80	0.1250000
NODE_3439_length_1258_cov_33.519413	608	688	21	17	80	0.2125000
NODE_3439_length_1258_cov_33.519413	608	688	22	15	80	0.1875000
NODE_3439_length_1258_cov_33.519413	608	688	23	19	80	0.2375000
NODE_3439_length_1258_cov_33.519413	608	688	25	6	80	0.0750000
NODE_3439_length_1258_cov_33.519413	608	688	26	2	80	0.0250000
NODE_3439_length_1258_cov_33.519413	608	688	27	11	80	0.1375000
NODE_3439_length_1258_cov_33.519413	661	741	21	7	80	0.0875000
NODE_3439_length_1258_cov_33.519413	661	741	22	1	80	0.0125000
NODE_3439_length_1258_cov_33.519413	661	741	24	5	80	0.0625000
NODE_3439_length_1258_cov_33.519413	661	741	25	9	80	0.1125000
NODE_3439_length_1258_cov_33.519413	661	741	26	13	80	0.1625000
NODE_3439_length_1258_cov_33.519413	661	741	27	21	80	0.2625000
NODE_3439_length_1258_cov_33.519413	661	741	28	12	80	0.1500000
NODE_3439_length_1258_cov_33.519413	661	741	29	12	80	0.1500000
NODE_3440_length_1258_cov_22.569456	583	663	0	80	80	1.0000000
NODE_3440_length_1258_cov_22.569456	636	716	0	35	80	0.4375000
NODE_3440_length_1258_cov_22.569456	636	716	1	30	80	0.3750000
NODE_3440_length_1258_cov_22.569456	636	716	2	15	80	0.1875000
NODE_3441_length_1258_cov_18.747196	308	388	10	6	80	0.0750000
NODE_3441_length_1258_cov_18.747196	308	388	14	2	80	0.0250000
NODE_3441_length_1258_cov_18.747196	308	388	15	32	80	0.4000000
NODE_3441_length_1258_cov_18.747196	308	388	16	16	80	0.2000000
NODE_3441_length_1258_cov_18.747196	308	388	18	1	80	0.0125000
NODE_3441_length_1258_cov_18.747196	308	388	19	6	80	0.0750000
NODE_3441_length_1258_cov_18.747196	308	388	21	17	80	0.2125000
NODE_3441_length_1258_cov_18.747196	361	441	16	16	80	0.2000000
NODE_3441_length_1258_cov_18.747196	361	441	18	2	80	0.0250000
NODE_3441_length_1258_cov_18.747196	361	441	19	17	80	0.2125000
NODE_3441_length_1258_cov_18.747196	361	441	20	25	80	0.3125000
NODE_3441_length_1258_cov_18.747196	361	441	21	20	80	0.2500000
NODE_3441_length_1258_cov_18.747196	437	517	10	4	80	0.0500000
NODE_3441_length_1258_cov_18.747196	437	517	11	6	80	0.0750000
NODE_3441_length_1258_cov_18.747196	437	517	12	22	80	0.2750000
NODE_3441_length_1258_cov_18.747196	437	517	13	2	80	0.0250000
NODE_3441_length_1258_cov_18.747196	437	517	14	8	80	0.1000000
NODE_3441_length_1258_cov_18.747196	437	517	15	11	80	0.1375000
NODE_3441_length_1258_cov_18.747196	437	517	16	4	80	0.0500000
NODE_3441_length_1258_cov_18.747196	437	517	17	23	80	0.2875000
NODE_3441_length_1258_cov_18.747196	490	570	4	12	80	0.1500000
NODE_3441_length_1258_cov_18.747196	490	570	5	37	80	0.4625000
NODE_3441_length_1258_cov_18.747196	490	570	7	1	80	0.0125000
NODE_3441_length_1258_cov_18.747196	490	570	10	7	80	0.0875000
NODE_3441_length_1258_cov_18.747196	490	570	11	6	80	0.0750000
NODE_3441_length_1258_cov_18.747196	490	570	12	1	80	0.0125000
NODE_3441_length_1258_cov_18.747196	490	570	14	8	80	0.1000000
NODE_3441_length_1258_cov_18.747196	490	570	15	8	80	0.1000000
NODE_3442_length_1258_cov_13.699741	332	412	8	1	80	0.0125000
NODE_3442_length_1258_cov_13.699741	332	412	9	2	80	0.0250000
NODE_3442_length_1258_cov_13.699741	332	412	10	31	80	0.3875000
NODE_3442_length_1258_cov_13.699741	332	412	11	36	80	0.4500000
NODE_3442_length_1258_cov_13.699741	332	412	12	10	80	0.1250000
NODE_3442_length_1258_cov_13.699741	385	465	9	9	80	0.1125000
NODE_3442_length_1258_cov_13.699741	385	465	10	2	80	0.0250000
NODE_3442_length_1258_cov_13.699741	385	465	11	38	80	0.4750000
NODE_3442_length_1258_cov_13.699741	385	465	12	15	80	0.1875000
NODE_3442_length_1258_cov_13.699741	385	465	13	16	80	0.2000000
NODE_3447_length_1257_cov_34.029361	567	647	6	32	80	0.4000000
NODE_3447_length_1257_cov_34.029361	567	647	8	40	80	0.5000000
NODE_3447_length_1257_cov_34.029361	567	647	9	8	80	0.1000000
NODE_3447_length_1257_cov_34.029361	620	700	5	6	80	0.0750000
NODE_3447_length_1257_cov_34.029361	620	700	6	55	80	0.6875000
NODE_3447_length_1257_cov_34.029361	620	700	8	4	80	0.0500000
NODE_3447_length_1257_cov_34.029361	620	700	9	5	80	0.0625000
NODE_3447_length_1257_cov_34.029361	620	700	10	9	80	0.1125000
NODE_3447_length_1257_cov_34.029361	620	700	11	1	80	0.0125000
NODE_3447_length_1257_cov_34.029361	696	776	9	34	80	0.4250000
NODE_3447_length_1257_cov_34.029361	696	776	11	11	80	0.1375000
NODE_3447_length_1257_cov_34.029361	696	776	13	19	80	0.2375000
NODE_3447_length_1257_cov_34.029361	696	776	14	16	80	0.2000000
NODE_3447_length_1257_cov_34.029361	749	829	12	7	80	0.0875000
NODE_3447_length_1257_cov_34.029361	749	829	13	31	80	0.3875000
NODE_3447_length_1257_cov_34.029361	749	829	14	42	80	0.5250000
NODE_3449_length_1257_cov_7.892919	317	397	1	14	80	0.1750000
NODE_3449_length_1257_cov_7.892919	317	397	2	66	80	0.8250000
NODE_3449_length_1257_cov_7.892919	370	450	2	80	80	1.0000000
NODE_3452_length_1256_cov_50.506482	389	469	4	9	80	0.1125000
NODE_3452_length_1256_cov_50.506482	389	469	5	5	80	0.0625000
NODE_3452_length_1256_cov_50.506482	389	469	7	39	80	0.4875000
NODE_3452_length_1256_cov_50.506482	389	469	8	24	80	0.3000000
NODE_3452_length_1256_cov_50.506482	389	469	9	3	80	0.0375000
NODE_3452_length_1256_cov_50.506482	442	522	8	32	80	0.4000000
NODE_3452_length_1256_cov_50.506482	442	522	9	18	80	0.2250000
NODE_3452_length_1256_cov_50.506482	442	522	10	6	80	0.0750000
NODE_3452_length_1256_cov_50.506482	442	522	11	3	80	0.0375000
NODE_3452_length_1256_cov_50.506482	442	522	12	9	80	0.1125000
NODE_3452_length_1256_cov_50.506482	442	522	13	3	80	0.0375000
NODE_3452_length_1256_cov_50.506482	442	522	14	1	80	0.0125000
NODE_3452_length_1256_cov_50.506482	442	522	16	4	80	0.0500000
NODE_3452_length_1256_cov_50.506482	442	522	20	1	80	0.0125000
NODE_3452_length_1256_cov_50.506482	442	522	21	3	80	0.0375000
NODE_3452_length_1256_cov_50.506482	518	598	20	1	80	0.0125000
NODE_3452_length_1256_cov_50.506482	518	598	21	8	80	0.1000000
NODE_3452_length_1256_cov_50.506482	518	598	22	1	80	0.0125000
NODE_3452_length_1256_cov_50.506482	518	598	24	13	80	0.1625000
NODE_3452_length_1256_cov_50.506482	518	598	25	10	80	0.1250000
NODE_3452_length_1256_cov_50.506482	518	598	26	21	80	0.2625000
NODE_3452_length_1256_cov_50.506482	518	598	27	8	80	0.1000000
NODE_3452_length_1256_cov_50.506482	518	598	28	14	80	0.1750000
NODE_3452_length_1256_cov_50.506482	518	598	30	4	80	0.0500000
NODE_3452_length_1256_cov_50.506482	571	651	26	1	80	0.0125000
NODE_3452_length_1256_cov_50.506482	571	651	27	12	80	0.1500000
NODE_3452_length_1256_cov_50.506482	571	651	28	14	80	0.1750000
NODE_3452_length_1256_cov_50.506482	571	651	29	5	80	0.0625000
NODE_3452_length_1256_cov_50.506482	571	651	30	25	80	0.3125000
NODE_3452_length_1256_cov_50.506482	571	651	31	23	80	0.2875000
NODE_3453_length_1256_cov_25.944685	754	834	3	25	80	0.3125000
NODE_3453_length_1256_cov_25.944685	754	834	5	10	80	0.1250000
NODE_3453_length_1256_cov_25.944685	754	834	6	15	80	0.1875000
NODE_3453_length_1256_cov_25.944685	754	834	7	30	80	0.3750000
NODE_3453_length_1256_cov_25.944685	807	887	6	14	80	0.1750000
NODE_3453_length_1256_cov_25.944685	807	887	7	34	80	0.4250000
NODE_3453_length_1256_cov_25.944685	807	887	8	32	80	0.4000000
NODE_3455_length_1256_cov_21.720830	713	793	10	17	80	0.2125000
NODE_3455_length_1256_cov_21.720830	713	793	11	22	80	0.2750000
NODE_3455_length_1256_cov_21.720830	713	793	12	40	80	0.5000000
NODE_3455_length_1256_cov_21.720830	713	793	13	1	80	0.0125000
NODE_3455_length_1256_cov_21.720830	766	846	7	14	80	0.1750000
NODE_3455_length_1256_cov_21.720830	766	846	8	2	80	0.0250000
NODE_3455_length_1256_cov_21.720830	766	846	9	22	80	0.2750000
NODE_3455_length_1256_cov_21.720830	766	846	10	9	80	0.1125000
NODE_3455_length_1256_cov_21.720830	766	846	11	21	80	0.2625000
NODE_3455_length_1256_cov_21.720830	766	846	12	11	80	0.1375000
NODE_3455_length_1256_cov_21.720830	766	846	13	1	80	0.0125000
NODE_3456_length_1256_cov_14.242005	595	675	5	37	80	0.4625000
NODE_3456_length_1256_cov_14.242005	595	675	6	18	80	0.2250000
NODE_3456_length_1256_cov_14.242005	595	675	7	22	80	0.2750000
NODE_3456_length_1256_cov_14.242005	595	675	8	3	80	0.0375000
NODE_3456_length_1256_cov_14.242005	648	728	4	3	80	0.0375000
NODE_3456_length_1256_cov_14.242005	648	728	5	2	80	0.0250000
NODE_3456_length_1256_cov_14.242005	648	728	6	20	80	0.2500000
NODE_3456_length_1256_cov_14.242005	648	728	7	36	80	0.4500000
NODE_3456_length_1256_cov_14.242005	648	728	8	19	80	0.2375000
NODE_3457_length_1256_cov_5.870354	879	959	0	80	80	1.0000000
NODE_3463_length_1255_cov_37.271626	458	538	4	49	80	0.6125000
NODE_3463_length_1255_cov_37.271626	458	538	6	12	80	0.1500000
NODE_3463_length_1255_cov_37.271626	458	538	10	2	80	0.0250000
NODE_3463_length_1255_cov_37.271626	458	538	11	17	80	0.2125000
NODE_3463_length_1255_cov_37.271626	511	591	6	8	80	0.1000000
NODE_3463_length_1255_cov_37.271626	511	591	10	2	80	0.0250000
NODE_3463_length_1255_cov_37.271626	511	591	11	24	80	0.3000000
NODE_3463_length_1255_cov_37.271626	511	591	12	17	80	0.2125000
NODE_3463_length_1255_cov_37.271626	511	591	14	29	80	0.3625000
NODE_3463_length_1255_cov_37.271626	587	667	4	4	80	0.0500000
NODE_3463_length_1255_cov_37.271626	587	667	5	2	80	0.0250000
NODE_3463_length_1255_cov_37.271626	587	667	8	12	80	0.1500000
NODE_3463_length_1255_cov_37.271626	587	667	10	51	80	0.6375000
NODE_3463_length_1255_cov_37.271626	587	667	14	11	80	0.1375000
NODE_3463_length_1255_cov_37.271626	640	720	4	15	80	0.1875000
NODE_3463_length_1255_cov_37.271626	640	720	5	10	80	0.1250000
NODE_3463_length_1255_cov_37.271626	640	720	6	25	80	0.3125000
NODE_3463_length_1255_cov_37.271626	640	720	7	5	80	0.0625000
NODE_3463_length_1255_cov_37.271626	640	720	8	16	80	0.2000000
NODE_3463_length_1255_cov_37.271626	640	720	10	9	80	0.1125000
NODE_3464_length_1255_cov_21.374567	516	596	5	17	80	0.2125000
NODE_3464_length_1255_cov_21.374567	516	596	6	4	80	0.0500000
NODE_3464_length_1255_cov_21.374567	516	596	7	34	80	0.4250000
NODE_3464_length_1255_cov_21.374567	516	596	8	25	80	0.3125000
NODE_3464_length_1255_cov_21.374567	569	649	4	1	80	0.0125000
NODE_3464_length_1255_cov_21.374567	569	649	5	1	80	0.0125000
NODE_3464_length_1255_cov_21.374567	569	649	7	2	80	0.0250000
NODE_3464_length_1255_cov_21.374567	569	649	8	53	80	0.6625000
NODE_3464_length_1255_cov_21.374567	569	649	11	13	80	0.1625000
NODE_3464_length_1255_cov_21.374567	569	649	12	10	80	0.1250000
NODE_3464_length_1255_cov_21.374567	645	725	11	47	80	0.5875000
NODE_3464_length_1255_cov_21.374567	645	725	12	30	80	0.3750000
NODE_3464_length_1255_cov_21.374567	645	725	13	3	80	0.0375000
NODE_3464_length_1255_cov_21.374567	698	778	3	2	80	0.0250000
NODE_3464_length_1255_cov_21.374567	698	778	9	1	80	0.0125000
NODE_3464_length_1255_cov_21.374567	698	778	11	54	80	0.6750000
NODE_3464_length_1255_cov_21.374567	698	778	12	23	80	0.2875000
NODE_3465_length_1255_cov_18.391869	521	601	12	35	80	0.4375000
NODE_3465_length_1255_cov_18.391869	521	601	14	10	80	0.1250000
NODE_3465_length_1255_cov_18.391869	521	601	15	35	80	0.4375000
NODE_3465_length_1255_cov_18.391869	574	654	13	11	80	0.1375000
NODE_3465_length_1255_cov_18.391869	574	654	14	17	80	0.2125000
NODE_3465_length_1255_cov_18.391869	574	654	15	50	80	0.6250000
NODE_3465_length_1255_cov_18.391869	574	654	16	2	80	0.0250000
NODE_3466_length_1255_cov_4.096021	1194	1242	0	48	48	1.0000000
NODE_3469_length_1254_cov_32.470996	612	692	14	4	80	0.0500000
NODE_3469_length_1254_cov_32.470996	612	692	19	1	80	0.0125000
NODE_3469_length_1254_cov_32.470996	612	692	20	5	80	0.0625000
NODE_3469_length_1254_cov_32.470996	612	692	21	5	80	0.0625000
NODE_3469_length_1254_cov_32.470996	612	692	22	17	80	0.2125000
NODE_3469_length_1254_cov_32.470996	612	692	23	8	80	0.1000000
NODE_3469_length_1254_cov_32.470996	612	692	24	15	80	0.1875000
NODE_3469_length_1254_cov_32.470996	612	692	25	25	80	0.3125000
NODE_3469_length_1254_cov_32.470996	665	745	8	1	80	0.0125000
NODE_3469_length_1254_cov_32.470996	665	745	9	6	80	0.0750000
NODE_3469_length_1254_cov_32.470996	665	745	12	15	80	0.1875000
NODE_3469_length_1254_cov_32.470996	665	745	13	8	80	0.1000000
NODE_3469_length_1254_cov_32.470996	665	745	14	26	80	0.3250000
NODE_3469_length_1254_cov_32.470996	665	745	15	1	80	0.0125000
NODE_3469_length_1254_cov_32.470996	665	745	19	1	80	0.0125000
NODE_3469_length_1254_cov_32.470996	665	745	20	5	80	0.0625000
NODE_3469_length_1254_cov_32.470996	665	745	21	5	80	0.0625000
NODE_3469_length_1254_cov_32.470996	665	745	23	3	80	0.0375000
NODE_3469_length_1254_cov_32.470996	665	745	25	9	80	0.1125000
NODE_3470_length_1254_cov_26.449351	488	568	11	5	80	0.0625000
NODE_3470_length_1254_cov_26.449351	488	568	12	1	80	0.0125000
NODE_3470_length_1254_cov_26.449351	488	568	13	6	80	0.0750000
NODE_3470_length_1254_cov_26.449351	488	568	14	6	80	0.0750000
NODE_3470_length_1254_cov_26.449351	488	568	15	3	80	0.0375000
NODE_3470_length_1254_cov_26.449351	488	568	16	59	80	0.7375000
NODE_3470_length_1254_cov_26.449351	541	621	4	21	80	0.2625000
NODE_3470_length_1254_cov_26.449351	541	621	6	14	80	0.1750000
NODE_3470_length_1254_cov_26.449351	541	621	8	8	80	0.1000000
NODE_3470_length_1254_cov_26.449351	541	621	9	2	80	0.0250000
NODE_3470_length_1254_cov_26.449351	541	621	11	13	80	0.1625000
NODE_3470_length_1254_cov_26.449351	541	621	15	3	80	0.0375000
NODE_3470_length_1254_cov_26.449351	541	621	16	19	80	0.2375000
NODE_3471_length_1254_cov_22.032035	531	611	20	7	80	0.0875000
NODE_3471_length_1254_cov_22.032035	531	611	23	2	80	0.0250000
NODE_3471_length_1254_cov_22.032035	531	611	25	12	80	0.1500000
NODE_3471_length_1254_cov_22.032035	531	611	26	12	80	0.1500000
NODE_3471_length_1254_cov_22.032035	531	611	27	16	80	0.2000000
NODE_3471_length_1254_cov_22.032035	531	611	28	3	80	0.0375000
NODE_3471_length_1254_cov_22.032035	531	611	29	1	80	0.0125000
NODE_3471_length_1254_cov_22.032035	531	611	30	1	80	0.0125000
NODE_3471_length_1254_cov_22.032035	531	611	36	6	80	0.0750000
NODE_3471_length_1254_cov_22.032035	531	611	37	7	80	0.0875000
NODE_3471_length_1254_cov_22.032035	531	611	43	6	80	0.0750000
NODE_3471_length_1254_cov_22.032035	531	611	44	7	80	0.0875000
NODE_3471_length_1254_cov_22.032035	584	664	29	12	80	0.1500000
NODE_3471_length_1254_cov_22.032035	584	664	30	1	80	0.0125000
NODE_3471_length_1254_cov_22.032035	584	664	31	17	80	0.2125000
NODE_3471_length_1254_cov_22.032035	584	664	32	9	80	0.1125000
NODE_3471_length_1254_cov_22.032035	584	664	35	1	80	0.0125000
NODE_3471_length_1254_cov_22.032035	584	664	36	9	80	0.1125000
NODE_3471_length_1254_cov_22.032035	584	664	37	7	80	0.0875000
NODE_3471_length_1254_cov_22.032035	584	664	43	17	80	0.2125000
NODE_3471_length_1254_cov_22.032035	584	664	44	7	80	0.0875000
NODE_3479_length_1253_cov_16.916811	651	731	0	24	80	0.3000000
NODE_3479_length_1253_cov_16.916811	651	731	1	56	80	0.7000000
NODE_3479_length_1253_cov_16.916811	704	784	1	49	80	0.6125000
NODE_3479_length_1253_cov_16.916811	704	784	3	31	80	0.3875000
NODE_3479_length_1253_cov_16.916811	780	860	3	43	80	0.5375000
NODE_3479_length_1253_cov_16.916811	780	860	4	37	80	0.4625000
NODE_3479_length_1253_cov_16.916811	833	913	3	55	80	0.6875000
NODE_3479_length_1253_cov_16.916811	833	913	5	25	80	0.3125000
NODE_3480_length_1253_cov_13.816291	811	891	0	80	80	1.0000000
NODE_3481_length_1253_cov_9.067591	306	386	4	80	80	1.0000000
NODE_3481_length_1253_cov_9.067591	359	439	4	56	80	0.7000000
NODE_3481_length_1253_cov_9.067591	359	439	7	1	80	0.0125000
NODE_3481_length_1253_cov_9.067591	359	439	8	23	80	0.2875000
NODE_3487_length_1252_cov_57.745880	477	557	3	15	80	0.1875000
NODE_3487_length_1252_cov_57.745880	477	557	6	8	80	0.1000000
NODE_3487_length_1252_cov_57.745880	477	557	7	52	80	0.6500000
NODE_3487_length_1252_cov_57.745880	477	557	8	5	80	0.0625000
NODE_3487_length_1252_cov_57.745880	530	610	6	9	80	0.1125000
NODE_3487_length_1252_cov_57.745880	530	610	7	29	80	0.3625000
NODE_3487_length_1252_cov_57.745880	530	610	8	18	80	0.2250000
NODE_3487_length_1252_cov_57.745880	530	610	9	12	80	0.1500000
NODE_3487_length_1252_cov_57.745880	530	610	10	2	80	0.0250000
NODE_3487_length_1252_cov_57.745880	530	610	11	10	80	0.1250000
NODE_3487_length_1252_cov_57.745880	606	686	9	3	80	0.0375000
NODE_3487_length_1252_cov_57.745880	606	686	10	8	80	0.1000000
NODE_3487_length_1252_cov_57.745880	606	686	11	14	80	0.1750000
NODE_3487_length_1252_cov_57.745880	606	686	12	4	80	0.0500000
NODE_3487_length_1252_cov_57.745880	606	686	13	28	80	0.3500000
NODE_3487_length_1252_cov_57.745880	606	686	14	1	80	0.0125000
NODE_3487_length_1252_cov_57.745880	606	686	16	10	80	0.1250000
NODE_3487_length_1252_cov_57.745880	606	686	17	12	80	0.1500000
NODE_3487_length_1252_cov_57.745880	659	739	12	4	80	0.0500000
NODE_3487_length_1252_cov_57.745880	659	739	13	12	80	0.1500000
NODE_3487_length_1252_cov_57.745880	659	739	14	1	80	0.0125000
NODE_3487_length_1252_cov_57.745880	659	739	15	8	80	0.1000000
NODE_3487_length_1252_cov_57.745880	659	739	16	27	80	0.3375000
NODE_3487_length_1252_cov_57.745880	659	739	17	28	80	0.3500000
NODE_3488_length_1252_cov_56.694709	594	674	34	13	80	0.1625000
NODE_3488_length_1252_cov_56.694709	594	674	35	18	80	0.2250000
NODE_3488_length_1252_cov_56.694709	594	674	37	8	80	0.1000000
NODE_3488_length_1252_cov_56.694709	594	674	41	8	80	0.1000000
NODE_3488_length_1252_cov_56.694709	594	674	42	1	80	0.0125000
NODE_3488_length_1252_cov_56.694709	594	674	43	9	80	0.1125000
NODE_3488_length_1252_cov_56.694709	594	674	48	1	80	0.0125000
NODE_3488_length_1252_cov_56.694709	594	674	49	14	80	0.1750000
NODE_3488_length_1252_cov_56.694709	594	674	50	8	80	0.1000000
NODE_3488_length_1252_cov_56.694709	647	727	27	6	80	0.0750000
NODE_3488_length_1252_cov_56.694709	647	727	28	17	80	0.2125000
NODE_3488_length_1252_cov_56.694709	647	727	30	9	80	0.1125000
NODE_3488_length_1252_cov_56.694709	647	727	32	5	80	0.0625000
NODE_3488_length_1252_cov_56.694709	647	727	34	8	80	0.1000000
NODE_3488_length_1252_cov_56.694709	647	727	35	34	80	0.4250000
NODE_3488_length_1252_cov_56.694709	647	727	42	1	80	0.0125000
NODE_3488_length_1252_cov_56.694709	723	803	0	8	80	0.1000000
NODE_3488_length_1252_cov_56.694709	723	803	9	32	80	0.4000000
NODE_3488_length_1252_cov_56.694709	723	803	10	11	80	0.1375000
NODE_3488_length_1252_cov_56.694709	723	803	18	14	80	0.1750000
NODE_3488_length_1252_cov_56.694709	723	803	25	1	80	0.0125000
NODE_3488_length_1252_cov_56.694709	723	803	26	1	80	0.0125000
NODE_3488_length_1252_cov_56.694709	723	803	27	13	80	0.1625000
NODE_3488_length_1252_cov_56.694709	785	847	0	52	62	0.8387097
NODE_3488_length_1252_cov_56.694709	785	847	9	10	62	0.1612903
NODE_3489_length_1252_cov_34.023417	468	548	7	12	80	0.1500000
NODE_3489_length_1252_cov_34.023417	468	548	8	7	80	0.0875000
NODE_3489_length_1252_cov_34.023417	468	548	9	34	80	0.4250000
NODE_3489_length_1252_cov_34.023417	468	548	10	16	80	0.2000000
NODE_3489_length_1252_cov_34.023417	468	548	11	11	80	0.1375000
NODE_3489_length_1252_cov_34.023417	521	601	6	4	80	0.0500000
NODE_3489_length_1252_cov_34.023417	521	601	7	10	80	0.1250000
NODE_3489_length_1252_cov_34.023417	521	601	8	14	80	0.1750000
NODE_3489_length_1252_cov_34.023417	521	601	9	12	80	0.1500000
NODE_3489_length_1252_cov_34.023417	521	601	10	29	80	0.3625000
NODE_3489_length_1252_cov_34.023417	521	601	11	11	80	0.1375000
NODE_3489_length_1252_cov_34.023417	597	677	6	9	80	0.1125000
NODE_3489_length_1252_cov_34.023417	597	677	7	38	80	0.4750000
NODE_3489_length_1252_cov_34.023417	597	677	8	24	80	0.3000000
NODE_3489_length_1252_cov_34.023417	597	677	9	9	80	0.1125000
NODE_3489_length_1252_cov_34.023417	650	730	5	51	80	0.6375000
NODE_3489_length_1252_cov_34.023417	650	730	6	8	80	0.1000000
NODE_3489_length_1252_cov_34.023417	650	730	7	21	80	0.2625000
NODE_3490_length_1252_cov_9.316565	573	653	0	6	80	0.0750000
NODE_3490_length_1252_cov_9.316565	573	653	1	1	80	0.0125000
NODE_3490_length_1252_cov_9.316565	573	653	2	73	80	0.9125000
NODE_3490_length_1252_cov_9.316565	626	706	2	28	80	0.3500000
NODE_3490_length_1252_cov_9.316565	626	706	4	37	80	0.4625000
NODE_3490_length_1252_cov_9.316565	626	706	6	15	80	0.1875000
NODE_3491_length_1252_cov_8.295750	602	682	3	27	80	0.3375000
NODE_3491_length_1252_cov_8.295750	602	682	4	36	80	0.4500000
NODE_3491_length_1252_cov_8.295750	602	682	6	17	80	0.2125000
NODE_3491_length_1252_cov_8.295750	655	735	4	10	80	0.1250000
NODE_3491_length_1252_cov_8.295750	655	735	5	26	80	0.3250000
NODE_3491_length_1252_cov_8.295750	655	735	6	44	80	0.5500000
NODE_3494_length_1251_cov_17.513889	579	659	2	16	80	0.2000000
NODE_3494_length_1251_cov_17.513889	579	659	3	17	80	0.2125000
NODE_3494_length_1251_cov_17.513889	579	659	4	38	80	0.4750000
NODE_3494_length_1251_cov_17.513889	579	659	5	9	80	0.1125000
NODE_3494_length_1251_cov_17.513889	632	712	4	18	80	0.2250000
NODE_3494_length_1251_cov_17.513889	632	712	5	20	80	0.2500000
NODE_3494_length_1251_cov_17.513889	632	712	6	42	80	0.5250000
NODE_3494_length_1251_cov_17.513889	708	788	2	26	80	0.3250000
NODE_3494_length_1251_cov_17.513889	708	788	3	17	80	0.2125000
NODE_3494_length_1251_cov_17.513889	708	788	4	22	80	0.2750000
NODE_3494_length_1251_cov_17.513889	708	788	5	15	80	0.1875000
NODE_3494_length_1251_cov_17.513889	761	841	0	28	80	0.3500000
NODE_3494_length_1251_cov_17.513889	761	841	1	13	80	0.1625000
NODE_3494_length_1251_cov_17.513889	761	841	2	38	80	0.4750000
NODE_3494_length_1251_cov_17.513889	761	841	3	1	80	0.0125000
NODE_3497_length_1251_cov_3.139757	0	76	0	76	76	1.0000000
NODE_3497_length_1251_cov_3.139757	49	98	0	49	49	1.0000000
NODE_3501_length_1250_cov_25.133797	325	405	0	80	80	1.0000000
NODE_3501_length_1250_cov_25.133797	378	458	0	80	80	1.0000000
NODE_3503_length_1250_cov_11.471764	652	733	6	24	81	0.2962963
NODE_3503_length_1250_cov_11.471764	652	733	7	1	81	0.0123457
NODE_3503_length_1250_cov_11.471764	652	733	8	12	81	0.1481481
NODE_3503_length_1250_cov_11.471764	652	733	10	1	81	0.0123457
NODE_3503_length_1250_cov_11.471764	652	733	11	8	81	0.0987654
NODE_3503_length_1250_cov_11.471764	652	733	12	13	81	0.1604938
NODE_3503_length_1250_cov_11.471764	652	733	13	22	81	0.2716049
NODE_3503_length_1250_cov_11.471764	706	786	9	1	80	0.0125000
NODE_3503_length_1250_cov_11.471764	706	786	10	1	80	0.0125000
NODE_3503_length_1250_cov_11.471764	706	786	11	12	80	0.1500000
NODE_3503_length_1250_cov_11.471764	706	786	12	13	80	0.1625000
NODE_3503_length_1250_cov_11.471764	706	786	13	11	80	0.1375000
NODE_3503_length_1250_cov_11.471764	706	786	14	42	80	0.5250000
NODE_3505_length_1249_cov_45.772174	543	623	4	1	80	0.0125000
NODE_3505_length_1249_cov_45.772174	543	623	5	20	80	0.2500000
NODE_3505_length_1249_cov_45.772174	543	623	6	59	80	0.7375000
NODE_3505_length_1249_cov_45.772174	596	676	4	6	80	0.0750000
NODE_3505_length_1249_cov_45.772174	596	676	5	22	80	0.2750000
NODE_3505_length_1249_cov_45.772174	596	676	6	8	80	0.1000000
NODE_3505_length_1249_cov_45.772174	596	676	7	31	80	0.3875000
NODE_3505_length_1249_cov_45.772174	596	676	8	13	80	0.1625000
NODE_3505_length_1249_cov_45.772174	672	749	6	22	77	0.2857143
NODE_3505_length_1249_cov_45.772174	672	749	7	1	77	0.0129870
NODE_3505_length_1249_cov_45.772174	672	749	8	14	77	0.1818182
NODE_3505_length_1249_cov_45.772174	672	749	9	20	77	0.2597403
NODE_3505_length_1249_cov_45.772174	672	749	11	4	77	0.0519481
NODE_3505_length_1249_cov_45.772174	672	749	12	4	77	0.0519481
NODE_3505_length_1249_cov_45.772174	672	749	14	12	77	0.1558442
NODE_3505_length_1249_cov_45.772174	729	802	11	5	73	0.0684932
NODE_3505_length_1249_cov_45.772174	729	802	12	11	73	0.1506849
NODE_3505_length_1249_cov_45.772174	729	802	13	2	73	0.0273973
NODE_3505_length_1249_cov_45.772174	729	802	14	55	73	0.7534246
NODE_3506_length_1249_cov_35.670435	515	595	12	6	80	0.0750000
NODE_3506_length_1249_cov_35.670435	515	595	13	20	80	0.2500000
NODE_3506_length_1249_cov_35.670435	515	595	14	26	80	0.3250000
NODE_3506_length_1249_cov_35.670435	515	595	16	22	80	0.2750000
NODE_3506_length_1249_cov_35.670435	515	595	17	6	80	0.0750000
NODE_3506_length_1249_cov_35.670435	568	648	9	4	80	0.0500000
NODE_3506_length_1249_cov_35.670435	568	648	10	15	80	0.1875000
NODE_3506_length_1249_cov_35.670435	568	648	11	19	80	0.2375000
NODE_3506_length_1249_cov_35.670435	568	648	12	21	80	0.2625000
NODE_3506_length_1249_cov_35.670435	568	648	13	6	80	0.0750000
NODE_3506_length_1249_cov_35.670435	568	648	14	15	80	0.1875000
NODE_3506_length_1249_cov_35.670435	644	724	9	1	80	0.0125000
NODE_3506_length_1249_cov_35.670435	644	724	10	3	80	0.0375000
NODE_3506_length_1249_cov_35.670435	644	724	11	65	80	0.8125000
NODE_3506_length_1249_cov_35.670435	644	724	12	11	80	0.1375000
NODE_3506_length_1249_cov_35.670435	697	777	8	21	80	0.2625000
NODE_3506_length_1249_cov_35.670435	697	777	9	13	80	0.1625000
NODE_3506_length_1249_cov_35.670435	697	777	10	11	80	0.1375000
NODE_3506_length_1249_cov_35.670435	697	777	11	33	80	0.4125000
NODE_3506_length_1249_cov_35.670435	697	777	12	2	80	0.0250000
NODE_3507_length_1249_cov_34.616522	576	656	5	14	80	0.1750000
NODE_3507_length_1249_cov_34.616522	576	656	6	17	80	0.2125000
NODE_3507_length_1249_cov_34.616522	576	656	7	25	80	0.3125000
NODE_3507_length_1249_cov_34.616522	576	656	8	9	80	0.1125000
NODE_3507_length_1249_cov_34.616522	576	656	12	15	80	0.1875000
NODE_3507_length_1249_cov_34.616522	629	709	5	14	80	0.1750000
NODE_3507_length_1249_cov_34.616522	629	709	7	12	80	0.1500000
NODE_3507_length_1249_cov_34.616522	629	709	8	14	80	0.1750000
NODE_3507_length_1249_cov_34.616522	629	709	9	18	80	0.2250000
NODE_3507_length_1249_cov_34.616522	629	709	12	22	80	0.2750000
NODE_3507_length_1249_cov_34.616522	705	785	8	27	80	0.3375000
NODE_3507_length_1249_cov_34.616522	705	785	9	25	80	0.3125000
NODE_3507_length_1249_cov_34.616522	705	785	10	28	80	0.3500000
NODE_3507_length_1249_cov_34.616522	758	838	1	19	80	0.2375000
NODE_3507_length_1249_cov_34.616522	758	838	4	1	80	0.0125000
NODE_3507_length_1249_cov_34.616522	758	838	5	13	80	0.1625000
NODE_3507_length_1249_cov_34.616522	758	838	8	47	80	0.5875000
NODE_3508_length_1249_cov_19.592174	461	541	3	6	80	0.0750000
NODE_3508_length_1249_cov_19.592174	461	541	4	2	80	0.0250000
NODE_3508_length_1249_cov_19.592174	461	541	5	27	80	0.3375000
NODE_3508_length_1249_cov_19.592174	461	541	6	37	80	0.4625000
NODE_3508_length_1249_cov_19.592174	461	541	7	8	80	0.1000000
NODE_3508_length_1249_cov_19.592174	514	594	2	16	80	0.2000000
NODE_3508_length_1249_cov_19.592174	514	594	3	16	80	0.2000000
NODE_3508_length_1249_cov_19.592174	514	594	4	29	80	0.3625000
NODE_3508_length_1249_cov_19.592174	514	594	5	19	80	0.2375000
NODE_3508_length_1249_cov_19.592174	860	940	10	13	80	0.1625000
NODE_3508_length_1249_cov_19.592174	860	940	11	3	80	0.0375000
NODE_3508_length_1249_cov_19.592174	860	940	12	34	80	0.4250000
NODE_3508_length_1249_cov_19.592174	860	940	13	21	80	0.2625000
NODE_3508_length_1249_cov_19.592174	860	940	14	1	80	0.0125000
NODE_3508_length_1249_cov_19.592174	860	940	15	8	80	0.1000000
NODE_3508_length_1249_cov_19.592174	913	993	6	8	80	0.1000000
NODE_3508_length_1249_cov_19.592174	913	993	11	26	80	0.3250000
NODE_3508_length_1249_cov_19.592174	913	993	12	46	80	0.5750000
NODE_3509_length_1249_cov_14.926957	1153	1219	0	66	66	1.0000000
NODE_3509_length_1249_cov_14.926957	1192	1249	0	57	57	1.0000000
NODE_3509_length_1249_cov_14.926957	1192	1247	0	55	55	1.0000000
NODE_3509_length_1249_cov_14.926957	1192	1249	0	57	57	1.0000000
NODE_3510_length_1249_cov_7.682609	757	837	6	15	80	0.1875000
NODE_3510_length_1249_cov_7.682609	757	837	7	10	80	0.1250000
NODE_3510_length_1249_cov_7.682609	757	837	8	7	80	0.0875000
NODE_3510_length_1249_cov_7.682609	757	837	9	48	80	0.6000000
NODE_3510_length_1249_cov_7.682609	810	890	4	1	80	0.0125000
NODE_3510_length_1249_cov_7.682609	810	890	5	21	80	0.2625000
NODE_3510_length_1249_cov_7.682609	810	890	6	3	80	0.0375000
NODE_3510_length_1249_cov_7.682609	810	890	8	31	80	0.3875000
NODE_3510_length_1249_cov_7.682609	810	890	9	24	80	0.3000000
NODE_3514_length_1248_cov_14.351610	469	549	8	31	80	0.3875000
NODE_3514_length_1248_cov_14.351610	469	549	10	10	80	0.1250000
NODE_3514_length_1248_cov_14.351610	469	549	12	39	80	0.4875000
NODE_3514_length_1248_cov_14.351610	522	602	6	13	80	0.1625000
NODE_3514_length_1248_cov_14.351610	522	602	7	20	80	0.2500000
NODE_3514_length_1248_cov_14.351610	522	602	8	23	80	0.2875000
NODE_3514_length_1248_cov_14.351610	522	602	9	11	80	0.1375000
NODE_3514_length_1248_cov_14.351610	522	602	10	10	80	0.1250000
NODE_3514_length_1248_cov_14.351610	522	602	12	3	80	0.0375000
NODE_3514_length_1248_cov_14.351610	598	678	4	10	80	0.1250000
NODE_3514_length_1248_cov_14.351610	598	678	5	32	80	0.4000000
NODE_3514_length_1248_cov_14.351610	598	678	7	18	80	0.2250000
NODE_3514_length_1248_cov_14.351610	598	678	8	20	80	0.2500000
NODE_3514_length_1248_cov_14.351610	651	731	2	10	80	0.1250000
NODE_3514_length_1248_cov_14.351610	651	731	5	33	80	0.4125000
NODE_3514_length_1248_cov_14.351610	651	731	6	37	80	0.4625000
NODE_3515_length_1248_cov_11.181027	303	383	5	80	80	1.0000000
NODE_3515_length_1248_cov_11.181027	356	436	1	1	80	0.0125000
NODE_3515_length_1248_cov_11.181027	356	436	2	9	80	0.1125000
NODE_3515_length_1248_cov_11.181027	356	436	5	54	80	0.6750000
NODE_3515_length_1248_cov_11.181027	356	436	6	16	80	0.2000000
NODE_3515_length_1248_cov_11.181027	432	512	2	62	80	0.7750000
NODE_3515_length_1248_cov_11.181027	432	512	3	18	80	0.2250000
NODE_3515_length_1248_cov_11.181027	485	565	2	9	80	0.1125000
NODE_3515_length_1248_cov_11.181027	485	565	3	22	80	0.2750000
NODE_3515_length_1248_cov_11.181027	485	565	5	9	80	0.1125000
NODE_3515_length_1248_cov_11.181027	485	565	6	40	80	0.5000000
NODE_3516_length_1248_cov_4.372498	17	98	0	81	81	1.0000000
NODE_3516_length_1248_cov_4.372498	94	152	0	58	58	1.0000000
NODE_3517_length_1248_cov_2.356832	952	1032	0	80	80	1.0000000
NODE_3517_length_1248_cov_2.356832	1005	1085	0	80	80	1.0000000
NODE_3518_length_1248_cov_2.283725	1102	1151	0	49	49	1.0000000
NODE_3522_length_1247_cov_25.355401	487	567	4	36	80	0.4500000
NODE_3522_length_1247_cov_25.355401	487	567	6	9	80	0.1125000
NODE_3522_length_1247_cov_25.355401	487	567	8	26	80	0.3250000
NODE_3522_length_1247_cov_25.355401	487	567	9	5	80	0.0625000
NODE_3522_length_1247_cov_25.355401	487	567	10	4	80	0.0500000
NODE_3522_length_1247_cov_25.355401	540	620	7	6	80	0.0750000
NODE_3522_length_1247_cov_25.355401	540	620	8	30	80	0.3750000
NODE_3522_length_1247_cov_25.355401	540	620	9	15	80	0.1875000
NODE_3522_length_1247_cov_25.355401	540	620	10	24	80	0.3000000
NODE_3522_length_1247_cov_25.355401	540	620	11	4	80	0.0500000
NODE_3522_length_1247_cov_25.355401	540	620	12	1	80	0.0125000
NODE_3522_length_1247_cov_25.355401	616	696	11	3	80	0.0375000
NODE_3522_length_1247_cov_25.355401	616	696	12	9	80	0.1125000
NODE_3522_length_1247_cov_25.355401	616	696	13	36	80	0.4500000
NODE_3522_length_1247_cov_25.355401	616	696	14	13	80	0.1625000
NODE_3522_length_1247_cov_25.355401	616	696	15	18	80	0.2250000
NODE_3522_length_1247_cov_25.355401	616	696	16	1	80	0.0125000
NODE_3522_length_1247_cov_25.355401	669	749	12	4	80	0.0500000
NODE_3522_length_1247_cov_25.355401	669	749	13	11	80	0.1375000
NODE_3522_length_1247_cov_25.355401	669	749	14	32	80	0.4000000
NODE_3522_length_1247_cov_25.355401	669	749	15	23	80	0.2875000
NODE_3522_length_1247_cov_25.355401	669	749	16	10	80	0.1250000
NODE_3528_length_1246_cov_30.231909	433	513	0	42	80	0.5250000
NODE_3528_length_1246_cov_30.231909	433	513	3	38	80	0.4750000
NODE_3528_length_1246_cov_30.231909	486	566	3	80	80	1.0000000
NODE_3528_length_1246_cov_30.231909	562	642	3	8	80	0.1000000
NODE_3528_length_1246_cov_30.231909	562	642	6	40	80	0.5000000
NODE_3528_length_1246_cov_30.231909	562	642	7	14	80	0.1750000
NODE_3528_length_1246_cov_30.231909	562	642	9	18	80	0.2250000
NODE_3528_length_1246_cov_30.231909	615	695	6	8	80	0.1000000
NODE_3528_length_1246_cov_30.231909	615	695	7	17	80	0.2125000
NODE_3528_length_1246_cov_30.231909	615	695	9	55	80	0.6875000
NODE_3529_length_1246_cov_13.847428	497	577	4	17	80	0.2125000
NODE_3529_length_1246_cov_13.847428	497	577	5	4	80	0.0500000
NODE_3529_length_1246_cov_13.847428	497	577	6	59	80	0.7375000
NODE_3529_length_1246_cov_13.847428	550	630	3	3	80	0.0375000
NODE_3529_length_1246_cov_13.847428	550	630	4	2	80	0.0250000
NODE_3529_length_1246_cov_13.847428	550	630	5	46	80	0.5750000
NODE_3529_length_1246_cov_13.847428	550	630	6	29	80	0.3625000
NODE_3535_length_1245_cov_31.472949	443	523	36	9	80	0.1125000
NODE_3535_length_1245_cov_31.472949	443	523	40	7	80	0.0875000
NODE_3535_length_1245_cov_31.472949	443	523	42	11	80	0.1375000
NODE_3535_length_1245_cov_31.472949	443	523	45	17	80	0.2125000
NODE_3535_length_1245_cov_31.472949	443	523	46	2	80	0.0250000
NODE_3535_length_1245_cov_31.472949	443	523	47	7	80	0.0875000
NODE_3535_length_1245_cov_31.472949	443	523	48	2	80	0.0250000
NODE_3535_length_1245_cov_31.472949	443	523	49	12	80	0.1500000
NODE_3535_length_1245_cov_31.472949	443	523	50	6	80	0.0750000
NODE_3535_length_1245_cov_31.472949	443	523	52	7	80	0.0875000
NODE_3535_length_1245_cov_31.472949	496	576	18	18	80	0.2250000
NODE_3535_length_1245_cov_31.472949	496	576	20	10	80	0.1250000
NODE_3535_length_1245_cov_31.472949	496	576	30	7	80	0.0875000
NODE_3535_length_1245_cov_31.472949	496	576	31	1	80	0.0125000
NODE_3535_length_1245_cov_31.472949	496	576	36	9	80	0.1125000
NODE_3535_length_1245_cov_31.472949	496	576	40	14	80	0.1750000
NODE_3535_length_1245_cov_31.472949	496	576	42	21	80	0.2625000
NODE_3536_length_1245_cov_30.068935	771	841	6	16	70	0.2285714
NODE_3536_length_1245_cov_30.068935	771	841	7	46	70	0.6571429
NODE_3536_length_1245_cov_30.068935	771	841	8	8	70	0.1142857
NODE_3537_length_1245_cov_24.765271	668	748	3	3	80	0.0375000
NODE_3537_length_1245_cov_24.765271	668	748	4	24	80	0.3000000
NODE_3537_length_1245_cov_24.765271	668	748	5	47	80	0.5875000
NODE_3537_length_1245_cov_24.765271	668	748	6	6	80	0.0750000
NODE_3537_length_1245_cov_24.765271	721	801	4	19	80	0.2375000
NODE_3537_length_1245_cov_24.765271	721	801	5	23	80	0.2875000
NODE_3537_length_1245_cov_24.765271	721	801	6	38	80	0.4750000
NODE_3537_length_1245_cov_24.765271	797	877	5	22	80	0.2750000
NODE_3537_length_1245_cov_24.765271	797	877	6	40	80	0.5000000
NODE_3537_length_1245_cov_24.765271	797	877	7	1	80	0.0125000
NODE_3537_length_1245_cov_24.765271	797	877	8	17	80	0.2125000
NODE_3537_length_1245_cov_24.765271	850	930	4	40	80	0.5000000
NODE_3537_length_1245_cov_24.765271	850	930	6	40	80	0.5000000
NODE_3538_length_1245_cov_16.854276	655	735	3	66	80	0.8250000
NODE_3538_length_1245_cov_16.854276	655	735	5	14	80	0.1750000
NODE_3538_length_1245_cov_16.854276	701	771	2	3	70	0.0428571
NODE_3538_length_1245_cov_16.854276	701	771	3	20	70	0.2857143
NODE_3538_length_1245_cov_16.854276	701	771	5	47	70	0.6714286
NODE_3538_length_1245_cov_16.854276	708	788	2	20	80	0.2500000
NODE_3538_length_1245_cov_16.854276	708	788	3	13	80	0.1625000
NODE_3538_length_1245_cov_16.854276	708	788	5	47	80	0.5875000
NODE_3540_length_1245_cov_1.187609	1148	1194	0	46	46	1.0000000
NODE_3540_length_1245_cov_1.187609	1167	1245	0	78	78	1.0000000
NODE_3541_length_1244_cov_52.633188	501	581	4	9	80	0.1125000
NODE_3541_length_1244_cov_52.633188	501	581	5	5	80	0.0625000
NODE_3541_length_1244_cov_52.633188	501	581	6	36	80	0.4500000
NODE_3541_length_1244_cov_52.633188	501	581	7	4	80	0.0500000
NODE_3541_length_1244_cov_52.633188	501	581	8	10	80	0.1250000
NODE_3541_length_1244_cov_52.633188	501	581	9	14	80	0.1750000
NODE_3541_length_1244_cov_52.633188	501	581	11	1	80	0.0125000
NODE_3541_length_1244_cov_52.633188	501	581	14	1	80	0.0125000
NODE_3541_length_1244_cov_52.633188	554	634	7	1	80	0.0125000
NODE_3541_length_1244_cov_52.633188	554	634	8	10	80	0.1250000
NODE_3541_length_1244_cov_52.633188	554	634	9	14	80	0.1750000
NODE_3541_length_1244_cov_52.633188	554	634	11	1	80	0.0125000
NODE_3541_length_1244_cov_52.633188	554	634	14	10	80	0.1250000
NODE_3541_length_1244_cov_52.633188	554	634	15	12	80	0.1500000
NODE_3541_length_1244_cov_52.633188	554	634	17	21	80	0.2625000
NODE_3541_length_1244_cov_52.633188	554	634	18	11	80	0.1375000
NODE_3541_length_1244_cov_52.633188	630	710	15	3	80	0.0375000
NODE_3541_length_1244_cov_52.633188	630	710	16	19	80	0.2375000
NODE_3541_length_1244_cov_52.633188	630	710	17	17	80	0.2125000
NODE_3541_length_1244_cov_52.633188	630	710	19	13	80	0.1625000
NODE_3541_length_1244_cov_52.633188	630	710	20	2	80	0.0250000
NODE_3541_length_1244_cov_52.633188	630	710	21	1	80	0.0125000
NODE_3541_length_1244_cov_52.633188	630	710	22	13	80	0.1625000
NODE_3541_length_1244_cov_52.633188	630	710	23	1	80	0.0125000
NODE_3541_length_1244_cov_52.633188	630	710	24	11	80	0.1375000
NODE_3541_length_1244_cov_52.633188	683	763	15	11	80	0.1375000
NODE_3541_length_1244_cov_52.633188	683	763	17	2	80	0.0250000
NODE_3541_length_1244_cov_52.633188	683	763	18	20	80	0.2500000
NODE_3541_length_1244_cov_52.633188	683	763	20	1	80	0.0125000
NODE_3541_length_1244_cov_52.633188	683	763	21	4	80	0.0500000
NODE_3541_length_1244_cov_52.633188	683	763	22	24	80	0.3000000
NODE_3541_length_1244_cov_52.633188	683	763	23	5	80	0.0625000
NODE_3541_length_1244_cov_52.633188	683	763	24	13	80	0.1625000
NODE_3542_length_1244_cov_33.889956	445	525	4	19	80	0.2375000
NODE_3542_length_1244_cov_33.889956	445	525	7	13	80	0.1625000
NODE_3542_length_1244_cov_33.889956	445	525	10	29	80	0.3625000
NODE_3542_length_1244_cov_33.889956	445	525	11	1	80	0.0125000
NODE_3542_length_1244_cov_33.889956	445	525	12	15	80	0.1875000
NODE_3542_length_1244_cov_33.889956	445	525	13	3	80	0.0375000
NODE_3542_length_1244_cov_33.889956	498	578	10	23	80	0.2875000
NODE_3542_length_1244_cov_33.889956	498	578	11	1	80	0.0125000
NODE_3542_length_1244_cov_33.889956	498	578	12	11	80	0.1375000
NODE_3542_length_1244_cov_33.889956	498	578	14	2	80	0.0250000
NODE_3542_length_1244_cov_33.889956	498	578	15	23	80	0.2875000
NODE_3542_length_1244_cov_33.889956	498	578	16	7	80	0.0875000
NODE_3542_length_1244_cov_33.889956	498	578	17	13	80	0.1625000
NODE_3542_length_1244_cov_33.889956	574	654	17	12	80	0.1500000
NODE_3542_length_1244_cov_33.889956	574	654	18	4	80	0.0500000
NODE_3542_length_1244_cov_33.889956	574	654	19	17	80	0.2125000
NODE_3542_length_1244_cov_33.889956	574	654	20	21	80	0.2625000
NODE_3542_length_1244_cov_33.889956	574	654	22	12	80	0.1500000
NODE_3542_length_1244_cov_33.889956	574	654	23	13	80	0.1625000
NODE_3542_length_1244_cov_33.889956	574	654	26	1	80	0.0125000
NODE_3542_length_1244_cov_33.889956	627	707	14	6	80	0.0750000
NODE_3542_length_1244_cov_33.889956	627	707	15	18	80	0.2250000
NODE_3542_length_1244_cov_33.889956	627	707	17	6	80	0.0750000
NODE_3542_length_1244_cov_33.889956	627	707	18	2	80	0.0250000
NODE_3542_length_1244_cov_33.889956	627	707	19	20	80	0.2500000
NODE_3542_length_1244_cov_33.889956	627	707	20	28	80	0.3500000
NODE_3543_length_1244_cov_16.798253	644	724	4	4	80	0.0500000
NODE_3543_length_1244_cov_16.798253	644	724	5	38	80	0.4750000
NODE_3543_length_1244_cov_16.798253	644	724	7	6	80	0.0750000
NODE_3543_length_1244_cov_16.798253	644	724	9	17	80	0.2125000
NODE_3543_length_1244_cov_16.798253	644	724	10	15	80	0.1875000
NODE_3543_length_1244_cov_16.798253	697	777	9	27	80	0.3375000
NODE_3543_length_1244_cov_16.798253	697	777	10	15	80	0.1875000
NODE_3543_length_1244_cov_16.798253	697	777	11	20	80	0.2500000
NODE_3543_length_1244_cov_16.798253	697	777	12	15	80	0.1875000
NODE_3543_length_1244_cov_16.798253	697	777	13	1	80	0.0125000
NODE_3543_length_1244_cov_16.798253	697	777	14	2	80	0.0250000
NODE_3544_length_1244_cov_1.735371	276	347	0	71	71	1.0000000
NODE_3544_length_1244_cov_1.735371	276	347	0	71	71	1.0000000
NODE_3544_length_1244_cov_1.735371	320	400	0	80	80	1.0000000
NODE_3544_length_1244_cov_1.735371	320	400	0	80	80	1.0000000
NODE_3548_length_1243_cov_34.284965	774	854	6	51	80	0.6375000
NODE_3548_length_1243_cov_34.284965	774	854	7	6	80	0.0750000
NODE_3548_length_1243_cov_34.284965	774	854	8	23	80	0.2875000
NODE_3548_length_1243_cov_34.284965	827	907	2	2	80	0.0250000
NODE_3548_length_1243_cov_34.284965	827	907	5	50	80	0.6250000
NODE_3548_length_1243_cov_34.284965	827	907	7	4	80	0.0500000
NODE_3548_length_1243_cov_34.284965	827	907	8	24	80	0.3000000
NODE_3552_length_1242_cov_29.665792	539	619	13	26	80	0.3250000
NODE_3552_length_1242_cov_29.665792	539	619	14	7	80	0.0875000
NODE_3552_length_1242_cov_29.665792	539	619	15	1	80	0.0125000
NODE_3552_length_1242_cov_29.665792	539	619	16	3	80	0.0375000
NODE_3552_length_1242_cov_29.665792	539	619	17	25	80	0.3125000
NODE_3552_length_1242_cov_29.665792	539	619	19	18	80	0.2250000
NODE_3552_length_1242_cov_29.665792	592	672	10	1	80	0.0125000
NODE_3552_length_1242_cov_29.665792	592	672	11	14	80	0.1750000
NODE_3552_length_1242_cov_29.665792	592	672	12	20	80	0.2500000
NODE_3552_length_1242_cov_29.665792	592	672	13	42	80	0.5250000
NODE_3552_length_1242_cov_29.665792	592	672	14	2	80	0.0250000
NODE_3552_length_1242_cov_29.665792	592	672	17	1	80	0.0125000
NODE_3553_length_1242_cov_28.304462	506	586	3	12	80	0.1500000
NODE_3553_length_1242_cov_28.304462	506	586	5	1	80	0.0125000
NODE_3553_length_1242_cov_28.304462	506	586	6	27	80	0.3375000
NODE_3553_length_1242_cov_28.304462	506	586	7	11	80	0.1375000
NODE_3553_length_1242_cov_28.304462	506	586	8	29	80	0.3625000
NODE_3553_length_1242_cov_28.304462	559	639	8	33	80	0.4125000
NODE_3553_length_1242_cov_28.304462	559	639	9	16	80	0.2000000
NODE_3553_length_1242_cov_28.304462	559	639	10	4	80	0.0500000
NODE_3553_length_1242_cov_28.304462	559	639	11	9	80	0.1125000
NODE_3553_length_1242_cov_28.304462	559	639	13	17	80	0.2125000
NODE_3553_length_1242_cov_28.304462	559	639	14	1	80	0.0125000
NODE_3553_length_1242_cov_28.304462	635	715	9	2	80	0.0250000
NODE_3553_length_1242_cov_28.304462	635	715	10	21	80	0.2625000
NODE_3553_length_1242_cov_28.304462	635	715	11	17	80	0.2125000
NODE_3553_length_1242_cov_28.304462	635	715	13	23	80	0.2875000
NODE_3553_length_1242_cov_28.304462	635	715	15	17	80	0.2125000
NODE_3553_length_1242_cov_28.304462	688	768	9	2	80	0.0250000
NODE_3553_length_1242_cov_28.304462	688	768	10	10	80	0.1250000
NODE_3553_length_1242_cov_28.304462	688	768	11	15	80	0.1875000
NODE_3553_length_1242_cov_28.304462	688	768	12	4	80	0.0500000
NODE_3553_length_1242_cov_28.304462	688	768	13	32	80	0.4000000
NODE_3553_length_1242_cov_28.304462	688	768	14	17	80	0.2125000
NODE_3554_length_1242_cov_16.383202	704	784	6	11	80	0.1375000
NODE_3554_length_1242_cov_16.383202	704	784	7	4	80	0.0500000
NODE_3554_length_1242_cov_16.383202	704	784	8	65	80	0.8125000
NODE_3554_length_1242_cov_16.383202	757	837	3	27	80	0.3375000
NODE_3554_length_1242_cov_16.383202	757	837	4	4	80	0.0500000
NODE_3554_length_1242_cov_16.383202	757	837	6	14	80	0.1750000
NODE_3554_length_1242_cov_16.383202	757	837	7	1	80	0.0125000
NODE_3554_length_1242_cov_16.383202	757	837	8	34	80	0.4250000
NODE_3555_length_1242_cov_8.081365	688	768	4	14	80	0.1750000
NODE_3555_length_1242_cov_8.081365	688	768	5	34	80	0.4250000
NODE_3555_length_1242_cov_8.081365	688	768	6	32	80	0.4000000
NODE_3555_length_1242_cov_8.081365	741	821	3	9	80	0.1125000
NODE_3555_length_1242_cov_8.081365	741	821	4	47	80	0.5875000
NODE_3555_length_1242_cov_8.081365	741	821	5	1	80	0.0125000
NODE_3555_length_1242_cov_8.081365	741	821	6	23	80	0.2875000
NODE_3561_length_1241_cov_36.544658	602	682	6	6	80	0.0750000
NODE_3561_length_1241_cov_36.544658	602	682	8	23	80	0.2875000
NODE_3561_length_1241_cov_36.544658	602	682	9	16	80	0.2000000
NODE_3561_length_1241_cov_36.544658	602	682	10	24	80	0.3000000
NODE_3561_length_1241_cov_36.544658	602	682	11	11	80	0.1375000
NODE_3561_length_1241_cov_36.544658	655	735	9	16	80	0.2000000
NODE_3561_length_1241_cov_36.544658	655	735	10	37	80	0.4625000
NODE_3561_length_1241_cov_36.544658	655	735	11	27	80	0.3375000
NODE_3562_length_1241_cov_19.894921	676	756	0	4	80	0.0500000
NODE_3562_length_1241_cov_19.894921	676	756	1	76	80	0.9500000
NODE_3562_length_1241_cov_19.894921	729	809	1	80	80	1.0000000
NODE_3569_length_1240_cov_38.375110	483	563	4	17	80	0.2125000
NODE_3569_length_1240_cov_38.375110	483	563	5	3	80	0.0375000
NODE_3569_length_1240_cov_38.375110	483	563	6	5	80	0.0625000
NODE_3569_length_1240_cov_38.375110	483	563	7	7	80	0.0875000
NODE_3569_length_1240_cov_38.375110	483	563	8	48	80	0.6000000
NODE_3569_length_1240_cov_38.375110	536	616	5	7	80	0.0875000
NODE_3569_length_1240_cov_38.375110	536	616	6	17	80	0.2125000
NODE_3569_length_1240_cov_38.375110	536	616	7	17	80	0.2125000
NODE_3569_length_1240_cov_38.375110	536	616	8	27	80	0.3375000
NODE_3569_length_1240_cov_38.375110	536	616	9	12	80	0.1500000
NODE_3569_length_1240_cov_38.375110	612	692	5	29	80	0.3625000
NODE_3569_length_1240_cov_38.375110	612	692	6	5	80	0.0625000
NODE_3569_length_1240_cov_38.375110	612	692	7	6	80	0.0750000
NODE_3569_length_1240_cov_38.375110	612	692	9	40	80	0.5000000
NODE_3569_length_1240_cov_38.375110	665	745	4	16	80	0.2000000
NODE_3569_length_1240_cov_38.375110	665	745	5	64	80	0.8000000
NODE_3570_length_1240_cov_24.975460	625	705	6	14	80	0.1750000
NODE_3570_length_1240_cov_24.975460	625	705	7	3	80	0.0375000
NODE_3570_length_1240_cov_24.975460	625	705	8	6	80	0.0750000
NODE_3570_length_1240_cov_24.975460	625	705	10	4	80	0.0500000
NODE_3570_length_1240_cov_24.975460	625	705	11	40	80	0.5000000
NODE_3570_length_1240_cov_24.975460	625	705	12	13	80	0.1625000
NODE_3570_length_1240_cov_24.975460	678	758	11	17	80	0.2125000
NODE_3570_length_1240_cov_24.975460	678	758	12	63	80	0.7875000
NODE_3571_length_1240_cov_23.812445	731	811	3	5	80	0.0625000
NODE_3571_length_1240_cov_23.812445	731	811	4	12	80	0.1500000
NODE_3571_length_1240_cov_23.812445	731	811	5	9	80	0.1125000
NODE_3571_length_1240_cov_23.812445	731	811	7	2	80	0.0250000
NODE_3571_length_1240_cov_23.812445	731	811	8	17	80	0.2125000
NODE_3571_length_1240_cov_23.812445	731	811	9	35	80	0.4375000
NODE_3571_length_1240_cov_23.812445	784	864	8	22	80	0.2750000
NODE_3571_length_1240_cov_23.812445	784	864	9	12	80	0.1500000
NODE_3571_length_1240_cov_23.812445	784	864	10	11	80	0.1375000
NODE_3571_length_1240_cov_23.812445	784	864	11	29	80	0.3625000
NODE_3571_length_1240_cov_23.812445	784	864	12	6	80	0.0750000
NODE_3576_length_1239_cov_37.657895	399	479	1	6	80	0.0750000
NODE_3576_length_1239_cov_37.657895	399	479	2	1	80	0.0125000
NODE_3576_length_1239_cov_37.657895	399	479	3	54	80	0.6750000
NODE_3576_length_1239_cov_37.657895	399	479	6	1	80	0.0125000
NODE_3576_length_1239_cov_37.657895	399	479	7	11	80	0.1375000
NODE_3576_length_1239_cov_37.657895	399	479	8	7	80	0.0875000
NODE_3576_length_1239_cov_37.657895	452	532	3	8	80	0.1000000
NODE_3576_length_1239_cov_37.657895	452	532	6	1	80	0.0125000
NODE_3576_length_1239_cov_37.657895	452	532	7	11	80	0.1375000
NODE_3576_length_1239_cov_37.657895	452	532	8	14	80	0.1750000
NODE_3576_length_1239_cov_37.657895	452	532	9	26	80	0.3250000
NODE_3576_length_1239_cov_37.657895	452	532	10	13	80	0.1625000
NODE_3576_length_1239_cov_37.657895	452	532	13	7	80	0.0875000
NODE_3576_length_1239_cov_37.657895	528	608	12	11	80	0.1375000
NODE_3576_length_1239_cov_37.657895	528	608	13	69	80	0.8625000
NODE_3576_length_1239_cov_37.657895	581	661	6	3	80	0.0375000
NODE_3576_length_1239_cov_37.657895	581	661	7	22	80	0.2750000
NODE_3576_length_1239_cov_37.657895	581	661	8	14	80	0.1750000
NODE_3576_length_1239_cov_37.657895	581	661	9	12	80	0.1500000
NODE_3576_length_1239_cov_37.657895	581	661	13	29	80	0.3625000
NODE_3577_length_1239_cov_14.984211	398	478	0	80	80	1.0000000
NODE_3577_length_1239_cov_14.984211	451	531	0	80	80	1.0000000
NODE_3577_length_1239_cov_14.984211	771	825	14	15	54	0.2777778
NODE_3577_length_1239_cov_14.984211	771	825	17	39	54	0.7222222
NODE_3577_length_1239_cov_14.984211	798	878	17	33	80	0.4125000
NODE_3577_length_1239_cov_14.984211	798	878	18	13	80	0.1625000
NODE_3577_length_1239_cov_14.984211	798	878	20	2	80	0.0250000
NODE_3577_length_1239_cov_14.984211	798	878	21	8	80	0.1000000
NODE_3577_length_1239_cov_14.984211	798	878	22	17	80	0.2125000
NODE_3577_length_1239_cov_14.984211	798	878	23	4	80	0.0500000
NODE_3577_length_1239_cov_14.984211	798	878	25	1	80	0.0125000
NODE_3577_length_1239_cov_14.984211	798	878	27	1	80	0.0125000
NODE_3577_length_1239_cov_14.984211	798	878	28	1	80	0.0125000
NODE_3578_length_1239_cov_13.312281	806	886	7	6	80	0.0750000
NODE_3578_length_1239_cov_13.312281	806	886	8	5	80	0.0625000
NODE_3578_length_1239_cov_13.312281	806	886	9	50	80	0.6250000
NODE_3578_length_1239_cov_13.312281	806	886	10	19	80	0.2375000
NODE_3578_length_1239_cov_13.312281	859	939	4	11	80	0.1375000
NODE_3578_length_1239_cov_13.312281	859	939	5	15	80	0.1875000
NODE_3578_length_1239_cov_13.312281	859	939	9	13	80	0.1625000
NODE_3578_length_1239_cov_13.312281	859	939	10	41	80	0.5125000
NODE_3579_length_1239_cov_7.116667	444	524	0	80	80	1.0000000
NODE_3579_length_1239_cov_7.116667	497	577	0	80	80	1.0000000
NODE_3582_length_1238_cov_33.830553	625	705	1	5	80	0.0625000
NODE_3582_length_1238_cov_33.830553	625	705	2	16	80	0.2000000
NODE_3582_length_1238_cov_33.830553	625	705	3	53	80	0.6625000
NODE_3582_length_1238_cov_33.830553	625	705	4	6	80	0.0750000
NODE_3582_length_1238_cov_33.830553	678	758	1	5	80	0.0625000
NODE_3582_length_1238_cov_33.830553	678	758	2	7	80	0.0875000
NODE_3582_length_1238_cov_33.830553	678	758	3	62	80	0.7750000
NODE_3582_length_1238_cov_33.830553	678	758	4	6	80	0.0750000
NODE_3583_length_1238_cov_8.163301	664	744	3	80	80	1.0000000
NODE_3583_length_1238_cov_8.163301	717	797	1	53	80	0.6625000
NODE_3583_length_1238_cov_8.163301	717	797	3	27	80	0.3375000
NODE_3586_length_1237_cov_24.562390	447	527	12	6	80	0.0750000
NODE_3586_length_1237_cov_24.562390	447	527	13	6	80	0.0750000
NODE_3586_length_1237_cov_24.562390	447	527	14	20	80	0.2500000
NODE_3586_length_1237_cov_24.562390	447	527	15	9	80	0.1125000
NODE_3586_length_1237_cov_24.562390	447	527	16	23	80	0.2875000
NODE_3586_length_1237_cov_24.562390	447	527	18	10	80	0.1250000
NODE_3586_length_1237_cov_24.562390	447	527	19	6	80	0.0750000
NODE_3586_length_1237_cov_24.562390	500	580	7	11	80	0.1375000
NODE_3586_length_1237_cov_24.562390	500	580	8	1	80	0.0125000
NODE_3586_length_1237_cov_24.562390	500	580	9	13	80	0.1625000
NODE_3586_length_1237_cov_24.562390	500	580	10	13	80	0.1625000
NODE_3586_length_1237_cov_24.562390	500	580	12	13	80	0.1625000
NODE_3586_length_1237_cov_24.562390	500	580	13	7	80	0.0875000
NODE_3586_length_1237_cov_24.562390	500	580	14	22	80	0.2750000
NODE_3587_length_1237_cov_9.297012	515	595	6	40	80	0.5000000
NODE_3587_length_1237_cov_9.297012	515	595	7	1	80	0.0125000
NODE_3587_length_1237_cov_9.297012	515	595	8	39	80	0.4875000
NODE_3587_length_1237_cov_9.297012	568	648	4	34	80	0.4250000
NODE_3587_length_1237_cov_9.297012	568	648	6	42	80	0.5250000
NODE_3587_length_1237_cov_9.297012	568	648	8	4	80	0.0500000
NODE_3594_length_1236_cov_46.661390	632	712	9	20	80	0.2500000
NODE_3594_length_1236_cov_46.661390	632	712	11	17	80	0.2125000
NODE_3594_length_1236_cov_46.661390	632	712	12	37	80	0.4625000
NODE_3594_length_1236_cov_46.661390	632	712	14	6	80	0.0750000
NODE_3594_length_1236_cov_46.661390	685	765	9	3	80	0.0375000
NODE_3594_length_1236_cov_46.661390	685	765	10	3	80	0.0375000
NODE_3594_length_1236_cov_46.661390	685	765	11	17	80	0.2125000
NODE_3594_length_1236_cov_46.661390	685	765	12	42	80	0.5250000
NODE_3594_length_1236_cov_46.661390	685	765	13	15	80	0.1875000
NODE_3595_length_1236_cov_8.625330	735	815	7	11	80	0.1375000
NODE_3595_length_1236_cov_8.625330	735	815	9	38	80	0.4750000
NODE_3595_length_1236_cov_8.625330	735	815	10	28	80	0.3500000
NODE_3595_length_1236_cov_8.625330	735	815	11	3	80	0.0375000
NODE_3595_length_1236_cov_8.625330	788	868	9	10	80	0.1250000
NODE_3595_length_1236_cov_8.625330	788	868	10	41	80	0.5125000
NODE_3595_length_1236_cov_8.625330	788	868	11	18	80	0.2250000
NODE_3595_length_1236_cov_8.625330	788	868	12	11	80	0.1375000
NODE_3597_length_1235_cov_31.619718	331	411	18	2	80	0.0250000
NODE_3597_length_1235_cov_31.619718	331	411	19	10	80	0.1250000
NODE_3597_length_1235_cov_31.619718	331	411	20	2	80	0.0250000
NODE_3597_length_1235_cov_31.619718	331	411	21	9	80	0.1125000
NODE_3597_length_1235_cov_31.619718	331	411	22	1	80	0.0125000
NODE_3597_length_1235_cov_31.619718	331	411	23	31	80	0.3875000
NODE_3597_length_1235_cov_31.619718	331	411	25	25	80	0.3125000
NODE_3597_length_1235_cov_31.619718	384	464	14	2	80	0.0250000
NODE_3597_length_1235_cov_31.619718	384	464	15	14	80	0.1750000
NODE_3597_length_1235_cov_31.619718	384	464	16	35	80	0.4375000
NODE_3597_length_1235_cov_31.619718	384	464	18	2	80	0.0250000
NODE_3597_length_1235_cov_31.619718	384	464	19	12	80	0.1500000
NODE_3597_length_1235_cov_31.619718	384	464	20	2	80	0.0250000
NODE_3597_length_1235_cov_31.619718	384	464	21	9	80	0.1125000
NODE_3597_length_1235_cov_31.619718	384	464	23	4	80	0.0500000
NODE_3598_length_1235_cov_20.252641	559	639	7	40	80	0.5000000
NODE_3598_length_1235_cov_20.252641	559	639	8	9	80	0.1125000
NODE_3598_length_1235_cov_20.252641	559	639	9	16	80	0.2000000
NODE_3598_length_1235_cov_20.252641	559	639	10	15	80	0.1875000
NODE_3598_length_1235_cov_20.252641	612	692	6	9	80	0.1125000
NODE_3598_length_1235_cov_20.252641	612	692	7	34	80	0.4250000
NODE_3598_length_1235_cov_20.252641	612	692	10	37	80	0.4625000
NODE_3598_length_1235_cov_20.252641	688	768	4	33	80	0.4125000
NODE_3598_length_1235_cov_20.252641	688	768	5	17	80	0.2125000
NODE_3598_length_1235_cov_20.252641	688	768	6	13	80	0.1625000
NODE_3598_length_1235_cov_20.252641	688	768	9	5	80	0.0625000
NODE_3598_length_1235_cov_20.252641	688	768	10	12	80	0.1500000
NODE_3598_length_1235_cov_20.252641	741	821	4	42	80	0.5250000
NODE_3598_length_1235_cov_20.252641	741	821	5	13	80	0.1625000
NODE_3598_length_1235_cov_20.252641	741	821	7	6	80	0.0750000
NODE_3598_length_1235_cov_20.252641	741	821	8	19	80	0.2375000
NODE_3599_length_1235_cov_18.462148	695	775	7	20	80	0.2500000
NODE_3599_length_1235_cov_18.462148	695	775	9	2	80	0.0250000
NODE_3599_length_1235_cov_18.462148	695	775	11	20	80	0.2500000
NODE_3599_length_1235_cov_18.462148	695	775	12	14	80	0.1750000
NODE_3599_length_1235_cov_18.462148	695	775	13	13	80	0.1625000
NODE_3599_length_1235_cov_18.462148	695	775	14	1	80	0.0125000
NODE_3599_length_1235_cov_18.462148	695	775	15	10	80	0.1250000
NODE_3599_length_1235_cov_18.462148	748	828	11	33	80	0.4125000
NODE_3599_length_1235_cov_18.462148	748	828	12	24	80	0.3000000
NODE_3599_length_1235_cov_18.462148	748	828	13	8	80	0.1000000
NODE_3599_length_1235_cov_18.462148	748	828	14	15	80	0.1875000
NODE_3600_length_1235_cov_8.696303	765	845	4	32	80	0.4000000
NODE_3600_length_1235_cov_8.696303	765	845	5	15	80	0.1875000
NODE_3600_length_1235_cov_8.696303	765	845	9	6	80	0.0750000
NODE_3600_length_1235_cov_8.696303	765	845	11	27	80	0.3375000
NODE_3600_length_1235_cov_8.696303	818	898	7	4	80	0.0500000
NODE_3600_length_1235_cov_8.696303	818	898	10	6	80	0.0750000
NODE_3600_length_1235_cov_8.696303	818	898	11	70	80	0.8750000
NODE_3601_length_1235_cov_5.580106	544	624	1	12	80	0.1500000
NODE_3601_length_1235_cov_5.580106	544	624	2	68	80	0.8500000
NODE_3601_length_1235_cov_5.580106	597	677	1	65	80	0.8125000
NODE_3601_length_1235_cov_5.580106	597	677	2	15	80	0.1875000
NODE_3608_length_1234_cov_27.136564	528	608	2	40	80	0.5000000
NODE_3608_length_1234_cov_27.136564	528	608	4	7	80	0.0875000
NODE_3608_length_1234_cov_27.136564	528	608	18	2	80	0.0250000
NODE_3608_length_1234_cov_27.136564	528	608	23	31	80	0.3875000
NODE_3608_length_1234_cov_27.136564	581	661	23	67	80	0.8375000
NODE_3608_length_1234_cov_27.136564	581	661	24	4	80	0.0500000
NODE_3608_length_1234_cov_27.136564	581	661	26	9	80	0.1125000
NODE_3611_length_1233_cov_64.374780	497	577	26	2	80	0.0250000
NODE_3611_length_1233_cov_64.374780	497	577	28	3	80	0.0375000
NODE_3611_length_1233_cov_64.374780	497	577	29	2	80	0.0250000
NODE_3611_length_1233_cov_64.374780	497	577	31	11	80	0.1375000
NODE_3611_length_1233_cov_64.374780	497	577	33	4	80	0.0500000
NODE_3611_length_1233_cov_64.374780	497	577	35	1	80	0.0125000
NODE_3611_length_1233_cov_64.374780	497	577	36	4	80	0.0500000
NODE_3611_length_1233_cov_64.374780	497	577	38	7	80	0.0875000
NODE_3611_length_1233_cov_64.374780	497	577	39	7	80	0.0875000
NODE_3611_length_1233_cov_64.374780	497	577	40	8	80	0.1000000
NODE_3611_length_1233_cov_64.374780	497	577	41	1	80	0.0125000
NODE_3611_length_1233_cov_64.374780	497	577	42	2	80	0.0250000
NODE_3611_length_1233_cov_64.374780	497	577	43	1	80	0.0125000
NODE_3611_length_1233_cov_64.374780	497	577	44	8	80	0.1000000
NODE_3611_length_1233_cov_64.374780	497	577	45	6	80	0.0750000
NODE_3611_length_1233_cov_64.374780	497	577	46	13	80	0.1625000
NODE_3611_length_1233_cov_64.374780	550	630	36	1	80	0.0125000
NODE_3611_length_1233_cov_64.374780	550	630	37	2	80	0.0250000
NODE_3611_length_1233_cov_64.374780	550	630	38	4	80	0.0500000
NODE_3611_length_1233_cov_64.374780	550	630	39	11	80	0.1375000
NODE_3611_length_1233_cov_64.374780	550	630	40	2	80	0.0250000
NODE_3611_length_1233_cov_64.374780	550	630	43	7	80	0.0875000
NODE_3611_length_1233_cov_64.374780	550	630	44	11	80	0.1375000
NODE_3611_length_1233_cov_64.374780	550	630	45	11	80	0.1375000
NODE_3611_length_1233_cov_64.374780	550	630	46	22	80	0.2750000
NODE_3611_length_1233_cov_64.374780	550	630	47	9	80	0.1125000
NODE_3611_length_1233_cov_64.374780	626	706	24	7	80	0.0875000
NODE_3611_length_1233_cov_64.374780	626	706	30	1	80	0.0125000
NODE_3611_length_1233_cov_64.374780	626	706	31	35	80	0.4375000
NODE_3611_length_1233_cov_64.374780	626	706	32	1	80	0.0125000
NODE_3611_length_1233_cov_64.374780	626	706	33	12	80	0.1500000
NODE_3611_length_1233_cov_64.374780	626	706	34	9	80	0.1125000
NODE_3611_length_1233_cov_64.374780	626	706	35	1	80	0.0125000
NODE_3611_length_1233_cov_64.374780	626	706	38	10	80	0.1250000
NODE_3611_length_1233_cov_64.374780	626	706	40	4	80	0.0500000
NODE_3611_length_1233_cov_64.374780	679	759	18	19	80	0.2375000
NODE_3611_length_1233_cov_64.374780	679	759	19	6	80	0.0750000
NODE_3611_length_1233_cov_64.374780	679	759	21	28	80	0.3500000
NODE_3611_length_1233_cov_64.374780	679	759	24	7	80	0.0875000
NODE_3611_length_1233_cov_64.374780	679	759	31	18	80	0.2250000
NODE_3611_length_1233_cov_64.374780	679	759	33	1	80	0.0125000
NODE_3611_length_1233_cov_64.374780	679	759	35	1	80	0.0125000
NODE_3612_length_1233_cov_52.833333	654	734	7	6	80	0.0750000
NODE_3612_length_1233_cov_52.833333	654	734	9	8	80	0.1000000
NODE_3612_length_1233_cov_52.833333	654	734	10	28	80	0.3500000
NODE_3612_length_1233_cov_52.833333	654	734	11	3	80	0.0375000
NODE_3612_length_1233_cov_52.833333	654	734	12	10	80	0.1250000
NODE_3612_length_1233_cov_52.833333	654	734	13	10	80	0.1250000
NODE_3612_length_1233_cov_52.833333	654	734	14	1	80	0.0125000
NODE_3612_length_1233_cov_52.833333	654	734	16	4	80	0.0500000
NODE_3612_length_1233_cov_52.833333	654	734	17	10	80	0.1250000
NODE_3612_length_1233_cov_52.833333	707	787	11	2	80	0.0250000
NODE_3612_length_1233_cov_52.833333	707	787	13	10	80	0.1250000
NODE_3612_length_1233_cov_52.833333	707	787	14	14	80	0.1750000
NODE_3612_length_1233_cov_52.833333	707	787	16	13	80	0.1625000
NODE_3612_length_1233_cov_52.833333	707	787	17	41	80	0.5125000
NODE_3613_length_1233_cov_18.096120	522	602	8	2	80	0.0250000
NODE_3613_length_1233_cov_18.096120	522	602	9	9	80	0.1125000
NODE_3613_length_1233_cov_18.096120	522	602	10	11	80	0.1375000
NODE_3613_length_1233_cov_18.096120	522	602	11	26	80	0.3250000
NODE_3613_length_1233_cov_18.096120	522	602	13	2	80	0.0250000
NODE_3613_length_1233_cov_18.096120	522	602	14	17	80	0.2125000
NODE_3613_length_1233_cov_18.096120	522	602	15	13	80	0.1625000
NODE_3613_length_1233_cov_18.096120	575	655	14	42	80	0.5250000
NODE_3613_length_1233_cov_18.096120	575	655	15	38	80	0.4750000
NODE_3613_length_1233_cov_18.096120	651	731	5	10	80	0.1250000
NODE_3613_length_1233_cov_18.096120	651	731	7	17	80	0.2125000
NODE_3613_length_1233_cov_18.096120	651	731	10	10	80	0.1250000
NODE_3613_length_1233_cov_18.096120	651	731	11	11	80	0.1375000
NODE_3613_length_1233_cov_18.096120	651	731	12	9	80	0.1125000
NODE_3613_length_1233_cov_18.096120	651	731	13	3	80	0.0375000
NODE_3613_length_1233_cov_18.096120	651	731	14	20	80	0.2500000
NODE_3613_length_1233_cov_18.096120	704	784	2	13	80	0.1625000
NODE_3613_length_1233_cov_18.096120	704	784	3	2	80	0.0250000
NODE_3613_length_1233_cov_18.096120	704	784	4	32	80	0.4000000
NODE_3613_length_1233_cov_18.096120	704	784	5	16	80	0.2000000
NODE_3613_length_1233_cov_18.096120	704	784	7	17	80	0.2125000
NODE_3614_length_1233_cov_15.360670	585	656	1	18	71	0.2535211
NODE_3614_length_1233_cov_15.360670	585	656	2	4	71	0.0563380
NODE_3614_length_1233_cov_15.360670	585	656	3	49	71	0.6901408
NODE_3614_length_1233_cov_15.360670	631	709	3	78	78	1.0000000
NODE_3620_length_1232_cov_62.112974	552	632	22	11	80	0.1375000
NODE_3620_length_1232_cov_62.112974	552	632	24	7	80	0.0875000
NODE_3620_length_1232_cov_62.112974	552	632	25	2	80	0.0250000
NODE_3620_length_1232_cov_62.112974	552	632	27	6	80	0.0750000
NODE_3620_length_1232_cov_62.112974	552	632	28	2	80	0.0250000
NODE_3620_length_1232_cov_62.112974	552	632	29	2	80	0.0250000
NODE_3620_length_1232_cov_62.112974	552	632	32	2	80	0.0250000
NODE_3620_length_1232_cov_62.112974	552	632	33	6	80	0.0750000
NODE_3620_length_1232_cov_62.112974	552	632	34	4	80	0.0500000
NODE_3620_length_1232_cov_62.112974	552	632	35	1	80	0.0125000
NODE_3620_length_1232_cov_62.112974	552	632	36	5	80	0.0625000
NODE_3620_length_1232_cov_62.112974	552	632	37	15	80	0.1875000
NODE_3620_length_1232_cov_62.112974	552	632	38	14	80	0.1750000
NODE_3620_length_1232_cov_62.112974	552	632	39	3	80	0.0375000
NODE_3620_length_1232_cov_62.112974	605	694	32	21	89	0.2359551
NODE_3620_length_1232_cov_62.112974	605	694	33	10	89	0.1123596
NODE_3620_length_1232_cov_62.112974	605	694	34	18	89	0.2022472
NODE_3620_length_1232_cov_62.112974	605	694	35	12	89	0.1348315
NODE_3620_length_1232_cov_62.112974	605	694	36	5	89	0.0561798
NODE_3620_length_1232_cov_62.112974	605	694	37	14	89	0.1573034
NODE_3620_length_1232_cov_62.112974	605	694	38	7	89	0.0786517
NODE_3620_length_1232_cov_62.112974	605	694	39	2	89	0.0224719
NODE_3620_length_1232_cov_62.112974	690	770	13	1	80	0.0125000
NODE_3620_length_1232_cov_62.112974	690	770	14	6	80	0.0750000
NODE_3620_length_1232_cov_62.112974	690	770	15	1	80	0.0125000
NODE_3620_length_1232_cov_62.112974	690	770	16	6	80	0.0750000
NODE_3620_length_1232_cov_62.112974	690	770	17	1	80	0.0125000
NODE_3620_length_1232_cov_62.112974	690	770	18	1	80	0.0125000
NODE_3620_length_1232_cov_62.112974	690	770	20	5	80	0.0625000
NODE_3620_length_1232_cov_62.112974	690	770	21	6	80	0.0750000
NODE_3620_length_1232_cov_62.112974	690	770	22	2	80	0.0250000
NODE_3620_length_1232_cov_62.112974	690	770	23	2	80	0.0250000
NODE_3620_length_1232_cov_62.112974	690	770	24	2	80	0.0250000
NODE_3620_length_1232_cov_62.112974	690	770	25	8	80	0.1000000
NODE_3620_length_1232_cov_62.112974	690	770	26	1	80	0.0125000
NODE_3620_length_1232_cov_62.112974	690	770	28	14	80	0.1750000
NODE_3620_length_1232_cov_62.112974	690	770	29	3	80	0.0375000
NODE_3620_length_1232_cov_62.112974	690	770	30	8	80	0.1000000
NODE_3620_length_1232_cov_62.112974	690	770	31	2	80	0.0250000
NODE_3620_length_1232_cov_62.112974	690	770	32	1	80	0.0125000
NODE_3620_length_1232_cov_62.112974	690	770	34	7	80	0.0875000
NODE_3620_length_1232_cov_62.112974	690	770	35	3	80	0.0375000
NODE_3620_length_1232_cov_62.112974	743	823	9	2	80	0.0250000
NODE_3620_length_1232_cov_62.112974	743	823	10	11	80	0.1375000
NODE_3620_length_1232_cov_62.112974	743	823	12	1	80	0.0125000
NODE_3620_length_1232_cov_62.112974	743	823	13	40	80	0.5000000
NODE_3620_length_1232_cov_62.112974	743	823	14	6	80	0.0750000
NODE_3620_length_1232_cov_62.112974	743	823	15	1	80	0.0125000
NODE_3620_length_1232_cov_62.112974	743	823	16	6	80	0.0750000
NODE_3620_length_1232_cov_62.112974	743	823	17	1	80	0.0125000
NODE_3620_length_1232_cov_62.112974	743	823	18	1	80	0.0125000
NODE_3620_length_1232_cov_62.112974	743	823	20	5	80	0.0625000
NODE_3620_length_1232_cov_62.112974	743	823	21	6	80	0.0750000
NODE_3621_length_1232_cov_34.635481	469	549	4	57	80	0.7125000
NODE_3621_length_1232_cov_34.635481	469	549	6	23	80	0.2875000
NODE_3621_length_1232_cov_34.635481	522	602	4	4	80	0.0500000
NODE_3621_length_1232_cov_34.635481	522	602	6	72	80	0.9000000
NODE_3621_length_1232_cov_34.635481	522	602	7	3	80	0.0375000
NODE_3621_length_1232_cov_34.635481	522	602	8	1	80	0.0125000
NODE_3622_length_1232_cov_16.362754	774	854	0	80	80	1.0000000
NODE_3622_length_1232_cov_16.362754	827	907	0	80	80	1.0000000
NODE_3623_length_1232_cov_13.395410	234	315	2	81	81	1.0000000
NODE_3623_length_1232_cov_13.395410	287	368	0	16	81	0.1975309
NODE_3623_length_1232_cov_13.395410	287	368	2	65	81	0.8024691
NODE_3623_length_1232_cov_13.395410	364	444	0	23	80	0.2875000
NODE_3623_length_1232_cov_13.395410	364	444	2	57	80	0.7125000
NODE_3623_length_1232_cov_13.395410	417	497	2	80	80	1.0000000
NODE_3625_length_1231_cov_47.606890	509	589	1	63	80	0.7875000
NODE_3625_length_1231_cov_47.606890	509	589	2	11	80	0.1375000
NODE_3625_length_1231_cov_47.606890	509	589	3	6	80	0.0750000
NODE_3625_length_1231_cov_47.606890	562	642	1	10	80	0.1250000
NODE_3625_length_1231_cov_47.606890	562	642	2	13	80	0.1625000
NODE_3625_length_1231_cov_47.606890	562	642	3	32	80	0.4000000
NODE_3625_length_1231_cov_47.606890	562	642	4	25	80	0.3125000
NODE_3625_length_1231_cov_47.606890	638	718	4	10	80	0.1250000
NODE_3625_length_1231_cov_47.606890	638	718	10	65	80	0.8125000
NODE_3625_length_1231_cov_47.606890	638	718	11	5	80	0.0625000
NODE_3625_length_1231_cov_47.606890	691	771	8	4	80	0.0500000
NODE_3625_length_1231_cov_47.606890	691	771	9	18	80	0.2250000
NODE_3625_length_1231_cov_47.606890	691	771	10	49	80	0.6125000
NODE_3625_length_1231_cov_47.606890	691	771	11	9	80	0.1125000
NODE_3626_length_1231_cov_27.498233	698	777	6	16	79	0.2025317
NODE_3626_length_1231_cov_27.498233	698	777	7	37	79	0.4683544
NODE_3626_length_1231_cov_27.498233	698	777	8	11	79	0.1392405
NODE_3626_length_1231_cov_27.498233	698	777	9	15	79	0.1898734
NODE_3626_length_1231_cov_27.498233	750	830	6	32	80	0.4000000
NODE_3626_length_1231_cov_27.498233	750	830	7	19	80	0.2375000
NODE_3626_length_1231_cov_27.498233	750	830	8	29	80	0.3625000
NODE_3627_length_1231_cov_21.245583	673	753	10	10	80	0.1250000
NODE_3627_length_1231_cov_21.245583	673	753	11	2	80	0.0250000
NODE_3627_length_1231_cov_21.245583	673	753	12	15	80	0.1875000
NODE_3627_length_1231_cov_21.245583	673	753	14	9	80	0.1125000
NODE_3627_length_1231_cov_21.245583	673	753	15	4	80	0.0500000
NODE_3627_length_1231_cov_21.245583	673	753	16	6	80	0.0750000
NODE_3627_length_1231_cov_21.245583	673	753	18	2	80	0.0250000
NODE_3627_length_1231_cov_21.245583	673	753	20	2	80	0.0250000
NODE_3627_length_1231_cov_21.245583	673	753	22	1	80	0.0125000
NODE_3627_length_1231_cov_21.245583	673	753	23	9	80	0.1125000
NODE_3627_length_1231_cov_21.245583	673	753	24	12	80	0.1500000
NODE_3627_length_1231_cov_21.245583	673	753	25	8	80	0.1000000
NODE_3627_length_1231_cov_21.245583	726	806	22	7	80	0.0875000
NODE_3627_length_1231_cov_21.245583	726	806	23	26	80	0.3250000
NODE_3627_length_1231_cov_21.245583	726	806	24	36	80	0.4500000
NODE_3627_length_1231_cov_21.245583	726	806	25	11	80	0.1375000
NODE_3627_length_1231_cov_21.245583	802	882	9	8	80	0.1000000
NODE_3627_length_1231_cov_21.245583	802	882	10	1	80	0.0125000
NODE_3627_length_1231_cov_21.245583	802	882	12	2	80	0.0250000
NODE_3627_length_1231_cov_21.245583	802	882	14	2	80	0.0250000
NODE_3627_length_1231_cov_21.245583	802	882	16	10	80	0.1250000
NODE_3627_length_1231_cov_21.245583	802	882	17	9	80	0.1125000
NODE_3627_length_1231_cov_21.245583	802	882	18	13	80	0.1625000
NODE_3627_length_1231_cov_21.245583	802	882	19	4	80	0.0500000
NODE_3627_length_1231_cov_21.245583	802	882	20	11	80	0.1375000
NODE_3627_length_1231_cov_21.245583	802	882	21	3	80	0.0375000
NODE_3627_length_1231_cov_21.245583	802	882	22	15	80	0.1875000
NODE_3627_length_1231_cov_21.245583	802	882	23	2	80	0.0250000
NODE_3627_length_1231_cov_21.245583	860	935	5	7	75	0.0933333
NODE_3627_length_1231_cov_21.245583	860	935	6	32	75	0.4266667
NODE_3627_length_1231_cov_21.245583	860	935	7	13	75	0.1733333
NODE_3627_length_1231_cov_21.245583	860	935	9	9	75	0.1200000
NODE_3627_length_1231_cov_21.245583	860	935	10	1	75	0.0133333
NODE_3627_length_1231_cov_21.245583	860	935	12	2	75	0.0266667
NODE_3627_length_1231_cov_21.245583	860	935	14	2	75	0.0266667
NODE_3627_length_1231_cov_21.245583	860	935	16	9	75	0.1200000
NODE_3628_length_1231_cov_9.895760	515	595	8	8	80	0.1000000
NODE_3628_length_1231_cov_9.895760	515	595	10	22	80	0.2750000
NODE_3628_length_1231_cov_9.895760	515	595	12	50	80	0.6250000
NODE_3628_length_1231_cov_9.895760	568	648	4	18	80	0.2250000
NODE_3628_length_1231_cov_9.895760	568	648	6	1	80	0.0125000
NODE_3628_length_1231_cov_9.895760	568	648	8	38	80	0.4750000
NODE_3628_length_1231_cov_9.895760	568	648	10	22	80	0.2750000
NODE_3628_length_1231_cov_9.895760	568	648	12	1	80	0.0125000
NODE_3630_length_1230_cov_43.705570	412	492	14	1	80	0.0125000
NODE_3630_length_1230_cov_43.705570	412	492	16	54	80	0.6750000
NODE_3630_length_1230_cov_43.705570	412	492	18	4	80	0.0500000
NODE_3630_length_1230_cov_43.705570	412	492	19	12	80	0.1500000
NODE_3630_length_1230_cov_43.705570	412	492	20	9	80	0.1125000
NODE_3630_length_1230_cov_43.705570	465	545	10	16	80	0.2000000
NODE_3630_length_1230_cov_43.705570	465	545	11	4	80	0.0500000
NODE_3630_length_1230_cov_43.705570	465	545	12	14	80	0.1750000
NODE_3630_length_1230_cov_43.705570	465	545	13	8	80	0.1000000
NODE_3630_length_1230_cov_43.705570	465	545	14	12	80	0.1500000
NODE_3630_length_1230_cov_43.705570	465	545	16	24	80	0.3000000
NODE_3630_length_1230_cov_43.705570	465	545	19	2	80	0.0250000
NODE_3631_length_1230_cov_43.663130	501	581	6	6	80	0.0750000
NODE_3631_length_1230_cov_43.663130	501	581	7	5	80	0.0625000
NODE_3631_length_1230_cov_43.663130	501	581	8	33	80	0.4125000
NODE_3631_length_1230_cov_43.663130	501	581	9	14	80	0.1750000
NODE_3631_length_1230_cov_43.663130	501	581	11	18	80	0.2250000
NODE_3631_length_1230_cov_43.663130	501	581	12	1	80	0.0125000
NODE_3631_length_1230_cov_43.663130	501	581	13	3	80	0.0375000
NODE_3631_length_1230_cov_43.663130	554	634	9	5	80	0.0625000
NODE_3631_length_1230_cov_43.663130	554	634	11	18	80	0.2250000
NODE_3631_length_1230_cov_43.663130	554	634	12	3	80	0.0375000
NODE_3631_length_1230_cov_43.663130	554	634	13	6	80	0.0750000
NODE_3631_length_1230_cov_43.663130	554	634	15	10	80	0.1250000
NODE_3631_length_1230_cov_43.663130	554	634	16	1	80	0.0125000
NODE_3631_length_1230_cov_43.663130	554	634	17	37	80	0.4625000
NODE_3632_length_1230_cov_33.173298	315	395	11	12	80	0.1500000
NODE_3632_length_1230_cov_33.173298	315	395	13	5	80	0.0625000
NODE_3632_length_1230_cov_33.173298	315	395	14	2	80	0.0250000
NODE_3632_length_1230_cov_33.173298	315	395	15	16	80	0.2000000
NODE_3632_length_1230_cov_33.173298	315	395	16	2	80	0.0250000
NODE_3632_length_1230_cov_33.173298	315	395	17	2	80	0.0250000
NODE_3632_length_1230_cov_33.173298	315	395	18	4	80	0.0500000
NODE_3632_length_1230_cov_33.173298	315	395	20	9	80	0.1125000
NODE_3632_length_1230_cov_33.173298	315	395	21	1	80	0.0125000
NODE_3632_length_1230_cov_33.173298	315	395	23	23	80	0.2875000
NODE_3632_length_1230_cov_33.173298	315	395	24	1	80	0.0125000
NODE_3632_length_1230_cov_33.173298	315	395	25	3	80	0.0375000
NODE_3632_length_1230_cov_33.173298	368	448	18	6	80	0.0750000
NODE_3632_length_1230_cov_33.173298	368	448	23	23	80	0.2875000
NODE_3632_length_1230_cov_33.173298	368	448	24	17	80	0.2125000
NODE_3632_length_1230_cov_33.173298	368	448	25	22	80	0.2750000
NODE_3632_length_1230_cov_33.173298	368	448	26	12	80	0.1500000
NODE_3633_length_1230_cov_12.939876	201	281	1	80	80	1.0000000
NODE_3633_length_1230_cov_12.939876	218	273	1	55	55	1.0000000
NODE_3633_length_1230_cov_12.939876	254	334	1	43	80	0.5375000
NODE_3633_length_1230_cov_12.939876	254	334	2	37	80	0.4625000
NODE_3633_length_1230_cov_12.939876	330	410	1	77	80	0.9625000
NODE_3633_length_1230_cov_12.939876	330	410	2	3	80	0.0375000
NODE_3633_length_1230_cov_12.939876	383	463	0	17	80	0.2125000
NODE_3633_length_1230_cov_12.939876	383	463	1	63	80	0.7875000
NODE_3634_length_1230_cov_5.155615	248	328	0	80	80	1.0000000
NODE_3634_length_1230_cov_5.155615	301	381	0	80	80	1.0000000
NODE_3640_length_1229_cov_30.214159	341	421	0	7	80	0.0875000
NODE_3640_length_1229_cov_30.214159	341	421	3	73	80	0.9125000
NODE_3640_length_1229_cov_30.214159	394	474	3	35	80	0.4375000
NODE_3640_length_1229_cov_30.214159	394	474	6	45	80	0.5625000
NODE_3641_length_1229_cov_23.165487	376	456	1	10	80	0.1250000
NODE_3641_length_1229_cov_23.165487	376	456	4	3	80	0.0375000
NODE_3641_length_1229_cov_23.165487	376	456	5	7	80	0.0875000
NODE_3641_length_1229_cov_23.165487	376	456	6	34	80	0.4250000
NODE_3641_length_1229_cov_23.165487	376	456	8	1	80	0.0125000
NODE_3641_length_1229_cov_23.165487	376	456	9	6	80	0.0750000
NODE_3641_length_1229_cov_23.165487	376	456	10	3	80	0.0375000
NODE_3641_length_1229_cov_23.165487	376	456	11	8	80	0.1000000
NODE_3641_length_1229_cov_23.165487	376	456	12	8	80	0.1000000
NODE_3641_length_1229_cov_23.165487	429	509	6	1	80	0.0125000
NODE_3641_length_1229_cov_23.165487	429	509	8	1	80	0.0125000
NODE_3641_length_1229_cov_23.165487	429	509	9	6	80	0.0750000
NODE_3641_length_1229_cov_23.165487	429	509	10	3	80	0.0375000
NODE_3641_length_1229_cov_23.165487	429	509	11	8	80	0.1000000
NODE_3641_length_1229_cov_23.165487	429	509	12	29	80	0.3625000
NODE_3641_length_1229_cov_23.165487	429	509	13	20	80	0.2500000
NODE_3641_length_1229_cov_23.165487	429	509	15	12	80	0.1500000
NODE_3641_length_1229_cov_23.165487	505	585	8	5	80	0.0625000
NODE_3641_length_1229_cov_23.165487	505	585	10	1	80	0.0125000
NODE_3641_length_1229_cov_23.165487	505	585	11	33	80	0.4125000
NODE_3641_length_1229_cov_23.165487	505	585	12	7	80	0.0875000
NODE_3641_length_1229_cov_23.165487	505	585	13	3	80	0.0375000
NODE_3641_length_1229_cov_23.165487	505	585	14	11	80	0.1375000
NODE_3641_length_1229_cov_23.165487	505	585	15	20	80	0.2500000
NODE_3641_length_1229_cov_23.165487	558	638	6	23	80	0.2875000
NODE_3641_length_1229_cov_23.165487	558	638	7	27	80	0.3375000
NODE_3641_length_1229_cov_23.165487	558	638	8	8	80	0.1000000
NODE_3641_length_1229_cov_23.165487	558	638	10	1	80	0.0125000
NODE_3641_length_1229_cov_23.165487	558	638	11	21	80	0.2625000
NODE_3642_length_1229_cov_19.376991	484	564	12	6	80	0.0750000
NODE_3642_length_1229_cov_19.376991	484	564	13	4	80	0.0500000
NODE_3642_length_1229_cov_19.376991	484	564	14	15	80	0.1875000
NODE_3642_length_1229_cov_19.376991	484	564	15	2	80	0.0250000
NODE_3642_length_1229_cov_19.376991	484	564	16	4	80	0.0500000
NODE_3642_length_1229_cov_19.376991	484	564	17	9	80	0.1125000
NODE_3642_length_1229_cov_19.376991	484	564	18	3	80	0.0375000
NODE_3642_length_1229_cov_19.376991	484	564	19	1	80	0.0125000
NODE_3642_length_1229_cov_19.376991	484	564	22	8	80	0.1000000
NODE_3642_length_1229_cov_19.376991	484	564	23	8	80	0.1000000
NODE_3642_length_1229_cov_19.376991	484	564	24	8	80	0.1000000
NODE_3642_length_1229_cov_19.376991	484	564	25	12	80	0.1500000
NODE_3642_length_1229_cov_19.376991	537	614	22	7	77	0.0909091
NODE_3642_length_1229_cov_19.376991	537	614	24	12	77	0.1558442
NODE_3642_length_1229_cov_19.376991	537	614	25	21	77	0.2727273
NODE_3642_length_1229_cov_19.376991	537	614	26	14	77	0.1818182
NODE_3642_length_1229_cov_19.376991	537	614	27	23	77	0.2987013
NODE_3643_length_1229_cov_11.799115	670	748	6	66	78	0.8461539
NODE_3643_length_1229_cov_11.799115	670	748	7	7	78	0.0897436
NODE_3643_length_1229_cov_11.799115	670	748	8	5	78	0.0641026
NODE_3643_length_1229_cov_11.799115	728	801	1	11	73	0.1506849
NODE_3643_length_1229_cov_11.799115	728	801	2	32	73	0.4383562
NODE_3643_length_1229_cov_11.799115	728	801	4	5	73	0.0684932
NODE_3643_length_1229_cov_11.799115	728	801	6	25	73	0.3424658
NODE_3644_length_1229_cov_8.140708	970	1050	0	80	80	1.0000000
NODE_3644_length_1229_cov_8.140708	1023	1103	0	80	80	1.0000000
NODE_3646_length_1229_cov_3.654867	765	840	0	75	75	1.0000000
NODE_3646_length_1229_cov_3.654867	813	893	0	80	80	1.0000000
NODE_3652_length_1229_cov_0.949558	1034	1079	0	45	45	1.0000000
NODE_3652_length_1229_cov_0.949558	1090	1130	0	40	40	1.0000000
NODE_3654_length_1228_cov_22.622675	604	684	2	30	80	0.3750000
NODE_3654_length_1228_cov_22.622675	604	684	4	21	80	0.2625000
NODE_3654_length_1228_cov_22.622675	604	684	5	29	80	0.3625000
NODE_3654_length_1228_cov_22.622675	657	738	4	8	81	0.0987654
NODE_3654_length_1228_cov_22.622675	657	738	5	44	81	0.5432099
NODE_3654_length_1228_cov_22.622675	657	738	7	29	81	0.3580247
NODE_3655_length_1228_cov_17.900797	423	503	0	80	80	1.0000000
NODE_3655_length_1228_cov_17.900797	423	503	0	80	80	1.0000000
NODE_3655_length_1228_cov_17.900797	423	503	0	80	80	1.0000000
NODE_3655_length_1228_cov_17.900797	476	538	0	62	62	1.0000000
NODE_3655_length_1228_cov_17.900797	476	538	0	62	62	1.0000000
NODE_3655_length_1228_cov_17.900797	476	538	0	62	62	1.0000000
NODE_3655_length_1228_cov_17.900797	476	556	0	80	80	1.0000000
NODE_3656_length_1228_cov_14.554473	367	447	2	15	80	0.1875000
NODE_3656_length_1228_cov_14.554473	367	447	3	14	80	0.1750000
NODE_3656_length_1228_cov_14.554473	367	447	4	51	80	0.6375000
NODE_3656_length_1228_cov_14.554473	420	500	3	29	80	0.3625000
NODE_3656_length_1228_cov_14.554473	420	500	4	51	80	0.6375000
NODE_3657_length_1228_cov_10.021258	661	741	12	54	80	0.6750000
NODE_3657_length_1228_cov_10.021258	661	741	13	26	80	0.3250000
NODE_3657_length_1228_cov_10.021258	714	794	7	22	80	0.2750000
NODE_3657_length_1228_cov_10.021258	714	794	8	24	80	0.3000000
NODE_3657_length_1228_cov_10.021258	714	794	11	5	80	0.0625000
NODE_3657_length_1228_cov_10.021258	714	794	12	20	80	0.2500000
NODE_3657_length_1228_cov_10.021258	714	794	13	9	80	0.1125000
NODE_3660_length_1228_cov_3.987600	1139	1219	0	80	80	1.0000000
NODE_3662_length_1227_cov_29.002660	423	503	18	12	80	0.1500000
NODE_3662_length_1227_cov_29.002660	423	503	19	24	80	0.3000000
NODE_3662_length_1227_cov_29.002660	423	503	21	16	80	0.2000000
NODE_3662_length_1227_cov_29.002660	423	503	23	3	80	0.0375000
NODE_3662_length_1227_cov_29.002660	423	503	24	25	80	0.3125000
NODE_3662_length_1227_cov_29.002660	476	556	13	1	80	0.0125000
NODE_3662_length_1227_cov_29.002660	476	556	14	14	80	0.1750000
NODE_3662_length_1227_cov_29.002660	476	556	15	10	80	0.1250000
NODE_3662_length_1227_cov_29.002660	476	556	16	14	80	0.1750000
NODE_3662_length_1227_cov_29.002660	476	556	18	18	80	0.2250000
NODE_3662_length_1227_cov_29.002660	476	556	19	12	80	0.1500000
NODE_3662_length_1227_cov_29.002660	476	556	23	1	80	0.0125000
NODE_3662_length_1227_cov_29.002660	476	556	24	10	80	0.1250000
NODE_3663_length_1227_cov_17.479610	759	839	4	17	80	0.2125000
NODE_3663_length_1227_cov_17.479610	759	839	6	38	80	0.4750000
NODE_3663_length_1227_cov_17.479610	759	839	8	7	80	0.0875000
NODE_3663_length_1227_cov_17.479610	759	839	10	18	80	0.2250000
NODE_3663_length_1227_cov_17.479610	812	892	6	2	80	0.0250000
NODE_3663_length_1227_cov_17.479610	812	892	8	23	80	0.2875000
NODE_3663_length_1227_cov_17.479610	812	892	9	7	80	0.0875000
NODE_3663_length_1227_cov_17.479610	812	892	10	45	80	0.5625000
NODE_3663_length_1227_cov_17.479610	812	892	11	2	80	0.0250000
NODE_3663_length_1227_cov_17.479610	812	892	12	1	80	0.0125000
NODE_3666_length_1227_cov_3.808511	120	186	3	4	66	0.0606061
NODE_3666_length_1227_cov_3.808511	120	186	4	62	66	0.9393939
NODE_3666_length_1227_cov_3.808511	173	239	2	3	66	0.0454545
NODE_3666_length_1227_cov_3.808511	173	239	3	37	66	0.5606061
NODE_3666_length_1227_cov_3.808511	173	239	4	26	66	0.3939394
NODE_3666_length_1227_cov_3.808511	229	299	0	25	70	0.3571429
NODE_3666_length_1227_cov_3.808511	229	299	1	13	70	0.1857143
NODE_3666_length_1227_cov_3.808511	229	299	2	25	70	0.3571429
NODE_3666_length_1227_cov_3.808511	229	299	3	7	70	0.1000000
NODE_3672_length_1226_cov_23.792369	579	659	4	50	80	0.6250000
NODE_3672_length_1226_cov_23.792369	579	659	5	30	80	0.3750000
NODE_3672_length_1226_cov_23.792369	632	712	4	39	80	0.4875000
NODE_3672_length_1226_cov_23.792369	632	712	5	6	80	0.0750000
NODE_3672_length_1226_cov_23.792369	632	712	6	1	80	0.0125000
NODE_3672_length_1226_cov_23.792369	632	712	7	23	80	0.2875000
NODE_3672_length_1226_cov_23.792369	632	712	8	11	80	0.1375000
NODE_3672_length_1226_cov_23.792369	708	788	4	42	80	0.5250000
NODE_3672_length_1226_cov_23.792369	708	788	6	35	80	0.4375000
NODE_3672_length_1226_cov_23.792369	708	788	8	3	80	0.0375000
NODE_3672_length_1226_cov_23.792369	761	839	3	12	78	0.1538462
NODE_3672_length_1226_cov_23.792369	761	839	4	4	78	0.0512821
NODE_3672_length_1226_cov_23.792369	761	839	5	6	78	0.0769231
NODE_3672_length_1226_cov_23.792369	761	839	6	56	78	0.7179487
NODE_3673_length_1226_cov_5.620231	463	543	0	80	80	1.0000000
NODE_3673_length_1226_cov_5.620231	516	596	0	80	80	1.0000000
NODE_3674_length_1226_cov_4.881988	582	662	8	39	80	0.4875000
NODE_3674_length_1226_cov_4.881988	582	662	11	24	80	0.3000000
NODE_3674_length_1226_cov_4.881988	582	662	12	17	80	0.2125000
NODE_3674_length_1226_cov_4.881988	635	715	8	80	80	1.0000000
NODE_3682_length_1225_cov_55.596803	637	717	44	12	80	0.1500000
NODE_3682_length_1225_cov_55.596803	637	717	45	2	80	0.0250000
NODE_3682_length_1225_cov_55.596803	637	717	46	3	80	0.0375000
NODE_3682_length_1225_cov_55.596803	637	717	47	11	80	0.1375000
NODE_3682_length_1225_cov_55.596803	637	717	48	2	80	0.0250000
NODE_3682_length_1225_cov_55.596803	637	717	50	8	80	0.1000000
NODE_3682_length_1225_cov_55.596803	637	717	51	6	80	0.0750000
NODE_3682_length_1225_cov_55.596803	637	717	52	8	80	0.1000000
NODE_3682_length_1225_cov_55.596803	637	717	54	7	80	0.0875000
NODE_3682_length_1225_cov_55.596803	637	717	55	13	80	0.1625000
NODE_3682_length_1225_cov_55.596803	637	717	56	2	80	0.0250000
NODE_3682_length_1225_cov_55.596803	637	717	59	1	80	0.0125000
NODE_3682_length_1225_cov_55.596803	637	717	60	5	80	0.0625000
NODE_3682_length_1225_cov_55.596803	690	770	28	1	80	0.0125000
NODE_3682_length_1225_cov_55.596803	690	770	29	3	80	0.0375000
NODE_3682_length_1225_cov_55.596803	690	770	30	4	80	0.0500000
NODE_3682_length_1225_cov_55.596803	690	770	33	1	80	0.0125000
NODE_3682_length_1225_cov_55.596803	690	770	35	6	80	0.0750000
NODE_3682_length_1225_cov_55.596803	690	770	36	4	80	0.0500000
NODE_3682_length_1225_cov_55.596803	690	770	42	2	80	0.0250000
NODE_3682_length_1225_cov_55.596803	690	770	43	3	80	0.0375000
NODE_3682_length_1225_cov_55.596803	690	770	44	4	80	0.0500000
NODE_3682_length_1225_cov_55.596803	690	770	49	1	80	0.0125000
NODE_3682_length_1225_cov_55.596803	690	770	50	1	80	0.0125000
NODE_3682_length_1225_cov_55.596803	690	770	52	9	80	0.1125000
NODE_3682_length_1225_cov_55.596803	690	770	53	10	80	0.1250000
NODE_3682_length_1225_cov_55.596803	690	770	54	6	80	0.0750000
NODE_3682_length_1225_cov_55.596803	690	770	55	15	80	0.1875000
NODE_3682_length_1225_cov_55.596803	690	770	56	2	80	0.0250000
NODE_3682_length_1225_cov_55.596803	690	770	57	1	80	0.0125000
NODE_3682_length_1225_cov_55.596803	690	770	58	1	80	0.0125000
NODE_3682_length_1225_cov_55.596803	690	770	59	1	80	0.0125000
NODE_3682_length_1225_cov_55.596803	690	770	60	5	80	0.0625000
NODE_3682_length_1225_cov_55.596803	766	846	12	7	80	0.0875000
NODE_3682_length_1225_cov_55.596803	766	846	15	8	80	0.1000000
NODE_3682_length_1225_cov_55.596803	766	846	16	4	80	0.0500000
NODE_3682_length_1225_cov_55.596803	766	846	17	21	80	0.2625000
NODE_3682_length_1225_cov_55.596803	766	846	18	1	80	0.0125000
NODE_3682_length_1225_cov_55.596803	766	846	19	1	80	0.0125000
NODE_3682_length_1225_cov_55.596803	766	846	20	1	80	0.0125000
NODE_3682_length_1225_cov_55.596803	766	846	21	1	80	0.0125000
NODE_3682_length_1225_cov_55.596803	766	846	23	14	80	0.1750000
NODE_3682_length_1225_cov_55.596803	766	846	24	5	80	0.0625000
NODE_3682_length_1225_cov_55.596803	766	846	25	8	80	0.1000000
NODE_3682_length_1225_cov_55.596803	766	846	26	1	80	0.0125000
NODE_3682_length_1225_cov_55.596803	766	846	28	1	80	0.0125000
NODE_3682_length_1225_cov_55.596803	766	846	29	4	80	0.0500000
NODE_3682_length_1225_cov_55.596803	766	846	30	3	80	0.0375000
NODE_3682_length_1225_cov_55.596803	819	899	6	4	80	0.0500000
NODE_3682_length_1225_cov_55.596803	819	899	7	23	80	0.2875000
NODE_3682_length_1225_cov_55.596803	819	899	8	11	80	0.1375000
NODE_3682_length_1225_cov_55.596803	819	899	11	15	80	0.1875000
NODE_3682_length_1225_cov_55.596803	819	899	12	7	80	0.0875000
NODE_3682_length_1225_cov_55.596803	819	899	15	8	80	0.1000000
NODE_3682_length_1225_cov_55.596803	819	899	16	4	80	0.0500000
NODE_3682_length_1225_cov_55.596803	819	899	17	8	80	0.1000000
NODE_3683_length_1225_cov_35.189165	661	742	8	33	81	0.4074074
NODE_3683_length_1225_cov_35.189165	661	742	9	19	81	0.2345679
NODE_3683_length_1225_cov_35.189165	661	742	10	29	81	0.3580247
NODE_3683_length_1225_cov_35.189165	714	795	4	20	81	0.2469136
NODE_3683_length_1225_cov_35.189165	714	795	5	1	81	0.0123457
NODE_3683_length_1225_cov_35.189165	714	795	6	2	81	0.0246914
NODE_3683_length_1225_cov_35.189165	714	795	8	8	81	0.0987654
NODE_3683_length_1225_cov_35.189165	714	795	9	9	81	0.1111111
NODE_3683_length_1225_cov_35.189165	714	795	10	41	81	0.5061728
NODE_3684_length_1225_cov_33.755773	456	535	14	3	79	0.0379747
NODE_3684_length_1225_cov_33.755773	456	535	17	1	79	0.0126582
NODE_3684_length_1225_cov_33.755773	456	535	18	7	79	0.0886076
NODE_3684_length_1225_cov_33.755773	456	535	19	1	79	0.0126582
NODE_3684_length_1225_cov_33.755773	456	535	20	33	79	0.4177215
NODE_3684_length_1225_cov_33.755773	456	535	21	10	79	0.1265823
NODE_3684_length_1225_cov_33.755773	456	535	22	24	79	0.3037975
NODE_3684_length_1225_cov_33.755773	508	588	12	4	80	0.0500000
NODE_3684_length_1225_cov_33.755773	508	588	13	17	80	0.2125000
NODE_3684_length_1225_cov_33.755773	508	588	15	1	80	0.0125000
NODE_3684_length_1225_cov_33.755773	508	588	16	5	80	0.0625000
NODE_3684_length_1225_cov_33.755773	508	588	18	33	80	0.4125000
NODE_3684_length_1225_cov_33.755773	508	588	19	1	80	0.0125000
NODE_3684_length_1225_cov_33.755773	508	588	20	17	80	0.2125000
NODE_3684_length_1225_cov_33.755773	508	588	21	2	80	0.0250000
NODE_3685_length_1225_cov_30.116341	566	646	1	6	80	0.0750000
NODE_3685_length_1225_cov_30.116341	566	646	4	10	80	0.1250000
NODE_3685_length_1225_cov_30.116341	566	646	5	58	80	0.7250000
NODE_3685_length_1225_cov_30.116341	566	646	8	6	80	0.0750000
NODE_3685_length_1225_cov_30.116341	619	699	5	21	80	0.2625000
NODE_3685_length_1225_cov_30.116341	619	699	8	20	80	0.2500000
NODE_3685_length_1225_cov_30.116341	619	699	9	19	80	0.2375000
NODE_3685_length_1225_cov_30.116341	619	699	10	20	80	0.2500000
NODE_3685_length_1225_cov_30.116341	695	775	7	2	80	0.0250000
NODE_3685_length_1225_cov_30.116341	695	775	8	12	80	0.1500000
NODE_3685_length_1225_cov_30.116341	695	775	9	39	80	0.4875000
NODE_3685_length_1225_cov_30.116341	695	775	10	12	80	0.1500000
NODE_3685_length_1225_cov_30.116341	695	775	11	15	80	0.1875000
NODE_3685_length_1225_cov_30.116341	748	828	4	1	80	0.0125000
NODE_3685_length_1225_cov_30.116341	748	828	5	17	80	0.2125000
NODE_3685_length_1225_cov_30.116341	748	828	6	20	80	0.2500000
NODE_3685_length_1225_cov_30.116341	748	828	8	1	80	0.0125000
NODE_3685_length_1225_cov_30.116341	748	828	9	41	80	0.5125000
NODE_3686_length_1225_cov_29.177620	195	275	17	2	80	0.0250000
NODE_3686_length_1225_cov_29.177620	195	275	18	6	80	0.0750000
NODE_3686_length_1225_cov_29.177620	195	275	19	3	80	0.0375000
NODE_3686_length_1225_cov_29.177620	195	275	20	8	80	0.1000000
NODE_3686_length_1225_cov_29.177620	195	275	21	13	80	0.1625000
NODE_3686_length_1225_cov_29.177620	195	275	22	10	80	0.1250000
NODE_3686_length_1225_cov_29.177620	195	275	23	3	80	0.0375000
NODE_3686_length_1225_cov_29.177620	195	275	24	4	80	0.0500000
NODE_3686_length_1225_cov_29.177620	195	275	28	6	80	0.0750000
NODE_3686_length_1225_cov_29.177620	195	275	29	25	80	0.3125000
NODE_3686_length_1225_cov_29.177620	248	328	24	12	80	0.1500000
NODE_3686_length_1225_cov_29.177620	248	328	25	18	80	0.2250000
NODE_3686_length_1225_cov_29.177620	248	328	27	1	80	0.0125000
NODE_3686_length_1225_cov_29.177620	248	328	28	10	80	0.1250000
NODE_3686_length_1225_cov_29.177620	248	328	29	37	80	0.4625000
NODE_3686_length_1225_cov_29.177620	248	328	30	2	80	0.0250000
NODE_3687_length_1225_cov_26.849023	588	668	3	36	80	0.4500000
NODE_3687_length_1225_cov_26.849023	588	668	4	41	80	0.5125000
NODE_3687_length_1225_cov_26.849023	588	668	5	3	80	0.0375000
NODE_3687_length_1225_cov_26.849023	641	721	2	37	80	0.4625000
NODE_3687_length_1225_cov_26.849023	641	721	3	22	80	0.2750000
NODE_3687_length_1225_cov_26.849023	641	721	4	21	80	0.2625000
NODE_3687_length_1225_cov_26.849023	717	797	2	31	80	0.3875000
NODE_3687_length_1225_cov_26.849023	717	797	3	26	80	0.3250000
NODE_3687_length_1225_cov_26.849023	717	797	4	23	80	0.2875000
NODE_3687_length_1225_cov_26.849023	770	850	2	76	80	0.9500000
NODE_3687_length_1225_cov_26.849023	770	850	4	4	80	0.0500000
NODE_3688_length_1225_cov_24.444938	386	466	7	6	80	0.0750000
NODE_3688_length_1225_cov_24.444938	386	466	9	41	80	0.5125000
NODE_3688_length_1225_cov_24.444938	386	466	10	6	80	0.0750000
NODE_3688_length_1225_cov_24.444938	386	466	11	5	80	0.0625000
NODE_3688_length_1225_cov_24.444938	386	466	12	22	80	0.2750000
NODE_3688_length_1225_cov_24.444938	439	519	7	59	80	0.7375000
NODE_3688_length_1225_cov_24.444938	439	519	9	11	80	0.1375000
NODE_3688_length_1225_cov_24.444938	439	519	10	5	80	0.0625000
NODE_3688_length_1225_cov_24.444938	439	519	11	5	80	0.0625000
NODE_3690_length_1225_cov_19.369449	491	571	0	80	80	1.0000000
NODE_3690_length_1225_cov_19.369449	544	624	0	80	80	1.0000000
NODE_3690_length_1225_cov_19.369449	620	700	0	34	80	0.4250000
NODE_3690_length_1225_cov_19.369449	620	700	1	46	80	0.5750000
NODE_3690_length_1225_cov_19.369449	673	753	1	80	80	1.0000000
NODE_3691_length_1225_cov_13.281528	462	542	8	51	80	0.6375000
NODE_3691_length_1225_cov_13.281528	462	542	10	29	80	0.3625000
NODE_3691_length_1225_cov_13.281528	515	595	7	13	80	0.1625000
NODE_3691_length_1225_cov_13.281528	515	595	8	23	80	0.2875000
NODE_3691_length_1225_cov_13.281528	515	595	9	30	80	0.3750000
NODE_3691_length_1225_cov_13.281528	515	595	10	14	80	0.1750000
NODE_3691_length_1225_cov_13.281528	591	671	5	31	80	0.3875000
NODE_3691_length_1225_cov_13.281528	591	671	7	32	80	0.4000000
NODE_3691_length_1225_cov_13.281528	591	671	9	7	80	0.0875000
NODE_3691_length_1225_cov_13.281528	591	671	10	10	80	0.1250000
NODE_3691_length_1225_cov_13.281528	644	724	2	5	80	0.0625000
NODE_3691_length_1225_cov_13.281528	644	724	3	8	80	0.1000000
NODE_3691_length_1225_cov_13.281528	644	724	5	62	80	0.7750000
NODE_3691_length_1225_cov_13.281528	644	724	6	5	80	0.0625000
NODE_3692_length_1225_cov_10.887211	566	646	0	8	80	0.1000000
NODE_3692_length_1225_cov_10.887211	566	646	1	37	80	0.4625000
NODE_3692_length_1225_cov_10.887211	566	646	2	14	80	0.1750000
NODE_3692_length_1225_cov_10.887211	566	646	3	21	80	0.2625000
NODE_3692_length_1225_cov_10.887211	619	699	2	6	80	0.0750000
NODE_3692_length_1225_cov_10.887211	619	699	3	22	80	0.2750000
NODE_3692_length_1225_cov_10.887211	619	699	4	52	80	0.6500000
NODE_3696_length_1224_cov_24.568889	613	693	3	22	80	0.2750000
NODE_3696_length_1224_cov_24.568889	613	693	4	13	80	0.1625000
NODE_3696_length_1224_cov_24.568889	613	693	5	45	80	0.5625000
NODE_3696_length_1224_cov_24.568889	666	746	5	52	80	0.6500000
NODE_3696_length_1224_cov_24.568889	666	746	6	12	80	0.1500000
NODE_3696_length_1224_cov_24.568889	666	746	7	3	80	0.0375000
NODE_3696_length_1224_cov_24.568889	666	746	8	13	80	0.1625000
NODE_3697_length_1224_cov_17.538667	762	842	6	8	80	0.1000000
NODE_3697_length_1224_cov_17.538667	762	842	8	1	80	0.0125000
NODE_3697_length_1224_cov_17.538667	762	842	10	5	80	0.0625000
NODE_3697_length_1224_cov_17.538667	762	842	12	1	80	0.0125000
NODE_3697_length_1224_cov_17.538667	762	842	13	2	80	0.0250000
NODE_3697_length_1224_cov_17.538667	762	842	14	6	80	0.0750000
NODE_3697_length_1224_cov_17.538667	762	842	15	12	80	0.1500000
NODE_3697_length_1224_cov_17.538667	762	842	16	1	80	0.0125000
NODE_3697_length_1224_cov_17.538667	762	842	19	4	80	0.0500000
NODE_3697_length_1224_cov_17.538667	762	842	20	18	80	0.2250000
NODE_3697_length_1224_cov_17.538667	762	842	21	1	80	0.0125000
NODE_3697_length_1224_cov_17.538667	762	842	24	1	80	0.0125000
NODE_3697_length_1224_cov_17.538667	762	842	25	15	80	0.1875000
NODE_3697_length_1224_cov_17.538667	762	842	28	5	80	0.0625000
NODE_3697_length_1224_cov_17.538667	815	895	20	5	80	0.0625000
NODE_3697_length_1224_cov_17.538667	815	895	21	1	80	0.0125000
NODE_3697_length_1224_cov_17.538667	815	895	23	49	80	0.6125000
NODE_3697_length_1224_cov_17.538667	815	895	24	1	80	0.0125000
NODE_3697_length_1224_cov_17.538667	815	895	25	15	80	0.1875000
NODE_3697_length_1224_cov_17.538667	815	895	26	4	80	0.0500000
NODE_3697_length_1224_cov_17.538667	815	895	28	5	80	0.0625000
NODE_3698_length_1224_cov_14.138667	389	469	2	8	80	0.1000000
NODE_3698_length_1224_cov_14.138667	389	469	4	22	80	0.2750000
NODE_3698_length_1224_cov_14.138667	389	469	5	32	80	0.4000000
NODE_3698_length_1224_cov_14.138667	389	469	6	1	80	0.0125000
NODE_3698_length_1224_cov_14.138667	389	469	7	17	80	0.2125000
NODE_3698_length_1224_cov_14.138667	442	522	2	21	80	0.2625000
NODE_3698_length_1224_cov_14.138667	442	522	3	40	80	0.5000000
NODE_3698_length_1224_cov_14.138667	442	522	4	19	80	0.2375000
NODE_3699_length_1224_cov_11.358222	704	784	12	80	80	1.0000000
NODE_3699_length_1224_cov_11.358222	757	837	12	37	80	0.4625000
NODE_3699_length_1224_cov_11.358222	757	837	13	6	80	0.0750000
NODE_3699_length_1224_cov_11.358222	757	837	14	13	80	0.1625000
NODE_3699_length_1224_cov_11.358222	757	837	15	1	80	0.0125000
NODE_3699_length_1224_cov_11.358222	757	837	16	4	80	0.0500000
NODE_3699_length_1224_cov_11.358222	757	837	17	5	80	0.0625000
NODE_3699_length_1224_cov_11.358222	757	837	18	6	80	0.0750000
NODE_3699_length_1224_cov_11.358222	757	837	19	8	80	0.1000000
NODE_3700_length_1224_cov_6.963556	516	581	1	6	65	0.0923077
NODE_3700_length_1224_cov_6.963556	516	581	2	59	65	0.9076923
NODE_3705_length_1223_cov_44.608541	548	630	7	5	82	0.0609756
NODE_3705_length_1223_cov_44.608541	548	630	9	3	82	0.0365854
NODE_3705_length_1223_cov_44.608541	548	630	10	43	82	0.5243902
NODE_3705_length_1223_cov_44.608541	548	630	11	18	82	0.2195122
NODE_3705_length_1223_cov_44.608541	548	630	12	13	82	0.1585366
NODE_3705_length_1223_cov_44.608541	601	683	7	31	82	0.3780488
NODE_3705_length_1223_cov_44.608541	601	683	8	27	82	0.3292683
NODE_3705_length_1223_cov_44.608541	601	683	9	1	82	0.0121951
NODE_3705_length_1223_cov_44.608541	601	683	10	23	82	0.2804878
NODE_3705_length_1223_cov_44.608541	679	759	2	5	80	0.0625000
NODE_3705_length_1223_cov_44.608541	679	759	3	28	80	0.3500000
NODE_3705_length_1223_cov_44.608541	679	759	4	26	80	0.3250000
NODE_3705_length_1223_cov_44.608541	679	759	6	5	80	0.0625000
NODE_3705_length_1223_cov_44.608541	679	759	7	15	80	0.1875000
NODE_3705_length_1223_cov_44.608541	679	759	8	1	80	0.0125000
NODE_3705_length_1223_cov_44.608541	732	812	3	11	80	0.1375000
NODE_3705_length_1223_cov_44.608541	732	812	4	16	80	0.2000000
NODE_3705_length_1223_cov_44.608541	732	812	5	9	80	0.1125000
NODE_3705_length_1223_cov_44.608541	732	812	6	6	80	0.0750000
NODE_3705_length_1223_cov_44.608541	732	812	7	38	80	0.4750000
NODE_3706_length_1223_cov_26.730427	508	588	5	10	80	0.1250000
NODE_3706_length_1223_cov_26.730427	508	588	6	36	80	0.4500000
NODE_3706_length_1223_cov_26.730427	508	588	7	4	80	0.0500000
NODE_3706_length_1223_cov_26.730427	508	588	9	17	80	0.2125000
NODE_3706_length_1223_cov_26.730427	508	588	10	13	80	0.1625000
NODE_3706_length_1223_cov_26.730427	561	641	6	8	80	0.1000000
NODE_3706_length_1223_cov_26.730427	561	641	7	33	80	0.4125000
NODE_3706_length_1223_cov_26.730427	561	641	9	28	80	0.3500000
NODE_3706_length_1223_cov_26.730427	561	641	10	11	80	0.1375000
NODE_3707_length_1223_cov_18.902135	460	540	9	5	80	0.0625000
NODE_3707_length_1223_cov_18.902135	460	540	12	14	80	0.1750000
NODE_3707_length_1223_cov_18.902135	460	540	13	23	80	0.2875000
NODE_3707_length_1223_cov_18.902135	460	540	14	37	80	0.4625000
NODE_3707_length_1223_cov_18.902135	460	540	15	1	80	0.0125000
NODE_3707_length_1223_cov_18.902135	513	593	4	7	80	0.0875000
NODE_3707_length_1223_cov_18.902135	513	593	5	10	80	0.1250000
NODE_3707_length_1223_cov_18.902135	513	593	7	13	80	0.1625000
NODE_3707_length_1223_cov_18.902135	513	593	9	22	80	0.2750000
NODE_3707_length_1223_cov_18.902135	513	593	10	6	80	0.0750000
NODE_3707_length_1223_cov_18.902135	513	593	12	14	80	0.1750000
NODE_3707_length_1223_cov_18.902135	513	593	13	8	80	0.1000000
NODE_3708_length_1223_cov_6.989324	707	778	0	2	71	0.0281690
NODE_3708_length_1223_cov_6.989324	707	778	2	69	71	0.9718310
NODE_3710_length_1223_cov_5.251779	666	746	2	9	80	0.1125000
NODE_3710_length_1223_cov_5.251779	666	746	3	3	80	0.0375000
NODE_3710_length_1223_cov_5.251779	666	746	4	46	80	0.5750000
NODE_3710_length_1223_cov_5.251779	666	746	5	1	80	0.0125000
NODE_3710_length_1223_cov_5.251779	666	746	6	14	80	0.1750000
NODE_3710_length_1223_cov_5.251779	666	746	7	7	80	0.0875000
NODE_3710_length_1223_cov_5.251779	719	799	4	5	80	0.0625000
NODE_3710_length_1223_cov_5.251779	719	799	5	12	80	0.1500000
NODE_3710_length_1223_cov_5.251779	719	799	6	23	80	0.2875000
NODE_3710_length_1223_cov_5.251779	719	799	7	40	80	0.5000000
NODE_3710_length_1223_cov_5.251779	795	875	2	1	80	0.0125000
NODE_3710_length_1223_cov_5.251779	795	875	4	46	80	0.5750000
NODE_3710_length_1223_cov_5.251779	795	875	5	12	80	0.1500000
NODE_3710_length_1223_cov_5.251779	795	875	6	21	80	0.2625000
NODE_3710_length_1223_cov_5.251779	848	928	1	39	80	0.4875000
NODE_3710_length_1223_cov_5.251779	848	928	2	15	80	0.1875000
NODE_3710_length_1223_cov_5.251779	848	928	4	26	80	0.3250000
NODE_3716_length_1222_cov_18.406946	273	353	1	11	80	0.1375000
NODE_3716_length_1222_cov_18.406946	273	353	3	7	80	0.0875000
NODE_3716_length_1222_cov_18.406946	273	353	4	2	80	0.0250000
NODE_3716_length_1222_cov_18.406946	273	353	5	32	80	0.4000000
NODE_3716_length_1222_cov_18.406946	273	353	6	28	80	0.3500000
NODE_3716_length_1222_cov_18.406946	326	406	6	42	80	0.5250000
NODE_3716_length_1222_cov_18.406946	326	406	8	38	80	0.4750000
NODE_3720_length_1221_cov_33.261141	505	577	6	8	72	0.1111111
NODE_3720_length_1221_cov_33.261141	505	577	8	56	72	0.7777778
NODE_3720_length_1221_cov_33.261141	505	577	9	3	72	0.0416667
NODE_3720_length_1221_cov_33.261141	505	577	10	5	72	0.0694444
NODE_3720_length_1221_cov_33.261141	558	637	8	11	79	0.1392405
NODE_3720_length_1221_cov_33.261141	558	637	9	3	79	0.0379747
NODE_3720_length_1221_cov_33.261141	558	637	10	8	79	0.1012658
NODE_3720_length_1221_cov_33.261141	558	637	11	2	79	0.0253165
NODE_3720_length_1221_cov_33.261141	558	637	12	25	79	0.3164557
NODE_3720_length_1221_cov_33.261141	558	637	13	9	79	0.1139240
NODE_3720_length_1221_cov_33.261141	558	637	14	21	79	0.2658228
NODE_3720_length_1221_cov_33.261141	633	713	12	4	80	0.0500000
NODE_3720_length_1221_cov_33.261141	633	713	13	73	80	0.9125000
NODE_3720_length_1221_cov_33.261141	633	713	15	3	80	0.0375000
NODE_3720_length_1221_cov_33.261141	686	766	5	10	80	0.1250000
NODE_3720_length_1221_cov_33.261141	686	766	6	20	80	0.2500000
NODE_3720_length_1221_cov_33.261141	686	766	7	7	80	0.0875000
NODE_3720_length_1221_cov_33.261141	686	766	8	2	80	0.0250000
NODE_3720_length_1221_cov_33.261141	686	766	9	7	80	0.0875000
NODE_3720_length_1221_cov_33.261141	686	766	10	3	80	0.0375000
NODE_3720_length_1221_cov_33.261141	686	766	11	2	80	0.0250000
NODE_3720_length_1221_cov_33.261141	686	766	13	29	80	0.3625000
NODE_3721_length_1221_cov_19.466132	541	621	5	21	80	0.2625000
NODE_3721_length_1221_cov_19.466132	541	621	6	12	80	0.1500000
NODE_3721_length_1221_cov_19.466132	541	621	7	47	80	0.5875000
NODE_3721_length_1221_cov_19.466132	594	674	4	3	80	0.0375000
NODE_3721_length_1221_cov_19.466132	594	674	5	12	80	0.1500000
NODE_3721_length_1221_cov_19.466132	594	674	6	18	80	0.2250000
NODE_3721_length_1221_cov_19.466132	594	674	7	47	80	0.5875000
NODE_3722_length_1221_cov_15.940285	788	868	6	8	80	0.1000000
NODE_3722_length_1221_cov_15.940285	788	868	7	17	80	0.2125000
NODE_3722_length_1221_cov_15.940285	788	868	8	19	80	0.2375000
NODE_3722_length_1221_cov_15.940285	788	868	9	17	80	0.2125000
NODE_3722_length_1221_cov_15.940285	788	868	10	19	80	0.2375000
NODE_3722_length_1221_cov_15.940285	841	921	9	8	80	0.1000000
NODE_3722_length_1221_cov_15.940285	841	921	10	21	80	0.2625000
NODE_3722_length_1221_cov_15.940285	841	921	12	19	80	0.2375000
NODE_3722_length_1221_cov_15.940285	841	921	13	5	80	0.0625000
NODE_3722_length_1221_cov_15.940285	841	921	14	2	80	0.0250000
NODE_3722_length_1221_cov_15.940285	841	921	15	25	80	0.3125000
NODE_3722_length_1221_cov_15.940285	917	997	14	7	80	0.0875000
NODE_3722_length_1221_cov_15.940285	917	997	15	22	80	0.2750000
NODE_3722_length_1221_cov_15.940285	917	997	16	19	80	0.2375000
NODE_3722_length_1221_cov_15.940285	917	997	17	25	80	0.3125000
NODE_3722_length_1221_cov_15.940285	917	997	18	7	80	0.0875000
NODE_3722_length_1221_cov_15.940285	970	1050	7	7	80	0.0875000
NODE_3722_length_1221_cov_15.940285	970	1050	9	2	80	0.0250000
NODE_3722_length_1221_cov_15.940285	970	1050	10	2	80	0.0250000
NODE_3722_length_1221_cov_15.940285	970	1050	12	19	80	0.2375000
NODE_3722_length_1221_cov_15.940285	970	1050	14	21	80	0.2625000
NODE_3722_length_1221_cov_15.940285	970	1050	15	17	80	0.2125000
NODE_3722_length_1221_cov_15.940285	970	1050	16	12	80	0.1500000
NODE_3723_length_1221_cov_15.796791	484	564	5	12	80	0.1500000
NODE_3723_length_1221_cov_15.796791	484	564	6	55	80	0.6875000
NODE_3723_length_1221_cov_15.796791	484	564	7	10	80	0.1250000
NODE_3723_length_1221_cov_15.796791	484	564	8	3	80	0.0375000
NODE_3723_length_1221_cov_15.796791	537	617	1	18	80	0.2250000
NODE_3723_length_1221_cov_15.796791	537	617	2	9	80	0.1125000
NODE_3723_length_1221_cov_15.796791	537	617	3	5	80	0.0625000
NODE_3723_length_1221_cov_15.796791	537	617	4	13	80	0.1625000
NODE_3723_length_1221_cov_15.796791	537	617	5	2	80	0.0250000
NODE_3723_length_1221_cov_15.796791	537	617	6	33	80	0.4125000
NODE_3724_length_1221_cov_15.312834	342	415	21	1	73	0.0136986
NODE_3724_length_1221_cov_15.312834	342	415	23	2	73	0.0273973
NODE_3724_length_1221_cov_15.312834	342	415	24	9	73	0.1232877
NODE_3724_length_1221_cov_15.312834	342	415	25	38	73	0.5205479
NODE_3724_length_1221_cov_15.312834	342	415	26	11	73	0.1506849
NODE_3724_length_1221_cov_15.312834	342	415	27	2	73	0.0273973
NODE_3724_length_1221_cov_15.312834	342	415	28	3	73	0.0410959
NODE_3724_length_1221_cov_15.312834	342	415	29	7	73	0.0958904
NODE_3724_length_1221_cov_15.312834	395	474	19	1	79	0.0126582
NODE_3724_length_1221_cov_15.312834	395	474	22	1	79	0.0126582
NODE_3724_length_1221_cov_15.312834	395	474	23	2	79	0.0253165
NODE_3724_length_1221_cov_15.312834	395	474	24	4	79	0.0506329
NODE_3724_length_1221_cov_15.312834	395	474	25	17	79	0.2151899
NODE_3724_length_1221_cov_15.312834	395	474	26	10	79	0.1265823
NODE_3724_length_1221_cov_15.312834	395	474	27	5	79	0.0632911
NODE_3724_length_1221_cov_15.312834	395	474	28	23	79	0.2911392
NODE_3724_length_1221_cov_15.312834	395	474	29	16	79	0.2025317
NODE_3725_length_1221_cov_9.695187	988	1068	0	80	80	1.0000000
NODE_3725_length_1221_cov_9.695187	1041	1100	0	59	59	1.0000000
NODE_3726_length_1221_cov_9.043672	695	775	0	80	80	1.0000000
NODE_3726_length_1221_cov_9.043672	748	828	0	80	80	1.0000000
NODE_3727_length_1221_cov_7.946524	147	227	0	80	80	1.0000000
NODE_3727_length_1221_cov_7.946524	200	280	0	80	80	1.0000000
NODE_3728_length_1221_cov_5.122103	248	328	0	80	80	1.0000000
NODE_3728_length_1221_cov_5.122103	301	381	0	80	80	1.0000000
NODE_3736_length_1220_cov_44.501338	319	399	0	65	80	0.8125000
NODE_3736_length_1220_cov_44.501338	319	399	4	15	80	0.1875000
NODE_3736_length_1220_cov_44.501338	372	452	0	12	80	0.1500000
NODE_3736_length_1220_cov_44.501338	372	452	4	28	80	0.3500000
NODE_3736_length_1220_cov_44.501338	372	452	5	12	80	0.1500000
NODE_3736_length_1220_cov_44.501338	372	452	6	22	80	0.2750000
NODE_3736_length_1220_cov_44.501338	372	452	7	6	80	0.0750000
NODE_3736_length_1220_cov_44.501338	448	528	7	9	80	0.1125000
NODE_3736_length_1220_cov_44.501338	448	528	8	13	80	0.1625000
NODE_3736_length_1220_cov_44.501338	448	528	10	20	80	0.2500000
NODE_3736_length_1220_cov_44.501338	448	528	11	36	80	0.4500000
NODE_3736_length_1220_cov_44.501338	448	528	13	2	80	0.0250000
NODE_3736_length_1220_cov_44.501338	501	581	8	7	80	0.0875000
NODE_3736_length_1220_cov_44.501338	501	581	9	17	80	0.2125000
NODE_3736_length_1220_cov_44.501338	501	581	10	27	80	0.3375000
NODE_3736_length_1220_cov_44.501338	501	581	11	25	80	0.3125000
NODE_3736_length_1220_cov_44.501338	501	581	13	4	80	0.0500000
NODE_3737_length_1220_cov_43.868867	720	800	7	7	80	0.0875000
NODE_3737_length_1220_cov_43.868867	720	800	8	21	80	0.2625000
NODE_3737_length_1220_cov_43.868867	720	800	9	32	80	0.4000000
NODE_3737_length_1220_cov_43.868867	720	800	10	20	80	0.2500000
NODE_3737_length_1220_cov_43.868867	773	853	4	8	80	0.1000000
NODE_3737_length_1220_cov_43.868867	773	853	5	13	80	0.1625000
NODE_3737_length_1220_cov_43.868867	773	853	7	10	80	0.1250000
NODE_3737_length_1220_cov_43.868867	773	853	8	22	80	0.2750000
NODE_3737_length_1220_cov_43.868867	773	853	9	27	80	0.3375000
NODE_3738_length_1220_cov_41.900089	593	673	25	8	80	0.1000000
NODE_3738_length_1220_cov_41.900089	593	673	26	5	80	0.0625000
NODE_3738_length_1220_cov_41.900089	593	673	27	10	80	0.1250000
NODE_3738_length_1220_cov_41.900089	593	673	28	45	80	0.5625000
NODE_3738_length_1220_cov_41.900089	593	673	35	12	80	0.1500000
NODE_3738_length_1220_cov_41.900089	646	726	17	3	80	0.0375000
NODE_3738_length_1220_cov_41.900089	646	726	18	7	80	0.0875000
NODE_3738_length_1220_cov_41.900089	646	726	19	11	80	0.1375000
NODE_3738_length_1220_cov_41.900089	646	726	21	1	80	0.0125000
NODE_3738_length_1220_cov_41.900089	646	726	23	18	80	0.2250000
NODE_3738_length_1220_cov_41.900089	646	726	24	8	80	0.1000000
NODE_3738_length_1220_cov_41.900089	646	726	25	13	80	0.1625000
NODE_3738_length_1220_cov_41.900089	646	726	26	5	80	0.0625000
NODE_3738_length_1220_cov_41.900089	646	726	27	8	80	0.1000000
NODE_3738_length_1220_cov_41.900089	646	726	28	6	80	0.0750000
NODE_3738_length_1220_cov_41.900089	722	802	5	6	80	0.0750000
NODE_3738_length_1220_cov_41.900089	722	802	6	15	80	0.1875000
NODE_3738_length_1220_cov_41.900089	722	802	7	37	80	0.4625000
NODE_3738_length_1220_cov_41.900089	722	802	8	10	80	0.1250000
NODE_3738_length_1220_cov_41.900089	722	802	9	1	80	0.0125000
NODE_3738_length_1220_cov_41.900089	722	802	10	5	80	0.0625000
NODE_3738_length_1220_cov_41.900089	722	802	17	3	80	0.0375000
NODE_3738_length_1220_cov_41.900089	722	802	19	3	80	0.0375000
NODE_3738_length_1220_cov_41.900089	775	855	6	8	80	0.1000000
NODE_3738_length_1220_cov_41.900089	775	855	7	22	80	0.2750000
NODE_3738_length_1220_cov_41.900089	775	855	8	9	80	0.1125000
NODE_3738_length_1220_cov_41.900089	775	855	11	41	80	0.5125000
NODE_3739_length_1220_cov_15.485281	395	475	7	7	80	0.0875000
NODE_3739_length_1220_cov_15.485281	395	475	9	42	80	0.5250000
NODE_3739_length_1220_cov_15.485281	395	475	10	1	80	0.0125000
NODE_3739_length_1220_cov_15.485281	395	475	11	30	80	0.3750000
NODE_3739_length_1220_cov_15.485281	448	528	2	1	80	0.0125000
NODE_3739_length_1220_cov_15.485281	448	528	3	10	80	0.1250000
NODE_3739_length_1220_cov_15.485281	448	528	5	23	80	0.2875000
NODE_3739_length_1220_cov_15.485281	448	528	6	9	80	0.1125000
NODE_3739_length_1220_cov_15.485281	448	528	7	17	80	0.2125000
NODE_3739_length_1220_cov_15.485281	448	528	9	20	80	0.2500000
NODE_3745_length_1219_cov_30.493750	643	723	10	3	80	0.0375000
NODE_3745_length_1219_cov_30.493750	643	723	11	15	80	0.1875000
NODE_3745_length_1219_cov_30.493750	643	723	12	5	80	0.0625000
NODE_3745_length_1219_cov_30.493750	643	723	13	8	80	0.1000000
NODE_3745_length_1219_cov_30.493750	643	723	14	12	80	0.1500000
NODE_3745_length_1219_cov_30.493750	643	723	15	13	80	0.1625000
NODE_3745_length_1219_cov_30.493750	643	723	16	3	80	0.0375000
NODE_3745_length_1219_cov_30.493750	643	723	19	19	80	0.2375000
NODE_3745_length_1219_cov_30.493750	643	723	20	2	80	0.0250000
NODE_3745_length_1219_cov_30.493750	696	776	15	42	80	0.5250000
NODE_3745_length_1219_cov_30.493750	696	776	16	13	80	0.1625000
NODE_3745_length_1219_cov_30.493750	696	776	17	11	80	0.1375000
NODE_3745_length_1219_cov_30.493750	696	776	18	3	80	0.0375000
NODE_3745_length_1219_cov_30.493750	696	776	19	9	80	0.1125000
NODE_3745_length_1219_cov_30.493750	696	776	20	2	80	0.0250000
NODE_3745_length_1219_cov_30.493750	772	852	8	3	80	0.0375000
NODE_3745_length_1219_cov_30.493750	772	852	9	13	80	0.1625000
NODE_3745_length_1219_cov_30.493750	772	852	11	4	80	0.0500000
NODE_3745_length_1219_cov_30.493750	772	852	12	2	80	0.0250000
NODE_3745_length_1219_cov_30.493750	772	852	13	5	80	0.0625000
NODE_3745_length_1219_cov_30.493750	772	852	14	15	80	0.1875000
NODE_3745_length_1219_cov_30.493750	772	852	15	18	80	0.2250000
NODE_3745_length_1219_cov_30.493750	772	852	16	7	80	0.0875000
NODE_3745_length_1219_cov_30.493750	772	852	17	13	80	0.1625000
NODE_3745_length_1219_cov_30.493750	825	905	4	3	80	0.0375000
NODE_3745_length_1219_cov_30.493750	825	905	5	15	80	0.1875000
NODE_3745_length_1219_cov_30.493750	825	905	7	20	80	0.2500000
NODE_3745_length_1219_cov_30.493750	825	905	8	18	80	0.2250000
NODE_3745_length_1219_cov_30.493750	825	905	9	13	80	0.1625000
NODE_3745_length_1219_cov_30.493750	825	905	15	11	80	0.1375000
NODE_3746_length_1219_cov_24.991071	566	646	7	63	80	0.7875000
NODE_3746_length_1219_cov_24.991071	566	646	8	3	80	0.0375000
NODE_3746_length_1219_cov_24.991071	566	646	9	14	80	0.1750000
NODE_3746_length_1219_cov_24.991071	619	699	4	2	80	0.0250000
NODE_3746_length_1219_cov_24.991071	619	699	5	30	80	0.3750000
NODE_3746_length_1219_cov_24.991071	619	699	7	45	80	0.5625000
NODE_3746_length_1219_cov_24.991071	619	699	8	3	80	0.0375000
NODE_3746_length_1219_cov_24.991071	695	775	5	42	80	0.5250000
NODE_3746_length_1219_cov_24.991071	695	775	6	14	80	0.1750000
NODE_3746_length_1219_cov_24.991071	695	775	7	24	80	0.3000000
NODE_3746_length_1219_cov_24.991071	748	828	5	12	80	0.1500000
NODE_3746_length_1219_cov_24.991071	748	828	7	15	80	0.1875000
NODE_3746_length_1219_cov_24.991071	748	828	8	20	80	0.2500000
NODE_3746_length_1219_cov_24.991071	748	828	9	33	80	0.4125000
NODE_3747_length_1219_cov_24.728571	465	545	0	21	80	0.2625000
NODE_3747_length_1219_cov_24.728571	465	545	1	46	80	0.5750000
NODE_3747_length_1219_cov_24.728571	465	545	2	13	80	0.1625000
NODE_3747_length_1219_cov_24.728571	518	598	1	14	80	0.1750000
NODE_3747_length_1219_cov_24.728571	518	598	2	43	80	0.5375000
NODE_3747_length_1219_cov_24.728571	518	598	3	23	80	0.2875000
NODE_3747_length_1219_cov_24.728571	594	674	3	9	80	0.1125000
NODE_3747_length_1219_cov_24.728571	594	674	5	28	80	0.3500000
NODE_3747_length_1219_cov_24.728571	594	674	6	9	80	0.1125000
NODE_3747_length_1219_cov_24.728571	594	674	7	34	80	0.4250000
NODE_3747_length_1219_cov_24.728571	647	727	5	2	80	0.0250000
NODE_3747_length_1219_cov_24.728571	647	727	6	43	80	0.5375000
NODE_3747_length_1219_cov_24.728571	647	727	7	35	80	0.4375000
NODE_3748_length_1219_cov_11.130357	535	615	4	8	80	0.1000000
NODE_3748_length_1219_cov_11.130357	535	615	5	11	80	0.1375000
NODE_3748_length_1219_cov_11.130357	535	615	6	11	80	0.1375000
NODE_3748_length_1219_cov_11.130357	535	615	7	8	80	0.1000000
NODE_3748_length_1219_cov_11.130357	535	615	9	7	80	0.0875000
NODE_3748_length_1219_cov_11.130357	535	615	11	19	80	0.2375000
NODE_3748_length_1219_cov_11.130357	535	615	13	3	80	0.0375000
NODE_3748_length_1219_cov_11.130357	535	615	14	11	80	0.1375000
NODE_3748_length_1219_cov_11.130357	535	615	15	2	80	0.0250000
NODE_3748_length_1219_cov_11.130357	588	668	11	11	80	0.1375000
NODE_3748_length_1219_cov_11.130357	588	668	13	3	80	0.0375000
NODE_3748_length_1219_cov_11.130357	588	668	14	11	80	0.1375000
NODE_3748_length_1219_cov_11.130357	588	668	15	17	80	0.2125000
NODE_3748_length_1219_cov_11.130357	588	668	17	6	80	0.0750000
NODE_3748_length_1219_cov_11.130357	588	668	18	32	80	0.4000000
NODE_3749_length_1219_cov_9.696429	734	814	0	9	80	0.1125000
NODE_3749_length_1219_cov_9.696429	734	814	1	21	80	0.2625000
NODE_3749_length_1219_cov_9.696429	734	814	2	18	80	0.2250000
NODE_3749_length_1219_cov_9.696429	734	814	3	32	80	0.4000000
NODE_3749_length_1219_cov_9.696429	787	867	3	57	80	0.7125000
NODE_3749_length_1219_cov_9.696429	787	867	4	23	80	0.2875000
NODE_3754_length_1218_cov_40.159071	554	634	13	3	80	0.0375000
NODE_3754_length_1218_cov_40.159071	554	634	14	57	80	0.7125000
NODE_3754_length_1218_cov_40.159071	554	634	15	16	80	0.2000000
NODE_3754_length_1218_cov_40.159071	554	634	17	1	80	0.0125000
NODE_3754_length_1218_cov_40.159071	554	634	18	3	80	0.0375000
NODE_3754_length_1218_cov_40.159071	607	687	10	9	80	0.1125000
NODE_3754_length_1218_cov_40.159071	607	687	12	14	80	0.1750000
NODE_3754_length_1218_cov_40.159071	607	687	13	4	80	0.0500000
NODE_3754_length_1218_cov_40.159071	607	687	14	50	80	0.6250000
NODE_3754_length_1218_cov_40.159071	607	687	15	2	80	0.0250000
NODE_3754_length_1218_cov_40.159071	607	687	18	1	80	0.0125000
NODE_3754_length_1218_cov_40.159071	683	763	3	8	80	0.1000000
NODE_3754_length_1218_cov_40.159071	683	763	4	17	80	0.2125000
NODE_3754_length_1218_cov_40.159071	683	763	5	31	80	0.3875000
NODE_3754_length_1218_cov_40.159071	683	763	6	3	80	0.0375000
NODE_3754_length_1218_cov_40.159071	683	763	8	4	80	0.0500000
NODE_3754_length_1218_cov_40.159071	683	763	9	5	80	0.0625000
NODE_3754_length_1218_cov_40.159071	683	763	10	12	80	0.1500000
NODE_3754_length_1218_cov_40.159071	736	816	3	61	80	0.7625000
NODE_3754_length_1218_cov_40.159071	736	816	4	17	80	0.2125000
NODE_3754_length_1218_cov_40.159071	736	816	5	2	80	0.0250000
NODE_3765_length_1216_cov_99.538944	44	124	11	2	80	0.0250000
NODE_3765_length_1216_cov_99.538944	44	124	12	4	80	0.0500000
NODE_3765_length_1216_cov_99.538944	44	124	14	11	80	0.1375000
NODE_3765_length_1216_cov_99.538944	44	124	15	4	80	0.0500000
NODE_3765_length_1216_cov_99.538944	44	124	16	7	80	0.0875000
NODE_3765_length_1216_cov_99.538944	44	124	18	2	80	0.0250000
NODE_3765_length_1216_cov_99.538944	44	124	20	9	80	0.1125000
NODE_3765_length_1216_cov_99.538944	44	124	22	2	80	0.0250000
NODE_3765_length_1216_cov_99.538944	44	124	23	2	80	0.0250000
NODE_3765_length_1216_cov_99.538944	44	124	25	5	80	0.0625000
NODE_3765_length_1216_cov_99.538944	44	124	26	3	80	0.0375000
NODE_3765_length_1216_cov_99.538944	44	124	27	1	80	0.0125000
NODE_3765_length_1216_cov_99.538944	44	124	32	4	80	0.0500000
NODE_3765_length_1216_cov_99.538944	44	124	34	11	80	0.1375000
NODE_3765_length_1216_cov_99.538944	44	124	35	11	80	0.1375000
NODE_3765_length_1216_cov_99.538944	44	124	36	2	80	0.0250000
NODE_3765_length_1216_cov_99.538944	97	157	32	3	60	0.0500000
NODE_3765_length_1216_cov_99.538944	97	157	34	11	60	0.1833333
NODE_3765_length_1216_cov_99.538944	97	157	35	11	60	0.1833333
NODE_3765_length_1216_cov_99.538944	97	157	36	2	60	0.0333333
NODE_3765_length_1216_cov_99.538944	97	157	37	4	60	0.0666667
NODE_3765_length_1216_cov_99.538944	97	157	38	5	60	0.0833333
NODE_3765_length_1216_cov_99.538944	97	157	39	5	60	0.0833333
NODE_3765_length_1216_cov_99.538944	97	157	41	3	60	0.0500000
NODE_3765_length_1216_cov_99.538944	97	157	43	2	60	0.0333333
NODE_3765_length_1216_cov_99.538944	97	157	45	10	60	0.1666667
NODE_3765_length_1216_cov_99.538944	97	157	46	4	60	0.0666667
NODE_3765_length_1216_cov_99.538944	824	903	1	4	79	0.0506329
NODE_3765_length_1216_cov_99.538944	824	903	3	20	79	0.2531646
NODE_3765_length_1216_cov_99.538944	824	903	4	22	79	0.2784810
NODE_3765_length_1216_cov_99.538944	824	903	5	8	79	0.1012658
NODE_3765_length_1216_cov_99.538944	824	903	10	15	79	0.1898734
NODE_3765_length_1216_cov_99.538944	824	903	11	1	79	0.0126582
NODE_3765_length_1216_cov_99.538944	824	903	12	9	79	0.1139240
NODE_3766_length_1216_cov_15.855864	668	748	0	80	80	1.0000000
NODE_3766_length_1216_cov_15.855864	721	801	0	80	80	1.0000000
NODE_3767_length_1216_cov_4.128917	720	800	0	10	80	0.1250000
NODE_3767_length_1216_cov_4.128917	720	800	4	70	80	0.8750000
NODE_3767_length_1216_cov_4.128917	773	853	0	62	80	0.7750000
NODE_3767_length_1216_cov_4.128917	773	853	4	18	80	0.2250000
NODE_3774_length_1215_cov_32.293011	411	491	7	2	80	0.0250000
NODE_3774_length_1215_cov_32.293011	411	491	8	45	80	0.5625000
NODE_3774_length_1215_cov_32.293011	411	491	9	1	80	0.0125000
NODE_3774_length_1215_cov_32.293011	411	491	10	23	80	0.2875000
NODE_3774_length_1215_cov_32.293011	411	491	11	9	80	0.1125000
NODE_3774_length_1215_cov_32.293011	464	544	6	37	80	0.4625000
NODE_3774_length_1215_cov_32.293011	464	544	8	19	80	0.2375000
NODE_3774_length_1215_cov_32.293011	464	544	9	1	80	0.0125000
NODE_3774_length_1215_cov_32.293011	464	544	10	23	80	0.2875000
NODE_3775_length_1215_cov_24.177419	729	809	4	80	80	1.0000000
NODE_3775_length_1215_cov_24.177419	782	862	4	63	80	0.7875000
NODE_3775_length_1215_cov_24.177419	782	862	6	9	80	0.1125000
NODE_3775_length_1215_cov_24.177419	782	862	7	8	80	0.1000000
NODE_3776_length_1215_cov_21.566308	645	725	14	10	80	0.1250000
NODE_3776_length_1215_cov_21.566308	645	725	15	8	80	0.1000000
NODE_3776_length_1215_cov_21.566308	645	725	16	1	80	0.0125000
NODE_3776_length_1215_cov_21.566308	645	725	18	8	80	0.1000000
NODE_3776_length_1215_cov_21.566308	645	725	19	4	80	0.0500000
NODE_3776_length_1215_cov_21.566308	645	725	30	3	80	0.0375000
NODE_3776_length_1215_cov_21.566308	645	725	32	12	80	0.1500000
NODE_3776_length_1215_cov_21.566308	645	725	33	34	80	0.4250000
NODE_3776_length_1215_cov_21.566308	698	778	30	8	80	0.1000000
NODE_3776_length_1215_cov_21.566308	698	778	31	2	80	0.0250000
NODE_3776_length_1215_cov_21.566308	698	778	32	25	80	0.3125000
NODE_3776_length_1215_cov_21.566308	698	778	33	17	80	0.2125000
NODE_3776_length_1215_cov_21.566308	698	778	34	4	80	0.0500000
NODE_3776_length_1215_cov_21.566308	698	778	35	9	80	0.1125000
NODE_3776_length_1215_cov_21.566308	698	778	36	5	80	0.0625000
NODE_3776_length_1215_cov_21.566308	698	778	37	1	80	0.0125000
NODE_3776_length_1215_cov_21.566308	698	778	38	9	80	0.1125000
NODE_3777_length_1215_cov_19.278674	630	710	9	12	80	0.1500000
NODE_3777_length_1215_cov_19.278674	630	710	10	35	80	0.4375000
NODE_3777_length_1215_cov_19.278674	630	710	12	33	80	0.4125000
NODE_3777_length_1215_cov_19.278674	683	763	2	4	80	0.0500000
NODE_3777_length_1215_cov_19.278674	683	763	3	18	80	0.2250000
NODE_3777_length_1215_cov_19.278674	683	763	5	2	80	0.0250000
NODE_3777_length_1215_cov_19.278674	683	763	6	3	80	0.0375000
NODE_3777_length_1215_cov_19.278674	683	763	7	14	80	0.1750000
NODE_3777_length_1215_cov_19.278674	683	763	8	6	80	0.0750000
NODE_3777_length_1215_cov_19.278674	683	763	9	18	80	0.2250000
NODE_3777_length_1215_cov_19.278674	683	763	10	8	80	0.1000000
NODE_3777_length_1215_cov_19.278674	683	763	12	7	80	0.0875000
NODE_3778_length_1215_cov_15.074373	664	744	7	2	80	0.0250000
NODE_3778_length_1215_cov_15.074373	664	744	8	52	80	0.6500000
NODE_3778_length_1215_cov_15.074373	664	744	10	26	80	0.3250000
NODE_3778_length_1215_cov_15.074373	717	797	4	17	80	0.2125000
NODE_3778_length_1215_cov_15.074373	717	797	5	31	80	0.3875000
NODE_3778_length_1215_cov_15.074373	717	797	6	4	80	0.0500000
NODE_3778_length_1215_cov_15.074373	717	797	7	1	80	0.0125000
NODE_3778_length_1215_cov_15.074373	717	797	8	27	80	0.3375000
NODE_3779_length_1215_cov_5.932796	507	587	0	3	80	0.0375000
NODE_3779_length_1215_cov_5.932796	507	587	2	61	80	0.7625000
NODE_3779_length_1215_cov_5.932796	507	587	4	16	80	0.2000000
NODE_3779_length_1215_cov_5.932796	560	640	0	56	80	0.7000000
NODE_3779_length_1215_cov_5.932796	560	640	2	24	80	0.3000000
NODE_3787_length_1214_cov_26.771300	420	500	16	9	80	0.1125000
NODE_3787_length_1214_cov_26.771300	420	500	18	11	80	0.1375000
NODE_3787_length_1214_cov_26.771300	420	500	19	15	80	0.1875000
NODE_3787_length_1214_cov_26.771300	420	500	20	3	80	0.0375000
NODE_3787_length_1214_cov_26.771300	420	500	22	6	80	0.0750000
NODE_3787_length_1214_cov_26.771300	420	500	23	27	80	0.3375000
NODE_3787_length_1214_cov_26.771300	420	500	24	9	80	0.1125000
NODE_3787_length_1214_cov_26.771300	473	553	3	4	80	0.0500000
NODE_3787_length_1214_cov_26.771300	473	553	4	5	80	0.0625000
NODE_3787_length_1214_cov_26.771300	473	553	5	13	80	0.1625000
NODE_3787_length_1214_cov_26.771300	473	553	8	8	80	0.1000000
NODE_3787_length_1214_cov_26.771300	473	553	11	3	80	0.0375000
NODE_3787_length_1214_cov_26.771300	473	553	12	2	80	0.0250000
NODE_3787_length_1214_cov_26.771300	473	553	16	27	80	0.3375000
NODE_3787_length_1214_cov_26.771300	473	553	18	11	80	0.1375000
NODE_3787_length_1214_cov_26.771300	473	553	19	7	80	0.0875000
NODE_3788_length_1214_cov_24.555157	480	560	6	7	80	0.0875000
NODE_3788_length_1214_cov_24.555157	480	560	7	28	80	0.3500000
NODE_3788_length_1214_cov_24.555157	480	560	8	4	80	0.0500000
NODE_3788_length_1214_cov_24.555157	480	560	10	41	80	0.5125000
NODE_3788_length_1214_cov_24.555157	533	613	8	4	80	0.0500000
NODE_3788_length_1214_cov_24.555157	533	613	9	36	80	0.4500000
NODE_3788_length_1214_cov_24.555157	533	613	10	29	80	0.3625000
NODE_3788_length_1214_cov_24.555157	533	613	11	11	80	0.1375000
NODE_3789_length_1214_cov_23.167713	623	703	10	9	80	0.1125000
NODE_3789_length_1214_cov_23.167713	623	703	11	4	80	0.0500000
NODE_3789_length_1214_cov_23.167713	623	703	12	3	80	0.0375000
NODE_3789_length_1214_cov_23.167713	623	703	13	10	80	0.1250000
NODE_3789_length_1214_cov_23.167713	623	703	14	3	80	0.0375000
NODE_3789_length_1214_cov_23.167713	623	703	15	33	80	0.4125000
NODE_3789_length_1214_cov_23.167713	623	703	16	7	80	0.0875000
NODE_3789_length_1214_cov_23.167713	623	703	17	11	80	0.1375000
NODE_3789_length_1214_cov_23.167713	676	756	13	10	80	0.1250000
NODE_3789_length_1214_cov_23.167713	676	756	14	8	80	0.1000000
NODE_3789_length_1214_cov_23.167713	676	756	15	39	80	0.4875000
NODE_3789_length_1214_cov_23.167713	676	756	16	14	80	0.1750000
NODE_3789_length_1214_cov_23.167713	676	756	17	9	80	0.1125000
NODE_3790_length_1214_cov_18.452915	555	635	0	80	80	1.0000000
NODE_3790_length_1214_cov_18.452915	608	688	0	80	80	1.0000000
NODE_3790_length_1214_cov_18.452915	684	764	0	80	80	1.0000000
NODE_3790_length_1214_cov_18.452915	737	817	0	80	80	1.0000000
NODE_3791_length_1214_cov_8.906726	206	286	0	80	80	1.0000000
NODE_3791_length_1214_cov_8.906726	259	339	0	80	80	1.0000000
NODE_3792_length_1214_cov_3.686996	415	495	2	49	80	0.6125000
NODE_3792_length_1214_cov_3.686996	415	495	4	31	80	0.3875000
NODE_3792_length_1214_cov_3.686996	468	548	2	77	80	0.9625000
NODE_3792_length_1214_cov_3.686996	468	548	4	3	80	0.0375000
NODE_3799_length_1214_cov_0.967713	1049	1129	3	8	80	0.1000000
NODE_3799_length_1214_cov_0.967713	1049	1129	4	42	80	0.5250000
NODE_3799_length_1214_cov_0.967713	1049	1129	5	30	80	0.3750000
NODE_3800_length_1213_cov_19.524237	499	579	0	18	80	0.2250000
NODE_3800_length_1213_cov_19.524237	499	579	2	55	80	0.6875000
NODE_3800_length_1213_cov_19.524237	499	579	5	7	80	0.0875000
NODE_3800_length_1213_cov_19.524237	552	632	2	20	80	0.2500000
NODE_3800_length_1213_cov_19.524237	552	632	5	19	80	0.2375000
NODE_3800_length_1213_cov_19.524237	552	632	6	41	80	0.5125000
NODE_3806_length_1212_cov_32.663073	688	768	25	3	80	0.0375000
NODE_3806_length_1212_cov_32.663073	688	768	26	8	80	0.1000000
NODE_3806_length_1212_cov_32.663073	688	768	27	7	80	0.0875000
NODE_3806_length_1212_cov_32.663073	688	768	28	25	80	0.3125000
NODE_3806_length_1212_cov_32.663073	688	768	29	19	80	0.2375000
NODE_3806_length_1212_cov_32.663073	688	768	30	5	80	0.0625000
NODE_3806_length_1212_cov_32.663073	688	768	31	13	80	0.1625000
NODE_3806_length_1212_cov_32.663073	741	821	17	11	80	0.1375000
NODE_3806_length_1212_cov_32.663073	741	821	19	8	80	0.1000000
NODE_3806_length_1212_cov_32.663073	741	821	20	3	80	0.0375000
NODE_3806_length_1212_cov_32.663073	741	821	22	3	80	0.0375000
NODE_3806_length_1212_cov_32.663073	741	821	23	4	80	0.0500000
NODE_3806_length_1212_cov_32.663073	741	821	24	6	80	0.0750000
NODE_3806_length_1212_cov_32.663073	741	821	25	21	80	0.2625000
NODE_3806_length_1212_cov_32.663073	741	821	26	8	80	0.1000000
NODE_3806_length_1212_cov_32.663073	741	821	27	7	80	0.0875000
NODE_3806_length_1212_cov_32.663073	741	821	28	2	80	0.0250000
NODE_3806_length_1212_cov_32.663073	741	821	29	1	80	0.0125000
NODE_3806_length_1212_cov_32.663073	741	821	30	1	80	0.0125000
NODE_3806_length_1212_cov_32.663073	741	821	31	5	80	0.0625000
NODE_3807_length_1212_cov_15.981132	33	113	0	80	80	1.0000000
NODE_3807_length_1212_cov_15.981132	511	591	4	5	80	0.0625000
NODE_3807_length_1212_cov_15.981132	511	591	6	12	80	0.1500000
NODE_3807_length_1212_cov_15.981132	511	591	7	1	80	0.0125000
NODE_3807_length_1212_cov_15.981132	511	591	8	8	80	0.1000000
NODE_3807_length_1212_cov_15.981132	511	591	9	24	80	0.3000000
NODE_3807_length_1212_cov_15.981132	511	591	10	22	80	0.2750000
NODE_3807_length_1212_cov_15.981132	511	591	11	8	80	0.1000000
NODE_3807_length_1212_cov_15.981132	564	637	10	39	73	0.5342466
NODE_3807_length_1212_cov_15.981132	564	637	11	34	73	0.4657534
NODE_3813_length_1211_cov_30.513489	561	641	6	38	80	0.4750000
NODE_3813_length_1211_cov_30.513489	561	641	10	16	80	0.2000000
NODE_3813_length_1211_cov_30.513489	561	641	12	26	80	0.3250000
NODE_3813_length_1211_cov_30.513489	614	694	6	12	80	0.1500000
NODE_3813_length_1211_cov_30.513489	614	694	7	17	80	0.2125000
NODE_3813_length_1211_cov_30.513489	614	694	10	21	80	0.2625000
NODE_3813_length_1211_cov_30.513489	614	694	11	1	80	0.0125000
NODE_3813_length_1211_cov_30.513489	614	694	12	29	80	0.3625000
NODE_3813_length_1211_cov_30.513489	690	770	8	5	80	0.0625000
NODE_3813_length_1211_cov_30.513489	690	770	9	4	80	0.0500000
NODE_3813_length_1211_cov_30.513489	690	770	10	49	80	0.6125000
NODE_3813_length_1211_cov_30.513489	690	770	13	22	80	0.2750000
NODE_3813_length_1211_cov_30.513489	743	823	8	26	80	0.3250000
NODE_3813_length_1211_cov_30.513489	743	823	9	36	80	0.4500000
NODE_3813_length_1211_cov_30.513489	743	823	10	12	80	0.1500000
NODE_3813_length_1211_cov_30.513489	743	823	13	6	80	0.0750000
NODE_3815_length_1211_cov_10.073741	380	460	1	2	80	0.0250000
NODE_3815_length_1211_cov_10.073741	380	460	2	78	80	0.9750000
NODE_3815_length_1211_cov_10.073741	433	513	0	7	80	0.0875000
NODE_3815_length_1211_cov_10.073741	433	513	1	48	80	0.6000000
NODE_3815_length_1211_cov_10.073741	433	513	2	25	80	0.3125000
NODE_3816_length_1211_cov_7.561151	598	678	6	8	80	0.1000000
NODE_3816_length_1211_cov_7.561151	598	678	8	14	80	0.1750000
NODE_3816_length_1211_cov_7.561151	598	678	9	54	80	0.6750000
NODE_3816_length_1211_cov_7.561151	598	678	10	4	80	0.0500000
NODE_3816_length_1211_cov_7.561151	651	731	4	18	80	0.2250000
NODE_3816_length_1211_cov_7.561151	651	731	5	13	80	0.1625000
NODE_3816_length_1211_cov_7.561151	651	731	6	4	80	0.0500000
NODE_3816_length_1211_cov_7.561151	651	731	8	27	80	0.3375000
NODE_3816_length_1211_cov_7.561151	651	731	9	18	80	0.2250000
NODE_3820_length_1210_cov_49.743474	398	478	29	2	80	0.0250000
NODE_3820_length_1210_cov_49.743474	398	478	30	6	80	0.0750000
NODE_3820_length_1210_cov_49.743474	398	478	31	12	80	0.1500000
NODE_3820_length_1210_cov_49.743474	398	478	32	1	80	0.0125000
NODE_3820_length_1210_cov_49.743474	398	478	34	3	80	0.0375000
NODE_3820_length_1210_cov_49.743474	398	478	36	3	80	0.0375000
NODE_3820_length_1210_cov_49.743474	398	478	37	13	80	0.1625000
NODE_3820_length_1210_cov_49.743474	398	478	39	8	80	0.1000000
NODE_3820_length_1210_cov_49.743474	398	478	40	18	80	0.2250000
NODE_3820_length_1210_cov_49.743474	398	478	41	5	80	0.0625000
NODE_3820_length_1210_cov_49.743474	398	478	42	9	80	0.1125000
NODE_3820_length_1210_cov_49.743474	451	531	24	1	80	0.0125000
NODE_3820_length_1210_cov_49.743474	451	531	26	4	80	0.0500000
NODE_3820_length_1210_cov_49.743474	451	531	28	2	80	0.0250000
NODE_3820_length_1210_cov_49.743474	451	531	29	1	80	0.0125000
NODE_3820_length_1210_cov_49.743474	451	531	30	3	80	0.0375000
NODE_3820_length_1210_cov_49.743474	451	531	31	5	80	0.0625000
NODE_3820_length_1210_cov_49.743474	451	531	33	1	80	0.0125000
NODE_3820_length_1210_cov_49.743474	451	531	34	8	80	0.1000000
NODE_3820_length_1210_cov_49.743474	451	531	36	3	80	0.0375000
NODE_3820_length_1210_cov_49.743474	451	531	37	3	80	0.0375000
NODE_3820_length_1210_cov_49.743474	451	531	38	5	80	0.0625000
NODE_3820_length_1210_cov_49.743474	451	531	39	15	80	0.1875000
NODE_3820_length_1210_cov_49.743474	451	531	40	28	80	0.3500000
NODE_3820_length_1210_cov_49.743474	451	531	41	1	80	0.0125000
NODE_3821_length_1210_cov_15.647165	647	727	2	46	80	0.5750000
NODE_3821_length_1210_cov_15.647165	647	727	3	34	80	0.4250000
NODE_3821_length_1210_cov_15.647165	700	780	1	24	80	0.3000000
NODE_3821_length_1210_cov_15.647165	700	780	2	54	80	0.6750000
NODE_3821_length_1210_cov_15.647165	700	780	3	2	80	0.0250000
NODE_3822_length_1210_cov_11.194419	794	874	1	13	80	0.1625000
NODE_3822_length_1210_cov_11.194419	794	874	2	67	80	0.8375000
NODE_3822_length_1210_cov_11.194419	847	927	2	31	80	0.3875000
NODE_3822_length_1210_cov_11.194419	847	927	3	12	80	0.1500000
NODE_3822_length_1210_cov_11.194419	847	927	4	32	80	0.4000000
NODE_3822_length_1210_cov_11.194419	847	927	5	3	80	0.0375000
NODE_3822_length_1210_cov_11.194419	847	927	7	2	80	0.0250000
NODE_3826_length_1209_cov_24.504505	582	662	9	7	80	0.0875000
NODE_3826_length_1209_cov_24.504505	582	662	10	14	80	0.1750000
NODE_3826_length_1209_cov_24.504505	582	662	11	15	80	0.1875000
NODE_3826_length_1209_cov_24.504505	582	662	12	20	80	0.2500000
NODE_3826_length_1209_cov_24.504505	582	662	13	24	80	0.3000000
NODE_3826_length_1209_cov_24.504505	635	715	5	16	80	0.2000000
NODE_3826_length_1209_cov_24.504505	635	715	6	15	80	0.1875000
NODE_3826_length_1209_cov_24.504505	635	715	7	10	80	0.1250000
NODE_3826_length_1209_cov_24.504505	635	715	8	6	80	0.0750000
NODE_3826_length_1209_cov_24.504505	635	715	9	7	80	0.0875000
NODE_3826_length_1209_cov_24.504505	635	715	10	11	80	0.1375000
NODE_3826_length_1209_cov_24.504505	635	715	11	15	80	0.1875000
NODE_3826_length_1209_cov_24.504505	711	791	5	4	80	0.0500000
NODE_3826_length_1209_cov_24.504505	711	791	6	14	80	0.1750000
NODE_3826_length_1209_cov_24.504505	711	791	7	26	80	0.3250000
NODE_3826_length_1209_cov_24.504505	711	791	8	36	80	0.4500000
NODE_3826_length_1209_cov_24.504505	764	844	7	9	80	0.1125000
NODE_3826_length_1209_cov_24.504505	764	844	8	58	80	0.7250000
NODE_3826_length_1209_cov_24.504505	764	844	9	13	80	0.1625000
NODE_3827_length_1209_cov_21.846847	520	600	6	22	80	0.2750000
NODE_3827_length_1209_cov_21.846847	520	600	7	2	80	0.0250000
NODE_3827_length_1209_cov_21.846847	520	600	8	19	80	0.2375000
NODE_3827_length_1209_cov_21.846847	520	600	9	26	80	0.3250000
NODE_3827_length_1209_cov_21.846847	520	600	10	11	80	0.1375000
NODE_3827_length_1209_cov_21.846847	573	653	9	43	80	0.5375000
NODE_3827_length_1209_cov_21.846847	573	653	10	37	80	0.4625000
NODE_3827_length_1209_cov_21.846847	649	729	7	2	80	0.0250000
NODE_3827_length_1209_cov_21.846847	649	729	8	33	80	0.4125000
NODE_3827_length_1209_cov_21.846847	649	729	9	32	80	0.4000000
NODE_3827_length_1209_cov_21.846847	649	729	10	13	80	0.1625000
NODE_3827_length_1209_cov_21.846847	702	782	8	20	80	0.2500000
NODE_3827_length_1209_cov_21.846847	702	782	9	42	80	0.5250000
NODE_3827_length_1209_cov_21.846847	702	782	10	18	80	0.2250000
NODE_3828_length_1209_cov_9.026126	782	862	5	77	80	0.9625000
NODE_3828_length_1209_cov_9.026126	782	862	10	3	80	0.0375000
NODE_3828_length_1209_cov_9.026126	835	915	5	29	80	0.3625000
NODE_3828_length_1209_cov_9.026126	835	915	10	51	80	0.6375000
NODE_3830_length_1209_cov_5.721622	926	1006	9	3	80	0.0375000
NODE_3830_length_1209_cov_5.721622	926	1006	10	4	80	0.0500000
NODE_3830_length_1209_cov_5.721622	926	1006	11	7	80	0.0875000
NODE_3830_length_1209_cov_5.721622	926	1006	13	31	80	0.3875000
NODE_3830_length_1209_cov_5.721622	926	1006	14	35	80	0.4375000
NODE_3830_length_1209_cov_5.721622	979	1059	12	3	80	0.0375000
NODE_3830_length_1209_cov_5.721622	979	1059	13	41	80	0.5125000
NODE_3830_length_1209_cov_5.721622	979	1059	14	1	80	0.0125000
NODE_3830_length_1209_cov_5.721622	979	1059	15	22	80	0.2750000
NODE_3830_length_1209_cov_5.721622	979	1059	16	1	80	0.0125000
NODE_3830_length_1209_cov_5.721622	979	1059	17	1	80	0.0125000
NODE_3830_length_1209_cov_5.721622	979	1059	18	9	80	0.1125000
NODE_3830_length_1209_cov_5.721622	979	1059	19	1	80	0.0125000
NODE_3830_length_1209_cov_5.721622	979	1059	20	1	80	0.0125000
NODE_3833_length_1208_cov_40.717764	886	966	19	4	80	0.0500000
NODE_3833_length_1208_cov_40.717764	886	966	20	3	80	0.0375000
NODE_3833_length_1208_cov_40.717764	886	966	22	1	80	0.0125000
NODE_3833_length_1208_cov_40.717764	886	966	23	11	80	0.1375000
NODE_3833_length_1208_cov_40.717764	886	966	27	3	80	0.0375000
NODE_3833_length_1208_cov_40.717764	886	966	29	1	80	0.0125000
NODE_3833_length_1208_cov_40.717764	886	966	31	3	80	0.0375000
NODE_3833_length_1208_cov_40.717764	886	966	33	8	80	0.1000000
NODE_3833_length_1208_cov_40.717764	886	966	34	10	80	0.1250000
NODE_3833_length_1208_cov_40.717764	886	966	35	5	80	0.0625000
NODE_3833_length_1208_cov_40.717764	886	966	37	1	80	0.0125000
NODE_3833_length_1208_cov_40.717764	886	966	42	6	80	0.0750000
NODE_3833_length_1208_cov_40.717764	886	966	44	1	80	0.0125000
NODE_3833_length_1208_cov_40.717764	886	966	45	3	80	0.0375000
NODE_3833_length_1208_cov_40.717764	886	966	47	5	80	0.0625000
NODE_3833_length_1208_cov_40.717764	886	966	48	3	80	0.0375000
NODE_3833_length_1208_cov_40.717764	886	966	50	3	80	0.0375000
NODE_3833_length_1208_cov_40.717764	886	966	51	2	80	0.0250000
NODE_3833_length_1208_cov_40.717764	886	966	52	4	80	0.0500000
NODE_3833_length_1208_cov_40.717764	886	966	53	3	80	0.0375000
NODE_3833_length_1208_cov_40.717764	939	985	42	3	46	0.0652174
NODE_3833_length_1208_cov_40.717764	939	985	44	1	46	0.0217391
NODE_3833_length_1208_cov_40.717764	939	985	45	3	46	0.0652174
NODE_3833_length_1208_cov_40.717764	939	985	47	5	46	0.1086956
NODE_3833_length_1208_cov_40.717764	939	985	48	3	46	0.0652174
NODE_3833_length_1208_cov_40.717764	939	985	50	3	46	0.0652174
NODE_3833_length_1208_cov_40.717764	939	985	51	10	46	0.2173913
NODE_3833_length_1208_cov_40.717764	939	985	52	6	46	0.1304348
NODE_3833_length_1208_cov_40.717764	939	985	53	6	46	0.1304348
NODE_3833_length_1208_cov_40.717764	939	985	54	1	46	0.0217391
NODE_3833_length_1208_cov_40.717764	939	985	55	5	46	0.1086956
NODE_3834_length_1208_cov_28.528404	614	694	6	12	80	0.1500000
NODE_3834_length_1208_cov_28.528404	614	694	7	44	80	0.5500000
NODE_3834_length_1208_cov_28.528404	614	694	9	24	80	0.3000000
NODE_3834_length_1208_cov_28.528404	667	747	4	6	80	0.0750000
NODE_3834_length_1208_cov_28.528404	667	747	5	33	80	0.4125000
NODE_3834_length_1208_cov_28.528404	667	747	6	26	80	0.3250000
NODE_3834_length_1208_cov_28.528404	667	747	7	15	80	0.1875000
NODE_3835_length_1208_cov_19.688007	682	762	0	27	80	0.3375000
NODE_3835_length_1208_cov_19.688007	682	762	1	53	80	0.6625000
NODE_3835_length_1208_cov_19.688007	735	815	0	64	80	0.8000000
NODE_3835_length_1208_cov_19.688007	735	815	1	16	80	0.2000000
NODE_3836_length_1208_cov_18.577096	455	535	5	27	80	0.3375000
NODE_3836_length_1208_cov_18.577096	455	535	6	30	80	0.3750000
NODE_3836_length_1208_cov_18.577096	455	535	7	23	80	0.2875000
NODE_3836_length_1208_cov_18.577096	508	588	6	4	80	0.0500000
NODE_3836_length_1208_cov_18.577096	508	588	7	68	80	0.8500000
NODE_3836_length_1208_cov_18.577096	508	588	9	8	80	0.1000000
NODE_3836_length_1208_cov_18.577096	584	664	3	2	80	0.0250000
NODE_3836_length_1208_cov_18.577096	584	664	4	56	80	0.7000000
NODE_3836_length_1208_cov_18.577096	584	664	5	12	80	0.1500000
NODE_3836_length_1208_cov_18.577096	584	664	6	2	80	0.0250000
NODE_3836_length_1208_cov_18.577096	584	664	7	7	80	0.0875000
NODE_3836_length_1208_cov_18.577096	584	664	9	1	80	0.0125000
NODE_3836_length_1208_cov_18.577096	637	717	3	55	80	0.6875000
NODE_3836_length_1208_cov_18.577096	637	717	4	25	80	0.3125000
NODE_3837_length_1208_cov_12.733995	766	846	1	34	80	0.4250000
NODE_3837_length_1208_cov_12.733995	766	846	2	46	80	0.5750000
NODE_3837_length_1208_cov_12.733995	819	899	1	4	80	0.0500000
NODE_3837_length_1208_cov_12.733995	819	899	2	76	80	0.9500000
NODE_3837_length_1208_cov_12.733995	895	975	0	7	80	0.0875000
NODE_3837_length_1208_cov_12.733995	895	975	1	55	80	0.6875000
NODE_3837_length_1208_cov_12.733995	895	975	2	18	80	0.2250000
NODE_3837_length_1208_cov_12.733995	948	1028	0	7	80	0.0875000
NODE_3837_length_1208_cov_12.733995	948	1028	1	2	80	0.0250000
NODE_3837_length_1208_cov_12.733995	948	1028	2	59	80	0.7375000
NODE_3837_length_1208_cov_12.733995	948	1028	4	12	80	0.1500000
NODE_3838_length_1207_cov_20.461191	874	954	8	2	80	0.0250000
NODE_3838_length_1207_cov_20.461191	874	954	9	3	80	0.0375000
NODE_3838_length_1207_cov_20.461191	874	954	11	15	80	0.1875000
NODE_3838_length_1207_cov_20.461191	874	954	12	27	80	0.3375000
NODE_3838_length_1207_cov_20.461191	874	954	13	5	80	0.0625000
NODE_3838_length_1207_cov_20.461191	874	954	14	14	80	0.1750000
NODE_3838_length_1207_cov_20.461191	874	954	15	4	80	0.0500000
NODE_3838_length_1207_cov_20.461191	874	954	16	4	80	0.0500000
NODE_3838_length_1207_cov_20.461191	874	954	18	6	80	0.0750000
NODE_3838_length_1207_cov_20.461191	927	1007	3	15	80	0.1875000
NODE_3838_length_1207_cov_20.461191	927	1007	6	29	80	0.3625000
NODE_3838_length_1207_cov_20.461191	927	1007	8	11	80	0.1375000
NODE_3838_length_1207_cov_20.461191	927	1007	9	3	80	0.0375000
NODE_3838_length_1207_cov_20.461191	927	1007	11	9	80	0.1125000
NODE_3838_length_1207_cov_20.461191	927	1007	12	13	80	0.1625000
NODE_3846_length_1206_cov_59.851852	540	620	10	1	80	0.0125000
NODE_3846_length_1206_cov_59.851852	540	620	11	10	80	0.1250000
NODE_3846_length_1206_cov_59.851852	540	620	13	22	80	0.2750000
NODE_3846_length_1206_cov_59.851852	540	620	14	4	80	0.0500000
NODE_3846_length_1206_cov_59.851852	540	620	15	3	80	0.0375000
NODE_3846_length_1206_cov_59.851852	540	620	16	1	80	0.0125000
NODE_3846_length_1206_cov_59.851852	540	620	17	12	80	0.1500000
NODE_3846_length_1206_cov_59.851852	540	620	18	27	80	0.3375000
NODE_3846_length_1206_cov_59.851852	593	673	15	1	80	0.0125000
NODE_3846_length_1206_cov_59.851852	593	673	17	5	80	0.0625000
NODE_3846_length_1206_cov_59.851852	593	673	18	42	80	0.5250000
NODE_3846_length_1206_cov_59.851852	593	673	19	10	80	0.1250000
NODE_3846_length_1206_cov_59.851852	593	673	20	3	80	0.0375000
NODE_3846_length_1206_cov_59.851852	593	673	21	14	80	0.1750000
NODE_3846_length_1206_cov_59.851852	593	673	22	1	80	0.0125000
NODE_3846_length_1206_cov_59.851852	593	673	23	4	80	0.0500000
NODE_3846_length_1206_cov_59.851852	669	749	13	5	80	0.0625000
NODE_3846_length_1206_cov_59.851852	669	749	16	16	80	0.2000000
NODE_3846_length_1206_cov_59.851852	669	749	17	14	80	0.1750000
NODE_3846_length_1206_cov_59.851852	669	749	18	27	80	0.3375000
NODE_3846_length_1206_cov_59.851852	669	749	20	18	80	0.2250000
NODE_3846_length_1206_cov_59.851852	722	802	12	13	80	0.1625000
NODE_3846_length_1206_cov_59.851852	722	802	13	9	80	0.1125000
NODE_3846_length_1206_cov_59.851852	722	802	15	3	80	0.0375000
NODE_3846_length_1206_cov_59.851852	722	802	16	15	80	0.1875000
NODE_3846_length_1206_cov_59.851852	722	802	17	21	80	0.2625000
NODE_3846_length_1206_cov_59.851852	722	802	18	1	80	0.0125000
NODE_3846_length_1206_cov_59.851852	722	802	20	18	80	0.2250000
NODE_3847_length_1206_cov_23.752484	669	749	0	21	80	0.2625000
NODE_3847_length_1206_cov_23.752484	669	749	1	35	80	0.4375000
NODE_3847_length_1206_cov_23.752484	669	749	2	13	80	0.1625000
NODE_3847_length_1206_cov_23.752484	669	749	3	11	80	0.1375000
NODE_3847_length_1206_cov_23.752484	722	802	1	3	80	0.0375000
NODE_3847_length_1206_cov_23.752484	722	802	2	13	80	0.1625000
NODE_3847_length_1206_cov_23.752484	722	802	3	64	80	0.8000000
NODE_3848_length_1206_cov_21.226739	585	665	7	15	80	0.1875000
NODE_3848_length_1206_cov_21.226739	585	665	8	32	80	0.4000000
NODE_3848_length_1206_cov_21.226739	585	665	9	3	80	0.0375000
NODE_3848_length_1206_cov_21.226739	585	665	10	26	80	0.3250000
NODE_3848_length_1206_cov_21.226739	585	665	11	4	80	0.0500000
NODE_3848_length_1206_cov_21.226739	638	718	7	10	80	0.1250000
NODE_3848_length_1206_cov_21.226739	638	718	8	11	80	0.1375000
NODE_3848_length_1206_cov_21.226739	638	718	9	2	80	0.0250000
NODE_3848_length_1206_cov_21.226739	638	718	10	50	80	0.6250000
NODE_3848_length_1206_cov_21.226739	638	718	11	7	80	0.0875000
NODE_3855_length_1205_cov_23.990054	355	435	3	12	80	0.1500000
NODE_3855_length_1205_cov_23.990054	355	435	4	68	80	0.8500000
NODE_3855_length_1205_cov_23.990054	408	488	1	8	80	0.1000000
NODE_3855_length_1205_cov_23.990054	408	488	2	28	80	0.3500000
NODE_3855_length_1205_cov_23.990054	408	488	4	44	80	0.5500000
NODE_3856_length_1205_cov_10.473779	780	860	0	80	80	1.0000000
NODE_3856_length_1205_cov_10.473779	833	913	0	80	80	1.0000000
NODE_3863_length_1204_cov_19.396380	537	617	0	64	80	0.8000000
NODE_3863_length_1204_cov_19.396380	537	617	1	16	80	0.2000000
NODE_3863_length_1204_cov_19.396380	590	670	0	80	80	1.0000000
NODE_3864_length_1204_cov_17.716742	448	528	5	6	80	0.0750000
NODE_3864_length_1204_cov_17.716742	448	528	6	31	80	0.3875000
NODE_3864_length_1204_cov_17.716742	448	528	7	28	80	0.3500000
NODE_3864_length_1204_cov_17.716742	448	528	8	15	80	0.1875000
NODE_3864_length_1204_cov_17.716742	501	581	4	3	80	0.0375000
NODE_3864_length_1204_cov_17.716742	501	581	5	37	80	0.4625000
NODE_3864_length_1204_cov_17.716742	501	581	6	13	80	0.1625000
NODE_3864_length_1204_cov_17.716742	501	581	7	18	80	0.2250000
NODE_3864_length_1204_cov_17.716742	501	581	8	9	80	0.1125000
NODE_3865_length_1204_cov_15.206335	426	506	11	13	80	0.1625000
NODE_3865_length_1204_cov_15.206335	426	506	12	9	80	0.1125000
NODE_3865_length_1204_cov_15.206335	426	506	14	27	80	0.3375000
NODE_3865_length_1204_cov_15.206335	426	506	15	12	80	0.1500000
NODE_3865_length_1204_cov_15.206335	426	506	16	19	80	0.2375000
NODE_3865_length_1204_cov_15.206335	479	559	3	2	80	0.0250000
NODE_3865_length_1204_cov_15.206335	479	559	4	4	80	0.0500000
NODE_3865_length_1204_cov_15.206335	479	559	6	5	80	0.0625000
NODE_3865_length_1204_cov_15.206335	479	559	7	3	80	0.0375000
NODE_3865_length_1204_cov_15.206335	479	559	8	1	80	0.0125000
NODE_3865_length_1204_cov_15.206335	479	559	10	9	80	0.1125000
NODE_3865_length_1204_cov_15.206335	479	559	11	18	80	0.2250000
NODE_3865_length_1204_cov_15.206335	479	559	13	9	80	0.1125000
NODE_3865_length_1204_cov_15.206335	479	559	14	17	80	0.2125000
NODE_3865_length_1204_cov_15.206335	479	559	15	1	80	0.0125000
NODE_3865_length_1204_cov_15.206335	479	559	16	11	80	0.1375000
NODE_3866_length_1204_cov_14.097738	632	712	1	12	80	0.1500000
NODE_3866_length_1204_cov_14.097738	632	712	2	13	80	0.1625000
NODE_3866_length_1204_cov_14.097738	632	712	3	26	80	0.3250000
NODE_3866_length_1204_cov_14.097738	632	712	4	29	80	0.3625000
NODE_3866_length_1204_cov_14.097738	685	765	4	80	80	1.0000000
NODE_3867_length_1204_cov_11.971946	549	629	5	15	80	0.1875000
NODE_3867_length_1204_cov_11.971946	549	629	7	54	80	0.6750000
NODE_3867_length_1204_cov_11.971946	549	629	9	11	80	0.1375000
NODE_3867_length_1204_cov_11.971946	602	682	5	31	80	0.3875000
NODE_3867_length_1204_cov_11.971946	602	682	6	1	80	0.0125000
NODE_3867_length_1204_cov_11.971946	602	682	7	38	80	0.4750000
NODE_3867_length_1204_cov_11.971946	602	682	9	10	80	0.1250000
NODE_3867_length_1204_cov_11.971946	678	758	0	7	80	0.0875000
NODE_3867_length_1204_cov_11.971946	678	758	2	12	80	0.1500000
NODE_3867_length_1204_cov_11.971946	678	758	3	25	80	0.3125000
NODE_3867_length_1204_cov_11.971946	678	758	4	1	80	0.0125000
NODE_3867_length_1204_cov_11.971946	678	758	5	35	80	0.4375000
NODE_3867_length_1204_cov_11.971946	731	811	0	60	80	0.7500000
NODE_3867_length_1204_cov_11.971946	731	811	2	12	80	0.1500000
NODE_3867_length_1204_cov_11.971946	731	811	3	8	80	0.1000000
NODE_3868_length_1204_cov_11.665158	499	579	3	11	80	0.1375000
NODE_3868_length_1204_cov_11.665158	499	579	4	69	80	0.8625000
NODE_3868_length_1204_cov_11.665158	552	632	1	35	80	0.4375000
NODE_3868_length_1204_cov_11.665158	552	632	3	7	80	0.0875000
NODE_3868_length_1204_cov_11.665158	552	632	4	38	80	0.4750000
NODE_3869_length_1204_cov_7.028959	637	717	3	8	80	0.1000000
NODE_3869_length_1204_cov_7.028959	637	717	4	1	80	0.0125000
NODE_3869_length_1204_cov_7.028959	637	717	5	8	80	0.1000000
NODE_3869_length_1204_cov_7.028959	637	717	7	4	80	0.0500000
NODE_3869_length_1204_cov_7.028959	637	717	8	59	80	0.7375000
NODE_3869_length_1204_cov_7.028959	690	770	5	26	80	0.3250000
NODE_3869_length_1204_cov_7.028959	690	770	7	13	80	0.1625000
NODE_3869_length_1204_cov_7.028959	690	770	8	41	80	0.5125000
NODE_3870_length_1204_cov_4.677828	807	887	0	80	80	1.0000000
NODE_3870_length_1204_cov_4.677828	860	940	0	80	80	1.0000000
NODE_3873_length_1203_cov_46.789855	515	595	7	23	80	0.2875000
NODE_3873_length_1203_cov_46.789855	515	595	8	47	80	0.5875000
NODE_3873_length_1203_cov_46.789855	515	595	9	5	80	0.0625000
NODE_3873_length_1203_cov_46.789855	515	595	15	5	80	0.0625000
NODE_3873_length_1203_cov_46.789855	568	648	8	22	80	0.2750000
NODE_3873_length_1203_cov_46.789855	568	648	12	18	80	0.2250000
NODE_3873_length_1203_cov_46.789855	568	648	13	10	80	0.1250000
NODE_3873_length_1203_cov_46.789855	568	648	14	4	80	0.0500000
NODE_3873_length_1203_cov_46.789855	568	648	15	17	80	0.2125000
NODE_3873_length_1203_cov_46.789855	568	648	16	9	80	0.1125000
NODE_3873_length_1203_cov_46.789855	644	724	12	16	80	0.2000000
NODE_3873_length_1203_cov_46.789855	644	724	13	6	80	0.0750000
NODE_3873_length_1203_cov_46.789855	644	724	14	4	80	0.0500000
NODE_3873_length_1203_cov_46.789855	644	724	15	3	80	0.0375000
NODE_3873_length_1203_cov_46.789855	644	724	16	15	80	0.1875000
NODE_3873_length_1203_cov_46.789855	644	724	21	1	80	0.0125000
NODE_3873_length_1203_cov_46.789855	644	724	23	1	80	0.0125000
NODE_3873_length_1203_cov_46.789855	644	724	30	14	80	0.1750000
NODE_3873_length_1203_cov_46.789855	644	724	31	15	80	0.1875000
NODE_3873_length_1203_cov_46.789855	644	724	32	5	80	0.0625000
NODE_3873_length_1203_cov_46.789855	697	777	22	10	80	0.1250000
NODE_3873_length_1203_cov_46.789855	697	777	23	8	80	0.1000000
NODE_3873_length_1203_cov_46.789855	697	777	27	1	80	0.0125000
NODE_3873_length_1203_cov_46.789855	697	777	28	2	80	0.0250000
NODE_3873_length_1203_cov_46.789855	697	777	29	16	80	0.2000000
NODE_3873_length_1203_cov_46.789855	697	777	30	30	80	0.3750000
NODE_3873_length_1203_cov_46.789855	697	777	31	8	80	0.1000000
NODE_3873_length_1203_cov_46.789855	697	777	32	5	80	0.0625000
NODE_3874_length_1203_cov_44.029891	471	551	6	10	80	0.1250000
NODE_3874_length_1203_cov_44.029891	471	551	8	4	80	0.0500000
NODE_3874_length_1203_cov_44.029891	471	551	11	3	80	0.0375000
NODE_3874_length_1203_cov_44.029891	471	551	13	10	80	0.1250000
NODE_3874_length_1203_cov_44.029891	471	551	15	11	80	0.1375000
NODE_3874_length_1203_cov_44.029891	471	551	16	33	80	0.4125000
NODE_3874_length_1203_cov_44.029891	471	551	17	9	80	0.1125000
NODE_3874_length_1203_cov_44.029891	524	604	13	1	80	0.0125000
NODE_3874_length_1203_cov_44.029891	524	604	15	11	80	0.1375000
NODE_3874_length_1203_cov_44.029891	524	604	16	27	80	0.3375000
NODE_3874_length_1203_cov_44.029891	524	604	17	14	80	0.1750000
NODE_3874_length_1203_cov_44.029891	524	604	19	4	80	0.0500000
NODE_3874_length_1203_cov_44.029891	524	604	20	11	80	0.1375000
NODE_3874_length_1203_cov_44.029891	524	604	22	7	80	0.0875000
NODE_3874_length_1203_cov_44.029891	524	604	25	5	80	0.0625000
NODE_3874_length_1203_cov_44.029891	600	680	15	28	80	0.3500000
NODE_3874_length_1203_cov_44.029891	600	680	16	5	80	0.0625000
NODE_3874_length_1203_cov_44.029891	600	680	18	9	80	0.1125000
NODE_3874_length_1203_cov_44.029891	600	680	20	3	80	0.0375000
NODE_3874_length_1203_cov_44.029891	600	680	22	1	80	0.0125000
NODE_3874_length_1203_cov_44.029891	600	680	23	3	80	0.0375000
NODE_3874_length_1203_cov_44.029891	600	680	25	23	80	0.2875000
NODE_3874_length_1203_cov_44.029891	600	680	26	8	80	0.1000000
NODE_3874_length_1203_cov_44.029891	653	733	12	2	80	0.0250000
NODE_3874_length_1203_cov_44.029891	653	733	13	28	80	0.3500000
NODE_3874_length_1203_cov_44.029891	653	733	14	7	80	0.0875000
NODE_3874_length_1203_cov_44.029891	653	733	15	26	80	0.3250000
NODE_3874_length_1203_cov_44.029891	653	733	16	17	80	0.2125000
NODE_3875_length_1203_cov_23.790761	308	388	6	1	80	0.0125000
NODE_3875_length_1203_cov_23.790761	308	388	8	10	80	0.1250000
NODE_3875_length_1203_cov_23.790761	308	388	9	50	80	0.6250000
NODE_3875_length_1203_cov_23.790761	308	388	10	19	80	0.2375000
NODE_3875_length_1203_cov_23.790761	361	441	5	3	80	0.0375000
NODE_3875_length_1203_cov_23.790761	361	441	7	1	80	0.0125000
NODE_3875_length_1203_cov_23.790761	361	441	8	3	80	0.0375000
NODE_3875_length_1203_cov_23.790761	361	441	9	8	80	0.1000000
NODE_3875_length_1203_cov_23.790761	361	441	10	56	80	0.7000000
NODE_3875_length_1203_cov_23.790761	361	441	11	9	80	0.1125000
NODE_3875_length_1203_cov_23.790761	437	517	5	3	80	0.0375000
NODE_3875_length_1203_cov_23.790761	437	517	6	29	80	0.3625000
NODE_3875_length_1203_cov_23.790761	437	517	7	27	80	0.3375000
NODE_3875_length_1203_cov_23.790761	437	517	9	21	80	0.2625000
NODE_3875_length_1203_cov_23.790761	490	570	6	30	80	0.3750000
NODE_3875_length_1203_cov_23.790761	490	570	7	20	80	0.2500000
NODE_3875_length_1203_cov_23.790761	490	570	8	25	80	0.3125000
NODE_3875_length_1203_cov_23.790761	490	570	9	5	80	0.0625000
NODE_3876_length_1203_cov_19.498188	336	416	2	80	80	1.0000000
NODE_3876_length_1203_cov_19.498188	389	469	0	41	80	0.5125000
NODE_3876_length_1203_cov_19.498188	389	469	2	39	80	0.4875000
NODE_3877_length_1203_cov_10.996377	317	397	4	29	80	0.3625000
NODE_3877_length_1203_cov_10.996377	317	397	5	1	80	0.0125000
NODE_3877_length_1203_cov_10.996377	317	397	6	10	80	0.1250000
NODE_3877_length_1203_cov_10.996377	317	397	7	40	80	0.5000000
NODE_3877_length_1203_cov_10.996377	370	450	3	12	80	0.1500000
NODE_3877_length_1203_cov_10.996377	370	450	4	30	80	0.3750000
NODE_3877_length_1203_cov_10.996377	370	450	5	38	80	0.4750000
NODE_3878_length_1203_cov_5.747283	725	805	3	1	80	0.0125000
NODE_3878_length_1203_cov_5.747283	725	805	4	3	80	0.0375000
NODE_3878_length_1203_cov_5.747283	725	805	5	6	80	0.0750000
NODE_3878_length_1203_cov_5.747283	725	805	6	2	80	0.0250000
NODE_3878_length_1203_cov_5.747283	725	805	7	40	80	0.5000000
NODE_3878_length_1203_cov_5.747283	725	805	8	26	80	0.3250000
NODE_3878_length_1203_cov_5.747283	725	805	9	2	80	0.0250000
NODE_3878_length_1203_cov_5.747283	778	858	8	25	80	0.3125000
NODE_3878_length_1203_cov_5.747283	778	858	9	3	80	0.0375000
NODE_3878_length_1203_cov_5.747283	778	858	10	52	80	0.6500000
NODE_3881_length_1202_cov_39.333636	475	555	9	3	80	0.0375000
NODE_3881_length_1202_cov_39.333636	475	555	10	3	80	0.0375000
NODE_3881_length_1202_cov_39.333636	475	555	11	10	80	0.1250000
NODE_3881_length_1202_cov_39.333636	475	555	12	15	80	0.1875000
NODE_3881_length_1202_cov_39.333636	475	555	13	1	80	0.0125000
NODE_3881_length_1202_cov_39.333636	475	555	14	22	80	0.2750000
NODE_3881_length_1202_cov_39.333636	475	555	16	8	80	0.1000000
NODE_3881_length_1202_cov_39.333636	475	555	17	11	80	0.1375000
NODE_3881_length_1202_cov_39.333636	475	555	18	7	80	0.0875000
NODE_3881_length_1202_cov_39.333636	528	608	13	1	80	0.0125000
NODE_3881_length_1202_cov_39.333636	528	608	15	3	80	0.0375000
NODE_3881_length_1202_cov_39.333636	528	608	16	26	80	0.3250000
NODE_3881_length_1202_cov_39.333636	528	608	17	30	80	0.3750000
NODE_3881_length_1202_cov_39.333636	528	608	18	20	80	0.2500000
NODE_3881_length_1202_cov_39.333636	604	684	11	1	80	0.0125000
NODE_3881_length_1202_cov_39.333636	604	684	12	6	80	0.0750000
NODE_3881_length_1202_cov_39.333636	604	684	13	14	80	0.1750000
NODE_3881_length_1202_cov_39.333636	604	684	14	6	80	0.0750000
NODE_3881_length_1202_cov_39.333636	604	684	15	32	80	0.4000000
NODE_3881_length_1202_cov_39.333636	604	684	16	7	80	0.0875000
NODE_3881_length_1202_cov_39.333636	604	684	17	14	80	0.1750000
NODE_3881_length_1202_cov_39.333636	657	737	9	15	80	0.1875000
NODE_3881_length_1202_cov_39.333636	657	737	10	1	80	0.0125000
NODE_3881_length_1202_cov_39.333636	657	737	11	11	80	0.1375000
NODE_3881_length_1202_cov_39.333636	657	737	12	3	80	0.0375000
NODE_3881_length_1202_cov_39.333636	657	737	13	3	80	0.0375000
NODE_3881_length_1202_cov_39.333636	657	737	14	14	80	0.1750000
NODE_3881_length_1202_cov_39.333636	657	737	15	33	80	0.4125000
NODE_3882_length_1202_cov_17.556664	599	679	11	4	80	0.0500000
NODE_3882_length_1202_cov_17.556664	599	679	12	2	80	0.0250000
NODE_3882_length_1202_cov_17.556664	599	679	13	4	80	0.0500000
NODE_3882_length_1202_cov_17.556664	599	679	14	1	80	0.0125000
NODE_3882_length_1202_cov_17.556664	599	679	15	8	80	0.1000000
NODE_3882_length_1202_cov_17.556664	599	679	16	7	80	0.0875000
NODE_3882_length_1202_cov_17.556664	599	679	17	1	80	0.0125000
NODE_3882_length_1202_cov_17.556664	599	679	18	31	80	0.3875000
NODE_3882_length_1202_cov_17.556664	599	679	19	10	80	0.1250000
NODE_3882_length_1202_cov_17.556664	599	679	20	5	80	0.0625000
NODE_3882_length_1202_cov_17.556664	599	679	21	6	80	0.0750000
NODE_3882_length_1202_cov_17.556664	599	679	22	1	80	0.0125000
NODE_3882_length_1202_cov_17.556664	652	732	16	2	80	0.0250000
NODE_3882_length_1202_cov_17.556664	652	732	17	7	80	0.0875000
NODE_3882_length_1202_cov_17.556664	652	732	18	18	80	0.2250000
NODE_3882_length_1202_cov_17.556664	652	732	19	4	80	0.0500000
NODE_3882_length_1202_cov_17.556664	652	732	20	5	80	0.0625000
NODE_3882_length_1202_cov_17.556664	652	732	21	8	80	0.1000000
NODE_3882_length_1202_cov_17.556664	652	732	22	29	80	0.3625000
NODE_3882_length_1202_cov_17.556664	652	732	23	7	80	0.0875000
NODE_3883_length_1202_cov_12.338169	634	714	0	80	80	1.0000000
NODE_3883_length_1202_cov_12.338169	687	767	0	80	80	1.0000000
NODE_3884_length_1202_cov_11.800544	520	600	5	7	80	0.0875000
NODE_3884_length_1202_cov_11.800544	520	600	6	42	80	0.5250000
NODE_3884_length_1202_cov_11.800544	520	600	8	20	80	0.2500000
NODE_3884_length_1202_cov_11.800544	520	600	9	3	80	0.0375000
NODE_3884_length_1202_cov_11.800544	520	600	10	7	80	0.0875000
NODE_3884_length_1202_cov_11.800544	520	600	11	1	80	0.0125000
NODE_3884_length_1202_cov_11.800544	573	653	5	18	80	0.2250000
NODE_3884_length_1202_cov_11.800544	573	653	6	45	80	0.5625000
NODE_3884_length_1202_cov_11.800544	573	653	7	17	80	0.2125000
NODE_3887_length_1201_cov_12.161525	434	514	6	39	80	0.4875000
NODE_3887_length_1201_cov_12.161525	434	514	8	14	80	0.1750000
NODE_3887_length_1201_cov_12.161525	434	514	10	27	80	0.3375000
NODE_3887_length_1201_cov_12.161525	487	567	4	1	80	0.0125000
NODE_3887_length_1201_cov_12.161525	487	567	6	3	80	0.0375000
NODE_3887_length_1201_cov_12.161525	487	567	8	44	80	0.5500000
NODE_3887_length_1201_cov_12.161525	487	567	10	32	80	0.4000000
NODE_3888_length_1201_cov_12.046279	643	723	2	46	80	0.5750000
NODE_3888_length_1201_cov_12.046279	643	723	3	34	80	0.4250000
NODE_3888_length_1201_cov_12.046279	696	776	0	2	80	0.0250000
NODE_3888_length_1201_cov_12.046279	696	776	1	51	80	0.6375000
NODE_3888_length_1201_cov_12.046279	696	776	2	27	80	0.3375000
NODE_3891_length_1200_cov_76.694823	630	710	13	2	80	0.0250000
NODE_3891_length_1200_cov_76.694823	630	710	14	23	80	0.2875000
NODE_3891_length_1200_cov_76.694823	630	710	15	32	80	0.4000000
NODE_3891_length_1200_cov_76.694823	630	710	16	23	80	0.2875000
NODE_3891_length_1200_cov_76.694823	683	763	10	7	80	0.0875000
NODE_3891_length_1200_cov_76.694823	683	763	11	21	80	0.2625000
NODE_3891_length_1200_cov_76.694823	683	763	12	4	80	0.0500000
NODE_3891_length_1200_cov_76.694823	683	763	13	6	80	0.0750000
NODE_3891_length_1200_cov_76.694823	683	763	14	5	80	0.0625000
NODE_3891_length_1200_cov_76.694823	683	763	15	30	80	0.3750000
NODE_3891_length_1200_cov_76.694823	683	763	16	7	80	0.0875000
NODE_3891_length_1200_cov_76.694823	759	839	10	19	80	0.2375000
NODE_3891_length_1200_cov_76.694823	759	839	11	3	80	0.0375000
NODE_3891_length_1200_cov_76.694823	759	839	12	7	80	0.0875000
NODE_3891_length_1200_cov_76.694823	759	839	17	8	80	0.1000000
NODE_3891_length_1200_cov_76.694823	759	839	20	31	80	0.3875000
NODE_3891_length_1200_cov_76.694823	759	839	21	4	80	0.0500000
NODE_3891_length_1200_cov_76.694823	759	839	22	8	80	0.1000000
NODE_3891_length_1200_cov_76.694823	812	892	15	5	80	0.0625000
NODE_3891_length_1200_cov_76.694823	812	892	17	16	80	0.2000000
NODE_3891_length_1200_cov_76.694823	812	892	18	4	80	0.0500000
NODE_3891_length_1200_cov_76.694823	812	892	19	16	80	0.2000000
NODE_3891_length_1200_cov_76.694823	812	892	20	39	80	0.4875000
NODE_3892_length_1200_cov_16.881926	827	902	1	7	75	0.0933333
NODE_3892_length_1200_cov_16.881926	827	902	3	13	75	0.1733333
NODE_3892_length_1200_cov_16.881926	827	902	5	4	75	0.0533333
NODE_3892_length_1200_cov_16.881926	827	902	15	8	75	0.1066667
NODE_3892_length_1200_cov_16.881926	827	902	16	8	75	0.1066667
NODE_3892_length_1200_cov_16.881926	827	902	17	13	75	0.1733333
NODE_3892_length_1200_cov_16.881926	827	902	19	4	75	0.0533333
NODE_3892_length_1200_cov_16.881926	827	902	20	6	75	0.0800000
NODE_3892_length_1200_cov_16.881926	827	902	21	3	75	0.0400000
NODE_3892_length_1200_cov_16.881926	827	902	23	7	75	0.0933333
NODE_3892_length_1200_cov_16.881926	827	902	24	2	75	0.0266667
NODE_3892_length_1200_cov_16.881926	828	904	1	6	76	0.0789474
NODE_3892_length_1200_cov_16.881926	828	904	3	13	76	0.1710526
NODE_3892_length_1200_cov_16.881926	828	904	5	4	76	0.0526316
NODE_3892_length_1200_cov_16.881926	828	904	15	8	76	0.1052632
NODE_3892_length_1200_cov_16.881926	828	904	16	8	76	0.1052632
NODE_3892_length_1200_cov_16.881926	828	904	17	13	76	0.1710526
NODE_3892_length_1200_cov_16.881926	828	904	19	4	76	0.0526316
NODE_3892_length_1200_cov_16.881926	828	904	20	6	76	0.0789474
NODE_3892_length_1200_cov_16.881926	828	904	21	3	76	0.0394737
NODE_3892_length_1200_cov_16.881926	828	904	23	9	76	0.1184211
NODE_3892_length_1200_cov_16.881926	828	904	24	2	76	0.0263158
NODE_3892_length_1200_cov_16.881926	841	907	3	6	66	0.0909091
NODE_3892_length_1200_cov_16.881926	841	907	5	4	66	0.0606061
NODE_3892_length_1200_cov_16.881926	841	907	15	8	66	0.1212121
NODE_3892_length_1200_cov_16.881926	841	907	16	8	66	0.1212121
NODE_3892_length_1200_cov_16.881926	841	907	17	13	66	0.1969697
NODE_3892_length_1200_cov_16.881926	841	907	19	4	66	0.0606061
NODE_3892_length_1200_cov_16.881926	841	907	20	6	66	0.0909091
NODE_3892_length_1200_cov_16.881926	841	907	21	3	66	0.0454545
NODE_3892_length_1200_cov_16.881926	841	907	23	12	66	0.1818182
NODE_3892_length_1200_cov_16.881926	841	907	24	2	66	0.0303030
NODE_3892_length_1200_cov_16.881926	880	957	19	4	77	0.0519481
NODE_3892_length_1200_cov_16.881926	880	957	20	6	77	0.0779221
NODE_3892_length_1200_cov_16.881926	880	957	21	3	77	0.0389610
NODE_3892_length_1200_cov_16.881926	880	957	23	38	77	0.4935065
NODE_3892_length_1200_cov_16.881926	880	957	24	5	77	0.0649351
NODE_3892_length_1200_cov_16.881926	880	957	26	10	77	0.1298701
NODE_3892_length_1200_cov_16.881926	880	957	27	3	77	0.0389610
NODE_3892_length_1200_cov_16.881926	880	957	28	2	77	0.0259740
NODE_3892_length_1200_cov_16.881926	880	957	29	3	77	0.0389610
NODE_3892_length_1200_cov_16.881926	880	957	30	1	77	0.0129870
NODE_3892_length_1200_cov_16.881926	880	957	39	2	77	0.0259740
NODE_3892_length_1200_cov_16.881926	880	957	19	4	77	0.0519481
NODE_3892_length_1200_cov_16.881926	880	957	20	6	77	0.0779221
NODE_3892_length_1200_cov_16.881926	880	957	21	3	77	0.0389610
NODE_3892_length_1200_cov_16.881926	880	957	23	38	77	0.4935065
NODE_3892_length_1200_cov_16.881926	880	957	24	5	77	0.0649351
NODE_3892_length_1200_cov_16.881926	880	957	26	10	77	0.1298701
NODE_3892_length_1200_cov_16.881926	880	957	27	3	77	0.0389610
NODE_3892_length_1200_cov_16.881926	880	957	28	2	77	0.0259740
NODE_3892_length_1200_cov_16.881926	880	957	29	3	77	0.0389610
NODE_3892_length_1200_cov_16.881926	880	957	30	1	77	0.0129870
NODE_3892_length_1200_cov_16.881926	880	957	39	2	77	0.0259740
NODE_3892_length_1200_cov_16.881926	880	957	19	4	77	0.0519481
NODE_3892_length_1200_cov_16.881926	880	957	20	6	77	0.0779221
NODE_3892_length_1200_cov_16.881926	880	957	21	3	77	0.0389610
NODE_3892_length_1200_cov_16.881926	880	957	23	38	77	0.4935065
NODE_3892_length_1200_cov_16.881926	880	957	24	5	77	0.0649351
NODE_3892_length_1200_cov_16.881926	880	957	26	10	77	0.1298701
NODE_3892_length_1200_cov_16.881926	880	957	27	3	77	0.0389610
NODE_3892_length_1200_cov_16.881926	880	957	28	2	77	0.0259740
NODE_3892_length_1200_cov_16.881926	880	957	29	3	77	0.0389610
NODE_3892_length_1200_cov_16.881926	880	957	30	1	77	0.0129870
NODE_3892_length_1200_cov_16.881926	880	957	39	2	77	0.0259740
NODE_3893_length_1200_cov_15.374205	605	685	8	19	80	0.2375000
NODE_3893_length_1200_cov_15.374205	605	685	9	34	80	0.4250000
NODE_3893_length_1200_cov_15.374205	605	685	11	1	80	0.0125000
NODE_3893_length_1200_cov_15.374205	605	685	14	20	80	0.2500000
NODE_3893_length_1200_cov_15.374205	605	685	15	2	80	0.0250000
NODE_3893_length_1200_cov_15.374205	605	685	16	4	80	0.0500000
NODE_3893_length_1200_cov_15.374205	658	738	7	6	80	0.0750000
NODE_3893_length_1200_cov_15.374205	658	738	8	50	80	0.6250000
NODE_3893_length_1200_cov_15.374205	658	738	9	10	80	0.1250000
NODE_3893_length_1200_cov_15.374205	658	738	11	1	80	0.0125000
NODE_3893_length_1200_cov_15.374205	658	738	12	13	80	0.1625000
NODE_3894_length_1200_cov_12.953678	486	550	2	17	64	0.2656250
NODE_3894_length_1200_cov_12.953678	486	550	3	47	64	0.7343750
NODE_3899_length_1199_cov_14.843636	222	302	9	56	80	0.7000000
NODE_3899_length_1199_cov_14.843636	222	302	13	24	80	0.3000000
NODE_3899_length_1199_cov_14.843636	275	355	4	32	80	0.4000000
NODE_3899_length_1199_cov_14.843636	275	355	5	20	80	0.2500000
NODE_3899_length_1199_cov_14.843636	275	355	9	28	80	0.3500000
NODE_3900_length_1199_cov_12.005455	383	463	0	80	80	1.0000000
NODE_3900_length_1199_cov_12.005455	436	516	0	29	80	0.3625000
NODE_3900_length_1199_cov_12.005455	436	516	1	28	80	0.3500000
NODE_3900_length_1199_cov_12.005455	436	516	2	23	80	0.2875000
NODE_3900_length_1199_cov_12.005455	512	592	2	53	80	0.6625000
NODE_3900_length_1199_cov_12.005455	512	592	3	27	80	0.3375000
NODE_3900_length_1199_cov_12.005455	565	645	3	80	80	1.0000000
NODE_3902_length_1198_cov_36.830755	619	699	6	6	80	0.0750000
NODE_3902_length_1198_cov_36.830755	619	699	8	12	80	0.1500000
NODE_3902_length_1198_cov_36.830755	619	699	10	4	80	0.0500000
NODE_3902_length_1198_cov_36.830755	619	699	12	38	80	0.4750000
NODE_3902_length_1198_cov_36.830755	619	699	13	13	80	0.1625000
NODE_3902_length_1198_cov_36.830755	619	699	15	7	80	0.0875000
NODE_3902_length_1198_cov_36.830755	672	752	12	7	80	0.0875000
NODE_3902_length_1198_cov_36.830755	672	752	13	13	80	0.1625000
NODE_3902_length_1198_cov_36.830755	672	752	14	28	80	0.3500000
NODE_3902_length_1198_cov_36.830755	672	752	15	21	80	0.2625000
NODE_3902_length_1198_cov_36.830755	672	752	16	11	80	0.1375000
NODE_3903_length_1198_cov_22.864422	719	799	9	9	80	0.1125000
NODE_3903_length_1198_cov_22.864422	719	799	11	15	80	0.1875000
NODE_3903_length_1198_cov_22.864422	719	799	12	3	80	0.0375000
NODE_3903_length_1198_cov_22.864422	719	799	13	53	80	0.6625000
NODE_3903_length_1198_cov_22.864422	772	852	0	4	80	0.0500000
NODE_3903_length_1198_cov_22.864422	772	852	2	2	80	0.0250000
NODE_3903_length_1198_cov_22.864422	772	852	3	8	80	0.1000000
NODE_3903_length_1198_cov_22.864422	772	852	4	11	80	0.1375000
NODE_3903_length_1198_cov_22.864422	772	852	6	13	80	0.1625000
NODE_3903_length_1198_cov_22.864422	772	852	7	10	80	0.1250000
NODE_3903_length_1198_cov_22.864422	772	852	8	1	80	0.0125000
NODE_3903_length_1198_cov_22.864422	772	852	9	13	80	0.1625000
NODE_3903_length_1198_cov_22.864422	772	852	11	15	80	0.1875000
NODE_3903_length_1198_cov_22.864422	772	852	12	3	80	0.0375000
NODE_3904_length_1198_cov_17.619654	260	340	5	9	80	0.1125000
NODE_3904_length_1198_cov_17.619654	260	340	6	23	80	0.2875000
NODE_3904_length_1198_cov_17.619654	260	340	7	23	80	0.2875000
NODE_3904_length_1198_cov_17.619654	260	340	8	25	80	0.3125000
NODE_3904_length_1198_cov_17.619654	313	392	4	25	79	0.3164557
NODE_3904_length_1198_cov_17.619654	313	392	5	36	79	0.4556962
NODE_3904_length_1198_cov_17.619654	313	392	7	18	79	0.2278481
NODE_3905_length_1198_cov_10.148317	718	798	0	80	80	1.0000000
NODE_3905_length_1198_cov_10.148317	771	851	0	80	80	1.0000000
NODE_3906_length_1198_cov_6.733394	549	629	3	74	80	0.9250000
NODE_3906_length_1198_cov_6.733394	549	629	4	6	80	0.0750000
NODE_3906_length_1198_cov_6.733394	602	682	0	19	80	0.2375000
NODE_3906_length_1198_cov_6.733394	602	682	1	6	80	0.0750000
NODE_3906_length_1198_cov_6.733394	602	682	2	3	80	0.0375000
NODE_3906_length_1198_cov_6.733394	602	682	3	52	80	0.6500000
NODE_3912_length_1197_cov_27.653005	417	497	1	11	80	0.1375000
NODE_3912_length_1197_cov_27.653005	417	497	3	28	80	0.3500000
NODE_3912_length_1197_cov_27.653005	417	497	5	37	80	0.4625000
NODE_3912_length_1197_cov_27.653005	417	497	6	4	80	0.0500000
NODE_3912_length_1197_cov_27.653005	470	550	5	53	80	0.6625000
NODE_3912_length_1197_cov_27.653005	470	550	6	27	80	0.3375000
NODE_3912_length_1197_cov_27.653005	546	626	4	7	80	0.0875000
NODE_3912_length_1197_cov_27.653005	546	626	5	20	80	0.2500000
NODE_3912_length_1197_cov_27.653005	546	626	6	28	80	0.3500000
NODE_3912_length_1197_cov_27.653005	546	626	7	25	80	0.3125000
NODE_3912_length_1197_cov_27.653005	599	679	2	3	80	0.0375000
NODE_3912_length_1197_cov_27.653005	599	679	3	18	80	0.2250000
NODE_3912_length_1197_cov_27.653005	599	679	4	23	80	0.2875000
NODE_3912_length_1197_cov_27.653005	599	679	5	29	80	0.3625000
NODE_3912_length_1197_cov_27.653005	599	679	6	7	80	0.0875000
NODE_3913_length_1197_cov_14.653916	490	570	10	1	80	0.0125000
NODE_3913_length_1197_cov_14.653916	490	570	11	15	80	0.1875000
NODE_3913_length_1197_cov_14.653916	490	570	12	30	80	0.3750000
NODE_3913_length_1197_cov_14.653916	490	570	13	8	80	0.1000000
NODE_3913_length_1197_cov_14.653916	490	570	14	25	80	0.3125000
NODE_3913_length_1197_cov_14.653916	490	570	15	1	80	0.0125000
NODE_3913_length_1197_cov_14.653916	543	623	8	7	80	0.0875000
NODE_3913_length_1197_cov_14.653916	543	623	10	47	80	0.5875000
NODE_3913_length_1197_cov_14.653916	543	623	12	26	80	0.3250000
NODE_3921_length_1196_cov_26.169553	298	378	1	2	80	0.0250000
NODE_3921_length_1196_cov_26.169553	298	378	2	19	80	0.2375000
NODE_3921_length_1196_cov_26.169553	298	378	3	38	80	0.4750000
NODE_3921_length_1196_cov_26.169553	298	378	4	15	80	0.1875000
NODE_3921_length_1196_cov_26.169553	298	378	5	1	80	0.0125000
NODE_3921_length_1196_cov_26.169553	298	378	6	5	80	0.0625000
NODE_3921_length_1196_cov_26.169553	351	431	2	6	80	0.0750000
NODE_3921_length_1196_cov_26.169553	351	431	4	15	80	0.1875000
NODE_3921_length_1196_cov_26.169553	351	431	5	1	80	0.0125000
NODE_3921_length_1196_cov_26.169553	351	431	6	53	80	0.6625000
NODE_3921_length_1196_cov_26.169553	351	431	7	1	80	0.0125000
NODE_3921_length_1196_cov_26.169553	351	431	8	4	80	0.0500000
NODE_3921_length_1196_cov_26.169553	427	507	8	45	80	0.5625000
NODE_3921_length_1196_cov_26.169553	427	507	9	35	80	0.4375000
NODE_3921_length_1196_cov_26.169553	480	560	4	37	80	0.4625000
NODE_3921_length_1196_cov_26.169553	480	560	5	1	80	0.0125000
NODE_3921_length_1196_cov_26.169553	480	560	6	15	80	0.1875000
NODE_3921_length_1196_cov_26.169553	480	560	8	8	80	0.1000000
NODE_3921_length_1196_cov_26.169553	480	560	9	19	80	0.2375000
NODE_3922_length_1196_cov_21.755697	521	601	2	26	80	0.3250000
NODE_3922_length_1196_cov_21.755697	521	601	4	38	80	0.4750000
NODE_3922_length_1196_cov_21.755697	521	601	7	16	80	0.2000000
NODE_3922_length_1196_cov_21.755697	574	654	2	2	80	0.0250000
NODE_3922_length_1196_cov_21.755697	574	654	4	9	80	0.1125000
NODE_3922_length_1196_cov_21.755697	574	654	5	13	80	0.1625000
NODE_3922_length_1196_cov_21.755697	574	654	7	56	80	0.7000000
NODE_3922_length_1196_cov_21.755697	650	730	3	4	80	0.0500000
NODE_3922_length_1196_cov_21.755697	650	730	5	76	80	0.9500000
NODE_3922_length_1196_cov_21.755697	703	783	0	48	80	0.6000000
NODE_3922_length_1196_cov_21.755697	703	783	3	9	80	0.1125000
NODE_3922_length_1196_cov_21.755697	703	783	5	23	80	0.2875000
NODE_3923_length_1196_cov_5.966272	556	636	0	26	80	0.3250000
NODE_3923_length_1196_cov_5.966272	556	636	3	25	80	0.3125000
NODE_3923_length_1196_cov_5.966272	556	636	4	29	80	0.3625000
NODE_3923_length_1196_cov_5.966272	609	689	4	42	80	0.5250000
NODE_3923_length_1196_cov_5.966272	609	689	7	38	80	0.4750000
NODE_3927_length_1195_cov_69.056569	474	554	4	11	80	0.1375000
NODE_3927_length_1195_cov_69.056569	474	554	5	3	80	0.0375000
NODE_3927_length_1195_cov_69.056569	474	554	6	21	80	0.2625000
NODE_3927_length_1195_cov_69.056569	474	554	8	15	80	0.1875000
NODE_3927_length_1195_cov_69.056569	474	554	9	21	80	0.2625000
NODE_3927_length_1195_cov_69.056569	474	554	10	9	80	0.1125000
NODE_3927_length_1195_cov_69.056569	527	607	7	9	80	0.1125000
NODE_3927_length_1195_cov_69.056569	527	607	9	39	80	0.4875000
NODE_3927_length_1195_cov_69.056569	527	607	10	20	80	0.2500000
NODE_3927_length_1195_cov_69.056569	527	607	12	2	80	0.0250000
NODE_3927_length_1195_cov_69.056569	527	607	13	10	80	0.1250000
NODE_3927_length_1195_cov_69.056569	603	683	9	12	80	0.1500000
NODE_3927_length_1195_cov_69.056569	603	683	11	30	80	0.3750000
NODE_3927_length_1195_cov_69.056569	603	683	12	6	80	0.0750000
NODE_3927_length_1195_cov_69.056569	603	683	13	32	80	0.4000000
NODE_3927_length_1195_cov_69.056569	656	736	9	17	80	0.2125000
NODE_3927_length_1195_cov_69.056569	656	736	11	31	80	0.3875000
NODE_3927_length_1195_cov_69.056569	656	736	12	23	80	0.2875000
NODE_3927_length_1195_cov_69.056569	656	736	13	9	80	0.1125000
NODE_3928_length_1195_cov_65.062044	579	659	9	6	80	0.0750000
NODE_3928_length_1195_cov_65.062044	579	659	10	28	80	0.3500000
NODE_3928_length_1195_cov_65.062044	579	659	12	7	80	0.0875000
NODE_3928_length_1195_cov_65.062044	579	659	14	6	80	0.0750000
NODE_3928_length_1195_cov_65.062044	579	659	16	33	80	0.4125000
NODE_3928_length_1195_cov_65.062044	632	712	14	8	80	0.1000000
NODE_3928_length_1195_cov_65.062044	632	712	16	21	80	0.2625000
NODE_3928_length_1195_cov_65.062044	632	712	17	39	80	0.4875000
NODE_3928_length_1195_cov_65.062044	632	712	18	8	80	0.1000000
NODE_3928_length_1195_cov_65.062044	632	712	19	4	80	0.0500000
NODE_3928_length_1195_cov_65.062044	708	788	12	1	80	0.0125000
NODE_3928_length_1195_cov_65.062044	708	788	13	16	80	0.2000000
NODE_3928_length_1195_cov_65.062044	708	788	14	1	80	0.0125000
NODE_3928_length_1195_cov_65.062044	708	788	15	16	80	0.2000000
NODE_3928_length_1195_cov_65.062044	708	788	16	4	80	0.0500000
NODE_3928_length_1195_cov_65.062044	708	788	17	16	80	0.2000000
NODE_3928_length_1195_cov_65.062044	708	788	18	18	80	0.2250000
NODE_3928_length_1195_cov_65.062044	708	788	19	7	80	0.0875000
NODE_3928_length_1195_cov_65.062044	708	788	20	1	80	0.0125000
NODE_3928_length_1195_cov_65.062044	761	841	13	2	80	0.0250000
NODE_3928_length_1195_cov_65.062044	761	841	14	28	80	0.3500000
NODE_3928_length_1195_cov_65.062044	761	841	15	16	80	0.2000000
NODE_3928_length_1195_cov_65.062044	761	841	17	24	80	0.3000000
NODE_3928_length_1195_cov_65.062044	761	841	18	2	80	0.0250000
NODE_3928_length_1195_cov_65.062044	761	841	19	7	80	0.0875000
NODE_3928_length_1195_cov_65.062044	761	841	20	1	80	0.0125000
NODE_3929_length_1195_cov_23.187044	460	540	8	48	80	0.6000000
NODE_3929_length_1195_cov_23.187044	460	540	9	12	80	0.1500000
NODE_3929_length_1195_cov_23.187044	460	540	11	20	80	0.2500000
NODE_3929_length_1195_cov_23.187044	513	593	5	9	80	0.1125000
NODE_3929_length_1195_cov_23.187044	513	593	7	6	80	0.0750000
NODE_3929_length_1195_cov_23.187044	513	593	9	45	80	0.5625000
NODE_3929_length_1195_cov_23.187044	513	593	11	20	80	0.2500000
NODE_3930_length_1195_cov_18.983577	521	601	1	55	80	0.6875000
NODE_3930_length_1195_cov_18.983577	521	601	2	25	80	0.3125000
NODE_3930_length_1195_cov_18.983577	574	654	1	22	80	0.2750000
NODE_3930_length_1195_cov_18.983577	574	654	2	58	80	0.7250000
NODE_3931_length_1195_cov_14.119526	726	806	0	50	80	0.6250000
NODE_3931_length_1195_cov_14.119526	726	806	1	7	80	0.0875000
NODE_3931_length_1195_cov_14.119526	726	806	2	6	80	0.0750000
NODE_3931_length_1195_cov_14.119526	726	806	4	17	80	0.2125000
NODE_3931_length_1195_cov_14.119526	779	859	1	4	80	0.0500000
NODE_3931_length_1195_cov_14.119526	779	859	2	6	80	0.0750000
NODE_3931_length_1195_cov_14.119526	779	859	4	70	80	0.8750000
NODE_3931_length_1195_cov_14.119526	855	935	4	29	80	0.3625000
NODE_3931_length_1195_cov_14.119526	855	935	5	8	80	0.1000000
NODE_3931_length_1195_cov_14.119526	855	935	6	43	80	0.5375000
NODE_3931_length_1195_cov_14.119526	908	988	2	53	80	0.6625000
NODE_3931_length_1195_cov_14.119526	908	988	4	2	80	0.0250000
NODE_3931_length_1195_cov_14.119526	908	988	5	7	80	0.0875000
NODE_3931_length_1195_cov_14.119526	908	988	6	18	80	0.2250000
NODE_3932_length_1195_cov_13.805657	759	839	2	1	80	0.0125000
NODE_3932_length_1195_cov_13.805657	759	839	4	48	80	0.6000000
NODE_3932_length_1195_cov_13.805657	759	839	5	31	80	0.3875000
NODE_3932_length_1195_cov_13.805657	812	892	3	28	80	0.3500000
NODE_3932_length_1195_cov_13.805657	812	892	4	31	80	0.3875000
NODE_3932_length_1195_cov_13.805657	812	892	5	21	80	0.2625000
NODE_3938_length_1195_cov_1.969891	912	992	0	80	80	1.0000000
NODE_3938_length_1195_cov_1.969891	912	992	0	80	80	1.0000000
NODE_3941_length_1194_cov_40.157991	237	317	20	2	80	0.0250000
NODE_3941_length_1194_cov_40.157991	237	317	21	8	80	0.1000000
NODE_3941_length_1194_cov_40.157991	237	317	22	17	80	0.2125000
NODE_3941_length_1194_cov_40.157991	237	317	23	5	80	0.0625000
NODE_3941_length_1194_cov_40.157991	237	317	24	4	80	0.0500000
NODE_3941_length_1194_cov_40.157991	237	317	25	15	80	0.1875000
NODE_3941_length_1194_cov_40.157991	237	317	26	6	80	0.0750000
NODE_3941_length_1194_cov_40.157991	237	317	27	21	80	0.2625000
NODE_3941_length_1194_cov_40.157991	237	317	28	2	80	0.0250000
NODE_3941_length_1194_cov_40.157991	290	370	20	8	80	0.1000000
NODE_3941_length_1194_cov_40.157991	290	370	21	2	80	0.0250000
NODE_3941_length_1194_cov_40.157991	290	370	22	9	80	0.1125000
NODE_3941_length_1194_cov_40.157991	290	370	23	19	80	0.2375000
NODE_3941_length_1194_cov_40.157991	290	370	24	13	80	0.1625000
NODE_3941_length_1194_cov_40.157991	290	370	25	15	80	0.1875000
NODE_3941_length_1194_cov_40.157991	290	370	26	3	80	0.0375000
NODE_3941_length_1194_cov_40.157991	290	370	27	9	80	0.1125000
NODE_3941_length_1194_cov_40.157991	290	370	28	2	80	0.0250000
NODE_3946_length_1193_cov_34.295247	443	523	0	74	80	0.9250000
NODE_3946_length_1193_cov_34.295247	443	523	2	6	80	0.0750000
NODE_3946_length_1193_cov_34.295247	496	576	0	21	80	0.2625000
NODE_3946_length_1193_cov_34.295247	496	576	2	59	80	0.7375000
NODE_3947_length_1193_cov_16.930530	124	154	0	30	30	1.0000000
NODE_3947_length_1193_cov_16.930530	390	470	19	15	80	0.1875000
NODE_3947_length_1193_cov_16.930530	390	470	20	5	80	0.0625000
NODE_3947_length_1193_cov_16.930530	390	470	21	15	80	0.1875000
NODE_3947_length_1193_cov_16.930530	390	470	22	31	80	0.3875000
NODE_3947_length_1193_cov_16.930530	390	470	23	14	80	0.1750000
NODE_3947_length_1193_cov_16.930530	443	523	7	1	80	0.0125000
NODE_3947_length_1193_cov_16.930530	443	523	8	20	80	0.2500000
NODE_3947_length_1193_cov_16.930530	443	523	9	1	80	0.0125000
NODE_3947_length_1193_cov_16.930530	443	523	12	20	80	0.2500000
NODE_3947_length_1193_cov_16.930530	443	523	14	3	80	0.0375000
NODE_3947_length_1193_cov_16.930530	443	523	15	4	80	0.0500000
NODE_3947_length_1193_cov_16.930530	443	523	16	1	80	0.0125000
NODE_3947_length_1193_cov_16.930530	443	523	19	18	80	0.2250000
NODE_3947_length_1193_cov_16.930530	443	523	22	12	80	0.1500000
NODE_3949_length_1192_cov_26.803294	205	285	6	13	80	0.1625000
NODE_3949_length_1192_cov_26.803294	205	285	7	16	80	0.2000000
NODE_3949_length_1192_cov_26.803294	205	285	9	43	80	0.5375000
NODE_3949_length_1192_cov_26.803294	205	285	12	8	80	0.1000000
NODE_3949_length_1192_cov_26.803294	258	338	8	51	80	0.6375000
NODE_3949_length_1192_cov_26.803294	258	338	9	21	80	0.2625000
NODE_3949_length_1192_cov_26.803294	258	338	12	8	80	0.1000000
NODE_3949_length_1192_cov_26.803294	334	414	8	20	80	0.2500000
NODE_3949_length_1192_cov_26.803294	334	414	9	6	80	0.0750000
NODE_3949_length_1192_cov_26.803294	334	414	10	3	80	0.0375000
NODE_3949_length_1192_cov_26.803294	334	414	12	30	80	0.3750000
NODE_3949_length_1192_cov_26.803294	334	414	13	11	80	0.1375000
NODE_3949_length_1192_cov_26.803294	334	414	14	10	80	0.1250000
NODE_3949_length_1192_cov_26.803294	387	467	9	14	80	0.1750000
NODE_3949_length_1192_cov_26.803294	387	467	10	14	80	0.1750000
NODE_3949_length_1192_cov_26.803294	387	467	11	24	80	0.3000000
NODE_3949_length_1192_cov_26.803294	387	467	12	28	80	0.3500000
NODE_3950_length_1192_cov_23.228728	487	567	3	13	80	0.1625000
NODE_3950_length_1192_cov_23.228728	487	567	4	8	80	0.1000000
NODE_3950_length_1192_cov_23.228728	487	567	5	30	80	0.3750000
NODE_3950_length_1192_cov_23.228728	487	567	6	2	80	0.0250000
NODE_3950_length_1192_cov_23.228728	487	567	7	4	80	0.0500000
NODE_3950_length_1192_cov_23.228728	487	567	8	7	80	0.0875000
NODE_3950_length_1192_cov_23.228728	487	567	9	11	80	0.1375000
NODE_3950_length_1192_cov_23.228728	487	567	12	5	80	0.0625000
NODE_3950_length_1192_cov_23.228728	540	620	7	4	80	0.0500000
NODE_3950_length_1192_cov_23.228728	540	620	8	7	80	0.0875000
NODE_3950_length_1192_cov_23.228728	540	620	9	11	80	0.1375000
NODE_3950_length_1192_cov_23.228728	540	620	10	1	80	0.0125000
NODE_3950_length_1192_cov_23.228728	540	620	11	41	80	0.5125000
NODE_3950_length_1192_cov_23.228728	540	620	12	6	80	0.0750000
NODE_3950_length_1192_cov_23.228728	540	620	14	3	80	0.0375000
NODE_3950_length_1192_cov_23.228728	540	620	15	7	80	0.0875000
NODE_3950_length_1192_cov_23.228728	616	696	14	11	80	0.1375000
NODE_3950_length_1192_cov_23.228728	616	696	15	40	80	0.5000000
NODE_3950_length_1192_cov_23.228728	616	696	16	2	80	0.0250000
NODE_3950_length_1192_cov_23.228728	616	696	17	4	80	0.0500000
NODE_3950_length_1192_cov_23.228728	616	696	18	9	80	0.1125000
NODE_3950_length_1192_cov_23.228728	616	696	19	14	80	0.1750000
NODE_3950_length_1192_cov_23.228728	669	749	14	3	80	0.0375000
NODE_3950_length_1192_cov_23.228728	669	749	15	21	80	0.2625000
NODE_3950_length_1192_cov_23.228728	669	749	16	13	80	0.1625000
NODE_3950_length_1192_cov_23.228728	669	749	17	4	80	0.0500000
NODE_3950_length_1192_cov_23.228728	669	749	18	20	80	0.2500000
NODE_3950_length_1192_cov_23.228728	669	749	19	19	80	0.2375000
NODE_3951_length_1192_cov_18.314730	613	693	0	10	80	0.1250000
NODE_3951_length_1192_cov_18.314730	613	693	1	70	80	0.8750000
NODE_3951_length_1192_cov_18.314730	666	746	1	56	80	0.7000000
NODE_3951_length_1192_cov_18.314730	666	746	2	2	80	0.0250000
NODE_3951_length_1192_cov_18.314730	666	746	3	22	80	0.2750000
NODE_3951_length_1192_cov_18.314730	742	822	2	29	80	0.3625000
NODE_3951_length_1192_cov_18.314730	742	822	3	51	80	0.6375000
NODE_3951_length_1192_cov_18.314730	795	875	0	1	80	0.0125000
NODE_3951_length_1192_cov_18.314730	795	875	1	2	80	0.0250000
NODE_3951_length_1192_cov_18.314730	795	875	2	77	80	0.9625000
NODE_3952_length_1192_cov_14.888381	622	702	2	7	80	0.0875000
NODE_3952_length_1192_cov_14.888381	622	702	3	26	80	0.3250000
NODE_3952_length_1192_cov_14.888381	622	702	7	10	80	0.1250000
NODE_3952_length_1192_cov_14.888381	622	702	8	7	80	0.0875000
NODE_3952_length_1192_cov_14.888381	622	702	9	30	80	0.3750000
NODE_3952_length_1192_cov_14.888381	675	755	8	23	80	0.2875000
NODE_3952_length_1192_cov_14.888381	675	755	9	26	80	0.3250000
NODE_3952_length_1192_cov_14.888381	675	755	10	21	80	0.2625000
NODE_3952_length_1192_cov_14.888381	675	755	11	2	80	0.0250000
NODE_3952_length_1192_cov_14.888381	675	755	15	8	80	0.1000000
NODE_3952_length_1192_cov_14.888381	751	831	8	16	80	0.2000000
NODE_3952_length_1192_cov_14.888381	751	831	10	10	80	0.1250000
NODE_3952_length_1192_cov_14.888381	751	831	13	2	80	0.0250000
NODE_3952_length_1192_cov_14.888381	751	831	14	24	80	0.3000000
NODE_3952_length_1192_cov_14.888381	751	831	15	28	80	0.3500000
NODE_3952_length_1192_cov_14.888381	804	884	6	16	80	0.2000000
NODE_3952_length_1192_cov_14.888381	804	884	7	1	80	0.0125000
NODE_3952_length_1192_cov_14.888381	804	884	8	52	80	0.6500000
NODE_3952_length_1192_cov_14.888381	804	884	10	10	80	0.1250000
NODE_3952_length_1192_cov_14.888381	804	884	13	1	80	0.0125000
NODE_3953_length_1192_cov_9.995425	161	241	0	42	80	0.5250000
NODE_3953_length_1192_cov_9.995425	161	241	1	19	80	0.2375000
NODE_3953_length_1192_cov_9.995425	161	241	2	19	80	0.2375000
NODE_3953_length_1192_cov_9.995425	214	294	1	8	80	0.1000000
NODE_3953_length_1192_cov_9.995425	214	294	2	72	80	0.9000000
NODE_3954_length_1192_cov_5.078683	749	829	7	30	80	0.3750000
NODE_3954_length_1192_cov_5.078683	749	829	8	6	80	0.0750000
NODE_3954_length_1192_cov_5.078683	749	829	9	44	80	0.5500000
NODE_3954_length_1192_cov_5.078683	802	882	4	22	80	0.2750000
NODE_3954_length_1192_cov_5.078683	802	882	5	28	80	0.3500000
NODE_3954_length_1192_cov_5.078683	802	882	7	26	80	0.3250000
NODE_3954_length_1192_cov_5.078683	802	882	8	4	80	0.0500000
NODE_3960_length_1192_cov_0.614822	1046	1126	0	80	80	1.0000000
NODE_3961_length_1191_cov_55.466117	392	472	3	47	80	0.5875000
NODE_3961_length_1191_cov_55.466117	392	472	5	3	80	0.0375000
NODE_3961_length_1191_cov_55.466117	392	472	6	3	80	0.0375000
NODE_3961_length_1191_cov_55.466117	392	472	7	27	80	0.3375000
NODE_3961_length_1191_cov_55.466117	445	525	5	27	80	0.3375000
NODE_3961_length_1191_cov_55.466117	445	525	6	1	80	0.0125000
NODE_3961_length_1191_cov_55.466117	445	525	7	23	80	0.2875000
NODE_3961_length_1191_cov_55.466117	445	525	9	15	80	0.1875000
NODE_3961_length_1191_cov_55.466117	445	525	10	14	80	0.1750000
NODE_3961_length_1191_cov_55.466117	521	601	7	12	80	0.1500000
NODE_3961_length_1191_cov_55.466117	521	601	10	26	80	0.3250000
NODE_3961_length_1191_cov_55.466117	521	601	11	1	80	0.0125000
NODE_3961_length_1191_cov_55.466117	521	601	12	41	80	0.5125000
NODE_3961_length_1191_cov_55.466117	574	654	4	1	80	0.0125000
NODE_3961_length_1191_cov_55.466117	574	654	5	7	80	0.0875000
NODE_3961_length_1191_cov_55.466117	574	654	7	48	80	0.6000000
NODE_3961_length_1191_cov_55.466117	574	654	8	1	80	0.0125000
NODE_3961_length_1191_cov_55.466117	574	654	9	8	80	0.1000000
NODE_3961_length_1191_cov_55.466117	574	654	11	1	80	0.0125000
NODE_3961_length_1191_cov_55.466117	574	654	12	14	80	0.1750000
NODE_3963_length_1191_cov_20.677656	695	775	6	22	80	0.2750000
NODE_3963_length_1191_cov_20.677656	695	775	11	24	80	0.3000000
NODE_3963_length_1191_cov_20.677656	695	775	12	14	80	0.1750000
NODE_3963_length_1191_cov_20.677656	695	775	13	10	80	0.1250000
NODE_3963_length_1191_cov_20.677656	695	775	17	10	80	0.1250000
NODE_3963_length_1191_cov_20.677656	748	828	12	22	80	0.2750000
NODE_3963_length_1191_cov_20.677656	748	828	13	5	80	0.0625000
NODE_3963_length_1191_cov_20.677656	748	828	14	43	80	0.5375000
NODE_3963_length_1191_cov_20.677656	748	828	17	10	80	0.1250000
NODE_3964_length_1191_cov_9.074176	420	500	0	15	80	0.1875000
NODE_3964_length_1191_cov_9.074176	420	500	2	65	80	0.8125000
NODE_3964_length_1191_cov_9.074176	473	553	2	80	80	1.0000000
NODE_3968_length_1190_cov_40.916590	521	601	0	80	80	1.0000000
NODE_3968_length_1190_cov_40.916590	574	654	0	80	80	1.0000000
NODE_3968_length_1190_cov_40.916590	650	730	0	80	80	1.0000000
NODE_3968_length_1190_cov_40.916590	703	783	0	80	80	1.0000000
NODE_3969_length_1190_cov_20.715857	257	337	10	27	80	0.3375000
NODE_3969_length_1190_cov_20.715857	257	337	12	31	80	0.3875000
NODE_3969_length_1190_cov_20.715857	257	337	13	22	80	0.2750000
NODE_3969_length_1190_cov_20.715857	310	390	9	8	80	0.1000000
NODE_3969_length_1190_cov_20.715857	310	390	10	19	80	0.2375000
NODE_3969_length_1190_cov_20.715857	310	390	11	5	80	0.0625000
NODE_3969_length_1190_cov_20.715857	310	390	12	20	80	0.2500000
NODE_3969_length_1190_cov_20.715857	310	390	13	28	80	0.3500000
NODE_3970_length_1190_cov_19.724106	296	376	5	37	80	0.4625000
NODE_3970_length_1190_cov_19.724106	296	376	7	9	80	0.1125000
NODE_3970_length_1190_cov_19.724106	296	376	8	34	80	0.4250000
NODE_3970_length_1190_cov_19.724106	349	429	8	36	80	0.4500000
NODE_3970_length_1190_cov_19.724106	349	429	9	29	80	0.3625000
NODE_3970_length_1190_cov_19.724106	349	429	10	11	80	0.1375000
NODE_3970_length_1190_cov_19.724106	349	429	11	4	80	0.0500000
NODE_3973_length_1190_cov_2.698442	1022	1070	0	48	48	1.0000000
NODE_3973_length_1190_cov_2.698442	1075	1123	0	48	48	1.0000000
NODE_3977_length_1189_cov_29.193578	576	656	21	14	80	0.1750000
NODE_3977_length_1189_cov_29.193578	576	656	22	4	80	0.0500000
NODE_3977_length_1189_cov_29.193578	576	656	23	7	80	0.0875000
NODE_3977_length_1189_cov_29.193578	576	656	24	14	80	0.1750000
NODE_3977_length_1189_cov_29.193578	576	656	26	8	80	0.1000000
NODE_3977_length_1189_cov_29.193578	576	656	27	3	80	0.0375000
NODE_3977_length_1189_cov_29.193578	576	656	28	21	80	0.2625000
NODE_3977_length_1189_cov_29.193578	576	656	30	9	80	0.1125000
NODE_3977_length_1189_cov_29.193578	629	709	18	2	80	0.0250000
NODE_3977_length_1189_cov_29.193578	629	709	19	4	80	0.0500000
NODE_3977_length_1189_cov_29.193578	629	709	21	1	80	0.0125000
NODE_3977_length_1189_cov_29.193578	629	709	22	4	80	0.0500000
NODE_3977_length_1189_cov_29.193578	629	709	24	15	80	0.1875000
NODE_3977_length_1189_cov_29.193578	629	709	25	15	80	0.1875000
NODE_3977_length_1189_cov_29.193578	629	709	26	9	80	0.1125000
NODE_3977_length_1189_cov_29.193578	629	709	27	25	80	0.3125000
NODE_3977_length_1189_cov_29.193578	629	709	30	5	80	0.0625000
NODE_3978_length_1189_cov_13.484404	315	341	1	25	26	0.9615384
NODE_3978_length_1189_cov_13.484404	315	341	2	1	26	0.0384615
NODE_3978_length_1189_cov_13.484404	366	446	1	80	80	1.0000000
NODE_3984_length_1188_cov_19.278237	396	476	4	5	80	0.0625000
NODE_3984_length_1188_cov_19.278237	396	476	5	26	80	0.3250000
NODE_3984_length_1188_cov_19.278237	396	476	6	23	80	0.2875000
NODE_3984_length_1188_cov_19.278237	396	476	7	22	80	0.2750000
NODE_3984_length_1188_cov_19.278237	396	476	8	4	80	0.0500000
NODE_3984_length_1188_cov_19.278237	449	529	6	1	80	0.0125000
NODE_3984_length_1188_cov_19.278237	449	529	7	31	80	0.3875000
NODE_3984_length_1188_cov_19.278237	449	529	8	48	80	0.6000000
NODE_3990_length_1187_cov_63.185662	529	609	7	11	80	0.1375000
NODE_3990_length_1187_cov_63.185662	529	609	8	28	80	0.3500000
NODE_3990_length_1187_cov_63.185662	529	609	9	41	80	0.5125000
NODE_3990_length_1187_cov_63.185662	582	662	6	2	80	0.0250000
NODE_3990_length_1187_cov_63.185662	582	662	7	13	80	0.1625000
NODE_3990_length_1187_cov_63.185662	582	662	8	1	80	0.0125000
NODE_3990_length_1187_cov_63.185662	582	662	9	20	80	0.2500000
NODE_3990_length_1187_cov_63.185662	582	662	10	6	80	0.0750000
NODE_3990_length_1187_cov_63.185662	582	662	11	1	80	0.0125000
NODE_3990_length_1187_cov_63.185662	582	662	12	8	80	0.1000000
NODE_3990_length_1187_cov_63.185662	582	662	13	22	80	0.2750000
NODE_3990_length_1187_cov_63.185662	582	662	17	7	80	0.0875000
NODE_3990_length_1187_cov_63.185662	658	738	16	13	80	0.1625000
NODE_3990_length_1187_cov_63.185662	658	738	17	47	80	0.5875000
NODE_3990_length_1187_cov_63.185662	658	738	18	20	80	0.2500000
NODE_3990_length_1187_cov_63.185662	711	791	9	15	80	0.1875000
NODE_3990_length_1187_cov_63.185662	711	791	10	2	80	0.0250000
NODE_3990_length_1187_cov_63.185662	711	791	11	6	80	0.0750000
NODE_3990_length_1187_cov_63.185662	711	791	12	1	80	0.0125000
NODE_3990_length_1187_cov_63.185662	711	791	15	16	80	0.2000000
NODE_3990_length_1187_cov_63.185662	711	791	16	23	80	0.2875000
NODE_3990_length_1187_cov_63.185662	711	791	17	17	80	0.2125000
NODE_3991_length_1187_cov_36.926471	432	512	8	3	80	0.0375000
NODE_3991_length_1187_cov_36.926471	432	512	10	46	80	0.5750000
NODE_3991_length_1187_cov_36.926471	432	512	11	13	80	0.1625000
NODE_3991_length_1187_cov_36.926471	432	512	12	13	80	0.1625000
NODE_3991_length_1187_cov_36.926471	432	512	13	4	80	0.0500000
NODE_3991_length_1187_cov_36.926471	432	512	14	1	80	0.0125000
NODE_3991_length_1187_cov_36.926471	485	565	6	21	80	0.2625000
NODE_3991_length_1187_cov_36.926471	485	565	7	4	80	0.0500000
NODE_3991_length_1187_cov_36.926471	485	565	8	26	80	0.3250000
NODE_3991_length_1187_cov_36.926471	485	565	9	4	80	0.0500000
NODE_3991_length_1187_cov_36.926471	485	565	10	1	80	0.0125000
NODE_3991_length_1187_cov_36.926471	485	565	11	13	80	0.1625000
NODE_3991_length_1187_cov_36.926471	485	565	12	9	80	0.1125000
NODE_3991_length_1187_cov_36.926471	485	565	13	1	80	0.0125000
NODE_3991_length_1187_cov_36.926471	485	565	14	1	80	0.0125000
NODE_3991_length_1187_cov_36.926471	561	641	6	34	80	0.4250000
NODE_3991_length_1187_cov_36.926471	561	641	7	1	80	0.0125000
NODE_3991_length_1187_cov_36.926471	561	641	8	37	80	0.4625000
NODE_3991_length_1187_cov_36.926471	561	641	9	8	80	0.1000000
NODE_3991_length_1187_cov_36.926471	614	694	6	5	80	0.0625000
NODE_3991_length_1187_cov_36.926471	614	694	7	34	80	0.4250000
NODE_3991_length_1187_cov_36.926471	614	694	8	13	80	0.1625000
NODE_3991_length_1187_cov_36.926471	614	694	9	28	80	0.3500000
NODE_3992_length_1187_cov_20.383272	492	572	4	11	80	0.1375000
NODE_3992_length_1187_cov_20.383272	492	572	6	14	80	0.1750000
NODE_3992_length_1187_cov_20.383272	492	572	7	8	80	0.1000000
NODE_3992_length_1187_cov_20.383272	492	572	8	47	80	0.5875000
NODE_3992_length_1187_cov_20.383272	545	625	0	9	80	0.1125000
NODE_3992_length_1187_cov_20.383272	545	625	1	23	80	0.2875000
NODE_3992_length_1187_cov_20.383272	545	625	4	32	80	0.4000000
NODE_3992_length_1187_cov_20.383272	545	625	6	14	80	0.1750000
NODE_3992_length_1187_cov_20.383272	545	625	7	2	80	0.0250000
NODE_3993_length_1187_cov_17.941176	377	457	0	80	80	1.0000000
NODE_3993_length_1187_cov_17.941176	430	510	0	30	80	0.3750000
NODE_3993_length_1187_cov_17.941176	430	510	2	50	80	0.6250000
NODE_3993_length_1187_cov_17.941176	506	586	0	1	80	0.0125000
NODE_3993_length_1187_cov_17.941176	506	586	2	79	80	0.9875000
NODE_3993_length_1187_cov_17.941176	559	639	0	54	80	0.6750000
NODE_3993_length_1187_cov_17.941176	559	639	2	26	80	0.3250000
NODE_3997_length_1186_cov_59.606256	338	418	23	8	80	0.1000000
NODE_3997_length_1186_cov_59.606256	338	418	24	20	80	0.2500000
NODE_3997_length_1186_cov_59.606256	338	418	25	1	80	0.0125000
NODE_3997_length_1186_cov_59.606256	338	418	26	18	80	0.2250000
NODE_3997_length_1186_cov_59.606256	338	418	27	7	80	0.0875000
NODE_3997_length_1186_cov_59.606256	338	418	28	26	80	0.3250000
NODE_3997_length_1186_cov_59.606256	391	471	16	6	80	0.0750000
NODE_3997_length_1186_cov_59.606256	391	471	19	3	80	0.0375000
NODE_3997_length_1186_cov_59.606256	391	471	21	6	80	0.0750000
NODE_3997_length_1186_cov_59.606256	391	471	24	6	80	0.0750000
NODE_3997_length_1186_cov_59.606256	391	471	26	1	80	0.0125000
NODE_3997_length_1186_cov_59.606256	391	471	27	6	80	0.0750000
NODE_3997_length_1186_cov_59.606256	391	471	28	30	80	0.3750000
NODE_3997_length_1186_cov_59.606256	391	471	29	7	80	0.0875000
NODE_3997_length_1186_cov_59.606256	391	471	30	7	80	0.0875000
NODE_3997_length_1186_cov_59.606256	391	471	31	3	80	0.0375000
NODE_3997_length_1186_cov_59.606256	391	471	32	2	80	0.0250000
NODE_3997_length_1186_cov_59.606256	391	471	33	3	80	0.0375000
NODE_3997_length_1186_cov_59.606256	480	551	12	3	71	0.0422535
NODE_3997_length_1186_cov_59.606256	480	551	13	24	71	0.3380282
NODE_3997_length_1186_cov_59.606256	480	551	14	28	71	0.3943662
NODE_3997_length_1186_cov_59.606256	480	551	15	16	71	0.2253521
NODE_3997_length_1186_cov_59.606256	524	604	5	3	80	0.0375000
NODE_3997_length_1186_cov_59.606256	524	604	6	2	80	0.0250000
NODE_3997_length_1186_cov_59.606256	524	604	7	7	80	0.0875000
NODE_3997_length_1186_cov_59.606256	524	604	8	1	80	0.0125000
NODE_3997_length_1186_cov_59.606256	524	604	10	17	80	0.2125000
NODE_3997_length_1186_cov_59.606256	524	604	12	8	80	0.1000000
NODE_3997_length_1186_cov_59.606256	524	604	13	28	80	0.3500000
NODE_3997_length_1186_cov_59.606256	524	604	14	14	80	0.1750000
NODE_3998_length_1186_cov_34.937443	582	662	21	9	80	0.1125000
NODE_3998_length_1186_cov_34.937443	582	662	22	17	80	0.2125000
NODE_3998_length_1186_cov_34.937443	582	662	23	1	80	0.0125000
NODE_3998_length_1186_cov_34.937443	582	662	24	17	80	0.2125000
NODE_3998_length_1186_cov_34.937443	582	662	25	32	80	0.4000000
NODE_3998_length_1186_cov_34.937443	582	662	27	4	80	0.0500000
NODE_3998_length_1186_cov_34.937443	635	715	20	10	80	0.1250000
NODE_3998_length_1186_cov_34.937443	635	715	21	11	80	0.1375000
NODE_3998_length_1186_cov_34.937443	635	715	22	7	80	0.0875000
NODE_3998_length_1186_cov_34.937443	635	715	23	6	80	0.0750000
NODE_3998_length_1186_cov_34.937443	635	715	24	23	80	0.2875000
NODE_3998_length_1186_cov_34.937443	635	715	25	23	80	0.2875000
NODE_3998_length_1186_cov_34.937443	711	791	16	11	80	0.1375000
NODE_3998_length_1186_cov_34.937443	711	791	17	5	80	0.0625000
NODE_3998_length_1186_cov_34.937443	711	791	18	26	80	0.3250000
NODE_3998_length_1186_cov_34.937443	711	791	20	3	80	0.0375000
NODE_3998_length_1186_cov_34.937443	711	791	21	8	80	0.1000000
NODE_3998_length_1186_cov_34.937443	711	791	22	4	80	0.0500000
NODE_3998_length_1186_cov_34.937443	711	791	23	16	80	0.2000000
NODE_3998_length_1186_cov_34.937443	711	791	25	7	80	0.0875000
NODE_3998_length_1186_cov_34.937443	764	844	17	8	80	0.1000000
NODE_3998_length_1186_cov_34.937443	764	844	18	33	80	0.4125000
NODE_3998_length_1186_cov_34.937443	764	844	20	32	80	0.4000000
NODE_3998_length_1186_cov_34.937443	764	844	21	2	80	0.0250000
NODE_3998_length_1186_cov_34.937443	764	844	23	5	80	0.0625000
NODE_3999_length_1186_cov_29.840846	511	591	0	80	80	1.0000000
NODE_3999_length_1186_cov_29.840846	564	644	0	80	80	1.0000000
NODE_3999_length_1186_cov_29.840846	640	720	0	80	80	1.0000000
NODE_3999_length_1186_cov_29.840846	693	773	0	80	80	1.0000000
NODE_4000_length_1186_cov_13.108556	578	658	2	22	80	0.2750000
NODE_4000_length_1186_cov_13.108556	578	658	3	18	80	0.2250000
NODE_4000_length_1186_cov_13.108556	578	658	4	40	80	0.5000000
NODE_4000_length_1186_cov_13.108556	631	711	3	33	80	0.4125000
NODE_4000_length_1186_cov_13.108556	631	711	4	47	80	0.5875000
NODE_4001_length_1186_cov_12.867525	404	484	5	47	80	0.5875000
NODE_4001_length_1186_cov_12.867525	404	484	6	29	80	0.3625000
NODE_4001_length_1186_cov_12.867525	404	484	7	4	80	0.0500000
NODE_4001_length_1186_cov_12.867525	457	534	4	8	77	0.1038961
NODE_4001_length_1186_cov_12.867525	457	534	5	23	77	0.2987013
NODE_4001_length_1186_cov_12.867525	457	534	6	16	77	0.2077922
NODE_4001_length_1186_cov_12.867525	457	534	7	30	77	0.3896104
NODE_4001_length_1186_cov_12.867525	536	613	2	5	77	0.0649351
NODE_4001_length_1186_cov_12.867525	536	613	3	2	77	0.0259740
NODE_4001_length_1186_cov_12.867525	536	613	4	70	77	0.9090909
NODE_4001_length_1186_cov_12.867525	586	666	4	67	80	0.8375000
NODE_4001_length_1186_cov_12.867525	586	666	6	13	80	0.1625000
NODE_4002_length_1186_cov_12.135235	643	723	2	19	80	0.2375000
NODE_4002_length_1186_cov_12.135235	643	723	3	61	80	0.7625000
NODE_4002_length_1186_cov_12.135235	696	776	1	43	80	0.5375000
NODE_4002_length_1186_cov_12.135235	696	776	2	29	80	0.3625000
NODE_4002_length_1186_cov_12.135235	696	776	3	8	80	0.1000000
NODE_4012_length_1185_cov_36.974217	423	503	2	2	80	0.0250000
NODE_4012_length_1185_cov_36.974217	423	503	3	12	80	0.1500000
NODE_4012_length_1185_cov_36.974217	423	503	4	44	80	0.5500000
NODE_4012_length_1185_cov_36.974217	423	503	5	22	80	0.2750000
NODE_4012_length_1185_cov_36.974217	476	556	1	38	80	0.4750000
NODE_4012_length_1185_cov_36.974217	476	556	2	17	80	0.2125000
NODE_4012_length_1185_cov_36.974217	476	556	3	3	80	0.0375000
NODE_4012_length_1185_cov_36.974217	476	556	4	18	80	0.2250000
NODE_4012_length_1185_cov_36.974217	476	556	5	4	80	0.0500000
NODE_4013_length_1185_cov_28.410681	448	528	1	1	80	0.0125000
NODE_4013_length_1185_cov_28.410681	448	528	2	2	80	0.0250000
NODE_4013_length_1185_cov_28.410681	448	528	3	70	80	0.8750000
NODE_4013_length_1185_cov_28.410681	448	528	4	7	80	0.0875000
NODE_4013_length_1185_cov_28.410681	501	581	3	49	80	0.6125000
NODE_4013_length_1185_cov_28.410681	501	581	5	22	80	0.2750000
NODE_4013_length_1185_cov_28.410681	501	581	7	9	80	0.1125000
NODE_4014_length_1185_cov_19.768877	411	491	2	80	80	1.0000000
NODE_4014_length_1185_cov_19.768877	464	544	2	68	80	0.8500000
NODE_4014_length_1185_cov_19.768877	464	544	3	12	80	0.1500000
NODE_4014_length_1185_cov_19.768877	540	620	2	12	80	0.1500000
NODE_4014_length_1185_cov_19.768877	540	620	3	68	80	0.8500000
NODE_4014_length_1185_cov_19.768877	593	673	2	11	80	0.1375000
NODE_4014_length_1185_cov_19.768877	593	673	3	69	80	0.8625000
NODE_4015_length_1185_cov_14.490792	379	459	7	10	80	0.1250000
NODE_4015_length_1185_cov_14.490792	379	459	9	40	80	0.5000000
NODE_4015_length_1185_cov_14.490792	379	459	10	17	80	0.2125000
NODE_4015_length_1185_cov_14.490792	379	459	12	13	80	0.1625000
NODE_4015_length_1185_cov_14.490792	432	512	10	16	80	0.2000000
NODE_4015_length_1185_cov_14.490792	432	512	11	38	80	0.4750000
NODE_4015_length_1185_cov_14.490792	432	512	12	26	80	0.3250000
NODE_4016_length_1185_cov_13.686004	677	757	0	80	80	1.0000000
NODE_4016_length_1185_cov_13.686004	730	810	0	80	80	1.0000000
NODE_4017_length_1185_cov_12.362799	711	791	2	41	80	0.5125000
NODE_4017_length_1185_cov_12.362799	711	791	4	39	80	0.4875000
NODE_4017_length_1185_cov_12.362799	764	844	0	46	80	0.5750000
NODE_4017_length_1185_cov_12.362799	764	844	2	34	80	0.4250000
NODE_4024_length_1184_cov_30.061751	416	497	7	81	81	1.0000000
NODE_4024_length_1184_cov_30.061751	470	550	2	21	80	0.2625000
NODE_4024_length_1184_cov_30.061751	470	550	3	13	80	0.1625000
NODE_4024_length_1184_cov_30.061751	470	550	5	1	80	0.0125000
NODE_4024_length_1184_cov_30.061751	470	550	7	45	80	0.5625000
NODE_4024_length_1184_cov_30.061751	546	627	1	10	81	0.1234568
NODE_4024_length_1184_cov_30.061751	546	627	2	16	81	0.1975309
NODE_4024_length_1184_cov_30.061751	546	627	3	55	81	0.6790124
NODE_4024_length_1184_cov_30.061751	600	680	3	58	80	0.7250000
NODE_4024_length_1184_cov_30.061751	600	680	4	22	80	0.2750000
NODE_4025_length_1184_cov_19.544700	550	630	6	31	80	0.3875000
NODE_4025_length_1184_cov_19.544700	550	630	7	46	80	0.5750000
NODE_4025_length_1184_cov_19.544700	550	630	9	3	80	0.0375000
NODE_4025_length_1184_cov_19.544700	603	683	6	29	80	0.3625000
NODE_4025_length_1184_cov_19.544700	603	683	7	51	80	0.6375000
NODE_4025_length_1184_cov_19.544700	679	759	4	6	80	0.0750000
NODE_4025_length_1184_cov_19.544700	679	759	6	42	80	0.5250000
NODE_4025_length_1184_cov_19.544700	679	759	7	14	80	0.1750000
NODE_4025_length_1184_cov_19.544700	679	759	9	3	80	0.0375000
NODE_4025_length_1184_cov_19.544700	679	759	12	13	80	0.1625000
NODE_4025_length_1184_cov_19.544700	679	759	13	2	80	0.0250000
NODE_4025_length_1184_cov_19.544700	732	812	4	6	80	0.0750000
NODE_4025_length_1184_cov_19.544700	732	812	6	3	80	0.0375000
NODE_4025_length_1184_cov_19.544700	732	812	9	3	80	0.0375000
NODE_4025_length_1184_cov_19.544700	732	812	11	34	80	0.4250000
NODE_4025_length_1184_cov_19.544700	732	812	12	26	80	0.3250000
NODE_4025_length_1184_cov_19.544700	732	812	13	8	80	0.1000000
NODE_4026_length_1184_cov_9.129954	624	704	0	30	80	0.3750000
NODE_4026_length_1184_cov_9.129954	624	704	1	50	80	0.6250000
NODE_4026_length_1184_cov_9.129954	677	757	0	4	80	0.0500000
NODE_4026_length_1184_cov_9.129954	677	757	1	76	80	0.9500000
NODE_4031_length_1183_cov_17.260148	545	625	1	5	80	0.0625000
NODE_4031_length_1183_cov_17.260148	545	625	2	75	80	0.9375000
NODE_4031_length_1183_cov_17.260148	598	678	1	23	80	0.2875000
NODE_4031_length_1183_cov_17.260148	598	678	2	57	80	0.7125000
NODE_4031_length_1183_cov_17.260148	674	754	0	22	80	0.2750000
NODE_4031_length_1183_cov_17.260148	674	754	1	26	80	0.3250000
NODE_4031_length_1183_cov_17.260148	674	754	2	32	80	0.4000000
NODE_4031_length_1183_cov_17.260148	727	807	2	48	80	0.6000000
NODE_4031_length_1183_cov_17.260148	727	807	3	32	80	0.4000000
NODE_4032_length_1183_cov_9.777675	484	564	1	16	80	0.2000000
NODE_4032_length_1183_cov_9.777675	484	564	2	64	80	0.8000000
NODE_4032_length_1183_cov_9.777675	537	617	2	80	80	1.0000000
NODE_4033_length_1183_cov_6.847786	711	791	3	60	80	0.7500000
NODE_4033_length_1183_cov_6.847786	711	791	6	20	80	0.2500000
NODE_4033_length_1183_cov_6.847786	764	844	0	30	80	0.3750000
NODE_4033_length_1183_cov_6.847786	764	844	3	50	80	0.6250000
NODE_4033_length_1183_cov_6.847786	840	920	0	80	80	1.0000000
NODE_4033_length_1183_cov_6.847786	893	973	0	80	80	1.0000000
NODE_4035_length_1183_cov_2.680812	59	139	0	80	80	1.0000000
NODE_4040_length_1182_cov_64.600185	588	668	6	21	80	0.2625000
NODE_4040_length_1182_cov_64.600185	588	668	7	20	80	0.2500000
NODE_4040_length_1182_cov_64.600185	588	668	9	1	80	0.0125000
NODE_4040_length_1182_cov_64.600185	588	668	10	21	80	0.2625000
NODE_4040_length_1182_cov_64.600185	588	668	11	17	80	0.2125000
NODE_4040_length_1182_cov_64.600185	641	721	9	23	80	0.2875000
NODE_4040_length_1182_cov_64.600185	641	721	10	17	80	0.2125000
NODE_4040_length_1182_cov_64.600185	641	721	11	27	80	0.3375000
NODE_4040_length_1182_cov_64.600185	641	721	12	4	80	0.0500000
NODE_4040_length_1182_cov_64.600185	641	721	14	9	80	0.1125000
NODE_4040_length_1182_cov_64.600185	717	797	8	6	80	0.0750000
NODE_4040_length_1182_cov_64.600185	717	797	9	6	80	0.0750000
NODE_4040_length_1182_cov_64.600185	717	797	10	6	80	0.0750000
NODE_4040_length_1182_cov_64.600185	717	797	11	20	80	0.2500000
NODE_4040_length_1182_cov_64.600185	717	797	12	24	80	0.3000000
NODE_4040_length_1182_cov_64.600185	717	797	13	12	80	0.1500000
NODE_4040_length_1182_cov_64.600185	717	797	14	6	80	0.0750000
NODE_4040_length_1182_cov_64.600185	770	849	7	7	79	0.0886076
NODE_4040_length_1182_cov_64.600185	770	849	8	6	79	0.0759494
NODE_4040_length_1182_cov_64.600185	770	849	9	29	79	0.3670886
NODE_4040_length_1182_cov_64.600185	770	849	10	28	79	0.3544304
NODE_4040_length_1182_cov_64.600185	770	849	12	9	79	0.1139240
NODE_4041_length_1182_cov_18.584488	487	557	8	5	70	0.0714286
NODE_4041_length_1182_cov_18.584488	487	557	13	27	70	0.3857143
NODE_4041_length_1182_cov_18.584488	487	557	14	12	70	0.1714286
NODE_4041_length_1182_cov_18.584488	487	557	17	9	70	0.1285714
NODE_4041_length_1182_cov_18.584488	487	557	18	3	70	0.0428571
NODE_4041_length_1182_cov_18.584488	487	557	19	2	70	0.0285714
NODE_4041_length_1182_cov_18.584488	487	557	20	4	70	0.0571429
NODE_4041_length_1182_cov_18.584488	487	557	22	1	70	0.0142857
NODE_4041_length_1182_cov_18.584488	487	557	25	1	70	0.0142857
NODE_4041_length_1182_cov_18.584488	487	557	26	6	70	0.0857143
NODE_4041_length_1182_cov_18.584488	536	612	17	4	76	0.0526316
NODE_4041_length_1182_cov_18.584488	536	612	18	3	76	0.0394737
NODE_4041_length_1182_cov_18.584488	536	612	19	2	76	0.0263158
NODE_4041_length_1182_cov_18.584488	536	612	20	4	76	0.0526316
NODE_4041_length_1182_cov_18.584488	536	612	22	1	76	0.0131579
NODE_4041_length_1182_cov_18.584488	536	612	25	1	76	0.0131579
NODE_4041_length_1182_cov_18.584488	536	612	26	10	76	0.1315790
NODE_4041_length_1182_cov_18.584488	536	612	27	5	76	0.0657895
NODE_4041_length_1182_cov_18.584488	536	612	28	9	76	0.1184211
NODE_4041_length_1182_cov_18.584488	536	612	29	2	76	0.0263158
NODE_4041_length_1182_cov_18.584488	536	612	30	2	76	0.0263158
NODE_4041_length_1182_cov_18.584488	536	612	31	23	76	0.3026316
NODE_4041_length_1182_cov_18.584488	536	612	32	10	76	0.1315790
NODE_4041_length_1182_cov_18.584488	608	688	28	12	80	0.1500000
NODE_4041_length_1182_cov_18.584488	608	688	29	7	80	0.0875000
NODE_4041_length_1182_cov_18.584488	608	688	30	6	80	0.0750000
NODE_4041_length_1182_cov_18.584488	608	688	31	24	80	0.3000000
NODE_4041_length_1182_cov_18.584488	608	688	32	10	80	0.1250000
NODE_4041_length_1182_cov_18.584488	608	688	34	7	80	0.0875000
NODE_4041_length_1182_cov_18.584488	608	688	35	14	80	0.1750000
NODE_4041_length_1182_cov_18.584488	671	741	13	5	70	0.0714286
NODE_4041_length_1182_cov_18.584488	671	741	14	15	70	0.2142857
NODE_4041_length_1182_cov_18.584488	671	741	17	9	70	0.1285714
NODE_4041_length_1182_cov_18.584488	671	741	18	6	70	0.0857143
NODE_4041_length_1182_cov_18.584488	671	741	19	6	70	0.0857143
NODE_4041_length_1182_cov_18.584488	671	741	21	1	70	0.0142857
NODE_4041_length_1182_cov_18.584488	671	741	23	2	70	0.0285714
NODE_4041_length_1182_cov_18.584488	671	741	26	7	70	0.1000000
NODE_4041_length_1182_cov_18.584488	671	741	28	1	70	0.0142857
NODE_4041_length_1182_cov_18.584488	671	741	29	8	70	0.1142857
NODE_4041_length_1182_cov_18.584488	671	741	32	10	70	0.1428571
NODE_4042_length_1182_cov_18.075716	598	678	9	47	80	0.5875000
NODE_4042_length_1182_cov_18.075716	598	678	10	33	80	0.4125000
NODE_4042_length_1182_cov_18.075716	651	731	3	2	80	0.0250000
NODE_4042_length_1182_cov_18.075716	651	731	4	3	80	0.0375000
NODE_4042_length_1182_cov_18.075716	651	731	6	20	80	0.2500000
NODE_4042_length_1182_cov_18.075716	651	731	7	14	80	0.1750000
NODE_4042_length_1182_cov_18.075716	651	731	10	41	80	0.5125000
NODE_4042_length_1182_cov_18.075716	727	807	0	12	80	0.1500000
NODE_4042_length_1182_cov_18.075716	727	807	1	51	80	0.6375000
NODE_4042_length_1182_cov_18.075716	727	807	3	15	80	0.1875000
NODE_4042_length_1182_cov_18.075716	727	807	4	2	80	0.0250000
NODE_4042_length_1182_cov_18.075716	780	860	0	39	80	0.4875000
NODE_4042_length_1182_cov_18.075716	780	860	1	41	80	0.5125000
NODE_4043_length_1182_cov_8.716528	464	544	1	13	80	0.1625000
NODE_4043_length_1182_cov_8.716528	464	544	2	67	80	0.8375000
NODE_4043_length_1182_cov_8.716528	517	597	1	37	80	0.4625000
NODE_4043_length_1182_cov_8.716528	517	597	2	43	80	0.5375000
NODE_4044_length_1182_cov_4.109880	793	873	1	80	80	1.0000000
NODE_4044_length_1182_cov_4.109880	846	926	0	46	80	0.5750000
NODE_4044_length_1182_cov_4.109880	846	926	1	34	80	0.4250000
NODE_4045_length_1182_cov_3.433980	1052	1100	0	8	48	0.1666667
NODE_4045_length_1182_cov_3.433980	1052	1100	1	40	48	0.8333333
NODE_4050_length_1181_cov_13.856747	687	767	5	14	80	0.1750000
NODE_4050_length_1181_cov_13.856747	687	767	6	8	80	0.1000000
NODE_4050_length_1181_cov_13.856747	687	767	7	5	80	0.0625000
NODE_4050_length_1181_cov_13.856747	687	767	8	11	80	0.1375000
NODE_4050_length_1181_cov_13.856747	687	767	9	25	80	0.3125000
NODE_4050_length_1181_cov_13.856747	687	767	10	10	80	0.1250000
NODE_4050_length_1181_cov_13.856747	687	767	11	7	80	0.0875000
NODE_4050_length_1181_cov_13.856747	740	820	6	8	80	0.1000000
NODE_4050_length_1181_cov_13.856747	740	820	9	2	80	0.0250000
NODE_4050_length_1181_cov_13.856747	740	820	10	10	80	0.1250000
NODE_4050_length_1181_cov_13.856747	740	820	11	17	80	0.2125000
NODE_4050_length_1181_cov_13.856747	740	820	12	20	80	0.2500000
NODE_4050_length_1181_cov_13.856747	740	820	13	23	80	0.2875000
NODE_4051_length_1181_cov_8.239372	735	815	0	80	80	1.0000000
NODE_4059_length_1180_cov_46.345051	695	775	16	3	80	0.0375000
NODE_4059_length_1180_cov_46.345051	695	775	17	1	80	0.0125000
NODE_4059_length_1180_cov_46.345051	695	775	18	2	80	0.0250000
NODE_4059_length_1180_cov_46.345051	695	775	22	7	80	0.0875000
NODE_4059_length_1180_cov_46.345051	695	775	25	7	80	0.0875000
NODE_4059_length_1180_cov_46.345051	695	775	26	9	80	0.1125000
NODE_4059_length_1180_cov_46.345051	695	775	27	3	80	0.0375000
NODE_4059_length_1180_cov_46.345051	695	775	28	15	80	0.1875000
NODE_4059_length_1180_cov_46.345051	695	775	29	7	80	0.0875000
NODE_4059_length_1180_cov_46.345051	695	775	30	10	80	0.1250000
NODE_4059_length_1180_cov_46.345051	695	775	31	16	80	0.2000000
NODE_4059_length_1180_cov_46.345051	748	828	15	7	80	0.0875000
NODE_4059_length_1180_cov_46.345051	748	828	16	49	80	0.6125000
NODE_4059_length_1180_cov_46.345051	748	828	17	1	80	0.0125000
NODE_4059_length_1180_cov_46.345051	748	828	18	2	80	0.0250000
NODE_4059_length_1180_cov_46.345051	748	828	22	7	80	0.0875000
NODE_4059_length_1180_cov_46.345051	748	828	25	2	80	0.0250000
NODE_4059_length_1180_cov_46.345051	748	828	26	4	80	0.0500000
NODE_4059_length_1180_cov_46.345051	748	828	27	3	80	0.0375000
NODE_4059_length_1180_cov_46.345051	748	828	28	5	80	0.0625000
NODE_4066_length_1179_cov_93.272222	660	740	46	14	80	0.1750000
NODE_4066_length_1179_cov_93.272222	660	740	47	3	80	0.0375000
NODE_4066_length_1179_cov_93.272222	660	740	48	13	80	0.1625000
NODE_4066_length_1179_cov_93.272222	660	740	49	6	80	0.0750000
NODE_4066_length_1179_cov_93.272222	660	740	50	15	80	0.1875000
NODE_4066_length_1179_cov_93.272222	660	740	51	1	80	0.0125000
NODE_4066_length_1179_cov_93.272222	660	740	52	5	80	0.0625000
NODE_4066_length_1179_cov_93.272222	660	740	54	4	80	0.0500000
NODE_4066_length_1179_cov_93.272222	660	740	55	7	80	0.0875000
NODE_4066_length_1179_cov_93.272222	660	740	56	7	80	0.0875000
NODE_4066_length_1179_cov_93.272222	660	740	57	5	80	0.0625000
NODE_4066_length_1179_cov_93.272222	713	793	34	10	80	0.1250000
NODE_4066_length_1179_cov_93.272222	713	793	35	2	80	0.0250000
NODE_4066_length_1179_cov_93.272222	713	793	38	6	80	0.0750000
NODE_4066_length_1179_cov_93.272222	713	793	39	1	80	0.0125000
NODE_4066_length_1179_cov_93.272222	713	793	40	11	80	0.1375000
NODE_4066_length_1179_cov_93.272222	713	793	41	7	80	0.0875000
NODE_4066_length_1179_cov_93.272222	713	793	42	3	80	0.0375000
NODE_4066_length_1179_cov_93.272222	713	793	43	8	80	0.1000000
NODE_4066_length_1179_cov_93.272222	713	793	45	2	80	0.0250000
NODE_4066_length_1179_cov_93.272222	713	793	46	14	80	0.1750000
NODE_4066_length_1179_cov_93.272222	713	793	47	4	80	0.0500000
NODE_4066_length_1179_cov_93.272222	713	793	48	4	80	0.0500000
NODE_4066_length_1179_cov_93.272222	713	793	50	8	80	0.1000000
NODE_4067_length_1179_cov_55.355556	547	627	22	2	80	0.0250000
NODE_4067_length_1179_cov_55.355556	547	627	24	2	80	0.0250000
NODE_4067_length_1179_cov_55.355556	547	627	25	1	80	0.0125000
NODE_4067_length_1179_cov_55.355556	547	627	27	11	80	0.1375000
NODE_4067_length_1179_cov_55.355556	547	627	29	2	80	0.0250000
NODE_4067_length_1179_cov_55.355556	547	627	30	2	80	0.0250000
NODE_4067_length_1179_cov_55.355556	547	627	31	12	80	0.1500000
NODE_4067_length_1179_cov_55.355556	547	627	32	2	80	0.0250000
NODE_4067_length_1179_cov_55.355556	547	627	33	1	80	0.0125000
NODE_4067_length_1179_cov_55.355556	547	627	34	4	80	0.0500000
NODE_4067_length_1179_cov_55.355556	547	627	35	9	80	0.1125000
NODE_4067_length_1179_cov_55.355556	547	627	36	22	80	0.2750000
NODE_4067_length_1179_cov_55.355556	547	627	37	10	80	0.1250000
NODE_4067_length_1179_cov_55.355556	600	680	20	2	80	0.0250000
NODE_4067_length_1179_cov_55.355556	600	680	21	2	80	0.0250000
NODE_4067_length_1179_cov_55.355556	600	680	23	3	80	0.0375000
NODE_4067_length_1179_cov_55.355556	600	680	24	1	80	0.0125000
NODE_4067_length_1179_cov_55.355556	600	680	25	12	80	0.1500000
NODE_4067_length_1179_cov_55.355556	600	680	26	14	80	0.1750000
NODE_4067_length_1179_cov_55.355556	600	680	27	3	80	0.0375000
NODE_4067_length_1179_cov_55.355556	600	680	28	7	80	0.0875000
NODE_4067_length_1179_cov_55.355556	600	680	29	2	80	0.0250000
NODE_4067_length_1179_cov_55.355556	600	680	31	11	80	0.1375000
NODE_4067_length_1179_cov_55.355556	600	680	32	1	80	0.0125000
NODE_4067_length_1179_cov_55.355556	600	680	33	1	80	0.0125000
NODE_4067_length_1179_cov_55.355556	600	680	34	3	80	0.0375000
NODE_4067_length_1179_cov_55.355556	600	680	35	8	80	0.1000000
NODE_4067_length_1179_cov_55.355556	600	680	36	10	80	0.1250000
NODE_4068_length_1179_cov_29.712037	613	693	9	1	80	0.0125000
NODE_4068_length_1179_cov_29.712037	613	693	10	57	80	0.7125000
NODE_4068_length_1179_cov_29.712037	613	693	11	5	80	0.0625000
NODE_4068_length_1179_cov_29.712037	613	693	12	7	80	0.0875000
NODE_4068_length_1179_cov_29.712037	613	693	14	4	80	0.0500000
NODE_4068_length_1179_cov_29.712037	613	693	15	6	80	0.0750000
NODE_4068_length_1179_cov_29.712037	666	746	6	9	80	0.1125000
NODE_4068_length_1179_cov_29.712037	666	746	7	2	80	0.0250000
NODE_4068_length_1179_cov_29.712037	666	746	8	14	80	0.1750000
NODE_4068_length_1179_cov_29.712037	666	746	10	5	80	0.0625000
NODE_4068_length_1179_cov_29.712037	666	746	11	13	80	0.1625000
NODE_4068_length_1179_cov_29.712037	666	746	12	27	80	0.3375000
NODE_4068_length_1179_cov_29.712037	666	746	14	4	80	0.0500000
NODE_4068_length_1179_cov_29.712037	666	746	15	6	80	0.0750000
NODE_4069_length_1179_cov_26.767593	483	563	1	41	80	0.5125000
NODE_4069_length_1179_cov_26.767593	483	563	2	4	80	0.0500000
NODE_4069_length_1179_cov_26.767593	483	563	3	2	80	0.0250000
NODE_4069_length_1179_cov_26.767593	483	563	4	12	80	0.1500000
NODE_4069_length_1179_cov_26.767593	483	563	5	21	80	0.2625000
NODE_4069_length_1179_cov_26.767593	536	616	4	28	80	0.3500000
NODE_4069_length_1179_cov_26.767593	536	616	5	52	80	0.6500000
NODE_4069_length_1179_cov_26.767593	612	692	1	10	80	0.1250000
NODE_4069_length_1179_cov_26.767593	612	692	2	4	80	0.0500000
NODE_4069_length_1179_cov_26.767593	612	692	3	4	80	0.0500000
NODE_4069_length_1179_cov_26.767593	612	692	4	62	80	0.7750000
NODE_4069_length_1179_cov_26.767593	665	745	1	53	80	0.6625000
NODE_4069_length_1179_cov_26.767593	665	745	2	14	80	0.1750000
NODE_4069_length_1179_cov_26.767593	665	745	3	4	80	0.0500000
NODE_4069_length_1179_cov_26.767593	665	745	4	9	80	0.1125000
NODE_4070_length_1179_cov_22.249074	581	661	12	10	80	0.1250000
NODE_4070_length_1179_cov_22.249074	581	661	13	12	80	0.1500000
NODE_4070_length_1179_cov_22.249074	581	661	14	11	80	0.1375000
NODE_4070_length_1179_cov_22.249074	581	661	15	24	80	0.3000000
NODE_4070_length_1179_cov_22.249074	581	661	16	10	80	0.1250000
NODE_4070_length_1179_cov_22.249074	581	661	17	13	80	0.1625000
NODE_4070_length_1179_cov_22.249074	634	714	9	9	80	0.1125000
NODE_4070_length_1179_cov_22.249074	634	714	11	3	80	0.0375000
NODE_4070_length_1179_cov_22.249074	634	714	12	20	80	0.2500000
NODE_4070_length_1179_cov_22.249074	634	714	13	14	80	0.1750000
NODE_4070_length_1179_cov_22.249074	634	714	14	16	80	0.2000000
NODE_4070_length_1179_cov_22.249074	634	714	15	18	80	0.2250000
NODE_4071_length_1179_cov_16.538889	498	568	32	3	70	0.0428571
NODE_4071_length_1179_cov_16.538889	498	568	34	4	70	0.0571429
NODE_4071_length_1179_cov_16.538889	498	568	36	1	70	0.0142857
NODE_4071_length_1179_cov_16.538889	498	568	37	6	70	0.0857143
NODE_4071_length_1179_cov_16.538889	498	568	39	1	70	0.0142857
NODE_4071_length_1179_cov_16.538889	498	568	40	6	70	0.0857143
NODE_4071_length_1179_cov_16.538889	498	568	41	5	70	0.0714286
NODE_4071_length_1179_cov_16.538889	498	568	42	5	70	0.0714286
NODE_4071_length_1179_cov_16.538889	498	568	43	14	70	0.2000000
NODE_4071_length_1179_cov_16.538889	498	568	44	3	70	0.0428571
NODE_4071_length_1179_cov_16.538889	498	568	45	2	70	0.0285714
NODE_4071_length_1179_cov_16.538889	498	568	46	2	70	0.0285714
NODE_4071_length_1179_cov_16.538889	498	568	47	10	70	0.1428571
NODE_4071_length_1179_cov_16.538889	498	568	48	6	70	0.0857143
NODE_4071_length_1179_cov_16.538889	498	568	49	2	70	0.0285714
NODE_4072_length_1179_cov_15.442593	535	615	0	80	80	1.0000000
NODE_4072_length_1179_cov_15.442593	588	668	0	80	80	1.0000000
NODE_4076_length_1179_cov_2.419444	1108	1155	0	47	47	1.0000000
NODE_4078_length_1179_cov_1.009259	944	1024	0	80	80	1.0000000
NODE_4078_length_1179_cov_1.009259	997	1077	0	80	80	1.0000000
NODE_4079_length_1178_cov_42.484708	423	503	15	62	80	0.7750000
NODE_4079_length_1178_cov_42.484708	423	503	17	1	80	0.0125000
NODE_4079_length_1178_cov_42.484708	423	503	18	17	80	0.2125000
NODE_4079_length_1178_cov_42.484708	476	556	4	15	80	0.1875000
NODE_4079_length_1178_cov_42.484708	476	556	6	18	80	0.2250000
NODE_4079_length_1178_cov_42.484708	476	556	7	10	80	0.1250000
NODE_4079_length_1178_cov_42.484708	476	556	8	5	80	0.0625000
NODE_4079_length_1178_cov_42.484708	476	556	14	1	80	0.0125000
NODE_4079_length_1178_cov_42.484708	476	556	15	31	80	0.3875000
NODE_4079_length_1178_cov_42.484708	552	632	4	47	80	0.5875000
NODE_4079_length_1178_cov_42.484708	552	632	5	11	80	0.1375000
NODE_4079_length_1178_cov_42.484708	552	632	6	8	80	0.1000000
NODE_4079_length_1178_cov_42.484708	552	632	7	8	80	0.1000000
NODE_4079_length_1178_cov_42.484708	552	632	8	6	80	0.0750000
NODE_4079_length_1178_cov_42.484708	605	685	4	14	80	0.1750000
NODE_4079_length_1178_cov_42.484708	605	685	5	11	80	0.1375000
NODE_4079_length_1178_cov_42.484708	605	685	6	13	80	0.1625000
NODE_4079_length_1178_cov_42.484708	605	685	8	42	80	0.5250000
NODE_4080_length_1178_cov_15.332715	215	295	4	66	80	0.8250000
NODE_4080_length_1178_cov_15.332715	215	295	7	14	80	0.1750000
NODE_4080_length_1178_cov_15.332715	268	348	4	13	80	0.1625000
NODE_4080_length_1178_cov_15.332715	268	348	7	67	80	0.8375000
NODE_4081_length_1178_cov_11.403151	527	607	18	9	80	0.1125000
NODE_4081_length_1178_cov_11.403151	527	607	19	52	80	0.6500000
NODE_4081_length_1178_cov_11.403151	527	607	20	9	80	0.1125000
NODE_4081_length_1178_cov_11.403151	527	607	21	10	80	0.1250000
NODE_4081_length_1178_cov_11.403151	580	660	14	6	80	0.0750000
NODE_4081_length_1178_cov_11.403151	580	660	15	9	80	0.1125000
NODE_4081_length_1178_cov_11.403151	580	660	16	1	80	0.0125000
NODE_4081_length_1178_cov_11.403151	580	660	18	5	80	0.0625000
NODE_4081_length_1178_cov_11.403151	580	660	19	26	80	0.3250000
NODE_4081_length_1178_cov_11.403151	580	660	20	13	80	0.1625000
NODE_4081_length_1178_cov_11.403151	580	660	21	7	80	0.0875000
NODE_4081_length_1178_cov_11.403151	580	660	22	4	80	0.0500000
NODE_4081_length_1178_cov_11.403151	580	660	23	9	80	0.1125000
NODE_4084_length_1177_cov_34.920223	369	449	6	31	80	0.3875000
NODE_4084_length_1177_cov_34.920223	369	449	7	41	80	0.5125000
NODE_4084_length_1177_cov_34.920223	369	449	8	6	80	0.0750000
NODE_4084_length_1177_cov_34.920223	369	449	9	2	80	0.0250000
NODE_4084_length_1177_cov_34.920223	422	502	7	19	80	0.2375000
NODE_4084_length_1177_cov_34.920223	422	502	8	6	80	0.0750000
NODE_4084_length_1177_cov_34.920223	422	502	9	25	80	0.3125000
NODE_4084_length_1177_cov_34.920223	422	502	10	5	80	0.0625000
NODE_4084_length_1177_cov_34.920223	422	502	12	13	80	0.1625000
NODE_4084_length_1177_cov_34.920223	422	502	14	10	80	0.1250000
NODE_4084_length_1177_cov_34.920223	422	502	15	2	80	0.0250000
NODE_4084_length_1177_cov_34.920223	498	578	12	24	80	0.3000000
NODE_4084_length_1177_cov_34.920223	498	578	13	22	80	0.2750000
NODE_4084_length_1177_cov_34.920223	498	578	14	1	80	0.0125000
NODE_4084_length_1177_cov_34.920223	498	578	17	28	80	0.3500000
NODE_4084_length_1177_cov_34.920223	498	578	18	5	80	0.0625000
NODE_4084_length_1177_cov_34.920223	551	631	13	6	80	0.0750000
NODE_4084_length_1177_cov_34.920223	551	631	15	3	80	0.0375000
NODE_4084_length_1177_cov_34.920223	551	631	16	25	80	0.3125000
NODE_4084_length_1177_cov_34.920223	551	631	17	36	80	0.4500000
NODE_4084_length_1177_cov_34.920223	551	631	18	10	80	0.1250000
NODE_4085_length_1177_cov_12.186456	481	561	1	24	80	0.3000000
NODE_4085_length_1177_cov_12.186456	481	561	2	56	80	0.7000000
NODE_4085_length_1177_cov_12.186456	534	614	2	80	80	1.0000000
NODE_4085_length_1177_cov_12.186456	610	690	1	22	80	0.2750000
NODE_4085_length_1177_cov_12.186456	610	690	2	7	80	0.0875000
NODE_4085_length_1177_cov_12.186456	610	690	6	13	80	0.1625000
NODE_4085_length_1177_cov_12.186456	610	690	7	35	80	0.4375000
NODE_4085_length_1177_cov_12.186456	610	690	8	3	80	0.0375000
NODE_4085_length_1177_cov_12.186456	663	743	7	32	80	0.4000000
NODE_4085_length_1177_cov_12.186456	663	743	8	45	80	0.5625000
NODE_4085_length_1177_cov_12.186456	663	743	9	3	80	0.0375000
NODE_4086_length_1177_cov_11.926716	443	523	0	43	80	0.5375000
NODE_4086_length_1177_cov_11.926716	443	523	1	13	80	0.1625000
NODE_4086_length_1177_cov_11.926716	443	523	2	24	80	0.3000000
NODE_4086_length_1177_cov_11.926716	496	578	1	3	82	0.0365854
NODE_4086_length_1177_cov_11.926716	496	578	2	79	82	0.9634146
NODE_4088_length_1177_cov_5.923933	358	438	6	3	80	0.0375000
NODE_4088_length_1177_cov_5.923933	358	438	7	9	80	0.1125000
NODE_4088_length_1177_cov_5.923933	358	438	9	50	80	0.6250000
NODE_4088_length_1177_cov_5.923933	358	438	10	11	80	0.1375000
NODE_4088_length_1177_cov_5.923933	358	438	12	7	80	0.0875000
NODE_4088_length_1177_cov_5.923933	411	491	3	32	80	0.4000000
NODE_4088_length_1177_cov_5.923933	411	491	5	9	80	0.1125000
NODE_4088_length_1177_cov_5.923933	411	491	6	15	80	0.1875000
NODE_4088_length_1177_cov_5.923933	411	491	9	24	80	0.3000000
NODE_4089_length_1177_cov_5.775510	760	840	0	12	80	0.1500000
NODE_4089_length_1177_cov_5.775510	760	840	1	68	80	0.8500000
NODE_4089_length_1177_cov_5.775510	813	893	1	63	80	0.7875000
NODE_4089_length_1177_cov_5.775510	813	893	2	17	80	0.2125000
NODE_4096_length_1176_cov_26.994429	377	457	5	24	80	0.3000000
NODE_4096_length_1176_cov_26.994429	377	457	6	22	80	0.2750000
NODE_4096_length_1176_cov_26.994429	377	457	7	34	80	0.4250000
NODE_4096_length_1176_cov_26.994429	430	510	5	4	80	0.0500000
NODE_4096_length_1176_cov_26.994429	430	510	6	23	80	0.2875000
NODE_4096_length_1176_cov_26.994429	430	510	7	53	80	0.6625000
NODE_4096_length_1176_cov_26.994429	506	586	3	2	80	0.0250000
NODE_4096_length_1176_cov_26.994429	506	586	4	38	80	0.4750000
NODE_4096_length_1176_cov_26.994429	506	586	5	27	80	0.3375000
NODE_4096_length_1176_cov_26.994429	506	586	7	13	80	0.1625000
NODE_4096_length_1176_cov_26.994429	559	639	4	30	80	0.3750000
NODE_4096_length_1176_cov_26.994429	559	639	5	30	80	0.3750000
NODE_4096_length_1176_cov_26.994429	559	639	6	20	80	0.2500000
NODE_4097_length_1176_cov_15.766945	531	611	1	11	80	0.1375000
NODE_4097_length_1176_cov_15.766945	531	611	2	1	80	0.0125000
NODE_4097_length_1176_cov_15.766945	531	611	4	44	80	0.5500000
NODE_4097_length_1176_cov_15.766945	531	611	6	24	80	0.3000000
NODE_4097_length_1176_cov_15.766945	584	664	4	74	80	0.9250000
NODE_4097_length_1176_cov_15.766945	584	664	6	6	80	0.0750000
NODE_4098_length_1176_cov_14.882080	628	708	4	35	80	0.4375000
NODE_4098_length_1176_cov_14.882080	628	708	5	14	80	0.1750000
NODE_4098_length_1176_cov_14.882080	628	708	7	4	80	0.0500000
NODE_4098_length_1176_cov_14.882080	628	708	8	27	80	0.3375000
NODE_4098_length_1176_cov_14.882080	681	761	5	1	80	0.0125000
NODE_4098_length_1176_cov_14.882080	681	761	6	21	80	0.2625000
NODE_4098_length_1176_cov_14.882080	681	761	7	1	80	0.0125000
NODE_4098_length_1176_cov_14.882080	681	761	8	57	80	0.7125000
NODE_4099_length_1176_cov_10.692665	392	472	0	16	80	0.2000000
NODE_4099_length_1176_cov_10.692665	392	472	1	64	80	0.8000000
NODE_4099_length_1176_cov_10.692665	445	525	0	69	80	0.8625000
NODE_4099_length_1176_cov_10.692665	445	525	1	11	80	0.1375000
NODE_4106_length_1175_cov_50.754647	526	606	7	3	80	0.0375000
NODE_4106_length_1175_cov_50.754647	526	606	9	11	80	0.1375000
NODE_4106_length_1175_cov_50.754647	526	606	10	5	80	0.0625000
NODE_4106_length_1175_cov_50.754647	526	606	11	3	80	0.0375000
NODE_4106_length_1175_cov_50.754647	526	606	16	2	80	0.0250000
NODE_4106_length_1175_cov_50.754647	526	606	17	3	80	0.0375000
NODE_4106_length_1175_cov_50.754647	526	606	19	3	80	0.0375000
NODE_4106_length_1175_cov_50.754647	526	606	21	23	80	0.2875000
NODE_4106_length_1175_cov_50.754647	526	606	23	13	80	0.1625000
NODE_4106_length_1175_cov_50.754647	526	606	25	7	80	0.0875000
NODE_4106_length_1175_cov_50.754647	526	606	26	1	80	0.0125000
NODE_4106_length_1175_cov_50.754647	526	606	27	6	80	0.0750000
NODE_4106_length_1175_cov_50.754647	579	659	23	13	80	0.1625000
NODE_4106_length_1175_cov_50.754647	579	659	25	7	80	0.0875000
NODE_4106_length_1175_cov_50.754647	579	659	26	9	80	0.1125000
NODE_4106_length_1175_cov_50.754647	579	659	27	22	80	0.2750000
NODE_4106_length_1175_cov_50.754647	579	659	28	5	80	0.0625000
NODE_4106_length_1175_cov_50.754647	579	659	29	2	80	0.0250000
NODE_4106_length_1175_cov_50.754647	579	659	30	4	80	0.0500000
NODE_4106_length_1175_cov_50.754647	579	659	35	18	80	0.2250000
NODE_4107_length_1175_cov_42.638476	327	407	29	21	80	0.2625000
NODE_4107_length_1175_cov_42.638476	327	407	30	1	80	0.0125000
NODE_4107_length_1175_cov_42.638476	327	407	32	1	80	0.0125000
NODE_4107_length_1175_cov_42.638476	327	407	36	4	80	0.0500000
NODE_4107_length_1175_cov_42.638476	327	407	37	15	80	0.1875000
NODE_4107_length_1175_cov_42.638476	327	407	38	9	80	0.1125000
NODE_4107_length_1175_cov_42.638476	327	407	39	6	80	0.0750000
NODE_4107_length_1175_cov_42.638476	327	407	40	16	80	0.2000000
NODE_4107_length_1175_cov_42.638476	327	407	42	7	80	0.0875000
NODE_4107_length_1175_cov_42.638476	380	460	27	4	80	0.0500000
NODE_4107_length_1175_cov_42.638476	380	460	29	2	80	0.0250000
NODE_4107_length_1175_cov_42.638476	380	460	31	1	80	0.0125000
NODE_4107_length_1175_cov_42.638476	380	460	32	5	80	0.0625000
NODE_4107_length_1175_cov_42.638476	380	460	33	7	80	0.0875000
NODE_4107_length_1175_cov_42.638476	380	460	35	8	80	0.1000000
NODE_4107_length_1175_cov_42.638476	380	460	36	3	80	0.0375000
NODE_4107_length_1175_cov_42.638476	380	460	37	15	80	0.1875000
NODE_4107_length_1175_cov_42.638476	380	460	38	29	80	0.3625000
NODE_4107_length_1175_cov_42.638476	380	460	39	4	80	0.0500000
NODE_4107_length_1175_cov_42.638476	380	460	40	2	80	0.0250000
NODE_4107_length_1175_cov_42.638476	456	536	7	10	80	0.1250000
NODE_4107_length_1175_cov_42.638476	456	536	8	21	80	0.2625000
NODE_4107_length_1175_cov_42.638476	456	536	9	1	80	0.0125000
NODE_4107_length_1175_cov_42.638476	456	536	11	4	80	0.0500000
NODE_4107_length_1175_cov_42.638476	456	536	15	1	80	0.0125000
NODE_4107_length_1175_cov_42.638476	456	536	16	1	80	0.0125000
NODE_4107_length_1175_cov_42.638476	456	536	20	23	80	0.2875000
NODE_4107_length_1175_cov_42.638476	456	536	21	3	80	0.0375000
NODE_4107_length_1175_cov_42.638476	456	536	26	1	80	0.0125000
NODE_4107_length_1175_cov_42.638476	456	536	27	2	80	0.0250000
NODE_4107_length_1175_cov_42.638476	456	536	29	13	80	0.1625000
NODE_4107_length_1175_cov_42.638476	509	589	5	20	80	0.2500000
NODE_4107_length_1175_cov_42.638476	509	589	6	20	80	0.2500000
NODE_4107_length_1175_cov_42.638476	509	589	7	19	80	0.2375000
NODE_4107_length_1175_cov_42.638476	509	589	8	21	80	0.2625000
NODE_4108_length_1175_cov_40.217472	437	517	6	4	80	0.0500000
NODE_4108_length_1175_cov_40.217472	437	517	7	27	80	0.3375000
NODE_4108_length_1175_cov_40.217472	437	517	8	14	80	0.1750000
NODE_4108_length_1175_cov_40.217472	437	517	9	35	80	0.4375000
NODE_4108_length_1175_cov_40.217472	490	570	7	3	80	0.0375000
NODE_4108_length_1175_cov_40.217472	490	570	8	28	80	0.3500000
NODE_4108_length_1175_cov_40.217472	490	570	9	32	80	0.4000000
NODE_4108_length_1175_cov_40.217472	490	570	10	17	80	0.2125000
NODE_4108_length_1175_cov_40.217472	566	646	6	2	80	0.0250000
NODE_4108_length_1175_cov_40.217472	566	646	7	12	80	0.1500000
NODE_4108_length_1175_cov_40.217472	566	646	8	41	80	0.5125000
NODE_4108_length_1175_cov_40.217472	566	646	9	16	80	0.2000000
NODE_4108_length_1175_cov_40.217472	566	646	10	9	80	0.1125000
NODE_4108_length_1175_cov_40.217472	619	699	7	38	80	0.4750000
NODE_4108_length_1175_cov_40.217472	619	699	8	25	80	0.3125000
NODE_4108_length_1175_cov_40.217472	619	699	9	8	80	0.1000000
NODE_4108_length_1175_cov_40.217472	619	699	10	9	80	0.1125000
NODE_4109_length_1175_cov_12.834572	775	855	11	6	80	0.0750000
NODE_4109_length_1175_cov_12.834572	775	855	14	4	80	0.0500000
NODE_4109_length_1175_cov_12.834572	775	855	15	49	80	0.6125000
NODE_4109_length_1175_cov_12.834572	775	855	16	21	80	0.2625000
NODE_4109_length_1175_cov_12.834572	828	908	2	7	80	0.0875000
NODE_4109_length_1175_cov_12.834572	828	908	5	2	80	0.0250000
NODE_4109_length_1175_cov_12.834572	828	908	6	3	80	0.0375000
NODE_4109_length_1175_cov_12.834572	828	908	9	2	80	0.0250000
NODE_4109_length_1175_cov_12.834572	828	908	10	37	80	0.4625000
NODE_4109_length_1175_cov_12.834572	828	908	11	8	80	0.1000000
NODE_4109_length_1175_cov_12.834572	828	908	14	4	80	0.0500000
NODE_4109_length_1175_cov_12.834572	828	908	15	17	80	0.2125000
NODE_4115_length_1174_cov_20.569302	433	513	4	3	80	0.0375000
NODE_4115_length_1174_cov_20.569302	433	513	5	24	80	0.3000000
NODE_4115_length_1174_cov_20.569302	433	513	6	53	80	0.6625000
NODE_4115_length_1174_cov_20.569302	486	566	2	4	80	0.0500000
NODE_4115_length_1174_cov_20.569302	486	566	3	22	80	0.2750000
NODE_4115_length_1174_cov_20.569302	486	566	4	30	80	0.3750000
NODE_4115_length_1174_cov_20.569302	486	566	5	9	80	0.1125000
NODE_4115_length_1174_cov_20.569302	486	566	6	15	80	0.1875000
NODE_4115_length_1174_cov_20.569302	562	642	3	64	80	0.8000000
NODE_4115_length_1174_cov_20.569302	562	642	4	16	80	0.2000000
NODE_4115_length_1174_cov_20.569302	615	695	2	10	80	0.1250000
NODE_4115_length_1174_cov_20.569302	615	695	3	70	80	0.8750000
NODE_4116_length_1174_cov_18.797209	578	658	0	80	80	1.0000000
NODE_4116_length_1174_cov_18.797209	631	711	0	80	80	1.0000000
NODE_4117_length_1174_cov_17.486512	589	669	23	26	80	0.3250000
NODE_4117_length_1174_cov_17.486512	589	669	24	13	80	0.1625000
NODE_4117_length_1174_cov_17.486512	589	669	25	13	80	0.1625000
NODE_4117_length_1174_cov_17.486512	589	669	27	12	80	0.1500000
NODE_4117_length_1174_cov_17.486512	589	669	28	10	80	0.1250000
NODE_4117_length_1174_cov_17.486512	589	669	29	6	80	0.0750000
NODE_4117_length_1174_cov_17.486512	642	722	8	9	80	0.1125000
NODE_4117_length_1174_cov_17.486512	642	722	10	1	80	0.0125000
NODE_4117_length_1174_cov_17.486512	642	722	11	1	80	0.0125000
NODE_4117_length_1174_cov_17.486512	642	722	15	7	80	0.0875000
NODE_4117_length_1174_cov_17.486512	642	722	16	11	80	0.1375000
NODE_4117_length_1174_cov_17.486512	642	722	17	12	80	0.1500000
NODE_4117_length_1174_cov_17.486512	642	722	19	3	80	0.0375000
NODE_4117_length_1174_cov_17.486512	642	722	20	2	80	0.0250000
NODE_4117_length_1174_cov_17.486512	642	722	21	3	80	0.0375000
NODE_4117_length_1174_cov_17.486512	642	722	22	4	80	0.0500000
NODE_4117_length_1174_cov_17.486512	642	722	23	26	80	0.3250000
NODE_4117_length_1174_cov_17.486512	642	722	24	1	80	0.0125000
NODE_4118_length_1174_cov_15.888372	570	650	0	28	80	0.3500000
NODE_4118_length_1174_cov_15.888372	570	650	1	31	80	0.3875000
NODE_4118_length_1174_cov_15.888372	570	650	3	16	80	0.2000000
NODE_4118_length_1174_cov_15.888372	570	650	4	5	80	0.0625000
NODE_4118_length_1174_cov_15.888372	623	703	1	6	80	0.0750000
NODE_4118_length_1174_cov_15.888372	623	703	3	16	80	0.2000000
NODE_4118_length_1174_cov_15.888372	623	703	4	6	80	0.0750000
NODE_4118_length_1174_cov_15.888372	623	703	9	41	80	0.5125000
NODE_4118_length_1174_cov_15.888372	623	703	10	11	80	0.1375000
NODE_4118_length_1174_cov_15.888372	699	779	8	8	80	0.1000000
NODE_4118_length_1174_cov_15.888372	699	779	9	20	80	0.2500000
NODE_4118_length_1174_cov_15.888372	699	779	10	52	80	0.6500000
NODE_4118_length_1174_cov_15.888372	752	832	3	31	80	0.3875000
NODE_4118_length_1174_cov_15.888372	752	832	8	18	80	0.2250000
NODE_4118_length_1174_cov_15.888372	752	832	9	28	80	0.3500000
NODE_4118_length_1174_cov_15.888372	752	832	10	3	80	0.0375000
NODE_4124_length_1174_cov_1.536744	1066	1115	0	49	49	1.0000000
NODE_4124_length_1174_cov_1.536744	1088	1168	0	80	80	1.0000000
NODE_4128_length_1173_cov_29.562384	455	535	7	14	80	0.1750000
NODE_4128_length_1173_cov_29.562384	455	535	8	61	80	0.7625000
NODE_4128_length_1173_cov_29.562384	455	535	9	5	80	0.0625000
NODE_4128_length_1173_cov_29.562384	508	588	6	21	80	0.2625000
NODE_4128_length_1173_cov_29.562384	508	588	7	14	80	0.1750000
NODE_4128_length_1173_cov_29.562384	508	588	8	31	80	0.3875000
NODE_4128_length_1173_cov_29.562384	508	588	9	11	80	0.1375000
NODE_4128_length_1173_cov_29.562384	508	588	10	3	80	0.0375000
NODE_4128_length_1173_cov_29.562384	584	664	5	33	80	0.4125000
NODE_4128_length_1173_cov_29.562384	584	664	6	47	80	0.5875000
NODE_4128_length_1173_cov_29.562384	637	717	2	10	80	0.1250000
NODE_4128_length_1173_cov_29.562384	637	717	4	24	80	0.3000000
NODE_4128_length_1173_cov_29.562384	637	717	5	9	80	0.1125000
NODE_4128_length_1173_cov_29.562384	637	717	6	37	80	0.4625000
NODE_4129_length_1173_cov_25.206704	395	475	5	1	80	0.0125000
NODE_4129_length_1173_cov_25.206704	395	475	7	16	80	0.2000000
NODE_4129_length_1173_cov_25.206704	395	475	8	12	80	0.1500000
NODE_4129_length_1173_cov_25.206704	395	475	9	51	80	0.6375000
NODE_4129_length_1173_cov_25.206704	448	528	3	1	80	0.0125000
NODE_4129_length_1173_cov_25.206704	448	528	5	11	80	0.1375000
NODE_4129_length_1173_cov_25.206704	448	528	8	7	80	0.0875000
NODE_4129_length_1173_cov_25.206704	448	528	9	61	80	0.7625000
NODE_4130_length_1173_cov_9.486965	693	773	5	38	80	0.4750000
NODE_4130_length_1173_cov_9.486965	693	773	6	15	80	0.1875000
NODE_4130_length_1173_cov_9.486965	693	773	7	27	80	0.3375000
NODE_4130_length_1173_cov_9.486965	746	826	3	37	80	0.4625000
NODE_4130_length_1173_cov_9.486965	746	826	7	43	80	0.5375000
NODE_4131_length_1173_cov_7.946927	201	281	21	19	80	0.2375000
NODE_4131_length_1173_cov_7.946927	201	281	23	2	80	0.0250000
NODE_4131_length_1173_cov_7.946927	201	281	24	23	80	0.2875000
NODE_4131_length_1173_cov_7.946927	201	281	25	21	80	0.2625000
NODE_4131_length_1173_cov_7.946927	201	281	26	11	80	0.1375000
NODE_4131_length_1173_cov_7.946927	201	281	27	3	80	0.0375000
NODE_4131_length_1173_cov_7.946927	201	281	28	1	80	0.0125000
NODE_4131_length_1173_cov_7.946927	254	334	19	30	80	0.3750000
NODE_4131_length_1173_cov_7.946927	254	334	20	10	80	0.1250000
NODE_4131_length_1173_cov_7.946927	254	334	21	26	80	0.3250000
NODE_4131_length_1173_cov_7.946927	254	334	22	6	80	0.0750000
NODE_4131_length_1173_cov_7.946927	254	334	24	8	80	0.1000000
NODE_4136_length_1172_cov_37.177074	527	607	2	45	80	0.5625000
NODE_4136_length_1172_cov_37.177074	527	607	3	11	80	0.1375000
NODE_4136_length_1172_cov_37.177074	527	607	4	12	80	0.1500000
NODE_4136_length_1172_cov_37.177074	527	607	5	12	80	0.1500000
NODE_4136_length_1172_cov_37.177074	580	660	3	26	80	0.3250000
NODE_4136_length_1172_cov_37.177074	580	660	4	42	80	0.5250000
NODE_4136_length_1172_cov_37.177074	580	660	5	12	80	0.1500000
NODE_4137_length_1172_cov_20.397018	677	757	5	16	80	0.2000000
NODE_4137_length_1172_cov_20.397018	677	757	6	23	80	0.2875000
NODE_4137_length_1172_cov_20.397018	677	757	8	24	80	0.3000000
NODE_4137_length_1172_cov_20.397018	677	757	9	5	80	0.0625000
NODE_4137_length_1172_cov_20.397018	677	757	10	12	80	0.1500000
NODE_4137_length_1172_cov_20.397018	730	810	8	10	80	0.1250000
NODE_4137_length_1172_cov_20.397018	730	810	9	5	80	0.0625000
NODE_4137_length_1172_cov_20.397018	730	810	10	38	80	0.4750000
NODE_4137_length_1172_cov_20.397018	730	810	11	7	80	0.0875000
NODE_4137_length_1172_cov_20.397018	730	810	12	6	80	0.0750000
NODE_4137_length_1172_cov_20.397018	730	810	14	9	80	0.1125000
NODE_4137_length_1172_cov_20.397018	730	810	15	5	80	0.0625000
NODE_4138_length_1172_cov_15.018639	460	540	6	30	80	0.3750000
NODE_4138_length_1172_cov_15.018639	460	540	7	21	80	0.2625000
NODE_4138_length_1172_cov_15.018639	460	540	8	26	80	0.3250000
NODE_4138_length_1172_cov_15.018639	460	540	9	3	80	0.0375000
NODE_4138_length_1172_cov_15.018639	513	593	3	3	80	0.0375000
NODE_4138_length_1172_cov_15.018639	513	593	4	25	80	0.3125000
NODE_4138_length_1172_cov_15.018639	513	593	6	4	80	0.0500000
NODE_4138_length_1172_cov_15.018639	513	593	7	4	80	0.0500000
NODE_4138_length_1172_cov_15.018639	513	593	8	24	80	0.3000000
NODE_4138_length_1172_cov_15.018639	513	593	9	20	80	0.2500000
NODE_4139_length_1172_cov_13.199441	622	702	12	2	80	0.0250000
NODE_4139_length_1172_cov_13.199441	622	702	13	20	80	0.2500000
NODE_4139_length_1172_cov_13.199441	622	702	14	23	80	0.2875000
NODE_4139_length_1172_cov_13.199441	622	702	15	20	80	0.2500000
NODE_4139_length_1172_cov_13.199441	622	702	16	7	80	0.0875000
NODE_4139_length_1172_cov_13.199441	622	702	17	8	80	0.1000000
NODE_4139_length_1172_cov_13.199441	675	755	12	19	80	0.2375000
NODE_4139_length_1172_cov_13.199441	675	755	13	21	80	0.2625000
NODE_4139_length_1172_cov_13.199441	675	755	14	13	80	0.1625000
NODE_4139_length_1172_cov_13.199441	675	755	15	27	80	0.3375000
NODE_4140_length_1172_cov_10.720410	499	579	10	45	80	0.5625000
NODE_4140_length_1172_cov_10.720410	499	579	11	8	80	0.1000000
NODE_4140_length_1172_cov_10.720410	499	579	12	27	80	0.3375000
NODE_4140_length_1172_cov_10.720410	552	632	4	4	80	0.0500000
NODE_4140_length_1172_cov_10.720410	552	632	6	17	80	0.2125000
NODE_4140_length_1172_cov_10.720410	552	632	7	10	80	0.1250000
NODE_4140_length_1172_cov_10.720410	552	632	8	19	80	0.2375000
NODE_4140_length_1172_cov_10.720410	552	632	9	2	80	0.0250000
NODE_4140_length_1172_cov_10.720410	552	632	10	28	80	0.3500000
NODE_4140_length_1172_cov_10.720410	628	708	1	25	80	0.3125000
NODE_4140_length_1172_cov_10.720410	628	708	2	44	80	0.5500000
NODE_4140_length_1172_cov_10.720410	628	708	3	5	80	0.0625000
NODE_4140_length_1172_cov_10.720410	628	708	4	6	80	0.0750000
NODE_4140_length_1172_cov_10.720410	681	761	0	18	80	0.2250000
NODE_4140_length_1172_cov_10.720410	681	761	1	60	80	0.7500000
NODE_4140_length_1172_cov_10.720410	681	761	2	2	80	0.0250000
NODE_4141_length_1172_cov_10.574091	951	1021	4	3	70	0.0428571
NODE_4141_length_1172_cov_10.574091	951	1021	5	8	70	0.1142857
NODE_4141_length_1172_cov_10.574091	951	1021	7	23	70	0.3285714
NODE_4141_length_1172_cov_10.574091	951	1021	8	34	70	0.4857143
NODE_4141_length_1172_cov_10.574091	951	1021	12	2	70	0.0285714
NODE_4142_length_1172_cov_9.204101	276	356	2	80	80	1.0000000
NODE_4142_length_1172_cov_9.204101	329	409	1	3	80	0.0375000
NODE_4142_length_1172_cov_9.204101	329	409	2	48	80	0.6000000
NODE_4142_length_1172_cov_9.204101	329	409	3	29	80	0.3625000
NODE_4148_length_1171_cov_13.311567	666	746	5	51	80	0.6375000
NODE_4148_length_1171_cov_13.311567	666	746	6	18	80	0.2250000
NODE_4148_length_1171_cov_13.311567	666	746	7	11	80	0.1375000
NODE_4148_length_1171_cov_13.311567	719	803	4	16	84	0.1904762
NODE_4148_length_1171_cov_13.311567	719	803	5	51	84	0.6071429
NODE_4148_length_1171_cov_13.311567	719	803	6	6	84	0.0714286
NODE_4148_length_1171_cov_13.311567	719	803	7	11	84	0.1309524
NODE_4149_length_1171_cov_9.154851	198	278	5	3	80	0.0375000
NODE_4149_length_1171_cov_9.154851	198	278	6	61	80	0.7625000
NODE_4149_length_1171_cov_9.154851	198	278	9	1	80	0.0125000
NODE_4149_length_1171_cov_9.154851	198	278	10	15	80	0.1875000
NODE_4149_length_1171_cov_9.154851	251	331	1	46	80	0.5750000
NODE_4149_length_1171_cov_9.154851	251	331	6	34	80	0.4250000
NODE_4157_length_1170_cov_65.480859	402	482	9	6	80	0.0750000
NODE_4157_length_1170_cov_65.480859	402	482	11	5	80	0.0625000
NODE_4157_length_1170_cov_65.480859	402	482	12	9	80	0.1125000
NODE_4157_length_1170_cov_65.480859	402	482	13	12	80	0.1500000
NODE_4157_length_1170_cov_65.480859	402	482	14	2	80	0.0250000
NODE_4157_length_1170_cov_65.480859	402	482	15	13	80	0.1625000
NODE_4157_length_1170_cov_65.480859	402	482	17	2	80	0.0250000
NODE_4157_length_1170_cov_65.480859	402	482	19	2	80	0.0250000
NODE_4157_length_1170_cov_65.480859	402	482	20	29	80	0.3625000
NODE_4157_length_1170_cov_65.480859	455	535	17	25	80	0.3125000
NODE_4157_length_1170_cov_65.480859	455	535	18	15	80	0.1875000
NODE_4157_length_1170_cov_65.480859	455	535	19	15	80	0.1875000
NODE_4157_length_1170_cov_65.480859	455	535	20	25	80	0.3125000
NODE_4158_length_1170_cov_35.283847	704	784	9	27	80	0.3375000
NODE_4158_length_1170_cov_35.283847	704	784	10	5	80	0.0625000
NODE_4158_length_1170_cov_35.283847	704	784	11	14	80	0.1750000
NODE_4158_length_1170_cov_35.283847	704	784	12	1	80	0.0125000
NODE_4158_length_1170_cov_35.283847	704	784	13	33	80	0.4125000
NODE_4158_length_1170_cov_35.283847	757	837	10	6	80	0.0750000
NODE_4158_length_1170_cov_35.283847	757	837	11	4	80	0.0500000
NODE_4158_length_1170_cov_35.283847	757	837	12	7	80	0.0875000
NODE_4158_length_1170_cov_35.283847	757	837	13	40	80	0.5000000
NODE_4158_length_1170_cov_35.283847	757	837	15	11	80	0.1375000
NODE_4158_length_1170_cov_35.283847	757	837	16	12	80	0.1500000
NODE_4159_length_1170_cov_23.600373	450	530	16	2	80	0.0250000
NODE_4159_length_1170_cov_23.600373	450	530	17	3	80	0.0375000
NODE_4159_length_1170_cov_23.600373	450	530	18	18	80	0.2250000
NODE_4159_length_1170_cov_23.600373	450	530	19	5	80	0.0625000
NODE_4159_length_1170_cov_23.600373	450	530	20	2	80	0.0250000
NODE_4159_length_1170_cov_23.600373	450	530	21	11	80	0.1375000
NODE_4159_length_1170_cov_23.600373	450	530	22	17	80	0.2125000
NODE_4159_length_1170_cov_23.600373	450	530	23	14	80	0.1750000
NODE_4159_length_1170_cov_23.600373	450	530	24	8	80	0.1000000
NODE_4159_length_1170_cov_23.600373	503	583	15	34	80	0.4250000
NODE_4159_length_1170_cov_23.600373	503	583	17	10	80	0.1250000
NODE_4159_length_1170_cov_23.600373	503	583	19	2	80	0.0250000
NODE_4159_length_1170_cov_23.600373	503	583	20	9	80	0.1125000
NODE_4159_length_1170_cov_23.600373	503	583	22	4	80	0.0500000
NODE_4159_length_1170_cov_23.600373	503	583	23	14	80	0.1750000
NODE_4159_length_1170_cov_23.600373	503	583	24	7	80	0.0875000
NODE_4159_length_1170_cov_23.600373	579	659	1	2	80	0.0250000
NODE_4159_length_1170_cov_23.600373	579	659	2	1	80	0.0125000
NODE_4159_length_1170_cov_23.600373	579	659	3	4	80	0.0500000
NODE_4159_length_1170_cov_23.600373	579	659	6	24	80	0.3000000
NODE_4159_length_1170_cov_23.600373	579	659	9	5	80	0.0625000
NODE_4159_length_1170_cov_23.600373	579	659	10	20	80	0.2500000
NODE_4159_length_1170_cov_23.600373	579	659	11	3	80	0.0375000
NODE_4159_length_1170_cov_23.600373	579	659	12	3	80	0.0375000
NODE_4159_length_1170_cov_23.600373	579	659	15	18	80	0.2250000
NODE_4159_length_1170_cov_23.600373	632	705	1	48	73	0.6575342
NODE_4159_length_1170_cov_23.600373	632	705	2	1	73	0.0136986
NODE_4159_length_1170_cov_23.600373	632	705	3	4	73	0.0547945
NODE_4159_length_1170_cov_23.600373	632	705	6	20	73	0.2739726
NODE_4160_length_1170_cov_19.783380	325	405	11	16	80	0.2000000
NODE_4160_length_1170_cov_19.783380	325	405	13	10	80	0.1250000
NODE_4160_length_1170_cov_19.783380	325	405	14	14	80	0.1750000
NODE_4160_length_1170_cov_19.783380	325	405	15	11	80	0.1375000
NODE_4160_length_1170_cov_19.783380	325	405	16	14	80	0.1750000
NODE_4160_length_1170_cov_19.783380	325	405	17	15	80	0.1875000
NODE_4160_length_1170_cov_19.783380	378	458	10	21	80	0.2625000
NODE_4160_length_1170_cov_19.783380	378	458	11	10	80	0.1250000
NODE_4160_length_1170_cov_19.783380	378	458	13	13	80	0.1625000
NODE_4160_length_1170_cov_19.783380	378	458	14	20	80	0.2500000
NODE_4160_length_1170_cov_19.783380	378	458	15	11	80	0.1375000
NODE_4160_length_1170_cov_19.783380	378	458	17	5	80	0.0625000
NODE_4168_length_1169_cov_61.689720	464	544	20	1	80	0.0125000
NODE_4168_length_1169_cov_61.689720	464	544	22	9	80	0.1125000
NODE_4168_length_1169_cov_61.689720	464	544	23	2	80	0.0250000
NODE_4168_length_1169_cov_61.689720	464	544	24	6	80	0.0750000
NODE_4168_length_1169_cov_61.689720	464	544	25	12	80	0.1500000
NODE_4168_length_1169_cov_61.689720	464	544	26	3	80	0.0375000
NODE_4168_length_1169_cov_61.689720	464	544	27	9	80	0.1125000
NODE_4168_length_1169_cov_61.689720	464	544	28	4	80	0.0500000
NODE_4168_length_1169_cov_61.689720	464	544	34	10	80	0.1250000
NODE_4168_length_1169_cov_61.689720	464	544	35	8	80	0.1000000
NODE_4168_length_1169_cov_61.689720	464	544	36	6	80	0.0750000
NODE_4168_length_1169_cov_61.689720	464	544	37	3	80	0.0375000
NODE_4168_length_1169_cov_61.689720	464	544	38	2	80	0.0250000
NODE_4168_length_1169_cov_61.689720	464	544	39	4	80	0.0500000
NODE_4168_length_1169_cov_61.689720	464	544	40	1	80	0.0125000
NODE_4168_length_1169_cov_61.689720	517	597	34	3	80	0.0375000
NODE_4168_length_1169_cov_61.689720	517	597	35	8	80	0.1000000
NODE_4168_length_1169_cov_61.689720	517	597	36	6	80	0.0750000
NODE_4168_length_1169_cov_61.689720	517	597	37	17	80	0.2125000
NODE_4168_length_1169_cov_61.689720	517	597	38	11	80	0.1375000
NODE_4168_length_1169_cov_61.689720	517	597	39	10	80	0.1250000
NODE_4168_length_1169_cov_61.689720	517	597	40	6	80	0.0750000
NODE_4168_length_1169_cov_61.689720	517	597	41	2	80	0.0250000
NODE_4168_length_1169_cov_61.689720	517	597	43	1	80	0.0125000
NODE_4168_length_1169_cov_61.689720	517	597	44	4	80	0.0500000
NODE_4168_length_1169_cov_61.689720	517	597	45	2	80	0.0250000
NODE_4168_length_1169_cov_61.689720	517	597	46	2	80	0.0250000
NODE_4168_length_1169_cov_61.689720	517	597	48	1	80	0.0125000
NODE_4168_length_1169_cov_61.689720	517	597	49	1	80	0.0125000
NODE_4168_length_1169_cov_61.689720	517	597	50	2	80	0.0250000
NODE_4168_length_1169_cov_61.689720	517	597	51	2	80	0.0250000
NODE_4168_length_1169_cov_61.689720	517	597	53	2	80	0.0250000
NODE_4168_length_1169_cov_61.689720	593	673	40	1	80	0.0125000
NODE_4168_length_1169_cov_61.689720	593	673	42	3	80	0.0375000
NODE_4168_length_1169_cov_61.689720	593	673	43	9	80	0.1125000
NODE_4168_length_1169_cov_61.689720	593	673	48	1	80	0.0125000
NODE_4168_length_1169_cov_61.689720	593	673	49	3	80	0.0375000
NODE_4168_length_1169_cov_61.689720	593	673	50	5	80	0.0625000
NODE_4168_length_1169_cov_61.689720	593	673	51	12	80	0.1500000
NODE_4168_length_1169_cov_61.689720	593	673	52	10	80	0.1250000
NODE_4168_length_1169_cov_61.689720	593	673	53	17	80	0.2125000
NODE_4168_length_1169_cov_61.689720	593	673	54	8	80	0.1000000
NODE_4168_length_1169_cov_61.689720	593	673	55	11	80	0.1375000
NODE_4168_length_1169_cov_61.689720	646	726	29	3	80	0.0375000
NODE_4168_length_1169_cov_61.689720	646	726	30	4	80	0.0500000
NODE_4168_length_1169_cov_61.689720	646	726	31	11	80	0.1375000
NODE_4168_length_1169_cov_61.689720	646	726	32	1	80	0.0125000
NODE_4168_length_1169_cov_61.689720	646	726	33	1	80	0.0125000
NODE_4168_length_1169_cov_61.689720	646	726	35	20	80	0.2500000
NODE_4168_length_1169_cov_61.689720	646	726	36	1	80	0.0125000
NODE_4168_length_1169_cov_61.689720	646	726	37	1	80	0.0125000
NODE_4168_length_1169_cov_61.689720	646	726	40	12	80	0.1500000
NODE_4168_length_1169_cov_61.689720	646	726	42	3	80	0.0375000
NODE_4168_length_1169_cov_61.689720	646	726	43	9	80	0.1125000
NODE_4168_length_1169_cov_61.689720	646	726	48	1	80	0.0125000
NODE_4168_length_1169_cov_61.689720	646	726	49	3	80	0.0375000
NODE_4168_length_1169_cov_61.689720	646	726	51	7	80	0.0875000
NODE_4168_length_1169_cov_61.689720	646	726	52	3	80	0.0375000
NODE_4169_length_1169_cov_55.247664	640	720	5	5	80	0.0625000
NODE_4169_length_1169_cov_55.247664	640	720	7	49	80	0.6125000
NODE_4169_length_1169_cov_55.247664	640	720	8	26	80	0.3250000
NODE_4169_length_1169_cov_55.247664	693	773	7	1	80	0.0125000
NODE_4169_length_1169_cov_55.247664	693	773	8	42	80	0.5250000
NODE_4169_length_1169_cov_55.247664	693	773	9	12	80	0.1500000
NODE_4169_length_1169_cov_55.247664	693	773	10	11	80	0.1375000
NODE_4169_length_1169_cov_55.247664	693	773	11	14	80	0.1750000
NODE_4170_length_1169_cov_39.016822	447	527	4	1	80	0.0125000
NODE_4170_length_1169_cov_39.016822	447	527	5	43	80	0.5375000
NODE_4170_length_1169_cov_39.016822	447	527	7	21	80	0.2625000
NODE_4170_length_1169_cov_39.016822	447	527	9	15	80	0.1875000
NODE_4170_length_1169_cov_39.016822	500	580	6	32	80	0.4000000
NODE_4170_length_1169_cov_39.016822	500	580	7	42	80	0.5250000
NODE_4170_length_1169_cov_39.016822	500	580	9	6	80	0.0750000
NODE_4170_length_1169_cov_39.016822	576	656	1	4	80	0.0500000
NODE_4170_length_1169_cov_39.016822	576	656	4	11	80	0.1375000
NODE_4170_length_1169_cov_39.016822	576	656	5	28	80	0.3500000
NODE_4170_length_1169_cov_39.016822	576	656	6	37	80	0.4625000
NODE_4170_length_1169_cov_39.016822	629	709	1	4	80	0.0500000
NODE_4170_length_1169_cov_39.016822	629	709	4	64	80	0.8000000
NODE_4170_length_1169_cov_39.016822	629	709	5	12	80	0.1500000
NODE_4171_length_1169_cov_35.383178	582	662	15	5	80	0.0625000
NODE_4171_length_1169_cov_35.383178	582	662	16	4	80	0.0500000
NODE_4171_length_1169_cov_35.383178	582	662	17	4	80	0.0500000
NODE_4171_length_1169_cov_35.383178	582	662	18	21	80	0.2625000
NODE_4171_length_1169_cov_35.383178	582	662	19	9	80	0.1125000
NODE_4171_length_1169_cov_35.383178	582	662	20	14	80	0.1750000
NODE_4171_length_1169_cov_35.383178	582	662	21	6	80	0.0750000
NODE_4171_length_1169_cov_35.383178	582	662	22	5	80	0.0625000
NODE_4171_length_1169_cov_35.383178	582	662	23	12	80	0.1500000
NODE_4171_length_1169_cov_35.383178	635	715	12	12	80	0.1500000
NODE_4171_length_1169_cov_35.383178	635	715	13	3	80	0.0375000
NODE_4171_length_1169_cov_35.383178	635	715	14	22	80	0.2750000
NODE_4171_length_1169_cov_35.383178	635	715	17	11	80	0.1375000
NODE_4171_length_1169_cov_35.383178	635	715	18	23	80	0.2875000
NODE_4171_length_1169_cov_35.383178	635	715	19	9	80	0.1125000
NODE_4173_length_1169_cov_12.010280	338	418	3	34	80	0.4250000
NODE_4173_length_1169_cov_12.010280	338	418	4	46	80	0.5750000
NODE_4173_length_1169_cov_12.010280	391	471	1	35	80	0.4375000
NODE_4173_length_1169_cov_12.010280	391	471	4	45	80	0.5625000
NODE_4175_length_1169_cov_4.172897	74	135	0	61	61	1.0000000
NODE_4175_length_1169_cov_4.172897	74	135	0	61	61	1.0000000
NODE_4175_length_1169_cov_4.172897	74	135	0	61	61	1.0000000
NODE_4183_length_1168_cov_27.350795	517	597	6	80	80	1.0000000
NODE_4183_length_1168_cov_27.350795	570	650	6	29	80	0.3625000
NODE_4183_length_1168_cov_27.350795	570	650	8	4	80	0.0500000
NODE_4183_length_1168_cov_27.350795	570	650	9	44	80	0.5500000
NODE_4183_length_1168_cov_27.350795	570	650	10	1	80	0.0125000
NODE_4183_length_1168_cov_27.350795	570	650	12	1	80	0.0125000
NODE_4183_length_1168_cov_27.350795	570	650	14	1	80	0.0125000
NODE_4183_length_1168_cov_27.350795	646	726	8	3	80	0.0375000
NODE_4183_length_1168_cov_27.350795	646	726	10	17	80	0.2125000
NODE_4183_length_1168_cov_27.350795	646	726	11	31	80	0.3875000
NODE_4183_length_1168_cov_27.350795	646	726	13	1	80	0.0125000
NODE_4183_length_1168_cov_27.350795	646	726	15	28	80	0.3500000
NODE_4183_length_1168_cov_27.350795	699	779	15	32	80	0.4000000
NODE_4183_length_1168_cov_27.350795	699	779	16	30	80	0.3750000
NODE_4183_length_1168_cov_27.350795	699	779	17	5	80	0.0625000
NODE_4183_length_1168_cov_27.350795	699	779	18	1	80	0.0125000
NODE_4183_length_1168_cov_27.350795	699	779	19	12	80	0.1500000
NODE_4184_length_1168_cov_25.777362	672	752	8	19	80	0.2375000
NODE_4184_length_1168_cov_25.777362	672	752	9	2	80	0.0250000
NODE_4184_length_1168_cov_25.777362	672	752	10	37	80	0.4625000
NODE_4184_length_1168_cov_25.777362	672	752	11	22	80	0.2750000
NODE_4184_length_1168_cov_25.777362	725	805	4	13	80	0.1625000
NODE_4184_length_1168_cov_25.777362	725	805	5	26	80	0.3250000
NODE_4184_length_1168_cov_25.777362	725	805	9	3	80	0.0375000
NODE_4184_length_1168_cov_25.777362	725	805	10	5	80	0.0625000
NODE_4184_length_1168_cov_25.777362	725	805	11	33	80	0.4125000
NODE_4185_length_1168_cov_25.295603	543	623	7	5	80	0.0625000
NODE_4185_length_1168_cov_25.295603	543	623	8	27	80	0.3375000
NODE_4185_length_1168_cov_25.295603	543	623	9	14	80	0.1750000
NODE_4185_length_1168_cov_25.295603	543	623	10	27	80	0.3375000
NODE_4185_length_1168_cov_25.295603	543	623	11	7	80	0.0875000
NODE_4185_length_1168_cov_25.295603	596	676	10	20	80	0.2500000
NODE_4185_length_1168_cov_25.295603	596	676	11	8	80	0.1000000
NODE_4185_length_1168_cov_25.295603	596	676	12	14	80	0.1750000
NODE_4185_length_1168_cov_25.295603	596	676	14	2	80	0.0250000
NODE_4185_length_1168_cov_25.295603	596	676	15	34	80	0.4250000
NODE_4185_length_1168_cov_25.295603	596	676	17	2	80	0.0250000
NODE_4185_length_1168_cov_25.295603	672	752	10	13	80	0.1625000
NODE_4185_length_1168_cov_25.295603	672	752	11	14	80	0.1750000
NODE_4185_length_1168_cov_25.295603	672	752	12	27	80	0.3375000
NODE_4185_length_1168_cov_25.295603	672	752	13	6	80	0.0750000
NODE_4185_length_1168_cov_25.295603	672	752	14	1	80	0.0125000
NODE_4185_length_1168_cov_25.295603	672	752	15	9	80	0.1125000
NODE_4185_length_1168_cov_25.295603	672	752	16	4	80	0.0500000
NODE_4185_length_1168_cov_25.295603	672	752	17	6	80	0.0750000
NODE_4185_length_1168_cov_25.295603	725	804	5	17	79	0.2151899
NODE_4185_length_1168_cov_25.295603	725	804	8	13	79	0.1645570
NODE_4185_length_1168_cov_25.295603	725	804	9	8	79	0.1012658
NODE_4185_length_1168_cov_25.295603	725	804	10	27	79	0.3417721
NODE_4185_length_1168_cov_25.295603	725	804	11	14	79	0.1772152
NODE_4186_length_1168_cov_20.202058	434	514	16	22	80	0.2750000
NODE_4186_length_1168_cov_20.202058	434	514	17	3	80	0.0375000
NODE_4186_length_1168_cov_20.202058	434	514	23	6	80	0.0750000
NODE_4186_length_1168_cov_20.202058	434	514	24	15	80	0.1875000
NODE_4186_length_1168_cov_20.202058	434	514	26	34	80	0.4250000
NODE_4186_length_1168_cov_20.202058	487	567	2	6	80	0.0750000
NODE_4186_length_1168_cov_20.202058	487	567	4	5	80	0.0625000
NODE_4186_length_1168_cov_20.202058	487	567	5	9	80	0.1125000
NODE_4186_length_1168_cov_20.202058	487	567	11	25	80	0.3125000
NODE_4186_length_1168_cov_20.202058	487	567	12	2	80	0.0250000
NODE_4186_length_1168_cov_20.202058	487	567	13	1	80	0.0125000
NODE_4186_length_1168_cov_20.202058	487	567	15	1	80	0.0125000
NODE_4186_length_1168_cov_20.202058	487	567	16	26	80	0.3250000
NODE_4186_length_1168_cov_20.202058	487	567	17	3	80	0.0375000
NODE_4186_length_1168_cov_20.202058	487	567	23	2	80	0.0250000
NODE_4187_length_1168_cov_16.787652	405	485	0	44	80	0.5500000
NODE_4187_length_1168_cov_16.787652	405	485	1	36	80	0.4500000
NODE_4187_length_1168_cov_16.787652	458	538	1	37	80	0.4625000
NODE_4187_length_1168_cov_16.787652	458	538	3	43	80	0.5375000
NODE_4188_length_1168_cov_10.079514	722	802	7	4	80	0.0500000
NODE_4188_length_1168_cov_10.079514	722	802	8	76	80	0.9500000
NODE_4188_length_1168_cov_10.079514	775	855	6	23	80	0.2875000
NODE_4188_length_1168_cov_10.079514	775	855	7	4	80	0.0500000
NODE_4188_length_1168_cov_10.079514	775	855	8	50	80	0.6250000
NODE_4188_length_1168_cov_10.079514	775	855	9	3	80	0.0375000
NODE_4198_length_1167_cov_27.961610	591	671	9	2	80	0.0250000
NODE_4198_length_1167_cov_27.961610	591	671	10	13	80	0.1625000
NODE_4198_length_1167_cov_27.961610	591	671	14	10	80	0.1250000
NODE_4198_length_1167_cov_27.961610	591	671	15	9	80	0.1125000
NODE_4198_length_1167_cov_27.961610	591	671	16	29	80	0.3625000
NODE_4198_length_1167_cov_27.961610	591	671	17	17	80	0.2125000
NODE_4198_length_1167_cov_27.961610	644	724	11	10	80	0.1250000
NODE_4198_length_1167_cov_27.961610	644	724	13	8	80	0.1000000
NODE_4198_length_1167_cov_27.961610	644	724	14	1	80	0.0125000
NODE_4198_length_1167_cov_27.961610	644	724	15	3	80	0.0375000
NODE_4198_length_1167_cov_27.961610	644	724	16	37	80	0.4625000
NODE_4198_length_1167_cov_27.961610	644	724	17	12	80	0.1500000
NODE_4198_length_1167_cov_27.961610	644	724	18	9	80	0.1125000
NODE_4199_length_1167_cov_12.393258	670	750	0	80	80	1.0000000
NODE_4199_length_1167_cov_12.393258	723	803	0	80	80	1.0000000
NODE_4200_length_1167_cov_11.189139	434	514	0	80	80	1.0000000
NODE_4200_length_1167_cov_11.189139	487	567	0	80	80	1.0000000
NODE_4201_length_1167_cov_7.998127	711	791	0	9	80	0.1125000
NODE_4201_length_1167_cov_7.998127	711	791	1	22	80	0.2750000
NODE_4201_length_1167_cov_7.998127	711	791	2	49	80	0.6125000
NODE_4201_length_1167_cov_7.998127	764	844	0	62	80	0.7750000
NODE_4201_length_1167_cov_7.998127	764	844	1	18	80	0.2250000
NODE_4206_length_1166_cov_313.815370	444	524	39	1	80	0.0125000
NODE_4206_length_1166_cov_313.815370	444	524	40	2	80	0.0250000
NODE_4206_length_1166_cov_313.815370	444	524	42	6	80	0.0750000
NODE_4206_length_1166_cov_313.815370	444	524	47	3	80	0.0375000
NODE_4206_length_1166_cov_313.815370	444	524	49	4	80	0.0500000
NODE_4206_length_1166_cov_313.815370	444	524	50	1	80	0.0125000
NODE_4206_length_1166_cov_313.815370	444	524	51	1	80	0.0125000
NODE_4206_length_1166_cov_313.815370	444	524	54	3	80	0.0375000
NODE_4206_length_1166_cov_313.815370	444	524	55	3	80	0.0375000
NODE_4206_length_1166_cov_313.815370	444	524	56	2	80	0.0250000
NODE_4206_length_1166_cov_313.815370	444	524	60	3	80	0.0375000
NODE_4206_length_1166_cov_313.815370	444	524	64	2	80	0.0250000
NODE_4206_length_1166_cov_313.815370	444	524	69	1	80	0.0125000
NODE_4206_length_1166_cov_313.815370	444	524	71	1	80	0.0125000
NODE_4206_length_1166_cov_313.815370	444	524	72	1	80	0.0125000
NODE_4206_length_1166_cov_313.815370	444	524	75	1	80	0.0125000
NODE_4206_length_1166_cov_313.815370	444	524	76	1	80	0.0125000
NODE_4206_length_1166_cov_313.815370	444	524	77	2	80	0.0250000
NODE_4206_length_1166_cov_313.815370	444	524	78	6	80	0.0750000
NODE_4206_length_1166_cov_313.815370	444	524	79	2	80	0.0250000
NODE_4206_length_1166_cov_313.815370	444	524	80	1	80	0.0125000
NODE_4206_length_1166_cov_313.815370	444	524	81	4	80	0.0500000
NODE_4206_length_1166_cov_313.815370	444	524	82	2	80	0.0250000
NODE_4206_length_1166_cov_313.815370	444	524	84	1	80	0.0125000
NODE_4206_length_1166_cov_313.815370	444	524	85	1	80	0.0125000
NODE_4206_length_1166_cov_313.815370	444	524	86	1	80	0.0125000
NODE_4206_length_1166_cov_313.815370	444	524	90	1	80	0.0125000
NODE_4206_length_1166_cov_313.815370	444	524	91	1	80	0.0125000
NODE_4206_length_1166_cov_313.815370	444	524	92	4	80	0.0500000
NODE_4206_length_1166_cov_313.815370	444	524	93	4	80	0.0500000
NODE_4206_length_1166_cov_313.815370	444	524	94	13	80	0.1625000
NODE_4206_length_1166_cov_313.815370	444	524	95	1	80	0.0125000
NODE_4206_length_1166_cov_313.815370	444	524	39	1	80	0.0125000
NODE_4206_length_1166_cov_313.815370	444	524	40	2	80	0.0250000
NODE_4206_length_1166_cov_313.815370	444	524	42	6	80	0.0750000
NODE_4206_length_1166_cov_313.815370	444	524	47	3	80	0.0375000
NODE_4206_length_1166_cov_313.815370	444	524	49	4	80	0.0500000
NODE_4206_length_1166_cov_313.815370	444	524	50	1	80	0.0125000
NODE_4206_length_1166_cov_313.815370	444	524	51	1	80	0.0125000
NODE_4206_length_1166_cov_313.815370	444	524	54	3	80	0.0375000
NODE_4206_length_1166_cov_313.815370	444	524	55	3	80	0.0375000
NODE_4206_length_1166_cov_313.815370	444	524	56	2	80	0.0250000
NODE_4206_length_1166_cov_313.815370	444	524	60	3	80	0.0375000
NODE_4206_length_1166_cov_313.815370	444	524	64	2	80	0.0250000
NODE_4206_length_1166_cov_313.815370	444	524	69	1	80	0.0125000
NODE_4206_length_1166_cov_313.815370	444	524	71	1	80	0.0125000
NODE_4206_length_1166_cov_313.815370	444	524	72	1	80	0.0125000
NODE_4206_length_1166_cov_313.815370	444	524	75	1	80	0.0125000
NODE_4206_length_1166_cov_313.815370	444	524	76	1	80	0.0125000
NODE_4206_length_1166_cov_313.815370	444	524	77	2	80	0.0250000
NODE_4206_length_1166_cov_313.815370	444	524	78	6	80	0.0750000
NODE_4206_length_1166_cov_313.815370	444	524	79	2	80	0.0250000
NODE_4206_length_1166_cov_313.815370	444	524	80	1	80	0.0125000
NODE_4206_length_1166_cov_313.815370	444	524	81	4	80	0.0500000
NODE_4206_length_1166_cov_313.815370	444	524	82	2	80	0.0250000
NODE_4206_length_1166_cov_313.815370	444	524	84	1	80	0.0125000
NODE_4206_length_1166_cov_313.815370	444	524	85	1	80	0.0125000
NODE_4206_length_1166_cov_313.815370	444	524	86	1	80	0.0125000
NODE_4206_length_1166_cov_313.815370	444	524	90	1	80	0.0125000
NODE_4206_length_1166_cov_313.815370	444	524	91	1	80	0.0125000
NODE_4206_length_1166_cov_313.815370	444	524	92	4	80	0.0500000
NODE_4206_length_1166_cov_313.815370	444	524	93	4	80	0.0500000
NODE_4206_length_1166_cov_313.815370	444	524	94	13	80	0.1625000
NODE_4206_length_1166_cov_313.815370	444	524	95	1	80	0.0125000
NODE_4206_length_1166_cov_313.815370	444	524	39	1	80	0.0125000
NODE_4206_length_1166_cov_313.815370	444	524	40	2	80	0.0250000
NODE_4206_length_1166_cov_313.815370	444	524	42	6	80	0.0750000
NODE_4206_length_1166_cov_313.815370	444	524	47	3	80	0.0375000
NODE_4206_length_1166_cov_313.815370	444	524	49	4	80	0.0500000
NODE_4206_length_1166_cov_313.815370	444	524	50	1	80	0.0125000
NODE_4206_length_1166_cov_313.815370	444	524	51	1	80	0.0125000
NODE_4206_length_1166_cov_313.815370	444	524	54	3	80	0.0375000
NODE_4206_length_1166_cov_313.815370	444	524	55	3	80	0.0375000
NODE_4206_length_1166_cov_313.815370	444	524	56	2	80	0.0250000
NODE_4206_length_1166_cov_313.815370	444	524	60	3	80	0.0375000
NODE_4206_length_1166_cov_313.815370	444	524	64	2	80	0.0250000
NODE_4206_length_1166_cov_313.815370	444	524	69	1	80	0.0125000
NODE_4206_length_1166_cov_313.815370	444	524	71	1	80	0.0125000
NODE_4206_length_1166_cov_313.815370	444	524	72	1	80	0.0125000
NODE_4206_length_1166_cov_313.815370	444	524	75	1	80	0.0125000
NODE_4206_length_1166_cov_313.815370	444	524	76	1	80	0.0125000
NODE_4206_length_1166_cov_313.815370	444	524	77	2	80	0.0250000
NODE_4206_length_1166_cov_313.815370	444	524	78	6	80	0.0750000
NODE_4206_length_1166_cov_313.815370	444	524	79	2	80	0.0250000
NODE_4206_length_1166_cov_313.815370	444	524	80	1	80	0.0125000
NODE_4206_length_1166_cov_313.815370	444	524	81	4	80	0.0500000
NODE_4206_length_1166_cov_313.815370	444	524	82	2	80	0.0250000
NODE_4206_length_1166_cov_313.815370	444	524	84	1	80	0.0125000
NODE_4206_length_1166_cov_313.815370	444	524	85	1	80	0.0125000
NODE_4206_length_1166_cov_313.815370	444	524	86	1	80	0.0125000
NODE_4206_length_1166_cov_313.815370	444	524	90	1	80	0.0125000
NODE_4206_length_1166_cov_313.815370	444	524	91	1	80	0.0125000
NODE_4206_length_1166_cov_313.815370	444	524	92	4	80	0.0500000
NODE_4206_length_1166_cov_313.815370	444	524	93	4	80	0.0500000
NODE_4206_length_1166_cov_313.815370	444	524	94	13	80	0.1625000
NODE_4206_length_1166_cov_313.815370	444	524	95	1	80	0.0125000
NODE_4206_length_1166_cov_313.815370	444	524	39	1	80	0.0125000
NODE_4206_length_1166_cov_313.815370	444	524	40	2	80	0.0250000
NODE_4206_length_1166_cov_313.815370	444	524	42	6	80	0.0750000
NODE_4206_length_1166_cov_313.815370	444	524	47	3	80	0.0375000
NODE_4206_length_1166_cov_313.815370	444	524	49	4	80	0.0500000
NODE_4206_length_1166_cov_313.815370	444	524	50	1	80	0.0125000
NODE_4206_length_1166_cov_313.815370	444	524	51	1	80	0.0125000
NODE_4206_length_1166_cov_313.815370	444	524	54	3	80	0.0375000
NODE_4206_length_1166_cov_313.815370	444	524	55	3	80	0.0375000
NODE_4206_length_1166_cov_313.815370	444	524	56	2	80	0.0250000
NODE_4206_length_1166_cov_313.815370	444	524	60	3	80	0.0375000
NODE_4206_length_1166_cov_313.815370	444	524	64	2	80	0.0250000
NODE_4206_length_1166_cov_313.815370	444	524	69	1	80	0.0125000
NODE_4206_length_1166_cov_313.815370	444	524	71	1	80	0.0125000
NODE_4206_length_1166_cov_313.815370	444	524	72	1	80	0.0125000
NODE_4206_length_1166_cov_313.815370	444	524	75	1	80	0.0125000
NODE_4206_length_1166_cov_313.815370	444	524	76	1	80	0.0125000
NODE_4206_length_1166_cov_313.815370	444	524	77	2	80	0.0250000
NODE_4206_length_1166_cov_313.815370	444	524	78	6	80	0.0750000
NODE_4206_length_1166_cov_313.815370	444	524	79	2	80	0.0250000
NODE_4206_length_1166_cov_313.815370	444	524	80	1	80	0.0125000
NODE_4206_length_1166_cov_313.815370	444	524	81	4	80	0.0500000
NODE_4206_length_1166_cov_313.815370	444	524	82	2	80	0.0250000
NODE_4206_length_1166_cov_313.815370	444	524	84	1	80	0.0125000
NODE_4206_length_1166_cov_313.815370	444	524	85	1	80	0.0125000
NODE_4206_length_1166_cov_313.815370	444	524	86	1	80	0.0125000
NODE_4206_length_1166_cov_313.815370	444	524	90	1	80	0.0125000
NODE_4206_length_1166_cov_313.815370	444	524	91	1	80	0.0125000
NODE_4206_length_1166_cov_313.815370	444	524	92	4	80	0.0500000
NODE_4206_length_1166_cov_313.815370	444	524	93	4	80	0.0500000
NODE_4206_length_1166_cov_313.815370	444	524	94	13	80	0.1625000
NODE_4206_length_1166_cov_313.815370	444	524	95	1	80	0.0125000
NODE_4206_length_1166_cov_313.815370	444	524	39	1	80	0.0125000
NODE_4206_length_1166_cov_313.815370	444	524	40	2	80	0.0250000
NODE_4206_length_1166_cov_313.815370	444	524	42	6	80	0.0750000
NODE_4206_length_1166_cov_313.815370	444	524	47	3	80	0.0375000
NODE_4206_length_1166_cov_313.815370	444	524	49	4	80	0.0500000
NODE_4206_length_1166_cov_313.815370	444	524	50	1	80	0.0125000
NODE_4206_length_1166_cov_313.815370	444	524	51	1	80	0.0125000
NODE_4206_length_1166_cov_313.815370	444	524	54	3	80	0.0375000
NODE_4206_length_1166_cov_313.815370	444	524	55	3	80	0.0375000
NODE_4206_length_1166_cov_313.815370	444	524	56	2	80	0.0250000
NODE_4206_length_1166_cov_313.815370	444	524	60	3	80	0.0375000
NODE_4206_length_1166_cov_313.815370	444	524	64	2	80	0.0250000
NODE_4206_length_1166_cov_313.815370	444	524	69	1	80	0.0125000
NODE_4206_length_1166_cov_313.815370	444	524	71	1	80	0.0125000
NODE_4206_length_1166_cov_313.815370	444	524	72	1	80	0.0125000
NODE_4206_length_1166_cov_313.815370	444	524	75	1	80	0.0125000
NODE_4206_length_1166_cov_313.815370	444	524	76	1	80	0.0125000
NODE_4206_length_1166_cov_313.815370	444	524	77	2	80	0.0250000
NODE_4206_length_1166_cov_313.815370	444	524	78	6	80	0.0750000
NODE_4206_length_1166_cov_313.815370	444	524	79	2	80	0.0250000
NODE_4206_length_1166_cov_313.815370	444	524	80	1	80	0.0125000
NODE_4206_length_1166_cov_313.815370	444	524	81	4	80	0.0500000
NODE_4206_length_1166_cov_313.815370	444	524	82	2	80	0.0250000
NODE_4206_length_1166_cov_313.815370	444	524	84	1	80	0.0125000
NODE_4206_length_1166_cov_313.815370	444	524	85	1	80	0.0125000
NODE_4206_length_1166_cov_313.815370	444	524	86	1	80	0.0125000
NODE_4206_length_1166_cov_313.815370	444	524	90	1	80	0.0125000
NODE_4206_length_1166_cov_313.815370	444	524	91	1	80	0.0125000
NODE_4206_length_1166_cov_313.815370	444	524	92	4	80	0.0500000
NODE_4206_length_1166_cov_313.815370	444	524	93	4	80	0.0500000
NODE_4206_length_1166_cov_313.815370	444	524	94	13	80	0.1625000
NODE_4206_length_1166_cov_313.815370	444	524	95	1	80	0.0125000
NODE_4206_length_1166_cov_313.815370	444	524	39	1	80	0.0125000
NODE_4206_length_1166_cov_313.815370	444	524	40	2	80	0.0250000
NODE_4206_length_1166_cov_313.815370	444	524	42	6	80	0.0750000
NODE_4206_length_1166_cov_313.815370	444	524	47	3	80	0.0375000
NODE_4206_length_1166_cov_313.815370	444	524	49	4	80	0.0500000
NODE_4206_length_1166_cov_313.815370	444	524	50	1	80	0.0125000
NODE_4206_length_1166_cov_313.815370	444	524	51	1	80	0.0125000
NODE_4206_length_1166_cov_313.815370	444	524	54	3	80	0.0375000
NODE_4206_length_1166_cov_313.815370	444	524	55	3	80	0.0375000
NODE_4206_length_1166_cov_313.815370	444	524	56	2	80	0.0250000
NODE_4206_length_1166_cov_313.815370	444	524	60	3	80	0.0375000
NODE_4206_length_1166_cov_313.815370	444	524	64	2	80	0.0250000
NODE_4206_length_1166_cov_313.815370	444	524	69	1	80	0.0125000
NODE_4206_length_1166_cov_313.815370	444	524	71	1	80	0.0125000
NODE_4206_length_1166_cov_313.815370	444	524	72	1	80	0.0125000
NODE_4206_length_1166_cov_313.815370	444	524	75	1	80	0.0125000
NODE_4206_length_1166_cov_313.815370	444	524	76	1	80	0.0125000
NODE_4206_length_1166_cov_313.815370	444	524	77	2	80	0.0250000
NODE_4206_length_1166_cov_313.815370	444	524	78	6	80	0.0750000
NODE_4206_length_1166_cov_313.815370	444	524	79	2	80	0.0250000
NODE_4206_length_1166_cov_313.815370	444	524	80	1	80	0.0125000
NODE_4206_length_1166_cov_313.815370	444	524	81	4	80	0.0500000
NODE_4206_length_1166_cov_313.815370	444	524	82	2	80	0.0250000
NODE_4206_length_1166_cov_313.815370	444	524	84	1	80	0.0125000
NODE_4206_length_1166_cov_313.815370	444	524	85	1	80	0.0125000
NODE_4206_length_1166_cov_313.815370	444	524	86	1	80	0.0125000
NODE_4206_length_1166_cov_313.815370	444	524	90	1	80	0.0125000
NODE_4206_length_1166_cov_313.815370	444	524	91	1	80	0.0125000
NODE_4206_length_1166_cov_313.815370	444	524	92	4	80	0.0500000
NODE_4206_length_1166_cov_313.815370	444	524	93	4	80	0.0500000
NODE_4206_length_1166_cov_313.815370	444	524	94	13	80	0.1625000
NODE_4206_length_1166_cov_313.815370	444	524	95	1	80	0.0125000
NODE_4206_length_1166_cov_313.815370	497	577	84	1	80	0.0125000
NODE_4206_length_1166_cov_313.815370	497	577	85	1	80	0.0125000
NODE_4206_length_1166_cov_313.815370	497	577	86	1	80	0.0125000
NODE_4206_length_1166_cov_313.815370	497	577	88	5	80	0.0625000
NODE_4206_length_1166_cov_313.815370	497	577	90	2	80	0.0250000
NODE_4206_length_1166_cov_313.815370	497	577	91	6	80	0.0750000
NODE_4206_length_1166_cov_313.815370	497	577	92	4	80	0.0500000
NODE_4206_length_1166_cov_313.815370	497	577	93	12	80	0.1500000
NODE_4206_length_1166_cov_313.815370	497	577	94	15	80	0.1875000
NODE_4206_length_1166_cov_313.815370	497	577	95	7	80	0.0875000
NODE_4206_length_1166_cov_313.815370	497	577	96	7	80	0.0875000
NODE_4206_length_1166_cov_313.815370	497	577	98	15	80	0.1875000
NODE_4206_length_1166_cov_313.815370	497	577	99	4	80	0.0500000
NODE_4206_length_1166_cov_313.815370	497	577	84	1	80	0.0125000
NODE_4206_length_1166_cov_313.815370	497	577	85	1	80	0.0125000
NODE_4206_length_1166_cov_313.815370	497	577	86	1	80	0.0125000
NODE_4206_length_1166_cov_313.815370	497	577	88	5	80	0.0625000
NODE_4206_length_1166_cov_313.815370	497	577	90	2	80	0.0250000
NODE_4206_length_1166_cov_313.815370	497	577	91	6	80	0.0750000
NODE_4206_length_1166_cov_313.815370	497	577	92	4	80	0.0500000
NODE_4206_length_1166_cov_313.815370	497	577	93	12	80	0.1500000
NODE_4206_length_1166_cov_313.815370	497	577	94	15	80	0.1875000
NODE_4206_length_1166_cov_313.815370	497	577	95	7	80	0.0875000
NODE_4206_length_1166_cov_313.815370	497	577	96	7	80	0.0875000
NODE_4206_length_1166_cov_313.815370	497	577	98	15	80	0.1875000
NODE_4206_length_1166_cov_313.815370	497	577	99	4	80	0.0500000
NODE_4206_length_1166_cov_313.815370	497	577	84	1	80	0.0125000
NODE_4206_length_1166_cov_313.815370	497	577	85	1	80	0.0125000
NODE_4206_length_1166_cov_313.815370	497	577	86	1	80	0.0125000
NODE_4206_length_1166_cov_313.815370	497	577	88	5	80	0.0625000
NODE_4206_length_1166_cov_313.815370	497	577	90	2	80	0.0250000
NODE_4206_length_1166_cov_313.815370	497	577	91	6	80	0.0750000
NODE_4206_length_1166_cov_313.815370	497	577	92	4	80	0.0500000
NODE_4206_length_1166_cov_313.815370	497	577	93	12	80	0.1500000
NODE_4206_length_1166_cov_313.815370	497	577	94	15	80	0.1875000
NODE_4206_length_1166_cov_313.815370	497	577	95	7	80	0.0875000
NODE_4206_length_1166_cov_313.815370	497	577	96	7	80	0.0875000
NODE_4206_length_1166_cov_313.815370	497	577	98	15	80	0.1875000
NODE_4206_length_1166_cov_313.815370	497	577	99	4	80	0.0500000
NODE_4206_length_1166_cov_313.815370	497	577	84	1	80	0.0125000
NODE_4206_length_1166_cov_313.815370	497	577	85	1	80	0.0125000
NODE_4206_length_1166_cov_313.815370	497	577	86	1	80	0.0125000
NODE_4206_length_1166_cov_313.815370	497	577	88	5	80	0.0625000
NODE_4206_length_1166_cov_313.815370	497	577	90	2	80	0.0250000
NODE_4206_length_1166_cov_313.815370	497	577	91	6	80	0.0750000
NODE_4206_length_1166_cov_313.815370	497	577	92	4	80	0.0500000
NODE_4206_length_1166_cov_313.815370	497	577	93	12	80	0.1500000
NODE_4206_length_1166_cov_313.815370	497	577	94	15	80	0.1875000
NODE_4206_length_1166_cov_313.815370	497	577	95	7	80	0.0875000
NODE_4206_length_1166_cov_313.815370	497	577	96	7	80	0.0875000
NODE_4206_length_1166_cov_313.815370	497	577	98	15	80	0.1875000
NODE_4206_length_1166_cov_313.815370	497	577	99	4	80	0.0500000
NODE_4206_length_1166_cov_313.815370	497	577	84	1	80	0.0125000
NODE_4206_length_1166_cov_313.815370	497	577	85	1	80	0.0125000
NODE_4206_length_1166_cov_313.815370	497	577	86	1	80	0.0125000
NODE_4206_length_1166_cov_313.815370	497	577	88	5	80	0.0625000
NODE_4206_length_1166_cov_313.815370	497	577	90	2	80	0.0250000
NODE_4206_length_1166_cov_313.815370	497	577	91	6	80	0.0750000
NODE_4206_length_1166_cov_313.815370	497	577	92	4	80	0.0500000
NODE_4206_length_1166_cov_313.815370	497	577	93	12	80	0.1500000
NODE_4206_length_1166_cov_313.815370	497	577	94	15	80	0.1875000
NODE_4206_length_1166_cov_313.815370	497	577	95	7	80	0.0875000
NODE_4206_length_1166_cov_313.815370	497	577	96	7	80	0.0875000
NODE_4206_length_1166_cov_313.815370	497	577	98	15	80	0.1875000
NODE_4206_length_1166_cov_313.815370	497	577	99	4	80	0.0500000
NODE_4206_length_1166_cov_313.815370	497	577	84	1	80	0.0125000
NODE_4206_length_1166_cov_313.815370	497	577	85	1	80	0.0125000
NODE_4206_length_1166_cov_313.815370	497	577	86	1	80	0.0125000
NODE_4206_length_1166_cov_313.815370	497	577	88	5	80	0.0625000
NODE_4206_length_1166_cov_313.815370	497	577	90	2	80	0.0250000
NODE_4206_length_1166_cov_313.815370	497	577	91	6	80	0.0750000
NODE_4206_length_1166_cov_313.815370	497	577	92	4	80	0.0500000
NODE_4206_length_1166_cov_313.815370	497	577	93	12	80	0.1500000
NODE_4206_length_1166_cov_313.815370	497	577	94	15	80	0.1875000
NODE_4206_length_1166_cov_313.815370	497	577	95	7	80	0.0875000
NODE_4206_length_1166_cov_313.815370	497	577	96	7	80	0.0875000
NODE_4206_length_1166_cov_313.815370	497	577	98	15	80	0.1875000
NODE_4206_length_1166_cov_313.815370	497	577	99	4	80	0.0500000
NODE_4206_length_1166_cov_313.815370	497	568	84	1	71	0.0140845
NODE_4206_length_1166_cov_313.815370	497	568	85	1	71	0.0140845
NODE_4206_length_1166_cov_313.815370	497	568	86	1	71	0.0140845
NODE_4206_length_1166_cov_313.815370	497	568	90	2	71	0.0281690
NODE_4206_length_1166_cov_313.815370	497	568	91	6	71	0.0845070
NODE_4206_length_1166_cov_313.815370	497	568	92	4	71	0.0563380
NODE_4206_length_1166_cov_313.815370	497	568	93	10	71	0.1408451
NODE_4206_length_1166_cov_313.815370	497	568	94	15	71	0.2112676
NODE_4206_length_1166_cov_313.815370	497	568	95	5	71	0.0704225
NODE_4206_length_1166_cov_313.815370	497	568	96	7	71	0.0985916
NODE_4206_length_1166_cov_313.815370	497	568	98	15	71	0.2112676
NODE_4206_length_1166_cov_313.815370	497	568	99	4	71	0.0563380
NODE_4206_length_1166_cov_313.815370	500	570	90	2	70	0.0285714
NODE_4206_length_1166_cov_313.815370	500	570	91	6	70	0.0857143
NODE_4206_length_1166_cov_313.815370	500	570	92	4	70	0.0571429
NODE_4206_length_1166_cov_313.815370	500	570	93	10	70	0.1428571
NODE_4206_length_1166_cov_313.815370	500	570	94	15	70	0.2142857
NODE_4206_length_1166_cov_313.815370	500	570	95	7	70	0.1000000
NODE_4206_length_1166_cov_313.815370	500	570	96	7	70	0.1000000
NODE_4206_length_1166_cov_313.815370	500	570	98	15	70	0.2142857
NODE_4206_length_1166_cov_313.815370	500	570	99	4	70	0.0571429
NODE_4206_length_1166_cov_313.815370	997	1077	4	7	80	0.0875000
NODE_4206_length_1166_cov_313.815370	997	1077	5	30	80	0.3750000
NODE_4206_length_1166_cov_313.815370	997	1077	6	6	80	0.0750000
NODE_4206_length_1166_cov_313.815370	997	1077	7	4	80	0.0500000
NODE_4206_length_1166_cov_313.815370	997	1077	8	9	80	0.1125000
NODE_4206_length_1166_cov_313.815370	997	1077	9	24	80	0.3000000
NODE_4206_length_1166_cov_313.815370	1050	1130	1	4	80	0.0500000
NODE_4206_length_1166_cov_313.815370	1050	1130	2	28	80	0.3500000
NODE_4206_length_1166_cov_313.815370	1050	1130	3	10	80	0.1250000
NODE_4206_length_1166_cov_313.815370	1050	1130	4	18	80	0.2250000
NODE_4206_length_1166_cov_313.815370	1050	1130	5	20	80	0.2500000
NODE_4206_length_1166_cov_313.815370	1050	1130	1	4	80	0.0500000
NODE_4206_length_1166_cov_313.815370	1050	1130	2	28	80	0.3500000
NODE_4206_length_1166_cov_313.815370	1050	1130	3	10	80	0.1250000
NODE_4206_length_1166_cov_313.815370	1050	1130	4	18	80	0.2250000
NODE_4206_length_1166_cov_313.815370	1050	1130	5	20	80	0.2500000
NODE_4206_length_1166_cov_313.815370	1050	1121	2	23	71	0.3239437
NODE_4206_length_1166_cov_313.815370	1050	1121	3	10	71	0.1408451
NODE_4206_length_1166_cov_313.815370	1050	1121	4	18	71	0.2535211
NODE_4206_length_1166_cov_313.815370	1050	1121	5	20	71	0.2816902
NODE_4207_length_1166_cov_25.107779	561	641	4	13	80	0.1625000
NODE_4207_length_1166_cov_25.107779	561	641	5	15	80	0.1875000
NODE_4207_length_1166_cov_25.107779	561	641	6	17	80	0.2125000
NODE_4207_length_1166_cov_25.107779	561	641	7	16	80	0.2000000
NODE_4207_length_1166_cov_25.107779	561	641	8	19	80	0.2375000
NODE_4207_length_1166_cov_25.107779	614	694	7	8	80	0.1000000
NODE_4207_length_1166_cov_25.107779	614	694	8	32	80	0.4000000
NODE_4207_length_1166_cov_25.107779	614	694	9	9	80	0.1125000
NODE_4207_length_1166_cov_25.107779	614	694	10	18	80	0.2250000
NODE_4207_length_1166_cov_25.107779	614	694	11	4	80	0.0500000
NODE_4207_length_1166_cov_25.107779	614	694	12	9	80	0.1125000
NODE_4209_length_1166_cov_18.820056	325	405	4	8	80	0.1000000
NODE_4209_length_1166_cov_18.820056	325	405	5	19	80	0.2375000
NODE_4209_length_1166_cov_18.820056	325	405	6	53	80	0.6625000
NODE_4209_length_1166_cov_18.820056	378	458	2	10	80	0.1250000
NODE_4209_length_1166_cov_18.820056	378	458	4	15	80	0.1875000
NODE_4209_length_1166_cov_18.820056	378	458	5	47	80	0.5875000
NODE_4209_length_1166_cov_18.820056	378	458	6	8	80	0.1000000
NODE_4210_length_1166_cov_18.404873	676	756	2	7	80	0.0875000
NODE_4210_length_1166_cov_18.404873	676	756	3	9	80	0.1125000
NODE_4210_length_1166_cov_18.404873	676	756	4	15	80	0.1875000
NODE_4210_length_1166_cov_18.404873	676	756	5	7	80	0.0875000
NODE_4210_length_1166_cov_18.404873	676	756	6	28	80	0.3500000
NODE_4210_length_1166_cov_18.404873	676	756	7	14	80	0.1750000
NODE_4210_length_1166_cov_18.404873	729	809	6	41	80	0.5125000
NODE_4210_length_1166_cov_18.404873	729	809	7	39	80	0.4875000
NODE_4214_length_1166_cov_1.893158	0	71	1	25	71	0.3521127
NODE_4214_length_1166_cov_1.893158	0	71	2	46	71	0.6478873
NODE_4214_length_1166_cov_1.893158	44	99	2	55	55	1.0000000
NODE_4218_length_1165_cov_29.402439	497	577	19	40	80	0.5000000
NODE_4218_length_1165_cov_29.402439	497	577	20	23	80	0.2875000
NODE_4218_length_1165_cov_29.402439	497	577	22	17	80	0.2125000
NODE_4218_length_1165_cov_29.402439	550	630	3	9	80	0.1125000
NODE_4218_length_1165_cov_29.402439	550	630	16	8	80	0.1000000
NODE_4218_length_1165_cov_29.402439	550	630	18	20	80	0.2500000
NODE_4218_length_1165_cov_29.402439	550	630	19	19	80	0.2375000
NODE_4218_length_1165_cov_29.402439	550	630	20	11	80	0.1375000
NODE_4218_length_1165_cov_29.402439	550	630	22	13	80	0.1625000
NODE_4218_length_1165_cov_29.402439	626	706	3	50	80	0.6250000
NODE_4218_length_1165_cov_29.402439	626	706	7	1	80	0.0125000
NODE_4218_length_1165_cov_29.402439	626	706	10	13	80	0.1625000
NODE_4218_length_1165_cov_29.402439	626	706	11	16	80	0.2000000
NODE_4218_length_1165_cov_29.402439	679	759	10	14	80	0.1750000
NODE_4218_length_1165_cov_29.402439	679	759	11	22	80	0.2750000
NODE_4218_length_1165_cov_29.402439	679	759	14	2	80	0.0250000
NODE_4218_length_1165_cov_29.402439	679	759	15	42	80	0.5250000
NODE_4219_length_1165_cov_28.366792	663	743	5	13	80	0.1625000
NODE_4219_length_1165_cov_28.366792	663	743	6	7	80	0.0875000
NODE_4219_length_1165_cov_28.366792	663	743	7	27	80	0.3375000
NODE_4219_length_1165_cov_28.366792	663	743	9	8	80	0.1000000
NODE_4219_length_1165_cov_28.366792	663	743	10	9	80	0.1125000
NODE_4219_length_1165_cov_28.366792	663	743	11	16	80	0.2000000
NODE_4219_length_1165_cov_28.366792	716	796	8	8	80	0.1000000
NODE_4219_length_1165_cov_28.366792	716	796	9	13	80	0.1625000
NODE_4219_length_1165_cov_28.366792	716	796	10	43	80	0.5375000
NODE_4219_length_1165_cov_28.366792	716	796	11	16	80	0.2000000
NODE_4220_length_1165_cov_23.841463	631	711	7	6	80	0.0750000
NODE_4220_length_1165_cov_23.841463	631	711	9	1	80	0.0125000
NODE_4220_length_1165_cov_23.841463	631	711	10	11	80	0.1375000
NODE_4220_length_1165_cov_23.841463	631	711	11	1	80	0.0125000
NODE_4220_length_1165_cov_23.841463	631	711	12	52	80	0.6500000
NODE_4220_length_1165_cov_23.841463	631	711	15	9	80	0.1125000
NODE_4220_length_1165_cov_23.841463	684	765	12	18	81	0.2222222
NODE_4220_length_1165_cov_23.841463	684	765	13	14	81	0.1728395
NODE_4220_length_1165_cov_23.841463	684	765	14	5	81	0.0617284
NODE_4220_length_1165_cov_23.841463	684	765	15	30	81	0.3703704
NODE_4220_length_1165_cov_23.841463	684	765	16	14	81	0.1728395
NODE_4220_length_1165_cov_23.841463	761	841	10	2	80	0.0250000
NODE_4220_length_1165_cov_23.841463	761	841	11	11	80	0.1375000
NODE_4220_length_1165_cov_23.841463	761	841	12	40	80	0.5000000
NODE_4220_length_1165_cov_23.841463	761	841	14	7	80	0.0875000
NODE_4220_length_1165_cov_23.841463	761	841	15	7	80	0.0875000
NODE_4220_length_1165_cov_23.841463	761	841	16	13	80	0.1625000
NODE_4220_length_1165_cov_23.841463	814	894	7	13	80	0.1625000
NODE_4220_length_1165_cov_23.841463	814	894	8	9	80	0.1125000
NODE_4220_length_1165_cov_23.841463	814	894	9	2	80	0.0250000
NODE_4220_length_1165_cov_23.841463	814	894	10	17	80	0.2125000
NODE_4220_length_1165_cov_23.841463	814	894	11	1	80	0.0125000
NODE_4220_length_1165_cov_23.841463	814	894	12	38	80	0.4750000
NODE_4221_length_1165_cov_21.883677	482	562	4	9	80	0.1125000
NODE_4221_length_1165_cov_21.883677	482	562	5	21	80	0.2625000
NODE_4221_length_1165_cov_21.883677	482	562	6	43	80	0.5375000
NODE_4221_length_1165_cov_21.883677	482	562	7	7	80	0.0875000
NODE_4221_length_1165_cov_21.883677	535	615	3	31	80	0.3875000
NODE_4221_length_1165_cov_21.883677	535	615	5	1	80	0.0125000
NODE_4221_length_1165_cov_21.883677	535	615	6	48	80	0.6000000
NODE_4222_length_1165_cov_14.591932	295	375	2	4	80	0.0500000
NODE_4222_length_1165_cov_14.591932	295	375	3	3	80	0.0375000
NODE_4222_length_1165_cov_14.591932	295	375	4	73	80	0.9125000
NODE_4222_length_1165_cov_14.591932	348	428	2	57	80	0.7125000
NODE_4222_length_1165_cov_14.591932	348	428	4	23	80	0.2875000
NODE_4223_length_1165_cov_13.683865	502	582	10	6	80	0.0750000
NODE_4223_length_1165_cov_13.683865	502	582	11	1	80	0.0125000
NODE_4223_length_1165_cov_13.683865	502	582	12	17	80	0.2125000
NODE_4223_length_1165_cov_13.683865	502	582	13	4	80	0.0500000
NODE_4223_length_1165_cov_13.683865	502	582	14	15	80	0.1875000
NODE_4223_length_1165_cov_13.683865	502	582	15	8	80	0.1000000
NODE_4223_length_1165_cov_13.683865	502	582	16	7	80	0.0875000
NODE_4223_length_1165_cov_13.683865	502	582	17	6	80	0.0750000
NODE_4223_length_1165_cov_13.683865	502	582	18	16	80	0.2000000
NODE_4223_length_1165_cov_13.683865	555	635	15	6	80	0.0750000
NODE_4223_length_1165_cov_13.683865	555	635	16	27	80	0.3375000
NODE_4223_length_1165_cov_13.683865	555	635	17	4	80	0.0500000
NODE_4223_length_1165_cov_13.683865	555	635	18	16	80	0.2000000
NODE_4223_length_1165_cov_13.683865	555	635	22	14	80	0.1750000
NODE_4223_length_1165_cov_13.683865	555	635	23	13	80	0.1625000
NODE_4224_length_1165_cov_7.915572	383	463	2	80	80	1.0000000
NODE_4224_length_1165_cov_7.915572	436	516	0	34	80	0.4250000
NODE_4224_length_1165_cov_7.915572	436	516	1	7	80	0.0875000
NODE_4224_length_1165_cov_7.915572	436	516	2	39	80	0.4875000
NODE_4225_length_1165_cov_7.466229	552	632	0	15	80	0.1875000
NODE_4225_length_1165_cov_7.466229	552	632	1	51	80	0.6375000
NODE_4225_length_1165_cov_7.466229	552	632	2	14	80	0.1750000
NODE_4225_length_1165_cov_7.466229	605	685	0	68	80	0.8500000
NODE_4225_length_1165_cov_7.466229	605	685	1	12	80	0.1500000
NODE_4226_length_1165_cov_5.617261	676	756	1	58	80	0.7250000
NODE_4226_length_1165_cov_5.617261	676	756	2	22	80	0.2750000
NODE_4226_length_1165_cov_5.617261	729	809	1	11	80	0.1375000
NODE_4226_length_1165_cov_5.617261	729	809	2	69	80	0.8625000
NODE_4227_length_1165_cov_3.658537	554	602	0	12	48	0.2500000
NODE_4227_length_1165_cov_3.658537	554	602	2	33	48	0.6875000
NODE_4227_length_1165_cov_3.658537	554	602	3	3	48	0.0625000
NODE_4233_length_1164_cov_55.273239	459	539	4	12	80	0.1500000
NODE_4233_length_1164_cov_55.273239	459	539	8	11	80	0.1375000
NODE_4233_length_1164_cov_55.273239	459	539	9	18	80	0.2250000
NODE_4233_length_1164_cov_55.273239	459	539	10	39	80	0.4875000
NODE_4233_length_1164_cov_55.273239	512	592	7	38	80	0.4750000
NODE_4233_length_1164_cov_55.273239	512	592	8	13	80	0.1625000
NODE_4233_length_1164_cov_55.273239	512	592	9	29	80	0.3625000
NODE_4234_length_1164_cov_44.183099	571	651	13	16	80	0.2000000
NODE_4234_length_1164_cov_44.183099	571	651	15	11	80	0.1375000
NODE_4234_length_1164_cov_44.183099	571	651	17	32	80	0.4000000
NODE_4234_length_1164_cov_44.183099	571	651	18	8	80	0.1000000
NODE_4234_length_1164_cov_44.183099	571	651	19	1	80	0.0125000
NODE_4234_length_1164_cov_44.183099	571	651	22	12	80	0.1500000
NODE_4234_length_1164_cov_44.183099	624	704	17	7	80	0.0875000
NODE_4234_length_1164_cov_44.183099	624	704	18	8	80	0.1000000
NODE_4234_length_1164_cov_44.183099	624	704	20	8	80	0.1000000
NODE_4234_length_1164_cov_44.183099	624	704	21	6	80	0.0750000
NODE_4234_length_1164_cov_44.183099	624	704	22	19	80	0.2375000
NODE_4234_length_1164_cov_44.183099	624	704	23	21	80	0.2625000
NODE_4234_length_1164_cov_44.183099	624	704	24	10	80	0.1250000
NODE_4234_length_1164_cov_44.183099	624	704	25	1	80	0.0125000
NODE_4234_length_1164_cov_44.183099	700	780	12	10	80	0.1250000
NODE_4234_length_1164_cov_44.183099	700	780	14	22	80	0.2750000
NODE_4234_length_1164_cov_44.183099	700	780	15	1	80	0.0125000
NODE_4234_length_1164_cov_44.183099	700	780	16	10	80	0.1250000
NODE_4234_length_1164_cov_44.183099	700	780	18	24	80	0.3000000
NODE_4234_length_1164_cov_44.183099	700	780	19	5	80	0.0625000
NODE_4234_length_1164_cov_44.183099	700	780	20	8	80	0.1000000
NODE_4234_length_1164_cov_44.183099	753	833	3	1	80	0.0125000
NODE_4234_length_1164_cov_44.183099	753	833	6	13	80	0.1625000
NODE_4234_length_1164_cov_44.183099	753	833	7	30	80	0.3750000
NODE_4234_length_1164_cov_44.183099	753	833	11	8	80	0.1000000
NODE_4234_length_1164_cov_44.183099	753	833	12	11	80	0.1375000
NODE_4234_length_1164_cov_44.183099	753	833	14	17	80	0.2125000
NODE_4235_length_1164_cov_14.277934	1029	1109	6	48	80	0.6000000
NODE_4235_length_1164_cov_14.277934	1029	1109	8	32	80	0.4000000
NODE_4235_length_1164_cov_14.277934	1097	1162	1	11	65	0.1692308
NODE_4235_length_1164_cov_14.277934	1097	1162	3	10	65	0.1538462
NODE_4235_length_1164_cov_14.277934	1097	1162	5	12	65	0.1846154
NODE_4235_length_1164_cov_14.277934	1097	1162	6	32	65	0.4923077
NODE_4236_length_1164_cov_12.880751	415	495	11	37	80	0.4625000
NODE_4236_length_1164_cov_12.880751	415	495	12	18	80	0.2250000
NODE_4236_length_1164_cov_12.880751	415	495	13	10	80	0.1250000
NODE_4236_length_1164_cov_12.880751	415	495	14	15	80	0.1875000
NODE_4236_length_1164_cov_12.880751	468	548	10	10	80	0.1250000
NODE_4236_length_1164_cov_12.880751	468	548	11	34	80	0.4250000
NODE_4236_length_1164_cov_12.880751	468	548	12	27	80	0.3375000
NODE_4236_length_1164_cov_12.880751	468	548	13	9	80	0.1125000
NODE_4237_length_1164_cov_6.924883	415	495	0	80	80	1.0000000
NODE_4237_length_1164_cov_6.924883	468	548	0	80	80	1.0000000
NODE_4245_length_1163_cov_36.315789	458	538	3	12	80	0.1500000
NODE_4245_length_1163_cov_36.315789	458	538	5	21	80	0.2625000
NODE_4245_length_1163_cov_36.315789	458	538	6	16	80	0.2000000
NODE_4245_length_1163_cov_36.315789	458	538	7	2	80	0.0250000
NODE_4245_length_1163_cov_36.315789	458	538	9	9	80	0.1125000
NODE_4245_length_1163_cov_36.315789	458	538	11	10	80	0.1250000
NODE_4245_length_1163_cov_36.315789	458	538	12	10	80	0.1250000
NODE_4245_length_1163_cov_36.315789	511	591	9	7	80	0.0875000
NODE_4245_length_1163_cov_36.315789	511	591	11	10	80	0.1250000
NODE_4245_length_1163_cov_36.315789	511	591	12	13	80	0.1625000
NODE_4245_length_1163_cov_36.315789	511	591	13	4	80	0.0500000
NODE_4245_length_1163_cov_36.315789	511	591	14	4	80	0.0500000
NODE_4245_length_1163_cov_36.315789	511	591	15	6	80	0.0750000
NODE_4245_length_1163_cov_36.315789	511	591	17	4	80	0.0500000
NODE_4245_length_1163_cov_36.315789	511	591	20	1	80	0.0125000
NODE_4245_length_1163_cov_36.315789	511	591	21	31	80	0.3875000
NODE_4245_length_1163_cov_36.315789	587	667	21	14	80	0.1750000
NODE_4245_length_1163_cov_36.315789	587	667	23	3	80	0.0375000
NODE_4245_length_1163_cov_36.315789	587	667	27	8	80	0.1000000
NODE_4245_length_1163_cov_36.315789	587	667	28	1	80	0.0125000
NODE_4245_length_1163_cov_36.315789	587	667	29	11	80	0.1375000
NODE_4245_length_1163_cov_36.315789	587	667	30	37	80	0.4625000
NODE_4245_length_1163_cov_36.315789	587	667	32	6	80	0.0750000
NODE_4245_length_1163_cov_36.315789	640	720	12	10	80	0.1250000
NODE_4245_length_1163_cov_36.315789	640	720	13	1	80	0.0125000
NODE_4245_length_1163_cov_36.315789	640	720	16	4	80	0.0500000
NODE_4245_length_1163_cov_36.315789	640	720	18	6	80	0.0750000
NODE_4245_length_1163_cov_36.315789	640	720	19	1	80	0.0125000
NODE_4245_length_1163_cov_36.315789	640	720	21	1	80	0.0125000
NODE_4245_length_1163_cov_36.315789	640	720	22	7	80	0.0875000
NODE_4245_length_1163_cov_36.315789	640	720	24	13	80	0.1625000
NODE_4245_length_1163_cov_36.315789	640	720	25	9	80	0.1125000
NODE_4245_length_1163_cov_36.315789	640	720	27	9	80	0.1125000
NODE_4245_length_1163_cov_36.315789	640	720	29	11	80	0.1375000
NODE_4245_length_1163_cov_36.315789	640	720	30	8	80	0.1000000
NODE_4246_length_1163_cov_29.466165	542	622	3	24	80	0.3000000
NODE_4246_length_1163_cov_29.466165	542	622	4	4	80	0.0500000
NODE_4246_length_1163_cov_29.466165	542	622	5	52	80	0.6500000
NODE_4246_length_1163_cov_29.466165	595	675	0	30	80	0.3750000
NODE_4246_length_1163_cov_29.466165	595	675	1	17	80	0.2125000
NODE_4246_length_1163_cov_29.466165	595	675	2	6	80	0.0750000
NODE_4246_length_1163_cov_29.466165	595	675	3	24	80	0.3000000
NODE_4246_length_1163_cov_29.466165	595	675	4	3	80	0.0375000
NODE_4246_length_1163_cov_29.466165	671	751	0	10	80	0.1250000
NODE_4246_length_1163_cov_29.466165	671	751	1	70	80	0.8750000
NODE_4246_length_1163_cov_29.466165	724	804	1	41	80	0.5125000
NODE_4246_length_1163_cov_29.466165	724	804	9	39	80	0.4875000
NODE_4247_length_1163_cov_15.107143	668	748	1	35	80	0.4375000
NODE_4247_length_1163_cov_15.107143	668	748	2	45	80	0.5625000
NODE_4247_length_1163_cov_15.107143	721	801	1	22	80	0.2750000
NODE_4247_length_1163_cov_15.107143	721	801	2	58	80	0.7250000
NODE_4248_length_1163_cov_14.347744	540	620	2	80	80	1.0000000
NODE_4248_length_1163_cov_14.347744	593	673	2	80	80	1.0000000
NODE_4249_length_1163_cov_11.650376	354	434	2	6	80	0.0750000
NODE_4249_length_1163_cov_11.650376	354	434	3	3	80	0.0375000
NODE_4249_length_1163_cov_11.650376	354	434	4	4	80	0.0500000
NODE_4249_length_1163_cov_11.650376	354	434	5	31	80	0.3875000
NODE_4249_length_1163_cov_11.650376	354	434	6	3	80	0.0375000
NODE_4249_length_1163_cov_11.650376	354	434	8	5	80	0.0625000
NODE_4249_length_1163_cov_11.650376	354	434	9	10	80	0.1250000
NODE_4249_length_1163_cov_11.650376	354	434	10	18	80	0.2250000
NODE_4249_length_1163_cov_11.650376	407	487	9	14	80	0.1750000
NODE_4249_length_1163_cov_11.650376	407	487	10	17	80	0.2125000
NODE_4249_length_1163_cov_11.650376	407	487	11	6	80	0.0750000
NODE_4249_length_1163_cov_11.650376	407	487	12	11	80	0.1375000
NODE_4249_length_1163_cov_11.650376	407	487	13	32	80	0.4000000
NODE_4249_length_1163_cov_11.650376	738	818	0	66	80	0.8250000
NODE_4249_length_1163_cov_11.650376	738	818	1	14	80	0.1750000
NODE_4249_length_1163_cov_11.650376	791	871	0	80	80	1.0000000
NODE_4253_length_1162_cov_30.049859	359	439	5	12	80	0.1500000
NODE_4253_length_1162_cov_30.049859	359	439	6	64	80	0.8000000
NODE_4253_length_1162_cov_30.049859	359	439	7	4	80	0.0500000
NODE_4253_length_1162_cov_30.049859	412	492	5	3	80	0.0375000
NODE_4253_length_1162_cov_30.049859	412	492	6	35	80	0.4375000
NODE_4253_length_1162_cov_30.049859	412	492	7	30	80	0.3750000
NODE_4253_length_1162_cov_30.049859	412	492	8	12	80	0.1500000
NODE_4254_length_1162_cov_25.960489	440	520	4	30	80	0.3750000
NODE_4254_length_1162_cov_25.960489	440	520	5	1	80	0.0125000
NODE_4254_length_1162_cov_25.960489	440	520	6	21	80	0.2625000
NODE_4254_length_1162_cov_25.960489	440	520	9	4	80	0.0500000
NODE_4254_length_1162_cov_25.960489	440	520	11	14	80	0.1750000
NODE_4254_length_1162_cov_25.960489	440	520	12	10	80	0.1250000
NODE_4254_length_1162_cov_25.960489	493	573	9	3	80	0.0375000
NODE_4254_length_1162_cov_25.960489	493	573	11	17	80	0.2125000
NODE_4254_length_1162_cov_25.960489	493	573	12	54	80	0.6750000
NODE_4254_length_1162_cov_25.960489	493	573	13	6	80	0.0750000
NODE_4254_length_1162_cov_25.960489	569	649	9	4	80	0.0500000
NODE_4254_length_1162_cov_25.960489	569	649	11	14	80	0.1750000
NODE_4254_length_1162_cov_25.960489	569	649	12	4	80	0.0500000
NODE_4254_length_1162_cov_25.960489	569	649	13	11	80	0.1375000
NODE_4254_length_1162_cov_25.960489	569	649	14	22	80	0.2750000
NODE_4254_length_1162_cov_25.960489	569	649	16	25	80	0.3125000
NODE_4254_length_1162_cov_25.960489	622	702	6	27	80	0.3375000
NODE_4254_length_1162_cov_25.960489	622	702	7	18	80	0.2250000
NODE_4254_length_1162_cov_25.960489	622	702	9	12	80	0.1500000
NODE_4254_length_1162_cov_25.960489	622	702	12	3	80	0.0375000
NODE_4254_length_1162_cov_25.960489	622	702	14	20	80	0.2500000
NODE_4255_length_1162_cov_24.843838	523	603	2	4	80	0.0500000
NODE_4255_length_1162_cov_24.843838	523	603	3	1	80	0.0125000
NODE_4255_length_1162_cov_24.843838	523	603	4	10	80	0.1250000
NODE_4255_length_1162_cov_24.843838	523	603	6	11	80	0.1375000
NODE_4255_length_1162_cov_24.843838	523	603	7	15	80	0.1875000
NODE_4255_length_1162_cov_24.843838	523	603	8	14	80	0.1750000
NODE_4255_length_1162_cov_24.843838	523	603	9	25	80	0.3125000
NODE_4255_length_1162_cov_24.843838	576	656	8	2	80	0.0250000
NODE_4255_length_1162_cov_24.843838	576	656	9	42	80	0.5250000
NODE_4255_length_1162_cov_24.843838	576	656	10	17	80	0.2125000
NODE_4255_length_1162_cov_24.843838	576	656	13	10	80	0.1250000
NODE_4255_length_1162_cov_24.843838	576	656	14	5	80	0.0625000
NODE_4255_length_1162_cov_24.843838	576	656	15	4	80	0.0500000
NODE_4255_length_1162_cov_24.843838	652	732	11	10	80	0.1250000
NODE_4255_length_1162_cov_24.843838	652	732	12	16	80	0.2000000
NODE_4255_length_1162_cov_24.843838	652	732	14	17	80	0.2125000
NODE_4255_length_1162_cov_24.843838	652	732	15	22	80	0.2750000
NODE_4255_length_1162_cov_24.843838	652	732	16	15	80	0.1875000
NODE_4255_length_1162_cov_24.843838	705	785	11	4	80	0.0500000
NODE_4255_length_1162_cov_24.843838	705	785	12	5	80	0.0625000
NODE_4255_length_1162_cov_24.843838	705	785	14	3	80	0.0375000
NODE_4255_length_1162_cov_24.843838	705	785	16	45	80	0.5625000
NODE_4255_length_1162_cov_24.843838	705	785	17	6	80	0.0750000
NODE_4255_length_1162_cov_24.843838	705	785	18	17	80	0.2125000
NODE_4257_length_1162_cov_17.131703	302	382	4	20	80	0.2500000
NODE_4257_length_1162_cov_17.131703	302	382	6	60	80	0.7500000
NODE_4257_length_1162_cov_17.131703	355	435	4	3	80	0.0375000
NODE_4257_length_1162_cov_17.131703	355	435	5	12	80	0.1500000
NODE_4257_length_1162_cov_17.131703	355	435	6	65	80	0.8125000
NODE_4257_length_1162_cov_17.131703	431	511	2	16	80	0.2000000
NODE_4257_length_1162_cov_17.131703	431	511	4	48	80	0.6000000
NODE_4257_length_1162_cov_17.131703	431	511	5	1	80	0.0125000
NODE_4257_length_1162_cov_17.131703	431	511	6	15	80	0.1875000
NODE_4257_length_1162_cov_17.131703	484	564	2	4	80	0.0500000
NODE_4257_length_1162_cov_17.131703	484	564	4	48	80	0.6000000
NODE_4257_length_1162_cov_17.131703	484	564	6	28	80	0.3500000
NODE_4258_length_1162_cov_14.766698	630	710	0	28	80	0.3500000
NODE_4258_length_1162_cov_14.766698	630	710	1	52	80	0.6500000
NODE_4258_length_1162_cov_14.766698	683	763	1	80	80	1.0000000
NODE_4259_length_1162_cov_13.968015	423	503	3	2	80	0.0250000
NODE_4259_length_1162_cov_13.968015	423	503	4	29	80	0.3625000
NODE_4259_length_1162_cov_13.968015	423	503	5	6	80	0.0750000
NODE_4259_length_1162_cov_13.968015	423	503	6	43	80	0.5375000
NODE_4259_length_1162_cov_13.968015	476	556	6	49	80	0.6125000
NODE_4259_length_1162_cov_13.968015	476	556	8	31	80	0.3875000
NODE_4264_length_1162_cov_1.977422	855	926	0	71	71	1.0000000
NODE_4264_length_1162_cov_1.977422	908	977	0	69	69	1.0000000
NODE_4264_length_1162_cov_1.977422	908	977	0	69	69	1.0000000
NODE_4266_length_1161_cov_33.312618	456	536	7	29	80	0.3625000
NODE_4266_length_1161_cov_33.312618	456	536	9	15	80	0.1875000
NODE_4266_length_1161_cov_33.312618	456	536	10	9	80	0.1125000
NODE_4266_length_1161_cov_33.312618	456	536	11	2	80	0.0250000
NODE_4266_length_1161_cov_33.312618	456	536	12	25	80	0.3125000
NODE_4266_length_1161_cov_33.312618	509	587	8	2	78	0.0256410
NODE_4266_length_1161_cov_33.312618	509	587	9	29	78	0.3717949
NODE_4266_length_1161_cov_33.312618	509	587	11	12	78	0.1538462
NODE_4266_length_1161_cov_33.312618	509	587	12	35	78	0.4487180
NODE_4267_length_1161_cov_30.466102	594	674	2	35	80	0.4375000
NODE_4267_length_1161_cov_30.466102	594	674	3	38	80	0.4750000
NODE_4267_length_1161_cov_30.466102	594	674	4	7	80	0.0875000
NODE_4267_length_1161_cov_30.466102	647	727	3	20	80	0.2500000
NODE_4267_length_1161_cov_30.466102	647	727	4	60	80	0.7500000
NODE_4268_length_1161_cov_29.628060	426	506	1	26	80	0.3250000
NODE_4268_length_1161_cov_29.628060	426	506	15	4	80	0.0500000
NODE_4268_length_1161_cov_29.628060	426	506	16	27	80	0.3375000
NODE_4268_length_1161_cov_29.628060	426	506	17	9	80	0.1125000
NODE_4268_length_1161_cov_29.628060	426	506	19	2	80	0.0250000
NODE_4268_length_1161_cov_29.628060	426	506	20	4	80	0.0500000
NODE_4268_length_1161_cov_29.628060	426	506	21	8	80	0.1000000
NODE_4268_length_1161_cov_29.628060	479	559	16	4	80	0.0500000
NODE_4268_length_1161_cov_29.628060	479	559	17	9	80	0.1125000
NODE_4268_length_1161_cov_29.628060	479	559	19	2	80	0.0250000
NODE_4268_length_1161_cov_29.628060	479	559	20	4	80	0.0500000
NODE_4268_length_1161_cov_29.628060	479	559	21	38	80	0.4750000
NODE_4268_length_1161_cov_29.628060	479	559	22	2	80	0.0250000
NODE_4268_length_1161_cov_29.628060	479	559	23	3	80	0.0375000
NODE_4268_length_1161_cov_29.628060	479	559	24	3	80	0.0375000
NODE_4268_length_1161_cov_29.628060	479	559	25	1	80	0.0125000
NODE_4268_length_1161_cov_29.628060	479	559	26	7	80	0.0875000
NODE_4268_length_1161_cov_29.628060	479	559	28	7	80	0.0875000
NODE_4268_length_1161_cov_29.628060	603	683	14	1	80	0.0125000
NODE_4268_length_1161_cov_29.628060	603	683	15	12	80	0.1500000
NODE_4268_length_1161_cov_29.628060	603	683	16	8	80	0.1000000
NODE_4268_length_1161_cov_29.628060	603	683	17	37	80	0.4625000
NODE_4268_length_1161_cov_29.628060	603	683	18	20	80	0.2500000
NODE_4268_length_1161_cov_29.628060	603	683	19	2	80	0.0250000
NODE_4268_length_1161_cov_29.628060	656	736	9	13	80	0.1625000
NODE_4268_length_1161_cov_29.628060	656	736	10	21	80	0.2625000
NODE_4268_length_1161_cov_29.628060	656	736	12	7	80	0.0875000
NODE_4268_length_1161_cov_29.628060	656	736	13	1	80	0.0125000
NODE_4268_length_1161_cov_29.628060	656	736	14	3	80	0.0375000
NODE_4268_length_1161_cov_29.628060	656	736	15	4	80	0.0500000
NODE_4268_length_1161_cov_29.628060	656	736	16	7	80	0.0875000
NODE_4268_length_1161_cov_29.628060	656	736	17	24	80	0.3000000
NODE_4269_length_1161_cov_22.923729	492	572	11	45	80	0.5625000
NODE_4269_length_1161_cov_22.923729	492	572	12	8	80	0.1000000
NODE_4269_length_1161_cov_22.923729	492	572	13	2	80	0.0250000
NODE_4269_length_1161_cov_22.923729	492	572	15	17	80	0.2125000
NODE_4269_length_1161_cov_22.923729	492	572	16	8	80	0.1000000
NODE_4269_length_1161_cov_22.923729	545	625	13	2	80	0.0250000
NODE_4269_length_1161_cov_22.923729	545	625	14	1	80	0.0125000
NODE_4269_length_1161_cov_22.923729	545	625	15	51	80	0.6375000
NODE_4269_length_1161_cov_22.923729	545	625	16	12	80	0.1500000
NODE_4269_length_1161_cov_22.923729	545	625	17	9	80	0.1125000
NODE_4269_length_1161_cov_22.923729	545	625	18	5	80	0.0625000
NODE_4269_length_1161_cov_22.923729	621	701	4	1	80	0.0125000
NODE_4269_length_1161_cov_22.923729	621	701	6	2	80	0.0250000
NODE_4269_length_1161_cov_22.923729	621	701	7	1	80	0.0125000
NODE_4269_length_1161_cov_22.923729	621	701	10	2	80	0.0250000
NODE_4269_length_1161_cov_22.923729	621	701	12	33	80	0.4125000
NODE_4269_length_1161_cov_22.923729	621	701	13	23	80	0.2875000
NODE_4269_length_1161_cov_22.923729	621	701	14	15	80	0.1875000
NODE_4269_length_1161_cov_22.923729	621	701	16	3	80	0.0375000
NODE_4269_length_1161_cov_22.923729	674	754	4	11	80	0.1375000
NODE_4269_length_1161_cov_22.923729	674	754	6	3	80	0.0375000
NODE_4269_length_1161_cov_22.923729	674	754	7	22	80	0.2750000
NODE_4269_length_1161_cov_22.923729	674	754	10	2	80	0.0250000
NODE_4269_length_1161_cov_22.923729	674	754	11	21	80	0.2625000
NODE_4269_length_1161_cov_22.923729	674	754	12	21	80	0.2625000
NODE_4270_length_1161_cov_20.184557	480	560	15	6	80	0.0750000
NODE_4270_length_1161_cov_20.184557	480	560	17	6	80	0.0750000
NODE_4270_length_1161_cov_20.184557	480	560	18	3	80	0.0375000
NODE_4270_length_1161_cov_20.184557	480	560	19	5	80	0.0625000
NODE_4270_length_1161_cov_20.184557	480	560	20	29	80	0.3625000
NODE_4270_length_1161_cov_20.184557	480	560	21	11	80	0.1375000
NODE_4270_length_1161_cov_20.184557	480	560	22	13	80	0.1625000
NODE_4270_length_1161_cov_20.184557	480	560	23	1	80	0.0125000
NODE_4270_length_1161_cov_20.184557	480	560	25	6	80	0.0750000
NODE_4270_length_1161_cov_20.184557	533	613	21	9	80	0.1125000
NODE_4270_length_1161_cov_20.184557	533	613	22	25	80	0.3125000
NODE_4270_length_1161_cov_20.184557	533	613	23	14	80	0.1750000
NODE_4270_length_1161_cov_20.184557	533	613	24	26	80	0.3250000
NODE_4270_length_1161_cov_20.184557	533	613	25	6	80	0.0750000
NODE_4271_length_1161_cov_17.437853	375	455	1	3	80	0.0375000
NODE_4271_length_1161_cov_17.437853	375	455	2	77	80	0.9625000
NODE_4271_length_1161_cov_17.437853	428	508	0	13	80	0.1625000
NODE_4271_length_1161_cov_17.437853	428	508	1	43	80	0.5375000
NODE_4271_length_1161_cov_17.437853	428	508	2	24	80	0.3000000
NODE_4272_length_1161_cov_14.062147	375	455	4	80	80	1.0000000
NODE_4272_length_1161_cov_14.062147	428	508	0	15	80	0.1875000
NODE_4272_length_1161_cov_14.062147	428	508	2	7	80	0.0875000
NODE_4272_length_1161_cov_14.062147	428	508	4	58	80	0.7250000
NODE_4273_length_1161_cov_12.304143	381	461	1	42	80	0.5250000
NODE_4273_length_1161_cov_12.304143	381	461	4	38	80	0.4750000
NODE_4273_length_1161_cov_12.304143	434	514	4	52	80	0.6500000
NODE_4273_length_1161_cov_12.304143	434	514	5	28	80	0.3500000
NODE_4274_length_1161_cov_10.297552	598	678	7	34	80	0.4250000
NODE_4274_length_1161_cov_10.297552	598	678	8	16	80	0.2000000
NODE_4274_length_1161_cov_10.297552	598	678	9	11	80	0.1375000
NODE_4274_length_1161_cov_10.297552	598	678	10	19	80	0.2375000
NODE_4274_length_1161_cov_10.297552	651	731	6	11	80	0.1375000
NODE_4274_length_1161_cov_10.297552	651	731	7	5	80	0.0625000
NODE_4274_length_1161_cov_10.297552	651	731	8	2	80	0.0250000
NODE_4274_length_1161_cov_10.297552	651	731	9	31	80	0.3875000
NODE_4274_length_1161_cov_10.297552	651	731	10	31	80	0.3875000
NODE_4283_length_1160_cov_86.515551	613	693	57	12	80	0.1500000
NODE_4283_length_1160_cov_86.515551	613	693	58	7	80	0.0875000
NODE_4283_length_1160_cov_86.515551	613	693	59	1	80	0.0125000
NODE_4283_length_1160_cov_86.515551	613	693	60	1	80	0.0125000
NODE_4283_length_1160_cov_86.515551	613	693	66	3	80	0.0375000
NODE_4283_length_1160_cov_86.515551	613	693	67	15	80	0.1875000
NODE_4283_length_1160_cov_86.515551	613	693	70	3	80	0.0375000
NODE_4283_length_1160_cov_86.515551	613	693	71	4	80	0.0500000
NODE_4283_length_1160_cov_86.515551	613	693	72	2	80	0.0250000
NODE_4283_length_1160_cov_86.515551	613	693	73	6	80	0.0750000
NODE_4283_length_1160_cov_86.515551	613	693	74	6	80	0.0750000
NODE_4283_length_1160_cov_86.515551	613	693	75	2	80	0.0250000
NODE_4283_length_1160_cov_86.515551	613	693	78	6	80	0.0750000
NODE_4283_length_1160_cov_86.515551	613	693	80	12	80	0.1500000
NODE_4283_length_1160_cov_86.515551	666	746	61	2	80	0.0250000
NODE_4283_length_1160_cov_86.515551	666	746	62	1	80	0.0125000
NODE_4283_length_1160_cov_86.515551	666	746	63	4	80	0.0500000
NODE_4283_length_1160_cov_86.515551	666	746	64	6	80	0.0750000
NODE_4283_length_1160_cov_86.515551	666	746	65	2	80	0.0250000
NODE_4283_length_1160_cov_86.515551	666	746	67	10	80	0.1250000
NODE_4283_length_1160_cov_86.515551	666	746	69	2	80	0.0250000
NODE_4283_length_1160_cov_86.515551	666	746	70	7	80	0.0875000
NODE_4283_length_1160_cov_86.515551	666	746	71	8	80	0.1000000
NODE_4283_length_1160_cov_86.515551	666	746	74	16	80	0.2000000
NODE_4283_length_1160_cov_86.515551	666	746	75	5	80	0.0625000
NODE_4283_length_1160_cov_86.515551	666	746	79	1	80	0.0125000
NODE_4283_length_1160_cov_86.515551	666	746	80	8	80	0.1000000
NODE_4283_length_1160_cov_86.515551	666	746	81	2	80	0.0250000
NODE_4283_length_1160_cov_86.515551	666	746	83	1	80	0.0125000
NODE_4283_length_1160_cov_86.515551	666	746	84	5	80	0.0625000
NODE_4284_length_1160_cov_29.272385	526	606	4	23	80	0.2875000
NODE_4284_length_1160_cov_29.272385	526	606	5	3	80	0.0375000
NODE_4284_length_1160_cov_29.272385	526	606	7	16	80	0.2000000
NODE_4284_length_1160_cov_29.272385	526	606	9	21	80	0.2625000
NODE_4284_length_1160_cov_29.272385	526	606	10	17	80	0.2125000
NODE_4284_length_1160_cov_29.272385	579	659	9	16	80	0.2000000
NODE_4284_length_1160_cov_29.272385	579	659	10	29	80	0.3625000
NODE_4284_length_1160_cov_29.272385	579	659	12	8	80	0.1000000
NODE_4284_length_1160_cov_29.272385	579	659	13	19	80	0.2375000
NODE_4284_length_1160_cov_29.272385	579	659	14	8	80	0.1000000
NODE_4285_length_1160_cov_21.391140	767	847	6	4	80	0.0500000
NODE_4285_length_1160_cov_21.391140	767	847	9	1	80	0.0125000
NODE_4285_length_1160_cov_21.391140	767	847	10	9	80	0.1125000
NODE_4285_length_1160_cov_21.391140	767	847	12	66	80	0.8250000
NODE_4296_length_1159_cov_147.794340	911	991	102	9	80	0.1125000
NODE_4296_length_1159_cov_147.794340	911	991	103	1	80	0.0125000
NODE_4296_length_1159_cov_147.794340	911	991	104	3	80	0.0375000
NODE_4296_length_1159_cov_147.794340	911	991	105	1	80	0.0125000
NODE_4296_length_1159_cov_147.794340	911	991	106	1	80	0.0125000
NODE_4296_length_1159_cov_147.794340	911	991	107	2	80	0.0250000
NODE_4296_length_1159_cov_147.794340	911	991	108	6	80	0.0750000
NODE_4296_length_1159_cov_147.794340	911	991	109	11	80	0.1375000
NODE_4296_length_1159_cov_147.794340	911	991	111	9	80	0.1125000
NODE_4296_length_1159_cov_147.794340	911	991	113	13	80	0.1625000
NODE_4296_length_1159_cov_147.794340	911	991	114	4	80	0.0500000
NODE_4296_length_1159_cov_147.794340	911	991	115	3	80	0.0375000
NODE_4296_length_1159_cov_147.794340	911	991	116	7	80	0.0875000
NODE_4296_length_1159_cov_147.794340	911	991	117	1	80	0.0125000
NODE_4296_length_1159_cov_147.794340	911	991	118	2	80	0.0250000
NODE_4296_length_1159_cov_147.794340	911	991	123	7	80	0.0875000
NODE_4296_length_1159_cov_147.794340	964	1044	38	1	80	0.0125000
NODE_4296_length_1159_cov_147.794340	964	1044	40	1	80	0.0125000
NODE_4296_length_1159_cov_147.794340	964	1044	42	2	80	0.0250000
NODE_4296_length_1159_cov_147.794340	964	1044	48	2	80	0.0250000
NODE_4296_length_1159_cov_147.794340	964	1044	50	1	80	0.0125000
NODE_4296_length_1159_cov_147.794340	964	1044	52	1	80	0.0125000
NODE_4296_length_1159_cov_147.794340	964	1044	55	1	80	0.0125000
NODE_4296_length_1159_cov_147.794340	964	1044	56	3	80	0.0375000
NODE_4296_length_1159_cov_147.794340	964	1044	58	3	80	0.0375000
NODE_4296_length_1159_cov_147.794340	964	1044	59	1	80	0.0125000
NODE_4296_length_1159_cov_147.794340	964	1044	60	1	80	0.0125000
NODE_4296_length_1159_cov_147.794340	964	1044	61	1	80	0.0125000
NODE_4296_length_1159_cov_147.794340	964	1044	65	2	80	0.0250000
NODE_4296_length_1159_cov_147.794340	964	1044	70	10	80	0.1250000
NODE_4296_length_1159_cov_147.794340	964	1044	76	1	80	0.0125000
NODE_4296_length_1159_cov_147.794340	964	1044	78	3	80	0.0375000
NODE_4296_length_1159_cov_147.794340	964	1044	81	1	80	0.0125000
NODE_4296_length_1159_cov_147.794340	964	1044	84	6	80	0.0750000
NODE_4296_length_1159_cov_147.794340	964	1044	85	1	80	0.0125000
NODE_4296_length_1159_cov_147.794340	964	1044	86	1	80	0.0125000
NODE_4296_length_1159_cov_147.794340	964	1044	94	1	80	0.0125000
NODE_4296_length_1159_cov_147.794340	964	1044	95	1	80	0.0125000
NODE_4296_length_1159_cov_147.794340	964	1044	96	5	80	0.0625000
NODE_4296_length_1159_cov_147.794340	964	1044	97	1	80	0.0125000
NODE_4296_length_1159_cov_147.794340	964	1044	98	1	80	0.0125000
NODE_4296_length_1159_cov_147.794340	964	1044	100	1	80	0.0125000
NODE_4296_length_1159_cov_147.794340	964	1044	102	9	80	0.1125000
NODE_4296_length_1159_cov_147.794340	964	1044	104	3	80	0.0375000
NODE_4296_length_1159_cov_147.794340	964	1044	105	1	80	0.0125000
NODE_4296_length_1159_cov_147.794340	964	1044	108	3	80	0.0375000
NODE_4296_length_1159_cov_147.794340	964	1044	109	10	80	0.1250000
NODE_4296_length_1159_cov_147.794340	964	1044	113	1	80	0.0125000
NODE_4297_length_1159_cov_57.566981	457	537	13	1	80	0.0125000
NODE_4297_length_1159_cov_57.566981	457	537	14	34	80	0.4250000
NODE_4297_length_1159_cov_57.566981	457	537	15	15	80	0.1875000
NODE_4297_length_1159_cov_57.566981	457	537	16	10	80	0.1250000
NODE_4297_length_1159_cov_57.566981	457	537	18	7	80	0.0875000
NODE_4297_length_1159_cov_57.566981	457	537	19	13	80	0.1625000
NODE_4297_length_1159_cov_57.566981	510	590	14	7	80	0.0875000
NODE_4297_length_1159_cov_57.566981	510	590	15	1	80	0.0125000
NODE_4297_length_1159_cov_57.566981	510	590	16	21	80	0.2625000
NODE_4297_length_1159_cov_57.566981	510	590	17	19	80	0.2375000
NODE_4297_length_1159_cov_57.566981	510	590	18	17	80	0.2125000
NODE_4297_length_1159_cov_57.566981	510	590	19	15	80	0.1875000
NODE_4297_length_1159_cov_57.566981	586	666	8	9	80	0.1125000
NODE_4297_length_1159_cov_57.566981	586	666	11	5	80	0.0625000
NODE_4297_length_1159_cov_57.566981	586	666	12	30	80	0.3750000
NODE_4297_length_1159_cov_57.566981	586	666	13	18	80	0.2250000
NODE_4297_length_1159_cov_57.566981	586	666	14	14	80	0.1750000
NODE_4297_length_1159_cov_57.566981	586	666	15	1	80	0.0125000
NODE_4297_length_1159_cov_57.566981	586	666	16	3	80	0.0375000
NODE_4297_length_1159_cov_57.566981	639	719	5	7	80	0.0875000
NODE_4297_length_1159_cov_57.566981	639	719	6	10	80	0.1250000
NODE_4297_length_1159_cov_57.566981	639	719	7	13	80	0.1625000
NODE_4297_length_1159_cov_57.566981	639	719	8	32	80	0.4000000
NODE_4297_length_1159_cov_57.566981	639	719	11	1	80	0.0125000
NODE_4297_length_1159_cov_57.566981	639	719	12	14	80	0.1750000
NODE_4297_length_1159_cov_57.566981	639	719	13	3	80	0.0375000
NODE_4298_length_1159_cov_44.053774	329	409	15	8	80	0.1000000
NODE_4298_length_1159_cov_44.053774	329	409	17	3	80	0.0375000
NODE_4298_length_1159_cov_44.053774	329	409	18	11	80	0.1375000
NODE_4298_length_1159_cov_44.053774	329	409	19	9	80	0.1125000
NODE_4298_length_1159_cov_44.053774	329	409	20	4	80	0.0500000
NODE_4298_length_1159_cov_44.053774	329	409	21	12	80	0.1500000
NODE_4298_length_1159_cov_44.053774	329	409	22	1	80	0.0125000
NODE_4298_length_1159_cov_44.053774	329	409	23	31	80	0.3875000
NODE_4298_length_1159_cov_44.053774	329	409	26	1	80	0.0125000
NODE_4298_length_1159_cov_44.053774	382	462	21	12	80	0.1500000
NODE_4298_length_1159_cov_44.053774	382	462	23	15	80	0.1875000
NODE_4298_length_1159_cov_44.053774	382	462	24	4	80	0.0500000
NODE_4298_length_1159_cov_44.053774	382	462	26	13	80	0.1625000
NODE_4298_length_1159_cov_44.053774	382	462	27	11	80	0.1375000
NODE_4298_length_1159_cov_44.053774	382	462	28	10	80	0.1250000
NODE_4298_length_1159_cov_44.053774	382	462	29	3	80	0.0375000
NODE_4298_length_1159_cov_44.053774	382	462	30	6	80	0.0750000
NODE_4298_length_1159_cov_44.053774	382	462	31	6	80	0.0750000
NODE_4298_length_1159_cov_44.053774	458	538	18	13	80	0.1625000
NODE_4298_length_1159_cov_44.053774	458	538	19	11	80	0.1375000
NODE_4298_length_1159_cov_44.053774	458	538	21	8	80	0.1000000
NODE_4298_length_1159_cov_44.053774	458	538	22	16	80	0.2000000
NODE_4298_length_1159_cov_44.053774	458	538	23	3	80	0.0375000
NODE_4298_length_1159_cov_44.053774	458	538	24	9	80	0.1125000
NODE_4298_length_1159_cov_44.053774	458	538	25	16	80	0.2000000
NODE_4298_length_1159_cov_44.053774	458	538	26	4	80	0.0500000
NODE_4298_length_1159_cov_44.053774	511	591	7	5	80	0.0625000
NODE_4298_length_1159_cov_44.053774	511	591	9	13	80	0.1625000
NODE_4298_length_1159_cov_44.053774	511	591	13	6	80	0.0750000
NODE_4298_length_1159_cov_44.053774	511	591	14	9	80	0.1125000
NODE_4298_length_1159_cov_44.053774	511	591	17	4	80	0.0500000
NODE_4298_length_1159_cov_44.053774	511	591	18	13	80	0.1625000
NODE_4298_length_1159_cov_44.053774	511	591	19	27	80	0.3375000
NODE_4298_length_1159_cov_44.053774	511	591	21	3	80	0.0375000
NODE_4299_length_1159_cov_40.194340	391	471	9	1	80	0.0125000
NODE_4299_length_1159_cov_40.194340	391	471	10	28	80	0.3500000
NODE_4299_length_1159_cov_40.194340	391	471	11	5	80	0.0625000
NODE_4299_length_1159_cov_40.194340	391	471	12	14	80	0.1750000
NODE_4299_length_1159_cov_40.194340	391	471	13	26	80	0.3250000
NODE_4299_length_1159_cov_40.194340	391	471	14	6	80	0.0750000
NODE_4299_length_1159_cov_40.194340	444	524	10	11	80	0.1375000
NODE_4299_length_1159_cov_40.194340	444	524	11	5	80	0.0625000
NODE_4299_length_1159_cov_40.194340	444	524	12	15	80	0.1875000
NODE_4299_length_1159_cov_40.194340	444	524	13	10	80	0.1250000
NODE_4299_length_1159_cov_40.194340	444	524	14	22	80	0.2750000
NODE_4299_length_1159_cov_40.194340	444	524	15	17	80	0.2125000
NODE_4301_length_1159_cov_25.919811	456	536	7	5	80	0.0625000
NODE_4301_length_1159_cov_25.919811	456	536	9	24	80	0.3000000
NODE_4301_length_1159_cov_25.919811	456	536	11	11	80	0.1375000
NODE_4301_length_1159_cov_25.919811	456	536	12	1	80	0.0125000
NODE_4301_length_1159_cov_25.919811	456	536	13	1	80	0.0125000
NODE_4301_length_1159_cov_25.919811	456	536	14	35	80	0.4375000
NODE_4301_length_1159_cov_25.919811	456	536	15	1	80	0.0125000
NODE_4301_length_1159_cov_25.919811	456	536	16	2	80	0.0250000
NODE_4301_length_1159_cov_25.919811	509	591	11	40	82	0.4878049
NODE_4301_length_1159_cov_25.919811	509	591	14	42	82	0.5121951
NODE_4302_length_1159_cov_18.306604	538	618	4	7	80	0.0875000
NODE_4302_length_1159_cov_18.306604	538	618	5	72	80	0.9000000
NODE_4302_length_1159_cov_18.306604	538	618	6	1	80	0.0125000
NODE_4302_length_1159_cov_18.306604	591	671	1	9	80	0.1125000
NODE_4302_length_1159_cov_18.306604	591	671	2	7	80	0.0875000
NODE_4302_length_1159_cov_18.306604	591	671	3	12	80	0.1500000
NODE_4302_length_1159_cov_18.306604	591	671	4	32	80	0.4000000
NODE_4302_length_1159_cov_18.306604	591	671	5	20	80	0.2500000
NODE_4303_length_1159_cov_14.457547	358	438	2	10	80	0.1250000
NODE_4303_length_1159_cov_14.457547	358	438	3	2	80	0.0250000
NODE_4303_length_1159_cov_14.457547	358	438	4	8	80	0.1000000
NODE_4303_length_1159_cov_14.457547	358	438	8	10	80	0.1250000
NODE_4303_length_1159_cov_14.457547	358	438	9	13	80	0.1625000
NODE_4303_length_1159_cov_14.457547	358	438	10	37	80	0.4625000
NODE_4303_length_1159_cov_14.457547	411	491	9	14	80	0.1750000
NODE_4303_length_1159_cov_14.457547	411	491	10	66	80	0.8250000
NODE_4304_length_1159_cov_11.566981	625	705	4	36	80	0.4500000
NODE_4304_length_1159_cov_11.566981	625	705	5	34	80	0.4250000
NODE_4304_length_1159_cov_11.566981	625	705	6	10	80	0.1250000
NODE_4304_length_1159_cov_11.566981	678	758	1	17	80	0.2125000
NODE_4304_length_1159_cov_11.566981	678	758	2	10	80	0.1250000
NODE_4304_length_1159_cov_11.566981	678	758	4	53	80	0.6625000
NODE_4305_length_1159_cov_9.927358	278	358	5	30	80	0.3750000
NODE_4305_length_1159_cov_9.927358	278	358	6	49	80	0.6125000
NODE_4305_length_1159_cov_9.927358	278	358	7	1	80	0.0125000
NODE_4305_length_1159_cov_9.927358	331	411	2	29	80	0.3625000
NODE_4305_length_1159_cov_9.927358	331	411	3	9	80	0.1125000
NODE_4305_length_1159_cov_9.927358	331	411	4	3	80	0.0375000
NODE_4305_length_1159_cov_9.927358	331	411	5	1	80	0.0125000
NODE_4305_length_1159_cov_9.927358	331	411	6	38	80	0.4750000
NODE_4314_length_1159_cov_1.568868	513	562	0	49	49	1.0000000
NODE_4316_length_1158_cov_33.529745	357	437	7	2	80	0.0250000
NODE_4316_length_1158_cov_33.529745	357	437	8	3	80	0.0375000
NODE_4316_length_1158_cov_33.529745	357	437	9	28	80	0.3500000
NODE_4316_length_1158_cov_33.529745	357	437	10	23	80	0.2875000
NODE_4316_length_1158_cov_33.529745	357	437	11	24	80	0.3000000
NODE_4316_length_1158_cov_33.529745	410	490	8	4	80	0.0500000
NODE_4316_length_1158_cov_33.529745	410	490	9	30	80	0.3750000
NODE_4316_length_1158_cov_33.529745	410	490	10	13	80	0.1625000
NODE_4316_length_1158_cov_33.529745	410	490	11	33	80	0.4125000
NODE_4316_length_1158_cov_33.529745	486	566	7	22	80	0.2750000
NODE_4316_length_1158_cov_33.529745	486	566	8	7	80	0.0875000
NODE_4316_length_1158_cov_33.529745	486	566	9	39	80	0.4875000
NODE_4316_length_1158_cov_33.529745	486	566	10	12	80	0.1500000
NODE_4316_length_1158_cov_33.529745	539	619	7	20	80	0.2500000
NODE_4316_length_1158_cov_33.529745	539	619	8	3	80	0.0375000
NODE_4316_length_1158_cov_33.529745	539	619	9	38	80	0.4750000
NODE_4316_length_1158_cov_33.529745	539	619	10	19	80	0.2375000
NODE_4317_length_1158_cov_31.368272	416	496	4	38	80	0.4750000
NODE_4317_length_1158_cov_31.368272	416	496	5	27	80	0.3375000
NODE_4317_length_1158_cov_31.368272	416	496	6	15	80	0.1875000
NODE_4317_length_1158_cov_31.368272	469	549	5	17	80	0.2125000
NODE_4317_length_1158_cov_31.368272	469	549	6	36	80	0.4500000
NODE_4317_length_1158_cov_31.368272	469	549	7	19	80	0.2375000
NODE_4317_length_1158_cov_31.368272	469	549	8	8	80	0.1000000
NODE_4317_length_1158_cov_31.368272	545	626	5	23	81	0.2839506
NODE_4317_length_1158_cov_31.368272	545	626	7	15	81	0.1851852
NODE_4317_length_1158_cov_31.368272	545	626	8	32	81	0.3950617
NODE_4317_length_1158_cov_31.368272	545	626	9	11	81	0.1358025
NODE_4317_length_1158_cov_31.368272	599	679	7	5	80	0.0625000
NODE_4317_length_1158_cov_31.368272	599	679	8	35	80	0.4375000
NODE_4317_length_1158_cov_31.368272	599	679	9	34	80	0.4250000
NODE_4317_length_1158_cov_31.368272	599	679	10	6	80	0.0750000
NODE_4318_length_1158_cov_31.240793	430	510	4	16	80	0.2000000
NODE_4318_length_1158_cov_31.240793	430	510	7	2	80	0.0250000
NODE_4318_length_1158_cov_31.240793	430	510	8	21	80	0.2625000
NODE_4318_length_1158_cov_31.240793	430	510	11	32	80	0.4000000
NODE_4318_length_1158_cov_31.240793	430	510	13	9	80	0.1125000
NODE_4318_length_1158_cov_31.240793	483	563	10	3	80	0.0375000
NODE_4318_length_1158_cov_31.240793	483	563	11	20	80	0.2500000
NODE_4318_length_1158_cov_31.240793	483	563	12	15	80	0.1875000
NODE_4318_length_1158_cov_31.240793	483	563	13	35	80	0.4375000
NODE_4318_length_1158_cov_31.240793	483	563	14	7	80	0.0875000
NODE_4318_length_1158_cov_31.240793	559	639	13	10	80	0.1250000
NODE_4318_length_1158_cov_31.240793	559	639	14	11	80	0.1375000
NODE_4318_length_1158_cov_31.240793	559	639	15	4	80	0.0500000
NODE_4318_length_1158_cov_31.240793	559	639	16	42	80	0.5250000
NODE_4318_length_1158_cov_31.240793	559	639	17	5	80	0.0625000
NODE_4318_length_1158_cov_31.240793	559	639	18	1	80	0.0125000
NODE_4318_length_1158_cov_31.240793	559	639	19	1	80	0.0125000
NODE_4318_length_1158_cov_31.240793	559	639	20	6	80	0.0750000
NODE_4318_length_1158_cov_31.240793	612	692	15	4	80	0.0500000
NODE_4318_length_1158_cov_31.240793	612	692	16	51	80	0.6375000
NODE_4318_length_1158_cov_31.240793	612	692	17	2	80	0.0250000
NODE_4318_length_1158_cov_31.240793	612	692	18	5	80	0.0625000
NODE_4318_length_1158_cov_31.240793	612	692	20	11	80	0.1375000
NODE_4318_length_1158_cov_31.240793	612	692	21	7	80	0.0875000
NODE_4319_length_1158_cov_29.216242	405	485	3	6	80	0.0750000
NODE_4319_length_1158_cov_29.216242	405	485	6	17	80	0.2125000
NODE_4319_length_1158_cov_29.216242	405	485	7	5	80	0.0625000
NODE_4319_length_1158_cov_29.216242	405	485	8	8	80	0.1000000
NODE_4319_length_1158_cov_29.216242	405	485	9	21	80	0.2625000
NODE_4319_length_1158_cov_29.216242	405	485	10	19	80	0.2375000
NODE_4319_length_1158_cov_29.216242	405	485	12	3	80	0.0375000
NODE_4319_length_1158_cov_29.216242	405	485	14	1	80	0.0125000
NODE_4319_length_1158_cov_29.216242	458	538	9	8	80	0.1000000
NODE_4319_length_1158_cov_29.216242	458	538	10	15	80	0.1875000
NODE_4319_length_1158_cov_29.216242	458	538	12	3	80	0.0375000
NODE_4319_length_1158_cov_29.216242	458	538	14	2	80	0.0250000
NODE_4319_length_1158_cov_29.216242	458	538	15	26	80	0.3250000
NODE_4319_length_1158_cov_29.216242	458	538	17	1	80	0.0125000
NODE_4319_length_1158_cov_29.216242	458	538	18	5	80	0.0625000
NODE_4319_length_1158_cov_29.216242	458	538	19	6	80	0.0750000
NODE_4319_length_1158_cov_29.216242	458	538	20	14	80	0.1750000
NODE_4320_length_1158_cov_25.245515	500	580	5	2	80	0.0250000
NODE_4320_length_1158_cov_25.245515	500	580	6	1	80	0.0125000
NODE_4320_length_1158_cov_25.245515	500	580	8	29	80	0.3625000
NODE_4320_length_1158_cov_25.245515	500	580	9	26	80	0.3250000
NODE_4320_length_1158_cov_25.245515	500	580	11	10	80	0.1250000
NODE_4320_length_1158_cov_25.245515	500	580	12	4	80	0.0500000
NODE_4320_length_1158_cov_25.245515	500	580	13	8	80	0.1000000
NODE_4320_length_1158_cov_25.245515	553	633	9	5	80	0.0625000
NODE_4320_length_1158_cov_25.245515	553	633	11	11	80	0.1375000
NODE_4320_length_1158_cov_25.245515	553	633	12	14	80	0.1750000
NODE_4320_length_1158_cov_25.245515	553	633	13	44	80	0.5500000
NODE_4320_length_1158_cov_25.245515	553	633	15	6	80	0.0750000
NODE_4320_length_1158_cov_25.245515	629	709	9	1	80	0.0125000
NODE_4320_length_1158_cov_25.245515	629	709	12	33	80	0.4125000
NODE_4320_length_1158_cov_25.245515	629	709	13	34	80	0.4250000
NODE_4320_length_1158_cov_25.245515	629	709	14	5	80	0.0625000
NODE_4320_length_1158_cov_25.245515	629	709	15	1	80	0.0125000
NODE_4320_length_1158_cov_25.245515	629	709	16	6	80	0.0750000
NODE_4320_length_1158_cov_25.245515	682	762	7	7	80	0.0875000
NODE_4320_length_1158_cov_25.245515	682	762	8	8	80	0.1000000
NODE_4320_length_1158_cov_25.245515	682	762	9	39	80	0.4875000
NODE_4320_length_1158_cov_25.245515	682	762	12	26	80	0.3250000
NODE_4321_length_1158_cov_16.566572	396	476	9	9	80	0.1125000
NODE_4321_length_1158_cov_16.566572	396	476	10	23	80	0.2875000
NODE_4321_length_1158_cov_16.566572	396	476	11	13	80	0.1625000
NODE_4321_length_1158_cov_16.566572	396	476	13	10	80	0.1250000
NODE_4321_length_1158_cov_16.566572	396	476	15	2	80	0.0250000
NODE_4321_length_1158_cov_16.566572	396	476	18	23	80	0.2875000
NODE_4321_length_1158_cov_16.566572	449	529	13	2	80	0.0250000
NODE_4321_length_1158_cov_16.566572	449	529	14	1	80	0.0125000
NODE_4321_length_1158_cov_16.566572	449	529	15	12	80	0.1500000
NODE_4321_length_1158_cov_16.566572	449	529	16	7	80	0.0875000
NODE_4321_length_1158_cov_16.566572	449	529	17	10	80	0.1250000
NODE_4321_length_1158_cov_16.566572	449	529	18	32	80	0.4000000
NODE_4321_length_1158_cov_16.566572	449	529	19	16	80	0.2000000
NODE_4322_length_1158_cov_13.092540	372	452	0	80	80	1.0000000
NODE_4322_length_1158_cov_13.092540	425	505	0	80	80	1.0000000
NODE_4322_length_1158_cov_13.092540	735	815	0	80	80	1.0000000
NODE_4322_length_1158_cov_13.092540	788	868	0	80	80	1.0000000
NODE_4323_length_1158_cov_7.408876	656	736	4	49	80	0.6125000
NODE_4323_length_1158_cov_7.408876	656	736	5	2	80	0.0250000
NODE_4323_length_1158_cov_7.408876	656	736	6	7	80	0.0875000
NODE_4323_length_1158_cov_7.408876	656	736	7	4	80	0.0500000
NODE_4323_length_1158_cov_7.408876	656	736	8	18	80	0.2250000
NODE_4323_length_1158_cov_7.408876	709	789	6	5	80	0.0625000
NODE_4323_length_1158_cov_7.408876	709	789	7	22	80	0.2750000
NODE_4323_length_1158_cov_7.408876	709	789	8	37	80	0.4625000
NODE_4323_length_1158_cov_7.408876	709	789	9	15	80	0.1875000
NODE_4323_length_1158_cov_7.408876	709	789	10	1	80	0.0125000
NODE_4324_length_1158_cov_6.242682	239	310	0	71	71	1.0000000
NODE_4325_length_1158_cov_6.043437	531	611	2	12	80	0.1500000
NODE_4325_length_1158_cov_6.043437	531	611	4	5	80	0.0625000
NODE_4325_length_1158_cov_6.043437	531	611	5	57	80	0.7125000
NODE_4325_length_1158_cov_6.043437	531	611	6	6	80	0.0750000
NODE_4325_length_1158_cov_6.043437	584	634	4	14	50	0.2800000
NODE_4325_length_1158_cov_6.043437	584	634	5	36	50	0.7200000
NODE_4326_length_1158_cov_5.855524	324	404	0	80	80	1.0000000
NODE_4326_length_1158_cov_5.855524	377	457	0	80	80	1.0000000
NODE_4329_length_1157_cov_32.233459	472	552	6	18	80	0.2250000
NODE_4329_length_1157_cov_32.233459	472	552	8	62	80	0.7750000
NODE_4329_length_1157_cov_32.233459	525	605	4	4	80	0.0500000
NODE_4329_length_1157_cov_32.233459	525	605	5	10	80	0.1250000
NODE_4329_length_1157_cov_32.233459	525	605	6	19	80	0.2375000
NODE_4329_length_1157_cov_32.233459	525	605	7	27	80	0.3375000
NODE_4329_length_1157_cov_32.233459	525	605	8	20	80	0.2500000
NODE_4329_length_1157_cov_32.233459	601	681	2	48	80	0.6000000
NODE_4329_length_1157_cov_32.233459	601	681	3	1	80	0.0125000
NODE_4329_length_1157_cov_32.233459	601	681	4	31	80	0.3875000
NODE_4329_length_1157_cov_32.233459	654	734	0	16	80	0.2000000
NODE_4329_length_1157_cov_32.233459	654	734	2	64	80	0.8000000
NODE_4330_length_1157_cov_6.438563	765	788	1	2	23	0.0869565
NODE_4330_length_1157_cov_6.438563	765	788	2	3	23	0.1304348
NODE_4330_length_1157_cov_6.438563	765	788	3	18	23	0.7826087
NODE_4332_length_1157_cov_4.068053	221	292	0	71	71	1.0000000
NODE_4333_length_1156_cov_46.381268	328	408	8	6	80	0.0750000
NODE_4333_length_1156_cov_46.381268	328	408	9	16	80	0.2000000
NODE_4333_length_1156_cov_46.381268	328	408	10	14	80	0.1750000
NODE_4333_length_1156_cov_46.381268	328	408	11	16	80	0.2000000
NODE_4333_length_1156_cov_46.381268	328	408	12	16	80	0.2000000
NODE_4333_length_1156_cov_46.381268	328	408	13	3	80	0.0375000
NODE_4333_length_1156_cov_46.381268	328	408	14	9	80	0.1125000
NODE_4333_length_1156_cov_46.381268	381	461	11	33	80	0.4125000
NODE_4333_length_1156_cov_46.381268	381	461	12	35	80	0.4375000
NODE_4333_length_1156_cov_46.381268	381	461	13	3	80	0.0375000
NODE_4333_length_1156_cov_46.381268	381	461	14	9	80	0.1125000
NODE_4333_length_1156_cov_46.381268	457	537	4	4	80	0.0500000
NODE_4333_length_1156_cov_46.381268	457	537	6	3	80	0.0375000
NODE_4333_length_1156_cov_46.381268	457	537	7	13	80	0.1625000
NODE_4333_length_1156_cov_46.381268	457	537	8	37	80	0.4625000
NODE_4333_length_1156_cov_46.381268	457	537	9	14	80	0.1750000
NODE_4333_length_1156_cov_46.381268	457	537	11	1	80	0.0125000
NODE_4333_length_1156_cov_46.381268	457	537	12	8	80	0.1000000
NODE_4333_length_1156_cov_46.381268	510	590	4	12	80	0.1500000
NODE_4333_length_1156_cov_46.381268	510	590	6	4	80	0.0500000
NODE_4333_length_1156_cov_46.381268	510	590	7	51	80	0.6375000
NODE_4333_length_1156_cov_46.381268	510	590	8	13	80	0.1625000
NODE_4334_length_1156_cov_32.198675	378	458	2	6	80	0.0750000
NODE_4334_length_1156_cov_32.198675	378	458	3	21	80	0.2625000
NODE_4334_length_1156_cov_32.198675	378	458	4	19	80	0.2375000
NODE_4334_length_1156_cov_32.198675	378	458	5	3	80	0.0375000
NODE_4334_length_1156_cov_32.198675	378	458	6	23	80	0.2875000
NODE_4334_length_1156_cov_32.198675	378	458	7	8	80	0.1000000
NODE_4334_length_1156_cov_32.198675	431	511	6	23	80	0.2875000
NODE_4334_length_1156_cov_32.198675	431	511	7	41	80	0.5125000
NODE_4334_length_1156_cov_32.198675	431	511	8	16	80	0.2000000
NODE_4334_length_1156_cov_32.198675	507	587	7	4	80	0.0500000
NODE_4334_length_1156_cov_32.198675	507	587	9	16	80	0.2000000
NODE_4334_length_1156_cov_32.198675	507	587	10	2	80	0.0250000
NODE_4334_length_1156_cov_32.198675	507	587	11	3	80	0.0375000
NODE_4334_length_1156_cov_32.198675	507	587	12	14	80	0.1750000
NODE_4334_length_1156_cov_32.198675	507	587	13	27	80	0.3375000
NODE_4334_length_1156_cov_32.198675	507	587	14	14	80	0.1750000
NODE_4334_length_1156_cov_32.198675	560	641	7	21	81	0.2592593
NODE_4334_length_1156_cov_32.198675	560	641	8	16	81	0.1975309
NODE_4334_length_1156_cov_32.198675	560	641	9	30	81	0.3703704
NODE_4334_length_1156_cov_32.198675	560	641	11	2	81	0.0246914
NODE_4334_length_1156_cov_32.198675	560	641	13	12	81	0.1481481
NODE_4335_length_1156_cov_12.683065	593	673	2	43	80	0.5375000
NODE_4335_length_1156_cov_12.683065	593	673	3	37	80	0.4625000
NODE_4335_length_1156_cov_12.683065	646	726	1	28	80	0.3500000
NODE_4335_length_1156_cov_12.683065	646	726	3	52	80	0.6500000
NODE_4336_length_1156_cov_9.287606	680	760	3	27	80	0.3375000
NODE_4336_length_1156_cov_9.287606	680	760	4	42	80	0.5250000
NODE_4336_length_1156_cov_9.287606	680	760	5	11	80	0.1375000
NODE_4336_length_1156_cov_9.287606	733	813	1	20	80	0.2500000
NODE_4336_length_1156_cov_9.287606	733	813	4	60	80	0.7500000
NODE_4339_length_1155_cov_19.570076	437	517	14	15	80	0.1875000
NODE_4339_length_1155_cov_19.570076	437	517	15	6	80	0.0750000
NODE_4339_length_1155_cov_19.570076	437	517	17	27	80	0.3375000
NODE_4339_length_1155_cov_19.570076	437	517	18	6	80	0.0750000
NODE_4339_length_1155_cov_19.570076	437	517	19	21	80	0.2625000
NODE_4339_length_1155_cov_19.570076	437	517	20	1	80	0.0125000
NODE_4339_length_1155_cov_19.570076	437	517	21	4	80	0.0500000
NODE_4339_length_1155_cov_19.570076	490	570	11	3	80	0.0375000
NODE_4339_length_1155_cov_19.570076	490	570	14	24	80	0.3000000
NODE_4339_length_1155_cov_19.570076	490	570	15	20	80	0.2500000
NODE_4339_length_1155_cov_19.570076	490	570	16	20	80	0.2500000
NODE_4339_length_1155_cov_19.570076	490	570	17	13	80	0.1625000
NODE_4340_length_1155_cov_18.666667	332	412	11	2	80	0.0250000
NODE_4340_length_1155_cov_18.666667	332	412	12	58	80	0.7250000
NODE_4340_length_1155_cov_18.666667	332	412	13	20	80	0.2500000
NODE_4340_length_1155_cov_18.666667	385	465	11	10	80	0.1250000
NODE_4340_length_1155_cov_18.666667	385	465	12	38	80	0.4750000
NODE_4340_length_1155_cov_18.666667	385	465	13	18	80	0.2250000
NODE_4340_length_1155_cov_18.666667	385	465	14	14	80	0.1750000
NODE_4346_length_1154_cov_61.769668	488	568	14	1	80	0.0125000
NODE_4346_length_1154_cov_61.769668	488	568	15	3	80	0.0375000
NODE_4346_length_1154_cov_61.769668	488	568	16	2	80	0.0250000
NODE_4346_length_1154_cov_61.769668	488	568	17	5	80	0.0625000
NODE_4346_length_1154_cov_61.769668	488	568	19	18	80	0.2250000
NODE_4346_length_1154_cov_61.769668	488	568	30	9	80	0.1125000
NODE_4346_length_1154_cov_61.769668	488	568	34	1	80	0.0125000
NODE_4346_length_1154_cov_61.769668	488	568	36	21	80	0.2625000
NODE_4346_length_1154_cov_61.769668	488	568	37	20	80	0.2500000
NODE_4346_length_1154_cov_61.769668	541	621	15	2	80	0.0250000
NODE_4346_length_1154_cov_61.769668	541	621	16	2	80	0.0250000
NODE_4346_length_1154_cov_61.769668	541	621	17	11	80	0.1375000
NODE_4346_length_1154_cov_61.769668	541	621	18	4	80	0.0500000
NODE_4346_length_1154_cov_61.769668	541	621	19	31	80	0.3875000
NODE_4346_length_1154_cov_61.769668	541	621	20	28	80	0.3500000
NODE_4346_length_1154_cov_61.769668	541	621	21	2	80	0.0250000
NODE_4347_length_1154_cov_50.909005	409	489	17	15	80	0.1875000
NODE_4347_length_1154_cov_50.909005	409	489	18	24	80	0.3000000
NODE_4347_length_1154_cov_50.909005	409	489	19	3	80	0.0375000
NODE_4347_length_1154_cov_50.909005	409	489	21	6	80	0.0750000
NODE_4347_length_1154_cov_50.909005	409	489	22	27	80	0.3375000
NODE_4347_length_1154_cov_50.909005	409	489	23	5	80	0.0625000
NODE_4347_length_1154_cov_50.909005	462	542	16	5	80	0.0625000
NODE_4347_length_1154_cov_50.909005	462	542	17	6	80	0.0750000
NODE_4347_length_1154_cov_50.909005	462	542	19	1	80	0.0125000
NODE_4347_length_1154_cov_50.909005	462	542	20	9	80	0.1125000
NODE_4347_length_1154_cov_50.909005	462	542	21	6	80	0.0750000
NODE_4347_length_1154_cov_50.909005	462	542	22	36	80	0.4500000
NODE_4347_length_1154_cov_50.909005	462	542	23	5	80	0.0625000
NODE_4347_length_1154_cov_50.909005	462	542	24	2	80	0.0250000
NODE_4347_length_1154_cov_50.909005	462	542	25	1	80	0.0125000
NODE_4347_length_1154_cov_50.909005	462	542	26	7	80	0.0875000
NODE_4347_length_1154_cov_50.909005	462	542	28	2	80	0.0250000
NODE_4347_length_1154_cov_50.909005	538	618	15	6	80	0.0750000
NODE_4347_length_1154_cov_50.909005	538	618	16	36	80	0.4500000
NODE_4347_length_1154_cov_50.909005	538	618	17	11	80	0.1375000
NODE_4347_length_1154_cov_50.909005	538	618	18	19	80	0.2375000
NODE_4347_length_1154_cov_50.909005	538	618	20	8	80	0.1000000
NODE_4347_length_1154_cov_50.909005	591	671	8	31	80	0.3875000
NODE_4347_length_1154_cov_50.909005	591	671	11	6	80	0.0750000
NODE_4347_length_1154_cov_50.909005	591	671	12	3	80	0.0375000
NODE_4347_length_1154_cov_50.909005	591	671	14	13	80	0.1625000
NODE_4347_length_1154_cov_50.909005	591	671	15	6	80	0.0750000
NODE_4347_length_1154_cov_50.909005	591	671	16	15	80	0.1875000
NODE_4347_length_1154_cov_50.909005	591	671	20	6	80	0.0750000
NODE_4348_length_1154_cov_28.941232	695	775	12	1	80	0.0125000
NODE_4348_length_1154_cov_28.941232	695	775	13	1	80	0.0125000
NODE_4348_length_1154_cov_28.941232	695	775	14	24	80	0.3000000
NODE_4348_length_1154_cov_28.941232	695	775	16	2	80	0.0250000
NODE_4348_length_1154_cov_28.941232	695	775	17	5	80	0.0625000
NODE_4348_length_1154_cov_28.941232	695	775	19	6	80	0.0750000
NODE_4348_length_1154_cov_28.941232	695	775	20	10	80	0.1250000
NODE_4348_length_1154_cov_28.941232	695	775	21	4	80	0.0500000
NODE_4348_length_1154_cov_28.941232	695	775	23	2	80	0.0250000
NODE_4348_length_1154_cov_28.941232	695	775	24	14	80	0.1750000
NODE_4348_length_1154_cov_28.941232	695	775	25	6	80	0.0750000
NODE_4348_length_1154_cov_28.941232	695	775	26	1	80	0.0125000
NODE_4348_length_1154_cov_28.941232	695	775	27	1	80	0.0125000
NODE_4348_length_1154_cov_28.941232	695	775	28	3	80	0.0375000
NODE_4348_length_1154_cov_28.941232	748	828	19	21	80	0.2625000
NODE_4348_length_1154_cov_28.941232	748	828	20	1	80	0.0125000
NODE_4348_length_1154_cov_28.941232	748	828	21	15	80	0.1875000
NODE_4348_length_1154_cov_28.941232	748	828	22	5	80	0.0625000
NODE_4348_length_1154_cov_28.941232	748	828	23	9	80	0.1125000
NODE_4348_length_1154_cov_28.941232	748	828	24	14	80	0.1750000
NODE_4348_length_1154_cov_28.941232	748	828	25	6	80	0.0750000
NODE_4348_length_1154_cov_28.941232	748	828	26	5	80	0.0625000
NODE_4348_length_1154_cov_28.941232	748	828	27	1	80	0.0125000
NODE_4348_length_1154_cov_28.941232	748	828	28	3	80	0.0375000
NODE_4349_length_1154_cov_13.765877	322	402	5	19	80	0.2375000
NODE_4349_length_1154_cov_13.765877	322	402	7	2	80	0.0250000
NODE_4349_length_1154_cov_13.765877	322	402	8	9	80	0.1125000
NODE_4349_length_1154_cov_13.765877	322	402	9	13	80	0.1625000
NODE_4349_length_1154_cov_13.765877	322	402	11	37	80	0.4625000
NODE_4349_length_1154_cov_13.765877	375	455	8	18	80	0.2250000
NODE_4349_length_1154_cov_13.765877	375	455	9	24	80	0.3000000
NODE_4349_length_1154_cov_13.765877	375	455	11	38	80	0.4750000
NODE_4351_length_1154_cov_5.930806	497	577	1	9	80	0.1125000
NODE_4351_length_1154_cov_5.930806	497	577	3	52	80	0.6500000
NODE_4351_length_1154_cov_5.930806	497	577	4	1	80	0.0125000
NODE_4351_length_1154_cov_5.930806	497	577	5	8	80	0.1000000
NODE_4351_length_1154_cov_5.930806	497	577	6	10	80	0.1250000
NODE_4351_length_1154_cov_5.930806	550	622	0	32	72	0.4444444
NODE_4351_length_1154_cov_5.930806	550	622	1	22	72	0.3055556
NODE_4351_length_1154_cov_5.930806	550	622	3	18	72	0.2500000
NODE_4357_length_1153_cov_65.486717	416	496	8	26	80	0.3250000
NODE_4357_length_1153_cov_65.486717	416	496	11	12	80	0.1500000
NODE_4357_length_1153_cov_65.486717	416	496	12	23	80	0.2875000
NODE_4357_length_1153_cov_65.486717	416	496	13	19	80	0.2375000
NODE_4357_length_1153_cov_65.486717	469	549	11	8	80	0.1000000
NODE_4357_length_1153_cov_65.486717	469	549	13	32	80	0.4000000
NODE_4357_length_1153_cov_65.486717	469	549	14	11	80	0.1375000
NODE_4357_length_1153_cov_65.486717	469	549	15	1	80	0.0125000
NODE_4357_length_1153_cov_65.486717	469	549	16	11	80	0.1375000
NODE_4357_length_1153_cov_65.486717	469	549	17	17	80	0.2125000
NODE_4357_length_1153_cov_65.486717	545	625	10	33	80	0.4125000
NODE_4357_length_1153_cov_65.486717	545	625	13	23	80	0.2875000
NODE_4357_length_1153_cov_65.486717	545	625	14	10	80	0.1250000
NODE_4357_length_1153_cov_65.486717	545	625	15	14	80	0.1750000
NODE_4357_length_1153_cov_65.486717	598	678	6	21	80	0.2625000
NODE_4357_length_1153_cov_65.486717	598	678	9	21	80	0.2625000
NODE_4357_length_1153_cov_65.486717	598	678	10	38	80	0.4750000
NODE_4358_length_1153_cov_50.733397	404	484	11	20	80	0.2500000
NODE_4358_length_1153_cov_50.733397	404	484	12	22	80	0.2750000
NODE_4358_length_1153_cov_50.733397	404	484	13	28	80	0.3500000
NODE_4358_length_1153_cov_50.733397	404	484	15	6	80	0.0750000
NODE_4358_length_1153_cov_50.733397	404	484	17	2	80	0.0250000
NODE_4358_length_1153_cov_50.733397	404	484	19	2	80	0.0250000
NODE_4358_length_1153_cov_50.733397	457	537	12	4	80	0.0500000
NODE_4358_length_1153_cov_50.733397	457	537	13	13	80	0.1625000
NODE_4358_length_1153_cov_50.733397	457	537	15	6	80	0.0750000
NODE_4358_length_1153_cov_50.733397	457	537	17	20	80	0.2500000
NODE_4358_length_1153_cov_50.733397	457	537	18	14	80	0.1750000
NODE_4358_length_1153_cov_50.733397	457	537	19	21	80	0.2625000
NODE_4358_length_1153_cov_50.733397	457	537	21	2	80	0.0250000
NODE_4358_length_1153_cov_50.733397	533	613	18	2	80	0.0250000
NODE_4358_length_1153_cov_50.733397	533	613	19	2	80	0.0250000
NODE_4358_length_1153_cov_50.733397	533	613	21	9	80	0.1125000
NODE_4358_length_1153_cov_50.733397	533	613	23	2	80	0.0250000
NODE_4358_length_1153_cov_50.733397	533	613	24	13	80	0.1625000
NODE_4358_length_1153_cov_50.733397	533	613	25	1	80	0.0125000
NODE_4358_length_1153_cov_50.733397	533	613	26	1	80	0.0125000
NODE_4358_length_1153_cov_50.733397	533	613	27	4	80	0.0500000
NODE_4358_length_1153_cov_50.733397	533	613	28	7	80	0.0875000
NODE_4358_length_1153_cov_50.733397	533	613	29	9	80	0.1125000
NODE_4358_length_1153_cov_50.733397	533	613	30	13	80	0.1625000
NODE_4358_length_1153_cov_50.733397	533	613	32	17	80	0.2125000
NODE_4358_length_1153_cov_50.733397	586	666	23	14	80	0.1750000
NODE_4358_length_1153_cov_50.733397	586	666	24	4	80	0.0500000
NODE_4358_length_1153_cov_50.733397	586	666	25	10	80	0.1250000
NODE_4358_length_1153_cov_50.733397	586	666	26	14	80	0.1750000
NODE_4358_length_1153_cov_50.733397	586	666	28	4	80	0.0500000
NODE_4358_length_1153_cov_50.733397	586	666	29	3	80	0.0375000
NODE_4358_length_1153_cov_50.733397	586	666	30	14	80	0.1750000
NODE_4358_length_1153_cov_50.733397	586	666	32	17	80	0.2125000
NODE_4359_length_1153_cov_26.131879	493	573	15	11	80	0.1375000
NODE_4359_length_1153_cov_26.131879	493	573	16	23	80	0.2875000
NODE_4359_length_1153_cov_26.131879	493	573	17	19	80	0.2375000
NODE_4359_length_1153_cov_26.131879	493	573	18	11	80	0.1375000
NODE_4359_length_1153_cov_26.131879	493	573	19	16	80	0.2000000
NODE_4359_length_1153_cov_26.131879	546	626	7	8	80	0.1000000
NODE_4359_length_1153_cov_26.131879	546	626	8	20	80	0.2500000
NODE_4359_length_1153_cov_26.131879	546	626	10	7	80	0.0875000
NODE_4359_length_1153_cov_26.131879	546	626	13	9	80	0.1125000
NODE_4359_length_1153_cov_26.131879	546	626	14	2	80	0.0250000
NODE_4359_length_1153_cov_26.131879	546	626	16	12	80	0.1500000
NODE_4359_length_1153_cov_26.131879	546	626	17	3	80	0.0375000
NODE_4359_length_1153_cov_26.131879	546	626	18	3	80	0.0375000
NODE_4359_length_1153_cov_26.131879	546	626	19	16	80	0.2000000
NODE_4360_length_1153_cov_10.195446	500	580	1	19	80	0.2375000
NODE_4360_length_1153_cov_10.195446	500	580	2	61	80	0.7625000
NODE_4360_length_1153_cov_10.195446	553	633	2	80	80	1.0000000
NODE_4361_length_1153_cov_8.286528	558	638	0	80	80	1.0000000
NODE_4361_length_1153_cov_8.286528	611	691	0	80	80	1.0000000
NODE_4368_length_1152_cov_19.800570	553	633	2	6	80	0.0750000
NODE_4368_length_1152_cov_19.800570	553	633	3	37	80	0.4625000
NODE_4368_length_1152_cov_19.800570	553	633	5	8	80	0.1000000
NODE_4368_length_1152_cov_19.800570	553	633	6	1	80	0.0125000
NODE_4368_length_1152_cov_19.800570	553	633	7	6	80	0.0750000
NODE_4368_length_1152_cov_19.800570	553	633	8	4	80	0.0500000
NODE_4368_length_1152_cov_19.800570	553	633	10	1	80	0.0125000
NODE_4368_length_1152_cov_19.800570	553	633	11	17	80	0.2125000
NODE_4368_length_1152_cov_19.800570	606	686	7	5	80	0.0625000
NODE_4368_length_1152_cov_19.800570	606	686	8	4	80	0.0500000
NODE_4368_length_1152_cov_19.800570	606	686	10	1	80	0.0125000
NODE_4368_length_1152_cov_19.800570	606	686	11	41	80	0.5125000
NODE_4368_length_1152_cov_19.800570	606	686	12	21	80	0.2625000
NODE_4368_length_1152_cov_19.800570	606	686	14	8	80	0.1000000
NODE_4369_length_1152_cov_19.365622	490	570	9	9	80	0.1125000
NODE_4369_length_1152_cov_19.365622	490	570	10	42	80	0.5250000
NODE_4369_length_1152_cov_19.365622	490	570	11	9	80	0.1125000
NODE_4369_length_1152_cov_19.365622	490	570	12	1	80	0.0125000
NODE_4369_length_1152_cov_19.365622	490	570	13	19	80	0.2375000
NODE_4369_length_1152_cov_19.365622	543	623	9	9	80	0.1125000
NODE_4369_length_1152_cov_19.365622	543	623	10	9	80	0.1125000
NODE_4369_length_1152_cov_19.365622	543	623	11	19	80	0.2375000
NODE_4369_length_1152_cov_19.365622	543	623	12	13	80	0.1625000
NODE_4369_length_1152_cov_19.365622	543	623	13	2	80	0.0250000
NODE_4369_length_1152_cov_19.365622	543	623	14	13	80	0.1625000
NODE_4369_length_1152_cov_19.365622	543	623	15	15	80	0.1875000
NODE_4370_length_1152_cov_18.654321	594	674	0	80	80	1.0000000
NODE_4370_length_1152_cov_18.654321	647	727	0	80	80	1.0000000
NODE_4371_length_1152_cov_18.075024	377	457	1	10	80	0.1250000
NODE_4371_length_1152_cov_18.075024	377	457	2	43	80	0.5375000
NODE_4371_length_1152_cov_18.075024	377	457	3	27	80	0.3375000
NODE_4371_length_1152_cov_18.075024	430	510	2	5	80	0.0625000
NODE_4371_length_1152_cov_18.075024	430	510	3	75	80	0.9375000
NODE_4371_length_1152_cov_18.075024	506	586	1	6	80	0.0750000
NODE_4371_length_1152_cov_18.075024	506	586	2	43	80	0.5375000
NODE_4371_length_1152_cov_18.075024	506	586	3	31	80	0.3875000
NODE_4371_length_1152_cov_18.075024	559	639	0	8	80	0.1000000
NODE_4371_length_1152_cov_18.075024	559	639	1	51	80	0.6375000
NODE_4371_length_1152_cov_18.075024	559	639	2	21	80	0.2625000
NODE_4373_length_1152_cov_16.047483	543	623	7	18	80	0.2250000
NODE_4373_length_1152_cov_16.047483	543	623	9	23	80	0.2875000
NODE_4373_length_1152_cov_16.047483	543	623	10	39	80	0.4875000
NODE_4373_length_1152_cov_16.047483	596	676	7	15	80	0.1875000
NODE_4373_length_1152_cov_16.047483	596	676	9	27	80	0.3375000
NODE_4373_length_1152_cov_16.047483	596	676	10	20	80	0.2500000
NODE_4373_length_1152_cov_16.047483	596	676	11	18	80	0.2250000
NODE_4373_length_1152_cov_16.047483	672	752	6	2	80	0.0250000
NODE_4373_length_1152_cov_16.047483	672	752	7	13	80	0.1625000
NODE_4373_length_1152_cov_16.047483	672	752	8	62	80	0.7750000
NODE_4373_length_1152_cov_16.047483	672	752	9	3	80	0.0375000
NODE_4373_length_1152_cov_16.047483	725	805	3	22	80	0.2750000
NODE_4373_length_1152_cov_16.047483	725	805	4	6	80	0.0750000
NODE_4373_length_1152_cov_16.047483	725	805	5	12	80	0.1500000
NODE_4373_length_1152_cov_16.047483	725	805	6	15	80	0.1875000
NODE_4373_length_1152_cov_16.047483	725	805	8	25	80	0.3125000
NODE_4374_length_1152_cov_13.981007	583	663	3	42	80	0.5250000
NODE_4374_length_1152_cov_13.981007	583	663	5	35	80	0.4375000
NODE_4374_length_1152_cov_13.981007	583	663	6	3	80	0.0375000
NODE_4374_length_1152_cov_13.981007	636	716	4	30	80	0.3750000
NODE_4374_length_1152_cov_13.981007	636	716	5	50	80	0.6250000
NODE_4380_length_1151_cov_30.469582	479	559	21	2	80	0.0250000
NODE_4380_length_1151_cov_30.469582	479	559	24	1	80	0.0125000
NODE_4380_length_1151_cov_30.469582	479	559	25	3	80	0.0375000
NODE_4380_length_1151_cov_30.469582	479	559	28	22	80	0.2750000
NODE_4380_length_1151_cov_30.469582	479	559	29	7	80	0.0875000
NODE_4380_length_1151_cov_30.469582	479	559	31	2	80	0.0250000
NODE_4380_length_1151_cov_30.469582	479	559	32	1	80	0.0125000
NODE_4380_length_1151_cov_30.469582	479	559	34	10	80	0.1250000
NODE_4380_length_1151_cov_30.469582	479	559	36	3	80	0.0375000
NODE_4380_length_1151_cov_30.469582	479	559	39	2	80	0.0250000
NODE_4380_length_1151_cov_30.469582	479	559	40	7	80	0.0875000
NODE_4380_length_1151_cov_30.469582	479	559	41	4	80	0.0500000
NODE_4380_length_1151_cov_30.469582	479	559	43	1	80	0.0125000
NODE_4380_length_1151_cov_30.469582	479	559	44	1	80	0.0125000
NODE_4380_length_1151_cov_30.469582	479	559	46	2	80	0.0250000
NODE_4380_length_1151_cov_30.469582	479	559	48	6	80	0.0750000
NODE_4380_length_1151_cov_30.469582	479	559	49	4	80	0.0500000
NODE_4380_length_1151_cov_30.469582	479	559	50	2	80	0.0250000
NODE_4380_length_1151_cov_30.469582	532	612	40	12	80	0.1500000
NODE_4380_length_1151_cov_30.469582	532	612	41	4	80	0.0500000
NODE_4380_length_1151_cov_30.469582	532	612	43	1	80	0.0125000
NODE_4380_length_1151_cov_30.469582	532	612	44	13	80	0.1625000
NODE_4380_length_1151_cov_30.469582	532	612	46	3	80	0.0375000
NODE_4380_length_1151_cov_30.469582	532	612	47	1	80	0.0125000
NODE_4380_length_1151_cov_30.469582	532	612	48	36	80	0.4500000
NODE_4380_length_1151_cov_30.469582	532	612	49	8	80	0.1000000
NODE_4380_length_1151_cov_30.469582	532	612	50	2	80	0.0250000
NODE_4381_length_1151_cov_26.650190	567	647	5	21	80	0.2625000
NODE_4381_length_1151_cov_26.650190	567	647	6	10	80	0.1250000
NODE_4381_length_1151_cov_26.650190	567	647	7	2	80	0.0250000
NODE_4381_length_1151_cov_26.650190	567	647	8	4	80	0.0500000
NODE_4381_length_1151_cov_26.650190	567	647	9	1	80	0.0125000
NODE_4381_length_1151_cov_26.650190	567	647	10	6	80	0.0750000
NODE_4381_length_1151_cov_26.650190	567	647	11	15	80	0.1875000
NODE_4381_length_1151_cov_26.650190	567	647	12	7	80	0.0875000
NODE_4381_length_1151_cov_26.650190	567	647	15	14	80	0.1750000
NODE_4381_length_1151_cov_26.650190	620	700	11	6	80	0.0750000
NODE_4381_length_1151_cov_26.650190	620	700	12	28	80	0.3500000
NODE_4381_length_1151_cov_26.650190	620	700	13	1	80	0.0125000
NODE_4381_length_1151_cov_26.650190	620	700	14	23	80	0.2875000
NODE_4381_length_1151_cov_26.650190	620	700	15	22	80	0.2750000
NODE_4382_length_1151_cov_26.375475	441	521	5	23	80	0.2875000
NODE_4382_length_1151_cov_26.375475	441	521	6	6	80	0.0750000
NODE_4382_length_1151_cov_26.375475	441	521	7	51	80	0.6375000
NODE_4382_length_1151_cov_26.375475	494	574	6	30	80	0.3750000
NODE_4382_length_1151_cov_26.375475	494	574	7	47	80	0.5875000
NODE_4382_length_1151_cov_26.375475	494	574	8	3	80	0.0375000
NODE_4382_length_1151_cov_26.375475	570	650	6	31	80	0.3875000
NODE_4382_length_1151_cov_26.375475	570	650	7	14	80	0.1750000
NODE_4382_length_1151_cov_26.375475	570	650	8	35	80	0.4375000
NODE_4382_length_1151_cov_26.375475	623	703	3	5	80	0.0625000
NODE_4382_length_1151_cov_26.375475	623	703	4	28	80	0.3500000
NODE_4382_length_1151_cov_26.375475	623	703	5	4	80	0.0500000
NODE_4382_length_1151_cov_26.375475	623	703	6	43	80	0.5375000
NODE_4383_length_1151_cov_23.614068	590	670	2	18	80	0.2250000
NODE_4383_length_1151_cov_23.614068	590	670	3	62	80	0.7750000
NODE_4383_length_1151_cov_23.614068	643	721	3	78	78	1.0000000
NODE_4384_length_1151_cov_18.693916	355	435	17	39	80	0.4875000
NODE_4384_length_1151_cov_18.693916	355	435	19	15	80	0.1875000
NODE_4384_length_1151_cov_18.693916	355	435	20	7	80	0.0875000
NODE_4384_length_1151_cov_18.693916	355	435	21	19	80	0.2375000
NODE_4384_length_1151_cov_18.693916	408	491	10	15	83	0.1807229
NODE_4384_length_1151_cov_18.693916	408	491	11	15	83	0.1807229
NODE_4384_length_1151_cov_18.693916	408	491	12	7	83	0.0843373
NODE_4384_length_1151_cov_18.693916	408	491	14	5	83	0.0602410
NODE_4384_length_1151_cov_18.693916	408	491	15	3	83	0.0361446
NODE_4384_length_1151_cov_18.693916	408	491	19	15	83	0.1807229
NODE_4384_length_1151_cov_18.693916	408	491	20	7	83	0.0843373
NODE_4384_length_1151_cov_18.693916	408	491	21	16	83	0.1927711
NODE_4385_length_1151_cov_16.093156	474	554	5	9	80	0.1125000
NODE_4385_length_1151_cov_16.093156	474	554	6	9	80	0.1125000
NODE_4385_length_1151_cov_16.093156	474	554	8	11	80	0.1375000
NODE_4385_length_1151_cov_16.093156	474	554	9	27	80	0.3375000
NODE_4385_length_1151_cov_16.093156	474	554	10	16	80	0.2000000
NODE_4385_length_1151_cov_16.093156	474	554	11	8	80	0.1000000
NODE_4385_length_1151_cov_16.093156	527	607	9	3	80	0.0375000
NODE_4385_length_1151_cov_16.093156	527	607	10	22	80	0.2750000
NODE_4385_length_1151_cov_16.093156	527	607	11	17	80	0.2125000
NODE_4385_length_1151_cov_16.093156	527	607	12	20	80	0.2500000
NODE_4385_length_1151_cov_16.093156	527	607	13	18	80	0.2250000
NODE_4386_length_1151_cov_13.782319	400	482	4	19	82	0.2317073
NODE_4386_length_1151_cov_13.782319	400	482	5	5	82	0.0609756
NODE_4386_length_1151_cov_13.782319	400	482	7	32	82	0.3902439
NODE_4386_length_1151_cov_13.782319	400	482	9	14	82	0.1707317
NODE_4386_length_1151_cov_13.782319	400	482	10	10	82	0.1219512
NODE_4386_length_1151_cov_13.782319	400	482	11	2	82	0.0243902
NODE_4386_length_1151_cov_13.782319	450	535	7	6	85	0.0705882
NODE_4386_length_1151_cov_13.782319	450	535	9	14	85	0.1647059
NODE_4386_length_1151_cov_13.782319	450	535	10	11	85	0.1294118
NODE_4386_length_1151_cov_13.782319	450	535	11	3	85	0.0352941
NODE_4386_length_1151_cov_13.782319	450	535	12	25	85	0.2941177
NODE_4386_length_1151_cov_13.782319	450	535	13	25	85	0.2941177
NODE_4386_length_1151_cov_13.782319	450	535	14	1	85	0.0117647
NODE_4392_length_1150_cov_38.601332	563	643	12	6	80	0.0750000
NODE_4392_length_1150_cov_38.601332	563	643	13	17	80	0.2125000
NODE_4392_length_1150_cov_38.601332	563	643	14	54	80	0.6750000
NODE_4392_length_1150_cov_38.601332	563	643	15	3	80	0.0375000
NODE_4392_length_1150_cov_38.601332	616	696	10	8	80	0.1000000
NODE_4392_length_1150_cov_38.601332	616	696	11	19	80	0.2375000
NODE_4392_length_1150_cov_38.601332	616	696	12	10	80	0.1250000
NODE_4392_length_1150_cov_38.601332	616	696	13	14	80	0.1750000
NODE_4392_length_1150_cov_38.601332	616	696	14	26	80	0.3250000
NODE_4392_length_1150_cov_38.601332	616	696	15	3	80	0.0375000
NODE_4392_length_1150_cov_38.601332	692	772	7	3	80	0.0375000
NODE_4392_length_1150_cov_38.601332	692	772	8	57	80	0.7125000
NODE_4392_length_1150_cov_38.601332	692	772	10	20	80	0.2500000
NODE_4392_length_1150_cov_38.601332	745	825	5	14	80	0.1750000
NODE_4392_length_1150_cov_38.601332	745	825	6	37	80	0.4625000
NODE_4392_length_1150_cov_38.601332	745	825	8	29	80	0.3625000
NODE_4393_length_1150_cov_15.741199	497	578	2	7	81	0.0864198
NODE_4393_length_1150_cov_15.741199	497	578	4	40	81	0.4938272
NODE_4393_length_1150_cov_15.741199	497	578	5	23	81	0.2839506
NODE_4393_length_1150_cov_15.741199	497	578	6	11	81	0.1358025
NODE_4393_length_1150_cov_15.741199	550	631	5	17	81	0.2098765
NODE_4393_length_1150_cov_15.741199	550	631	6	19	81	0.2345679
NODE_4393_length_1150_cov_15.741199	550	631	7	2	81	0.0246914
NODE_4393_length_1150_cov_15.741199	550	631	8	43	81	0.5308642
NODE_4394_length_1150_cov_11.132255	795	875	2	6	80	0.0750000
NODE_4394_length_1150_cov_11.132255	795	875	3	16	80	0.2000000
NODE_4394_length_1150_cov_11.132255	795	875	4	58	80	0.7250000
NODE_4394_length_1150_cov_11.132255	848	928	2	17	80	0.2125000
NODE_4394_length_1150_cov_11.132255	848	928	4	63	80	0.7875000
NODE_4395_length_1150_cov_9.253092	583	663	6	58	80	0.7250000
NODE_4395_length_1150_cov_9.253092	583	663	9	13	80	0.1625000
NODE_4395_length_1150_cov_9.253092	583	663	10	9	80	0.1125000
NODE_4395_length_1150_cov_9.253092	636	716	0	4	80	0.0500000
NODE_4395_length_1150_cov_9.253092	636	716	5	23	80	0.2875000
NODE_4395_length_1150_cov_9.253092	636	716	6	53	80	0.6625000
NODE_4398_length_1149_cov_17.289524	644	695	0	51	51	1.0000000
NODE_4399_length_1149_cov_13.805714	584	664	0	50	80	0.6250000
NODE_4399_length_1149_cov_13.805714	584	664	1	30	80	0.3750000
NODE_4399_length_1149_cov_13.805714	637	717	1	41	80	0.5125000
NODE_4399_length_1149_cov_13.805714	637	717	2	39	80	0.4875000
NODE_4399_length_1149_cov_13.805714	713	793	2	39	80	0.4875000
NODE_4399_length_1149_cov_13.805714	713	793	3	9	80	0.1125000
NODE_4399_length_1149_cov_13.805714	713	793	4	32	80	0.4000000
NODE_4399_length_1149_cov_13.805714	766	846	0	7	80	0.0875000
NODE_4399_length_1149_cov_13.805714	766	846	2	11	80	0.1375000
NODE_4399_length_1149_cov_13.805714	766	846	3	44	80	0.5500000
NODE_4399_length_1149_cov_13.805714	766	846	4	18	80	0.2250000
NODE_4407_length_1148_cov_27.674929	387	467	2	68	80	0.8500000
NODE_4407_length_1148_cov_27.674929	387	467	3	5	80	0.0625000
NODE_4407_length_1148_cov_27.674929	387	467	4	7	80	0.0875000
NODE_4407_length_1148_cov_27.674929	440	520	2	15	80	0.1875000
NODE_4407_length_1148_cov_27.674929	440	520	3	42	80	0.5250000
NODE_4407_length_1148_cov_27.674929	440	520	4	23	80	0.2875000
NODE_4408_length_1148_cov_13.275500	136	216	9	5	80	0.0625000
NODE_4408_length_1148_cov_13.275500	136	216	10	3	80	0.0375000
NODE_4408_length_1148_cov_13.275500	136	216	11	2	80	0.0250000
NODE_4408_length_1148_cov_13.275500	136	216	12	29	80	0.3625000
NODE_4408_length_1148_cov_13.275500	136	216	14	17	80	0.2125000
NODE_4408_length_1148_cov_13.275500	136	216	16	23	80	0.2875000
NODE_4408_length_1148_cov_13.275500	136	216	17	1	80	0.0125000
NODE_4408_length_1148_cov_13.275500	189	268	9	2	79	0.0253165
NODE_4408_length_1148_cov_13.275500	189	268	10	11	79	0.1392405
NODE_4408_length_1148_cov_13.275500	189	268	12	3	79	0.0379747
NODE_4408_length_1148_cov_13.275500	189	268	13	4	79	0.0506329
NODE_4408_length_1148_cov_13.275500	189	268	14	5	79	0.0632911
NODE_4408_length_1148_cov_13.275500	189	268	16	53	79	0.6708861
NODE_4408_length_1148_cov_13.275500	189	268	17	1	79	0.0126582
NODE_4409_length_1148_cov_10.613918	506	586	0	80	80	1.0000000
NODE_4409_length_1148_cov_10.613918	559	639	0	80	80	1.0000000
NODE_4415_length_1147_cov_33.543893	378	458	16	10	80	0.1250000
NODE_4415_length_1147_cov_33.543893	378	458	18	3	80	0.0375000
NODE_4415_length_1147_cov_33.543893	378	458	19	8	80	0.1000000
NODE_4415_length_1147_cov_33.543893	378	458	20	22	80	0.2750000
NODE_4415_length_1147_cov_33.543893	378	458	21	10	80	0.1250000
NODE_4415_length_1147_cov_33.543893	378	458	22	15	80	0.1875000
NODE_4415_length_1147_cov_33.543893	378	458	23	1	80	0.0125000
NODE_4415_length_1147_cov_33.543893	378	458	24	11	80	0.1375000
NODE_4415_length_1147_cov_33.543893	431	511	21	5	80	0.0625000
NODE_4415_length_1147_cov_33.543893	431	511	22	10	80	0.1250000
NODE_4415_length_1147_cov_33.543893	431	511	23	5	80	0.0625000
NODE_4415_length_1147_cov_33.543893	431	511	24	33	80	0.4125000
NODE_4415_length_1147_cov_33.543893	431	511	25	1	80	0.0125000
NODE_4415_length_1147_cov_33.543893	431	511	26	14	80	0.1750000
NODE_4415_length_1147_cov_33.543893	431	511	27	5	80	0.0625000
NODE_4415_length_1147_cov_33.543893	431	511	28	7	80	0.0875000
NODE_4416_length_1147_cov_26.858779	254	334	2	48	80	0.6000000
NODE_4416_length_1147_cov_26.858779	254	334	3	7	80	0.0875000
NODE_4416_length_1147_cov_26.858779	254	334	4	25	80	0.3125000
NODE_4416_length_1147_cov_26.858779	307	387	2	34	80	0.4250000
NODE_4416_length_1147_cov_26.858779	307	387	3	7	80	0.0875000
NODE_4416_length_1147_cov_26.858779	307	387	4	2	80	0.0250000
NODE_4416_length_1147_cov_26.858779	307	387	5	19	80	0.2375000
NODE_4416_length_1147_cov_26.858779	307	387	6	18	80	0.2250000
NODE_4416_length_1147_cov_26.858779	383	463	6	9	80	0.1125000
NODE_4416_length_1147_cov_26.858779	383	463	8	13	80	0.1625000
NODE_4416_length_1147_cov_26.858779	383	463	9	6	80	0.0750000
NODE_4416_length_1147_cov_26.858779	383	463	11	10	80	0.1250000
NODE_4416_length_1147_cov_26.858779	383	463	14	5	80	0.0625000
NODE_4416_length_1147_cov_26.858779	383	463	15	37	80	0.4625000
NODE_4416_length_1147_cov_26.858779	436	516	14	21	80	0.2625000
NODE_4416_length_1147_cov_26.858779	436	516	15	43	80	0.5375000
NODE_4416_length_1147_cov_26.858779	436	516	16	1	80	0.0125000
NODE_4416_length_1147_cov_26.858779	436	516	17	15	80	0.1875000
NODE_4417_length_1147_cov_24.227099	606	686	2	32	80	0.4000000
NODE_4417_length_1147_cov_24.227099	606	686	3	48	80	0.6000000
NODE_4417_length_1147_cov_24.227099	659	739	2	80	80	1.0000000
NODE_4417_length_1147_cov_24.227099	735	815	0	30	80	0.3750000
NODE_4417_length_1147_cov_24.227099	735	815	1	41	80	0.5125000
NODE_4417_length_1147_cov_24.227099	735	815	2	9	80	0.1125000
NODE_4417_length_1147_cov_24.227099	788	868	0	80	80	1.0000000
NODE_4418_length_1147_cov_16.559160	417	497	3	42	80	0.5250000
NODE_4418_length_1147_cov_16.559160	417	497	4	38	80	0.4750000
NODE_4418_length_1147_cov_16.559160	470	550	2	2	80	0.0250000
NODE_4418_length_1147_cov_16.559160	470	550	4	78	80	0.9750000
NODE_4428_length_1146_cov_52.393505	411	491	5	1	80	0.0125000
NODE_4428_length_1146_cov_52.393505	411	491	6	79	80	0.9875000
NODE_4428_length_1146_cov_52.393505	464	544	4	15	80	0.1875000
NODE_4428_length_1146_cov_52.393505	464	544	5	4	80	0.0500000
NODE_4428_length_1146_cov_52.393505	464	544	6	35	80	0.4375000
NODE_4428_length_1146_cov_52.393505	464	544	8	13	80	0.1625000
NODE_4428_length_1146_cov_52.393505	464	544	10	13	80	0.1625000
NODE_4428_length_1146_cov_52.393505	540	620	10	8	80	0.1000000
NODE_4428_length_1146_cov_52.393505	540	620	11	7	80	0.0875000
NODE_4428_length_1146_cov_52.393505	540	620	12	10	80	0.1250000
NODE_4428_length_1146_cov_52.393505	540	620	13	34	80	0.4250000
NODE_4428_length_1146_cov_52.393505	540	620	15	6	80	0.0750000
NODE_4428_length_1146_cov_52.393505	540	620	16	11	80	0.1375000
NODE_4428_length_1146_cov_52.393505	540	620	17	4	80	0.0500000
NODE_4428_length_1146_cov_52.393505	593	673	11	18	80	0.2250000
NODE_4428_length_1146_cov_52.393505	593	673	13	10	80	0.1250000
NODE_4428_length_1146_cov_52.393505	593	673	15	12	80	0.1500000
NODE_4428_length_1146_cov_52.393505	593	673	16	11	80	0.1375000
NODE_4428_length_1146_cov_52.393505	593	673	17	29	80	0.3625000
NODE_4429_length_1146_cov_46.364852	233	313	7	6	80	0.0750000
NODE_4429_length_1146_cov_46.364852	233	313	9	12	80	0.1500000
NODE_4429_length_1146_cov_46.364852	233	313	10	6	80	0.0750000
NODE_4429_length_1146_cov_46.364852	233	313	11	1	80	0.0125000
NODE_4429_length_1146_cov_46.364852	233	313	12	9	80	0.1125000
NODE_4429_length_1146_cov_46.364852	233	313	13	8	80	0.1000000
NODE_4429_length_1146_cov_46.364852	233	313	14	12	80	0.1500000
NODE_4429_length_1146_cov_46.364852	233	313	16	9	80	0.1125000
NODE_4429_length_1146_cov_46.364852	233	313	18	3	80	0.0375000
NODE_4429_length_1146_cov_46.364852	233	313	19	14	80	0.1750000
NODE_4429_length_1146_cov_46.364852	286	366	14	1	80	0.0125000
NODE_4429_length_1146_cov_46.364852	286	366	16	12	80	0.1500000
NODE_4429_length_1146_cov_46.364852	286	366	17	28	80	0.3500000
NODE_4429_length_1146_cov_46.364852	286	366	18	21	80	0.2625000
NODE_4429_length_1146_cov_46.364852	286	366	19	18	80	0.2250000
NODE_4430_length_1146_cov_26.159503	476	556	14	10	80	0.1250000
NODE_4430_length_1146_cov_26.159503	476	556	15	11	80	0.1375000
NODE_4430_length_1146_cov_26.159503	476	556	16	3	80	0.0375000
NODE_4430_length_1146_cov_26.159503	476	556	17	32	80	0.4000000
NODE_4430_length_1146_cov_26.159503	476	556	18	24	80	0.3000000
NODE_4430_length_1146_cov_26.159503	529	609	10	11	80	0.1375000
NODE_4430_length_1146_cov_26.159503	529	609	11	8	80	0.1000000
NODE_4430_length_1146_cov_26.159503	529	609	13	12	80	0.1500000
NODE_4430_length_1146_cov_26.159503	529	609	14	9	80	0.1125000
NODE_4430_length_1146_cov_26.159503	529	609	15	1	80	0.0125000
NODE_4430_length_1146_cov_26.159503	529	609	16	10	80	0.1250000
NODE_4430_length_1146_cov_26.159503	529	609	17	7	80	0.0875000
NODE_4430_length_1146_cov_26.159503	529	609	18	22	80	0.2750000
NODE_4430_length_1146_cov_26.159503	605	685	5	18	80	0.2250000
NODE_4430_length_1146_cov_26.159503	605	685	6	25	80	0.3125000
NODE_4430_length_1146_cov_26.159503	605	685	8	15	80	0.1875000
NODE_4430_length_1146_cov_26.159503	605	685	9	2	80	0.0250000
NODE_4430_length_1146_cov_26.159503	605	685	10	20	80	0.2500000
NODE_4430_length_1146_cov_26.159503	658	738	1	33	80	0.4125000
NODE_4430_length_1146_cov_26.159503	658	738	5	38	80	0.4750000
NODE_4430_length_1146_cov_26.159503	658	738	6	9	80	0.1125000
NODE_4431_length_1146_cov_14.210124	343	423	1	78	80	0.9750000
NODE_4431_length_1146_cov_14.210124	343	423	2	2	80	0.0250000
NODE_4431_length_1146_cov_14.210124	396	476	1	61	80	0.7625000
NODE_4431_length_1146_cov_14.210124	396	476	2	19	80	0.2375000
NODE_4432_length_1146_cov_13.479465	425	501	3	9	76	0.1184211
NODE_4432_length_1146_cov_13.479465	425	501	5	67	76	0.8815789
NODE_4432_length_1146_cov_13.479465	505	565	4	40	60	0.6666667
NODE_4432_length_1146_cov_13.479465	505	565	5	19	60	0.3166667
NODE_4432_length_1146_cov_13.479465	505	565	6	1	60	0.0166667
NODE_4432_length_1146_cov_13.479465	561	641	5	38	80	0.4750000
NODE_4432_length_1146_cov_13.479465	561	641	6	17	80	0.2125000
NODE_4432_length_1146_cov_13.479465	561	641	7	14	80	0.1750000
NODE_4432_length_1146_cov_13.479465	561	641	8	11	80	0.1375000
NODE_4432_length_1146_cov_13.479465	614	694	6	10	80	0.1250000
NODE_4432_length_1146_cov_13.479465	614	694	7	6	80	0.0750000
NODE_4432_length_1146_cov_13.479465	614	694	8	22	80	0.2750000
NODE_4432_length_1146_cov_13.479465	614	694	10	42	80	0.5250000
NODE_4438_length_1145_cov_49.566922	395	470	7	8	75	0.1066667
NODE_4438_length_1145_cov_49.566922	395	470	10	1	75	0.0133333
NODE_4438_length_1145_cov_49.566922	395	470	13	46	75	0.6133333
NODE_4438_length_1145_cov_49.566922	395	470	14	20	75	0.2666667
NODE_4438_length_1145_cov_49.566922	443	523	13	48	80	0.6000000
NODE_4438_length_1145_cov_49.566922	443	523	15	2	80	0.0250000
NODE_4438_length_1145_cov_49.566922	443	523	16	21	80	0.2625000
NODE_4438_length_1145_cov_49.566922	443	523	17	9	80	0.1125000
NODE_4439_length_1145_cov_38.191205	497	576	5	6	79	0.0759494
NODE_4439_length_1145_cov_38.191205	497	576	6	6	79	0.0759494
NODE_4439_length_1145_cov_38.191205	497	576	7	10	79	0.1265823
NODE_4439_length_1145_cov_38.191205	497	576	9	1	79	0.0126582
NODE_4439_length_1145_cov_38.191205	497	576	11	18	79	0.2278481
NODE_4439_length_1145_cov_38.191205	497	576	12	8	79	0.1012658
NODE_4439_length_1145_cov_38.191205	497	576	13	13	79	0.1645570
NODE_4439_length_1145_cov_38.191205	497	576	14	17	79	0.2151899
NODE_4439_length_1145_cov_38.191205	549	629	11	4	80	0.0500000
NODE_4439_length_1145_cov_38.191205	549	629	12	6	80	0.0750000
NODE_4439_length_1145_cov_38.191205	549	629	14	30	80	0.3750000
NODE_4439_length_1145_cov_38.191205	549	629	15	4	80	0.0500000
NODE_4439_length_1145_cov_38.191205	549	629	17	20	80	0.2500000
NODE_4439_length_1145_cov_38.191205	549	629	18	16	80	0.2000000
NODE_4440_length_1145_cov_26.929254	468	548	5	29	80	0.3625000
NODE_4440_length_1145_cov_26.929254	468	548	6	1	80	0.0125000
NODE_4440_length_1145_cov_26.929254	468	548	7	40	80	0.5000000
NODE_4440_length_1145_cov_26.929254	468	548	8	10	80	0.1250000
NODE_4440_length_1145_cov_26.929254	521	601	3	29	80	0.3625000
NODE_4440_length_1145_cov_26.929254	521	601	4	22	80	0.2750000
NODE_4440_length_1145_cov_26.929254	521	601	5	27	80	0.3375000
NODE_4440_length_1145_cov_26.929254	521	601	7	2	80	0.0250000
NODE_4441_length_1145_cov_20.121415	508	588	1	17	80	0.2125000
NODE_4441_length_1145_cov_20.121415	508	588	2	63	80	0.7875000
NODE_4441_length_1145_cov_20.121415	561	641	1	64	80	0.8000000
NODE_4441_length_1145_cov_20.121415	561	641	2	16	80	0.2000000
NODE_4442_length_1145_cov_11.753346	527	605	3	43	78	0.5512820
NODE_4442_length_1145_cov_11.753346	527	605	4	35	78	0.4487180
NODE_4442_length_1145_cov_11.753346	578	659	0	31	81	0.3827161
NODE_4442_length_1145_cov_11.753346	578	659	2	16	81	0.1975309
NODE_4442_length_1145_cov_11.753346	578	659	3	34	81	0.4197531
NODE_4443_length_1145_cov_9.571702	93	173	3	44	80	0.5500000
NODE_4443_length_1145_cov_9.571702	93	173	4	22	80	0.2750000
NODE_4443_length_1145_cov_9.571702	93	173	6	14	80	0.1750000
NODE_4443_length_1145_cov_9.571702	146	226	4	13	80	0.1625000
NODE_4443_length_1145_cov_9.571702	146	226	5	27	80	0.3375000
NODE_4443_length_1145_cov_9.571702	146	226	6	40	80	0.5000000
NODE_4455_length_1143_cov_42.255747	380	460	3	3	80	0.0375000
NODE_4455_length_1143_cov_42.255747	380	460	4	7	80	0.0875000
NODE_4455_length_1143_cov_42.255747	380	460	5	23	80	0.2875000
NODE_4455_length_1143_cov_42.255747	380	460	8	4	80	0.0500000
NODE_4455_length_1143_cov_42.255747	380	460	10	13	80	0.1625000
NODE_4455_length_1143_cov_42.255747	380	460	11	2	80	0.0250000
NODE_4455_length_1143_cov_42.255747	380	460	12	17	80	0.2125000
NODE_4455_length_1143_cov_42.255747	380	460	13	3	80	0.0375000
NODE_4455_length_1143_cov_42.255747	380	460	14	8	80	0.1000000
NODE_4455_length_1143_cov_42.255747	433	513	12	16	80	0.2000000
NODE_4455_length_1143_cov_42.255747	433	513	13	3	80	0.0375000
NODE_4455_length_1143_cov_42.255747	433	513	14	18	80	0.2250000
NODE_4455_length_1143_cov_42.255747	433	513	15	7	80	0.0875000
NODE_4455_length_1143_cov_42.255747	433	513	16	21	80	0.2625000
NODE_4455_length_1143_cov_42.255747	433	513	17	6	80	0.0750000
NODE_4455_length_1143_cov_42.255747	433	513	18	4	80	0.0500000
NODE_4455_length_1143_cov_42.255747	433	513	19	2	80	0.0250000
NODE_4455_length_1143_cov_42.255747	433	513	20	3	80	0.0375000
NODE_4455_length_1143_cov_42.255747	509	589	14	7	80	0.0875000
NODE_4455_length_1143_cov_42.255747	509	589	15	2	80	0.0250000
NODE_4455_length_1143_cov_42.255747	509	589	16	13	80	0.1625000
NODE_4455_length_1143_cov_42.255747	509	589	19	17	80	0.2125000
NODE_4455_length_1143_cov_42.255747	509	589	20	29	80	0.3625000
NODE_4455_length_1143_cov_42.255747	509	589	21	12	80	0.1500000
NODE_4455_length_1143_cov_42.255747	562	642	12	1	80	0.0125000
NODE_4455_length_1143_cov_42.255747	562	642	13	7	80	0.0875000
NODE_4455_length_1143_cov_42.255747	562	642	14	36	80	0.4500000
NODE_4455_length_1143_cov_42.255747	562	642	15	18	80	0.2250000
NODE_4455_length_1143_cov_42.255747	562	642	16	13	80	0.1625000
NODE_4455_length_1143_cov_42.255747	562	642	21	5	80	0.0625000
NODE_4456_length_1143_cov_22.076628	526	606	6	9	80	0.1125000
NODE_4456_length_1143_cov_22.076628	526	606	8	17	80	0.2125000
NODE_4456_length_1143_cov_22.076628	526	606	10	2	80	0.0250000
NODE_4456_length_1143_cov_22.076628	526	606	11	3	80	0.0375000
NODE_4456_length_1143_cov_22.076628	526	606	12	49	80	0.6125000
NODE_4456_length_1143_cov_22.076628	579	659	7	2	80	0.0250000
NODE_4456_length_1143_cov_22.076628	579	659	8	3	80	0.0375000
NODE_4456_length_1143_cov_22.076628	579	659	9	41	80	0.5125000
NODE_4456_length_1143_cov_22.076628	579	659	10	9	80	0.1125000
NODE_4456_length_1143_cov_22.076628	579	659	12	25	80	0.3125000
NODE_4457_length_1143_cov_19.106322	565	645	5	4	80	0.0500000
NODE_4457_length_1143_cov_19.106322	565	645	7	50	80	0.6250000
NODE_4457_length_1143_cov_19.106322	565	645	8	26	80	0.3250000
NODE_4457_length_1143_cov_19.106322	618	698	6	23	80	0.2875000
NODE_4457_length_1143_cov_19.106322	618	698	7	45	80	0.5625000
NODE_4457_length_1143_cov_19.106322	618	698	8	12	80	0.1500000
NODE_4458_length_1143_cov_16.223180	638	719	5	23	81	0.2839506
NODE_4458_length_1143_cov_16.223180	638	719	6	4	81	0.0493827
NODE_4458_length_1143_cov_16.223180	638	719	7	54	81	0.6666667
NODE_4458_length_1143_cov_16.223180	692	772	3	15	80	0.1875000
NODE_4458_length_1143_cov_16.223180	692	772	5	32	80	0.4000000
NODE_4458_length_1143_cov_16.223180	692	772	7	33	80	0.4125000
NODE_4459_length_1143_cov_13.961686	634	714	8	24	80	0.3000000
NODE_4459_length_1143_cov_13.961686	634	714	9	20	80	0.2500000
NODE_4459_length_1143_cov_13.961686	634	714	10	31	80	0.3875000
NODE_4459_length_1143_cov_13.961686	634	714	11	5	80	0.0625000
NODE_4459_length_1143_cov_13.961686	687	767	7	10	80	0.1250000
NODE_4459_length_1143_cov_13.961686	687	767	8	18	80	0.2250000
NODE_4459_length_1143_cov_13.961686	687	767	9	12	80	0.1500000
NODE_4459_length_1143_cov_13.961686	687	767	10	35	80	0.4375000
NODE_4459_length_1143_cov_13.961686	687	767	11	5	80	0.0625000
NODE_4459_length_1143_cov_13.961686	763	843	1	1	80	0.0125000
NODE_4459_length_1143_cov_13.961686	763	843	2	14	80	0.1750000
NODE_4459_length_1143_cov_13.961686	763	843	3	20	80	0.2500000
NODE_4459_length_1143_cov_13.961686	763	843	4	25	80	0.3125000
NODE_4459_length_1143_cov_13.961686	763	843	6	15	80	0.1875000
NODE_4459_length_1143_cov_13.961686	763	843	7	5	80	0.0625000
NODE_4459_length_1143_cov_13.961686	816	896	0	7	80	0.0875000
NODE_4459_length_1143_cov_13.961686	816	896	1	47	80	0.5875000
NODE_4459_length_1143_cov_13.961686	816	896	2	14	80	0.1750000
NODE_4459_length_1143_cov_13.961686	816	896	3	12	80	0.1500000
NODE_4460_length_1143_cov_12.782567	328	409	0	17	81	0.2098765
NODE_4460_length_1143_cov_12.782567	328	409	1	45	81	0.5555556
NODE_4460_length_1143_cov_12.782567	328	409	2	19	81	0.2345679
NODE_4460_length_1143_cov_12.782567	381	462	1	9	81	0.1111111
NODE_4460_length_1143_cov_12.782567	381	462	2	55	81	0.6790124
NODE_4460_length_1143_cov_12.782567	381	462	4	17	81	0.2098765
NODE_4460_length_1143_cov_12.782567	458	538	4	34	80	0.4250000
NODE_4460_length_1143_cov_12.782567	458	538	5	31	80	0.3875000
NODE_4460_length_1143_cov_12.782567	458	538	6	3	80	0.0375000
NODE_4460_length_1143_cov_12.782567	458	538	7	12	80	0.1500000
NODE_4460_length_1143_cov_12.782567	511	591	4	3	80	0.0375000
NODE_4460_length_1143_cov_12.782567	511	591	5	9	80	0.1125000
NODE_4460_length_1143_cov_12.782567	511	591	6	3	80	0.0375000
NODE_4460_length_1143_cov_12.782567	511	591	7	65	80	0.8125000
NODE_4461_length_1143_cov_8.287356	692	772	0	54	80	0.6750000
NODE_4461_length_1143_cov_8.287356	692	772	2	26	80	0.3250000
NODE_4461_length_1143_cov_8.287356	745	825	0	1	80	0.0125000
NODE_4461_length_1143_cov_8.287356	745	825	2	45	80	0.5625000
NODE_4461_length_1143_cov_8.287356	745	825	4	34	80	0.4250000
NODE_4463_length_1143_cov_2.197318	988	1057	2	54	69	0.7826087
NODE_4463_length_1143_cov_2.197318	988	1057	4	15	69	0.2173913
NODE_4466_length_1142_cov_28.364334	613	693	14	17	80	0.2125000
NODE_4466_length_1142_cov_28.364334	613	693	15	7	80	0.0875000
NODE_4466_length_1142_cov_28.364334	613	693	16	17	80	0.2125000
NODE_4466_length_1142_cov_28.364334	613	693	17	1	80	0.0125000
NODE_4466_length_1142_cov_28.364334	613	693	18	29	80	0.3625000
NODE_4466_length_1142_cov_28.364334	613	693	19	9	80	0.1125000
NODE_4466_length_1142_cov_28.364334	666	746	13	14	80	0.1750000
NODE_4466_length_1142_cov_28.364334	666	746	14	37	80	0.4625000
NODE_4466_length_1142_cov_28.364334	666	746	15	9	80	0.1125000
NODE_4466_length_1142_cov_28.364334	666	746	16	10	80	0.1250000
NODE_4466_length_1142_cov_28.364334	666	746	18	1	80	0.0125000
NODE_4466_length_1142_cov_28.364334	666	746	19	9	80	0.1125000
NODE_4467_length_1142_cov_21.669223	518	598	12	9	80	0.1125000
NODE_4467_length_1142_cov_21.669223	518	598	13	20	80	0.2500000
NODE_4467_length_1142_cov_21.669223	518	598	14	20	80	0.2500000
NODE_4467_length_1142_cov_21.669223	518	598	15	10	80	0.1250000
NODE_4467_length_1142_cov_21.669223	518	598	16	10	80	0.1250000
NODE_4467_length_1142_cov_21.669223	518	598	19	11	80	0.1375000
NODE_4467_length_1142_cov_21.669223	571	651	12	25	80	0.3125000
NODE_4467_length_1142_cov_21.669223	571	651	13	5	80	0.0625000
NODE_4467_length_1142_cov_21.669223	571	651	14	29	80	0.3625000
NODE_4467_length_1142_cov_21.669223	571	651	15	6	80	0.0750000
NODE_4467_length_1142_cov_21.669223	571	651	16	1	80	0.0125000
NODE_4467_length_1142_cov_21.669223	571	651	17	6	80	0.0750000
NODE_4467_length_1142_cov_21.669223	571	651	19	8	80	0.1000000
NODE_4468_length_1142_cov_19.007670	411	491	0	15	80	0.1875000
NODE_4468_length_1142_cov_19.007670	411	491	1	19	80	0.2375000
NODE_4468_length_1142_cov_19.007670	411	491	2	2	80	0.0250000
NODE_4468_length_1142_cov_19.007670	411	491	3	18	80	0.2250000
NODE_4468_length_1142_cov_19.007670	411	491	4	16	80	0.2000000
NODE_4468_length_1142_cov_19.007670	411	491	6	10	80	0.1250000
NODE_4468_length_1142_cov_19.007670	464	544	3	1	80	0.0125000
NODE_4468_length_1142_cov_19.007670	464	544	4	16	80	0.2000000
NODE_4468_length_1142_cov_19.007670	464	544	6	63	80	0.7875000
NODE_4474_length_1141_cov_12.500960	17	97	1	59	80	0.7375000
NODE_4474_length_1141_cov_12.500960	17	97	6	21	80	0.2625000
NODE_4474_length_1141_cov_12.500960	17	97	1	59	80	0.7375000
NODE_4474_length_1141_cov_12.500960	17	97	6	21	80	0.2625000
NODE_4474_length_1141_cov_12.500960	17	97	1	59	80	0.7375000
NODE_4474_length_1141_cov_12.500960	17	97	6	21	80	0.2625000
NODE_4474_length_1141_cov_12.500960	17	97	1	59	80	0.7375000
NODE_4474_length_1141_cov_12.500960	17	97	6	21	80	0.2625000
NODE_4474_length_1141_cov_12.500960	70	132	1	6	62	0.0967742
NODE_4474_length_1141_cov_12.500960	70	132	6	56	62	0.9032258
NODE_4474_length_1141_cov_12.500960	70	132	1	6	62	0.0967742
NODE_4474_length_1141_cov_12.500960	70	132	6	56	62	0.9032258
NODE_4474_length_1141_cov_12.500960	70	132	1	6	62	0.0967742
NODE_4474_length_1141_cov_12.500960	70	132	6	56	62	0.9032258
NODE_4474_length_1141_cov_12.500960	70	132	1	6	62	0.0967742
NODE_4474_length_1141_cov_12.500960	70	132	6	56	62	0.9032258
NODE_4475_length_1141_cov_7.197697	54	134	0	80	80	1.0000000
NODE_4475_length_1141_cov_7.197697	107	187	0	80	80	1.0000000
NODE_4475_length_1141_cov_7.197697	573	653	0	5	80	0.0625000
NODE_4475_length_1141_cov_7.197697	573	653	1	41	80	0.5125000
NODE_4475_length_1141_cov_7.197697	573	653	2	34	80	0.4250000
NODE_4475_length_1141_cov_7.197697	626	707	2	81	81	1.0000000
NODE_4476_length_1141_cov_5.428023	411	491	0	80	80	1.0000000
NODE_4476_length_1141_cov_5.428023	464	544	0	80	80	1.0000000
NODE_4482_length_1140_cov_39.383285	451	531	7	10	80	0.1250000
NODE_4482_length_1140_cov_39.383285	451	531	9	24	80	0.3000000
NODE_4482_length_1140_cov_39.383285	451	531	10	1	80	0.0125000
NODE_4482_length_1140_cov_39.383285	451	531	13	45	80	0.5625000
NODE_4482_length_1140_cov_39.383285	504	584	6	7	80	0.0875000
NODE_4482_length_1140_cov_39.383285	504	584	7	1	80	0.0125000
NODE_4482_length_1140_cov_39.383285	504	584	8	4	80	0.0500000
NODE_4482_length_1140_cov_39.383285	504	584	9	10	80	0.1250000
NODE_4482_length_1140_cov_39.383285	504	584	10	12	80	0.1500000
NODE_4482_length_1140_cov_39.383285	504	584	11	2	80	0.0250000
NODE_4482_length_1140_cov_39.383285	504	584	12	3	80	0.0375000
NODE_4482_length_1140_cov_39.383285	504	584	13	41	80	0.5125000
NODE_4482_length_1140_cov_39.383285	580	660	13	4	80	0.0500000
NODE_4482_length_1140_cov_39.383285	580	660	14	6	80	0.0750000
NODE_4482_length_1140_cov_39.383285	580	660	15	5	80	0.0625000
NODE_4482_length_1140_cov_39.383285	580	660	16	16	80	0.2000000
NODE_4482_length_1140_cov_39.383285	580	660	17	11	80	0.1375000
NODE_4482_length_1140_cov_39.383285	580	660	18	23	80	0.2875000
NODE_4482_length_1140_cov_39.383285	580	660	19	10	80	0.1250000
NODE_4482_length_1140_cov_39.383285	580	660	20	5	80	0.0625000
NODE_4482_length_1140_cov_39.383285	633	713	14	6	80	0.0750000
NODE_4482_length_1140_cov_39.383285	633	713	16	15	80	0.1875000
NODE_4482_length_1140_cov_39.383285	633	713	17	1	80	0.0125000
NODE_4482_length_1140_cov_39.383285	633	713	18	1	80	0.0125000
NODE_4482_length_1140_cov_39.383285	633	713	19	2	80	0.0250000
NODE_4482_length_1140_cov_39.383285	633	713	20	39	80	0.4875000
NODE_4482_length_1140_cov_39.383285	633	713	21	4	80	0.0500000
NODE_4482_length_1140_cov_39.383285	633	713	22	1	80	0.0125000
NODE_4482_length_1140_cov_39.383285	633	713	23	4	80	0.0500000
NODE_4482_length_1140_cov_39.383285	633	713	24	7	80	0.0875000
NODE_4483_length_1140_cov_19.493756	543	623	0	38	80	0.4750000
NODE_4483_length_1140_cov_19.493756	543	623	1	42	80	0.5250000
NODE_4483_length_1140_cov_19.493756	596	676	1	34	80	0.4250000
NODE_4483_length_1140_cov_19.493756	596	676	2	46	80	0.5750000
NODE_4484_length_1140_cov_18.341018	347	427	2	18	80	0.2250000
NODE_4484_length_1140_cov_18.341018	347	427	3	62	80	0.7750000
NODE_4484_length_1140_cov_18.341018	400	480	2	28	80	0.3500000
NODE_4484_length_1140_cov_18.341018	400	480	3	52	80	0.6500000
NODE_4484_length_1140_cov_18.341018	476	556	1	49	80	0.6125000
NODE_4484_length_1140_cov_18.341018	476	556	2	14	80	0.1750000
NODE_4484_length_1140_cov_18.341018	476	556	3	17	80	0.2125000
NODE_4484_length_1140_cov_18.341018	529	609	0	12	80	0.1500000
NODE_4484_length_1140_cov_18.341018	529	609	1	68	80	0.8500000
NODE_4494_length_1139_cov_26.812500	410	490	5	3	80	0.0375000
NODE_4494_length_1139_cov_26.812500	410	490	6	5	80	0.0625000
NODE_4494_length_1139_cov_26.812500	410	490	7	58	80	0.7250000
NODE_4494_length_1139_cov_26.812500	410	490	8	14	80	0.1750000
NODE_4494_length_1139_cov_26.812500	463	543	5	6	80	0.0750000
NODE_4494_length_1139_cov_26.812500	463	543	6	38	80	0.4750000
NODE_4494_length_1139_cov_26.812500	463	543	7	22	80	0.2750000
NODE_4494_length_1139_cov_26.812500	463	543	8	14	80	0.1750000
NODE_4494_length_1139_cov_26.812500	539	619	4	4	80	0.0500000
NODE_4494_length_1139_cov_26.812500	539	619	5	15	80	0.1875000
NODE_4494_length_1139_cov_26.812500	539	619	6	30	80	0.3750000
NODE_4494_length_1139_cov_26.812500	539	619	8	21	80	0.2625000
NODE_4494_length_1139_cov_26.812500	539	619	9	10	80	0.1250000
NODE_4494_length_1139_cov_26.812500	592	672	8	20	80	0.2500000
NODE_4494_length_1139_cov_26.812500	592	672	9	12	80	0.1500000
NODE_4494_length_1139_cov_26.812500	592	672	10	37	80	0.4625000
NODE_4494_length_1139_cov_26.812500	592	672	11	11	80	0.1375000
NODE_4495_length_1139_cov_26.323077	308	388	3	6	80	0.0750000
NODE_4495_length_1139_cov_26.323077	308	388	5	5	80	0.0625000
NODE_4495_length_1139_cov_26.323077	308	388	6	1	80	0.0125000
NODE_4495_length_1139_cov_26.323077	308	388	7	1	80	0.0125000
NODE_4495_length_1139_cov_26.323077	308	388	8	28	80	0.3500000
NODE_4495_length_1139_cov_26.323077	308	388	9	39	80	0.4875000
NODE_4495_length_1139_cov_26.323077	361	441	6	18	80	0.2250000
NODE_4495_length_1139_cov_26.323077	361	441	8	33	80	0.4125000
NODE_4495_length_1139_cov_26.323077	361	441	9	28	80	0.3500000
NODE_4495_length_1139_cov_26.323077	361	441	10	1	80	0.0125000
NODE_4495_length_1139_cov_26.323077	437	517	2	18	80	0.2250000
NODE_4495_length_1139_cov_26.323077	437	517	3	33	80	0.4125000
NODE_4495_length_1139_cov_26.323077	437	517	4	2	80	0.0250000
NODE_4495_length_1139_cov_26.323077	437	517	5	9	80	0.1125000
NODE_4495_length_1139_cov_26.323077	437	517	6	18	80	0.2250000
NODE_4495_length_1139_cov_26.323077	490	570	1	31	80	0.3875000
NODE_4495_length_1139_cov_26.323077	490	570	2	40	80	0.5000000
NODE_4495_length_1139_cov_26.323077	490	570	3	9	80	0.1125000
NODE_4496_length_1139_cov_15.223077	530	610	8	5	80	0.0625000
NODE_4496_length_1139_cov_15.223077	530	610	9	6	80	0.0750000
NODE_4496_length_1139_cov_15.223077	530	610	10	68	80	0.8500000
NODE_4496_length_1139_cov_15.223077	530	610	11	1	80	0.0125000
NODE_4496_length_1139_cov_15.223077	583	663	1	2	80	0.0250000
NODE_4496_length_1139_cov_15.223077	583	663	2	6	80	0.0750000
NODE_4496_length_1139_cov_15.223077	583	663	3	21	80	0.2625000
NODE_4496_length_1139_cov_15.223077	583	663	4	10	80	0.1250000
NODE_4496_length_1139_cov_15.223077	583	663	5	2	80	0.0250000
NODE_4496_length_1139_cov_15.223077	583	663	8	17	80	0.2125000
NODE_4496_length_1139_cov_15.223077	583	663	9	6	80	0.0750000
NODE_4496_length_1139_cov_15.223077	583	663	10	15	80	0.1875000
NODE_4496_length_1139_cov_15.223077	583	663	11	1	80	0.0125000
NODE_4505_length_1138_cov_74.599615	480	560	13	18	80	0.2250000
NODE_4505_length_1138_cov_74.599615	480	560	14	30	80	0.3750000
NODE_4505_length_1138_cov_74.599615	480	560	15	31	80	0.3875000
NODE_4505_length_1138_cov_74.599615	480	560	16	1	80	0.0125000
NODE_4505_length_1138_cov_74.599615	533	613	8	4	80	0.0500000
NODE_4505_length_1138_cov_74.599615	533	613	9	15	80	0.1875000
NODE_4505_length_1138_cov_74.599615	533	613	10	12	80	0.1500000
NODE_4505_length_1138_cov_74.599615	533	613	11	16	80	0.2000000
NODE_4505_length_1138_cov_74.599615	533	613	13	9	80	0.1125000
NODE_4505_length_1138_cov_74.599615	533	613	14	12	80	0.1500000
NODE_4505_length_1138_cov_74.599615	533	613	15	12	80	0.1500000
NODE_4505_length_1138_cov_74.599615	609	689	3	5	80	0.0625000
NODE_4505_length_1138_cov_74.599615	609	689	5	21	80	0.2625000
NODE_4505_length_1138_cov_74.599615	609	689	6	18	80	0.2250000
NODE_4505_length_1138_cov_74.599615	609	689	7	28	80	0.3500000
NODE_4505_length_1138_cov_74.599615	609	689	8	8	80	0.1000000
NODE_4505_length_1138_cov_74.599615	662	742	1	10	80	0.1250000
NODE_4505_length_1138_cov_74.599615	662	742	2	3	80	0.0375000
NODE_4505_length_1138_cov_74.599615	662	742	3	45	80	0.5625000
NODE_4505_length_1138_cov_74.599615	662	742	5	21	80	0.2625000
NODE_4505_length_1138_cov_74.599615	662	742	6	1	80	0.0125000
NODE_4506_length_1138_cov_29.407122	559	639	0	80	80	1.0000000
NODE_4506_length_1138_cov_29.407122	612	692	0	80	80	1.0000000
NODE_4506_length_1138_cov_29.407122	688	768	0	80	80	1.0000000
NODE_4506_length_1138_cov_29.407122	741	821	0	80	80	1.0000000
NODE_4507_length_1138_cov_18.326275	454	534	5	1	80	0.0125000
NODE_4507_length_1138_cov_18.326275	454	534	12	7	80	0.0875000
NODE_4507_length_1138_cov_18.326275	454	534	13	11	80	0.1375000
NODE_4507_length_1138_cov_18.326275	454	534	14	61	80	0.7625000
NODE_4507_length_1138_cov_18.326275	507	587	10	13	80	0.1625000
NODE_4507_length_1138_cov_18.326275	507	587	11	4	80	0.0500000
NODE_4507_length_1138_cov_18.326275	507	587	13	5	80	0.0625000
NODE_4507_length_1138_cov_18.326275	507	587	14	58	80	0.7250000
NODE_4507_length_1138_cov_18.326275	583	663	2	5	80	0.0625000
NODE_4507_length_1138_cov_18.326275	583	663	3	7	80	0.0875000
NODE_4507_length_1138_cov_18.326275	583	663	4	38	80	0.4750000
NODE_4507_length_1138_cov_18.326275	583	663	5	8	80	0.1000000
NODE_4507_length_1138_cov_18.326275	583	663	10	9	80	0.1125000
NODE_4507_length_1138_cov_18.326275	583	663	12	13	80	0.1625000
NODE_4507_length_1138_cov_18.326275	636	716	4	53	80	0.6625000
NODE_4507_length_1138_cov_18.326275	636	716	6	27	80	0.3375000
NODE_4509_length_1138_cov_11.834456	291	371	3	17	80	0.2125000
NODE_4509_length_1138_cov_11.834456	291	371	4	2	80	0.0250000
NODE_4509_length_1138_cov_11.834456	291	371	5	61	80	0.7625000
NODE_4509_length_1138_cov_11.834456	344	424	3	3	80	0.0375000
NODE_4509_length_1138_cov_11.834456	344	424	4	38	80	0.4750000
NODE_4509_length_1138_cov_11.834456	344	424	5	39	80	0.4875000
NODE_4510_length_1138_cov_10.923003	318	398	5	1	80	0.0125000
NODE_4510_length_1138_cov_10.923003	318	398	8	1	80	0.0125000
NODE_4510_length_1138_cov_10.923003	318	398	9	15	80	0.1875000
NODE_4510_length_1138_cov_10.923003	318	398	10	13	80	0.1625000
NODE_4510_length_1138_cov_10.923003	318	398	11	2	80	0.0250000
NODE_4510_length_1138_cov_10.923003	318	398	12	6	80	0.0750000
NODE_4510_length_1138_cov_10.923003	318	398	14	10	80	0.1250000
NODE_4510_length_1138_cov_10.923003	318	398	16	32	80	0.4000000
NODE_4510_length_1138_cov_10.923003	371	451	13	4	80	0.0500000
NODE_4510_length_1138_cov_10.923003	371	451	15	37	80	0.4625000
NODE_4510_length_1138_cov_10.923003	371	451	16	39	80	0.4875000
NODE_4517_length_1137_cov_23.983622	470	550	6	11	80	0.1375000
NODE_4517_length_1137_cov_23.983622	470	550	8	20	80	0.2500000
NODE_4517_length_1137_cov_23.983622	470	550	9	1	80	0.0125000
NODE_4517_length_1137_cov_23.983622	470	550	10	10	80	0.1250000
NODE_4517_length_1137_cov_23.983622	470	550	11	3	80	0.0375000
NODE_4517_length_1137_cov_23.983622	470	550	12	29	80	0.3625000
NODE_4517_length_1137_cov_23.983622	470	550	13	6	80	0.0750000
NODE_4517_length_1137_cov_23.983622	523	603	12	70	80	0.8750000
NODE_4517_length_1137_cov_23.983622	523	603	13	10	80	0.1250000
NODE_4517_length_1137_cov_23.983622	599	679	2	8	80	0.1000000
NODE_4517_length_1137_cov_23.983622	599	679	4	12	80	0.1500000
NODE_4517_length_1137_cov_23.983622	599	679	8	20	80	0.2500000
NODE_4517_length_1137_cov_23.983622	599	679	10	35	80	0.4375000
NODE_4517_length_1137_cov_23.983622	599	679	12	5	80	0.0625000
NODE_4517_length_1137_cov_23.983622	652	732	1	44	80	0.5500000
NODE_4517_length_1137_cov_23.983622	652	732	2	17	80	0.2125000
NODE_4517_length_1137_cov_23.983622	652	732	4	12	80	0.1500000
NODE_4517_length_1137_cov_23.983622	652	732	8	7	80	0.0875000
NODE_4518_length_1137_cov_22.877649	405	485	1	14	80	0.1750000
NODE_4518_length_1137_cov_22.877649	405	485	2	32	80	0.4000000
NODE_4518_length_1137_cov_22.877649	405	485	3	34	80	0.4250000
NODE_4518_length_1137_cov_22.877649	458	538	3	27	80	0.3375000
NODE_4518_length_1137_cov_22.877649	458	538	7	14	80	0.1750000
NODE_4518_length_1137_cov_22.877649	458	538	9	4	80	0.0500000
NODE_4518_length_1137_cov_22.877649	458	538	10	35	80	0.4375000
NODE_4518_length_1137_cov_22.877649	534	614	10	10	80	0.1250000
NODE_4518_length_1137_cov_22.877649	534	614	11	1	80	0.0125000
NODE_4518_length_1137_cov_22.877649	534	614	12	21	80	0.2625000
NODE_4518_length_1137_cov_22.877649	534	614	13	20	80	0.2500000
NODE_4518_length_1137_cov_22.877649	534	614	14	2	80	0.0250000
NODE_4518_length_1137_cov_22.877649	534	614	15	26	80	0.3250000
NODE_4518_length_1137_cov_22.877649	587	667	8	1	80	0.0125000
NODE_4518_length_1137_cov_22.877649	587	667	9	7	80	0.0875000
NODE_4518_length_1137_cov_22.877649	587	667	10	10	80	0.1250000
NODE_4518_length_1137_cov_22.877649	587	667	11	14	80	0.1750000
NODE_4518_length_1137_cov_22.877649	587	667	13	33	80	0.4125000
NODE_4518_length_1137_cov_22.877649	587	667	15	15	80	0.1875000
NODE_4519_length_1137_cov_21.570328	383	463	8	6	80	0.0750000
NODE_4519_length_1137_cov_21.570328	383	463	9	21	80	0.2625000
NODE_4519_length_1137_cov_21.570328	383	463	11	34	80	0.4250000
NODE_4519_length_1137_cov_21.570328	383	463	12	19	80	0.2375000
NODE_4519_length_1137_cov_21.570328	436	516	4	6	80	0.0750000
NODE_4519_length_1137_cov_21.570328	436	516	7	1	80	0.0125000
NODE_4519_length_1137_cov_21.570328	436	516	8	15	80	0.1875000
NODE_4519_length_1137_cov_21.570328	436	516	9	51	80	0.6375000
NODE_4519_length_1137_cov_21.570328	436	516	11	7	80	0.0875000
NODE_4520_length_1137_cov_18.560694	665	745	11	15	80	0.1875000
NODE_4520_length_1137_cov_18.560694	665	745	14	1	80	0.0125000
NODE_4520_length_1137_cov_18.560694	665	745	15	7	80	0.0875000
NODE_4520_length_1137_cov_18.560694	665	745	16	26	80	0.3250000
NODE_4520_length_1137_cov_18.560694	665	745	17	18	80	0.2250000
NODE_4520_length_1137_cov_18.560694	665	745	18	2	80	0.0250000
NODE_4520_length_1137_cov_18.560694	665	745	19	11	80	0.1375000
NODE_4520_length_1137_cov_18.560694	718	798	13	14	80	0.1750000
NODE_4520_length_1137_cov_18.560694	718	798	14	3	80	0.0375000
NODE_4520_length_1137_cov_18.560694	718	798	16	24	80	0.3000000
NODE_4520_length_1137_cov_18.560694	718	798	17	30	80	0.3750000
NODE_4520_length_1137_cov_18.560694	718	798	18	2	80	0.0250000
NODE_4520_length_1137_cov_18.560694	718	798	19	7	80	0.0875000
NODE_4521_length_1137_cov_18.505780	557	637	9	1	80	0.0125000
NODE_4521_length_1137_cov_18.505780	557	637	10	2	80	0.0250000
NODE_4521_length_1137_cov_18.505780	557	637	11	28	80	0.3500000
NODE_4521_length_1137_cov_18.505780	557	637	12	5	80	0.0625000
NODE_4521_length_1137_cov_18.505780	557	637	13	30	80	0.3750000
NODE_4521_length_1137_cov_18.505780	557	637	14	1	80	0.0125000
NODE_4521_length_1137_cov_18.505780	557	637	15	13	80	0.1625000
NODE_4521_length_1137_cov_18.505780	610	690	2	4	80	0.0500000
NODE_4521_length_1137_cov_18.505780	610	690	3	6	80	0.0750000
NODE_4521_length_1137_cov_18.505780	610	690	4	7	80	0.0875000
NODE_4521_length_1137_cov_18.505780	610	690	6	13	80	0.1625000
NODE_4521_length_1137_cov_18.505780	610	690	7	8	80	0.1000000
NODE_4521_length_1137_cov_18.505780	610	690	8	1	80	0.0125000
NODE_4521_length_1137_cov_18.505780	610	690	9	15	80	0.1875000
NODE_4521_length_1137_cov_18.505780	610	690	10	2	80	0.0250000
NODE_4521_length_1137_cov_18.505780	610	690	11	24	80	0.3000000
NODE_4521_length_1137_cov_18.505780	686	766	1	10	80	0.1250000
NODE_4521_length_1137_cov_18.505780	686	766	3	70	80	0.8750000
NODE_4521_length_1137_cov_18.505780	739	819	1	63	80	0.7875000
NODE_4521_length_1137_cov_18.505780	739	819	3	17	80	0.2125000
NODE_4523_length_1137_cov_11.866089	313	393	7	4	80	0.0500000
NODE_4523_length_1137_cov_11.866089	313	393	8	12	80	0.1500000
NODE_4523_length_1137_cov_11.866089	313	393	10	28	80	0.3500000
NODE_4523_length_1137_cov_11.866089	313	393	12	23	80	0.2875000
NODE_4523_length_1137_cov_11.866089	313	393	13	13	80	0.1625000
NODE_4523_length_1137_cov_11.866089	366	446	2	7	80	0.0875000
NODE_4523_length_1137_cov_11.866089	366	446	6	15	80	0.1875000
NODE_4523_length_1137_cov_11.866089	366	446	7	4	80	0.0500000
NODE_4523_length_1137_cov_11.866089	366	446	8	43	80	0.5375000
NODE_4523_length_1137_cov_11.866089	366	446	10	11	80	0.1375000
NODE_4523_length_1137_cov_11.866089	442	522	1	14	80	0.1750000
NODE_4523_length_1137_cov_11.866089	442	522	2	15	80	0.1875000
NODE_4523_length_1137_cov_11.866089	442	522	3	6	80	0.0750000
NODE_4523_length_1137_cov_11.866089	442	522	5	45	80	0.5625000
NODE_4523_length_1137_cov_11.866089	495	575	4	34	80	0.4250000
NODE_4523_length_1137_cov_11.866089	495	575	5	36	80	0.4500000
NODE_4523_length_1137_cov_11.866089	495	575	6	10	80	0.1250000
NODE_4524_length_1137_cov_5.594412	144	224	8	72	80	0.9000000
NODE_4524_length_1137_cov_5.594412	144	224	10	8	80	0.1000000
NODE_4524_length_1137_cov_5.594412	197	277	5	4	80	0.0500000
NODE_4524_length_1137_cov_5.594412	197	277	7	32	80	0.4000000
NODE_4524_length_1137_cov_5.594412	197	277	8	19	80	0.2375000
NODE_4524_length_1137_cov_5.594412	197	277	9	1	80	0.0125000
NODE_4524_length_1137_cov_5.594412	197	277	10	24	80	0.3000000
NODE_4532_length_1136_cov_42.827387	445	525	2	80	80	1.0000000
NODE_4532_length_1136_cov_42.827387	498	578	1	9	80	0.1125000
NODE_4532_length_1136_cov_42.827387	498	578	2	58	80	0.7250000
NODE_4532_length_1136_cov_42.827387	498	578	3	13	80	0.1625000
NODE_4532_length_1136_cov_42.827387	574	654	2	76	80	0.9500000
NODE_4532_length_1136_cov_42.827387	574	654	3	4	80	0.0500000
NODE_4532_length_1136_cov_42.827387	627	707	2	37	80	0.4625000
NODE_4532_length_1136_cov_42.827387	627	707	3	43	80	0.5375000
NODE_4533_length_1136_cov_30.940212	534	614	0	80	80	1.0000000
NODE_4533_length_1136_cov_30.940212	587	667	0	80	80	1.0000000
NODE_4533_length_1136_cov_30.940212	663	743	0	5	80	0.0625000
NODE_4533_length_1136_cov_30.940212	663	743	1	17	80	0.2125000
NODE_4533_length_1136_cov_30.940212	663	743	3	7	80	0.0875000
NODE_4533_length_1136_cov_30.940212	663	743	5	51	80	0.6375000
NODE_4533_length_1136_cov_30.940212	716	796	5	35	80	0.4375000
NODE_4533_length_1136_cov_30.940212	716	796	7	3	80	0.0375000
NODE_4533_length_1136_cov_30.940212	716	796	8	13	80	0.1625000
NODE_4533_length_1136_cov_30.940212	716	796	9	23	80	0.2875000
NODE_4533_length_1136_cov_30.940212	716	796	10	6	80	0.0750000
NODE_4534_length_1136_cov_30.797493	557	637	24	6	80	0.0750000
NODE_4534_length_1136_cov_30.797493	557	637	26	3	80	0.0375000
NODE_4534_length_1136_cov_30.797493	557	637	27	2	80	0.0250000
NODE_4534_length_1136_cov_30.797493	557	637	29	10	80	0.1250000
NODE_4534_length_1136_cov_30.797493	557	637	30	3	80	0.0375000
NODE_4534_length_1136_cov_30.797493	557	637	31	21	80	0.2625000
NODE_4534_length_1136_cov_30.797493	557	637	32	8	80	0.1000000
NODE_4534_length_1136_cov_30.797493	557	637	33	27	80	0.3375000
NODE_4534_length_1136_cov_30.797493	610	691	14	9	81	0.1111111
NODE_4534_length_1136_cov_30.797493	610	691	15	8	81	0.0987654
NODE_4534_length_1136_cov_30.797493	610	691	16	9	81	0.1111111
NODE_4534_length_1136_cov_30.797493	610	691	19	3	81	0.0370370
NODE_4534_length_1136_cov_30.797493	610	691	20	20	81	0.2469136
NODE_4534_length_1136_cov_30.797493	610	691	21	5	81	0.0617284
NODE_4534_length_1136_cov_30.797493	610	691	24	6	81	0.0740741
NODE_4534_length_1136_cov_30.797493	610	691	26	1	81	0.0123457
NODE_4534_length_1136_cov_30.797493	610	691	29	9	81	0.1111111
NODE_4534_length_1136_cov_30.797493	610	691	30	2	81	0.0246914
NODE_4534_length_1136_cov_30.797493	610	691	31	7	81	0.0864198
NODE_4534_length_1136_cov_30.797493	610	691	33	2	81	0.0246914
NODE_4534_length_1136_cov_30.797493	687	767	1	2	80	0.0250000
NODE_4534_length_1136_cov_30.797493	687	767	2	12	80	0.1500000
NODE_4534_length_1136_cov_30.797493	687	767	4	15	80	0.1875000
NODE_4534_length_1136_cov_30.797493	687	767	5	1	80	0.0125000
NODE_4534_length_1136_cov_30.797493	687	767	6	16	80	0.2000000
NODE_4534_length_1136_cov_30.797493	687	767	9	8	80	0.1000000
NODE_4534_length_1136_cov_30.797493	687	767	12	3	80	0.0375000
NODE_4534_length_1136_cov_30.797493	687	767	13	2	80	0.0250000
NODE_4534_length_1136_cov_30.797493	687	767	15	21	80	0.2625000
NODE_4534_length_1136_cov_30.797493	740	820	1	17	80	0.2125000
NODE_4534_length_1136_cov_30.797493	740	820	2	12	80	0.1500000
NODE_4534_length_1136_cov_30.797493	740	820	3	38	80	0.4750000
NODE_4534_length_1136_cov_30.797493	740	820	4	13	80	0.1625000
NODE_4535_length_1136_cov_23.142719	704	784	7	7	80	0.0875000
NODE_4535_length_1136_cov_23.142719	704	784	8	18	80	0.2250000
NODE_4535_length_1136_cov_23.142719	704	784	9	38	80	0.4750000
NODE_4535_length_1136_cov_23.142719	704	784	10	8	80	0.1000000
NODE_4535_length_1136_cov_23.142719	704	784	11	9	80	0.1125000
NODE_4535_length_1136_cov_23.142719	757	837	8	9	80	0.1125000
NODE_4535_length_1136_cov_23.142719	757	837	9	25	80	0.3125000
NODE_4535_length_1136_cov_23.142719	757	837	10	37	80	0.4625000
NODE_4535_length_1136_cov_23.142719	757	837	11	9	80	0.1125000
NODE_4536_length_1136_cov_21.798457	570	651	1	4	81	0.0493827
NODE_4536_length_1136_cov_21.798457	570	651	2	26	81	0.3209876
NODE_4536_length_1136_cov_21.798457	570	651	3	6	81	0.0740741
NODE_4536_length_1136_cov_21.798457	570	651	4	45	81	0.5555556
NODE_4536_length_1136_cov_21.798457	624	704	0	32	80	0.4000000
NODE_4536_length_1136_cov_21.798457	624	704	1	25	80	0.3125000
NODE_4536_length_1136_cov_21.798457	624	704	2	23	80	0.2875000
NODE_4537_length_1136_cov_21.109932	460	532	7	16	72	0.2222222
NODE_4537_length_1136_cov_21.109932	460	532	8	5	72	0.0694444
NODE_4537_length_1136_cov_21.109932	460	532	9	21	72	0.2916667
NODE_4537_length_1136_cov_21.109932	460	532	10	30	72	0.4166667
NODE_4537_length_1136_cov_21.109932	505	585	6	4	80	0.0500000
NODE_4537_length_1136_cov_21.109932	505	585	8	3	80	0.0375000
NODE_4537_length_1136_cov_21.109932	505	585	9	20	80	0.2500000
NODE_4537_length_1136_cov_21.109932	505	585	10	53	80	0.6625000
NODE_4538_length_1136_cov_20.528447	19	99	2	2	80	0.0250000
NODE_4538_length_1136_cov_20.528447	19	99	3	3	80	0.0375000
NODE_4538_length_1136_cov_20.528447	19	99	5	35	80	0.4375000
NODE_4538_length_1136_cov_20.528447	19	99	6	37	80	0.4625000
NODE_4538_length_1136_cov_20.528447	19	99	7	3	80	0.0375000
NODE_4538_length_1136_cov_20.528447	19	99	2	2	80	0.0250000
NODE_4538_length_1136_cov_20.528447	19	99	3	3	80	0.0375000
NODE_4538_length_1136_cov_20.528447	19	99	5	35	80	0.4375000
NODE_4538_length_1136_cov_20.528447	19	99	6	37	80	0.4625000
NODE_4538_length_1136_cov_20.528447	19	99	7	3	80	0.0375000
NODE_4538_length_1136_cov_20.528447	28	99	5	31	71	0.4366197
NODE_4538_length_1136_cov_20.528447	28	99	6	37	71	0.5211267
NODE_4538_length_1136_cov_20.528447	28	99	7	3	71	0.0422535
NODE_4538_length_1136_cov_20.528447	877	912	0	35	35	1.0000000
NODE_4538_length_1136_cov_20.528447	879	921	0	42	42	1.0000000
NODE_4539_length_1136_cov_14.921890	657	737	0	49	80	0.6125000
NODE_4539_length_1136_cov_14.921890	657	737	1	31	80	0.3875000
NODE_4539_length_1136_cov_14.921890	710	790	1	32	80	0.4000000
NODE_4539_length_1136_cov_14.921890	710	790	2	48	80	0.6000000
NODE_4556_length_1135_cov_100.121622	454	534	10	5	80	0.0625000
NODE_4556_length_1135_cov_100.121622	454	534	11	22	80	0.2750000
NODE_4556_length_1135_cov_100.121622	454	534	12	19	80	0.2375000
NODE_4556_length_1135_cov_100.121622	454	534	13	19	80	0.2375000
NODE_4556_length_1135_cov_100.121622	454	534	15	8	80	0.1000000
NODE_4556_length_1135_cov_100.121622	454	534	17	2	80	0.0250000
NODE_4556_length_1135_cov_100.121622	454	534	18	5	80	0.0625000
NODE_4556_length_1135_cov_100.121622	507	587	12	1	80	0.0125000
NODE_4556_length_1135_cov_100.121622	507	587	13	11	80	0.1375000
NODE_4556_length_1135_cov_100.121622	507	587	15	8	80	0.1000000
NODE_4556_length_1135_cov_100.121622	507	587	17	2	80	0.0250000
NODE_4556_length_1135_cov_100.121622	507	587	18	5	80	0.0625000
NODE_4556_length_1135_cov_100.121622	507	587	20	13	80	0.1625000
NODE_4556_length_1135_cov_100.121622	507	587	21	16	80	0.2000000
NODE_4556_length_1135_cov_100.121622	507	587	22	8	80	0.1000000
NODE_4556_length_1135_cov_100.121622	507	587	23	12	80	0.1500000
NODE_4556_length_1135_cov_100.121622	507	587	24	1	80	0.0125000
NODE_4556_length_1135_cov_100.121622	507	587	25	3	80	0.0375000
NODE_4556_length_1135_cov_100.121622	583	663	21	7	80	0.0875000
NODE_4556_length_1135_cov_100.121622	583	663	22	7	80	0.0875000
NODE_4556_length_1135_cov_100.121622	583	663	23	1	80	0.0125000
NODE_4556_length_1135_cov_100.121622	583	663	27	4	80	0.0500000
NODE_4556_length_1135_cov_100.121622	583	663	28	3	80	0.0375000
NODE_4556_length_1135_cov_100.121622	583	663	29	15	80	0.1875000
NODE_4556_length_1135_cov_100.121622	583	663	30	4	80	0.0500000
NODE_4556_length_1135_cov_100.121622	583	663	31	12	80	0.1500000
NODE_4556_length_1135_cov_100.121622	583	663	32	4	80	0.0500000
NODE_4556_length_1135_cov_100.121622	583	663	33	10	80	0.1250000
NODE_4556_length_1135_cov_100.121622	583	663	34	13	80	0.1625000
NODE_4556_length_1135_cov_100.121622	636	719	27	4	83	0.0481928
NODE_4556_length_1135_cov_100.121622	636	719	28	6	83	0.0722892
NODE_4556_length_1135_cov_100.121622	636	719	29	7	83	0.0843373
NODE_4556_length_1135_cov_100.121622	636	719	30	7	83	0.0843373
NODE_4556_length_1135_cov_100.121622	636	719	31	30	83	0.3614458
NODE_4556_length_1135_cov_100.121622	636	719	32	4	83	0.0481928
NODE_4556_length_1135_cov_100.121622	636	719	33	4	83	0.0481928
NODE_4556_length_1135_cov_100.121622	636	719	34	21	83	0.2530121
NODE_4557_length_1135_cov_34.523166	313	393	6	13	80	0.1625000
NODE_4557_length_1135_cov_34.523166	313	393	7	1	80	0.0125000
NODE_4557_length_1135_cov_34.523166	313	393	9	7	80	0.0875000
NODE_4557_length_1135_cov_34.523166	313	393	10	10	80	0.1250000
NODE_4557_length_1135_cov_34.523166	313	393	11	49	80	0.6125000
NODE_4557_length_1135_cov_34.523166	366	446	5	42	80	0.5250000
NODE_4557_length_1135_cov_34.523166	366	446	6	13	80	0.1625000
NODE_4557_length_1135_cov_34.523166	366	446	7	12	80	0.1500000
NODE_4557_length_1135_cov_34.523166	366	446	9	7	80	0.0875000
NODE_4557_length_1135_cov_34.523166	366	446	10	6	80	0.0750000
NODE_4558_length_1135_cov_20.735521	484	564	18	27	80	0.3375000
NODE_4558_length_1135_cov_20.735521	484	564	19	8	80	0.1000000
NODE_4558_length_1135_cov_20.735521	484	564	20	39	80	0.4875000
NODE_4558_length_1135_cov_20.735521	484	564	23	4	80	0.0500000
NODE_4558_length_1135_cov_20.735521	484	564	25	2	80	0.0250000
NODE_4558_length_1135_cov_20.735521	537	617	18	24	80	0.3000000
NODE_4558_length_1135_cov_20.735521	537	617	19	6	80	0.0750000
NODE_4558_length_1135_cov_20.735521	537	617	22	12	80	0.1500000
NODE_4558_length_1135_cov_20.735521	537	617	23	25	80	0.3125000
NODE_4558_length_1135_cov_20.735521	537	617	24	11	80	0.1375000
NODE_4558_length_1135_cov_20.735521	537	617	25	2	80	0.0250000
NODE_4558_length_1135_cov_20.735521	613	693	10	23	80	0.2875000
NODE_4558_length_1135_cov_20.735521	613	693	11	31	80	0.3875000
NODE_4558_length_1135_cov_20.735521	613	693	12	21	80	0.2625000
NODE_4558_length_1135_cov_20.735521	613	693	19	5	80	0.0625000
NODE_4558_length_1135_cov_20.735521	666	746	1	1	80	0.0125000
NODE_4558_length_1135_cov_20.735521	666	746	2	25	80	0.3125000
NODE_4558_length_1135_cov_20.735521	666	746	3	12	80	0.1500000
NODE_4558_length_1135_cov_20.735521	666	746	10	38	80	0.4750000
NODE_4558_length_1135_cov_20.735521	666	746	11	4	80	0.0500000
NODE_4559_length_1135_cov_9.644788	620	700	3	9	80	0.1125000
NODE_4559_length_1135_cov_9.644788	620	700	4	7	80	0.0875000
NODE_4559_length_1135_cov_9.644788	620	700	6	64	80	0.8000000
NODE_4559_length_1135_cov_9.644788	673	753	0	5	80	0.0625000
NODE_4559_length_1135_cov_9.644788	673	753	1	15	80	0.1875000
NODE_4559_length_1135_cov_9.644788	673	753	2	18	80	0.2250000
NODE_4559_length_1135_cov_9.644788	673	753	3	24	80	0.3000000
NODE_4559_length_1135_cov_9.644788	673	753	4	7	80	0.0875000
NODE_4559_length_1135_cov_9.644788	673	753	6	11	80	0.1375000
NODE_4562_length_1135_cov_2.990347	349	429	1	62	80	0.7750000
NODE_4562_length_1135_cov_2.990347	349	429	2	5	80	0.0625000
NODE_4562_length_1135_cov_2.990347	349	429	4	13	80	0.1625000
NODE_4562_length_1135_cov_2.990347	402	482	1	9	80	0.1125000
NODE_4562_length_1135_cov_2.990347	402	482	2	5	80	0.0625000
NODE_4562_length_1135_cov_2.990347	402	482	3	41	80	0.5125000
NODE_4562_length_1135_cov_2.990347	402	482	4	25	80	0.3125000
NODE_4571_length_1134_cov_34.784541	478	558	0	80	80	1.0000000
NODE_4571_length_1134_cov_34.784541	531	611	0	74	80	0.9250000
NODE_4571_length_1134_cov_34.784541	531	611	2	6	80	0.0750000
NODE_4571_length_1134_cov_34.784541	607	687	2	26	80	0.3250000
NODE_4571_length_1134_cov_34.784541	607	687	3	1	80	0.0125000
NODE_4571_length_1134_cov_34.784541	607	687	4	30	80	0.3750000
NODE_4571_length_1134_cov_34.784541	607	687	6	11	80	0.1375000
NODE_4571_length_1134_cov_34.784541	607	687	9	12	80	0.1500000
NODE_4571_length_1134_cov_34.784541	660	740	4	4	80	0.0500000
NODE_4571_length_1134_cov_34.784541	660	740	6	11	80	0.1375000
NODE_4571_length_1134_cov_34.784541	660	740	9	40	80	0.5000000
NODE_4571_length_1134_cov_34.784541	660	740	11	25	80	0.3125000
NODE_4572_length_1134_cov_28.524638	511	591	4	26	80	0.3250000
NODE_4572_length_1134_cov_28.524638	511	591	5	54	80	0.6750000
NODE_4572_length_1134_cov_28.524638	564	644	0	10	80	0.1250000
NODE_4572_length_1134_cov_28.524638	564	644	2	22	80	0.2750000
NODE_4572_length_1134_cov_28.524638	564	644	4	47	80	0.5875000
NODE_4572_length_1134_cov_28.524638	564	644	5	1	80	0.0125000
NODE_4572_length_1134_cov_28.524638	640	720	4	37	80	0.4625000
NODE_4572_length_1134_cov_28.524638	640	720	5	17	80	0.2125000
NODE_4572_length_1134_cov_28.524638	640	720	9	26	80	0.3250000
NODE_4572_length_1134_cov_28.524638	693	773	5	1	80	0.0125000
NODE_4572_length_1134_cov_28.524638	693	773	8	10	80	0.1250000
NODE_4572_length_1134_cov_28.524638	693	773	9	69	80	0.8625000
NODE_4576_length_1134_cov_2.619324	606	686	0	80	80	1.0000000
NODE_4576_length_1134_cov_2.619324	659	739	0	80	80	1.0000000
NODE_4584_length_1133_cov_5.563830	292	372	0	80	80	1.0000000
NODE_4584_length_1133_cov_5.563830	345	425	0	80	80	1.0000000
NODE_4584_length_1133_cov_5.563830	904	966	0	62	62	1.0000000
NODE_4592_length_1132_cov_23.121007	485	565	4	29	80	0.3625000
NODE_4592_length_1132_cov_23.121007	485	565	13	21	80	0.2625000
NODE_4592_length_1132_cov_23.121007	485	565	14	30	80	0.3750000
NODE_4592_length_1132_cov_23.121007	538	618	9	4	80	0.0500000
NODE_4592_length_1132_cov_23.121007	538	618	10	3	80	0.0375000
NODE_4592_length_1132_cov_23.121007	538	618	13	19	80	0.2375000
NODE_4592_length_1132_cov_23.121007	538	618	14	54	80	0.6750000
NODE_4592_length_1132_cov_23.121007	618	664	7	1	46	0.0217391
NODE_4592_length_1132_cov_23.121007	618	664	8	1	46	0.0217391
NODE_4592_length_1132_cov_23.121007	618	664	9	44	46	0.9565217
NODE_4592_length_1132_cov_23.121007	700	751	8	1	51	0.0196078
NODE_4592_length_1132_cov_23.121007	700	751	9	2	51	0.0392157
NODE_4592_length_1132_cov_23.121007	700	751	10	48	51	0.9411765
NODE_4593_length_1132_cov_19.377541	595	675	9	1	80	0.0125000
NODE_4593_length_1132_cov_19.377541	595	675	10	14	80	0.1750000
NODE_4593_length_1132_cov_19.377541	595	675	11	26	80	0.3250000
NODE_4593_length_1132_cov_19.377541	595	675	12	10	80	0.1250000
NODE_4593_length_1132_cov_19.377541	595	675	13	1	80	0.0125000
NODE_4593_length_1132_cov_19.377541	595	675	15	28	80	0.3500000
NODE_4593_length_1132_cov_19.377541	648	728	11	1	80	0.0125000
NODE_4593_length_1132_cov_19.377541	648	728	12	3	80	0.0375000
NODE_4593_length_1132_cov_19.377541	648	728	13	17	80	0.2125000
NODE_4593_length_1132_cov_19.377541	648	728	14	28	80	0.3500000
NODE_4593_length_1132_cov_19.377541	648	728	15	31	80	0.3875000
NODE_4594_length_1132_cov_18.872217	363	443	3	17	80	0.2125000
NODE_4594_length_1132_cov_18.872217	363	443	4	17	80	0.2125000
NODE_4594_length_1132_cov_18.872217	363	443	5	33	80	0.4125000
NODE_4594_length_1132_cov_18.872217	363	443	7	10	80	0.1250000
NODE_4594_length_1132_cov_18.872217	363	443	8	3	80	0.0375000
NODE_4594_length_1132_cov_18.872217	416	496	5	21	80	0.2625000
NODE_4594_length_1132_cov_18.872217	416	496	6	1	80	0.0125000
NODE_4594_length_1132_cov_18.872217	416	496	7	55	80	0.6875000
NODE_4594_length_1132_cov_18.872217	416	496	8	3	80	0.0375000
NODE_4595_length_1132_cov_11.242982	474	554	3	11	80	0.1375000
NODE_4595_length_1132_cov_11.242982	474	554	4	37	80	0.4625000
NODE_4595_length_1132_cov_11.242982	474	554	5	32	80	0.4000000
NODE_4595_length_1132_cov_11.242982	527	607	1	20	80	0.2500000
NODE_4595_length_1132_cov_11.242982	527	607	2	26	80	0.3250000
NODE_4595_length_1132_cov_11.242982	527	607	3	18	80	0.2250000
NODE_4595_length_1132_cov_11.242982	527	607	4	16	80	0.2000000
NODE_4596_length_1132_cov_7.356244	354	434	0	34	80	0.4250000
NODE_4596_length_1132_cov_7.356244	354	434	2	46	80	0.5750000
NODE_4596_length_1132_cov_7.356244	407	487	2	55	80	0.6875000
NODE_4596_length_1132_cov_7.356244	407	487	4	25	80	0.3125000
NODE_4597_length_1132_cov_6.214908	269	349	3	9	80	0.1125000
NODE_4597_length_1132_cov_6.214908	269	349	4	9	80	0.1125000
NODE_4597_length_1132_cov_6.214908	269	349	5	62	80	0.7750000
NODE_4597_length_1132_cov_6.214908	322	402	1	6	80	0.0750000
NODE_4597_length_1132_cov_6.214908	322	402	3	56	80	0.7000000
NODE_4597_length_1132_cov_6.214908	322	402	5	18	80	0.2250000
NODE_4606_length_1131_cov_36.161822	478	558	11	3	80	0.0375000
NODE_4606_length_1131_cov_36.161822	478	558	12	14	80	0.1750000
NODE_4606_length_1131_cov_36.161822	478	558	13	36	80	0.4500000
NODE_4606_length_1131_cov_36.161822	478	558	14	5	80	0.0625000
NODE_4606_length_1131_cov_36.161822	478	558	15	16	80	0.2000000
NODE_4606_length_1131_cov_36.161822	478	558	16	6	80	0.0750000
NODE_4606_length_1131_cov_36.161822	531	611	8	9	80	0.1125000
NODE_4606_length_1131_cov_36.161822	531	611	9	6	80	0.0750000
NODE_4606_length_1131_cov_36.161822	531	611	10	11	80	0.1375000
NODE_4606_length_1131_cov_36.161822	531	611	12	5	80	0.0625000
NODE_4606_length_1131_cov_36.161822	531	611	13	49	80	0.6125000
NODE_4606_length_1131_cov_36.161822	607	687	7	4	80	0.0500000
NODE_4606_length_1131_cov_36.161822	607	687	8	6	80	0.0750000
NODE_4606_length_1131_cov_36.161822	607	687	9	5	80	0.0625000
NODE_4606_length_1131_cov_36.161822	607	687	12	5	80	0.0625000
NODE_4606_length_1131_cov_36.161822	607	687	13	13	80	0.1625000
NODE_4606_length_1131_cov_36.161822	607	687	14	6	80	0.0750000
NODE_4606_length_1131_cov_36.161822	607	687	15	2	80	0.0250000
NODE_4606_length_1131_cov_36.161822	607	687	16	17	80	0.2125000
NODE_4606_length_1131_cov_36.161822	607	687	17	8	80	0.1000000
NODE_4606_length_1131_cov_36.161822	607	687	18	14	80	0.1750000
NODE_4606_length_1131_cov_36.161822	660	740	16	6	80	0.0750000
NODE_4606_length_1131_cov_36.161822	660	740	17	7	80	0.0875000
NODE_4606_length_1131_cov_36.161822	660	740	18	15	80	0.1875000
NODE_4606_length_1131_cov_36.161822	660	740	20	21	80	0.2625000
NODE_4606_length_1131_cov_36.161822	660	740	22	2	80	0.0250000
NODE_4606_length_1131_cov_36.161822	660	740	24	4	80	0.0500000
NODE_4606_length_1131_cov_36.161822	660	740	25	16	80	0.2000000
NODE_4606_length_1131_cov_36.161822	660	740	26	1	80	0.0125000
NODE_4606_length_1131_cov_36.161822	660	740	28	5	80	0.0625000
NODE_4606_length_1131_cov_36.161822	660	740	30	3	80	0.0375000
NODE_4607_length_1131_cov_31.907946	390	470	9	1	80	0.0125000
NODE_4607_length_1131_cov_31.907946	390	470	11	9	80	0.1125000
NODE_4607_length_1131_cov_31.907946	390	470	12	36	80	0.4500000
NODE_4607_length_1131_cov_31.907946	390	470	14	16	80	0.2000000
NODE_4607_length_1131_cov_31.907946	390	470	15	1	80	0.0125000
NODE_4607_length_1131_cov_31.907946	390	470	17	17	80	0.2125000
NODE_4607_length_1131_cov_31.907946	443	523	11	16	80	0.2000000
NODE_4607_length_1131_cov_31.907946	443	523	13	18	80	0.2250000
NODE_4607_length_1131_cov_31.907946	443	523	14	9	80	0.1125000
NODE_4607_length_1131_cov_31.907946	443	523	15	12	80	0.1500000
NODE_4607_length_1131_cov_31.907946	443	523	16	2	80	0.0250000
NODE_4607_length_1131_cov_31.907946	443	523	17	23	80	0.2875000
NODE_4607_length_1131_cov_31.907946	519	599	6	18	80	0.2250000
NODE_4607_length_1131_cov_31.907946	519	599	7	35	80	0.4375000
NODE_4607_length_1131_cov_31.907946	519	599	8	1	80	0.0125000
NODE_4607_length_1131_cov_31.907946	519	599	9	14	80	0.1750000
NODE_4607_length_1131_cov_31.907946	519	599	11	12	80	0.1500000
NODE_4607_length_1131_cov_31.907946	572	652	3	15	80	0.1875000
NODE_4607_length_1131_cov_31.907946	572	652	4	34	80	0.4250000
NODE_4607_length_1131_cov_31.907946	572	652	6	9	80	0.1125000
NODE_4607_length_1131_cov_31.907946	572	652	7	21	80	0.2625000
NODE_4607_length_1131_cov_31.907946	572	652	8	1	80	0.0125000
NODE_4608_length_1131_cov_26.827519	464	544	2	8	80	0.1000000
NODE_4608_length_1131_cov_26.827519	464	544	3	8	80	0.1000000
NODE_4608_length_1131_cov_26.827519	464	544	4	4	80	0.0500000
NODE_4608_length_1131_cov_26.827519	464	544	5	6	80	0.0750000
NODE_4608_length_1131_cov_26.827519	464	544	6	54	80	0.6750000
NODE_4608_length_1131_cov_26.827519	517	597	4	4	80	0.0500000
NODE_4608_length_1131_cov_26.827519	517	597	5	33	80	0.4125000
NODE_4608_length_1131_cov_26.827519	517	597	6	43	80	0.5375000
NODE_4609_length_1131_cov_20.441860	555	635	2	79	80	0.9875000
NODE_4609_length_1131_cov_20.441860	555	635	3	1	80	0.0125000
NODE_4609_length_1131_cov_20.441860	608	688	1	3	80	0.0375000
NODE_4609_length_1131_cov_20.441860	608	688	2	77	80	0.9625000
NODE_4610_length_1131_cov_12.517442	420	500	5	30	80	0.3750000
NODE_4610_length_1131_cov_12.517442	420	500	6	2	80	0.0250000
NODE_4610_length_1131_cov_12.517442	420	500	7	10	80	0.1250000
NODE_4610_length_1131_cov_12.517442	420	500	9	38	80	0.4750000
NODE_4610_length_1131_cov_12.517442	473	553	6	14	80	0.1750000
NODE_4610_length_1131_cov_12.517442	473	553	7	5	80	0.0625000
NODE_4610_length_1131_cov_12.517442	473	553	9	61	80	0.7625000
NODE_4611_length_1131_cov_10.912791	429	509	2	25	80	0.3125000
NODE_4611_length_1131_cov_10.912791	429	509	4	55	80	0.6875000
NODE_4611_length_1131_cov_10.912791	482	562	0	4	80	0.0500000
NODE_4611_length_1131_cov_10.912791	482	562	2	74	80	0.9250000
NODE_4611_length_1131_cov_10.912791	482	562	4	2	80	0.0250000
NODE_4620_length_1130_cov_43.354995	742	822	8	2	80	0.0250000
NODE_4620_length_1130_cov_43.354995	742	822	10	35	80	0.4375000
NODE_4620_length_1130_cov_43.354995	742	822	12	6	80	0.0750000
NODE_4620_length_1130_cov_43.354995	742	822	13	37	80	0.4625000
NODE_4620_length_1130_cov_43.354995	795	875	3	7	80	0.0875000
NODE_4620_length_1130_cov_43.354995	795	875	5	14	80	0.1750000
NODE_4620_length_1130_cov_43.354995	795	875	7	8	80	0.1000000
NODE_4620_length_1130_cov_43.354995	795	875	8	26	80	0.3250000
NODE_4620_length_1130_cov_43.354995	795	875	10	4	80	0.0500000
NODE_4620_length_1130_cov_43.354995	795	875	12	4	80	0.0500000
NODE_4620_length_1130_cov_43.354995	795	875	13	17	80	0.2125000
NODE_4621_length_1130_cov_13.097963	642	722	10	5	80	0.0625000
NODE_4621_length_1130_cov_13.097963	642	722	11	11	80	0.1375000
NODE_4621_length_1130_cov_13.097963	642	722	18	3	80	0.0375000
NODE_4621_length_1130_cov_13.097963	642	722	19	24	80	0.3000000
NODE_4621_length_1130_cov_13.097963	642	722	20	6	80	0.0750000
NODE_4621_length_1130_cov_13.097963	642	722	22	4	80	0.0500000
NODE_4621_length_1130_cov_13.097963	642	722	23	1	80	0.0125000
NODE_4621_length_1130_cov_13.097963	642	722	24	6	80	0.0750000
NODE_4621_length_1130_cov_13.097963	642	722	26	5	80	0.0625000
NODE_4621_length_1130_cov_13.097963	642	722	27	8	80	0.1000000
NODE_4621_length_1130_cov_13.097963	642	722	31	3	80	0.0375000
NODE_4621_length_1130_cov_13.097963	642	722	33	2	80	0.0250000
NODE_4621_length_1130_cov_13.097963	642	722	34	2	80	0.0250000
NODE_4621_length_1130_cov_13.097963	695	775	23	1	80	0.0125000
NODE_4621_length_1130_cov_13.097963	695	775	24	6	80	0.0750000
NODE_4621_length_1130_cov_13.097963	695	775	26	5	80	0.0625000
NODE_4621_length_1130_cov_13.097963	695	775	27	8	80	0.1000000
NODE_4621_length_1130_cov_13.097963	695	775	31	3	80	0.0375000
NODE_4621_length_1130_cov_13.097963	695	775	33	12	80	0.1500000
NODE_4621_length_1130_cov_13.097963	695	775	34	18	80	0.2250000
NODE_4621_length_1130_cov_13.097963	695	775	35	4	80	0.0500000
NODE_4621_length_1130_cov_13.097963	695	775	36	1	80	0.0125000
NODE_4621_length_1130_cov_13.097963	695	775	38	10	80	0.1250000
NODE_4621_length_1130_cov_13.097963	695	775	40	12	80	0.1500000
NODE_4626_length_1129_cov_31.088350	396	476	2	23	80	0.2875000
NODE_4626_length_1129_cov_31.088350	396	476	3	2	80	0.0250000
NODE_4626_length_1129_cov_31.088350	396	476	4	55	80	0.6875000
NODE_4626_length_1129_cov_31.088350	449	529	1	44	80	0.5500000
NODE_4626_length_1129_cov_31.088350	449	529	2	32	80	0.4000000
NODE_4626_length_1129_cov_31.088350	449	529	3	2	80	0.0250000
NODE_4626_length_1129_cov_31.088350	449	529	4	2	80	0.0250000
NODE_4627_length_1129_cov_20.591262	450	530	5	30	80	0.3750000
NODE_4627_length_1129_cov_20.591262	450	530	7	19	80	0.2375000
NODE_4627_length_1129_cov_20.591262	450	530	8	31	80	0.3875000
NODE_4627_length_1129_cov_20.591262	503	583	8	40	80	0.5000000
NODE_4627_length_1129_cov_20.591262	503	583	10	29	80	0.3625000
NODE_4627_length_1129_cov_20.591262	503	583	12	11	80	0.1375000
NODE_4628_length_1129_cov_16.934951	261	341	15	5	80	0.0625000
NODE_4628_length_1129_cov_16.934951	261	341	16	15	80	0.1875000
NODE_4628_length_1129_cov_16.934951	261	341	17	60	80	0.7500000
NODE_4628_length_1129_cov_16.934951	314	394	16	24	80	0.3000000
NODE_4628_length_1129_cov_16.934951	314	394	17	56	80	0.7000000
NODE_4629_length_1129_cov_9.441748	665	738	0	11	73	0.1506849
NODE_4629_length_1129_cov_9.441748	665	738	1	18	73	0.2465753
NODE_4629_length_1129_cov_9.441748	665	738	2	44	73	0.6027398
NODE_4629_length_1129_cov_9.441748	711	791	2	80	80	1.0000000
NODE_4630_length_1129_cov_9.260194	658	738	2	35	80	0.4375000
NODE_4630_length_1129_cov_9.260194	658	738	3	27	80	0.3375000
NODE_4630_length_1129_cov_9.260194	658	738	4	18	80	0.2250000
NODE_4630_length_1129_cov_9.260194	711	791	2	55	80	0.6875000
NODE_4630_length_1129_cov_9.260194	711	791	3	20	80	0.2500000
NODE_4630_length_1129_cov_9.260194	711	791	4	5	80	0.0625000
NODE_4631_length_1129_cov_5.055340	759	839	2	1	80	0.0125000
NODE_4631_length_1129_cov_5.055340	759	839	3	4	80	0.0500000
NODE_4631_length_1129_cov_5.055340	759	839	4	75	80	0.9375000
NODE_4638_length_1128_cov_48.099125	588	668	8	16	80	0.2000000
NODE_4638_length_1128_cov_48.099125	588	668	13	1	80	0.0125000
NODE_4638_length_1128_cov_48.099125	588	668	14	28	80	0.3500000
NODE_4638_length_1128_cov_48.099125	588	668	15	1	80	0.0125000
NODE_4638_length_1128_cov_48.099125	588	668	16	5	80	0.0625000
NODE_4638_length_1128_cov_48.099125	588	668	17	5	80	0.0625000
NODE_4638_length_1128_cov_48.099125	588	668	18	24	80	0.3000000
NODE_4638_length_1128_cov_48.099125	641	721	10	7	80	0.0875000
NODE_4638_length_1128_cov_48.099125	641	721	11	11	80	0.1375000
NODE_4638_length_1128_cov_48.099125	641	721	12	6	80	0.0750000
NODE_4638_length_1128_cov_48.099125	641	721	14	26	80	0.3250000
NODE_4638_length_1128_cov_48.099125	641	721	17	3	80	0.0375000
NODE_4638_length_1128_cov_48.099125	641	721	18	27	80	0.3375000
NODE_4640_length_1128_cov_26.230321	455	535	5	1	80	0.0125000
NODE_4640_length_1128_cov_26.230321	455	535	6	3	80	0.0375000
NODE_4640_length_1128_cov_26.230321	455	535	7	3	80	0.0375000
NODE_4640_length_1128_cov_26.230321	455	535	8	1	80	0.0125000
NODE_4640_length_1128_cov_26.230321	455	535	10	6	80	0.0750000
NODE_4640_length_1128_cov_26.230321	455	535	11	4	80	0.0500000
NODE_4640_length_1128_cov_26.230321	455	535	12	10	80	0.1250000
NODE_4640_length_1128_cov_26.230321	455	535	13	1	80	0.0125000
NODE_4640_length_1128_cov_26.230321	455	535	14	2	80	0.0250000
NODE_4640_length_1128_cov_26.230321	455	535	15	22	80	0.2750000
NODE_4640_length_1128_cov_26.230321	455	535	16	27	80	0.3375000
NODE_4640_length_1128_cov_26.230321	508	588	16	33	80	0.4125000
NODE_4640_length_1128_cov_26.230321	508	588	17	10	80	0.1250000
NODE_4640_length_1128_cov_26.230321	508	588	18	4	80	0.0500000
NODE_4640_length_1128_cov_26.230321	508	588	19	10	80	0.1250000
NODE_4640_length_1128_cov_26.230321	508	588	20	10	80	0.1250000
NODE_4640_length_1128_cov_26.230321	508	588	21	11	80	0.1375000
NODE_4640_length_1128_cov_26.230321	508	588	23	2	80	0.0250000
NODE_4640_length_1128_cov_26.230321	584	664	18	5	80	0.0625000
NODE_4640_length_1128_cov_26.230321	584	664	19	25	80	0.3125000
NODE_4640_length_1128_cov_26.230321	584	664	20	26	80	0.3250000
NODE_4640_length_1128_cov_26.230321	584	664	21	14	80	0.1750000
NODE_4640_length_1128_cov_26.230321	584	664	22	4	80	0.0500000
NODE_4640_length_1128_cov_26.230321	584	664	23	6	80	0.0750000
NODE_4640_length_1128_cov_26.230321	637	718	13	3	81	0.0370370
NODE_4640_length_1128_cov_26.230321	637	718	14	13	81	0.1604938
NODE_4640_length_1128_cov_26.230321	637	718	17	1	81	0.0123457
NODE_4640_length_1128_cov_26.230321	637	718	18	3	81	0.0370370
NODE_4640_length_1128_cov_26.230321	637	718	19	13	81	0.1604938
NODE_4640_length_1128_cov_26.230321	637	718	20	20	81	0.2469136
NODE_4640_length_1128_cov_26.230321	637	718	21	28	81	0.3456790
NODE_4641_length_1128_cov_26.031098	594	674	0	80	80	1.0000000
NODE_4641_length_1128_cov_26.031098	647	727	0	80	80	1.0000000
NODE_4642_length_1128_cov_25.869776	465	538	1	22	73	0.3013699
NODE_4642_length_1128_cov_25.869776	465	538	2	51	73	0.6986302
NODE_4642_length_1128_cov_25.869776	601	674	5	23	73	0.3150685
NODE_4642_length_1128_cov_25.869776	601	674	6	37	73	0.5068493
NODE_4642_length_1128_cov_25.869776	601	674	7	13	73	0.1780822
NODE_4642_length_1128_cov_25.869776	647	723	6	47	76	0.6184211
NODE_4642_length_1128_cov_25.869776	647	723	7	27	76	0.3552631
NODE_4642_length_1128_cov_25.869776	647	723	8	2	76	0.0263158
NODE_4643_length_1128_cov_24.185617	350	430	6	3	80	0.0375000
NODE_4643_length_1128_cov_24.185617	350	430	7	2	80	0.0250000
NODE_4643_length_1128_cov_24.185617	350	430	9	26	80	0.3250000
NODE_4643_length_1128_cov_24.185617	350	430	10	1	80	0.0125000
NODE_4643_length_1128_cov_24.185617	350	430	11	4	80	0.0500000
NODE_4643_length_1128_cov_24.185617	350	430	13	7	80	0.0875000
NODE_4643_length_1128_cov_24.185617	350	430	14	21	80	0.2625000
NODE_4643_length_1128_cov_24.185617	350	430	15	12	80	0.1500000
NODE_4643_length_1128_cov_24.185617	350	430	17	4	80	0.0500000
NODE_4643_length_1128_cov_24.185617	403	483	11	2	80	0.0250000
NODE_4643_length_1128_cov_24.185617	403	483	12	33	80	0.4125000
NODE_4643_length_1128_cov_24.185617	403	483	14	12	80	0.1500000
NODE_4643_length_1128_cov_24.185617	403	483	15	29	80	0.3625000
NODE_4643_length_1128_cov_24.185617	403	483	17	4	80	0.0500000
NODE_4644_length_1128_cov_18.537415	335	415	9	8	80	0.1000000
NODE_4644_length_1128_cov_18.537415	335	415	10	46	80	0.5750000
NODE_4644_length_1128_cov_18.537415	335	415	11	22	80	0.2750000
NODE_4644_length_1128_cov_18.537415	335	415	12	4	80	0.0500000
NODE_4644_length_1128_cov_18.537415	388	468	5	2	80	0.0250000
NODE_4644_length_1128_cov_18.537415	388	468	6	6	80	0.0750000
NODE_4644_length_1128_cov_18.537415	388	468	7	1	80	0.0125000
NODE_4644_length_1128_cov_18.537415	388	468	8	38	80	0.4750000
NODE_4644_length_1128_cov_18.537415	388	468	9	8	80	0.1000000
NODE_4644_length_1128_cov_18.537415	388	468	10	25	80	0.3125000
NODE_4645_length_1128_cov_9.345967	690	770	3	80	80	1.0000000
NODE_4645_length_1128_cov_9.345967	743	823	1	16	80	0.2000000
NODE_4645_length_1128_cov_9.345967	743	823	2	4	80	0.0500000
NODE_4645_length_1128_cov_9.345967	743	823	3	60	80	0.7500000
NODE_4647_length_1128_cov_3.920311	675	725	0	50	50	1.0000000
NODE_4647_length_1128_cov_3.920311	698	778	0	80	80	1.0000000
NODE_4648_length_1128_cov_3.631681	613	693	0	80	80	1.0000000
NODE_4648_length_1128_cov_3.631681	666	746	0	80	80	1.0000000
NODE_4650_length_1128_cov_3.091351	519	599	1	25	80	0.3125000
NODE_4650_length_1128_cov_3.091351	519	599	2	25	80	0.3125000
NODE_4650_length_1128_cov_3.091351	519	599	3	1	80	0.0125000
NODE_4650_length_1128_cov_3.091351	519	599	4	29	80	0.3625000
NODE_4650_length_1128_cov_3.091351	572	652	3	40	80	0.5000000
NODE_4650_length_1128_cov_3.091351	572	652	4	40	80	0.5000000
NODE_4660_length_1127_cov_38.932879	405	485	2	9	80	0.1125000
NODE_4660_length_1127_cov_38.932879	405	485	4	34	80	0.4250000
NODE_4660_length_1127_cov_38.932879	405	485	6	18	80	0.2250000
NODE_4660_length_1127_cov_38.932879	405	485	11	1	80	0.0125000
NODE_4660_length_1127_cov_38.932879	405	485	13	18	80	0.2250000
NODE_4660_length_1127_cov_38.932879	458	538	6	8	80	0.1000000
NODE_4660_length_1127_cov_38.932879	458	538	11	1	80	0.0125000
NODE_4660_length_1127_cov_38.932879	458	538	12	3	80	0.0375000
NODE_4660_length_1127_cov_38.932879	458	538	13	51	80	0.6375000
NODE_4660_length_1127_cov_38.932879	458	538	14	8	80	0.1000000
NODE_4660_length_1127_cov_38.932879	458	538	15	9	80	0.1125000
NODE_4660_length_1127_cov_38.932879	534	614	14	3	80	0.0375000
NODE_4660_length_1127_cov_38.932879	534	614	15	10	80	0.1250000
NODE_4660_length_1127_cov_38.932879	534	614	17	5	80	0.0625000
NODE_4660_length_1127_cov_38.932879	534	614	18	9	80	0.1125000
NODE_4660_length_1127_cov_38.932879	534	614	19	13	80	0.1625000
NODE_4660_length_1127_cov_38.932879	534	614	20	4	80	0.0500000
NODE_4660_length_1127_cov_38.932879	534	614	21	21	80	0.2625000
NODE_4660_length_1127_cov_38.932879	534	614	22	7	80	0.0875000
NODE_4660_length_1127_cov_38.932879	534	614	23	8	80	0.1000000
NODE_4660_length_1127_cov_38.932879	587	667	15	5	80	0.0625000
NODE_4660_length_1127_cov_38.932879	587	667	16	24	80	0.3000000
NODE_4660_length_1127_cov_38.932879	587	667	17	1	80	0.0125000
NODE_4660_length_1127_cov_38.932879	587	667	19	5	80	0.0625000
NODE_4660_length_1127_cov_38.932879	587	667	20	16	80	0.2000000
NODE_4660_length_1127_cov_38.932879	587	667	21	21	80	0.2625000
NODE_4660_length_1127_cov_38.932879	587	667	22	4	80	0.0500000
NODE_4660_length_1127_cov_38.932879	587	667	23	4	80	0.0500000
NODE_4661_length_1127_cov_37.721790	236	316	8	1	80	0.0125000
NODE_4661_length_1127_cov_37.721790	236	316	9	2	80	0.0250000
NODE_4661_length_1127_cov_37.721790	236	316	10	27	80	0.3375000
NODE_4661_length_1127_cov_37.721790	236	316	11	50	80	0.6250000
NODE_4661_length_1127_cov_37.721790	289	369	4	1	80	0.0125000
NODE_4661_length_1127_cov_37.721790	289	369	5	11	80	0.1375000
NODE_4661_length_1127_cov_37.721790	289	369	6	8	80	0.1000000
NODE_4661_length_1127_cov_37.721790	289	369	7	17	80	0.2125000
NODE_4661_length_1127_cov_37.721790	289	369	8	17	80	0.2125000
NODE_4661_length_1127_cov_37.721790	289	369	9	2	80	0.0250000
NODE_4661_length_1127_cov_37.721790	289	369	10	16	80	0.2000000
NODE_4661_length_1127_cov_37.721790	289	369	11	8	80	0.1000000
NODE_4661_length_1127_cov_37.721790	365	445	3	26	80	0.3250000
NODE_4661_length_1127_cov_37.721790	365	445	4	17	80	0.2125000
NODE_4661_length_1127_cov_37.721790	365	445	5	3	80	0.0375000
NODE_4661_length_1127_cov_37.721790	365	445	12	1	80	0.0125000
NODE_4661_length_1127_cov_37.721790	365	445	13	16	80	0.2000000
NODE_4661_length_1127_cov_37.721790	365	445	14	17	80	0.2125000
NODE_4661_length_1127_cov_37.721790	418	498	12	13	80	0.1625000
NODE_4661_length_1127_cov_37.721790	418	498	13	51	80	0.6375000
NODE_4661_length_1127_cov_37.721790	418	498	14	16	80	0.2000000
NODE_4662_length_1127_cov_31.866732	444	523	0	4	79	0.0506329
NODE_4662_length_1127_cov_31.866732	444	523	1	1	79	0.0126582
NODE_4662_length_1127_cov_31.866732	444	523	2	74	79	0.9367089
NODE_4662_length_1127_cov_31.866732	496	576	0	4	80	0.0500000
NODE_4662_length_1127_cov_31.866732	496	576	1	1	80	0.0125000
NODE_4662_length_1127_cov_31.866732	496	576	2	64	80	0.8000000
NODE_4662_length_1127_cov_31.866732	496	576	4	11	80	0.1375000
NODE_4662_length_1127_cov_31.866732	572	652	4	12	80	0.1500000
NODE_4662_length_1127_cov_31.866732	572	652	6	28	80	0.3500000
NODE_4662_length_1127_cov_31.866732	572	652	8	40	80	0.5000000
NODE_4662_length_1127_cov_31.866732	625	705	6	37	80	0.4625000
NODE_4662_length_1127_cov_31.866732	625	705	8	43	80	0.5375000
NODE_4663_length_1127_cov_25.616732	430	510	0	80	80	1.0000000
NODE_4663_length_1127_cov_25.616732	483	563	0	80	80	1.0000000
NODE_4664_length_1127_cov_21.838521	338	418	0	80	80	1.0000000
NODE_4664_length_1127_cov_21.838521	391	471	0	78	80	0.9750000
NODE_4664_length_1127_cov_21.838521	391	471	1	2	80	0.0250000
NODE_4664_length_1127_cov_21.838521	467	547	0	2	80	0.0250000
NODE_4664_length_1127_cov_21.838521	467	547	1	2	80	0.0250000
NODE_4664_length_1127_cov_21.838521	467	547	2	10	80	0.1250000
NODE_4664_length_1127_cov_21.838521	467	547	3	16	80	0.2000000
NODE_4664_length_1127_cov_21.838521	467	547	4	26	80	0.3250000
NODE_4664_length_1127_cov_21.838521	467	547	6	24	80	0.3000000
NODE_4664_length_1127_cov_21.838521	520	600	4	3	80	0.0375000
NODE_4664_length_1127_cov_21.838521	520	600	6	77	80	0.9625000
NODE_4665_length_1127_cov_15.024319	711	800	8	15	89	0.1685393
NODE_4665_length_1127_cov_15.024319	711	800	11	21	89	0.2359551
NODE_4665_length_1127_cov_15.024319	711	800	12	24	89	0.2696629
NODE_4665_length_1127_cov_15.024319	711	800	13	28	89	0.3146068
NODE_4665_length_1127_cov_15.024319	711	800	15	1	89	0.0112360
NODE_4665_length_1127_cov_15.024319	773	853	7	10	80	0.1250000
NODE_4665_length_1127_cov_15.024319	773	853	8	24	80	0.3000000
NODE_4665_length_1127_cov_15.024319	773	853	9	8	80	0.1000000
NODE_4665_length_1127_cov_15.024319	773	853	10	1	80	0.0125000
NODE_4665_length_1127_cov_15.024319	773	853	11	7	80	0.0875000
NODE_4665_length_1127_cov_15.024319	773	853	12	21	80	0.2625000
NODE_4665_length_1127_cov_15.024319	773	853	13	9	80	0.1125000
NODE_4667_length_1127_cov_4.786965	386	466	0	18	80	0.2250000
NODE_4667_length_1127_cov_4.786965	386	466	2	62	80	0.7750000
NODE_4667_length_1127_cov_4.786965	439	519	2	80	80	1.0000000
NODE_4672_length_1126_cov_51.699124	448	528	20	16	80	0.2000000
NODE_4672_length_1126_cov_51.699124	448	528	21	1	80	0.0125000
NODE_4672_length_1126_cov_51.699124	448	528	22	19	80	0.2375000
NODE_4672_length_1126_cov_51.699124	448	528	23	12	80	0.1500000
NODE_4672_length_1126_cov_51.699124	448	528	24	5	80	0.0625000
NODE_4672_length_1126_cov_51.699124	448	528	25	5	80	0.0625000
NODE_4672_length_1126_cov_51.699124	448	528	30	15	80	0.1875000
NODE_4672_length_1126_cov_51.699124	448	528	32	1	80	0.0125000
NODE_4672_length_1126_cov_51.699124	448	528	34	6	80	0.0750000
NODE_4672_length_1126_cov_51.699124	501	581	23	15	80	0.1875000
NODE_4672_length_1126_cov_51.699124	501	581	25	9	80	0.1125000
NODE_4672_length_1126_cov_51.699124	501	581	28	23	80	0.2875000
NODE_4672_length_1126_cov_51.699124	501	581	29	2	80	0.0250000
NODE_4672_length_1126_cov_51.699124	501	581	30	15	80	0.1875000
NODE_4672_length_1126_cov_51.699124	501	581	32	1	80	0.0125000
NODE_4672_length_1126_cov_51.699124	501	581	33	1	80	0.0125000
NODE_4672_length_1126_cov_51.699124	501	581	34	14	80	0.1750000
NODE_4673_length_1126_cov_38.135346	427	507	5	3	80	0.0375000
NODE_4673_length_1126_cov_38.135346	427	507	6	19	80	0.2375000
NODE_4673_length_1126_cov_38.135346	427	507	7	6	80	0.0750000
NODE_4673_length_1126_cov_38.135346	427	507	8	52	80	0.6500000
NODE_4673_length_1126_cov_38.135346	480	560	8	65	80	0.8125000
NODE_4673_length_1126_cov_38.135346	480	560	9	8	80	0.1000000
NODE_4673_length_1126_cov_38.135346	480	560	10	7	80	0.0875000
NODE_4673_length_1126_cov_38.135346	556	638	6	10	82	0.1219512
NODE_4673_length_1126_cov_38.135346	556	638	8	37	82	0.4512195
NODE_4673_length_1126_cov_38.135346	556	638	9	24	82	0.2926829
NODE_4673_length_1126_cov_38.135346	556	638	10	11	82	0.1341463
NODE_4673_length_1126_cov_38.135346	611	691	6	16	80	0.2000000
NODE_4673_length_1126_cov_38.135346	611	691	8	15	80	0.1875000
NODE_4673_length_1126_cov_38.135346	611	691	9	49	80	0.6125000
NODE_4674_length_1126_cov_34.637780	23	97	5	20	74	0.2702703
NODE_4674_length_1126_cov_34.637780	23	97	6	1	74	0.0135135
NODE_4674_length_1126_cov_34.637780	23	97	8	39	74	0.5270270
NODE_4674_length_1126_cov_34.637780	23	97	10	2	74	0.0270270
NODE_4674_length_1126_cov_34.637780	23	97	12	5	74	0.0675676
NODE_4674_length_1126_cov_34.637780	23	97	13	7	74	0.0945946
NODE_4674_length_1126_cov_34.637780	146	226	7	32	80	0.4000000
NODE_4674_length_1126_cov_34.637780	146	226	9	38	80	0.4750000
NODE_4674_length_1126_cov_34.637780	146	226	10	4	80	0.0500000
NODE_4674_length_1126_cov_34.637780	146	226	12	3	80	0.0375000
NODE_4674_length_1126_cov_34.637780	146	226	14	3	80	0.0375000
NODE_4674_length_1126_cov_34.637780	146	226	7	32	80	0.4000000
NODE_4674_length_1126_cov_34.637780	146	226	9	38	80	0.4750000
NODE_4674_length_1126_cov_34.637780	146	226	10	4	80	0.0500000
NODE_4674_length_1126_cov_34.637780	146	226	12	3	80	0.0375000
NODE_4674_length_1126_cov_34.637780	146	226	14	3	80	0.0375000
NODE_4674_length_1126_cov_34.637780	146	208	7	14	62	0.2258064
NODE_4674_length_1126_cov_34.637780	146	208	9	38	62	0.6129032
NODE_4674_length_1126_cov_34.637780	146	208	10	4	62	0.0645161
NODE_4674_length_1126_cov_34.637780	146	208	12	3	62	0.0483871
NODE_4674_length_1126_cov_34.637780	146	208	14	3	62	0.0483871
NODE_4674_length_1126_cov_34.637780	146	217	7	23	71	0.3239437
NODE_4674_length_1126_cov_34.637780	146	217	9	38	71	0.5352113
NODE_4674_length_1126_cov_34.637780	146	217	10	4	71	0.0563380
NODE_4674_length_1126_cov_34.637780	146	217	12	3	71	0.0422535
NODE_4674_length_1126_cov_34.637780	146	217	14	3	71	0.0422535
NODE_4675_length_1126_cov_21.360273	595	675	7	52	80	0.6500000
NODE_4675_length_1126_cov_21.360273	595	675	9	10	80	0.1250000
NODE_4675_length_1126_cov_21.360273	595	675	10	18	80	0.2250000
NODE_4675_length_1126_cov_21.360273	648	728	5	41	80	0.5125000
NODE_4675_length_1126_cov_21.360273	648	728	7	39	80	0.4875000
NODE_4676_length_1126_cov_17.420643	422	502	2	1	80	0.0125000
NODE_4676_length_1126_cov_17.420643	422	502	4	13	80	0.1625000
NODE_4676_length_1126_cov_17.420643	422	502	5	9	80	0.1125000
NODE_4676_length_1126_cov_17.420643	422	502	6	57	80	0.7125000
NODE_4676_length_1126_cov_17.420643	475	555	2	24	80	0.3000000
NODE_4676_length_1126_cov_17.420643	475	555	4	43	80	0.5375000
NODE_4676_length_1126_cov_17.420643	475	555	5	9	80	0.1125000
NODE_4676_length_1126_cov_17.420643	475	555	6	4	80	0.0500000
NODE_4677_length_1126_cov_15.896787	383	463	6	21	80	0.2625000
NODE_4677_length_1126_cov_15.896787	383	463	8	59	80	0.7375000
NODE_4677_length_1126_cov_15.896787	436	516	5	32	80	0.4000000
NODE_4677_length_1126_cov_15.896787	436	516	6	25	80	0.3125000
NODE_4677_length_1126_cov_15.896787	436	516	8	23	80	0.2875000
NODE_4678_length_1126_cov_8.525803	174	254	5	5	80	0.0625000
NODE_4678_length_1126_cov_8.525803	174	254	7	18	80	0.2250000
NODE_4678_length_1126_cov_8.525803	174	254	9	21	80	0.2625000
NODE_4678_length_1126_cov_8.525803	174	254	10	3	80	0.0375000
NODE_4678_length_1126_cov_8.525803	174	254	11	33	80	0.4125000
NODE_4678_length_1126_cov_8.525803	227	307	5	24	80	0.3000000
NODE_4678_length_1126_cov_8.525803	227	307	6	34	80	0.4250000
NODE_4678_length_1126_cov_8.525803	227	307	7	12	80	0.1500000
NODE_4678_length_1126_cov_8.525803	227	307	10	2	80	0.0250000
NODE_4678_length_1126_cov_8.525803	227	307	11	8	80	0.1000000
NODE_4679_length_1126_cov_5.805258	463	543	0	30	80	0.3750000
NODE_4679_length_1126_cov_5.805258	463	543	1	50	80	0.6250000
NODE_4679_length_1126_cov_5.805258	516	596	0	80	80	1.0000000
NODE_4685_length_1126_cov_1.502434	6	86	0	80	80	1.0000000
NODE_4685_length_1126_cov_1.502434	59	108	0	49	49	1.0000000
NODE_4689_length_1125_cov_34.314815	405	485	23	9	80	0.1125000
NODE_4689_length_1125_cov_34.314815	405	485	24	8	80	0.1000000
NODE_4689_length_1125_cov_34.314815	405	485	25	15	80	0.1875000
NODE_4689_length_1125_cov_34.314815	405	485	26	21	80	0.2625000
NODE_4689_length_1125_cov_34.314815	405	485	27	23	80	0.2875000
NODE_4689_length_1125_cov_34.314815	405	485	28	4	80	0.0500000
NODE_4689_length_1125_cov_34.314815	458	538	17	7	80	0.0875000
NODE_4689_length_1125_cov_34.314815	458	538	18	15	80	0.1875000
NODE_4689_length_1125_cov_34.314815	458	538	20	2	80	0.0250000
NODE_4689_length_1125_cov_34.314815	458	538	22	1	80	0.0125000
NODE_4689_length_1125_cov_34.314815	458	538	23	1	80	0.0125000
NODE_4689_length_1125_cov_34.314815	458	538	24	20	80	0.2500000
NODE_4689_length_1125_cov_34.314815	458	538	25	10	80	0.1250000
NODE_4689_length_1125_cov_34.314815	458	538	26	17	80	0.2125000
NODE_4689_length_1125_cov_34.314815	458	538	27	7	80	0.0875000
NODE_4689_length_1125_cov_34.314815	534	614	17	2	80	0.0250000
NODE_4689_length_1125_cov_34.314815	534	614	18	6	80	0.0750000
NODE_4689_length_1125_cov_34.314815	534	614	20	3	80	0.0375000
NODE_4689_length_1125_cov_34.314815	534	614	23	1	80	0.0125000
NODE_4689_length_1125_cov_34.314815	534	614	24	8	80	0.1000000
NODE_4689_length_1125_cov_34.314815	534	614	26	16	80	0.2000000
NODE_4689_length_1125_cov_34.314815	534	614	27	29	80	0.3625000
NODE_4689_length_1125_cov_34.314815	534	614	28	6	80	0.0750000
NODE_4689_length_1125_cov_34.314815	534	614	29	6	80	0.0750000
NODE_4689_length_1125_cov_34.314815	534	614	30	3	80	0.0375000
NODE_4689_length_1125_cov_34.314815	587	667	18	4	80	0.0500000
NODE_4689_length_1125_cov_34.314815	587	667	19	9	80	0.1125000
NODE_4689_length_1125_cov_34.314815	587	667	20	3	80	0.0375000
NODE_4689_length_1125_cov_34.314815	587	667	22	2	80	0.0250000
NODE_4689_length_1125_cov_34.314815	587	667	23	22	80	0.2750000
NODE_4689_length_1125_cov_34.314815	587	667	24	5	80	0.0625000
NODE_4689_length_1125_cov_34.314815	587	667	25	3	80	0.0375000
NODE_4689_length_1125_cov_34.314815	587	667	26	12	80	0.1500000
NODE_4689_length_1125_cov_34.314815	587	667	27	20	80	0.2500000
NODE_4690_length_1125_cov_33.553606	458	538	9	1	80	0.0125000
NODE_4690_length_1125_cov_33.553606	458	538	10	23	80	0.2875000
NODE_4690_length_1125_cov_33.553606	458	538	11	14	80	0.1750000
NODE_4690_length_1125_cov_33.553606	458	538	12	19	80	0.2375000
NODE_4690_length_1125_cov_33.553606	458	538	13	19	80	0.2375000
NODE_4690_length_1125_cov_33.553606	458	538	14	4	80	0.0500000
NODE_4690_length_1125_cov_33.553606	511	591	10	11	80	0.1375000
NODE_4690_length_1125_cov_33.553606	511	591	11	4	80	0.0500000
NODE_4690_length_1125_cov_33.553606	511	591	12	8	80	0.1000000
NODE_4690_length_1125_cov_33.553606	511	591	13	7	80	0.0875000
NODE_4690_length_1125_cov_33.553606	511	591	14	23	80	0.2875000
NODE_4690_length_1125_cov_33.553606	511	591	15	18	80	0.2250000
NODE_4690_length_1125_cov_33.553606	511	591	16	9	80	0.1125000
NODE_4690_length_1125_cov_33.553606	587	667	10	1	80	0.0125000
NODE_4690_length_1125_cov_33.553606	587	667	11	6	80	0.0750000
NODE_4690_length_1125_cov_33.553606	587	667	12	4	80	0.0500000
NODE_4690_length_1125_cov_33.553606	587	667	13	39	80	0.4875000
NODE_4690_length_1125_cov_33.553606	587	667	14	30	80	0.3750000
NODE_4690_length_1125_cov_33.553606	640	720	7	16	80	0.2000000
NODE_4690_length_1125_cov_33.553606	640	720	9	3	80	0.0375000
NODE_4690_length_1125_cov_33.553606	640	720	10	17	80	0.2125000
NODE_4690_length_1125_cov_33.553606	640	720	12	8	80	0.1000000
NODE_4690_length_1125_cov_33.553606	640	720	13	23	80	0.2875000
NODE_4690_length_1125_cov_33.553606	640	720	14	13	80	0.1625000
NODE_4691_length_1125_cov_33.371345	408	488	0	33	80	0.4125000
NODE_4691_length_1125_cov_33.371345	408	488	1	4	80	0.0500000
NODE_4691_length_1125_cov_33.371345	408	488	2	43	80	0.5375000
NODE_4691_length_1125_cov_33.371345	461	541	0	37	80	0.4625000
NODE_4691_length_1125_cov_33.371345	461	541	1	43	80	0.5375000
NODE_4691_length_1125_cov_33.371345	537	617	1	66	80	0.8250000
NODE_4691_length_1125_cov_33.371345	537	617	2	7	80	0.0875000
NODE_4691_length_1125_cov_33.371345	537	617	3	7	80	0.0875000
NODE_4691_length_1125_cov_33.371345	590	670	1	13	80	0.1625000
NODE_4691_length_1125_cov_33.371345	590	670	2	29	80	0.3625000
NODE_4691_length_1125_cov_33.371345	590	670	3	38	80	0.4750000
NODE_4692_length_1125_cov_22.580897	279	359	1	57	80	0.7125000
NODE_4692_length_1125_cov_22.580897	279	359	2	6	80	0.0750000
NODE_4692_length_1125_cov_22.580897	279	359	10	17	80	0.2125000
NODE_4692_length_1125_cov_22.580897	332	412	1	4	80	0.0500000
NODE_4692_length_1125_cov_22.580897	332	412	2	6	80	0.0750000
NODE_4692_length_1125_cov_22.580897	332	412	10	32	80	0.4000000
NODE_4692_length_1125_cov_22.580897	332	412	11	18	80	0.2250000
NODE_4692_length_1125_cov_22.580897	332	412	13	6	80	0.0750000
NODE_4692_length_1125_cov_22.580897	332	412	14	14	80	0.1750000
NODE_4692_length_1125_cov_22.580897	408	488	14	4	80	0.0500000
NODE_4692_length_1125_cov_22.580897	408	488	15	25	80	0.3125000
NODE_4692_length_1125_cov_22.580897	408	488	17	6	80	0.0750000
NODE_4692_length_1125_cov_22.580897	408	488	18	30	80	0.3750000
NODE_4692_length_1125_cov_22.580897	408	488	19	2	80	0.0250000
NODE_4692_length_1125_cov_22.580897	408	488	20	2	80	0.0250000
NODE_4692_length_1125_cov_22.580897	408	488	21	11	80	0.1375000
NODE_4692_length_1125_cov_22.580897	461	541	12	13	80	0.1625000
NODE_4692_length_1125_cov_22.580897	461	541	13	1	80	0.0125000
NODE_4692_length_1125_cov_22.580897	461	541	14	19	80	0.2375000
NODE_4692_length_1125_cov_22.580897	461	541	18	12	80	0.1500000
NODE_4692_length_1125_cov_22.580897	461	541	19	13	80	0.1625000
NODE_4692_length_1125_cov_22.580897	461	541	20	7	80	0.0875000
NODE_4692_length_1125_cov_22.580897	461	541	21	15	80	0.1875000
NODE_4705_length_1124_cov_52.278049	616	696	4	10	80	0.1250000
NODE_4705_length_1124_cov_52.278049	616	696	6	34	80	0.4250000
NODE_4705_length_1124_cov_52.278049	616	696	7	1	80	0.0125000
NODE_4705_length_1124_cov_52.278049	616	696	8	35	80	0.4375000
NODE_4705_length_1124_cov_52.278049	669	749	7	1	80	0.0125000
NODE_4705_length_1124_cov_52.278049	669	749	8	42	80	0.5250000
NODE_4705_length_1124_cov_52.278049	669	749	9	37	80	0.4625000
NODE_4706_length_1124_cov_25.280000	444	524	3	29	80	0.3625000
NODE_4706_length_1124_cov_25.280000	444	524	4	5	80	0.0625000
NODE_4706_length_1124_cov_25.280000	444	524	5	16	80	0.2000000
NODE_4706_length_1124_cov_25.280000	444	524	6	2	80	0.0250000
NODE_4706_length_1124_cov_25.280000	444	524	7	7	80	0.0875000
NODE_4706_length_1124_cov_25.280000	444	524	8	1	80	0.0125000
NODE_4706_length_1124_cov_25.280000	444	524	9	20	80	0.2500000
NODE_4706_length_1124_cov_25.280000	497	577	7	6	80	0.0750000
NODE_4706_length_1124_cov_25.280000	497	577	8	1	80	0.0125000
NODE_4706_length_1124_cov_25.280000	497	577	9	39	80	0.4875000
NODE_4706_length_1124_cov_25.280000	497	577	11	33	80	0.4125000
NODE_4706_length_1124_cov_25.280000	497	577	12	1	80	0.0125000
NODE_4706_length_1124_cov_25.280000	573	653	4	7	80	0.0875000
NODE_4706_length_1124_cov_25.280000	573	653	5	2	80	0.0250000
NODE_4706_length_1124_cov_25.280000	573	653	6	16	80	0.2000000
NODE_4706_length_1124_cov_25.280000	573	653	7	5	80	0.0625000
NODE_4706_length_1124_cov_25.280000	573	653	9	32	80	0.4000000
NODE_4706_length_1124_cov_25.280000	573	653	10	4	80	0.0500000
NODE_4706_length_1124_cov_25.280000	573	653	11	3	80	0.0375000
NODE_4706_length_1124_cov_25.280000	573	653	12	11	80	0.1375000
NODE_4706_length_1124_cov_25.280000	626	706	1	32	80	0.4000000
NODE_4706_length_1124_cov_25.280000	626	706	3	21	80	0.2625000
NODE_4706_length_1124_cov_25.280000	626	706	4	7	80	0.0875000
NODE_4706_length_1124_cov_25.280000	626	706	5	2	80	0.0250000
NODE_4706_length_1124_cov_25.280000	626	706	6	16	80	0.2000000
NODE_4706_length_1124_cov_25.280000	626	706	7	2	80	0.0250000
NODE_4707_length_1124_cov_18.700488	114	194	0	54	80	0.6750000
NODE_4707_length_1124_cov_18.700488	114	194	1	3	80	0.0375000
NODE_4707_length_1124_cov_18.700488	114	194	3	23	80	0.2875000
NODE_4707_length_1124_cov_18.700488	167	247	0	1	80	0.0125000
NODE_4707_length_1124_cov_18.700488	167	247	1	3	80	0.0375000
NODE_4707_length_1124_cov_18.700488	167	247	3	39	80	0.4875000
NODE_4707_length_1124_cov_18.700488	167	247	4	37	80	0.4625000
NODE_4717_length_1123_cov_26.445312	388	468	4	8	80	0.1000000
NODE_4717_length_1123_cov_26.445312	388	468	5	66	80	0.8250000
NODE_4717_length_1123_cov_26.445312	388	468	6	6	80	0.0750000
NODE_4717_length_1123_cov_26.445312	441	521	5	34	80	0.4250000
NODE_4717_length_1123_cov_26.445312	441	521	6	37	80	0.4625000
NODE_4717_length_1123_cov_26.445312	441	521	7	9	80	0.1125000
NODE_4717_length_1123_cov_26.445312	517	597	4	12	80	0.1500000
NODE_4717_length_1123_cov_26.445312	517	597	5	68	80	0.8500000
NODE_4717_length_1123_cov_26.445312	570	650	4	12	80	0.1500000
NODE_4717_length_1123_cov_26.445312	570	650	5	55	80	0.6875000
NODE_4717_length_1123_cov_26.445312	570	650	6	13	80	0.1625000
NODE_4718_length_1123_cov_18.677734	522	602	2	1	80	0.0125000
NODE_4718_length_1123_cov_18.677734	522	602	4	24	80	0.3000000
NODE_4718_length_1123_cov_18.677734	522	602	5	9	80	0.1125000
NODE_4718_length_1123_cov_18.677734	522	602	6	46	80	0.5750000
NODE_4718_length_1123_cov_18.677734	575	655	2	24	80	0.3000000
NODE_4718_length_1123_cov_18.677734	575	655	3	2	80	0.0250000
NODE_4718_length_1123_cov_18.677734	575	655	4	24	80	0.3000000
NODE_4718_length_1123_cov_18.677734	575	655	5	28	80	0.3500000
NODE_4718_length_1123_cov_18.677734	575	655	6	2	80	0.0250000
NODE_4718_length_1123_cov_18.677734	651	731	3	50	80	0.6250000
NODE_4718_length_1123_cov_18.677734	651	731	4	24	80	0.3000000
NODE_4718_length_1123_cov_18.677734	651	731	5	6	80	0.0750000
NODE_4718_length_1123_cov_18.677734	704	784	1	7	80	0.0875000
NODE_4718_length_1123_cov_18.677734	704	784	3	38	80	0.4750000
NODE_4718_length_1123_cov_18.677734	704	784	4	35	80	0.4375000
NODE_4728_length_1122_cov_38.688172	295	375	4	4	80	0.0500000
NODE_4728_length_1122_cov_38.688172	295	375	6	4	80	0.0500000
NODE_4728_length_1122_cov_38.688172	295	375	7	8	80	0.1000000
NODE_4728_length_1122_cov_38.688172	295	375	8	12	80	0.1500000
NODE_4728_length_1122_cov_38.688172	295	375	9	9	80	0.1125000
NODE_4728_length_1122_cov_38.688172	295	375	10	11	80	0.1375000
NODE_4728_length_1122_cov_38.688172	295	375	11	1	80	0.0125000
NODE_4728_length_1122_cov_38.688172	295	375	12	21	80	0.2625000
NODE_4728_length_1122_cov_38.688172	295	375	13	10	80	0.1250000
NODE_4728_length_1122_cov_38.688172	348	428	11	1	80	0.0125000
NODE_4728_length_1122_cov_38.688172	348	428	12	16	80	0.2000000
NODE_4728_length_1122_cov_38.688172	348	428	13	12	80	0.1500000
NODE_4728_length_1122_cov_38.688172	348	428	16	1	80	0.0125000
NODE_4728_length_1122_cov_38.688172	348	428	17	20	80	0.2500000
NODE_4728_length_1122_cov_38.688172	348	428	19	11	80	0.1375000
NODE_4728_length_1122_cov_38.688172	348	428	20	2	80	0.0250000
NODE_4728_length_1122_cov_38.688172	348	428	21	15	80	0.1875000
NODE_4728_length_1122_cov_38.688172	348	428	22	2	80	0.0250000
NODE_4728_length_1122_cov_38.688172	424	504	19	11	80	0.1375000
NODE_4728_length_1122_cov_38.688172	424	504	20	9	80	0.1125000
NODE_4728_length_1122_cov_38.688172	424	504	21	13	80	0.1625000
NODE_4728_length_1122_cov_38.688172	424	504	22	23	80	0.2875000
NODE_4728_length_1122_cov_38.688172	424	504	23	11	80	0.1375000
NODE_4728_length_1122_cov_38.688172	424	504	24	4	80	0.0500000
NODE_4728_length_1122_cov_38.688172	424	504	25	2	80	0.0250000
NODE_4728_length_1122_cov_38.688172	424	504	26	7	80	0.0875000
NODE_4728_length_1122_cov_38.688172	477	557	7	4	80	0.0500000
NODE_4728_length_1122_cov_38.688172	477	557	8	19	80	0.2375000
NODE_4728_length_1122_cov_38.688172	477	557	10	7	80	0.0875000
NODE_4728_length_1122_cov_38.688172	477	557	14	1	80	0.0125000
NODE_4728_length_1122_cov_38.688172	477	557	16	9	80	0.1125000
NODE_4728_length_1122_cov_38.688172	477	557	18	2	80	0.0250000
NODE_4728_length_1122_cov_38.688172	477	557	19	19	80	0.2375000
NODE_4728_length_1122_cov_38.688172	477	557	20	12	80	0.1500000
NODE_4728_length_1122_cov_38.688172	477	557	21	7	80	0.0875000
NODE_4729_length_1122_cov_32.827957	232	312	7	6	80	0.0750000
NODE_4729_length_1122_cov_32.827957	232	312	8	30	80	0.3750000
NODE_4729_length_1122_cov_32.827957	232	312	10	5	80	0.0625000
NODE_4729_length_1122_cov_32.827957	232	312	11	1	80	0.0125000
NODE_4729_length_1122_cov_32.827957	232	312	14	4	80	0.0500000
NODE_4729_length_1122_cov_32.827957	232	312	16	13	80	0.1625000
NODE_4729_length_1122_cov_32.827957	232	312	17	4	80	0.0500000
NODE_4729_length_1122_cov_32.827957	232	312	18	11	80	0.1375000
NODE_4729_length_1122_cov_32.827957	232	312	20	6	80	0.0750000
NODE_4729_length_1122_cov_32.827957	285	365	16	6	80	0.0750000
NODE_4729_length_1122_cov_32.827957	285	365	17	4	80	0.0500000
NODE_4729_length_1122_cov_32.827957	285	365	18	11	80	0.1375000
NODE_4729_length_1122_cov_32.827957	285	365	20	19	80	0.2375000
NODE_4729_length_1122_cov_32.827957	285	365	22	2	80	0.0250000
NODE_4729_length_1122_cov_32.827957	285	365	23	12	80	0.1500000
NODE_4729_length_1122_cov_32.827957	285	365	26	11	80	0.1375000
NODE_4729_length_1122_cov_32.827957	285	365	27	10	80	0.1250000
NODE_4729_length_1122_cov_32.827957	285	365	28	5	80	0.0625000
NODE_4729_length_1122_cov_32.827957	361	441	18	13	80	0.1625000
NODE_4729_length_1122_cov_32.827957	361	441	20	4	80	0.0500000
NODE_4729_length_1122_cov_32.827957	361	441	21	2	80	0.0250000
NODE_4729_length_1122_cov_32.827957	361	441	22	14	80	0.1750000
NODE_4729_length_1122_cov_32.827957	361	441	23	37	80	0.4625000
NODE_4729_length_1122_cov_32.827957	361	441	24	3	80	0.0375000
NODE_4729_length_1122_cov_32.827957	361	441	25	1	80	0.0125000
NODE_4729_length_1122_cov_32.827957	361	441	26	1	80	0.0125000
NODE_4729_length_1122_cov_32.827957	361	441	28	5	80	0.0625000
NODE_4729_length_1122_cov_32.827957	414	494	6	5	80	0.0625000
NODE_4729_length_1122_cov_32.827957	414	494	9	13	80	0.1625000
NODE_4729_length_1122_cov_32.827957	414	494	12	9	80	0.1125000
NODE_4729_length_1122_cov_32.827957	414	494	14	11	80	0.1375000
NODE_4729_length_1122_cov_32.827957	414	494	16	11	80	0.1375000
NODE_4729_length_1122_cov_32.827957	414	494	17	4	80	0.0500000
NODE_4729_length_1122_cov_32.827957	414	494	18	13	80	0.1625000
NODE_4729_length_1122_cov_32.827957	414	494	20	4	80	0.0500000
NODE_4729_length_1122_cov_32.827957	414	494	21	2	80	0.0250000
NODE_4729_length_1122_cov_32.827957	414	494	22	1	80	0.0125000
NODE_4729_length_1122_cov_32.827957	414	494	23	4	80	0.0500000
NODE_4729_length_1122_cov_32.827957	414	494	24	3	80	0.0375000
NODE_4730_length_1122_cov_12.574780	396	476	0	18	80	0.2250000
NODE_4730_length_1122_cov_12.574780	396	476	1	62	80	0.7750000
NODE_4730_length_1122_cov_12.574780	449	529	1	80	80	1.0000000
NODE_4730_length_1122_cov_12.574780	525	605	1	16	80	0.2000000
NODE_4730_length_1122_cov_12.574780	525	605	2	57	80	0.7125000
NODE_4730_length_1122_cov_12.574780	525	605	3	7	80	0.0875000
NODE_4730_length_1122_cov_12.574780	578	658	2	20	80	0.2500000
NODE_4730_length_1122_cov_12.574780	578	658	3	60	80	0.7500000
NODE_4731_length_1122_cov_8.582600	586	666	5	34	80	0.4250000
NODE_4731_length_1122_cov_8.582600	586	666	6	3	80	0.0375000
NODE_4731_length_1122_cov_8.582600	586	666	7	19	80	0.2375000
NODE_4731_length_1122_cov_8.582600	586	666	8	24	80	0.3000000
NODE_4731_length_1122_cov_8.582600	639	719	4	3	80	0.0375000
NODE_4731_length_1122_cov_8.582600	639	719	5	11	80	0.1375000
NODE_4731_length_1122_cov_8.582600	639	719	6	31	80	0.3875000
NODE_4731_length_1122_cov_8.582600	639	719	7	11	80	0.1375000
NODE_4731_length_1122_cov_8.582600	639	719	8	24	80	0.3000000
NODE_4733_length_1122_cov_3.714565	284	364	0	29	80	0.3625000
NODE_4733_length_1122_cov_3.714565	284	364	1	51	80	0.6375000
NODE_4733_length_1122_cov_3.714565	337	417	0	80	80	1.0000000
NODE_4738_length_1122_cov_1.757576	25	87	0	62	62	1.0000000
NODE_4742_length_1121_cov_39.595890	507	587	39	6	80	0.0750000
NODE_4742_length_1121_cov_39.595890	507	587	40	6	80	0.0750000
NODE_4742_length_1121_cov_39.595890	507	587	41	12	80	0.1500000
NODE_4742_length_1121_cov_39.595890	507	587	42	16	80	0.2000000
NODE_4742_length_1121_cov_39.595890	507	587	43	27	80	0.3375000
NODE_4742_length_1121_cov_39.595890	507	587	44	5	80	0.0625000
NODE_4742_length_1121_cov_39.595890	507	587	45	8	80	0.1000000
NODE_4742_length_1121_cov_39.595890	560	640	23	4	80	0.0500000
NODE_4742_length_1121_cov_39.595890	560	640	24	1	80	0.0125000
NODE_4742_length_1121_cov_39.595890	560	640	27	3	80	0.0375000
NODE_4742_length_1121_cov_39.595890	560	640	28	3	80	0.0375000
NODE_4742_length_1121_cov_39.595890	560	640	30	1	80	0.0125000
NODE_4742_length_1121_cov_39.595890	560	640	34	8	80	0.1000000
NODE_4742_length_1121_cov_39.595890	560	640	37	4	80	0.0500000
NODE_4742_length_1121_cov_39.595890	560	640	38	12	80	0.1500000
NODE_4742_length_1121_cov_39.595890	560	640	39	16	80	0.2000000
NODE_4742_length_1121_cov_39.595890	560	640	40	7	80	0.0875000
NODE_4742_length_1121_cov_39.595890	560	640	42	6	80	0.0750000
NODE_4742_length_1121_cov_39.595890	560	640	43	10	80	0.1250000
NODE_4742_length_1121_cov_39.595890	560	640	44	4	80	0.0500000
NODE_4742_length_1121_cov_39.595890	560	640	45	1	80	0.0125000
NODE_4742_length_1121_cov_39.595890	636	716	10	6	80	0.0750000
NODE_4742_length_1121_cov_39.595890	636	716	13	5	80	0.0625000
NODE_4742_length_1121_cov_39.595890	636	716	14	1	80	0.0125000
NODE_4742_length_1121_cov_39.595890	636	716	15	11	80	0.1375000
NODE_4742_length_1121_cov_39.595890	636	716	17	16	80	0.2000000
NODE_4742_length_1121_cov_39.595890	636	716	18	6	80	0.0750000
NODE_4742_length_1121_cov_39.595890	636	716	19	10	80	0.1250000
NODE_4742_length_1121_cov_39.595890	636	716	20	17	80	0.2125000
NODE_4742_length_1121_cov_39.595890	636	716	21	1	80	0.0125000
NODE_4742_length_1121_cov_39.595890	636	716	22	1	80	0.0125000
NODE_4742_length_1121_cov_39.595890	636	716	23	6	80	0.0750000
NODE_4742_length_1121_cov_39.595890	689	769	0	12	80	0.1500000
NODE_4742_length_1121_cov_39.595890	689	769	3	16	80	0.2000000
NODE_4742_length_1121_cov_39.595890	689	769	5	8	80	0.1000000
NODE_4742_length_1121_cov_39.595890	689	769	6	7	80	0.0875000
NODE_4742_length_1121_cov_39.595890	689	769	8	4	80	0.0500000
NODE_4742_length_1121_cov_39.595890	689	769	9	4	80	0.0500000
NODE_4742_length_1121_cov_39.595890	689	769	10	8	80	0.1000000
NODE_4742_length_1121_cov_39.595890	689	769	13	5	80	0.0625000
NODE_4742_length_1121_cov_39.595890	689	769	14	1	80	0.0125000
NODE_4742_length_1121_cov_39.595890	689	769	15	11	80	0.1375000
NODE_4742_length_1121_cov_39.595890	689	769	17	4	80	0.0500000
NODE_4743_length_1121_cov_23.832681	525	605	6	6	80	0.0750000
NODE_4743_length_1121_cov_23.832681	525	605	8	7	80	0.0875000
NODE_4743_length_1121_cov_23.832681	525	605	10	1	80	0.0125000
NODE_4743_length_1121_cov_23.832681	525	605	11	3	80	0.0375000
NODE_4743_length_1121_cov_23.832681	525	605	12	10	80	0.1250000
NODE_4743_length_1121_cov_23.832681	525	605	14	5	80	0.0625000
NODE_4743_length_1121_cov_23.832681	525	605	15	5	80	0.0625000
NODE_4743_length_1121_cov_23.832681	525	605	17	5	80	0.0625000
NODE_4743_length_1121_cov_23.832681	525	605	19	5	80	0.0625000
NODE_4743_length_1121_cov_23.832681	525	605	21	11	80	0.1375000
NODE_4743_length_1121_cov_23.832681	525	605	23	4	80	0.0500000
NODE_4743_length_1121_cov_23.832681	525	605	25	18	80	0.2250000
NODE_4743_length_1121_cov_23.832681	578	658	21	5	80	0.0625000
NODE_4743_length_1121_cov_23.832681	578	658	23	4	80	0.0500000
NODE_4743_length_1121_cov_23.832681	578	658	24	4	80	0.0500000
NODE_4743_length_1121_cov_23.832681	578	658	25	29	80	0.3625000
NODE_4743_length_1121_cov_23.832681	578	658	26	6	80	0.0750000
NODE_4743_length_1121_cov_23.832681	578	658	27	32	80	0.4000000
NODE_4744_length_1121_cov_18.033268	1	42	0	41	41	1.0000000
NODE_4744_length_1121_cov_18.033268	671	751	7	3	80	0.0375000
NODE_4744_length_1121_cov_18.033268	671	751	8	16	80	0.2000000
NODE_4744_length_1121_cov_18.033268	671	751	13	12	80	0.1500000
NODE_4744_length_1121_cov_18.033268	671	751	14	35	80	0.4375000
NODE_4744_length_1121_cov_18.033268	671	751	15	2	80	0.0250000
NODE_4744_length_1121_cov_18.033268	671	751	16	12	80	0.1500000
NODE_4744_length_1121_cov_18.033268	724	804	4	1	80	0.0125000
NODE_4744_length_1121_cov_18.033268	724	804	5	6	80	0.0750000
NODE_4744_length_1121_cov_18.033268	724	804	6	36	80	0.4500000
NODE_4744_length_1121_cov_18.033268	724	804	7	13	80	0.1625000
NODE_4744_length_1121_cov_18.033268	724	804	8	16	80	0.2000000
NODE_4744_length_1121_cov_18.033268	724	804	15	2	80	0.0250000
NODE_4744_length_1121_cov_18.033268	724	804	16	6	80	0.0750000
NODE_4745_length_1121_cov_8.633072	610	690	1	70	80	0.8750000
NODE_4745_length_1121_cov_8.633072	610	690	2	10	80	0.1250000
NODE_4745_length_1121_cov_8.633072	663	743	1	17	80	0.2125000
NODE_4745_length_1121_cov_8.633072	663	743	2	63	80	0.7875000
NODE_4751_length_1120_cov_34.281097	377	457	1	5	80	0.0625000
NODE_4751_length_1120_cov_34.281097	377	457	2	16	80	0.2000000
NODE_4751_length_1120_cov_34.281097	377	457	3	30	80	0.3750000
NODE_4751_length_1120_cov_34.281097	377	457	4	20	80	0.2500000
NODE_4751_length_1120_cov_34.281097	377	457	5	9	80	0.1125000
NODE_4751_length_1120_cov_34.281097	430	510	1	26	80	0.3250000
NODE_4751_length_1120_cov_34.281097	430	510	2	48	80	0.6000000
NODE_4751_length_1120_cov_34.281097	430	510	3	6	80	0.0750000
NODE_4751_length_1120_cov_34.281097	506	586	1	80	80	1.0000000
NODE_4751_length_1120_cov_34.281097	559	639	0	48	80	0.6000000
NODE_4751_length_1120_cov_34.281097	559	639	1	32	80	0.4000000
NODE_4752_length_1120_cov_31.468168	401	481	3	17	80	0.2125000
NODE_4752_length_1120_cov_31.468168	401	481	4	51	80	0.6375000
NODE_4752_length_1120_cov_31.468168	401	481	5	4	80	0.0500000
NODE_4752_length_1120_cov_31.468168	401	481	6	8	80	0.1000000
NODE_4752_length_1120_cov_31.468168	454	534	3	15	80	0.1875000
NODE_4752_length_1120_cov_31.468168	454	534	4	23	80	0.2875000
NODE_4752_length_1120_cov_31.468168	454	534	5	11	80	0.1375000
NODE_4752_length_1120_cov_31.468168	454	534	6	31	80	0.3875000
NODE_4752_length_1120_cov_31.468168	530	610	5	12	80	0.1500000
NODE_4752_length_1120_cov_31.468168	530	610	6	23	80	0.2875000
NODE_4752_length_1120_cov_31.468168	530	610	8	37	80	0.4625000
NODE_4752_length_1120_cov_31.468168	530	610	9	8	80	0.1000000
NODE_4752_length_1120_cov_31.468168	583	663	5	17	80	0.2125000
NODE_4752_length_1120_cov_31.468168	583	663	6	22	80	0.2750000
NODE_4752_length_1120_cov_31.468168	583	663	7	6	80	0.0750000
NODE_4752_length_1120_cov_31.468168	583	663	8	19	80	0.2375000
NODE_4752_length_1120_cov_31.468168	583	663	9	16	80	0.2000000
NODE_4753_length_1120_cov_28.182174	418	498	3	6	80	0.0750000
NODE_4753_length_1120_cov_28.182174	418	498	4	8	80	0.1000000
NODE_4753_length_1120_cov_28.182174	418	498	7	32	80	0.4000000
NODE_4753_length_1120_cov_28.182174	418	498	10	1	80	0.0125000
NODE_4753_length_1120_cov_28.182174	418	498	11	33	80	0.4125000
NODE_4753_length_1120_cov_28.182174	471	551	8	20	80	0.2500000
NODE_4753_length_1120_cov_28.182174	471	551	10	15	80	0.1875000
NODE_4753_length_1120_cov_28.182174	471	551	11	45	80	0.5625000
NODE_4754_length_1120_cov_25.423115	405	485	4	12	80	0.1500000
NODE_4754_length_1120_cov_25.423115	405	485	5	8	80	0.1000000
NODE_4754_length_1120_cov_25.423115	405	485	6	9	80	0.1125000
NODE_4754_length_1120_cov_25.423115	405	485	7	51	80	0.6375000
NODE_4754_length_1120_cov_25.423115	458	538	3	19	80	0.2375000
NODE_4754_length_1120_cov_25.423115	458	538	4	12	80	0.1500000
NODE_4754_length_1120_cov_25.423115	458	538	5	23	80	0.2875000
NODE_4754_length_1120_cov_25.423115	458	538	6	26	80	0.3250000
NODE_4754_length_1120_cov_25.423115	534	614	6	36	80	0.4500000
NODE_4754_length_1120_cov_25.423115	534	614	7	44	80	0.5500000
NODE_4754_length_1120_cov_25.423115	587	667	4	31	80	0.3875000
NODE_4754_length_1120_cov_25.423115	587	667	5	8	80	0.1000000
NODE_4754_length_1120_cov_25.423115	587	667	7	41	80	0.5125000
NODE_4755_length_1120_cov_24.441724	589	662	7	55	73	0.7534246
NODE_4755_length_1120_cov_24.441724	589	662	8	17	73	0.2328767
NODE_4755_length_1120_cov_24.441724	589	662	10	1	73	0.0136986
NODE_4755_length_1120_cov_24.441724	636	716	4	20	80	0.2500000
NODE_4755_length_1120_cov_24.441724	636	716	6	2	80	0.0250000
NODE_4755_length_1120_cov_24.441724	636	716	7	8	80	0.1000000
NODE_4755_length_1120_cov_24.441724	636	716	8	49	80	0.6125000
NODE_4755_length_1120_cov_24.441724	636	716	10	1	80	0.0125000
NODE_4756_length_1120_cov_18.966699	406	486	4	20	80	0.2500000
NODE_4756_length_1120_cov_18.966699	406	486	5	19	80	0.2375000
NODE_4756_length_1120_cov_18.966699	406	486	6	34	80	0.4250000
NODE_4756_length_1120_cov_18.966699	406	486	7	7	80	0.0875000
NODE_4756_length_1120_cov_18.966699	459	539	3	3	80	0.0375000
NODE_4756_length_1120_cov_18.966699	459	539	4	59	80	0.7375000
NODE_4756_length_1120_cov_18.966699	459	539	5	11	80	0.1375000
NODE_4756_length_1120_cov_18.966699	459	539	6	7	80	0.0875000
NODE_4757_length_1120_cov_16.136141	508	588	7	8	80	0.1000000
NODE_4757_length_1120_cov_16.136141	508	588	8	2	80	0.0250000
NODE_4757_length_1120_cov_16.136141	508	588	10	47	80	0.5875000
NODE_4757_length_1120_cov_16.136141	508	588	11	23	80	0.2875000
NODE_4757_length_1120_cov_16.136141	561	641	5	23	80	0.2875000
NODE_4757_length_1120_cov_16.136141	561	641	7	2	80	0.0250000
NODE_4757_length_1120_cov_16.136141	561	641	8	6	80	0.0750000
NODE_4757_length_1120_cov_16.136141	561	641	10	2	80	0.0250000
NODE_4757_length_1120_cov_16.136141	561	641	11	47	80	0.5875000
NODE_4758_length_1120_cov_15.492654	460	540	2	77	80	0.9625000
NODE_4758_length_1120_cov_15.492654	460	540	3	3	80	0.0375000
NODE_4758_length_1120_cov_15.492654	460	540	2	77	80	0.9625000
NODE_4758_length_1120_cov_15.492654	460	540	3	3	80	0.0375000
NODE_4758_length_1120_cov_15.492654	513	593	0	28	80	0.3500000
NODE_4758_length_1120_cov_15.492654	513	593	1	2	80	0.0250000
NODE_4758_length_1120_cov_15.492654	513	593	2	50	80	0.6250000
NODE_4759_length_1120_cov_8.696376	646	726	4	26	80	0.3250000
NODE_4759_length_1120_cov_8.696376	646	726	6	39	80	0.4875000
NODE_4759_length_1120_cov_8.696376	646	726	7	15	80	0.1875000
NODE_4759_length_1120_cov_8.696376	699	779	6	16	80	0.2000000
NODE_4759_length_1120_cov_8.696376	699	779	7	53	80	0.6625000
NODE_4759_length_1120_cov_8.696376	699	779	8	11	80	0.1375000
NODE_4760_length_1120_cov_7.916748	304	384	3	25	80	0.3125000
NODE_4760_length_1120_cov_7.916748	304	384	4	15	80	0.1875000
NODE_4760_length_1120_cov_7.916748	304	384	5	40	80	0.5000000
NODE_4760_length_1120_cov_7.916748	357	437	3	38	80	0.4750000
NODE_4760_length_1120_cov_7.916748	357	437	4	27	80	0.3375000
NODE_4760_length_1120_cov_7.916748	357	437	5	15	80	0.1875000
NODE_4772_length_1119_cov_32.617647	425	505	23	1	80	0.0125000
NODE_4772_length_1119_cov_32.617647	425	505	24	9	80	0.1125000
NODE_4772_length_1119_cov_32.617647	425	505	25	5	80	0.0625000
NODE_4772_length_1119_cov_32.617647	425	505	26	4	80	0.0500000
NODE_4772_length_1119_cov_32.617647	425	505	27	38	80	0.4750000
NODE_4772_length_1119_cov_32.617647	425	505	28	6	80	0.0750000
NODE_4772_length_1119_cov_32.617647	425	505	29	17	80	0.2125000
NODE_4772_length_1119_cov_32.617647	478	558	16	1	80	0.0125000
NODE_4772_length_1119_cov_32.617647	478	558	18	3	80	0.0375000
NODE_4772_length_1119_cov_32.617647	478	558	19	3	80	0.0375000
NODE_4772_length_1119_cov_32.617647	478	558	21	6	80	0.0750000
NODE_4772_length_1119_cov_32.617647	478	558	23	2	80	0.0250000
NODE_4772_length_1119_cov_32.617647	478	558	24	46	80	0.5750000
NODE_4772_length_1119_cov_32.617647	478	558	25	5	80	0.0625000
NODE_4772_length_1119_cov_32.617647	478	558	26	4	80	0.0500000
NODE_4772_length_1119_cov_32.617647	478	558	27	4	80	0.0500000
NODE_4772_length_1119_cov_32.617647	478	558	28	2	80	0.0250000
NODE_4772_length_1119_cov_32.617647	478	558	29	4	80	0.0500000
NODE_4773_length_1119_cov_24.944118	455	535	2	4	80	0.0500000
NODE_4773_length_1119_cov_24.944118	455	535	3	12	80	0.1500000
NODE_4773_length_1119_cov_24.944118	455	535	5	11	80	0.1375000
NODE_4773_length_1119_cov_24.944118	455	535	6	33	80	0.4125000
NODE_4773_length_1119_cov_24.944118	455	535	7	15	80	0.1875000
NODE_4773_length_1119_cov_24.944118	455	535	8	5	80	0.0625000
NODE_4773_length_1119_cov_24.944118	508	588	6	21	80	0.2625000
NODE_4773_length_1119_cov_24.944118	508	588	7	54	80	0.6750000
NODE_4773_length_1119_cov_24.944118	508	588	8	5	80	0.0625000
NODE_4774_length_1119_cov_22.214706	614	694	1	16	80	0.2000000
NODE_4774_length_1119_cov_22.214706	614	694	2	8	80	0.1000000
NODE_4774_length_1119_cov_22.214706	614	694	3	8	80	0.1000000
NODE_4774_length_1119_cov_22.214706	614	694	4	1	80	0.0125000
NODE_4774_length_1119_cov_22.214706	614	694	5	20	80	0.2500000
NODE_4774_length_1119_cov_22.214706	614	694	6	27	80	0.3375000
NODE_4774_length_1119_cov_22.214706	667	747	5	23	80	0.2875000
NODE_4774_length_1119_cov_22.214706	667	747	6	57	80	0.7125000
NODE_4775_length_1119_cov_21.115686	431	511	4	47	80	0.5875000
NODE_4775_length_1119_cov_21.115686	431	511	5	13	80	0.1625000
NODE_4775_length_1119_cov_21.115686	431	511	6	13	80	0.1625000
NODE_4775_length_1119_cov_21.115686	431	511	8	7	80	0.0875000
NODE_4775_length_1119_cov_21.115686	484	564	5	7	80	0.0875000
NODE_4775_length_1119_cov_21.115686	484	564	6	13	80	0.1625000
NODE_4775_length_1119_cov_21.115686	484	564	8	12	80	0.1500000
NODE_4775_length_1119_cov_21.115686	484	564	9	8	80	0.1000000
NODE_4775_length_1119_cov_21.115686	484	564	10	8	80	0.1000000
NODE_4775_length_1119_cov_21.115686	484	564	11	29	80	0.3625000
NODE_4775_length_1119_cov_21.115686	484	564	12	3	80	0.0375000
NODE_4777_length_1119_cov_11.895098	565	645	7	1	80	0.0125000
NODE_4777_length_1119_cov_11.895098	565	645	8	36	80	0.4500000
NODE_4777_length_1119_cov_11.895098	565	645	9	1	80	0.0125000
NODE_4777_length_1119_cov_11.895098	565	645	10	42	80	0.5250000
NODE_4777_length_1119_cov_11.895098	618	698	8	2	80	0.0250000
NODE_4777_length_1119_cov_11.895098	618	698	9	12	80	0.1500000
NODE_4777_length_1119_cov_11.895098	618	698	10	66	80	0.8250000
NODE_4782_length_1119_cov_2.783333	37	99	0	62	62	1.0000000
NODE_4789_length_1118_cov_35.214917	555	635	4	9	80	0.1125000
NODE_4789_length_1118_cov_35.214917	555	635	5	42	80	0.5250000
NODE_4789_length_1118_cov_35.214917	555	635	6	5	80	0.0625000
NODE_4789_length_1118_cov_35.214917	555	635	7	2	80	0.0250000
NODE_4789_length_1118_cov_35.214917	555	635	9	2	80	0.0250000
NODE_4789_length_1118_cov_35.214917	555	635	11	4	80	0.0500000
NODE_4789_length_1118_cov_35.214917	555	635	12	16	80	0.2000000
NODE_4789_length_1118_cov_35.214917	608	688	5	3	80	0.0375000
NODE_4789_length_1118_cov_35.214917	608	688	7	2	80	0.0250000
NODE_4789_length_1118_cov_35.214917	608	688	9	2	80	0.0250000
NODE_4789_length_1118_cov_35.214917	608	688	11	4	80	0.0500000
NODE_4789_length_1118_cov_35.214917	608	688	12	16	80	0.2000000
NODE_4789_length_1118_cov_35.214917	608	688	14	22	80	0.2750000
NODE_4789_length_1118_cov_35.214917	608	688	17	4	80	0.0500000
NODE_4789_length_1118_cov_35.214917	608	688	18	14	80	0.1750000
NODE_4789_length_1118_cov_35.214917	608	688	19	13	80	0.1625000
NODE_4789_length_1118_cov_35.214917	684	764	15	1	80	0.0125000
NODE_4789_length_1118_cov_35.214917	684	764	17	2	80	0.0250000
NODE_4789_length_1118_cov_35.214917	684	764	18	8	80	0.1000000
NODE_4789_length_1118_cov_35.214917	684	764	19	47	80	0.5875000
NODE_4789_length_1118_cov_35.214917	684	764	20	7	80	0.0875000
NODE_4789_length_1118_cov_35.214917	684	764	21	15	80	0.1875000
NODE_4789_length_1118_cov_35.214917	737	817	7	8	80	0.1000000
NODE_4789_length_1118_cov_35.214917	737	817	8	2	80	0.0250000
NODE_4789_length_1118_cov_35.214917	737	817	12	29	80	0.3625000
NODE_4789_length_1118_cov_35.214917	737	817	13	4	80	0.0500000
NODE_4789_length_1118_cov_35.214917	737	817	14	9	80	0.1125000
NODE_4789_length_1118_cov_35.214917	737	817	15	2	80	0.0250000
NODE_4789_length_1118_cov_35.214917	737	817	17	2	80	0.0250000
NODE_4789_length_1118_cov_35.214917	737	817	19	24	80	0.3000000
NODE_4790_length_1118_cov_23.114818	602	682	3	5	80	0.0625000
NODE_4790_length_1118_cov_23.114818	602	682	4	25	80	0.3125000
NODE_4790_length_1118_cov_23.114818	602	682	5	44	80	0.5500000
NODE_4790_length_1118_cov_23.114818	602	682	7	6	80	0.0750000
NODE_4790_length_1118_cov_23.114818	655	735	1	23	80	0.2875000
NODE_4790_length_1118_cov_23.114818	655	735	2	3	80	0.0375000
NODE_4790_length_1118_cov_23.114818	655	735	3	31	80	0.3875000
NODE_4790_length_1118_cov_23.114818	655	735	4	7	80	0.0875000
NODE_4790_length_1118_cov_23.114818	655	735	5	16	80	0.2000000
NODE_4790_length_1118_cov_23.114818	731	811	3	3	80	0.0375000
NODE_4790_length_1118_cov_23.114818	731	811	4	50	80	0.6250000
NODE_4790_length_1118_cov_23.114818	731	811	5	27	80	0.3375000
NODE_4790_length_1118_cov_23.114818	784	864	3	5	80	0.0625000
NODE_4790_length_1118_cov_23.114818	784	864	4	60	80	0.7500000
NODE_4790_length_1118_cov_23.114818	784	864	5	15	80	0.1875000
NODE_4791_length_1118_cov_18.293425	388	463	1	23	75	0.3066667
NODE_4791_length_1118_cov_18.293425	388	463	2	52	75	0.6933333
NODE_4791_length_1118_cov_18.293425	436	516	0	53	80	0.6625000
NODE_4791_length_1118_cov_18.293425	436	516	1	23	80	0.2875000
NODE_4791_length_1118_cov_18.293425	436	516	2	4	80	0.0500000
NODE_4791_length_1118_cov_18.293425	512	592	0	80	80	1.0000000
NODE_4791_length_1118_cov_18.293425	565	645	0	80	80	1.0000000
NODE_4792_length_1118_cov_17.228656	480	560	10	9	80	0.1125000
NODE_4792_length_1118_cov_17.228656	480	560	11	5	80	0.0625000
NODE_4792_length_1118_cov_17.228656	480	560	12	7	80	0.0875000
NODE_4792_length_1118_cov_17.228656	480	560	13	18	80	0.2250000
NODE_4792_length_1118_cov_17.228656	480	560	14	41	80	0.5125000
NODE_4792_length_1118_cov_17.228656	533	613	8	10	80	0.1250000
NODE_4792_length_1118_cov_17.228656	533	613	9	1	80	0.0125000
NODE_4792_length_1118_cov_17.228656	533	613	10	8	80	0.1000000
NODE_4792_length_1118_cov_17.228656	533	613	11	10	80	0.1250000
NODE_4792_length_1118_cov_17.228656	533	613	12	1	80	0.0125000
NODE_4792_length_1118_cov_17.228656	533	613	13	3	80	0.0375000
NODE_4792_length_1118_cov_17.228656	533	613	14	47	80	0.5875000
NODE_4794_length_1118_cov_14.299313	468	548	4	2	80	0.0250000
NODE_4794_length_1118_cov_14.299313	468	548	5	5	80	0.0625000
NODE_4794_length_1118_cov_14.299313	468	548	6	59	80	0.7375000
NODE_4794_length_1118_cov_14.299313	468	548	7	5	80	0.0625000
NODE_4794_length_1118_cov_14.299313	468	548	8	9	80	0.1125000
NODE_4794_length_1118_cov_14.299313	521	601	6	13	80	0.1625000
NODE_4794_length_1118_cov_14.299313	521	601	7	17	80	0.2125000
NODE_4794_length_1118_cov_14.299313	521	601	8	50	80	0.6250000
NODE_4795_length_1118_cov_10.203140	306	386	2	72	80	0.9000000
NODE_4795_length_1118_cov_10.203140	306	386	4	8	80	0.1000000
NODE_4795_length_1118_cov_10.203140	359	439	0	29	80	0.3625000
NODE_4795_length_1118_cov_10.203140	359	439	2	51	80	0.6375000
NODE_4795_length_1118_cov_10.203140	435	515	0	60	80	0.7500000
NODE_4795_length_1118_cov_10.203140	435	515	1	20	80	0.2500000
NODE_4795_length_1118_cov_10.203140	488	568	0	7	80	0.0875000
NODE_4795_length_1118_cov_10.203140	488	568	1	73	80	0.9125000
NODE_4796_length_1118_cov_2.885182	471	551	0	80	80	1.0000000
NODE_4796_length_1118_cov_2.885182	524	604	0	80	80	1.0000000
NODE_4805_length_1117_cov_19.425344	541	621	1	34	80	0.4250000
NODE_4805_length_1117_cov_19.425344	541	621	2	33	80	0.4125000
NODE_4805_length_1117_cov_19.425344	541	621	3	13	80	0.1625000
NODE_4805_length_1117_cov_19.425344	594	674	2	14	80	0.1750000
NODE_4805_length_1117_cov_19.425344	594	674	3	66	80	0.8250000
NODE_4806_length_1117_cov_16.386051	385	465	2	4	80	0.0500000
NODE_4806_length_1117_cov_16.386051	385	465	6	38	80	0.4750000
NODE_4806_length_1117_cov_16.386051	385	465	7	38	80	0.4750000
NODE_4806_length_1117_cov_16.386051	438	518	7	39	80	0.4875000
NODE_4806_length_1117_cov_16.386051	438	518	8	41	80	0.5125000
NODE_4807_length_1117_cov_10.353635	294	374	7	2	80	0.0250000
NODE_4807_length_1117_cov_10.353635	294	374	8	5	80	0.0625000
NODE_4807_length_1117_cov_10.353635	294	374	9	15	80	0.1875000
NODE_4807_length_1117_cov_10.353635	294	374	10	13	80	0.1625000
NODE_4807_length_1117_cov_10.353635	294	374	11	39	80	0.4875000
NODE_4807_length_1117_cov_10.353635	294	374	12	6	80	0.0750000
NODE_4807_length_1117_cov_10.353635	347	427	9	52	80	0.6500000
NODE_4807_length_1117_cov_10.353635	347	427	10	22	80	0.2750000
NODE_4807_length_1117_cov_10.353635	347	427	11	6	80	0.0750000
NODE_4808_length_1117_cov_7.492141	417	497	0	80	80	1.0000000
NODE_4808_length_1117_cov_7.492141	470	550	0	80	80	1.0000000
NODE_4812_length_1117_cov_3.225933	666	728	0	62	62	1.0000000
NODE_4819_length_1116_cov_30.106195	457	537	4	45	80	0.5625000
NODE_4819_length_1116_cov_30.106195	457	537	5	35	80	0.4375000
NODE_4819_length_1116_cov_30.106195	510	590	4	22	80	0.2750000
NODE_4819_length_1116_cov_30.106195	510	590	5	38	80	0.4750000
NODE_4819_length_1116_cov_30.106195	510	590	6	20	80	0.2500000
NODE_4820_length_1116_cov_25.518191	831	911	9	8	80	0.1000000
NODE_4820_length_1116_cov_25.518191	831	911	10	3	80	0.0375000
NODE_4820_length_1116_cov_25.518191	831	911	11	41	80	0.5125000
NODE_4820_length_1116_cov_25.518191	831	911	12	28	80	0.3500000
NODE_4820_length_1116_cov_25.518191	884	964	1	13	80	0.1625000
NODE_4820_length_1116_cov_25.518191	884	964	5	34	80	0.4250000
NODE_4820_length_1116_cov_25.518191	884	964	9	14	80	0.1750000
NODE_4820_length_1116_cov_25.518191	884	964	10	3	80	0.0375000
NODE_4820_length_1116_cov_25.518191	884	964	11	16	80	0.2000000
NODE_4821_length_1116_cov_20.629302	500	580	2	13	80	0.1625000
NODE_4821_length_1116_cov_20.629302	500	580	5	11	80	0.1375000
NODE_4821_length_1116_cov_20.629302	500	580	6	56	80	0.7000000
NODE_4821_length_1116_cov_20.629302	553	633	1	16	80	0.2000000
NODE_4821_length_1116_cov_20.629302	553	633	2	50	80	0.6250000
NODE_4821_length_1116_cov_20.629302	553	633	6	14	80	0.1750000
NODE_4822_length_1116_cov_16.723697	345	425	0	16	80	0.2000000
NODE_4822_length_1116_cov_16.723697	345	425	1	29	80	0.3625000
NODE_4822_length_1116_cov_16.723697	345	425	2	35	80	0.4375000
NODE_4822_length_1116_cov_16.723697	398	478	2	39	80	0.4875000
NODE_4822_length_1116_cov_16.723697	398	478	3	8	80	0.1000000
NODE_4822_length_1116_cov_16.723697	398	478	4	33	80	0.4125000
NODE_4823_length_1116_cov_16.046214	735	815	3	2	80	0.0250000
NODE_4823_length_1116_cov_16.046214	735	815	5	9	80	0.1125000
NODE_4823_length_1116_cov_16.046214	735	815	6	2	80	0.0250000
NODE_4823_length_1116_cov_16.046214	735	815	7	31	80	0.3875000
NODE_4823_length_1116_cov_16.046214	735	815	8	15	80	0.1875000
NODE_4823_length_1116_cov_16.046214	735	815	9	11	80	0.1375000
NODE_4823_length_1116_cov_16.046214	735	815	11	10	80	0.1250000
NODE_4823_length_1116_cov_16.046214	788	868	8	15	80	0.1875000
NODE_4823_length_1116_cov_16.046214	788	868	9	2	80	0.0250000
NODE_4823_length_1116_cov_16.046214	788	868	11	44	80	0.5500000
NODE_4823_length_1116_cov_16.046214	788	868	12	19	80	0.2375000
NODE_4828_length_1116_cov_1.379548	800	880	0	80	80	1.0000000
NODE_4828_length_1116_cov_1.379548	853	933	0	80	80	1.0000000
NODE_4832_length_1115_cov_30.584646	549	629	3	3	80	0.0375000
NODE_4832_length_1115_cov_30.584646	549	629	4	2	80	0.0250000
NODE_4832_length_1115_cov_30.584646	549	629	5	33	80	0.4125000
NODE_4832_length_1115_cov_30.584646	549	629	6	20	80	0.2500000
NODE_4832_length_1115_cov_30.584646	549	629	7	22	80	0.2750000
NODE_4832_length_1115_cov_30.584646	602	682	3	30	80	0.3750000
NODE_4832_length_1115_cov_30.584646	602	682	4	25	80	0.3125000
NODE_4832_length_1115_cov_30.584646	602	682	5	25	80	0.3125000
NODE_4833_length_1115_cov_15.871063	454	534	3	29	80	0.3625000
NODE_4833_length_1115_cov_15.871063	454	534	5	20	80	0.2500000
NODE_4833_length_1115_cov_15.871063	454	534	6	4	80	0.0500000
NODE_4833_length_1115_cov_15.871063	454	534	8	27	80	0.3375000
NODE_4833_length_1115_cov_15.871063	507	587	6	23	80	0.2875000
NODE_4833_length_1115_cov_15.871063	507	587	8	57	80	0.7125000
NODE_4833_length_1115_cov_15.871063	583	663	5	6	80	0.0750000
NODE_4833_length_1115_cov_15.871063	583	663	7	4	80	0.0500000
NODE_4833_length_1115_cov_15.871063	583	663	8	35	80	0.4375000
NODE_4833_length_1115_cov_15.871063	583	663	9	12	80	0.1500000
NODE_4833_length_1115_cov_15.871063	583	663	10	23	80	0.2875000
NODE_4833_length_1115_cov_15.871063	636	716	5	52	80	0.6500000
NODE_4833_length_1115_cov_15.871063	636	716	6	7	80	0.0875000
NODE_4833_length_1115_cov_15.871063	636	716	7	4	80	0.0500000
NODE_4833_length_1115_cov_15.871063	636	716	8	17	80	0.2125000
NODE_4840_length_1114_cov_20.633498	1034	1114	0	80	80	1.0000000
NODE_4840_length_1114_cov_20.633498	1034	1114	0	80	80	1.0000000
NODE_4840_length_1114_cov_20.633498	1034	1114	0	80	80	1.0000000
NODE_4840_length_1114_cov_20.633498	1034	1114	0	80	80	1.0000000
NODE_4840_length_1114_cov_20.633498	1034	1114	0	80	80	1.0000000
NODE_4840_length_1114_cov_20.633498	1043	1114	0	71	71	1.0000000
NODE_4841_length_1114_cov_17.383251	516	601	9	7	85	0.0823529
NODE_4841_length_1114_cov_17.383251	516	601	10	4	85	0.0470588
NODE_4841_length_1114_cov_17.383251	516	601	11	29	85	0.3411765
NODE_4841_length_1114_cov_17.383251	516	601	12	16	85	0.1882353
NODE_4841_length_1114_cov_17.383251	516	601	13	10	85	0.1176471
NODE_4841_length_1114_cov_17.383251	516	601	14	19	85	0.2235294
NODE_4841_length_1114_cov_17.383251	574	653	3	8	79	0.1012658
NODE_4841_length_1114_cov_17.383251	574	653	4	11	79	0.1392405
NODE_4841_length_1114_cov_17.383251	574	653	6	15	79	0.1898734
NODE_4841_length_1114_cov_17.383251	574	653	7	4	79	0.0506329
NODE_4841_length_1114_cov_17.383251	574	653	8	10	79	0.1265823
NODE_4841_length_1114_cov_17.383251	574	653	9	11	79	0.1392405
NODE_4841_length_1114_cov_17.383251	574	653	10	4	79	0.0506329
NODE_4841_length_1114_cov_17.383251	574	653	11	7	79	0.0886076
NODE_4841_length_1114_cov_17.383251	574	653	12	2	79	0.0253165
NODE_4841_length_1114_cov_17.383251	574	653	13	7	79	0.0886076
NODE_4841_length_1114_cov_17.383251	649	729	3	42	80	0.5250000
NODE_4841_length_1114_cov_17.383251	649	729	6	38	80	0.4750000
NODE_4841_length_1114_cov_17.383251	702	782	3	8	80	0.1000000
NODE_4841_length_1114_cov_17.383251	702	782	4	44	80	0.5500000
NODE_4841_length_1114_cov_17.383251	702	782	5	1	80	0.0125000
NODE_4841_length_1114_cov_17.383251	702	782	6	27	80	0.3375000
NODE_4842_length_1114_cov_5.562562	563	643	2	80	80	1.0000000
NODE_4842_length_1114_cov_5.562562	616	696	1	11	80	0.1375000
NODE_4842_length_1114_cov_5.562562	616	696	2	69	80	0.8625000
NODE_4847_length_1113_cov_51.988166	343	423	12	7	80	0.0875000
NODE_4847_length_1113_cov_51.988166	343	423	13	6	80	0.0750000
NODE_4847_length_1113_cov_51.988166	343	423	14	3	80	0.0375000
NODE_4847_length_1113_cov_51.988166	343	423	16	2	80	0.0250000
NODE_4847_length_1113_cov_51.988166	343	423	17	17	80	0.2125000
NODE_4847_length_1113_cov_51.988166	343	423	21	7	80	0.0875000
NODE_4847_length_1113_cov_51.988166	343	423	22	1	80	0.0125000
NODE_4847_length_1113_cov_51.988166	343	423	23	37	80	0.4625000
NODE_4847_length_1113_cov_51.988166	396	476	18	6	80	0.0750000
NODE_4847_length_1113_cov_51.988166	396	476	19	27	80	0.3375000
NODE_4847_length_1113_cov_51.988166	396	476	20	11	80	0.1375000
NODE_4847_length_1113_cov_51.988166	396	476	23	32	80	0.4000000
NODE_4847_length_1113_cov_51.988166	396	476	24	2	80	0.0250000
NODE_4847_length_1113_cov_51.988166	396	476	25	2	80	0.0250000
NODE_4847_length_1113_cov_51.988166	472	552	7	16	80	0.2000000
NODE_4847_length_1113_cov_51.988166	472	552	8	1	80	0.0125000
NODE_4847_length_1113_cov_51.988166	472	552	9	7	80	0.0875000
NODE_4847_length_1113_cov_51.988166	472	552	13	17	80	0.2125000
NODE_4847_length_1113_cov_51.988166	472	552	14	2	80	0.0250000
NODE_4847_length_1113_cov_51.988166	472	552	16	3	80	0.0375000
NODE_4847_length_1113_cov_51.988166	472	552	17	15	80	0.1875000
NODE_4847_length_1113_cov_51.988166	472	552	19	9	80	0.1125000
NODE_4847_length_1113_cov_51.988166	472	552	20	10	80	0.1250000
NODE_4847_length_1113_cov_51.988166	525	605	2	21	80	0.2625000
NODE_4847_length_1113_cov_51.988166	525	605	4	2	80	0.0250000
NODE_4847_length_1113_cov_51.988166	525	605	5	2	80	0.0250000
NODE_4847_length_1113_cov_51.988166	525	605	6	3	80	0.0375000
NODE_4847_length_1113_cov_51.988166	525	605	7	41	80	0.5125000
NODE_4847_length_1113_cov_51.988166	525	605	8	1	80	0.0125000
NODE_4847_length_1113_cov_51.988166	525	605	9	7	80	0.0875000
NODE_4847_length_1113_cov_51.988166	525	605	13	3	80	0.0375000
NODE_4848_length_1113_cov_35.005917	359	439	12	25	80	0.3125000
NODE_4848_length_1113_cov_35.005917	359	439	14	3	80	0.0375000
NODE_4848_length_1113_cov_35.005917	359	439	17	25	80	0.3125000
NODE_4848_length_1113_cov_35.005917	359	439	21	27	80	0.3375000
NODE_4848_length_1113_cov_35.005917	412	492	14	2	80	0.0250000
NODE_4848_length_1113_cov_35.005917	412	492	15	11	80	0.1375000
NODE_4848_length_1113_cov_35.005917	412	492	17	59	80	0.7375000
NODE_4848_length_1113_cov_35.005917	412	492	18	8	80	0.1000000
NODE_4849_length_1113_cov_28.106509	570	650	4	4	80	0.0500000
NODE_4849_length_1113_cov_28.106509	570	650	6	76	80	0.9500000
NODE_4849_length_1113_cov_28.106509	623	703	3	14	80	0.1750000
NODE_4849_length_1113_cov_28.106509	623	703	4	40	80	0.5000000
NODE_4849_length_1113_cov_28.106509	623	703	5	3	80	0.0375000
NODE_4849_length_1113_cov_28.106509	623	703	6	23	80	0.2875000
NODE_4849_length_1113_cov_28.106509	699	779	2	3	80	0.0375000
NODE_4849_length_1113_cov_28.106509	699	779	3	18	80	0.2250000
NODE_4849_length_1113_cov_28.106509	699	779	4	3	80	0.0375000
NODE_4849_length_1113_cov_28.106509	699	779	5	56	80	0.7000000
NODE_4849_length_1113_cov_28.106509	752	832	5	50	80	0.6250000
NODE_4849_length_1113_cov_28.106509	752	832	6	30	80	0.3750000
NODE_4850_length_1113_cov_18.636095	512	592	3	66	80	0.8250000
NODE_4850_length_1113_cov_18.636095	512	592	5	14	80	0.1750000
NODE_4850_length_1113_cov_18.636095	565	645	0	46	80	0.5750000
NODE_4850_length_1113_cov_18.636095	565	645	2	1	80	0.0125000
NODE_4850_length_1113_cov_18.636095	565	645	3	33	80	0.4125000
NODE_4851_length_1113_cov_16.664694	352	432	0	57	80	0.7125000
NODE_4851_length_1113_cov_16.664694	352	432	1	15	80	0.1875000
NODE_4851_length_1113_cov_16.664694	352	432	2	8	80	0.1000000
NODE_4851_length_1113_cov_16.664694	405	485	0	4	80	0.0500000
NODE_4851_length_1113_cov_16.664694	405	485	1	15	80	0.1875000
NODE_4851_length_1113_cov_16.664694	405	485	2	45	80	0.5625000
NODE_4851_length_1113_cov_16.664694	405	485	3	16	80	0.2000000
NODE_4851_length_1113_cov_16.664694	481	561	3	14	80	0.1750000
NODE_4851_length_1113_cov_16.664694	481	561	4	53	80	0.6625000
NODE_4851_length_1113_cov_16.664694	481	561	5	4	80	0.0500000
NODE_4851_length_1113_cov_16.664694	481	561	6	9	80	0.1125000
NODE_4851_length_1113_cov_16.664694	534	614	4	54	80	0.6750000
NODE_4851_length_1113_cov_16.664694	534	614	5	17	80	0.2125000
NODE_4851_length_1113_cov_16.664694	534	614	6	9	80	0.1125000
NODE_4852_length_1113_cov_14.155819	454	512	6	1	58	0.0172414
NODE_4852_length_1113_cov_14.155819	454	512	7	24	58	0.4137931
NODE_4852_length_1113_cov_14.155819	454	512	8	32	58	0.5517241
NODE_4852_length_1113_cov_14.155819	454	512	10	1	58	0.0172414
NODE_4852_length_1113_cov_14.155819	511	575	7	7	64	0.1093750
NODE_4852_length_1113_cov_14.155819	511	575	8	5	64	0.0781250
NODE_4852_length_1113_cov_14.155819	511	575	9	8	64	0.1250000
NODE_4852_length_1113_cov_14.155819	511	575	10	2	64	0.0312500
NODE_4852_length_1113_cov_14.155819	511	575	11	31	64	0.4843750
NODE_4852_length_1113_cov_14.155819	511	575	13	11	64	0.1718750
NODE_4853_length_1113_cov_10.185404	494	574	0	80	80	1.0000000
NODE_4853_length_1113_cov_10.185404	547	627	0	80	80	1.0000000
NODE_4855_length_1113_cov_4.005917	700	780	0	80	80	1.0000000
NODE_4855_length_1113_cov_4.005917	753	833	0	80	80	1.0000000
NODE_4866_length_1112_cov_14.961500	427	507	5	3	80	0.0375000
NODE_4866_length_1112_cov_14.961500	427	507	6	28	80	0.3500000
NODE_4866_length_1112_cov_14.961500	427	507	7	14	80	0.1750000
NODE_4866_length_1112_cov_14.961500	427	507	8	10	80	0.1250000
NODE_4866_length_1112_cov_14.961500	427	507	10	1	80	0.0125000
NODE_4866_length_1112_cov_14.961500	427	507	11	22	80	0.2750000
NODE_4866_length_1112_cov_14.961500	427	507	12	2	80	0.0250000
NODE_4866_length_1112_cov_14.961500	480	560	7	2	80	0.0250000
NODE_4866_length_1112_cov_14.961500	480	560	10	1	80	0.0125000
NODE_4866_length_1112_cov_14.961500	480	560	11	41	80	0.5125000
NODE_4866_length_1112_cov_14.961500	480	560	12	36	80	0.4500000
NODE_4866_length_1112_cov_14.961500	556	636	3	4	80	0.0500000
NODE_4866_length_1112_cov_14.961500	556	636	7	16	80	0.2000000
NODE_4866_length_1112_cov_14.961500	556	636	8	8	80	0.1000000
NODE_4866_length_1112_cov_14.961500	556	636	9	12	80	0.1500000
NODE_4866_length_1112_cov_14.961500	556	636	10	18	80	0.2250000
NODE_4866_length_1112_cov_14.961500	556	636	11	20	80	0.2500000
NODE_4866_length_1112_cov_14.961500	556	636	12	2	80	0.0250000
NODE_4866_length_1112_cov_14.961500	609	689	1	15	80	0.1875000
NODE_4866_length_1112_cov_14.961500	609	689	2	19	80	0.2375000
NODE_4866_length_1112_cov_14.961500	609	689	3	23	80	0.2875000
NODE_4866_length_1112_cov_14.961500	609	689	7	16	80	0.2000000
NODE_4866_length_1112_cov_14.961500	609	689	8	7	80	0.0875000
NODE_4875_length_1112_cov_1.655479	45	123	0	78	78	1.0000000
NODE_4875_length_1112_cov_1.655479	98	166	0	68	68	1.0000000
NODE_4880_length_1111_cov_37.999012	473	553	1	16	80	0.2000000
NODE_4880_length_1111_cov_37.999012	473	553	2	64	80	0.8000000
NODE_4880_length_1111_cov_37.999012	526	606	1	12	80	0.1500000
NODE_4880_length_1111_cov_37.999012	526	606	2	42	80	0.5250000
NODE_4880_length_1111_cov_37.999012	526	606	3	1	80	0.0125000
NODE_4880_length_1111_cov_37.999012	526	606	4	25	80	0.3125000
NODE_4880_length_1111_cov_37.999012	602	682	4	80	80	1.0000000
NODE_4880_length_1111_cov_37.999012	655	735	0	4	80	0.0500000
NODE_4880_length_1111_cov_37.999012	655	735	1	9	80	0.1125000
NODE_4880_length_1111_cov_37.999012	655	735	2	21	80	0.2625000
NODE_4880_length_1111_cov_37.999012	655	735	3	13	80	0.1625000
NODE_4880_length_1111_cov_37.999012	655	735	4	33	80	0.4125000
NODE_4881_length_1111_cov_24.394269	644	724	1	8	80	0.1000000
NODE_4881_length_1111_cov_24.394269	644	724	2	2	80	0.0250000
NODE_4881_length_1111_cov_24.394269	644	724	3	21	80	0.2625000
NODE_4881_length_1111_cov_24.394269	644	724	4	49	80	0.6125000
NODE_4881_length_1111_cov_24.394269	697	777	3	12	80	0.1500000
NODE_4881_length_1111_cov_24.394269	697	777	4	68	80	0.8500000
NODE_4882_length_1111_cov_23.676877	374	454	1	3	80	0.0375000
NODE_4882_length_1111_cov_23.676877	374	454	3	10	80	0.1250000
NODE_4882_length_1111_cov_23.676877	374	454	4	2	80	0.0250000
NODE_4882_length_1111_cov_23.676877	374	454	6	23	80	0.2875000
NODE_4882_length_1111_cov_23.676877	374	454	7	19	80	0.2375000
NODE_4882_length_1111_cov_23.676877	374	454	8	23	80	0.2875000
NODE_4882_length_1111_cov_23.676877	427	507	5	3	80	0.0375000
NODE_4882_length_1111_cov_23.676877	427	507	7	37	80	0.4625000
NODE_4882_length_1111_cov_23.676877	427	507	8	40	80	0.5000000
NODE_4883_length_1111_cov_17.522727	383	463	17	12	80	0.1500000
NODE_4883_length_1111_cov_17.522727	383	463	18	16	80	0.2000000
NODE_4883_length_1111_cov_17.522727	383	463	19	21	80	0.2625000
NODE_4883_length_1111_cov_17.522727	383	463	20	17	80	0.2125000
NODE_4883_length_1111_cov_17.522727	383	463	21	14	80	0.1750000
NODE_4883_length_1111_cov_17.522727	436	516	10	14	80	0.1750000
NODE_4883_length_1111_cov_17.522727	436	516	12	1	80	0.0125000
NODE_4883_length_1111_cov_17.522727	436	516	13	1	80	0.0125000
NODE_4883_length_1111_cov_17.522727	436	516	15	21	80	0.2625000
NODE_4883_length_1111_cov_17.522727	436	516	16	7	80	0.0875000
NODE_4883_length_1111_cov_17.522727	436	516	17	18	80	0.2250000
NODE_4883_length_1111_cov_17.522727	436	516	18	18	80	0.2250000
NODE_4884_length_1111_cov_16.495059	388	468	6	3	80	0.0375000
NODE_4884_length_1111_cov_16.495059	388	468	7	5	80	0.0625000
NODE_4884_length_1111_cov_16.495059	388	468	9	26	80	0.3250000
NODE_4884_length_1111_cov_16.495059	388	468	13	1	80	0.0125000
NODE_4884_length_1111_cov_16.495059	388	468	14	12	80	0.1500000
NODE_4884_length_1111_cov_16.495059	388	468	16	33	80	0.4125000
NODE_4884_length_1111_cov_16.495059	441	521	11	5	80	0.0625000
NODE_4884_length_1111_cov_16.495059	441	521	13	15	80	0.1875000
NODE_4884_length_1111_cov_16.495059	441	521	14	45	80	0.5625000
NODE_4884_length_1111_cov_16.495059	441	521	16	15	80	0.1875000
NODE_4885_length_1111_cov_15.366601	555	635	6	12	80	0.1500000
NODE_4885_length_1111_cov_15.366601	555	635	7	27	80	0.3375000
NODE_4885_length_1111_cov_15.366601	555	635	8	41	80	0.5125000
NODE_4885_length_1111_cov_15.366601	608	688	6	17	80	0.2125000
NODE_4885_length_1111_cov_15.366601	608	688	7	58	80	0.7250000
NODE_4885_length_1111_cov_15.366601	608	688	8	5	80	0.0625000
NODE_4886_length_1111_cov_15.314229	809	889	5	1	80	0.0125000
NODE_4886_length_1111_cov_15.314229	809	889	6	53	80	0.6625000
NODE_4886_length_1111_cov_15.314229	809	889	7	20	80	0.2500000
NODE_4886_length_1111_cov_15.314229	809	889	8	6	80	0.0750000
NODE_4886_length_1111_cov_15.314229	862	942	5	53	80	0.6625000
NODE_4886_length_1111_cov_15.314229	862	942	6	27	80	0.3375000
NODE_4887_length_1111_cov_9.732213	443	523	1	34	80	0.4250000
NODE_4887_length_1111_cov_9.732213	443	523	2	46	80	0.5750000
NODE_4887_length_1111_cov_9.732213	496	576	2	80	80	1.0000000
NODE_4888_length_1111_cov_4.907115	606	686	1	20	80	0.2500000
NODE_4888_length_1111_cov_4.907115	606	686	2	24	80	0.3000000
NODE_4888_length_1111_cov_4.907115	606	686	3	36	80	0.4500000
NODE_4888_length_1111_cov_4.907115	659	739	0	33	80	0.4125000
NODE_4888_length_1111_cov_4.907115	659	739	1	40	80	0.5000000
NODE_4888_length_1111_cov_4.907115	659	739	2	7	80	0.0875000
NODE_4892_length_1110_cov_23.012859	453	533	9	2	80	0.0250000
NODE_4892_length_1110_cov_23.012859	453	533	10	3	80	0.0375000
NODE_4892_length_1110_cov_23.012859	453	533	15	1	80	0.0125000
NODE_4892_length_1110_cov_23.012859	453	533	16	3	80	0.0375000
NODE_4892_length_1110_cov_23.012859	453	533	17	28	80	0.3500000
NODE_4892_length_1110_cov_23.012859	453	533	18	11	80	0.1375000
NODE_4892_length_1110_cov_23.012859	453	533	19	14	80	0.1750000
NODE_4892_length_1110_cov_23.012859	453	533	20	18	80	0.2250000
NODE_4892_length_1110_cov_23.012859	506	586	5	9	80	0.1125000
NODE_4892_length_1110_cov_23.012859	506	586	6	9	80	0.1125000
NODE_4892_length_1110_cov_23.012859	506	586	7	1	80	0.0125000
NODE_4892_length_1110_cov_23.012859	506	586	8	34	80	0.4250000
NODE_4892_length_1110_cov_23.012859	506	586	9	2	80	0.0250000
NODE_4892_length_1110_cov_23.012859	506	586	10	3	80	0.0375000
NODE_4892_length_1110_cov_23.012859	506	586	15	1	80	0.0125000
NODE_4892_length_1110_cov_23.012859	506	586	16	3	80	0.0375000
NODE_4892_length_1110_cov_23.012859	506	586	17	11	80	0.1375000
NODE_4892_length_1110_cov_23.012859	506	586	18	7	80	0.0875000
NODE_4892_length_1110_cov_23.012859	582	662	0	26	80	0.3250000
NODE_4892_length_1110_cov_23.012859	582	662	1	5	80	0.0625000
NODE_4892_length_1110_cov_23.012859	582	662	2	7	80	0.0875000
NODE_4892_length_1110_cov_23.012859	582	662	3	13	80	0.1625000
NODE_4892_length_1110_cov_23.012859	582	662	4	23	80	0.2875000
NODE_4892_length_1110_cov_23.012859	582	662	5	6	80	0.0750000
NODE_4892_length_1110_cov_23.012859	635	715	0	79	80	0.9875000
NODE_4892_length_1110_cov_23.012859	635	715	1	1	80	0.0125000
NODE_4895_length_1110_cov_5.305638	754	834	0	80	80	1.0000000
NODE_4895_length_1110_cov_5.305638	807	887	0	80	80	1.0000000
NODE_4896_length_1110_cov_3.698318	642	685	0	43	43	1.0000000
NODE_4899_length_1110_cov_1.871414	15	86	0	71	71	1.0000000
NODE_4903_length_1109_cov_35.307921	413	493	3	18	80	0.2250000
NODE_4903_length_1109_cov_35.307921	413	493	5	1	80	0.0125000
NODE_4903_length_1109_cov_35.307921	413	493	6	15	80	0.1875000
NODE_4903_length_1109_cov_35.307921	413	493	7	12	80	0.1500000
NODE_4903_length_1109_cov_35.307921	413	493	9	7	80	0.0875000
NODE_4903_length_1109_cov_35.307921	413	493	11	4	80	0.0500000
NODE_4903_length_1109_cov_35.307921	413	493	12	19	80	0.2375000
NODE_4903_length_1109_cov_35.307921	413	493	14	4	80	0.0500000
NODE_4903_length_1109_cov_35.307921	466	546	9	4	80	0.0500000
NODE_4903_length_1109_cov_35.307921	466	546	12	19	80	0.2375000
NODE_4903_length_1109_cov_35.307921	466	546	14	5	80	0.0625000
NODE_4903_length_1109_cov_35.307921	466	546	16	33	80	0.4125000
NODE_4903_length_1109_cov_35.307921	466	546	19	6	80	0.0750000
NODE_4903_length_1109_cov_35.307921	466	546	20	8	80	0.1000000
NODE_4903_length_1109_cov_35.307921	466	546	21	5	80	0.0625000
NODE_4903_length_1109_cov_35.307921	542	622	21	9	80	0.1125000
NODE_4903_length_1109_cov_35.307921	542	622	22	1	80	0.0125000
NODE_4903_length_1109_cov_35.307921	542	622	23	9	80	0.1125000
NODE_4903_length_1109_cov_35.307921	542	622	25	11	80	0.1375000
NODE_4903_length_1109_cov_35.307921	542	622	27	3	80	0.0375000
NODE_4903_length_1109_cov_35.307921	542	622	29	13	80	0.1625000
NODE_4903_length_1109_cov_35.307921	542	622	30	24	80	0.3000000
NODE_4903_length_1109_cov_35.307921	542	622	31	1	80	0.0125000
NODE_4903_length_1109_cov_35.307921	542	622	33	9	80	0.1125000
NODE_4903_length_1109_cov_35.307921	595	675	18	31	80	0.3875000
NODE_4903_length_1109_cov_35.307921	595	675	20	5	80	0.0625000
NODE_4903_length_1109_cov_35.307921	595	675	22	18	80	0.2250000
NODE_4903_length_1109_cov_35.307921	595	675	23	1	80	0.0125000
NODE_4903_length_1109_cov_35.307921	595	675	25	11	80	0.1375000
NODE_4903_length_1109_cov_35.307921	595	675	29	12	80	0.1500000
NODE_4903_length_1109_cov_35.307921	595	675	30	2	80	0.0250000
NODE_4904_length_1109_cov_27.880198	501	581	6	45	80	0.5625000
NODE_4904_length_1109_cov_27.880198	501	581	7	19	80	0.2375000
NODE_4904_length_1109_cov_27.880198	501	581	8	12	80	0.1500000
NODE_4904_length_1109_cov_27.880198	501	581	9	4	80	0.0500000
NODE_4904_length_1109_cov_27.880198	554	634	4	35	80	0.4375000
NODE_4904_length_1109_cov_27.880198	554	634	6	23	80	0.2875000
NODE_4904_length_1109_cov_27.880198	554	634	7	22	80	0.2750000
NODE_4904_length_1109_cov_27.880198	630	710	4	23	80	0.2875000
NODE_4904_length_1109_cov_27.880198	630	710	5	35	80	0.4375000
NODE_4904_length_1109_cov_27.880198	630	710	6	22	80	0.2750000
NODE_4904_length_1109_cov_27.880198	683	763	3	38	80	0.4750000
NODE_4904_length_1109_cov_27.880198	683	763	4	27	80	0.3375000
NODE_4904_length_1109_cov_27.880198	683	763	5	15	80	0.1875000
NODE_4905_length_1109_cov_21.858416	571	651	3	6	80	0.0750000
NODE_4905_length_1109_cov_21.858416	571	651	4	20	80	0.2500000
NODE_4905_length_1109_cov_21.858416	571	651	5	23	80	0.2875000
NODE_4905_length_1109_cov_21.858416	571	651	7	2	80	0.0250000
NODE_4905_length_1109_cov_21.858416	571	651	8	10	80	0.1250000
NODE_4905_length_1109_cov_21.858416	571	651	9	4	80	0.0500000
NODE_4905_length_1109_cov_21.858416	571	651	10	10	80	0.1250000
NODE_4905_length_1109_cov_21.858416	571	651	11	5	80	0.0625000
NODE_4905_length_1109_cov_21.858416	624	704	8	8	80	0.1000000
NODE_4905_length_1109_cov_21.858416	624	704	9	4	80	0.0500000
NODE_4905_length_1109_cov_21.858416	624	704	10	16	80	0.2000000
NODE_4905_length_1109_cov_21.858416	624	704	11	23	80	0.2875000
NODE_4905_length_1109_cov_21.858416	624	704	12	7	80	0.0875000
NODE_4905_length_1109_cov_21.858416	624	704	14	22	80	0.2750000
NODE_4912_length_1108_cov_59.921705	386	466	15	1	80	0.0125000
NODE_4912_length_1108_cov_59.921705	386	466	16	2	80	0.0250000
NODE_4912_length_1108_cov_59.921705	386	466	17	23	80	0.2875000
NODE_4912_length_1108_cov_59.921705	386	466	18	10	80	0.1250000
NODE_4912_length_1108_cov_59.921705	386	466	19	32	80	0.4000000
NODE_4912_length_1108_cov_59.921705	386	466	20	11	80	0.1375000
NODE_4912_length_1108_cov_59.921705	386	466	21	1	80	0.0125000
NODE_4912_length_1108_cov_59.921705	439	519	9	6	80	0.0750000
NODE_4912_length_1108_cov_59.921705	439	519	12	10	80	0.1250000
NODE_4912_length_1108_cov_59.921705	439	519	14	4	80	0.0500000
NODE_4912_length_1108_cov_59.921705	439	519	16	24	80	0.3000000
NODE_4912_length_1108_cov_59.921705	439	519	18	19	80	0.2375000
NODE_4912_length_1108_cov_59.921705	439	519	19	17	80	0.2125000
NODE_4912_length_1108_cov_59.921705	515	595	8	4	80	0.0500000
NODE_4912_length_1108_cov_59.921705	515	595	9	14	80	0.1750000
NODE_4912_length_1108_cov_59.921705	515	595	10	16	80	0.2000000
NODE_4912_length_1108_cov_59.921705	515	595	11	18	80	0.2250000
NODE_4912_length_1108_cov_59.921705	515	595	12	6	80	0.0750000
NODE_4912_length_1108_cov_59.921705	515	595	13	2	80	0.0250000
NODE_4912_length_1108_cov_59.921705	515	595	14	11	80	0.1375000
NODE_4912_length_1108_cov_59.921705	515	595	16	5	80	0.0625000
NODE_4912_length_1108_cov_59.921705	515	595	19	4	80	0.0500000
NODE_4912_length_1108_cov_59.921705	568	648	8	4	80	0.0500000
NODE_4912_length_1108_cov_59.921705	568	648	9	3	80	0.0375000
NODE_4912_length_1108_cov_59.921705	568	648	10	2	80	0.0250000
NODE_4912_length_1108_cov_59.921705	568	648	11	7	80	0.0875000
NODE_4912_length_1108_cov_59.921705	568	648	12	1	80	0.0125000
NODE_4912_length_1108_cov_59.921705	568	648	13	1	80	0.0125000
NODE_4912_length_1108_cov_59.921705	568	648	16	5	80	0.0625000
NODE_4912_length_1108_cov_59.921705	568	648	19	23	80	0.2875000
NODE_4912_length_1108_cov_59.921705	568	648	20	19	80	0.2375000
NODE_4912_length_1108_cov_59.921705	568	648	21	15	80	0.1875000
NODE_4914_length_1108_cov_16.069376	513	593	3	80	80	1.0000000
NODE_4914_length_1108_cov_16.069376	566	646	0	14	80	0.1750000
NODE_4914_length_1108_cov_16.069376	566	646	3	66	80	0.8250000
NODE_4916_length_1108_cov_11.656095	333	413	3	80	80	1.0000000
NODE_4916_length_1108_cov_11.656095	386	466	3	80	80	1.0000000
NODE_4917_length_1108_cov_10.266601	431	511	2	60	80	0.7500000
NODE_4917_length_1108_cov_10.266601	431	511	3	20	80	0.2500000
NODE_4917_length_1108_cov_10.266601	484	564	2	44	80	0.5500000
NODE_4917_length_1108_cov_10.266601	484	564	3	36	80	0.4500000
NODE_4918_length_1108_cov_8.895937	635	715	2	18	80	0.2250000
NODE_4918_length_1108_cov_8.895937	635	715	4	33	80	0.4125000
NODE_4918_length_1108_cov_8.895937	635	715	5	1	80	0.0125000
NODE_4918_length_1108_cov_8.895937	635	715	6	28	80	0.3500000
NODE_4918_length_1108_cov_8.895937	688	768	2	19	80	0.2375000
NODE_4918_length_1108_cov_8.895937	688	768	4	41	80	0.5125000
NODE_4918_length_1108_cov_8.895937	688	768	6	20	80	0.2500000
NODE_4920_length_1108_cov_5.682854	577	657	0	80	80	1.0000000
NODE_4920_length_1108_cov_5.682854	630	710	0	80	80	1.0000000
NODE_4927_length_1107_cov_35.050595	423	503	1	25	80	0.3125000
NODE_4927_length_1107_cov_35.050595	423	503	2	47	80	0.5875000
NODE_4927_length_1107_cov_35.050595	423	503	3	8	80	0.1000000
NODE_4927_length_1107_cov_35.050595	476	556	1	17	80	0.2125000
NODE_4927_length_1107_cov_35.050595	476	556	2	2	80	0.0250000
NODE_4927_length_1107_cov_35.050595	476	556	3	17	80	0.2125000
NODE_4927_length_1107_cov_35.050595	476	556	4	39	80	0.4875000
NODE_4927_length_1107_cov_35.050595	476	556	5	5	80	0.0625000
NODE_4927_length_1107_cov_35.050595	552	632	4	24	80	0.3000000
NODE_4927_length_1107_cov_35.050595	552	632	6	10	80	0.1250000
NODE_4927_length_1107_cov_35.050595	552	632	7	13	80	0.1625000
NODE_4927_length_1107_cov_35.050595	552	632	8	33	80	0.4125000
NODE_4927_length_1107_cov_35.050595	605	685	6	14	80	0.1750000
NODE_4927_length_1107_cov_35.050595	605	685	7	22	80	0.2750000
NODE_4927_length_1107_cov_35.050595	605	685	8	44	80	0.5500000
NODE_4928_length_1107_cov_31.386905	422	502	15	2	80	0.0250000
NODE_4928_length_1107_cov_31.386905	422	502	17	5	80	0.0625000
NODE_4928_length_1107_cov_31.386905	422	502	25	6	80	0.0750000
NODE_4928_length_1107_cov_31.386905	422	502	26	22	80	0.2750000
NODE_4928_length_1107_cov_31.386905	422	502	27	9	80	0.1125000
NODE_4928_length_1107_cov_31.386905	422	502	28	1	80	0.0125000
NODE_4928_length_1107_cov_31.386905	422	502	29	2	80	0.0250000
NODE_4928_length_1107_cov_31.386905	422	502	32	11	80	0.1375000
NODE_4928_length_1107_cov_31.386905	422	502	33	3	80	0.0375000
NODE_4928_length_1107_cov_31.386905	422	502	34	9	80	0.1125000
NODE_4928_length_1107_cov_31.386905	422	502	35	5	80	0.0625000
NODE_4928_length_1107_cov_31.386905	422	502	36	4	80	0.0500000
NODE_4928_length_1107_cov_31.386905	422	502	37	1	80	0.0125000
NODE_4928_length_1107_cov_31.386905	475	555	32	6	80	0.0750000
NODE_4928_length_1107_cov_31.386905	475	555	33	2	80	0.0250000
NODE_4928_length_1107_cov_31.386905	475	555	34	9	80	0.1125000
NODE_4928_length_1107_cov_31.386905	475	555	35	5	80	0.0625000
NODE_4928_length_1107_cov_31.386905	475	555	36	13	80	0.1625000
NODE_4928_length_1107_cov_31.386905	475	555	37	4	80	0.0500000
NODE_4928_length_1107_cov_31.386905	475	555	39	12	80	0.1500000
NODE_4928_length_1107_cov_31.386905	475	555	40	3	80	0.0375000
NODE_4928_length_1107_cov_31.386905	475	555	42	26	80	0.3250000
NODE_4929_length_1107_cov_29.178571	577	657	16	8	80	0.1000000
NODE_4929_length_1107_cov_29.178571	577	657	18	5	80	0.0625000
NODE_4929_length_1107_cov_29.178571	577	657	21	28	80	0.3500000
NODE_4929_length_1107_cov_29.178571	577	657	22	39	80	0.4875000
NODE_4929_length_1107_cov_29.178571	630	710	10	10	80	0.1250000
NODE_4929_length_1107_cov_29.178571	630	710	14	5	80	0.0625000
NODE_4929_length_1107_cov_29.178571	630	710	15	5	80	0.0625000
NODE_4929_length_1107_cov_29.178571	630	710	16	2	80	0.0250000
NODE_4929_length_1107_cov_29.178571	630	710	17	9	80	0.1125000
NODE_4929_length_1107_cov_29.178571	630	710	18	9	80	0.1125000
NODE_4929_length_1107_cov_29.178571	630	710	19	3	80	0.0375000
NODE_4929_length_1107_cov_29.178571	630	710	20	7	80	0.0875000
NODE_4929_length_1107_cov_29.178571	630	710	21	19	80	0.2375000
NODE_4929_length_1107_cov_29.178571	630	710	22	11	80	0.1375000
NODE_4929_length_1107_cov_29.178571	934	1000	3	66	66	1.0000000
NODE_4929_length_1107_cov_29.178571	934	1005	3	71	71	1.0000000
NODE_4930_length_1107_cov_16.038690	574	654	6	15	80	0.1875000
NODE_4930_length_1107_cov_16.038690	574	654	8	17	80	0.2125000
NODE_4930_length_1107_cov_16.038690	574	654	10	2	80	0.0250000
NODE_4930_length_1107_cov_16.038690	574	654	12	15	80	0.1875000
NODE_4930_length_1107_cov_16.038690	574	654	14	31	80	0.3875000
NODE_4930_length_1107_cov_16.038690	627	707	8	10	80	0.1250000
NODE_4930_length_1107_cov_16.038690	627	707	10	12	80	0.1500000
NODE_4930_length_1107_cov_16.038690	627	707	12	22	80	0.2750000
NODE_4930_length_1107_cov_16.038690	627	707	13	7	80	0.0875000
NODE_4930_length_1107_cov_16.038690	627	707	14	29	80	0.3625000
NODE_4931_length_1107_cov_15.472222	78	158	7	4	80	0.0500000
NODE_4931_length_1107_cov_15.472222	78	158	11	3	80	0.0375000
NODE_4931_length_1107_cov_15.472222	78	158	12	2	80	0.0250000
NODE_4931_length_1107_cov_15.472222	78	158	13	1	80	0.0125000
NODE_4931_length_1107_cov_15.472222	78	158	14	70	80	0.8750000
NODE_4931_length_1107_cov_15.472222	131	194	1	2	63	0.0317460
NODE_4931_length_1107_cov_15.472222	131	194	3	21	63	0.3333333
NODE_4931_length_1107_cov_15.472222	131	194	4	1	63	0.0158730
NODE_4931_length_1107_cov_15.472222	131	194	5	11	63	0.1746032
NODE_4931_length_1107_cov_15.472222	131	194	7	5	63	0.0793651
NODE_4931_length_1107_cov_15.472222	131	194	11	3	63	0.0476190
NODE_4931_length_1107_cov_15.472222	131	194	12	2	63	0.0317460
NODE_4931_length_1107_cov_15.472222	131	194	13	1	63	0.0158730
NODE_4931_length_1107_cov_15.472222	131	194	14	17	63	0.2698413
NODE_4931_length_1107_cov_15.472222	952	995	0	43	43	1.0000000
NODE_4931_length_1107_cov_15.472222	968	1052	0	84	84	1.0000000
NODE_4932_length_1107_cov_13.911706	502	582	2	42	80	0.5250000
NODE_4932_length_1107_cov_13.911706	502	582	4	38	80	0.4750000
NODE_4932_length_1107_cov_13.911706	555	635	0	15	80	0.1875000
NODE_4932_length_1107_cov_13.911706	555	635	2	65	80	0.8125000
NODE_4933_length_1107_cov_11.701389	520	600	0	80	80	1.0000000
NODE_4933_length_1107_cov_11.701389	573	653	0	80	80	1.0000000
NODE_4944_length_1106_cov_59.617676	452	532	13	3	80	0.0375000
NODE_4944_length_1106_cov_59.617676	452	532	14	21	80	0.2625000
NODE_4944_length_1106_cov_59.617676	452	532	15	28	80	0.3500000
NODE_4944_length_1106_cov_59.617676	452	532	16	13	80	0.1625000
NODE_4944_length_1106_cov_59.617676	452	532	17	3	80	0.0375000
NODE_4944_length_1106_cov_59.617676	452	532	21	5	80	0.0625000
NODE_4944_length_1106_cov_59.617676	452	532	22	7	80	0.0875000
NODE_4944_length_1106_cov_59.617676	505	585	6	24	80	0.3000000
NODE_4944_length_1106_cov_59.617676	505	585	15	12	80	0.1500000
NODE_4944_length_1106_cov_59.617676	505	585	16	13	80	0.1625000
NODE_4944_length_1106_cov_59.617676	505	585	17	31	80	0.3875000
NODE_4944_length_1106_cov_59.617676	581	661	3	3	80	0.0375000
NODE_4944_length_1106_cov_59.617676	581	661	4	52	80	0.6500000
NODE_4944_length_1106_cov_59.617676	581	661	5	14	80	0.1750000
NODE_4944_length_1106_cov_59.617676	581	661	6	11	80	0.1375000
NODE_4944_length_1106_cov_59.617676	634	714	2	19	80	0.2375000
NODE_4944_length_1106_cov_59.617676	634	714	3	31	80	0.3875000
NODE_4944_length_1106_cov_59.617676	634	714	4	30	80	0.3750000
NODE_4945_length_1106_cov_40.808342	439	504	0	32	65	0.4923077
NODE_4945_length_1106_cov_40.808342	439	504	5	33	65	0.5076923
NODE_4945_length_1106_cov_40.808342	471	511	0	39	40	0.9750000
NODE_4945_length_1106_cov_40.808342	471	511	5	1	40	0.0250000
NODE_4945_length_1106_cov_40.808342	503	569	0	66	66	1.0000000
NODE_4945_length_1106_cov_40.808342	536	601	0	65	65	1.0000000
NODE_4945_length_1106_cov_40.808342	568	648	0	80	80	1.0000000
NODE_4945_length_1106_cov_40.808342	621	682	0	52	61	0.8524590
NODE_4945_length_1106_cov_40.808342	621	682	4	9	61	0.1475410
NODE_4946_length_1106_cov_23.186693	560	640	15	35	80	0.4375000
NODE_4946_length_1106_cov_23.186693	560	640	16	40	80	0.5000000
NODE_4946_length_1106_cov_23.186693	560	640	17	3	80	0.0375000
NODE_4946_length_1106_cov_23.186693	560	640	18	2	80	0.0250000
NODE_4946_length_1106_cov_23.186693	613	693	9	5	80	0.0625000
NODE_4946_length_1106_cov_23.186693	613	693	10	9	80	0.1125000
NODE_4946_length_1106_cov_23.186693	613	693	11	6	80	0.0750000
NODE_4946_length_1106_cov_23.186693	613	693	12	7	80	0.0875000
NODE_4946_length_1106_cov_23.186693	613	693	13	14	80	0.1750000
NODE_4946_length_1106_cov_23.186693	613	693	14	6	80	0.0750000
NODE_4946_length_1106_cov_23.186693	613	693	16	33	80	0.4125000
NODE_4947_length_1106_cov_14.570010	466	546	5	8	80	0.1000000
NODE_4947_length_1106_cov_14.570010	466	546	6	1	80	0.0125000
NODE_4947_length_1106_cov_14.570010	466	546	8	28	80	0.3500000
NODE_4947_length_1106_cov_14.570010	466	546	9	6	80	0.0750000
NODE_4947_length_1106_cov_14.570010	466	546	10	32	80	0.4000000
NODE_4947_length_1106_cov_14.570010	466	546	11	5	80	0.0625000
NODE_4947_length_1106_cov_14.570010	519	599	6	13	80	0.1625000
NODE_4947_length_1106_cov_14.570010	519	599	8	7	80	0.0875000
NODE_4947_length_1106_cov_14.570010	519	599	9	30	80	0.3750000
NODE_4947_length_1106_cov_14.570010	519	599	10	22	80	0.2750000
NODE_4947_length_1106_cov_14.570010	519	599	11	8	80	0.1000000
NODE_4948_length_1106_cov_14.039722	487	567	0	80	80	1.0000000
NODE_4948_length_1106_cov_14.039722	540	620	0	80	80	1.0000000
NODE_4949_length_1106_cov_8.872890	328	408	2	28	80	0.3500000
NODE_4949_length_1106_cov_8.872890	328	408	3	21	80	0.2625000
NODE_4949_length_1106_cov_8.872890	328	408	6	1	80	0.0125000
NODE_4949_length_1106_cov_8.872890	328	408	7	30	80	0.3750000
NODE_4949_length_1106_cov_8.872890	381	461	5	6	80	0.0750000
NODE_4949_length_1106_cov_8.872890	381	461	6	35	80	0.4375000
NODE_4949_length_1106_cov_8.872890	381	461	7	39	80	0.4875000
NODE_4950_length_1106_cov_7.157895	332	412	6	8	80	0.1000000
NODE_4950_length_1106_cov_7.157895	332	412	8	7	80	0.0875000
NODE_4950_length_1106_cov_7.157895	332	412	9	2	80	0.0250000
NODE_4950_length_1106_cov_7.157895	332	412	10	33	80	0.4125000
NODE_4950_length_1106_cov_7.157895	332	412	12	28	80	0.3500000
NODE_4950_length_1106_cov_7.157895	332	412	14	2	80	0.0250000
NODE_4950_length_1106_cov_7.157895	385	465	11	15	80	0.1875000
NODE_4950_length_1106_cov_7.157895	385	465	12	34	80	0.4250000
NODE_4950_length_1106_cov_7.157895	385	465	13	12	80	0.1500000
NODE_4950_length_1106_cov_7.157895	385	465	14	19	80	0.2375000
NODE_4951_length_1106_cov_6.530288	513	593	3	23	80	0.2875000
NODE_4951_length_1106_cov_6.530288	513	593	4	1	80	0.0125000
NODE_4951_length_1106_cov_6.530288	513	593	5	1	80	0.0125000
NODE_4951_length_1106_cov_6.530288	513	593	6	41	80	0.5125000
NODE_4951_length_1106_cov_6.530288	513	593	7	14	80	0.1750000
NODE_4951_length_1106_cov_6.530288	566	646	2	4	80	0.0500000
NODE_4951_length_1106_cov_6.530288	566	646	3	57	80	0.7125000
NODE_4951_length_1106_cov_6.530288	566	646	4	16	80	0.2000000
NODE_4951_length_1106_cov_6.530288	566	646	5	1	80	0.0125000
NODE_4951_length_1106_cov_6.530288	566	646	6	2	80	0.0250000
NODE_4959_length_1105_cov_28.126243	253	333	37	5	80	0.0625000
NODE_4959_length_1105_cov_28.126243	253	333	40	8	80	0.1000000
NODE_4959_length_1105_cov_28.126243	253	333	41	1	80	0.0125000
NODE_4959_length_1105_cov_28.126243	253	333	43	1	80	0.0125000
NODE_4959_length_1105_cov_28.126243	253	333	56	2	80	0.0250000
NODE_4959_length_1105_cov_28.126243	253	333	60	10	80	0.1250000
NODE_4959_length_1105_cov_28.126243	253	333	62	2	80	0.0250000
NODE_4959_length_1105_cov_28.126243	253	333	63	1	80	0.0125000
NODE_4959_length_1105_cov_28.126243	253	333	65	16	80	0.2000000
NODE_4959_length_1105_cov_28.126243	253	333	67	1	80	0.0125000
NODE_4959_length_1105_cov_28.126243	253	333	68	8	80	0.1000000
NODE_4959_length_1105_cov_28.126243	253	333	69	9	80	0.1125000
NODE_4959_length_1105_cov_28.126243	253	333	70	2	80	0.0250000
NODE_4959_length_1105_cov_28.126243	253	333	71	7	80	0.0875000
NODE_4959_length_1105_cov_28.126243	253	333	74	2	80	0.0250000
NODE_4959_length_1105_cov_28.126243	253	333	75	3	80	0.0375000
NODE_4959_length_1105_cov_28.126243	253	333	76	2	80	0.0250000
NODE_4959_length_1105_cov_28.126243	306	386	62	2	80	0.0250000
NODE_4959_length_1105_cov_28.126243	306	386	63	1	80	0.0125000
NODE_4959_length_1105_cov_28.126243	306	386	67	4	80	0.0500000
NODE_4959_length_1105_cov_28.126243	306	386	68	1	80	0.0125000
NODE_4959_length_1105_cov_28.126243	306	386	69	8	80	0.1000000
NODE_4959_length_1105_cov_28.126243	306	386	70	6	80	0.0750000
NODE_4959_length_1105_cov_28.126243	306	386	71	7	80	0.0875000
NODE_4959_length_1105_cov_28.126243	306	386	73	1	80	0.0125000
NODE_4959_length_1105_cov_28.126243	306	386	74	5	80	0.0625000
NODE_4959_length_1105_cov_28.126243	306	386	75	4	80	0.0500000
NODE_4959_length_1105_cov_28.126243	306	386	76	6	80	0.0750000
NODE_4959_length_1105_cov_28.126243	306	386	78	6	80	0.0750000
NODE_4959_length_1105_cov_28.126243	306	386	79	5	80	0.0625000
NODE_4959_length_1105_cov_28.126243	306	386	80	1	80	0.0125000
NODE_4959_length_1105_cov_28.126243	306	386	81	10	80	0.1250000
NODE_4959_length_1105_cov_28.126243	306	386	83	4	80	0.0500000
NODE_4959_length_1105_cov_28.126243	306	386	84	9	80	0.1125000
NODE_4960_length_1105_cov_24.994036	549	629	4	27	80	0.3375000
NODE_4960_length_1105_cov_24.994036	549	629	5	2	80	0.0250000
NODE_4960_length_1105_cov_24.994036	549	629	6	51	80	0.6375000
NODE_4960_length_1105_cov_24.994036	602	682	2	12	80	0.1500000
NODE_4960_length_1105_cov_24.994036	602	682	4	59	80	0.7375000
NODE_4960_length_1105_cov_24.994036	602	682	5	1	80	0.0125000
NODE_4960_length_1105_cov_24.994036	602	682	6	8	80	0.1000000
NODE_4961_length_1105_cov_17.635189	442	522	7	23	80	0.2875000
NODE_4961_length_1105_cov_17.635189	442	522	8	45	80	0.5625000
NODE_4961_length_1105_cov_17.635189	442	522	9	6	80	0.0750000
NODE_4961_length_1105_cov_17.635189	442	522	10	6	80	0.0750000
NODE_4961_length_1105_cov_17.635189	495	575	5	6	80	0.0750000
NODE_4961_length_1105_cov_17.635189	495	575	6	13	80	0.1625000
NODE_4961_length_1105_cov_17.635189	495	575	7	1	80	0.0125000
NODE_4961_length_1105_cov_17.635189	495	575	8	37	80	0.4625000
NODE_4961_length_1105_cov_17.635189	495	575	9	11	80	0.1375000
NODE_4961_length_1105_cov_17.635189	495	575	10	12	80	0.1500000
NODE_4963_length_1105_cov_10.114314	438	518	2	3	80	0.0375000
NODE_4963_length_1105_cov_10.114314	438	518	4	16	80	0.2000000
NODE_4963_length_1105_cov_10.114314	438	518	5	18	80	0.2250000
NODE_4963_length_1105_cov_10.114314	438	518	6	43	80	0.5375000
NODE_4963_length_1105_cov_10.114314	491	571	1	31	80	0.3875000
NODE_4963_length_1105_cov_10.114314	491	571	2	25	80	0.3125000
NODE_4963_length_1105_cov_10.114314	491	571	4	16	80	0.2000000
NODE_4963_length_1105_cov_10.114314	491	571	6	8	80	0.1000000
NODE_4964_length_1105_cov_8.403579	507	587	3	20	80	0.2500000
NODE_4964_length_1105_cov_8.403579	507	587	4	60	80	0.7500000
NODE_4964_length_1105_cov_8.403579	560	640	2	7	80	0.0875000
NODE_4964_length_1105_cov_8.403579	560	640	3	6	80	0.0750000
NODE_4964_length_1105_cov_8.403579	560	640	4	67	80	0.8375000
NODE_4966_length_1105_cov_6.682903	467	547	0	80	80	1.0000000
NODE_4966_length_1105_cov_6.682903	520	600	0	51	80	0.6375000
NODE_4966_length_1105_cov_6.682903	520	600	2	29	80	0.3625000
NODE_4966_length_1105_cov_6.682903	596	676	2	80	80	1.0000000
NODE_4966_length_1105_cov_6.682903	649	729	2	43	80	0.5375000
NODE_4966_length_1105_cov_6.682903	649	729	3	2	80	0.0250000
NODE_4966_length_1105_cov_6.682903	649	729	4	35	80	0.4375000
NODE_4974_length_1104_cov_27.599005	388	468	13	3	80	0.0375000
NODE_4974_length_1104_cov_27.599005	388	468	14	17	80	0.2125000
NODE_4974_length_1104_cov_27.599005	388	468	16	8	80	0.1000000
NODE_4974_length_1104_cov_27.599005	388	468	17	38	80	0.4750000
NODE_4974_length_1104_cov_27.599005	388	468	18	14	80	0.1750000
NODE_4974_length_1104_cov_27.599005	441	521	14	46	80	0.5750000
NODE_4974_length_1104_cov_27.599005	441	521	15	2	80	0.0250000
NODE_4974_length_1104_cov_27.599005	441	521	16	4	80	0.0500000
NODE_4974_length_1104_cov_27.599005	441	521	17	19	80	0.2375000
NODE_4974_length_1104_cov_27.599005	441	521	18	9	80	0.1125000
NODE_4984_length_1103_cov_2.787849	620	682	0	16	62	0.2580645
NODE_4984_length_1103_cov_2.787849	620	682	1	46	62	0.7419355
NODE_4986_length_1102_cov_34.484546	667	747	12	11	80	0.1375000
NODE_4986_length_1102_cov_34.484546	667	747	14	20	80	0.2500000
NODE_4986_length_1102_cov_34.484546	667	747	15	49	80	0.6125000
NODE_4986_length_1102_cov_34.484546	720	800	6	8	80	0.1000000
NODE_4986_length_1102_cov_34.484546	720	800	8	4	80	0.0500000
NODE_4986_length_1102_cov_34.484546	720	800	9	22	80	0.2750000
NODE_4986_length_1102_cov_34.484546	720	800	10	4	80	0.0500000
NODE_4986_length_1102_cov_34.484546	720	800	11	2	80	0.0250000
NODE_4986_length_1102_cov_34.484546	720	800	12	2	80	0.0250000
NODE_4986_length_1102_cov_34.484546	720	800	13	7	80	0.0875000
NODE_4986_length_1102_cov_34.484546	720	800	14	3	80	0.0375000
NODE_4986_length_1102_cov_34.484546	720	800	15	28	80	0.3500000
NODE_4987_length_1102_cov_17.631107	511	587	10	7	76	0.0921053
NODE_4987_length_1102_cov_17.631107	511	587	11	6	76	0.0789474
NODE_4987_length_1102_cov_17.631107	511	587	12	24	76	0.3157895
NODE_4987_length_1102_cov_17.631107	511	587	13	39	76	0.5131579
NODE_4987_length_1102_cov_17.631107	560	640	5	10	80	0.1250000
NODE_4987_length_1102_cov_17.631107	560	640	7	12	80	0.1500000
NODE_4987_length_1102_cov_17.631107	560	640	9	12	80	0.1500000
NODE_4987_length_1102_cov_17.631107	560	640	10	1	80	0.0125000
NODE_4987_length_1102_cov_17.631107	560	640	11	2	80	0.0250000
NODE_4987_length_1102_cov_17.631107	560	640	12	4	80	0.0500000
NODE_4987_length_1102_cov_17.631107	560	640	13	39	80	0.4875000
NODE_4998_length_1101_cov_35.638723	414	491	2	24	77	0.3116883
NODE_4998_length_1101_cov_35.638723	414	491	3	15	77	0.1948052
NODE_4998_length_1101_cov_35.638723	414	491	4	34	77	0.4415585
NODE_4998_length_1101_cov_35.638723	414	491	5	1	77	0.0129870
NODE_4998_length_1101_cov_35.638723	414	491	7	3	77	0.0389610
NODE_4998_length_1101_cov_35.638723	414	491	2	24	77	0.3116883
NODE_4998_length_1101_cov_35.638723	414	491	3	15	77	0.1948052
NODE_4998_length_1101_cov_35.638723	414	491	4	34	77	0.4415585
NODE_4998_length_1101_cov_35.638723	414	491	5	1	77	0.0129870
NODE_4998_length_1101_cov_35.638723	414	491	7	3	77	0.0389610
NODE_4998_length_1101_cov_35.638723	488	544	4	5	56	0.0892857
NODE_4998_length_1101_cov_35.638723	488	544	18	51	56	0.9107143
NODE_4998_length_1101_cov_35.638723	752	832	0	63	80	0.7875000
NODE_4998_length_1101_cov_35.638723	752	832	1	17	80	0.2125000
NODE_4998_length_1101_cov_35.638723	805	885	0	80	80	1.0000000
NODE_4998_length_1101_cov_35.638723	881	961	0	80	80	1.0000000
NODE_4998_length_1101_cov_35.638723	934	1014	0	80	80	1.0000000
NODE_4999_length_1101_cov_28.366267	452	532	2	58	80	0.7250000
NODE_4999_length_1101_cov_28.366267	452	532	3	22	80	0.2750000
NODE_4999_length_1101_cov_28.366267	505	585	0	37	80	0.4625000
NODE_4999_length_1101_cov_28.366267	505	585	2	8	80	0.1000000
NODE_4999_length_1101_cov_28.366267	505	585	3	35	80	0.4375000
NODE_5000_length_1101_cov_24.513972	475	555	4	45	80	0.5625000
NODE_5000_length_1101_cov_24.513972	475	555	5	20	80	0.2500000
NODE_5000_length_1101_cov_24.513972	475	555	6	15	80	0.1875000
NODE_5000_length_1101_cov_24.513972	528	608	5	16	80	0.2000000
NODE_5000_length_1101_cov_24.513972	528	608	6	31	80	0.3875000
NODE_5000_length_1101_cov_24.513972	528	608	7	33	80	0.4125000
NODE_5001_length_1101_cov_22.315369	335	415	13	17	80	0.2125000
NODE_5001_length_1101_cov_22.315369	335	415	14	16	80	0.2000000
NODE_5001_length_1101_cov_22.315369	335	415	15	6	80	0.0750000
NODE_5001_length_1101_cov_22.315369	335	415	16	4	80	0.0500000
NODE_5001_length_1101_cov_22.315369	335	415	18	6	80	0.0750000
NODE_5001_length_1101_cov_22.315369	335	415	20	1	80	0.0125000
NODE_5001_length_1101_cov_22.315369	335	415	21	30	80	0.3750000
NODE_5001_length_1101_cov_22.315369	388	468	17	2	80	0.0250000
NODE_5001_length_1101_cov_22.315369	388	468	18	18	80	0.2250000
NODE_5001_length_1101_cov_22.315369	388	468	19	10	80	0.1250000
NODE_5001_length_1101_cov_22.315369	388	468	20	9	80	0.1125000
NODE_5001_length_1101_cov_22.315369	388	468	21	41	80	0.5125000
NODE_5001_length_1101_cov_22.315369	464	544	15	2	80	0.0250000
NODE_5001_length_1101_cov_22.315369	464	544	17	8	80	0.1000000
NODE_5001_length_1101_cov_22.315369	464	544	18	6	80	0.0750000
NODE_5001_length_1101_cov_22.315369	464	544	19	13	80	0.1625000
NODE_5001_length_1101_cov_22.315369	464	544	20	11	80	0.1375000
NODE_5001_length_1101_cov_22.315369	464	544	21	2	80	0.0250000
NODE_5001_length_1101_cov_22.315369	464	544	22	38	80	0.4750000
NODE_5001_length_1101_cov_22.315369	517	597	14	11	80	0.1375000
NODE_5001_length_1101_cov_22.315369	517	597	15	2	80	0.0250000
NODE_5001_length_1101_cov_22.315369	517	597	16	1	80	0.0125000
NODE_5001_length_1101_cov_22.315369	517	597	17	33	80	0.4125000
NODE_5001_length_1101_cov_22.315369	517	597	18	22	80	0.2750000
NODE_5001_length_1101_cov_22.315369	517	597	19	4	80	0.0500000
NODE_5001_length_1101_cov_22.315369	517	597	22	7	80	0.0875000
NODE_5002_length_1101_cov_22.070858	419	499	0	80	80	1.0000000
NODE_5002_length_1101_cov_22.070858	472	552	0	80	80	1.0000000
NODE_5002_length_1101_cov_22.070858	548	628	0	80	80	1.0000000
NODE_5002_length_1101_cov_22.070858	601	681	0	80	80	1.0000000
NODE_5003_length_1101_cov_18.821357	469	549	8	11	80	0.1375000
NODE_5003_length_1101_cov_18.821357	469	549	11	10	80	0.1250000
NODE_5003_length_1101_cov_18.821357	469	549	13	20	80	0.2500000
NODE_5003_length_1101_cov_18.821357	469	549	16	39	80	0.4875000
NODE_5003_length_1101_cov_18.821357	522	602	4	28	80	0.3500000
NODE_5003_length_1101_cov_18.821357	522	602	7	9	80	0.1125000
NODE_5003_length_1101_cov_18.821357	522	602	8	21	80	0.2625000
NODE_5003_length_1101_cov_18.821357	522	602	10	6	80	0.0750000
NODE_5003_length_1101_cov_18.821357	522	602	11	10	80	0.1250000
NODE_5003_length_1101_cov_18.821357	522	602	13	6	80	0.0750000
NODE_5004_length_1101_cov_17.151697	502	582	4	7	80	0.0875000
NODE_5004_length_1101_cov_17.151697	502	582	5	39	80	0.4875000
NODE_5004_length_1101_cov_17.151697	502	582	6	12	80	0.1500000
NODE_5004_length_1101_cov_17.151697	502	582	7	22	80	0.2750000
NODE_5004_length_1101_cov_17.151697	555	635	4	40	80	0.5000000
NODE_5004_length_1101_cov_17.151697	555	635	6	21	80	0.2625000
NODE_5004_length_1101_cov_17.151697	555	635	7	19	80	0.2375000
NODE_5005_length_1101_cov_8.371257	968	1048	0	80	80	1.0000000
NODE_5010_length_1100_cov_42.528472	582	662	9	26	80	0.3250000
NODE_5010_length_1100_cov_42.528472	582	662	10	20	80	0.2500000
NODE_5010_length_1100_cov_42.528472	582	662	11	34	80	0.4250000
NODE_5010_length_1100_cov_42.528472	635	715	9	15	80	0.1875000
NODE_5010_length_1100_cov_42.528472	635	715	11	50	80	0.6250000
NODE_5010_length_1100_cov_42.528472	635	715	12	15	80	0.1875000
NODE_5010_length_1100_cov_42.528472	711	791	8	43	80	0.5375000
NODE_5010_length_1100_cov_42.528472	711	791	9	24	80	0.3000000
NODE_5010_length_1100_cov_42.528472	711	791	11	13	80	0.1625000
NODE_5010_length_1100_cov_42.528472	764	844	7	12	80	0.1500000
NODE_5010_length_1100_cov_42.528472	764	844	8	23	80	0.2875000
NODE_5010_length_1100_cov_42.528472	764	844	9	31	80	0.3875000
NODE_5010_length_1100_cov_42.528472	764	844	10	14	80	0.1750000
NODE_5011_length_1100_cov_40.883117	324	404	5	14	80	0.1750000
NODE_5011_length_1100_cov_40.883117	324	404	6	3	80	0.0375000
NODE_5011_length_1100_cov_40.883117	324	404	7	63	80	0.7875000
NODE_5011_length_1100_cov_40.883117	377	457	3	5	80	0.0625000
NODE_5011_length_1100_cov_40.883117	377	457	4	5	80	0.0625000
NODE_5011_length_1100_cov_40.883117	377	457	5	53	80	0.6625000
NODE_5011_length_1100_cov_40.883117	377	457	6	7	80	0.0875000
NODE_5011_length_1100_cov_40.883117	377	457	7	10	80	0.1250000
NODE_5011_length_1100_cov_40.883117	453	533	3	12	80	0.1500000
NODE_5011_length_1100_cov_40.883117	453	533	4	7	80	0.0875000
NODE_5011_length_1100_cov_40.883117	453	533	6	14	80	0.1750000
NODE_5011_length_1100_cov_40.883117	453	533	7	4	80	0.0500000
NODE_5011_length_1100_cov_40.883117	453	533	9	1	80	0.0125000
NODE_5011_length_1100_cov_40.883117	453	533	10	1	80	0.0125000
NODE_5011_length_1100_cov_40.883117	453	533	11	41	80	0.5125000
NODE_5011_length_1100_cov_40.883117	506	586	10	3	80	0.0375000
NODE_5011_length_1100_cov_40.883117	506	586	11	42	80	0.5250000
NODE_5011_length_1100_cov_40.883117	506	586	12	16	80	0.2000000
NODE_5011_length_1100_cov_40.883117	506	586	13	19	80	0.2375000
NODE_5012_length_1100_cov_23.160839	524	604	10	18	80	0.2250000
NODE_5012_length_1100_cov_23.160839	524	604	11	33	80	0.4125000
NODE_5012_length_1100_cov_23.160839	524	604	12	29	80	0.3625000
NODE_5012_length_1100_cov_23.160839	577	657	6	6	80	0.0750000
NODE_5012_length_1100_cov_23.160839	577	657	7	4	80	0.0500000
NODE_5012_length_1100_cov_23.160839	577	657	8	3	80	0.0375000
NODE_5012_length_1100_cov_23.160839	577	657	9	6	80	0.0750000
NODE_5012_length_1100_cov_23.160839	577	657	10	18	80	0.2250000
NODE_5012_length_1100_cov_23.160839	577	657	11	30	80	0.3750000
NODE_5012_length_1100_cov_23.160839	577	657	12	13	80	0.1625000
NODE_5012_length_1100_cov_23.160839	653	733	6	15	80	0.1875000
NODE_5012_length_1100_cov_23.160839	653	733	8	11	80	0.1375000
NODE_5012_length_1100_cov_23.160839	653	733	9	46	80	0.5750000
NODE_5012_length_1100_cov_23.160839	653	733	10	8	80	0.1000000
NODE_5012_length_1100_cov_23.160839	706	786	8	12	80	0.1500000
NODE_5012_length_1100_cov_23.160839	706	786	9	56	80	0.7000000
NODE_5012_length_1100_cov_23.160839	706	786	10	12	80	0.1500000
NODE_5013_length_1100_cov_22.200799	485	565	1	27	80	0.3375000
NODE_5013_length_1100_cov_22.200799	485	565	2	37	80	0.4625000
NODE_5013_length_1100_cov_22.200799	485	565	3	16	80	0.2000000
NODE_5013_length_1100_cov_22.200799	538	618	1	11	80	0.1375000
NODE_5013_length_1100_cov_22.200799	538	618	3	17	80	0.2125000
NODE_5013_length_1100_cov_22.200799	538	618	4	37	80	0.4625000
NODE_5013_length_1100_cov_22.200799	538	618	5	8	80	0.1000000
NODE_5013_length_1100_cov_22.200799	538	618	6	7	80	0.0875000
NODE_5013_length_1100_cov_22.200799	614	694	5	28	80	0.3500000
NODE_5013_length_1100_cov_22.200799	614	694	6	31	80	0.3875000
NODE_5013_length_1100_cov_22.200799	614	694	7	2	80	0.0250000
NODE_5013_length_1100_cov_22.200799	614	694	8	19	80	0.2375000
NODE_5013_length_1100_cov_22.200799	667	745	5	31	78	0.3974359
NODE_5013_length_1100_cov_22.200799	667	745	6	21	78	0.2692308
NODE_5013_length_1100_cov_22.200799	667	745	7	2	78	0.0256410
NODE_5013_length_1100_cov_22.200799	667	745	8	24	78	0.3076923
NODE_5014_length_1100_cov_15.353646	472	552	7	34	80	0.4250000
NODE_5014_length_1100_cov_15.353646	472	552	8	46	80	0.5750000
NODE_5014_length_1100_cov_15.353646	525	605	6	21	80	0.2625000
NODE_5014_length_1100_cov_15.353646	525	605	7	53	80	0.6625000
NODE_5014_length_1100_cov_15.353646	525	605	8	6	80	0.0750000
NODE_5015_length_1100_cov_14.584416	673	753	1	8	80	0.1000000
NODE_5015_length_1100_cov_14.584416	673	753	2	2	80	0.0250000
NODE_5015_length_1100_cov_14.584416	673	753	3	55	80	0.6875000
NODE_5015_length_1100_cov_14.584416	673	753	4	15	80	0.1875000
NODE_5015_length_1100_cov_14.584416	726	806	1	61	80	0.7625000
NODE_5015_length_1100_cov_14.584416	726	806	2	2	80	0.0250000
NODE_5015_length_1100_cov_14.584416	726	806	3	2	80	0.0250000
NODE_5015_length_1100_cov_14.584416	726	806	4	15	80	0.1875000
NODE_5029_length_1099_cov_85.893000	464	544	5	20	80	0.2500000
NODE_5029_length_1099_cov_85.893000	464	544	6	49	80	0.6125000
NODE_5029_length_1099_cov_85.893000	464	544	7	11	80	0.1375000
NODE_5029_length_1099_cov_85.893000	517	597	2	32	80	0.4000000
NODE_5029_length_1099_cov_85.893000	517	597	3	5	80	0.0625000
NODE_5029_length_1099_cov_85.893000	517	597	4	10	80	0.1250000
NODE_5029_length_1099_cov_85.893000	517	597	5	11	80	0.1375000
NODE_5029_length_1099_cov_85.893000	517	597	6	22	80	0.2750000
NODE_5029_length_1099_cov_85.893000	593	673	3	15	80	0.1875000
NODE_5029_length_1099_cov_85.893000	593	673	4	48	80	0.6000000
NODE_5029_length_1099_cov_85.893000	593	673	5	17	80	0.2125000
NODE_5029_length_1099_cov_85.893000	646	726	4	27	80	0.3375000
NODE_5029_length_1099_cov_85.893000	646	726	7	7	80	0.0875000
NODE_5029_length_1099_cov_85.893000	646	726	8	46	80	0.5750000
NODE_5030_length_1099_cov_45.874000	521	601	2	16	80	0.2000000
NODE_5030_length_1099_cov_45.874000	521	601	4	23	80	0.2875000
NODE_5030_length_1099_cov_45.874000	521	601	8	11	80	0.1375000
NODE_5030_length_1099_cov_45.874000	521	601	9	17	80	0.2125000
NODE_5030_length_1099_cov_45.874000	521	601	10	8	80	0.1000000
NODE_5030_length_1099_cov_45.874000	521	601	11	5	80	0.0625000
NODE_5030_length_1099_cov_45.874000	574	654	9	29	80	0.3625000
NODE_5030_length_1099_cov_45.874000	574	654	10	8	80	0.1000000
NODE_5030_length_1099_cov_45.874000	574	654	11	11	80	0.1375000
NODE_5030_length_1099_cov_45.874000	574	654	12	8	80	0.1000000
NODE_5030_length_1099_cov_45.874000	574	654	13	5	80	0.0625000
NODE_5030_length_1099_cov_45.874000	574	654	14	8	80	0.1000000
NODE_5030_length_1099_cov_45.874000	574	654	15	11	80	0.1375000
NODE_5030_length_1099_cov_45.874000	650	730	15	6	80	0.0750000
NODE_5030_length_1099_cov_45.874000	650	730	17	6	80	0.0750000
NODE_5030_length_1099_cov_45.874000	650	730	18	19	80	0.2375000
NODE_5030_length_1099_cov_45.874000	650	730	20	3	80	0.0375000
NODE_5030_length_1099_cov_45.874000	650	730	21	2	80	0.0250000
NODE_5030_length_1099_cov_45.874000	650	730	22	44	80	0.5500000
NODE_5030_length_1099_cov_45.874000	703	783	15	3	80	0.0375000
NODE_5030_length_1099_cov_45.874000	703	783	16	3	80	0.0375000
NODE_5030_length_1099_cov_45.874000	703	783	17	6	80	0.0750000
NODE_5030_length_1099_cov_45.874000	703	783	18	23	80	0.2875000
NODE_5030_length_1099_cov_45.874000	703	783	19	32	80	0.4000000
NODE_5030_length_1099_cov_45.874000	703	783	20	6	80	0.0750000
NODE_5030_length_1099_cov_45.874000	703	783	21	1	80	0.0125000
NODE_5030_length_1099_cov_45.874000	703	783	22	6	80	0.0750000
NODE_5031_length_1099_cov_25.192000	526	606	0	23	80	0.2875000
NODE_5031_length_1099_cov_25.192000	526	606	1	57	80	0.7125000
NODE_5031_length_1099_cov_25.192000	579	659	1	27	80	0.3375000
NODE_5031_length_1099_cov_25.192000	579	659	2	53	80	0.6625000
NODE_5032_length_1099_cov_11.846000	565	645	3	24	80	0.3000000
NODE_5032_length_1099_cov_11.846000	565	645	4	21	80	0.2625000
NODE_5032_length_1099_cov_11.846000	565	645	5	3	80	0.0375000
NODE_5032_length_1099_cov_11.846000	565	645	6	32	80	0.4000000
NODE_5032_length_1099_cov_11.846000	618	698	5	9	80	0.1125000
NODE_5032_length_1099_cov_11.846000	618	698	6	71	80	0.8875000
NODE_5033_length_1099_cov_9.527000	495	575	5	19	80	0.2375000
NODE_5033_length_1099_cov_9.527000	495	575	6	9	80	0.1125000
NODE_5033_length_1099_cov_9.527000	495	575	7	8	80	0.1000000
NODE_5033_length_1099_cov_9.527000	495	575	9	44	80	0.5500000
NODE_5033_length_1099_cov_9.527000	548	628	3	46	80	0.5750000
NODE_5033_length_1099_cov_9.527000	548	628	5	26	80	0.3250000
NODE_5033_length_1099_cov_9.527000	548	628	6	7	80	0.0875000
NODE_5033_length_1099_cov_9.527000	548	628	9	1	80	0.0125000
NODE_5034_length_1099_cov_8.993000	464	544	3	1	80	0.0125000
NODE_5034_length_1099_cov_8.993000	464	544	4	49	80	0.6125000
NODE_5034_length_1099_cov_8.993000	464	544	7	1	80	0.0125000
NODE_5034_length_1099_cov_8.993000	464	544	8	29	80	0.3625000
NODE_5034_length_1099_cov_8.993000	517	597	7	51	80	0.6375000
NODE_5034_length_1099_cov_8.993000	517	597	8	29	80	0.3625000
NODE_5039_length_1099_cov_2.286000	273	353	0	80	80	1.0000000
NODE_5045_length_1098_cov_44.988989	360	440	19	9	80	0.1125000
NODE_5045_length_1098_cov_44.988989	360	440	21	29	80	0.3625000
NODE_5045_length_1098_cov_44.988989	360	440	23	19	80	0.2375000
NODE_5045_length_1098_cov_44.988989	360	440	26	2	80	0.0250000
NODE_5045_length_1098_cov_44.988989	360	440	27	21	80	0.2625000
NODE_5045_length_1098_cov_44.988989	413	493	4	9	80	0.1125000
NODE_5045_length_1098_cov_44.988989	413	493	5	4	80	0.0500000
NODE_5045_length_1098_cov_44.988989	413	493	6	9	80	0.1125000
NODE_5045_length_1098_cov_44.988989	413	493	14	1	80	0.0125000
NODE_5045_length_1098_cov_44.988989	413	493	16	2	80	0.0250000
NODE_5045_length_1098_cov_44.988989	413	493	17	3	80	0.0375000
NODE_5045_length_1098_cov_44.988989	413	493	18	13	80	0.1625000
NODE_5045_length_1098_cov_44.988989	413	493	19	20	80	0.2500000
NODE_5045_length_1098_cov_44.988989	413	493	20	1	80	0.0125000
NODE_5045_length_1098_cov_44.988989	413	493	21	18	80	0.2250000
NODE_5046_length_1098_cov_35.192192	452	532	8	1	80	0.0125000
NODE_5046_length_1098_cov_35.192192	452	532	9	5	80	0.0625000
NODE_5046_length_1098_cov_35.192192	452	532	11	4	80	0.0500000
NODE_5046_length_1098_cov_35.192192	452	532	12	5	80	0.0625000
NODE_5046_length_1098_cov_35.192192	452	532	14	6	80	0.0750000
NODE_5046_length_1098_cov_35.192192	452	532	15	18	80	0.2250000
NODE_5046_length_1098_cov_35.192192	452	532	17	39	80	0.4875000
NODE_5046_length_1098_cov_35.192192	452	532	18	2	80	0.0250000
NODE_5046_length_1098_cov_35.192192	505	585	15	6	80	0.0750000
NODE_5046_length_1098_cov_35.192192	505	585	16	13	80	0.1625000
NODE_5046_length_1098_cov_35.192192	505	585	17	39	80	0.4875000
NODE_5046_length_1098_cov_35.192192	505	585	18	4	80	0.0500000
NODE_5046_length_1098_cov_35.192192	505	585	19	18	80	0.2250000
NODE_5046_length_1098_cov_35.192192	581	661	9	8	80	0.1000000
NODE_5046_length_1098_cov_35.192192	581	661	11	30	80	0.3750000
NODE_5046_length_1098_cov_35.192192	581	661	12	11	80	0.1375000
NODE_5046_length_1098_cov_35.192192	581	661	13	4	80	0.0500000
NODE_5046_length_1098_cov_35.192192	581	661	14	1	80	0.0125000
NODE_5046_length_1098_cov_35.192192	581	661	15	10	80	0.1250000
NODE_5046_length_1098_cov_35.192192	581	661	16	6	80	0.0750000
NODE_5046_length_1098_cov_35.192192	581	661	18	10	80	0.1250000
NODE_5046_length_1098_cov_35.192192	634	714	8	18	80	0.2250000
NODE_5046_length_1098_cov_35.192192	634	714	9	8	80	0.1000000
NODE_5046_length_1098_cov_35.192192	634	714	10	21	80	0.2625000
NODE_5046_length_1098_cov_35.192192	634	714	11	33	80	0.4125000
NODE_5047_length_1098_cov_28.743744	449	529	2	62	80	0.7750000
NODE_5047_length_1098_cov_28.743744	449	529	4	18	80	0.2250000
NODE_5047_length_1098_cov_28.743744	502	582	2	63	80	0.7875000
NODE_5047_length_1098_cov_28.743744	502	582	4	17	80	0.2125000
NODE_5047_length_1098_cov_28.743744	578	658	0	7	80	0.0875000
NODE_5047_length_1098_cov_28.743744	578	658	2	73	80	0.9125000
NODE_5047_length_1098_cov_28.743744	631	711	0	13	80	0.1625000
NODE_5047_length_1098_cov_28.743744	631	711	1	27	80	0.3375000
NODE_5047_length_1098_cov_28.743744	631	711	2	20	80	0.2500000
NODE_5047_length_1098_cov_28.743744	631	711	3	20	80	0.2500000
NODE_5048_length_1098_cov_28.230230	477	557	11	1	80	0.0125000
NODE_5048_length_1098_cov_28.230230	477	557	12	13	80	0.1625000
NODE_5048_length_1098_cov_28.230230	477	557	13	6	80	0.0750000
NODE_5048_length_1098_cov_28.230230	477	557	14	8	80	0.1000000
NODE_5048_length_1098_cov_28.230230	477	557	15	32	80	0.4000000
NODE_5048_length_1098_cov_28.230230	477	557	16	1	80	0.0125000
NODE_5048_length_1098_cov_28.230230	477	557	17	1	80	0.0125000
NODE_5048_length_1098_cov_28.230230	477	557	18	14	80	0.1750000
NODE_5048_length_1098_cov_28.230230	477	557	20	2	80	0.0250000
NODE_5048_length_1098_cov_28.230230	477	557	21	2	80	0.0250000
NODE_5048_length_1098_cov_28.230230	530	610	15	7	80	0.0875000
NODE_5048_length_1098_cov_28.230230	530	610	16	1	80	0.0125000
NODE_5048_length_1098_cov_28.230230	530	610	17	1	80	0.0125000
NODE_5048_length_1098_cov_28.230230	530	610	18	14	80	0.1750000
NODE_5048_length_1098_cov_28.230230	530	610	20	4	80	0.0500000
NODE_5048_length_1098_cov_28.230230	530	610	21	37	80	0.4625000
NODE_5048_length_1098_cov_28.230230	530	610	22	8	80	0.1000000
NODE_5048_length_1098_cov_28.230230	530	610	23	8	80	0.1000000
NODE_5048_length_1098_cov_28.230230	606	686	9	21	80	0.2625000
NODE_5048_length_1098_cov_28.230230	606	686	10	18	80	0.2250000
NODE_5048_length_1098_cov_28.230230	606	686	12	1	80	0.0125000
NODE_5048_length_1098_cov_28.230230	606	686	13	10	80	0.1250000
NODE_5048_length_1098_cov_28.230230	606	686	14	10	80	0.1250000
NODE_5048_length_1098_cov_28.230230	606	686	16	7	80	0.0875000
NODE_5048_length_1098_cov_28.230230	606	686	18	8	80	0.1000000
NODE_5048_length_1098_cov_28.230230	606	686	20	1	80	0.0125000
NODE_5048_length_1098_cov_28.230230	606	686	21	4	80	0.0500000
NODE_5048_length_1098_cov_28.230230	659	739	0	4	80	0.0500000
NODE_5048_length_1098_cov_28.230230	659	739	1	8	80	0.1000000
NODE_5048_length_1098_cov_28.230230	659	739	3	24	80	0.3000000
NODE_5048_length_1098_cov_28.230230	659	739	6	14	80	0.1750000
NODE_5048_length_1098_cov_28.230230	659	739	8	2	80	0.0250000
NODE_5048_length_1098_cov_28.230230	659	739	9	22	80	0.2750000
NODE_5048_length_1098_cov_28.230230	659	739	10	6	80	0.0750000
NODE_5049_length_1098_cov_26.131131	494	574	2	5	80	0.0625000
NODE_5049_length_1098_cov_26.131131	494	574	3	4	80	0.0500000
NODE_5049_length_1098_cov_26.131131	494	574	4	1	80	0.0125000
NODE_5049_length_1098_cov_26.131131	494	574	5	28	80	0.3500000
NODE_5049_length_1098_cov_26.131131	494	574	7	42	80	0.5250000
NODE_5049_length_1098_cov_26.131131	547	627	6	36	80	0.4500000
NODE_5049_length_1098_cov_26.131131	547	627	7	44	80	0.5500000
NODE_5050_length_1098_cov_21.355355	599	679	4	3	80	0.0375000
NODE_5050_length_1098_cov_21.355355	599	679	5	1	80	0.0125000
NODE_5050_length_1098_cov_21.355355	599	679	6	15	80	0.1875000
NODE_5050_length_1098_cov_21.355355	599	679	7	2	80	0.0250000
NODE_5050_length_1098_cov_21.355355	599	679	9	2	80	0.0250000
NODE_5050_length_1098_cov_21.355355	599	679	11	52	80	0.6500000
NODE_5050_length_1098_cov_21.355355	599	679	12	2	80	0.0250000
NODE_5050_length_1098_cov_21.355355	599	679	13	3	80	0.0375000
NODE_5050_length_1098_cov_21.355355	652	732	9	28	80	0.3500000
NODE_5050_length_1098_cov_21.355355	652	732	10	1	80	0.0125000
NODE_5050_length_1098_cov_21.355355	652	732	11	20	80	0.2500000
NODE_5050_length_1098_cov_21.355355	652	732	12	2	80	0.0250000
NODE_5050_length_1098_cov_21.355355	652	732	13	29	80	0.3625000
NODE_5051_length_1098_cov_17.087087	541	621	9	17	80	0.2125000
NODE_5051_length_1098_cov_17.087087	541	621	10	20	80	0.2500000
NODE_5051_length_1098_cov_17.087087	541	621	11	43	80	0.5375000
NODE_5051_length_1098_cov_17.087087	594	674	7	3	80	0.0375000
NODE_5051_length_1098_cov_17.087087	594	674	8	18	80	0.2250000
NODE_5051_length_1098_cov_17.087087	594	674	9	17	80	0.2125000
NODE_5051_length_1098_cov_17.087087	594	674	10	11	80	0.1375000
NODE_5051_length_1098_cov_17.087087	594	674	11	31	80	0.3875000
NODE_5051_length_1098_cov_17.087087	670	750	1	22	80	0.2750000
NODE_5051_length_1098_cov_17.087087	670	750	2	20	80	0.2500000
NODE_5051_length_1098_cov_17.087087	670	750	3	31	80	0.3875000
NODE_5051_length_1098_cov_17.087087	670	750	7	6	80	0.0750000
NODE_5051_length_1098_cov_17.087087	670	750	8	1	80	0.0125000
NODE_5051_length_1098_cov_17.087087	723	803	0	13	80	0.1625000
NODE_5051_length_1098_cov_17.087087	723	803	1	62	80	0.7750000
NODE_5051_length_1098_cov_17.087087	723	803	2	5	80	0.0625000
NODE_5052_length_1098_cov_15.455455	545	625	0	31	80	0.3875000
NODE_5052_length_1098_cov_15.455455	545	625	1	39	80	0.4875000
NODE_5052_length_1098_cov_15.455455	545	625	2	5	80	0.0625000
NODE_5052_length_1098_cov_15.455455	545	625	5	5	80	0.0625000
NODE_5052_length_1098_cov_15.455455	598	678	0	80	80	1.0000000
NODE_5052_length_1098_cov_15.455455	674	754	0	80	80	1.0000000
NODE_5052_length_1098_cov_15.455455	727	807	0	63	80	0.7875000
NODE_5052_length_1098_cov_15.455455	727	807	1	16	80	0.2000000
NODE_5052_length_1098_cov_15.455455	727	807	2	1	80	0.0125000
NODE_5054_length_1097_cov_37.103206	438	518	19	3	80	0.0375000
NODE_5054_length_1097_cov_37.103206	438	518	21	2	80	0.0250000
NODE_5054_length_1097_cov_37.103206	438	518	24	24	80	0.3000000
NODE_5054_length_1097_cov_37.103206	438	518	25	39	80	0.4875000
NODE_5054_length_1097_cov_37.103206	438	518	26	9	80	0.1125000
NODE_5054_length_1097_cov_37.103206	438	518	28	3	80	0.0375000
NODE_5054_length_1097_cov_37.103206	491	571	10	17	80	0.2125000
NODE_5054_length_1097_cov_37.103206	491	571	11	19	80	0.2375000
NODE_5054_length_1097_cov_37.103206	491	571	19	6	80	0.0750000
NODE_5054_length_1097_cov_37.103206	491	571	20	4	80	0.0500000
NODE_5054_length_1097_cov_37.103206	491	571	21	6	80	0.0750000
NODE_5054_length_1097_cov_37.103206	491	571	22	6	80	0.0750000
NODE_5054_length_1097_cov_37.103206	491	571	24	10	80	0.1250000
NODE_5054_length_1097_cov_37.103206	491	571	25	12	80	0.1500000
NODE_5054_length_1097_cov_37.103206	567	647	9	7	80	0.0875000
NODE_5054_length_1097_cov_37.103206	567	647	10	16	80	0.2000000
NODE_5054_length_1097_cov_37.103206	567	647	11	13	80	0.1625000
NODE_5054_length_1097_cov_37.103206	567	647	13	11	80	0.1375000
NODE_5054_length_1097_cov_37.103206	567	647	14	33	80	0.4125000
NODE_5054_length_1097_cov_37.103206	620	700	10	10	80	0.1250000
NODE_5054_length_1097_cov_37.103206	620	700	11	1	80	0.0125000
NODE_5054_length_1097_cov_37.103206	620	700	12	18	80	0.2250000
NODE_5054_length_1097_cov_37.103206	620	700	13	3	80	0.0375000
NODE_5054_length_1097_cov_37.103206	620	700	14	48	80	0.6000000
NODE_5055_length_1097_cov_32.624248	501	581	17	13	80	0.1625000
NODE_5055_length_1097_cov_32.624248	501	581	18	19	80	0.2375000
NODE_5055_length_1097_cov_32.624248	501	581	19	16	80	0.2000000
NODE_5055_length_1097_cov_32.624248	501	581	20	23	80	0.2875000
NODE_5055_length_1097_cov_32.624248	501	581	21	4	80	0.0500000
NODE_5055_length_1097_cov_32.624248	501	581	22	5	80	0.0625000
NODE_5055_length_1097_cov_32.624248	554	634	10	16	80	0.2000000
NODE_5055_length_1097_cov_32.624248	554	634	11	1	80	0.0125000
NODE_5055_length_1097_cov_32.624248	554	634	13	12	80	0.1500000
NODE_5055_length_1097_cov_32.624248	554	634	15	14	80	0.1750000
NODE_5055_length_1097_cov_32.624248	554	634	16	3	80	0.0375000
NODE_5055_length_1097_cov_32.624248	554	634	19	19	80	0.2375000
NODE_5055_length_1097_cov_32.624248	554	634	20	11	80	0.1375000
NODE_5055_length_1097_cov_32.624248	554	634	21	4	80	0.0500000
NODE_5056_length_1097_cov_25.240481	401	480	4	10	79	0.1265823
NODE_5056_length_1097_cov_25.240481	401	480	7	1	79	0.0126582
NODE_5056_length_1097_cov_25.240481	401	480	8	1	79	0.0126582
NODE_5056_length_1097_cov_25.240481	401	480	9	1	79	0.0126582
NODE_5056_length_1097_cov_25.240481	401	480	10	21	79	0.2658228
NODE_5056_length_1097_cov_25.240481	401	480	11	16	79	0.2025317
NODE_5056_length_1097_cov_25.240481	401	480	13	7	79	0.0886076
NODE_5056_length_1097_cov_25.240481	401	480	14	1	79	0.0126582
NODE_5056_length_1097_cov_25.240481	401	480	15	1	79	0.0126582
NODE_5056_length_1097_cov_25.240481	401	480	16	1	79	0.0126582
NODE_5056_length_1097_cov_25.240481	401	480	18	19	79	0.2405063
NODE_5056_length_1097_cov_25.240481	453	533	13	5	80	0.0625000
NODE_5056_length_1097_cov_25.240481	453	533	14	1	80	0.0125000
NODE_5056_length_1097_cov_25.240481	453	533	15	1	80	0.0125000
NODE_5056_length_1097_cov_25.240481	453	533	16	1	80	0.0125000
NODE_5056_length_1097_cov_25.240481	453	533	18	30	80	0.3750000
NODE_5056_length_1097_cov_25.240481	453	533	19	42	80	0.5250000
NODE_5056_length_1097_cov_25.240481	529	609	6	1	80	0.0125000
NODE_5056_length_1097_cov_25.240481	529	609	7	1	80	0.0125000
NODE_5056_length_1097_cov_25.240481	529	609	8	22	80	0.2750000
NODE_5056_length_1097_cov_25.240481	529	609	9	22	80	0.2750000
NODE_5056_length_1097_cov_25.240481	529	609	10	1	80	0.0125000
NODE_5056_length_1097_cov_25.240481	529	609	11	1	80	0.0125000
NODE_5056_length_1097_cov_25.240481	529	609	13	24	80	0.3000000
NODE_5056_length_1097_cov_25.240481	529	609	19	8	80	0.1000000
NODE_5056_length_1097_cov_25.240481	582	662	2	21	80	0.2625000
NODE_5056_length_1097_cov_25.240481	582	662	3	30	80	0.3750000
NODE_5056_length_1097_cov_25.240481	582	662	6	3	80	0.0375000
NODE_5056_length_1097_cov_25.240481	582	662	7	1	80	0.0125000
NODE_5056_length_1097_cov_25.240481	582	662	8	22	80	0.2750000
NODE_5056_length_1097_cov_25.240481	582	662	9	3	80	0.0375000
NODE_5057_length_1097_cov_21.221443	484	564	6	11	80	0.1375000
NODE_5057_length_1097_cov_21.221443	484	564	7	26	80	0.3250000
NODE_5057_length_1097_cov_21.221443	484	564	8	43	80	0.5375000
NODE_5057_length_1097_cov_21.221443	537	617	5	7	80	0.0875000
NODE_5057_length_1097_cov_21.221443	537	617	7	15	80	0.1875000
NODE_5057_length_1097_cov_21.221443	537	617	8	37	80	0.4625000
NODE_5057_length_1097_cov_21.221443	537	617	10	9	80	0.1125000
NODE_5057_length_1097_cov_21.221443	537	617	11	12	80	0.1500000
NODE_5057_length_1097_cov_21.221443	613	693	7	38	80	0.4750000
NODE_5057_length_1097_cov_21.221443	613	693	10	7	80	0.0875000
NODE_5057_length_1097_cov_21.221443	613	693	12	35	80	0.4375000
NODE_5057_length_1097_cov_21.221443	666	746	9	22	80	0.2750000
NODE_5057_length_1097_cov_21.221443	666	746	10	7	80	0.0875000
NODE_5057_length_1097_cov_21.221443	666	746	12	51	80	0.6375000
NODE_5058_length_1097_cov_20.968938	515	595	2	80	80	1.0000000
NODE_5058_length_1097_cov_20.968938	568	648	1	8	80	0.1000000
NODE_5058_length_1097_cov_20.968938	568	648	2	72	80	0.9000000
NODE_5059_length_1097_cov_13.136273	697	779	5	12	82	0.1463415
NODE_5059_length_1097_cov_13.136273	697	779	6	12	82	0.1463415
NODE_5059_length_1097_cov_13.136273	697	779	7	44	82	0.5365854
NODE_5059_length_1097_cov_13.136273	697	779	8	14	82	0.1707317
NODE_5059_length_1097_cov_13.136273	752	832	4	36	80	0.4500000
NODE_5059_length_1097_cov_13.136273	752	832	5	23	80	0.2875000
NODE_5059_length_1097_cov_13.136273	752	832	6	1	80	0.0125000
NODE_5059_length_1097_cov_13.136273	752	832	7	18	80	0.2250000
NODE_5059_length_1097_cov_13.136273	752	832	8	2	80	0.0250000
NODE_5060_length_1097_cov_6.376754	442	522	0	29	80	0.3625000
NODE_5060_length_1097_cov_6.376754	442	522	2	51	80	0.6375000
NODE_5060_length_1097_cov_6.376754	495	575	2	80	80	1.0000000
NODE_5061_length_1097_cov_6.068136	299	379	1	4	80	0.0500000
NODE_5061_length_1097_cov_6.068136	299	379	3	57	80	0.7125000
NODE_5061_length_1097_cov_6.068136	299	379	4	19	80	0.2375000
NODE_5061_length_1097_cov_6.068136	352	432	3	13	80	0.1625000
NODE_5061_length_1097_cov_6.068136	352	432	4	67	80	0.8375000
NODE_5072_length_1096_cov_55.816449	430	510	3	4	80	0.0500000
NODE_5072_length_1096_cov_55.816449	430	510	4	27	80	0.3375000
NODE_5072_length_1096_cov_55.816449	430	510	5	26	80	0.3250000
NODE_5072_length_1096_cov_55.816449	430	510	6	1	80	0.0125000
NODE_5072_length_1096_cov_55.816449	430	510	7	4	80	0.0500000
NODE_5072_length_1096_cov_55.816449	430	510	8	13	80	0.1625000
NODE_5072_length_1096_cov_55.816449	430	510	9	5	80	0.0625000
NODE_5072_length_1096_cov_55.816449	483	563	5	4	80	0.0500000
NODE_5072_length_1096_cov_55.816449	483	563	6	1	80	0.0125000
NODE_5072_length_1096_cov_55.816449	483	563	7	4	80	0.0500000
NODE_5072_length_1096_cov_55.816449	483	563	8	13	80	0.1625000
NODE_5072_length_1096_cov_55.816449	483	563	9	5	80	0.0625000
NODE_5072_length_1096_cov_55.816449	483	563	10	12	80	0.1500000
NODE_5072_length_1096_cov_55.816449	483	563	11	3	80	0.0375000
NODE_5072_length_1096_cov_55.816449	483	563	12	13	80	0.1625000
NODE_5072_length_1096_cov_55.816449	483	563	13	12	80	0.1500000
NODE_5072_length_1096_cov_55.816449	483	563	14	13	80	0.1625000
NODE_5072_length_1096_cov_55.816449	559	639	10	5	80	0.0625000
NODE_5072_length_1096_cov_55.816449	559	639	11	21	80	0.2625000
NODE_5072_length_1096_cov_55.816449	559	639	12	34	80	0.4250000
NODE_5072_length_1096_cov_55.816449	559	639	13	20	80	0.2500000
NODE_5072_length_1096_cov_55.816449	612	692	5	1	80	0.0125000
NODE_5072_length_1096_cov_55.816449	612	692	6	9	80	0.1125000
NODE_5072_length_1096_cov_55.816449	612	692	7	7	80	0.0875000
NODE_5072_length_1096_cov_55.816449	612	692	8	9	80	0.1125000
NODE_5072_length_1096_cov_55.816449	612	692	9	11	80	0.1375000
NODE_5072_length_1096_cov_55.816449	612	692	10	13	80	0.1625000
NODE_5072_length_1096_cov_55.816449	612	692	11	4	80	0.0500000
NODE_5072_length_1096_cov_55.816449	612	692	12	21	80	0.2625000
NODE_5072_length_1096_cov_55.816449	612	692	13	5	80	0.0625000
NODE_5073_length_1096_cov_24.672016	431	511	2	50	80	0.6250000
NODE_5073_length_1096_cov_24.672016	431	511	3	1	80	0.0125000
NODE_5073_length_1096_cov_24.672016	431	511	7	29	80	0.3625000
NODE_5073_length_1096_cov_24.672016	484	564	6	48	80	0.6000000
NODE_5073_length_1096_cov_24.672016	484	564	7	32	80	0.4000000
NODE_5073_length_1096_cov_24.672016	560	640	6	14	80	0.1750000
NODE_5073_length_1096_cov_24.672016	560	640	10	52	80	0.6500000
NODE_5073_length_1096_cov_24.672016	560	640	11	14	80	0.1750000
NODE_5073_length_1096_cov_24.672016	613	693	6	34	80	0.4250000
NODE_5073_length_1096_cov_24.672016	613	693	7	6	80	0.0750000
NODE_5073_length_1096_cov_24.672016	613	693	8	21	80	0.2625000
NODE_5073_length_1096_cov_24.672016	613	693	10	10	80	0.1250000
NODE_5073_length_1096_cov_24.672016	613	693	11	9	80	0.1125000
NODE_5074_length_1096_cov_22.980943	372	452	7	1	80	0.0125000
NODE_5074_length_1096_cov_22.980943	372	452	9	7	80	0.0875000
NODE_5074_length_1096_cov_22.980943	372	452	10	3	80	0.0375000
NODE_5074_length_1096_cov_22.980943	372	452	11	15	80	0.1875000
NODE_5074_length_1096_cov_22.980943	372	452	13	45	80	0.5625000
NODE_5074_length_1096_cov_22.980943	372	452	14	9	80	0.1125000
NODE_5074_length_1096_cov_22.980943	425	505	4	38	80	0.4750000
NODE_5074_length_1096_cov_22.980943	425	505	5	5	80	0.0625000
NODE_5074_length_1096_cov_22.980943	425	505	7	11	80	0.1375000
NODE_5074_length_1096_cov_22.980943	425	505	9	7	80	0.0875000
NODE_5074_length_1096_cov_22.980943	425	505	10	3	80	0.0375000
NODE_5074_length_1096_cov_22.980943	425	505	11	6	80	0.0750000
NODE_5074_length_1096_cov_22.980943	425	505	13	1	80	0.0125000
NODE_5074_length_1096_cov_22.980943	425	505	14	9	80	0.1125000
NODE_5075_length_1096_cov_16.649950	486	566	5	57	80	0.7125000
NODE_5075_length_1096_cov_16.649950	486	566	6	6	80	0.0750000
NODE_5075_length_1096_cov_16.649950	486	566	7	17	80	0.2125000
NODE_5075_length_1096_cov_16.649950	539	619	3	2	80	0.0250000
NODE_5075_length_1096_cov_16.649950	539	619	4	45	80	0.5625000
NODE_5075_length_1096_cov_16.649950	539	619	5	33	80	0.4125000
NODE_5076_length_1096_cov_16.433300	443	523	2	13	80	0.1625000
NODE_5076_length_1096_cov_16.433300	443	523	3	13	80	0.1625000
NODE_5076_length_1096_cov_16.433300	443	523	5	4	80	0.0500000
NODE_5076_length_1096_cov_16.433300	443	523	6	6	80	0.0750000
NODE_5076_length_1096_cov_16.433300	443	523	9	25	80	0.3125000
NODE_5076_length_1096_cov_16.433300	443	523	12	19	80	0.2375000
NODE_5076_length_1096_cov_16.433300	496	576	9	8	80	0.1000000
NODE_5076_length_1096_cov_16.433300	496	576	12	48	80	0.6000000
NODE_5076_length_1096_cov_16.433300	496	576	14	24	80	0.3000000
NODE_5076_length_1096_cov_16.433300	886	966	0	80	80	1.0000000
NODE_5076_length_1096_cov_16.433300	939	1018	0	79	79	1.0000000
NODE_5077_length_1096_cov_13.398195	670	750	3	23	80	0.2875000
NODE_5077_length_1096_cov_13.398195	670	750	4	57	80	0.7125000
NODE_5077_length_1096_cov_13.398195	723	803	3	58	80	0.7250000
NODE_5077_length_1096_cov_13.398195	723	803	4	22	80	0.2750000
NODE_5080_length_1095_cov_25.390562	520	600	7	35	80	0.4375000
NODE_5080_length_1095_cov_25.390562	520	600	8	32	80	0.4000000
NODE_5080_length_1095_cov_25.390562	520	600	9	5	80	0.0625000
NODE_5080_length_1095_cov_25.390562	520	600	10	6	80	0.0750000
NODE_5080_length_1095_cov_25.390562	520	600	13	2	80	0.0250000
NODE_5080_length_1095_cov_25.390562	573	653	8	20	80	0.2500000
NODE_5080_length_1095_cov_25.390562	573	653	9	3	80	0.0375000
NODE_5080_length_1095_cov_25.390562	573	653	10	19	80	0.2375000
NODE_5080_length_1095_cov_25.390562	573	653	11	10	80	0.1250000
NODE_5080_length_1095_cov_25.390562	573	653	12	15	80	0.1875000
NODE_5080_length_1095_cov_25.390562	573	653	13	13	80	0.1625000
NODE_5080_length_1095_cov_25.390562	649	729	6	2	80	0.0250000
NODE_5080_length_1095_cov_25.390562	649	729	7	39	80	0.4875000
NODE_5080_length_1095_cov_25.390562	649	729	8	25	80	0.3125000
NODE_5080_length_1095_cov_25.390562	649	729	9	14	80	0.1750000
NODE_5080_length_1095_cov_25.390562	702	782	4	34	80	0.4250000
NODE_5080_length_1095_cov_25.390562	702	782	6	8	80	0.1000000
NODE_5080_length_1095_cov_25.390562	702	782	7	3	80	0.0375000
NODE_5080_length_1095_cov_25.390562	702	782	8	21	80	0.2625000
NODE_5080_length_1095_cov_25.390562	702	782	9	14	80	0.1750000
NODE_5081_length_1095_cov_13.832329	549	629	9	1	80	0.0125000
NODE_5081_length_1095_cov_13.832329	549	629	10	3	80	0.0375000
NODE_5081_length_1095_cov_13.832329	549	629	11	11	80	0.1375000
NODE_5081_length_1095_cov_13.832329	549	629	12	27	80	0.3375000
NODE_5081_length_1095_cov_13.832329	549	629	14	38	80	0.4750000
NODE_5081_length_1095_cov_13.832329	602	682	7	43	80	0.5375000
NODE_5081_length_1095_cov_13.832329	602	682	9	1	80	0.0125000
NODE_5081_length_1095_cov_13.832329	602	682	10	6	80	0.0750000
NODE_5081_length_1095_cov_13.832329	602	682	11	18	80	0.2250000
NODE_5081_length_1095_cov_13.832329	602	682	12	5	80	0.0625000
NODE_5081_length_1095_cov_13.832329	602	682	14	7	80	0.0875000
NODE_5082_length_1095_cov_13.017068	497	577	1	10	80	0.1250000
NODE_5082_length_1095_cov_13.017068	497	577	2	17	80	0.2125000
NODE_5082_length_1095_cov_13.017068	497	577	3	31	80	0.3875000
NODE_5082_length_1095_cov_13.017068	497	577	4	22	80	0.2750000
NODE_5082_length_1095_cov_13.017068	550	630	3	52	80	0.6500000
NODE_5082_length_1095_cov_13.017068	550	630	4	28	80	0.3500000
NODE_5083_length_1095_cov_7.640562	627	707	2	59	80	0.7375000
NODE_5083_length_1095_cov_7.640562	627	707	4	21	80	0.2625000
NODE_5083_length_1095_cov_7.640562	680	760	2	6	80	0.0750000
NODE_5083_length_1095_cov_7.640562	680	760	4	74	80	0.9250000
NODE_5085_length_1095_cov_4.664659	307	387	1	21	80	0.2625000
NODE_5085_length_1095_cov_4.664659	307	387	6	33	80	0.4125000
NODE_5085_length_1095_cov_4.664659	307	387	7	26	80	0.3250000
NODE_5089_length_1094_cov_35.850251	409	489	7	9	80	0.1125000
NODE_5089_length_1094_cov_35.850251	409	489	8	28	80	0.3500000
NODE_5089_length_1094_cov_35.850251	409	489	9	5	80	0.0625000
NODE_5089_length_1094_cov_35.850251	409	489	10	24	80	0.3000000
NODE_5089_length_1094_cov_35.850251	409	489	11	14	80	0.1750000
NODE_5089_length_1094_cov_35.850251	462	542	7	7	80	0.0875000
NODE_5089_length_1094_cov_35.850251	462	542	9	5	80	0.0625000
NODE_5089_length_1094_cov_35.850251	462	542	10	8	80	0.1000000
NODE_5089_length_1094_cov_35.850251	462	542	11	42	80	0.5250000
NODE_5089_length_1094_cov_35.850251	462	542	12	10	80	0.1250000
NODE_5089_length_1094_cov_35.850251	462	542	13	8	80	0.1000000
NODE_5089_length_1094_cov_35.850251	538	618	8	1	80	0.0125000
NODE_5089_length_1094_cov_35.850251	538	618	10	8	80	0.1000000
NODE_5089_length_1094_cov_35.850251	538	618	11	20	80	0.2500000
NODE_5089_length_1094_cov_35.850251	538	618	12	10	80	0.1250000
NODE_5089_length_1094_cov_35.850251	538	618	13	41	80	0.5125000
NODE_5089_length_1094_cov_35.850251	591	671	4	1	80	0.0125000
NODE_5089_length_1094_cov_35.850251	591	671	6	32	80	0.4000000
NODE_5089_length_1094_cov_35.850251	591	671	7	5	80	0.0625000
NODE_5089_length_1094_cov_35.850251	591	671	8	16	80	0.2000000
NODE_5089_length_1094_cov_35.850251	591	671	10	8	80	0.1000000
NODE_5089_length_1094_cov_35.850251	591	671	11	18	80	0.2250000
NODE_5090_length_1094_cov_27.197990	462	542	1	16	80	0.2000000
NODE_5090_length_1094_cov_27.197990	462	542	2	14	80	0.1750000
NODE_5090_length_1094_cov_27.197990	462	542	4	30	80	0.3750000
NODE_5090_length_1094_cov_27.197990	462	542	5	11	80	0.1375000
NODE_5090_length_1094_cov_27.197990	462	542	6	9	80	0.1125000
NODE_5090_length_1094_cov_27.197990	515	595	4	7	80	0.0875000
NODE_5090_length_1094_cov_27.197990	515	595	5	11	80	0.1375000
NODE_5090_length_1094_cov_27.197990	515	595	6	43	80	0.5375000
NODE_5090_length_1094_cov_27.197990	515	595	7	19	80	0.2375000
NODE_5091_length_1094_cov_19.282412	451	531	14	5	80	0.0625000
NODE_5091_length_1094_cov_19.282412	451	531	15	8	80	0.1000000
NODE_5091_length_1094_cov_19.282412	451	531	16	14	80	0.1750000
NODE_5091_length_1094_cov_19.282412	451	531	17	4	80	0.0500000
NODE_5091_length_1094_cov_19.282412	451	531	18	13	80	0.1625000
NODE_5091_length_1094_cov_19.282412	451	531	20	17	80	0.2125000
NODE_5091_length_1094_cov_19.282412	451	531	22	19	80	0.2375000
NODE_5091_length_1094_cov_19.282412	504	584	17	6	80	0.0750000
NODE_5091_length_1094_cov_19.282412	504	584	18	24	80	0.3000000
NODE_5091_length_1094_cov_19.282412	504	584	19	15	80	0.1875000
NODE_5091_length_1094_cov_19.282412	504	584	20	16	80	0.2000000
NODE_5091_length_1094_cov_19.282412	504	584	21	4	80	0.0500000
NODE_5091_length_1094_cov_19.282412	504	584	22	15	80	0.1875000
NODE_5092_length_1094_cov_16.084422	558	614	4	13	56	0.2321429
NODE_5092_length_1094_cov_16.084422	558	614	5	43	56	0.7678571
NODE_5092_length_1094_cov_16.084422	587	667	5	46	80	0.5750000
NODE_5092_length_1094_cov_16.084422	587	667	6	34	80	0.4250000
NODE_5093_length_1094_cov_11.335678	384	464	7	1	80	0.0125000
NODE_5093_length_1094_cov_11.335678	384	464	8	43	80	0.5375000
NODE_5093_length_1094_cov_11.335678	384	464	9	9	80	0.1125000
NODE_5093_length_1094_cov_11.335678	384	464	10	26	80	0.3250000
NODE_5093_length_1094_cov_11.335678	384	464	11	1	80	0.0125000
NODE_5093_length_1094_cov_11.335678	437	517	9	18	80	0.2250000
NODE_5093_length_1094_cov_11.335678	437	517	10	24	80	0.3000000
NODE_5093_length_1094_cov_11.335678	437	517	12	22	80	0.2750000
NODE_5093_length_1094_cov_11.335678	437	517	13	3	80	0.0375000
NODE_5093_length_1094_cov_11.335678	437	517	14	13	80	0.1625000
NODE_5094_length_1094_cov_10.767839	396	476	13	8	80	0.1000000
NODE_5094_length_1094_cov_10.767839	396	476	14	9	80	0.1125000
NODE_5094_length_1094_cov_10.767839	396	476	15	15	80	0.1875000
NODE_5094_length_1094_cov_10.767839	396	476	17	8	80	0.1000000
NODE_5094_length_1094_cov_10.767839	396	476	18	11	80	0.1375000
NODE_5094_length_1094_cov_10.767839	396	476	19	16	80	0.2000000
NODE_5094_length_1094_cov_10.767839	396	476	20	9	80	0.1125000
NODE_5094_length_1094_cov_10.767839	396	476	21	4	80	0.0500000
NODE_5094_length_1094_cov_10.767839	449	529	17	6	80	0.0750000
NODE_5094_length_1094_cov_10.767839	449	529	18	25	80	0.3125000
NODE_5094_length_1094_cov_10.767839	449	529	19	36	80	0.4500000
NODE_5094_length_1094_cov_10.767839	449	529	20	9	80	0.1125000
NODE_5094_length_1094_cov_10.767839	449	529	21	4	80	0.0500000
NODE_5095_length_1094_cov_9.527638	579	659	2	67	80	0.8375000
NODE_5095_length_1094_cov_9.527638	579	659	3	13	80	0.1625000
NODE_5095_length_1094_cov_9.527638	632	712	2	14	80	0.1750000
NODE_5095_length_1094_cov_9.527638	632	712	3	66	80	0.8250000
NODE_5096_length_1094_cov_9.166834	527	607	0	43	80	0.5375000
NODE_5096_length_1094_cov_9.166834	527	607	1	37	80	0.4625000
NODE_5096_length_1094_cov_9.166834	580	660	1	71	80	0.8875000
NODE_5096_length_1094_cov_9.166834	580	660	2	9	80	0.1125000
NODE_5097_length_1094_cov_5.632161	708	768	0	60	60	1.0000000
NODE_5097_length_1094_cov_5.632161	761	821	0	60	60	1.0000000
NODE_5108_length_1093_cov_28.531187	374	454	9	13	80	0.1625000
NODE_5108_length_1093_cov_28.531187	374	454	13	9	80	0.1125000
NODE_5108_length_1093_cov_28.531187	374	454	15	29	80	0.3625000
NODE_5108_length_1093_cov_28.531187	374	454	16	29	80	0.3625000
NODE_5108_length_1093_cov_28.531187	427	507	9	21	80	0.2625000
NODE_5108_length_1093_cov_28.531187	427	507	10	13	80	0.1625000
NODE_5108_length_1093_cov_28.531187	427	507	11	7	80	0.0875000
NODE_5108_length_1093_cov_28.531187	427	507	12	1	80	0.0125000
NODE_5108_length_1093_cov_28.531187	427	507	13	7	80	0.0875000
NODE_5108_length_1093_cov_28.531187	427	507	14	17	80	0.2125000
NODE_5108_length_1093_cov_28.531187	427	507	15	3	80	0.0375000
NODE_5108_length_1093_cov_28.531187	427	507	16	11	80	0.1375000
NODE_5109_length_1093_cov_22.744467	516	596	3	5	80	0.0625000
NODE_5109_length_1093_cov_22.744467	516	596	4	33	80	0.4125000
NODE_5109_length_1093_cov_22.744467	516	596	5	14	80	0.1750000
NODE_5109_length_1093_cov_22.744467	516	596	6	28	80	0.3500000
NODE_5109_length_1093_cov_22.744467	569	649	4	42	80	0.5250000
NODE_5109_length_1093_cov_22.744467	569	649	7	21	80	0.2625000
NODE_5109_length_1093_cov_22.744467	569	649	8	17	80	0.2125000
NODE_5109_length_1093_cov_22.744467	645	725	4	1	80	0.0125000
NODE_5109_length_1093_cov_22.744467	645	725	6	10	80	0.1250000
NODE_5109_length_1093_cov_22.744467	645	725	7	26	80	0.3250000
NODE_5109_length_1093_cov_22.744467	645	725	8	43	80	0.5375000
NODE_5109_length_1093_cov_22.744467	698	778	6	9	80	0.1125000
NODE_5109_length_1093_cov_22.744467	698	778	7	8	80	0.1000000
NODE_5109_length_1093_cov_22.744467	698	778	8	51	80	0.6375000
NODE_5109_length_1093_cov_22.744467	698	778	10	12	80	0.1500000
NODE_5110_length_1093_cov_11.637827	282	362	4	80	80	1.0000000
NODE_5110_length_1093_cov_11.637827	335	415	1	6	80	0.0750000
NODE_5110_length_1093_cov_11.637827	335	415	3	4	80	0.0500000
NODE_5110_length_1093_cov_11.637827	335	415	4	70	80	0.8750000
NODE_5111_length_1093_cov_9.047284	660	740	0	24	80	0.3000000
NODE_5111_length_1093_cov_9.047284	660	740	5	28	80	0.3500000
NODE_5111_length_1093_cov_9.047284	660	740	6	28	80	0.3500000
NODE_5111_length_1093_cov_9.047284	713	793	6	49	80	0.6125000
NODE_5111_length_1093_cov_9.047284	713	793	7	31	80	0.3875000
NODE_5112_length_1093_cov_6.857143	658	738	2	80	80	1.0000000
NODE_5112_length_1093_cov_6.857143	711	791	0	12	80	0.1500000
NODE_5112_length_1093_cov_6.857143	711	791	2	68	80	0.8500000
NODE_5113_length_1093_cov_5.311871	587	667	0	9	80	0.1125000
NODE_5113_length_1093_cov_5.311871	587	667	2	19	80	0.2375000
NODE_5113_length_1093_cov_5.311871	587	667	3	5	80	0.0625000
NODE_5113_length_1093_cov_5.311871	587	667	4	47	80	0.5875000
NODE_5113_length_1093_cov_5.311871	640	720	4	80	80	1.0000000
NODE_5118_length_1092_cov_105.542800	682	768	22	15	86	0.1744186
NODE_5118_length_1092_cov_105.542800	682	768	25	9	86	0.1046512
NODE_5118_length_1092_cov_105.542800	682	768	26	29	86	0.3372093
NODE_5118_length_1092_cov_105.542800	682	768	27	12	86	0.1395349
NODE_5118_length_1092_cov_105.542800	682	768	28	5	86	0.0581395
NODE_5118_length_1092_cov_105.542800	682	768	29	11	86	0.1279070
NODE_5118_length_1092_cov_105.542800	682	768	30	5	86	0.0581395
NODE_5118_length_1092_cov_105.542800	745	807	18	16	62	0.2580645
NODE_5118_length_1092_cov_105.542800	745	807	22	13	62	0.2096774
NODE_5118_length_1092_cov_105.542800	745	807	23	5	62	0.0806452
NODE_5118_length_1092_cov_105.542800	745	807	26	13	62	0.2096774
NODE_5118_length_1092_cov_105.542800	745	807	28	3	62	0.0483871
NODE_5118_length_1092_cov_105.542800	745	807	29	12	62	0.1935484
NODE_5119_length_1092_cov_30.957704	610	690	6	39	80	0.4875000
NODE_5119_length_1092_cov_30.957704	610	690	7	41	80	0.5125000
NODE_5119_length_1092_cov_30.957704	663	743	0	41	80	0.5125000
NODE_5119_length_1092_cov_30.957704	663	743	6	39	80	0.4875000
NODE_5121_length_1092_cov_16.737160	725	805	1	80	80	1.0000000
NODE_5121_length_1092_cov_16.737160	778	858	0	32	80	0.4000000
NODE_5121_length_1092_cov_16.737160	778	858	1	48	80	0.6000000
NODE_5123_length_1092_cov_11.193353	335	415	5	3	80	0.0375000
NODE_5123_length_1092_cov_11.193353	335	415	6	12	80	0.1500000
NODE_5123_length_1092_cov_11.193353	335	415	10	65	80	0.8125000
NODE_5123_length_1092_cov_11.193353	388	468	6	56	80	0.7000000
NODE_5123_length_1092_cov_11.193353	388	468	10	24	80	0.3000000
NODE_5124_length_1092_cov_9.348439	489	569	10	1	80	0.0125000
NODE_5124_length_1092_cov_9.348439	489	569	11	4	80	0.0500000
NODE_5124_length_1092_cov_9.348439	489	569	12	47	80	0.5875000
NODE_5124_length_1092_cov_9.348439	489	569	13	19	80	0.2375000
NODE_5124_length_1092_cov_9.348439	489	569	14	9	80	0.1125000
NODE_5124_length_1092_cov_9.348439	542	622	6	5	80	0.0625000
NODE_5124_length_1092_cov_9.348439	542	622	7	9	80	0.1125000
NODE_5124_length_1092_cov_9.348439	542	622	8	3	80	0.0375000
NODE_5124_length_1092_cov_9.348439	542	622	10	37	80	0.4625000
NODE_5124_length_1092_cov_9.348439	542	622	11	3	80	0.0375000
NODE_5124_length_1092_cov_9.348439	542	622	12	23	80	0.2875000
NODE_5125_length_1092_cov_7.533736	243	323	5	10	80	0.1250000
NODE_5125_length_1092_cov_7.533736	243	323	6	51	80	0.6375000
NODE_5125_length_1092_cov_7.533736	243	323	7	19	80	0.2375000
NODE_5125_length_1092_cov_7.533736	296	376	4	16	80	0.2000000
NODE_5125_length_1092_cov_7.533736	296	376	5	11	80	0.1375000
NODE_5125_length_1092_cov_7.533736	296	376	6	34	80	0.4250000
NODE_5125_length_1092_cov_7.533736	296	376	7	19	80	0.2375000
NODE_5126_length_1092_cov_6.968781	470	550	1	8	80	0.1000000
NODE_5126_length_1092_cov_6.968781	470	550	2	72	80	0.9000000
NODE_5126_length_1092_cov_6.968781	523	603	1	45	80	0.5625000
NODE_5126_length_1092_cov_6.968781	523	603	2	35	80	0.4375000
NODE_5134_length_1091_cov_54.234879	417	497	1	6	80	0.0750000
NODE_5134_length_1091_cov_54.234879	417	497	2	18	80	0.2250000
NODE_5134_length_1091_cov_54.234879	417	497	3	18	80	0.2250000
NODE_5134_length_1091_cov_54.234879	417	497	4	38	80	0.4750000
NODE_5134_length_1091_cov_54.234879	470	550	4	38	80	0.4750000
NODE_5134_length_1091_cov_54.234879	470	550	5	7	80	0.0875000
NODE_5134_length_1091_cov_54.234879	470	550	6	4	80	0.0500000
NODE_5134_length_1091_cov_54.234879	470	550	7	1	80	0.0125000
NODE_5134_length_1091_cov_54.234879	470	550	9	30	80	0.3750000
NODE_5134_length_1091_cov_54.234879	546	626	9	4	80	0.0500000
NODE_5134_length_1091_cov_54.234879	546	626	11	8	80	0.1000000
NODE_5134_length_1091_cov_54.234879	546	626	13	19	80	0.2375000
NODE_5134_length_1091_cov_54.234879	546	626	15	19	80	0.2375000
NODE_5134_length_1091_cov_54.234879	546	626	16	26	80	0.3250000
NODE_5134_length_1091_cov_54.234879	546	626	17	3	80	0.0375000
NODE_5134_length_1091_cov_54.234879	546	626	18	1	80	0.0125000
NODE_5134_length_1091_cov_54.234879	599	679	13	9	80	0.1125000
NODE_5134_length_1091_cov_54.234879	599	679	15	15	80	0.1875000
NODE_5134_length_1091_cov_54.234879	599	679	16	21	80	0.2625000
NODE_5134_length_1091_cov_54.234879	599	679	17	34	80	0.4250000
NODE_5134_length_1091_cov_54.234879	599	679	18	1	80	0.0125000
NODE_5135_length_1091_cov_35.045363	384	464	5	4	80	0.0500000
NODE_5135_length_1091_cov_35.045363	384	464	6	10	80	0.1250000
NODE_5135_length_1091_cov_35.045363	384	464	7	18	80	0.2250000
NODE_5135_length_1091_cov_35.045363	384	464	8	8	80	0.1000000
NODE_5135_length_1091_cov_35.045363	384	464	10	5	80	0.0625000
NODE_5135_length_1091_cov_35.045363	384	464	12	35	80	0.4375000
NODE_5135_length_1091_cov_35.045363	437	517	5	12	80	0.1500000
NODE_5135_length_1091_cov_35.045363	437	517	6	12	80	0.1500000
NODE_5135_length_1091_cov_35.045363	437	517	7	13	80	0.1625000
NODE_5135_length_1091_cov_35.045363	437	517	10	4	80	0.0500000
NODE_5135_length_1091_cov_35.045363	437	517	11	14	80	0.1750000
NODE_5135_length_1091_cov_35.045363	437	517	13	25	80	0.3125000
NODE_5135_length_1091_cov_35.045363	513	593	13	5	80	0.0625000
NODE_5135_length_1091_cov_35.045363	513	593	14	46	80	0.5750000
NODE_5135_length_1091_cov_35.045363	513	593	15	4	80	0.0500000
NODE_5135_length_1091_cov_35.045363	513	593	16	8	80	0.1000000
NODE_5135_length_1091_cov_35.045363	513	593	18	17	80	0.2125000
NODE_5135_length_1091_cov_35.045363	566	646	5	4	80	0.0500000
NODE_5135_length_1091_cov_35.045363	566	646	7	14	80	0.1750000
NODE_5135_length_1091_cov_35.045363	566	646	8	4	80	0.0500000
NODE_5135_length_1091_cov_35.045363	566	646	13	20	80	0.2500000
NODE_5135_length_1091_cov_35.045363	566	646	14	38	80	0.4750000
NODE_5136_length_1091_cov_28.490927	329	409	0	49	80	0.6125000
NODE_5136_length_1091_cov_28.490927	329	409	2	1	80	0.0125000
NODE_5136_length_1091_cov_28.490927	329	409	3	30	80	0.3750000
NODE_5136_length_1091_cov_28.490927	382	462	3	41	80	0.5125000
NODE_5136_length_1091_cov_28.490927	382	462	4	39	80	0.4875000
NODE_5136_length_1091_cov_28.490927	618	698	1	15	80	0.1875000
NODE_5136_length_1091_cov_28.490927	618	698	4	65	80	0.8125000
NODE_5136_length_1091_cov_28.490927	671	751	0	32	80	0.4000000
NODE_5136_length_1091_cov_28.490927	671	751	1	36	80	0.4500000
NODE_5136_length_1091_cov_28.490927	671	751	4	12	80	0.1500000
NODE_5137_length_1091_cov_23.733871	514	594	13	5	80	0.0625000
NODE_5137_length_1091_cov_23.733871	514	594	15	8	80	0.1000000
NODE_5137_length_1091_cov_23.733871	514	594	16	36	80	0.4500000
NODE_5137_length_1091_cov_23.733871	514	594	17	17	80	0.2125000
NODE_5137_length_1091_cov_23.733871	514	594	19	14	80	0.1750000
NODE_5137_length_1091_cov_23.733871	567	647	13	5	80	0.0625000
NODE_5137_length_1091_cov_23.733871	567	647	14	5	80	0.0625000
NODE_5137_length_1091_cov_23.733871	567	647	16	7	80	0.0875000
NODE_5137_length_1091_cov_23.733871	567	647	17	22	80	0.2750000
NODE_5137_length_1091_cov_23.733871	567	647	18	13	80	0.1625000
NODE_5137_length_1091_cov_23.733871	567	647	19	12	80	0.1500000
NODE_5137_length_1091_cov_23.733871	567	647	20	16	80	0.2000000
NODE_5138_length_1091_cov_13.065524	444	524	0	80	80	1.0000000
NODE_5138_length_1091_cov_13.065524	497	577	0	80	80	1.0000000
NODE_5139_length_1091_cov_10.961694	582	646	17	26	64	0.4062500
NODE_5139_length_1091_cov_10.961694	582	646	19	36	64	0.5625000
NODE_5139_length_1091_cov_10.961694	582	646	26	1	64	0.0156250
NODE_5139_length_1091_cov_10.961694	582	646	27	1	64	0.0156250
NODE_5140_length_1091_cov_8.166331	299	379	0	4	80	0.0500000
NODE_5140_length_1091_cov_8.166331	299	379	1	39	80	0.4875000
NODE_5140_length_1091_cov_8.166331	299	379	2	37	80	0.4625000
NODE_5140_length_1091_cov_8.166331	352	432	2	80	80	1.0000000
NODE_5141_length_1091_cov_7.006048	617	697	0	80	80	1.0000000
NODE_5141_length_1091_cov_7.006048	670	750	0	80	80	1.0000000
NODE_5151_length_1090_cov_73.781029	352	432	25	1	80	0.0125000
NODE_5151_length_1090_cov_73.781029	352	432	26	12	80	0.1500000
NODE_5151_length_1090_cov_73.781029	352	432	27	11	80	0.1375000
NODE_5151_length_1090_cov_73.781029	352	432	28	23	80	0.2875000
NODE_5151_length_1090_cov_73.781029	352	432	29	8	80	0.1000000
NODE_5151_length_1090_cov_73.781029	352	432	30	4	80	0.0500000
NODE_5151_length_1090_cov_73.781029	352	432	31	3	80	0.0375000
NODE_5151_length_1090_cov_73.781029	352	432	32	5	80	0.0625000
NODE_5151_length_1090_cov_73.781029	352	432	34	10	80	0.1250000
NODE_5151_length_1090_cov_73.781029	352	432	36	3	80	0.0375000
NODE_5151_length_1090_cov_73.781029	405	485	26	12	80	0.1500000
NODE_5151_length_1090_cov_73.781029	405	485	28	5	80	0.0625000
NODE_5151_length_1090_cov_73.781029	405	485	31	1	80	0.0125000
NODE_5151_length_1090_cov_73.781029	405	485	32	2	80	0.0250000
NODE_5151_length_1090_cov_73.781029	405	485	33	4	80	0.0500000
NODE_5151_length_1090_cov_73.781029	405	485	34	21	80	0.2625000
NODE_5151_length_1090_cov_73.781029	405	485	35	2	80	0.0250000
NODE_5151_length_1090_cov_73.781029	405	485	36	31	80	0.3875000
NODE_5151_length_1090_cov_73.781029	405	485	37	2	80	0.0250000
NODE_5151_length_1090_cov_73.781029	481	567	27	16	86	0.1860465
NODE_5151_length_1090_cov_73.781029	481	567	29	8	86	0.0930233
NODE_5151_length_1090_cov_73.781029	481	567	30	20	86	0.2325581
NODE_5151_length_1090_cov_73.781029	481	567	31	1	86	0.0116279
NODE_5151_length_1090_cov_73.781029	481	567	32	6	86	0.0697674
NODE_5151_length_1090_cov_73.781029	481	567	33	6	86	0.0697674
NODE_5151_length_1090_cov_73.781029	481	567	34	12	86	0.1395349
NODE_5151_length_1090_cov_73.781029	481	567	35	5	86	0.0581395
NODE_5151_length_1090_cov_73.781029	481	567	36	1	86	0.0116279
NODE_5151_length_1090_cov_73.781029	481	567	38	5	86	0.0581395
NODE_5151_length_1090_cov_73.781029	481	567	40	6	86	0.0697674
NODE_5151_length_1090_cov_73.781029	540	620	17	6	80	0.0750000
NODE_5151_length_1090_cov_73.781029	540	620	18	20	80	0.2500000
NODE_5151_length_1090_cov_73.781029	540	620	19	2	80	0.0250000
NODE_5151_length_1090_cov_73.781029	540	620	20	13	80	0.1625000
NODE_5151_length_1090_cov_73.781029	540	620	23	3	80	0.0375000
NODE_5151_length_1090_cov_73.781029	540	620	25	2	80	0.0250000
NODE_5151_length_1090_cov_73.781029	540	620	27	23	80	0.2875000
NODE_5151_length_1090_cov_73.781029	540	620	29	3	80	0.0375000
NODE_5151_length_1090_cov_73.781029	540	620	30	8	80	0.1000000
NODE_5152_length_1090_cov_42.394551	530	610	27	1	80	0.0125000
NODE_5152_length_1090_cov_42.394551	530	610	29	10	80	0.1250000
NODE_5152_length_1090_cov_42.394551	530	610	32	5	80	0.0625000
NODE_5152_length_1090_cov_42.394551	530	610	34	13	80	0.1625000
NODE_5152_length_1090_cov_42.394551	530	610	35	2	80	0.0250000
NODE_5152_length_1090_cov_42.394551	530	610	36	4	80	0.0500000
NODE_5152_length_1090_cov_42.394551	530	610	38	20	80	0.2500000
NODE_5152_length_1090_cov_42.394551	530	610	39	11	80	0.1375000
NODE_5152_length_1090_cov_42.394551	530	610	41	1	80	0.0125000
NODE_5152_length_1090_cov_42.394551	530	610	55	2	80	0.0250000
NODE_5152_length_1090_cov_42.394551	530	610	56	1	80	0.0125000
NODE_5152_length_1090_cov_42.394551	530	610	60	7	80	0.0875000
NODE_5152_length_1090_cov_42.394551	530	610	61	1	80	0.0125000
NODE_5152_length_1090_cov_42.394551	530	610	62	2	80	0.0250000
NODE_5152_length_1090_cov_42.394551	583	663	34	5	80	0.0625000
NODE_5152_length_1090_cov_42.394551	583	663	36	3	80	0.0375000
NODE_5152_length_1090_cov_42.394551	583	663	38	5	80	0.0625000
NODE_5152_length_1090_cov_42.394551	583	663	41	1	80	0.0125000
NODE_5152_length_1090_cov_42.394551	583	663	50	16	80	0.2000000
NODE_5152_length_1090_cov_42.394551	583	663	51	1	80	0.0125000
NODE_5152_length_1090_cov_42.394551	583	663	55	2	80	0.0250000
NODE_5152_length_1090_cov_42.394551	583	663	56	1	80	0.0125000
NODE_5152_length_1090_cov_42.394551	583	663	60	9	80	0.1125000
NODE_5152_length_1090_cov_42.394551	583	663	61	2	80	0.0250000
NODE_5152_length_1090_cov_42.394551	583	663	62	15	80	0.1875000
NODE_5152_length_1090_cov_42.394551	583	663	63	10	80	0.1250000
NODE_5152_length_1090_cov_42.394551	583	663	64	10	80	0.1250000
NODE_5153_length_1090_cov_37.643794	436	516	1	80	80	1.0000000
NODE_5153_length_1090_cov_37.643794	489	569	1	80	80	1.0000000
NODE_5153_length_1090_cov_37.643794	565	645	0	67	80	0.8375000
NODE_5153_length_1090_cov_37.643794	565	645	1	13	80	0.1625000
NODE_5153_length_1090_cov_37.643794	618	698	0	27	80	0.3375000
NODE_5153_length_1090_cov_37.643794	618	698	1	53	80	0.6625000
NODE_5154_length_1090_cov_32.876892	487	567	5	3	80	0.0375000
NODE_5154_length_1090_cov_32.876892	487	567	6	4	80	0.0500000
NODE_5154_length_1090_cov_32.876892	487	567	8	11	80	0.1375000
NODE_5154_length_1090_cov_32.876892	487	567	9	13	80	0.1625000
NODE_5154_length_1090_cov_32.876892	487	567	10	7	80	0.0875000
NODE_5154_length_1090_cov_32.876892	487	567	11	31	80	0.3875000
NODE_5154_length_1090_cov_32.876892	487	567	12	2	80	0.0250000
NODE_5154_length_1090_cov_32.876892	487	567	14	9	80	0.1125000
NODE_5154_length_1090_cov_32.876892	540	620	9	5	80	0.0625000
NODE_5154_length_1090_cov_32.876892	540	620	10	10	80	0.1250000
NODE_5154_length_1090_cov_32.876892	540	620	11	21	80	0.2625000
NODE_5154_length_1090_cov_32.876892	540	620	12	6	80	0.0750000
NODE_5154_length_1090_cov_32.876892	540	620	13	23	80	0.2875000
NODE_5154_length_1090_cov_32.876892	540	620	14	15	80	0.1875000
NODE_5155_length_1090_cov_25.373360	486	566	2	80	80	1.0000000
NODE_5155_length_1090_cov_25.373360	539	619	1	19	80	0.2375000
NODE_5155_length_1090_cov_25.373360	539	619	2	61	80	0.7625000
NODE_5156_length_1090_cov_21.290616	422	502	2	3	80	0.0375000
NODE_5156_length_1090_cov_21.290616	422	502	3	44	80	0.5500000
NODE_5156_length_1090_cov_21.290616	422	502	4	33	80	0.4125000
NODE_5156_length_1090_cov_21.290616	475	555	0	13	80	0.1625000
NODE_5156_length_1090_cov_21.290616	475	555	1	25	80	0.3125000
NODE_5156_length_1090_cov_21.290616	475	555	2	18	80	0.2250000
NODE_5156_length_1090_cov_21.290616	475	555	3	24	80	0.3000000
NODE_5156_length_1090_cov_21.290616	551	631	0	80	80	1.0000000
NODE_5156_length_1090_cov_21.290616	604	684	0	80	80	1.0000000
NODE_5157_length_1090_cov_16.040363	666	746	7	12	80	0.1500000
NODE_5157_length_1090_cov_16.040363	666	746	8	20	80	0.2500000
NODE_5157_length_1090_cov_16.040363	666	746	9	22	80	0.2750000
NODE_5157_length_1090_cov_16.040363	666	746	10	26	80	0.3250000
NODE_5157_length_1090_cov_16.040363	719	799	5	16	80	0.2000000
NODE_5157_length_1090_cov_16.040363	719	799	6	4	80	0.0500000
NODE_5157_length_1090_cov_16.040363	719	799	7	17	80	0.2125000
NODE_5157_length_1090_cov_16.040363	719	799	8	19	80	0.2375000
NODE_5157_length_1090_cov_16.040363	719	799	10	24	80	0.3000000
NODE_5158_length_1090_cov_14.826438	393	473	8	47	80	0.5875000
NODE_5158_length_1090_cov_14.826438	393	473	9	33	80	0.4125000
NODE_5158_length_1090_cov_14.826438	446	526	6	21	80	0.2625000
NODE_5158_length_1090_cov_14.826438	446	526	7	14	80	0.1750000
NODE_5158_length_1090_cov_14.826438	446	526	8	37	80	0.4625000
NODE_5158_length_1090_cov_14.826438	446	526	9	8	80	0.1000000
NODE_5159_length_1090_cov_13.721493	498	578	12	3	80	0.0375000
NODE_5159_length_1090_cov_13.721493	498	578	14	23	80	0.2875000
NODE_5159_length_1090_cov_13.721493	498	578	15	9	80	0.1125000
NODE_5159_length_1090_cov_13.721493	498	578	16	17	80	0.2125000
NODE_5159_length_1090_cov_13.721493	498	578	17	28	80	0.3500000
NODE_5159_length_1090_cov_13.721493	551	631	12	32	80	0.4000000
NODE_5159_length_1090_cov_13.721493	551	631	13	18	80	0.2250000
NODE_5159_length_1090_cov_13.721493	551	631	14	2	80	0.0250000
NODE_5159_length_1090_cov_13.721493	551	631	16	10	80	0.1250000
NODE_5159_length_1090_cov_13.721493	551	631	17	17	80	0.2125000
NODE_5159_length_1090_cov_13.721493	551	631	18	1	80	0.0125000
NODE_5160_length_1090_cov_12.365288	386	467	4	43	81	0.5308642
NODE_5160_length_1090_cov_12.365288	386	467	5	24	81	0.2962963
NODE_5160_length_1090_cov_12.365288	386	467	7	14	81	0.1728395
NODE_5160_length_1090_cov_12.365288	440	520	4	1	80	0.0125000
NODE_5160_length_1090_cov_12.365288	440	520	5	20	80	0.2500000
NODE_5160_length_1090_cov_12.365288	440	520	6	1	80	0.0125000
NODE_5160_length_1090_cov_12.365288	440	520	7	38	80	0.4750000
NODE_5160_length_1090_cov_12.365288	440	520	8	20	80	0.2500000
NODE_5160_length_1090_cov_12.365288	516	596	5	28	80	0.3500000
NODE_5160_length_1090_cov_12.365288	516	596	6	47	80	0.5875000
NODE_5160_length_1090_cov_12.365288	516	596	7	5	80	0.0625000
NODE_5160_length_1090_cov_12.365288	569	649	2	16	80	0.2000000
NODE_5160_length_1090_cov_12.365288	569	649	3	20	80	0.2500000
NODE_5160_length_1090_cov_12.365288	569	649	4	10	80	0.1250000
NODE_5160_length_1090_cov_12.365288	569	649	5	1	80	0.0125000
NODE_5160_length_1090_cov_12.365288	569	649	6	28	80	0.3500000
NODE_5160_length_1090_cov_12.365288	569	649	7	5	80	0.0625000
NODE_5161_length_1090_cov_5.348133	0	80	0	80	80	1.0000000
NODE_5161_length_1090_cov_5.348133	53	99	0	46	46	1.0000000
NODE_5163_length_1090_cov_3.598385	300	340	0	40	40	1.0000000
NODE_5170_length_1089_cov_55.374747	515	594	11	35	79	0.4430380
NODE_5170_length_1089_cov_55.374747	515	594	12	16	79	0.2025317
NODE_5170_length_1089_cov_55.374747	515	594	16	1	79	0.0126582
NODE_5170_length_1089_cov_55.374747	515	594	18	3	79	0.0379747
NODE_5170_length_1089_cov_55.374747	515	594	19	4	79	0.0506329
NODE_5170_length_1089_cov_55.374747	515	594	20	17	79	0.2151899
NODE_5170_length_1089_cov_55.374747	515	594	23	3	79	0.0379747
NODE_5170_length_1089_cov_55.374747	567	647	16	6	80	0.0750000
NODE_5170_length_1089_cov_55.374747	567	647	17	1	80	0.0125000
NODE_5170_length_1089_cov_55.374747	567	647	18	11	80	0.1375000
NODE_5170_length_1089_cov_55.374747	567	647	19	22	80	0.2750000
NODE_5170_length_1089_cov_55.374747	567	647	20	30	80	0.3750000
NODE_5170_length_1089_cov_55.374747	567	647	21	7	80	0.0875000
NODE_5170_length_1089_cov_55.374747	567	647	23	3	80	0.0375000
NODE_5170_length_1089_cov_55.374747	643	723	12	3	80	0.0375000
NODE_5170_length_1089_cov_55.374747	643	723	14	4	80	0.0500000
NODE_5170_length_1089_cov_55.374747	643	723	16	2	80	0.0250000
NODE_5170_length_1089_cov_55.374747	643	723	18	1	80	0.0125000
NODE_5170_length_1089_cov_55.374747	643	723	19	44	80	0.5500000
NODE_5170_length_1089_cov_55.374747	643	723	20	15	80	0.1875000
NODE_5170_length_1089_cov_55.374747	643	723	21	11	80	0.1375000
NODE_5170_length_1089_cov_55.374747	696	776	6	1	80	0.0125000
NODE_5170_length_1089_cov_55.374747	696	776	7	9	80	0.1125000
NODE_5170_length_1089_cov_55.374747	696	776	9	29	80	0.3625000
NODE_5170_length_1089_cov_55.374747	696	776	12	17	80	0.2125000
NODE_5170_length_1089_cov_55.374747	696	776	14	4	80	0.0500000
NODE_5170_length_1089_cov_55.374747	696	776	19	9	80	0.1125000
NODE_5170_length_1089_cov_55.374747	696	776	21	11	80	0.1375000
NODE_5171_length_1089_cov_38.506061	458	538	5	13	80	0.1625000
NODE_5171_length_1089_cov_38.506061	458	538	6	7	80	0.0875000
NODE_5171_length_1089_cov_38.506061	458	538	7	3	80	0.0375000
NODE_5171_length_1089_cov_38.506061	458	538	8	4	80	0.0500000
NODE_5171_length_1089_cov_38.506061	458	538	9	15	80	0.1875000
NODE_5171_length_1089_cov_38.506061	458	538	10	38	80	0.4750000
NODE_5171_length_1089_cov_38.506061	511	591	7	17	80	0.2125000
NODE_5171_length_1089_cov_38.506061	511	591	8	11	80	0.1375000
NODE_5171_length_1089_cov_38.506061	511	591	9	23	80	0.2875000
NODE_5171_length_1089_cov_38.506061	511	591	10	29	80	0.3625000
NODE_5171_length_1089_cov_38.506061	587	667	4	30	80	0.3750000
NODE_5171_length_1089_cov_38.506061	587	667	5	2	80	0.0250000
NODE_5171_length_1089_cov_38.506061	587	667	6	4	80	0.0500000
NODE_5171_length_1089_cov_38.506061	587	667	7	14	80	0.1750000
NODE_5171_length_1089_cov_38.506061	587	667	8	7	80	0.0875000
NODE_5171_length_1089_cov_38.506061	587	667	9	23	80	0.2875000
NODE_5171_length_1089_cov_38.506061	640	720	1	7	80	0.0875000
NODE_5171_length_1089_cov_38.506061	640	720	3	15	80	0.1875000
NODE_5171_length_1089_cov_38.506061	640	720	4	58	80	0.7250000
NODE_5172_length_1089_cov_22.657576	379	459	9	13	80	0.1625000
NODE_5172_length_1089_cov_22.657576	379	459	10	1	80	0.0125000
NODE_5172_length_1089_cov_22.657576	379	459	12	1	80	0.0125000
NODE_5172_length_1089_cov_22.657576	379	459	13	49	80	0.6125000
NODE_5172_length_1089_cov_22.657576	379	459	14	16	80	0.2000000
NODE_5172_length_1089_cov_22.657576	432	512	6	21	80	0.2625000
NODE_5172_length_1089_cov_22.657576	432	512	7	11	80	0.1375000
NODE_5172_length_1089_cov_22.657576	432	512	10	10	80	0.1250000
NODE_5172_length_1089_cov_22.657576	432	512	13	22	80	0.2750000
NODE_5172_length_1089_cov_22.657576	432	512	14	16	80	0.2000000
NODE_5173_length_1089_cov_21.180808	547	627	7	21	80	0.2625000
NODE_5173_length_1089_cov_21.180808	547	627	8	49	80	0.6125000
NODE_5173_length_1089_cov_21.180808	547	627	10	10	80	0.1250000
NODE_5173_length_1089_cov_21.180808	600	680	6	20	80	0.2500000
NODE_5173_length_1089_cov_21.180808	600	680	7	14	80	0.1750000
NODE_5173_length_1089_cov_21.180808	600	680	8	18	80	0.2250000
NODE_5173_length_1089_cov_21.180808	600	680	9	10	80	0.1250000
NODE_5173_length_1089_cov_21.180808	600	680	10	18	80	0.2250000
NODE_5174_length_1089_cov_18.713131	431	511	2	5	80	0.0625000
NODE_5174_length_1089_cov_18.713131	431	511	3	1	80	0.0125000
NODE_5174_length_1089_cov_18.713131	431	511	4	1	80	0.0125000
NODE_5174_length_1089_cov_18.713131	431	511	6	6	80	0.0750000
NODE_5174_length_1089_cov_18.713131	431	511	7	13	80	0.1625000
NODE_5174_length_1089_cov_18.713131	431	511	9	7	80	0.0875000
NODE_5174_length_1089_cov_18.713131	431	511	10	47	80	0.5875000
NODE_5174_length_1089_cov_18.713131	484	564	8	45	80	0.5625000
NODE_5174_length_1089_cov_18.713131	484	564	9	6	80	0.0750000
NODE_5174_length_1089_cov_18.713131	484	564	10	29	80	0.3625000
NODE_5174_length_1089_cov_18.713131	560	640	1	21	80	0.2625000
NODE_5174_length_1089_cov_18.713131	560	640	2	12	80	0.1500000
NODE_5174_length_1089_cov_18.713131	560	640	3	1	80	0.0125000
NODE_5174_length_1089_cov_18.713131	560	640	4	18	80	0.2250000
NODE_5174_length_1089_cov_18.713131	560	640	6	1	80	0.0125000
NODE_5174_length_1089_cov_18.713131	560	640	7	1	80	0.0125000
NODE_5174_length_1089_cov_18.713131	560	640	8	26	80	0.3250000
NODE_5174_length_1089_cov_18.713131	613	693	1	21	80	0.2625000
NODE_5174_length_1089_cov_18.713131	613	693	2	59	80	0.7375000
NODE_5175_length_1089_cov_17.382828	376	456	2	35	80	0.4375000
NODE_5175_length_1089_cov_17.382828	376	456	3	37	80	0.4625000
NODE_5175_length_1089_cov_17.382828	376	456	4	8	80	0.1000000
NODE_5175_length_1089_cov_17.382828	429	509	2	80	80	1.0000000
NODE_5175_length_1089_cov_17.382828	505	585	0	22	80	0.2750000
NODE_5175_length_1089_cov_17.382828	505	585	1	49	80	0.6125000
NODE_5175_length_1089_cov_17.382828	505	585	2	9	80	0.1125000
NODE_5175_length_1089_cov_17.382828	558	638	0	75	80	0.9375000
NODE_5175_length_1089_cov_17.382828	558	638	1	5	80	0.0625000
NODE_5176_length_1089_cov_14.540404	610	690	2	5	80	0.0625000
NODE_5176_length_1089_cov_14.540404	610	690	3	10	80	0.1250000
NODE_5176_length_1089_cov_14.540404	610	690	4	30	80	0.3750000
NODE_5176_length_1089_cov_14.540404	610	690	5	23	80	0.2875000
NODE_5176_length_1089_cov_14.540404	610	690	6	12	80	0.1500000
NODE_5176_length_1089_cov_14.540404	663	743	4	18	80	0.2250000
NODE_5176_length_1089_cov_14.540404	663	743	5	50	80	0.6250000
NODE_5176_length_1089_cov_14.540404	663	743	6	12	80	0.1500000
NODE_5182_length_1088_cov_10.603640	504	584	8	4	80	0.0500000
NODE_5182_length_1088_cov_10.603640	504	584	9	20	80	0.2500000
NODE_5182_length_1088_cov_10.603640	504	584	10	26	80	0.3250000
NODE_5182_length_1088_cov_10.603640	504	584	11	30	80	0.3750000
NODE_5182_length_1088_cov_10.603640	557	632	6	13	75	0.1733333
NODE_5182_length_1088_cov_10.603640	557	632	7	6	75	0.0800000
NODE_5182_length_1088_cov_10.603640	557	632	8	9	75	0.1200000
NODE_5182_length_1088_cov_10.603640	557	632	10	30	75	0.4000000
NODE_5182_length_1088_cov_10.603640	557	632	11	17	75	0.2266667
NODE_5194_length_1088_cov_0.759353	0	59	0	59	59	1.0000000
NODE_5194_length_1088_cov_0.759353	32	97	0	65	65	1.0000000
NODE_5195_length_1087_cov_51.676113	457	537	2	35	80	0.4375000
NODE_5195_length_1087_cov_51.676113	457	537	3	45	80	0.5625000
NODE_5195_length_1087_cov_51.676113	510	590	0	30	80	0.3750000
NODE_5195_length_1087_cov_51.676113	510	590	2	50	80	0.6250000
NODE_5195_length_1087_cov_51.676113	586	666	0	18	80	0.2250000
NODE_5195_length_1087_cov_51.676113	586	666	2	1	80	0.0125000
NODE_5195_length_1087_cov_51.676113	586	666	3	16	80	0.2000000
NODE_5195_length_1087_cov_51.676113	586	666	4	45	80	0.5625000
NODE_5195_length_1087_cov_51.676113	639	719	4	80	80	1.0000000
NODE_5196_length_1087_cov_47.144737	214	276	8	3	62	0.0483871
NODE_5196_length_1087_cov_47.144737	214	276	9	1	62	0.0161290
NODE_5196_length_1087_cov_47.144737	214	276	10	41	62	0.6612903
NODE_5196_length_1087_cov_47.144737	214	276	13	4	62	0.0645161
NODE_5196_length_1087_cov_47.144737	214	276	14	11	62	0.1774193
NODE_5196_length_1087_cov_47.144737	214	276	15	2	62	0.0322581
NODE_5196_length_1087_cov_47.144737	630	710	20	8	80	0.1000000
NODE_5196_length_1087_cov_47.144737	630	710	21	17	80	0.2125000
NODE_5196_length_1087_cov_47.144737	630	710	22	17	80	0.2125000
NODE_5196_length_1087_cov_47.144737	630	710	23	37	80	0.4625000
NODE_5196_length_1087_cov_47.144737	630	710	24	1	80	0.0125000
NODE_5196_length_1087_cov_47.144737	683	763	6	10	80	0.1250000
NODE_5196_length_1087_cov_47.144737	683	763	8	12	80	0.1500000
NODE_5196_length_1087_cov_47.144737	683	763	13	1	80	0.0125000
NODE_5196_length_1087_cov_47.144737	683	763	14	6	80	0.0750000
NODE_5196_length_1087_cov_47.144737	683	763	15	9	80	0.1125000
NODE_5196_length_1087_cov_47.144737	683	763	16	11	80	0.1375000
NODE_5196_length_1087_cov_47.144737	683	763	18	2	80	0.0250000
NODE_5196_length_1087_cov_47.144737	683	763	20	10	80	0.1250000
NODE_5196_length_1087_cov_47.144737	683	763	22	4	80	0.0500000
NODE_5196_length_1087_cov_47.144737	683	763	23	15	80	0.1875000
NODE_5197_length_1087_cov_46.633603	871	951	9	9	80	0.1125000
NODE_5197_length_1087_cov_46.633603	871	951	10	30	80	0.3750000
NODE_5197_length_1087_cov_46.633603	871	951	12	2	80	0.0250000
NODE_5197_length_1087_cov_46.633603	871	951	14	25	80	0.3125000
NODE_5197_length_1087_cov_46.633603	871	951	15	14	80	0.1750000
NODE_5197_length_1087_cov_46.633603	924	999	0	1	75	0.0133333
NODE_5197_length_1087_cov_46.633603	924	999	1	20	75	0.2666667
NODE_5197_length_1087_cov_46.633603	924	999	2	6	75	0.0800000
NODE_5197_length_1087_cov_46.633603	924	999	4	3	75	0.0400000
NODE_5197_length_1087_cov_46.633603	924	999	6	13	75	0.1733333
NODE_5197_length_1087_cov_46.633603	924	999	8	1	75	0.0133333
NODE_5197_length_1087_cov_46.633603	924	999	9	13	75	0.1733333
NODE_5197_length_1087_cov_46.633603	924	999	10	18	75	0.2400000
NODE_5198_length_1087_cov_30.577935	528	608	23	8	80	0.1000000
NODE_5198_length_1087_cov_30.577935	528	608	24	2	80	0.0250000
NODE_5198_length_1087_cov_30.577935	528	608	25	4	80	0.0500000
NODE_5198_length_1087_cov_30.577935	528	608	26	3	80	0.0375000
NODE_5198_length_1087_cov_30.577935	528	608	27	7	80	0.0875000
NODE_5198_length_1087_cov_30.577935	528	608	28	15	80	0.1875000
NODE_5198_length_1087_cov_30.577935	528	608	29	4	80	0.0500000
NODE_5198_length_1087_cov_30.577935	528	608	31	7	80	0.0875000
NODE_5198_length_1087_cov_30.577935	528	608	33	6	80	0.0750000
NODE_5198_length_1087_cov_30.577935	528	608	34	4	80	0.0500000
NODE_5198_length_1087_cov_30.577935	528	608	35	7	80	0.0875000
NODE_5198_length_1087_cov_30.577935	528	608	36	12	80	0.1500000
NODE_5198_length_1087_cov_30.577935	528	608	37	1	80	0.0125000
NODE_5198_length_1087_cov_30.577935	581	661	25	11	80	0.1375000
NODE_5198_length_1087_cov_30.577935	581	661	27	6	80	0.0750000
NODE_5198_length_1087_cov_30.577935	581	661	29	2	80	0.0250000
NODE_5198_length_1087_cov_30.577935	581	661	32	1	80	0.0125000
NODE_5198_length_1087_cov_30.577935	581	661	33	13	80	0.1625000
NODE_5198_length_1087_cov_30.577935	581	661	34	4	80	0.0500000
NODE_5198_length_1087_cov_30.577935	581	661	35	8	80	0.1000000
NODE_5198_length_1087_cov_30.577935	581	661	36	32	80	0.4000000
NODE_5198_length_1087_cov_30.577935	581	661	37	3	80	0.0375000
NODE_5199_length_1087_cov_30.205466	515	591	9	9	76	0.1184211
NODE_5199_length_1087_cov_30.205466	515	591	11	14	76	0.1842105
NODE_5199_length_1087_cov_30.205466	515	591	12	3	76	0.0394737
NODE_5199_length_1087_cov_30.205466	515	591	14	12	76	0.1578947
NODE_5199_length_1087_cov_30.205466	515	591	15	6	76	0.0789474
NODE_5199_length_1087_cov_30.205466	515	591	18	8	76	0.1052632
NODE_5199_length_1087_cov_30.205466	515	591	19	12	76	0.1578947
NODE_5199_length_1087_cov_30.205466	515	591	20	11	76	0.1447368
NODE_5199_length_1087_cov_30.205466	515	591	23	1	76	0.0131579
NODE_5199_length_1087_cov_30.205466	564	644	18	24	80	0.3000000
NODE_5199_length_1087_cov_30.205466	564	644	19	26	80	0.3250000
NODE_5199_length_1087_cov_30.205466	564	644	20	11	80	0.1375000
NODE_5199_length_1087_cov_30.205466	564	644	21	10	80	0.1250000
NODE_5199_length_1087_cov_30.205466	564	644	23	9	80	0.1125000
NODE_5200_length_1087_cov_29.595142	568	648	6	28	80	0.3500000
NODE_5200_length_1087_cov_29.595142	568	648	7	31	80	0.3875000
NODE_5200_length_1087_cov_29.595142	568	648	8	16	80	0.2000000
NODE_5200_length_1087_cov_29.595142	568	648	11	5	80	0.0625000
NODE_5200_length_1087_cov_29.595142	621	701	7	9	80	0.1125000
NODE_5200_length_1087_cov_29.595142	621	701	8	24	80	0.3000000
NODE_5200_length_1087_cov_29.595142	621	701	11	47	80	0.5875000
NODE_5201_length_1087_cov_11.600202	374	454	11	2	80	0.0250000
NODE_5201_length_1087_cov_11.600202	374	454	12	32	80	0.4000000
NODE_5201_length_1087_cov_11.600202	374	454	14	6	80	0.0750000
NODE_5201_length_1087_cov_11.600202	374	454	15	33	80	0.4125000
NODE_5201_length_1087_cov_11.600202	374	454	16	7	80	0.0875000
NODE_5201_length_1087_cov_11.600202	427	507	8	4	80	0.0500000
NODE_5201_length_1087_cov_11.600202	427	507	11	11	80	0.1375000
NODE_5201_length_1087_cov_11.600202	427	507	12	5	80	0.0625000
NODE_5201_length_1087_cov_11.600202	427	507	15	46	80	0.5750000
NODE_5201_length_1087_cov_11.600202	427	507	16	14	80	0.1750000
NODE_5202_length_1087_cov_7.746964	436	516	3	41	80	0.5125000
NODE_5202_length_1087_cov_7.746964	436	516	4	34	80	0.4250000
NODE_5202_length_1087_cov_7.746964	436	516	5	5	80	0.0625000
NODE_5202_length_1087_cov_7.746964	489	569	2	6	80	0.0750000
NODE_5202_length_1087_cov_7.746964	489	569	3	48	80	0.6000000
NODE_5202_length_1087_cov_7.746964	489	569	4	26	80	0.3250000
NODE_5211_length_1086_cov_35.748734	406	486	8	3	80	0.0375000
NODE_5211_length_1086_cov_35.748734	406	486	9	53	80	0.6625000
NODE_5211_length_1086_cov_35.748734	406	486	10	24	80	0.3000000
NODE_5211_length_1086_cov_35.748734	459	539	4	12	80	0.1500000
NODE_5211_length_1086_cov_35.748734	459	539	6	15	80	0.1875000
NODE_5211_length_1086_cov_35.748734	459	539	7	2	80	0.0250000
NODE_5211_length_1086_cov_35.748734	459	539	8	6	80	0.0750000
NODE_5211_length_1086_cov_35.748734	459	539	9	26	80	0.3250000
NODE_5211_length_1086_cov_35.748734	459	539	10	19	80	0.2375000
NODE_5212_length_1086_cov_18.445795	325	405	6	21	80	0.2625000
NODE_5212_length_1086_cov_18.445795	325	405	9	5	80	0.0625000
NODE_5212_length_1086_cov_18.445795	325	405	13	5	80	0.0625000
NODE_5212_length_1086_cov_18.445795	325	405	14	23	80	0.2875000
NODE_5212_length_1086_cov_18.445795	325	405	15	13	80	0.1625000
NODE_5212_length_1086_cov_18.445795	325	405	18	1	80	0.0125000
NODE_5212_length_1086_cov_18.445795	325	405	19	3	80	0.0375000
NODE_5212_length_1086_cov_18.445795	325	405	26	7	80	0.0875000
NODE_5212_length_1086_cov_18.445795	325	405	27	2	80	0.0250000
NODE_5212_length_1086_cov_18.445795	378	458	14	1	80	0.0125000
NODE_5212_length_1086_cov_18.445795	378	458	15	13	80	0.1625000
NODE_5212_length_1086_cov_18.445795	378	458	18	1	80	0.0125000
NODE_5212_length_1086_cov_18.445795	378	458	19	3	80	0.0375000
NODE_5212_length_1086_cov_18.445795	378	458	23	30	80	0.3750000
NODE_5212_length_1086_cov_18.445795	378	458	26	30	80	0.3750000
NODE_5212_length_1086_cov_18.445795	378	458	27	2	80	0.0250000
NODE_5213_length_1086_cov_16.878419	528	608	0	16	80	0.2000000
NODE_5213_length_1086_cov_16.878419	528	608	3	64	80	0.8000000
NODE_5213_length_1086_cov_16.878419	581	661	0	7	80	0.0875000
NODE_5213_length_1086_cov_16.878419	581	661	3	73	80	0.9125000
NODE_5214_length_1086_cov_10.700101	498	578	11	11	80	0.1375000
NODE_5214_length_1086_cov_10.700101	498	578	12	11	80	0.1375000
NODE_5214_length_1086_cov_10.700101	498	578	13	32	80	0.4000000
NODE_5214_length_1086_cov_10.700101	498	578	14	18	80	0.2250000
NODE_5214_length_1086_cov_10.700101	498	578	15	1	80	0.0125000
NODE_5214_length_1086_cov_10.700101	498	578	16	7	80	0.0875000
NODE_5214_length_1086_cov_10.700101	551	631	9	29	80	0.3625000
NODE_5214_length_1086_cov_10.700101	551	631	12	15	80	0.1875000
NODE_5214_length_1086_cov_10.700101	551	631	13	18	80	0.2250000
NODE_5214_length_1086_cov_10.700101	551	631	14	11	80	0.1375000
NODE_5214_length_1086_cov_10.700101	551	631	16	7	80	0.0875000
NODE_5215_length_1086_cov_10.656535	277	357	3	80	80	1.0000000
NODE_5215_length_1086_cov_10.656535	330	410	0	22	80	0.2750000
NODE_5215_length_1086_cov_10.656535	330	410	3	58	80	0.7250000
NODE_5216_length_1086_cov_6.873354	374	454	0	80	80	1.0000000
NODE_5216_length_1086_cov_6.873354	427	507	0	80	80	1.0000000
NODE_5217_length_1086_cov_5.225937	869	949	4	57	80	0.7125000
NODE_5217_length_1086_cov_5.225937	869	949	5	15	80	0.1875000
NODE_5217_length_1086_cov_5.225937	869	949	6	8	80	0.1000000
NODE_5217_length_1086_cov_5.225937	922	1002	3	11	80	0.1375000
NODE_5217_length_1086_cov_5.225937	922	1002	4	29	80	0.3625000
NODE_5217_length_1086_cov_5.225937	922	1002	5	32	80	0.4000000
NODE_5217_length_1086_cov_5.225937	922	1002	6	8	80	0.1000000
NODE_5229_length_1085_cov_30.599391	515	595	8	23	80	0.2875000
NODE_5229_length_1085_cov_30.599391	515	595	10	51	80	0.6375000
NODE_5229_length_1085_cov_30.599391	515	595	11	6	80	0.0750000
NODE_5229_length_1085_cov_30.599391	568	648	7	9	80	0.1125000
NODE_5229_length_1085_cov_30.599391	568	648	8	19	80	0.2375000
NODE_5229_length_1085_cov_30.599391	568	648	9	19	80	0.2375000
NODE_5229_length_1085_cov_30.599391	568	648	10	27	80	0.3375000
NODE_5229_length_1085_cov_30.599391	568	648	11	6	80	0.0750000
NODE_5231_length_1085_cov_13.723124	558	638	14	37	80	0.4625000
NODE_5231_length_1085_cov_13.723124	558	638	16	17	80	0.2125000
NODE_5231_length_1085_cov_13.723124	558	638	18	16	80	0.2000000
NODE_5231_length_1085_cov_13.723124	558	638	19	1	80	0.0125000
NODE_5231_length_1085_cov_13.723124	558	638	20	9	80	0.1125000
NODE_5231_length_1085_cov_13.723124	611	691	10	28	80	0.3500000
NODE_5231_length_1085_cov_13.723124	611	691	11	2	80	0.0250000
NODE_5231_length_1085_cov_13.723124	611	691	13	1	80	0.0125000
NODE_5231_length_1085_cov_13.723124	611	691	14	5	80	0.0625000
NODE_5231_length_1085_cov_13.723124	611	691	16	6	80	0.0750000
NODE_5231_length_1085_cov_13.723124	611	691	17	15	80	0.1875000
NODE_5231_length_1085_cov_13.723124	611	691	18	23	80	0.2875000
NODE_5232_length_1085_cov_12.481744	576	656	1	25	80	0.3125000
NODE_5232_length_1085_cov_12.481744	576	656	2	55	80	0.6875000
NODE_5232_length_1085_cov_12.481744	629	709	1	59	80	0.7375000
NODE_5232_length_1085_cov_12.481744	629	709	2	21	80	0.2625000
NODE_5233_length_1085_cov_11.570994	553	633	0	80	80	1.0000000
NODE_5233_length_1085_cov_11.570994	606	686	0	80	80	1.0000000
NODE_5234_length_1085_cov_10.730223	273	353	0	24	80	0.3000000
NODE_5234_length_1085_cov_10.730223	273	353	1	56	80	0.7000000
NODE_5234_length_1085_cov_10.730223	326	406	1	50	80	0.6250000
NODE_5234_length_1085_cov_10.730223	326	406	2	30	80	0.3750000
NODE_5234_length_1085_cov_10.730223	402	482	2	53	80	0.6625000
NODE_5234_length_1085_cov_10.730223	402	482	3	6	80	0.0750000
NODE_5234_length_1085_cov_10.730223	402	482	4	21	80	0.2625000
NODE_5234_length_1085_cov_10.730223	455	535	2	6	80	0.0750000
NODE_5234_length_1085_cov_10.730223	455	535	4	46	80	0.5750000
NODE_5234_length_1085_cov_10.730223	455	535	5	28	80	0.3500000
NODE_5234_length_1085_cov_10.730223	832	908	4	76	76	1.0000000
NODE_5236_length_1085_cov_8.309331	400	480	2	2	80	0.0250000
NODE_5236_length_1085_cov_8.309331	400	480	3	78	80	0.9750000
NODE_5236_length_1085_cov_8.309331	453	533	1	47	80	0.5875000
NODE_5236_length_1085_cov_8.309331	453	533	2	1	80	0.0125000
NODE_5236_length_1085_cov_8.309331	453	533	3	32	80	0.4000000
NODE_5248_length_1084_cov_60.255838	446	524	6	7	78	0.0897436
NODE_5248_length_1084_cov_60.255838	446	524	7	6	78	0.0769231
NODE_5248_length_1084_cov_60.255838	446	524	8	65	78	0.8333333
NODE_5248_length_1084_cov_60.255838	497	577	6	7	80	0.0875000
NODE_5248_length_1084_cov_60.255838	497	577	7	20	80	0.2500000
NODE_5248_length_1084_cov_60.255838	497	577	8	53	80	0.6625000
NODE_5249_length_1084_cov_33.332995	445	525	3	20	80	0.2500000
NODE_5249_length_1084_cov_33.332995	445	525	4	23	80	0.2875000
NODE_5249_length_1084_cov_33.332995	445	525	5	37	80	0.4625000
NODE_5249_length_1084_cov_33.332995	498	578	3	26	80	0.3250000
NODE_5249_length_1084_cov_33.332995	498	578	4	54	80	0.6750000
NODE_5250_length_1084_cov_11.004061	757	837	13	15	80	0.1875000
NODE_5250_length_1084_cov_11.004061	757	837	14	51	80	0.6375000
NODE_5250_length_1084_cov_11.004061	757	837	16	14	80	0.1750000
NODE_5250_length_1084_cov_11.004061	810	890	6	5	80	0.0625000
NODE_5250_length_1084_cov_11.004061	810	890	9	24	80	0.3000000
NODE_5250_length_1084_cov_11.004061	810	890	10	2	80	0.0250000
NODE_5250_length_1084_cov_11.004061	810	890	11	9	80	0.1125000
NODE_5250_length_1084_cov_11.004061	810	890	12	12	80	0.1500000
NODE_5250_length_1084_cov_11.004061	810	890	13	10	80	0.1250000
NODE_5250_length_1084_cov_11.004061	810	890	14	4	80	0.0500000
NODE_5250_length_1084_cov_11.004061	810	890	16	14	80	0.1750000
NODE_5258_length_1083_cov_42.182927	451	531	0	69	80	0.8625000
NODE_5258_length_1083_cov_42.182927	451	531	1	11	80	0.1375000
NODE_5258_length_1083_cov_42.182927	504	584	0	80	80	1.0000000
NODE_5258_length_1083_cov_42.182927	580	660	0	8	80	0.1000000
NODE_5258_length_1083_cov_42.182927	580	660	1	8	80	0.1000000
NODE_5258_length_1083_cov_42.182927	580	660	2	32	80	0.4000000
NODE_5258_length_1083_cov_42.182927	580	660	3	32	80	0.4000000
NODE_5258_length_1083_cov_42.182927	633	713	3	80	80	1.0000000
NODE_5259_length_1083_cov_41.163618	275	355	8	38	80	0.4750000
NODE_5259_length_1083_cov_41.163618	275	355	9	21	80	0.2625000
NODE_5259_length_1083_cov_41.163618	275	355	13	21	80	0.2625000
NODE_5259_length_1083_cov_41.163618	328	408	9	6	80	0.0750000
NODE_5259_length_1083_cov_41.163618	328	408	12	5	80	0.0625000
NODE_5259_length_1083_cov_41.163618	328	408	13	31	80	0.3875000
NODE_5259_length_1083_cov_41.163618	328	408	14	2	80	0.0250000
NODE_5259_length_1083_cov_41.163618	328	408	15	9	80	0.1125000
NODE_5259_length_1083_cov_41.163618	328	408	16	7	80	0.0875000
NODE_5259_length_1083_cov_41.163618	328	408	18	16	80	0.2000000
NODE_5259_length_1083_cov_41.163618	328	408	19	4	80	0.0500000
NODE_5259_length_1083_cov_41.163618	404	484	12	10	80	0.1250000
NODE_5259_length_1083_cov_41.163618	404	484	13	2	80	0.0250000
NODE_5259_length_1083_cov_41.163618	404	484	14	13	80	0.1625000
NODE_5259_length_1083_cov_41.163618	404	484	15	55	80	0.6875000
NODE_5259_length_1083_cov_41.163618	457	537	7	4	80	0.0500000
NODE_5259_length_1083_cov_41.163618	457	537	8	16	80	0.2000000
NODE_5259_length_1083_cov_41.163618	457	537	11	8	80	0.1000000
NODE_5259_length_1083_cov_41.163618	457	537	12	2	80	0.0250000
NODE_5259_length_1083_cov_41.163618	457	537	13	23	80	0.2875000
NODE_5259_length_1083_cov_41.163618	457	537	14	3	80	0.0375000
NODE_5259_length_1083_cov_41.163618	457	537	15	24	80	0.3000000
NODE_5260_length_1083_cov_39.798780	527	607	11	5	80	0.0625000
NODE_5260_length_1083_cov_39.798780	527	607	12	11	80	0.1375000
NODE_5260_length_1083_cov_39.798780	527	607	13	19	80	0.2375000
NODE_5260_length_1083_cov_39.798780	527	607	14	9	80	0.1125000
NODE_5260_length_1083_cov_39.798780	527	607	15	30	80	0.3750000
NODE_5260_length_1083_cov_39.798780	527	607	16	6	80	0.0750000
NODE_5260_length_1083_cov_39.798780	580	660	12	45	80	0.5625000
NODE_5260_length_1083_cov_39.798780	580	660	13	13	80	0.1625000
NODE_5260_length_1083_cov_39.798780	580	660	14	4	80	0.0500000
NODE_5260_length_1083_cov_39.798780	580	660	15	4	80	0.0500000
NODE_5260_length_1083_cov_39.798780	580	660	16	14	80	0.1750000
NODE_5261_length_1083_cov_34.261179	475	555	14	2	80	0.0250000
NODE_5261_length_1083_cov_34.261179	475	555	15	4	80	0.0500000
NODE_5261_length_1083_cov_34.261179	475	555	20	2	80	0.0250000
NODE_5261_length_1083_cov_34.261179	475	555	23	20	80	0.2500000
NODE_5261_length_1083_cov_34.261179	475	555	24	22	80	0.2750000
NODE_5261_length_1083_cov_34.261179	475	555	25	10	80	0.1250000
NODE_5261_length_1083_cov_34.261179	475	555	26	5	80	0.0625000
NODE_5261_length_1083_cov_34.261179	475	555	27	2	80	0.0250000
NODE_5261_length_1083_cov_34.261179	475	555	28	13	80	0.1625000
NODE_5261_length_1083_cov_34.261179	528	608	19	16	80	0.2000000
NODE_5261_length_1083_cov_34.261179	528	608	20	1	80	0.0125000
NODE_5261_length_1083_cov_34.261179	528	608	21	1	80	0.0125000
NODE_5261_length_1083_cov_34.261179	528	608	22	3	80	0.0375000
NODE_5261_length_1083_cov_34.261179	528	608	24	20	80	0.2500000
NODE_5261_length_1083_cov_34.261179	528	608	25	7	80	0.0875000
NODE_5261_length_1083_cov_34.261179	528	608	26	5	80	0.0625000
NODE_5261_length_1083_cov_34.261179	528	608	27	14	80	0.1750000
NODE_5261_length_1083_cov_34.261179	528	608	28	13	80	0.1625000
NODE_5262_length_1083_cov_33.573171	486	566	1	31	80	0.3875000
NODE_5262_length_1083_cov_33.573171	486	566	3	2	80	0.0250000
NODE_5262_length_1083_cov_33.573171	486	566	5	7	80	0.0875000
NODE_5262_length_1083_cov_33.573171	486	566	7	1	80	0.0125000
NODE_5262_length_1083_cov_33.573171	486	566	8	39	80	0.4875000
NODE_5262_length_1083_cov_33.573171	539	619	8	40	80	0.5000000
NODE_5262_length_1083_cov_33.573171	539	619	9	19	80	0.2375000
NODE_5262_length_1083_cov_33.573171	539	619	10	1	80	0.0125000
NODE_5262_length_1083_cov_33.573171	539	619	11	20	80	0.2500000
NODE_5262_length_1083_cov_33.573171	615	695	6	18	80	0.2250000
NODE_5262_length_1083_cov_33.573171	615	695	7	1	80	0.0125000
NODE_5262_length_1083_cov_33.573171	615	695	9	18	80	0.2250000
NODE_5262_length_1083_cov_33.573171	615	695	11	43	80	0.5375000
NODE_5262_length_1083_cov_33.573171	668	748	5	19	80	0.2375000
NODE_5262_length_1083_cov_33.573171	668	748	6	52	80	0.6500000
NODE_5262_length_1083_cov_33.573171	668	748	7	1	80	0.0125000
NODE_5262_length_1083_cov_33.573171	668	748	9	8	80	0.1000000
NODE_5263_length_1083_cov_33.091463	452	532	12	12	80	0.1500000
NODE_5263_length_1083_cov_33.091463	452	532	13	8	80	0.1000000
NODE_5263_length_1083_cov_33.091463	452	532	14	16	80	0.2000000
NODE_5263_length_1083_cov_33.091463	452	532	15	7	80	0.0875000
NODE_5263_length_1083_cov_33.091463	452	532	16	1	80	0.0125000
NODE_5263_length_1083_cov_33.091463	452	532	17	29	80	0.3625000
NODE_5263_length_1083_cov_33.091463	452	532	18	5	80	0.0625000
NODE_5263_length_1083_cov_33.091463	452	532	19	2	80	0.0250000
NODE_5263_length_1083_cov_33.091463	505	585	10	29	80	0.3625000
NODE_5263_length_1083_cov_33.091463	505	585	12	20	80	0.2500000
NODE_5263_length_1083_cov_33.091463	505	585	13	12	80	0.1500000
NODE_5263_length_1083_cov_33.091463	505	585	14	6	80	0.0750000
NODE_5263_length_1083_cov_33.091463	505	585	15	13	80	0.1625000
NODE_5264_length_1083_cov_30.982724	550	630	7	8	80	0.1000000
NODE_5264_length_1083_cov_30.982724	550	630	8	25	80	0.3125000
NODE_5264_length_1083_cov_30.982724	550	630	9	3	80	0.0375000
NODE_5264_length_1083_cov_30.982724	550	630	10	9	80	0.1125000
NODE_5264_length_1083_cov_30.982724	550	630	11	18	80	0.2250000
NODE_5264_length_1083_cov_30.982724	550	630	12	6	80	0.0750000
NODE_5264_length_1083_cov_30.982724	550	630	13	11	80	0.1375000
NODE_5264_length_1083_cov_30.982724	603	683	4	40	80	0.5000000
NODE_5264_length_1083_cov_30.982724	603	683	5	3	80	0.0375000
NODE_5264_length_1083_cov_30.982724	603	683	6	5	80	0.0625000
NODE_5264_length_1083_cov_30.982724	603	683	7	13	80	0.1625000
NODE_5264_length_1083_cov_30.982724	603	683	8	19	80	0.2375000
NODE_5265_length_1083_cov_18.819106	586	666	4	80	80	1.0000000
NODE_5265_length_1083_cov_18.819106	639	719	1	2	80	0.0250000
NODE_5265_length_1083_cov_18.819106	639	719	2	28	80	0.3500000
NODE_5265_length_1083_cov_18.819106	639	719	4	50	80	0.6250000
NODE_5266_length_1083_cov_17.278455	408	488	2	53	80	0.6625000
NODE_5266_length_1083_cov_17.278455	408	488	3	27	80	0.3375000
NODE_5266_length_1083_cov_17.278455	461	541	2	75	80	0.9375000
NODE_5266_length_1083_cov_17.278455	461	541	3	5	80	0.0625000
NODE_5267_length_1083_cov_13.862805	481	561	0	58	80	0.7250000
NODE_5267_length_1083_cov_13.862805	481	561	1	22	80	0.2750000
NODE_5267_length_1083_cov_13.862805	534	614	0	5	80	0.0625000
NODE_5267_length_1083_cov_13.862805	534	614	1	57	80	0.7125000
NODE_5267_length_1083_cov_13.862805	534	614	2	18	80	0.2250000
NODE_5268_length_1083_cov_13.083333	522	602	10	2	80	0.0250000
NODE_5268_length_1083_cov_13.083333	522	602	12	27	80	0.3375000
NODE_5268_length_1083_cov_13.083333	522	602	15	25	80	0.3125000
NODE_5268_length_1083_cov_13.083333	522	602	16	2	80	0.0250000
NODE_5268_length_1083_cov_13.083333	522	602	17	12	80	0.1500000
NODE_5268_length_1083_cov_13.083333	522	602	18	1	80	0.0125000
NODE_5268_length_1083_cov_13.083333	522	602	19	11	80	0.1375000
NODE_5268_length_1083_cov_13.083333	575	655	15	13	80	0.1625000
NODE_5268_length_1083_cov_13.083333	575	655	17	12	80	0.1500000
NODE_5268_length_1083_cov_13.083333	575	655	18	13	80	0.1625000
NODE_5268_length_1083_cov_13.083333	575	655	19	12	80	0.1500000
NODE_5268_length_1083_cov_13.083333	575	655	20	22	80	0.2750000
NODE_5268_length_1083_cov_13.083333	575	655	21	8	80	0.1000000
NODE_5269_length_1083_cov_11.824187	242	322	2	21	80	0.2625000
NODE_5269_length_1083_cov_11.824187	242	322	4	59	80	0.7375000
NODE_5269_length_1083_cov_11.824187	295	375	4	80	80	1.0000000
NODE_5271_length_1083_cov_3.025407	359	439	2	5	80	0.0625000
NODE_5271_length_1083_cov_3.025407	359	439	3	10	80	0.1250000
NODE_5271_length_1083_cov_3.025407	359	439	4	3	80	0.0375000
NODE_5271_length_1083_cov_3.025407	359	439	5	27	80	0.3375000
NODE_5271_length_1083_cov_3.025407	359	439	6	35	80	0.4375000
NODE_5271_length_1083_cov_3.025407	412	489	4	45	77	0.5844156
NODE_5271_length_1083_cov_3.025407	412	489	5	32	77	0.4155844
NODE_5277_length_1082_cov_34.664293	461	541	8	4	80	0.0500000
NODE_5277_length_1082_cov_34.664293	461	541	9	6	80	0.0750000
NODE_5277_length_1082_cov_34.664293	461	541	12	2	80	0.0250000
NODE_5277_length_1082_cov_34.664293	461	541	13	14	80	0.1750000
NODE_5277_length_1082_cov_34.664293	461	541	14	54	80	0.6750000
NODE_5277_length_1082_cov_34.664293	514	594	10	6	80	0.0750000
NODE_5277_length_1082_cov_34.664293	514	594	11	9	80	0.1125000
NODE_5277_length_1082_cov_34.664293	514	594	12	10	80	0.1250000
NODE_5277_length_1082_cov_34.664293	514	594	13	7	80	0.0875000
NODE_5277_length_1082_cov_34.664293	514	594	14	48	80	0.6000000
NODE_5278_length_1082_cov_17.422177	406	486	0	8	80	0.1000000
NODE_5278_length_1082_cov_17.422177	406	486	2	72	80	0.9000000
NODE_5278_length_1082_cov_17.422177	459	539	2	29	80	0.3625000
NODE_5278_length_1082_cov_17.422177	459	539	3	51	80	0.6375000
NODE_5279_length_1082_cov_15.906409	442	522	8	2	80	0.0250000
NODE_5279_length_1082_cov_15.906409	442	522	9	8	80	0.1000000
NODE_5279_length_1082_cov_15.906409	442	522	11	3	80	0.0375000
NODE_5279_length_1082_cov_15.906409	442	522	12	5	80	0.0625000
NODE_5279_length_1082_cov_15.906409	442	522	13	4	80	0.0500000
NODE_5279_length_1082_cov_15.906409	442	522	14	45	80	0.5625000
NODE_5279_length_1082_cov_15.906409	442	522	15	13	80	0.1625000
NODE_5279_length_1082_cov_15.906409	495	575	12	17	80	0.2125000
NODE_5279_length_1082_cov_15.906409	495	575	14	37	80	0.4625000
NODE_5279_length_1082_cov_15.906409	495	575	15	14	80	0.1750000
NODE_5279_length_1082_cov_15.906409	495	575	16	9	80	0.1125000
NODE_5279_length_1082_cov_15.906409	495	575	17	3	80	0.0375000
NODE_5280_length_1082_cov_13.703967	324	404	2	5	80	0.0625000
NODE_5280_length_1082_cov_13.703967	324	404	3	4	80	0.0500000
NODE_5280_length_1082_cov_13.703967	324	404	6	4	80	0.0500000
NODE_5280_length_1082_cov_13.703967	324	404	7	65	80	0.8125000
NODE_5280_length_1082_cov_13.703967	324	404	8	2	80	0.0250000
NODE_5280_length_1082_cov_13.703967	377	457	2	58	80	0.7250000
NODE_5280_length_1082_cov_13.703967	377	457	3	4	80	0.0500000
NODE_5280_length_1082_cov_13.703967	377	457	7	18	80	0.2250000
NODE_5281_length_1082_cov_6.478128	159	205	0	46	46	1.0000000
NODE_5281_length_1082_cov_6.478128	203	283	0	80	80	1.0000000
NODE_5281_length_1082_cov_6.478128	256	336	0	80	80	1.0000000
NODE_5281_length_1082_cov_6.478128	861	941	0	80	80	1.0000000
NODE_5282_length_1082_cov_4.218718	982	1062	8	12	80	0.1500000
NODE_5282_length_1082_cov_4.218718	982	1062	9	5	80	0.0625000
NODE_5282_length_1082_cov_4.218718	982	1062	11	39	80	0.4875000
NODE_5282_length_1082_cov_4.218718	982	1062	13	1	80	0.0125000
NODE_5282_length_1082_cov_4.218718	982	1062	14	23	80	0.2875000
NODE_5291_length_1081_cov_45.308554	510	590	10	5	80	0.0625000
NODE_5291_length_1081_cov_45.308554	510	590	12	9	80	0.1125000
NODE_5291_length_1081_cov_45.308554	510	590	13	5	80	0.0625000
NODE_5291_length_1081_cov_45.308554	510	590	14	10	80	0.1250000
NODE_5291_length_1081_cov_45.308554	510	590	15	37	80	0.4625000
NODE_5291_length_1081_cov_45.308554	510	590	16	14	80	0.1750000
NODE_5291_length_1081_cov_45.308554	563	643	8	46	80	0.5750000
NODE_5291_length_1081_cov_45.308554	563	643	9	7	80	0.0875000
NODE_5291_length_1081_cov_45.308554	563	643	10	5	80	0.0625000
NODE_5291_length_1081_cov_45.308554	563	643	13	4	80	0.0500000
NODE_5291_length_1081_cov_45.308554	563	643	14	10	80	0.1250000
NODE_5291_length_1081_cov_45.308554	563	643	15	7	80	0.0875000
NODE_5291_length_1081_cov_45.308554	563	643	16	1	80	0.0125000
NODE_5292_length_1081_cov_39.581466	476	556	12	10	80	0.1250000
NODE_5292_length_1081_cov_39.581466	476	556	13	2	80	0.0250000
NODE_5292_length_1081_cov_39.581466	476	556	14	13	80	0.1625000
NODE_5292_length_1081_cov_39.581466	476	556	15	17	80	0.2125000
NODE_5292_length_1081_cov_39.581466	476	556	16	4	80	0.0500000
NODE_5292_length_1081_cov_39.581466	476	556	17	17	80	0.2125000
NODE_5292_length_1081_cov_39.581466	476	556	18	17	80	0.2125000
NODE_5292_length_1081_cov_39.581466	529	609	14	17	80	0.2125000
NODE_5292_length_1081_cov_39.581466	529	609	15	24	80	0.3000000
NODE_5292_length_1081_cov_39.581466	529	609	16	19	80	0.2375000
NODE_5292_length_1081_cov_39.581466	529	609	18	20	80	0.2500000
NODE_5292_length_1081_cov_39.581466	605	685	9	9	80	0.1125000
NODE_5292_length_1081_cov_39.581466	605	685	10	9	80	0.1125000
NODE_5292_length_1081_cov_39.581466	605	685	11	5	80	0.0625000
NODE_5292_length_1081_cov_39.581466	605	685	12	18	80	0.2250000
NODE_5292_length_1081_cov_39.581466	605	685	13	13	80	0.1625000
NODE_5292_length_1081_cov_39.581466	605	685	14	15	80	0.1875000
NODE_5292_length_1081_cov_39.581466	605	685	15	11	80	0.1375000
NODE_5292_length_1081_cov_39.581466	658	738	4	1	80	0.0125000
NODE_5292_length_1081_cov_39.581466	658	738	7	16	80	0.2000000
NODE_5292_length_1081_cov_39.581466	658	738	8	3	80	0.0375000
NODE_5292_length_1081_cov_39.581466	658	738	9	42	80	0.5250000
NODE_5292_length_1081_cov_39.581466	658	738	10	9	80	0.1125000
NODE_5292_length_1081_cov_39.581466	658	738	12	3	80	0.0375000
NODE_5292_length_1081_cov_39.581466	658	738	13	6	80	0.0750000
NODE_5293_length_1081_cov_39.457230	373	453	16	3	80	0.0375000
NODE_5293_length_1081_cov_39.457230	373	453	18	7	80	0.0875000
NODE_5293_length_1081_cov_39.457230	373	453	19	12	80	0.1500000
NODE_5293_length_1081_cov_39.457230	373	453	21	5	80	0.0625000
NODE_5293_length_1081_cov_39.457230	373	453	22	9	80	0.1125000
NODE_5293_length_1081_cov_39.457230	373	453	23	2	80	0.0250000
NODE_5293_length_1081_cov_39.457230	373	453	26	1	80	0.0125000
NODE_5293_length_1081_cov_39.457230	373	453	27	15	80	0.1875000
NODE_5293_length_1081_cov_39.457230	373	453	28	10	80	0.1250000
NODE_5293_length_1081_cov_39.457230	373	453	29	12	80	0.1500000
NODE_5293_length_1081_cov_39.457230	373	453	30	1	80	0.0125000
NODE_5293_length_1081_cov_39.457230	373	453	31	1	80	0.0125000
NODE_5293_length_1081_cov_39.457230	373	453	32	2	80	0.0250000
NODE_5293_length_1081_cov_39.457230	426	506	22	10	80	0.1250000
NODE_5293_length_1081_cov_39.457230	426	506	23	7	80	0.0875000
NODE_5293_length_1081_cov_39.457230	426	506	25	2	80	0.0250000
NODE_5293_length_1081_cov_39.457230	426	506	27	22	80	0.2750000
NODE_5293_length_1081_cov_39.457230	426	506	28	4	80	0.0500000
NODE_5293_length_1081_cov_39.457230	426	506	29	16	80	0.2000000
NODE_5293_length_1081_cov_39.457230	426	506	30	12	80	0.1500000
NODE_5293_length_1081_cov_39.457230	426	506	31	5	80	0.0625000
NODE_5293_length_1081_cov_39.457230	426	506	32	2	80	0.0250000
NODE_5294_length_1081_cov_20.415479	376	451	0	75	75	1.0000000
NODE_5294_length_1081_cov_20.415479	436	511	0	75	75	1.0000000
NODE_5294_length_1081_cov_20.415479	496	571	0	68	75	0.9066667
NODE_5294_length_1081_cov_20.415479	496	571	1	7	75	0.0933333
NODE_5294_length_1081_cov_20.415479	544	624	0	20	80	0.2500000
NODE_5294_length_1081_cov_20.415479	544	624	1	19	80	0.2375000
NODE_5294_length_1081_cov_20.415479	544	624	2	41	80	0.5125000
NODE_5295_length_1081_cov_19.985743	378	458	4	48	80	0.6000000
NODE_5295_length_1081_cov_19.985743	378	458	5	5	80	0.0625000
NODE_5295_length_1081_cov_19.985743	378	458	6	9	80	0.1125000
NODE_5295_length_1081_cov_19.985743	378	458	7	18	80	0.2250000
NODE_5295_length_1081_cov_19.985743	431	511	4	10	80	0.1250000
NODE_5295_length_1081_cov_19.985743	431	511	5	16	80	0.2000000
NODE_5295_length_1081_cov_19.985743	431	511	6	9	80	0.1125000
NODE_5295_length_1081_cov_19.985743	431	511	7	45	80	0.5625000
NODE_5295_length_1081_cov_19.985743	507	587	4	8	80	0.1000000
NODE_5295_length_1081_cov_19.985743	507	587	6	5	80	0.0625000
NODE_5295_length_1081_cov_19.985743	507	587	7	16	80	0.2000000
NODE_5295_length_1081_cov_19.985743	507	587	8	6	80	0.0750000
NODE_5295_length_1081_cov_19.985743	507	587	9	5	80	0.0625000
NODE_5295_length_1081_cov_19.985743	507	587	10	40	80	0.5000000
NODE_5295_length_1081_cov_19.985743	560	640	4	4	80	0.0500000
NODE_5295_length_1081_cov_19.985743	560	640	6	1	80	0.0125000
NODE_5295_length_1081_cov_19.985743	560	640	7	45	80	0.5625000
NODE_5295_length_1081_cov_19.985743	560	640	8	9	80	0.1125000
NODE_5295_length_1081_cov_19.985743	560	640	9	5	80	0.0625000
NODE_5295_length_1081_cov_19.985743	560	640	10	16	80	0.2000000
NODE_5296_length_1081_cov_12.658859	468	548	5	5	80	0.0625000
NODE_5296_length_1081_cov_12.658859	468	548	7	34	80	0.4250000
NODE_5296_length_1081_cov_12.658859	468	548	8	6	80	0.0750000
NODE_5296_length_1081_cov_12.658859	468	548	9	35	80	0.4375000
NODE_5296_length_1081_cov_12.658859	521	601	5	23	80	0.2875000
NODE_5296_length_1081_cov_12.658859	521	601	6	6	80	0.0750000
NODE_5296_length_1081_cov_12.658859	521	601	7	21	80	0.2625000
NODE_5296_length_1081_cov_12.658859	521	601	8	30	80	0.3750000
NODE_5299_length_1081_cov_2.586558	7	44	0	37	37	1.0000000
NODE_5304_length_1080_cov_27.857288	261	341	3	29	80	0.3625000
NODE_5304_length_1080_cov_27.857288	261	341	4	13	80	0.1625000
NODE_5304_length_1080_cov_27.857288	261	341	5	38	80	0.4750000
NODE_5304_length_1080_cov_27.857288	314	394	2	13	80	0.1625000
NODE_5304_length_1080_cov_27.857288	314	394	3	15	80	0.1875000
NODE_5304_length_1080_cov_27.857288	314	394	4	52	80	0.6500000
NODE_5305_length_1080_cov_24.258919	321	401	6	36	80	0.4500000
NODE_5305_length_1080_cov_24.258919	321	401	7	4	80	0.0500000
NODE_5305_length_1080_cov_24.258919	321	401	11	7	80	0.0875000
NODE_5305_length_1080_cov_24.258919	321	401	13	8	80	0.1000000
NODE_5305_length_1080_cov_24.258919	321	401	14	16	80	0.2000000
NODE_5305_length_1080_cov_24.258919	321	401	15	9	80	0.1125000
NODE_5305_length_1080_cov_24.258919	374	454	13	13	80	0.1625000
NODE_5305_length_1080_cov_24.258919	374	454	14	33	80	0.4125000
NODE_5305_length_1080_cov_24.258919	374	454	15	27	80	0.3375000
NODE_5305_length_1080_cov_24.258919	374	454	16	7	80	0.0875000
NODE_5305_length_1080_cov_24.258919	450	530	4	2	80	0.0250000
NODE_5305_length_1080_cov_24.258919	450	530	5	8	80	0.1000000
NODE_5305_length_1080_cov_24.258919	450	530	7	7	80	0.0875000
NODE_5305_length_1080_cov_24.258919	450	530	8	2	80	0.0250000
NODE_5305_length_1080_cov_24.258919	450	530	11	4	80	0.0500000
NODE_5305_length_1080_cov_24.258919	450	530	12	49	80	0.6125000
NODE_5305_length_1080_cov_24.258919	450	530	14	8	80	0.1000000
NODE_5305_length_1080_cov_24.258919	503	583	4	2	80	0.0250000
NODE_5305_length_1080_cov_24.258919	503	583	5	20	80	0.2500000
NODE_5305_length_1080_cov_24.258919	503	583	6	16	80	0.2000000
NODE_5305_length_1080_cov_24.258919	503	583	7	20	80	0.2500000
NODE_5305_length_1080_cov_24.258919	503	583	8	14	80	0.1750000
NODE_5305_length_1080_cov_24.258919	503	583	11	4	80	0.0500000
NODE_5305_length_1080_cov_24.258919	503	583	12	4	80	0.0500000
NODE_5306_length_1080_cov_22.589195	446	526	3	1	80	0.0125000
NODE_5306_length_1080_cov_22.589195	446	526	4	6	80	0.0750000
NODE_5306_length_1080_cov_22.589195	446	526	5	3	80	0.0375000
NODE_5306_length_1080_cov_22.589195	446	526	7	22	80	0.2750000
NODE_5306_length_1080_cov_22.589195	446	526	8	17	80	0.2125000
NODE_5306_length_1080_cov_22.589195	446	526	9	19	80	0.2375000
NODE_5306_length_1080_cov_22.589195	446	526	10	12	80	0.1500000
NODE_5306_length_1080_cov_22.589195	499	579	8	17	80	0.2125000
NODE_5306_length_1080_cov_22.589195	499	579	9	35	80	0.4375000
NODE_5306_length_1080_cov_22.589195	499	579	10	28	80	0.3500000
NODE_5306_length_1080_cov_22.589195	575	655	2	13	80	0.1625000
NODE_5306_length_1080_cov_22.589195	575	655	3	14	80	0.1750000
NODE_5306_length_1080_cov_22.589195	575	655	5	22	80	0.2750000
NODE_5306_length_1080_cov_22.589195	575	655	7	3	80	0.0375000
NODE_5306_length_1080_cov_22.589195	575	655	8	6	80	0.0750000
NODE_5306_length_1080_cov_22.589195	575	655	9	22	80	0.2750000
NODE_5306_length_1080_cov_22.589195	628	708	1	11	80	0.1375000
NODE_5306_length_1080_cov_22.589195	628	708	2	49	80	0.6125000
NODE_5306_length_1080_cov_22.589195	628	708	3	20	80	0.2500000
NODE_5307_length_1080_cov_15.544343	599	679	2	60	80	0.7500000
NODE_5307_length_1080_cov_15.544343	599	679	3	17	80	0.2125000
NODE_5307_length_1080_cov_15.544343	599	679	4	3	80	0.0375000
NODE_5307_length_1080_cov_15.544343	652	732	2	7	80	0.0875000
NODE_5307_length_1080_cov_15.544343	652	732	3	17	80	0.2125000
NODE_5307_length_1080_cov_15.544343	652	732	4	56	80	0.7000000
NODE_5308_length_1080_cov_10.416922	321	401	1	78	80	0.9750000
NODE_5308_length_1080_cov_10.416922	321	401	2	2	80	0.0250000
NODE_5308_length_1080_cov_10.416922	374	454	1	65	80	0.8125000
NODE_5308_length_1080_cov_10.416922	374	454	2	15	80	0.1875000
NODE_5315_length_1079_cov_55.352041	367	447	8	7	80	0.0875000
NODE_5315_length_1079_cov_55.352041	367	447	9	4	80	0.0500000
NODE_5315_length_1079_cov_55.352041	367	447	10	47	80	0.5875000
NODE_5315_length_1079_cov_55.352041	367	447	11	5	80	0.0625000
NODE_5315_length_1079_cov_55.352041	367	447	12	8	80	0.1000000
NODE_5315_length_1079_cov_55.352041	367	447	15	4	80	0.0500000
NODE_5315_length_1079_cov_55.352041	367	447	17	1	80	0.0125000
NODE_5315_length_1079_cov_55.352041	367	447	22	3	80	0.0375000
NODE_5315_length_1079_cov_55.352041	367	447	23	1	80	0.0125000
NODE_5315_length_1079_cov_55.352041	420	500	10	5	80	0.0625000
NODE_5315_length_1079_cov_55.352041	420	500	11	5	80	0.0625000
NODE_5315_length_1079_cov_55.352041	420	500	12	8	80	0.1000000
NODE_5315_length_1079_cov_55.352041	420	500	15	4	80	0.0500000
NODE_5315_length_1079_cov_55.352041	420	500	17	1	80	0.0125000
NODE_5315_length_1079_cov_55.352041	420	500	22	3	80	0.0375000
NODE_5315_length_1079_cov_55.352041	420	500	23	17	80	0.2125000
NODE_5315_length_1079_cov_55.352041	420	500	25	7	80	0.0875000
NODE_5315_length_1079_cov_55.352041	420	500	27	16	80	0.2000000
NODE_5315_length_1079_cov_55.352041	420	500	28	1	80	0.0125000
NODE_5315_length_1079_cov_55.352041	420	500	29	13	80	0.1625000
NODE_5315_length_1079_cov_55.352041	496	576	29	10	80	0.1250000
NODE_5315_length_1079_cov_55.352041	496	576	30	9	80	0.1125000
NODE_5315_length_1079_cov_55.352041	496	576	31	13	80	0.1625000
NODE_5315_length_1079_cov_55.352041	496	576	32	4	80	0.0500000
NODE_5315_length_1079_cov_55.352041	496	576	33	11	80	0.1375000
NODE_5315_length_1079_cov_55.352041	496	576	34	5	80	0.0625000
NODE_5315_length_1079_cov_55.352041	496	576	35	6	80	0.0750000
NODE_5315_length_1079_cov_55.352041	496	576	36	4	80	0.0500000
NODE_5315_length_1079_cov_55.352041	496	576	39	1	80	0.0125000
NODE_5315_length_1079_cov_55.352041	496	576	40	2	80	0.0250000
NODE_5315_length_1079_cov_55.352041	496	576	41	8	80	0.1000000
NODE_5315_length_1079_cov_55.352041	496	576	43	2	80	0.0250000
NODE_5315_length_1079_cov_55.352041	496	576	44	1	80	0.0125000
NODE_5315_length_1079_cov_55.352041	496	576	46	1	80	0.0125000
NODE_5315_length_1079_cov_55.352041	496	576	47	3	80	0.0375000
NODE_5315_length_1079_cov_55.352041	549	629	34	14	80	0.1750000
NODE_5315_length_1079_cov_55.352041	549	629	35	7	80	0.0875000
NODE_5315_length_1079_cov_55.352041	549	629	36	8	80	0.1000000
NODE_5315_length_1079_cov_55.352041	549	629	37	1	80	0.0125000
NODE_5315_length_1079_cov_55.352041	549	629	38	15	80	0.1875000
NODE_5315_length_1079_cov_55.352041	549	629	39	1	80	0.0125000
NODE_5315_length_1079_cov_55.352041	549	629	40	3	80	0.0375000
NODE_5315_length_1079_cov_55.352041	549	629	41	8	80	0.1000000
NODE_5315_length_1079_cov_55.352041	549	629	42	4	80	0.0500000
NODE_5315_length_1079_cov_55.352041	549	629	43	2	80	0.0250000
NODE_5315_length_1079_cov_55.352041	549	629	44	2	80	0.0250000
NODE_5315_length_1079_cov_55.352041	549	629	45	7	80	0.0875000
NODE_5315_length_1079_cov_55.352041	549	629	46	5	80	0.0625000
NODE_5315_length_1079_cov_55.352041	549	629	47	3	80	0.0375000
NODE_5316_length_1079_cov_46.879592	444	524	13	2	80	0.0250000
NODE_5316_length_1079_cov_46.879592	444	524	15	7	80	0.0875000
NODE_5316_length_1079_cov_46.879592	444	524	16	7	80	0.0875000
NODE_5316_length_1079_cov_46.879592	444	524	17	1	80	0.0125000
NODE_5316_length_1079_cov_46.879592	444	524	18	6	80	0.0750000
NODE_5316_length_1079_cov_46.879592	444	524	21	4	80	0.0500000
NODE_5316_length_1079_cov_46.879592	444	524	22	22	80	0.2750000
NODE_5316_length_1079_cov_46.879592	444	524	23	18	80	0.2250000
NODE_5316_length_1079_cov_46.879592	444	524	24	9	80	0.1125000
NODE_5316_length_1079_cov_46.879592	444	524	26	4	80	0.0500000
NODE_5316_length_1079_cov_46.879592	497	577	22	3	80	0.0375000
NODE_5316_length_1079_cov_46.879592	497	577	23	11	80	0.1375000
NODE_5316_length_1079_cov_46.879592	497	577	24	9	80	0.1125000
NODE_5316_length_1079_cov_46.879592	497	577	26	6	80	0.0750000
NODE_5316_length_1079_cov_46.879592	497	577	27	2	80	0.0250000
NODE_5316_length_1079_cov_46.879592	497	577	28	10	80	0.1250000
NODE_5316_length_1079_cov_46.879592	497	577	29	9	80	0.1125000
NODE_5316_length_1079_cov_46.879592	497	577	30	15	80	0.1875000
NODE_5316_length_1079_cov_46.879592	497	577	31	14	80	0.1750000
NODE_5316_length_1079_cov_46.879592	497	577	32	1	80	0.0125000
NODE_5316_length_1079_cov_46.879592	573	652	23	2	79	0.0253165
NODE_5316_length_1079_cov_46.879592	573	652	24	3	79	0.0379747
NODE_5316_length_1079_cov_46.879592	573	652	25	6	79	0.0759494
NODE_5316_length_1079_cov_46.879592	573	652	26	6	79	0.0759494
NODE_5316_length_1079_cov_46.879592	573	652	27	1	79	0.0126582
NODE_5316_length_1079_cov_46.879592	573	652	28	6	79	0.0759494
NODE_5316_length_1079_cov_46.879592	573	652	30	21	79	0.2658228
NODE_5316_length_1079_cov_46.879592	573	652	31	19	79	0.2405063
NODE_5316_length_1079_cov_46.879592	573	652	32	5	79	0.0632911
NODE_5316_length_1079_cov_46.879592	573	652	33	6	79	0.0759494
NODE_5316_length_1079_cov_46.879592	573	652	34	4	79	0.0506329
NODE_5316_length_1079_cov_46.879592	625	703	21	16	78	0.2051282
NODE_5316_length_1079_cov_46.879592	625	703	23	4	78	0.0512821
NODE_5316_length_1079_cov_46.879592	625	703	24	1	78	0.0128205
NODE_5316_length_1079_cov_46.879592	625	703	25	4	78	0.0512821
NODE_5316_length_1079_cov_46.879592	625	703	26	4	78	0.0512821
NODE_5316_length_1079_cov_46.879592	625	703	27	8	78	0.1025641
NODE_5316_length_1079_cov_46.879592	625	703	28	12	78	0.1538462
NODE_5316_length_1079_cov_46.879592	625	703	30	15	78	0.1923077
NODE_5316_length_1079_cov_46.879592	625	703	31	3	78	0.0384615
NODE_5316_length_1079_cov_46.879592	625	703	32	1	78	0.0128205
NODE_5316_length_1079_cov_46.879592	625	703	33	5	78	0.0641026
NODE_5316_length_1079_cov_46.879592	625	703	34	5	78	0.0641026
NODE_5317_length_1079_cov_13.708163	611	691	2	12	80	0.1500000
NODE_5317_length_1079_cov_13.708163	611	691	3	18	80	0.2250000
NODE_5317_length_1079_cov_13.708163	611	691	4	27	80	0.3375000
NODE_5317_length_1079_cov_13.708163	611	691	5	16	80	0.2000000
NODE_5317_length_1079_cov_13.708163	611	691	6	7	80	0.0875000
NODE_5317_length_1079_cov_13.708163	664	744	4	21	80	0.2625000
NODE_5317_length_1079_cov_13.708163	664	744	5	16	80	0.2000000
NODE_5317_length_1079_cov_13.708163	664	744	6	43	80	0.5375000
NODE_5318_length_1079_cov_8.632653	416	496	0	80	80	1.0000000
NODE_5318_length_1079_cov_8.632653	469	549	0	80	80	1.0000000
NODE_5325_length_1078_cov_27.804903	357	437	3	4	80	0.0500000
NODE_5325_length_1078_cov_27.804903	357	437	5	44	80	0.5500000
NODE_5325_length_1078_cov_27.804903	357	437	6	3	80	0.0375000
NODE_5325_length_1078_cov_27.804903	357	437	7	16	80	0.2000000
NODE_5325_length_1078_cov_27.804903	357	437	8	13	80	0.1625000
NODE_5325_length_1078_cov_27.804903	410	490	7	14	80	0.1750000
NODE_5325_length_1078_cov_27.804903	410	490	8	36	80	0.4500000
NODE_5325_length_1078_cov_27.804903	410	490	9	4	80	0.0500000
NODE_5325_length_1078_cov_27.804903	410	490	10	10	80	0.1250000
NODE_5325_length_1078_cov_27.804903	410	490	11	1	80	0.0125000
NODE_5325_length_1078_cov_27.804903	410	490	12	15	80	0.1875000
NODE_5326_length_1078_cov_26.071502	459	539	6	34	80	0.4250000
NODE_5326_length_1078_cov_26.071502	459	539	7	24	80	0.3000000
NODE_5326_length_1078_cov_26.071502	459	539	8	10	80	0.1250000
NODE_5326_length_1078_cov_26.071502	459	539	9	12	80	0.1500000
NODE_5326_length_1078_cov_26.071502	512	592	6	10	80	0.1250000
NODE_5326_length_1078_cov_26.071502	512	592	7	28	80	0.3500000
NODE_5326_length_1078_cov_26.071502	512	592	8	13	80	0.1625000
NODE_5326_length_1078_cov_26.071502	512	592	9	29	80	0.3625000
NODE_5326_length_1078_cov_26.071502	588	668	5	12	80	0.1500000
NODE_5326_length_1078_cov_26.071502	588	668	6	10	80	0.1250000
NODE_5326_length_1078_cov_26.071502	588	668	7	22	80	0.2750000
NODE_5326_length_1078_cov_26.071502	588	668	8	28	80	0.3500000
NODE_5326_length_1078_cov_26.071502	588	668	9	8	80	0.1000000
NODE_5326_length_1078_cov_26.071502	641	718	5	3	77	0.0389610
NODE_5326_length_1078_cov_26.071502	641	718	6	38	77	0.4935065
NODE_5326_length_1078_cov_26.071502	641	718	7	31	77	0.4025974
NODE_5326_length_1078_cov_26.071502	641	718	8	5	77	0.0649351
NODE_5327_length_1078_cov_14.985700	495	575	10	80	80	1.0000000
NODE_5327_length_1078_cov_14.985700	548	628	9	14	80	0.1750000
NODE_5327_length_1078_cov_14.985700	548	628	10	52	80	0.6500000
NODE_5327_length_1078_cov_14.985700	548	628	11	1	80	0.0125000
NODE_5327_length_1078_cov_14.985700	548	628	12	13	80	0.1625000
NODE_5333_length_1077_cov_23.876278	546	626	2	22	80	0.2750000
NODE_5333_length_1077_cov_23.876278	546	626	3	11	80	0.1375000
NODE_5333_length_1077_cov_23.876278	546	626	4	5	80	0.0625000
NODE_5333_length_1077_cov_23.876278	546	626	5	26	80	0.3250000
NODE_5333_length_1077_cov_23.876278	546	626	6	16	80	0.2000000
NODE_5333_length_1077_cov_23.876278	599	679	4	23	80	0.2875000
NODE_5333_length_1077_cov_23.876278	599	679	5	45	80	0.5625000
NODE_5333_length_1077_cov_23.876278	599	679	6	12	80	0.1500000
NODE_5334_length_1077_cov_16.067485	532	612	5	14	80	0.1750000
NODE_5334_length_1077_cov_16.067485	532	612	6	12	80	0.1500000
NODE_5334_length_1077_cov_16.067485	532	612	7	3	80	0.0375000
NODE_5334_length_1077_cov_16.067485	532	612	8	22	80	0.2750000
NODE_5334_length_1077_cov_16.067485	532	612	9	29	80	0.3625000
NODE_5334_length_1077_cov_16.067485	585	665	0	1	80	0.0125000
NODE_5334_length_1077_cov_16.067485	585	665	2	24	80	0.3000000
NODE_5334_length_1077_cov_16.067485	585	665	3	7	80	0.0875000
NODE_5334_length_1077_cov_16.067485	585	665	5	35	80	0.4375000
NODE_5334_length_1077_cov_16.067485	585	665	6	12	80	0.1500000
NODE_5334_length_1077_cov_16.067485	585	665	8	1	80	0.0125000
NODE_5335_length_1077_cov_14.568507	556	636	8	17	80	0.2125000
NODE_5335_length_1077_cov_14.568507	556	636	9	10	80	0.1250000
NODE_5335_length_1077_cov_14.568507	556	636	10	51	80	0.6375000
NODE_5335_length_1077_cov_14.568507	556	636	13	2	80	0.0250000
NODE_5335_length_1077_cov_14.568507	609	689	8	53	80	0.6625000
NODE_5335_length_1077_cov_14.568507	609	689	10	25	80	0.3125000
NODE_5335_length_1077_cov_14.568507	609	689	13	2	80	0.0250000
NODE_5336_length_1077_cov_9.507157	496	576	11	10	80	0.1250000
NODE_5336_length_1077_cov_9.507157	496	576	12	1	80	0.0125000
NODE_5336_length_1077_cov_9.507157	496	576	13	29	80	0.3625000
NODE_5336_length_1077_cov_9.507157	496	576	14	40	80	0.5000000
NODE_5336_length_1077_cov_9.507157	549	629	4	22	80	0.2750000
NODE_5336_length_1077_cov_9.507157	549	629	6	5	80	0.0625000
NODE_5336_length_1077_cov_9.507157	549	629	8	4	80	0.0500000
NODE_5336_length_1077_cov_9.507157	549	629	9	2	80	0.0250000
NODE_5336_length_1077_cov_9.507157	549	629	10	12	80	0.1500000
NODE_5336_length_1077_cov_9.507157	549	629	11	17	80	0.2125000
NODE_5336_length_1077_cov_9.507157	549	629	12	1	80	0.0125000
NODE_5336_length_1077_cov_9.507157	549	629	13	10	80	0.1250000
NODE_5336_length_1077_cov_9.507157	549	629	14	7	80	0.0875000
NODE_5342_length_1077_cov_1.781186	252	274	0	22	22	1.0000000
NODE_5345_length_1076_cov_20.592631	534	614	3	14	80	0.1750000
NODE_5345_length_1076_cov_20.592631	534	614	4	25	80	0.3125000
NODE_5345_length_1076_cov_20.592631	534	614	5	28	80	0.3500000
NODE_5345_length_1076_cov_20.592631	534	614	6	13	80	0.1625000
NODE_5345_length_1076_cov_20.592631	587	667	4	52	80	0.6500000
NODE_5345_length_1076_cov_20.592631	587	667	5	12	80	0.1500000
NODE_5345_length_1076_cov_20.592631	587	667	6	16	80	0.2000000
NODE_5346_length_1076_cov_14.788127	427	507	2	21	80	0.2625000
NODE_5346_length_1076_cov_14.788127	427	507	3	59	80	0.7375000
NODE_5346_length_1076_cov_14.788127	480	560	3	43	80	0.5375000
NODE_5346_length_1076_cov_14.788127	480	560	5	37	80	0.4625000
NODE_5348_length_1076_cov_6.306039	883	961	0	34	78	0.4358974
NODE_5348_length_1076_cov_6.306039	883	961	2	44	78	0.5641026
NODE_5348_length_1076_cov_6.306039	936	1014	0	78	78	1.0000000
NODE_5357_length_1075_cov_37.941598	550	630	14	19	80	0.2375000
NODE_5357_length_1075_cov_37.941598	550	630	15	20	80	0.2500000
NODE_5357_length_1075_cov_37.941598	550	630	16	14	80	0.1750000
NODE_5357_length_1075_cov_37.941598	550	630	17	8	80	0.1000000
NODE_5357_length_1075_cov_37.941598	550	630	18	16	80	0.2000000
NODE_5357_length_1075_cov_37.941598	550	630	19	3	80	0.0375000
NODE_5357_length_1075_cov_37.941598	603	685	14	1	82	0.0121951
NODE_5357_length_1075_cov_37.941598	603	685	15	9	82	0.1097561
NODE_5357_length_1075_cov_37.941598	603	685	16	20	82	0.2439024
NODE_5357_length_1075_cov_37.941598	603	685	17	12	82	0.1463415
NODE_5357_length_1075_cov_37.941598	603	685	18	19	82	0.2317073
NODE_5357_length_1075_cov_37.941598	603	685	19	21	82	0.2560976
NODE_5357_length_1075_cov_37.941598	681	761	7	3	80	0.0375000
NODE_5357_length_1075_cov_37.941598	681	761	8	5	80	0.0625000
NODE_5357_length_1075_cov_37.941598	681	761	9	8	80	0.1000000
NODE_5357_length_1075_cov_37.941598	681	761	10	5	80	0.0625000
NODE_5357_length_1075_cov_37.941598	681	761	11	11	80	0.1375000
NODE_5357_length_1075_cov_37.941598	681	761	12	7	80	0.0875000
NODE_5357_length_1075_cov_37.941598	681	761	13	23	80	0.2875000
NODE_5357_length_1075_cov_37.941598	681	761	14	4	80	0.0500000
NODE_5357_length_1075_cov_37.941598	681	761	15	4	80	0.0500000
NODE_5357_length_1075_cov_37.941598	681	761	16	10	80	0.1250000
NODE_5357_length_1075_cov_37.941598	734	814	4	2	80	0.0250000
NODE_5357_length_1075_cov_37.941598	734	814	5	1	80	0.0125000
NODE_5357_length_1075_cov_37.941598	734	814	6	11	80	0.1375000
NODE_5357_length_1075_cov_37.941598	734	814	7	26	80	0.3250000
NODE_5357_length_1075_cov_37.941598	734	814	8	21	80	0.2625000
NODE_5357_length_1075_cov_37.941598	734	814	9	8	80	0.1000000
NODE_5357_length_1075_cov_37.941598	734	814	10	5	80	0.0625000
NODE_5357_length_1075_cov_37.941598	734	814	11	6	80	0.0750000
NODE_5358_length_1075_cov_32.224385	397	477	11	11	80	0.1375000
NODE_5358_length_1075_cov_32.224385	397	477	12	5	80	0.0625000
NODE_5358_length_1075_cov_32.224385	397	477	13	6	80	0.0750000
NODE_5358_length_1075_cov_32.224385	397	477	14	15	80	0.1875000
NODE_5358_length_1075_cov_32.224385	397	477	15	37	80	0.4625000
NODE_5358_length_1075_cov_32.224385	397	477	16	6	80	0.0750000
NODE_5358_length_1075_cov_32.224385	450	530	10	27	80	0.3375000
NODE_5358_length_1075_cov_32.224385	450	530	14	11	80	0.1375000
NODE_5358_length_1075_cov_32.224385	450	530	15	35	80	0.4375000
NODE_5358_length_1075_cov_32.224385	450	530	16	7	80	0.0875000
NODE_5359_length_1075_cov_9.626025	440	520	1	36	80	0.4500000
NODE_5359_length_1075_cov_9.626025	440	520	3	44	80	0.5500000
NODE_5359_length_1075_cov_9.626025	493	573	2	30	80	0.3750000
NODE_5359_length_1075_cov_9.626025	493	573	3	50	80	0.6250000
NODE_5362_length_1075_cov_2.926230	38	99	0	61	61	1.0000000
NODE_5372_length_1074_cov_19.034872	568	648	3	18	80	0.2250000
NODE_5372_length_1074_cov_19.034872	568	648	4	4	80	0.0500000
NODE_5372_length_1074_cov_19.034872	568	648	5	6	80	0.0750000
NODE_5372_length_1074_cov_19.034872	568	648	6	38	80	0.4750000
NODE_5372_length_1074_cov_19.034872	568	648	7	14	80	0.1750000
NODE_5372_length_1074_cov_19.034872	621	701	6	22	80	0.2750000
NODE_5372_length_1074_cov_19.034872	621	701	7	14	80	0.1750000
NODE_5372_length_1074_cov_19.034872	621	701	9	26	80	0.3250000
NODE_5372_length_1074_cov_19.034872	621	701	10	18	80	0.2250000
NODE_5372_length_1074_cov_19.034872	697	777	7	4	80	0.0500000
NODE_5372_length_1074_cov_19.034872	697	777	8	27	80	0.3375000
NODE_5372_length_1074_cov_19.034872	697	777	9	10	80	0.1250000
NODE_5372_length_1074_cov_19.034872	697	777	10	5	80	0.0625000
NODE_5372_length_1074_cov_19.034872	697	777	11	34	80	0.4250000
NODE_5372_length_1074_cov_19.034872	750	830	1	23	80	0.2875000
NODE_5372_length_1074_cov_19.034872	750	830	5	14	80	0.1750000
NODE_5372_length_1074_cov_19.034872	750	830	7	20	80	0.2500000
NODE_5372_length_1074_cov_19.034872	750	830	8	23	80	0.2875000
NODE_5373_length_1074_cov_9.450256	577	657	6	13	80	0.1625000
NODE_5373_length_1074_cov_9.450256	577	657	7	1	80	0.0125000
NODE_5373_length_1074_cov_9.450256	577	657	8	4	80	0.0500000
NODE_5373_length_1074_cov_9.450256	577	657	10	13	80	0.1625000
NODE_5373_length_1074_cov_9.450256	577	657	11	13	80	0.1625000
NODE_5373_length_1074_cov_9.450256	577	657	12	1	80	0.0125000
NODE_5373_length_1074_cov_9.450256	577	657	13	35	80	0.4375000
NODE_5373_length_1074_cov_9.450256	630	710	8	17	80	0.2125000
NODE_5373_length_1074_cov_9.450256	630	710	9	29	80	0.3625000
NODE_5373_length_1074_cov_9.450256	630	710	11	7	80	0.0875000
NODE_5373_length_1074_cov_9.450256	630	710	13	27	80	0.3375000
NODE_5374_length_1074_cov_9.155897	526	606	0	2	80	0.0250000
NODE_5374_length_1074_cov_9.155897	526	606	1	77	80	0.9625000
NODE_5374_length_1074_cov_9.155897	526	606	2	1	80	0.0125000
NODE_5374_length_1074_cov_9.155897	579	659	0	55	80	0.6875000
NODE_5374_length_1074_cov_9.155897	579	659	1	25	80	0.3125000
NODE_5374_length_1074_cov_9.155897	655	735	0	80	80	1.0000000
NODE_5374_length_1074_cov_9.155897	708	788	0	80	80	1.0000000
NODE_5375_length_1074_cov_4.600000	606	686	0	80	80	1.0000000
NODE_5375_length_1074_cov_4.600000	659	739	0	80	80	1.0000000
NODE_5376_length_1074_cov_4.328205	32	112	0	21	80	0.2625000
NODE_5376_length_1074_cov_4.328205	32	112	2	24	80	0.3000000
NODE_5376_length_1074_cov_4.328205	32	112	4	8	80	0.1000000
NODE_5376_length_1074_cov_4.328205	32	112	6	27	80	0.3375000
NODE_5380_length_1073_cov_60.012320	448	528	4	1	80	0.0125000
NODE_5380_length_1073_cov_60.012320	448	528	5	12	80	0.1500000
NODE_5380_length_1073_cov_60.012320	448	528	6	10	80	0.1250000
NODE_5380_length_1073_cov_60.012320	448	528	7	40	80	0.5000000
NODE_5380_length_1073_cov_60.012320	448	528	8	15	80	0.1875000
NODE_5380_length_1073_cov_60.012320	448	528	10	2	80	0.0250000
NODE_5380_length_1073_cov_60.012320	501	581	7	10	80	0.1250000
NODE_5380_length_1073_cov_60.012320	501	581	8	15	80	0.1875000
NODE_5380_length_1073_cov_60.012320	501	581	9	8	80	0.1000000
NODE_5380_length_1073_cov_60.012320	501	581	10	41	80	0.5125000
NODE_5380_length_1073_cov_60.012320	501	581	11	3	80	0.0375000
NODE_5380_length_1073_cov_60.012320	501	581	12	3	80	0.0375000
NODE_5382_length_1073_cov_26.415811	529	609	3	11	80	0.1375000
NODE_5382_length_1073_cov_26.415811	529	609	4	10	80	0.1250000
NODE_5382_length_1073_cov_26.415811	529	609	6	1	80	0.0125000
NODE_5382_length_1073_cov_26.415811	529	609	7	37	80	0.4625000
NODE_5382_length_1073_cov_26.415811	529	609	9	21	80	0.2625000
NODE_5382_length_1073_cov_26.415811	582	662	2	10	80	0.1250000
NODE_5382_length_1073_cov_26.415811	582	662	3	51	80	0.6375000
NODE_5382_length_1073_cov_26.415811	582	662	4	10	80	0.1250000
NODE_5382_length_1073_cov_26.415811	582	662	5	3	80	0.0375000
NODE_5382_length_1073_cov_26.415811	582	662	6	1	80	0.0125000
NODE_5382_length_1073_cov_26.415811	582	662	7	5	80	0.0625000
NODE_5383_length_1073_cov_19.062628	571	651	1	17	80	0.2125000
NODE_5383_length_1073_cov_19.062628	571	651	2	17	80	0.2125000
NODE_5383_length_1073_cov_19.062628	571	651	4	2	80	0.0250000
NODE_5383_length_1073_cov_19.062628	571	651	5	19	80	0.2375000
NODE_5383_length_1073_cov_19.062628	571	651	6	25	80	0.3125000
NODE_5383_length_1073_cov_19.062628	624	704	1	70	80	0.8750000
NODE_5383_length_1073_cov_19.062628	624	704	2	10	80	0.1250000
NODE_5384_length_1073_cov_18.536961	447	527	11	41	80	0.5125000
NODE_5384_length_1073_cov_18.536961	447	527	12	20	80	0.2500000
NODE_5384_length_1073_cov_18.536961	447	527	13	19	80	0.2375000
NODE_5384_length_1073_cov_18.536961	500	580	9	9	80	0.1125000
NODE_5384_length_1073_cov_18.536961	500	580	10	20	80	0.2500000
NODE_5384_length_1073_cov_18.536961	500	580	11	16	80	0.2000000
NODE_5384_length_1073_cov_18.536961	500	580	12	16	80	0.2000000
NODE_5384_length_1073_cov_18.536961	500	580	13	19	80	0.2375000
NODE_5384_length_1073_cov_18.536961	576	656	3	15	80	0.1875000
NODE_5384_length_1073_cov_18.536961	576	656	4	3	80	0.0375000
NODE_5384_length_1073_cov_18.536961	576	656	5	43	80	0.5375000
NODE_5384_length_1073_cov_18.536961	576	656	6	8	80	0.1000000
NODE_5384_length_1073_cov_18.536961	576	656	11	11	80	0.1375000
NODE_5384_length_1073_cov_18.536961	629	709	1	5	80	0.0625000
NODE_5384_length_1073_cov_18.536961	629	709	2	21	80	0.2625000
NODE_5384_length_1073_cov_18.536961	629	709	3	42	80	0.5250000
NODE_5384_length_1073_cov_18.536961	629	709	4	3	80	0.0375000
NODE_5384_length_1073_cov_18.536961	629	709	5	9	80	0.1125000
NODE_5385_length_1073_cov_15.318275	712	792	0	12	80	0.1500000
NODE_5385_length_1073_cov_15.318275	712	792	1	43	80	0.5375000
NODE_5385_length_1073_cov_15.318275	712	792	2	17	80	0.2125000
NODE_5385_length_1073_cov_15.318275	712	792	3	1	80	0.0125000
NODE_5385_length_1073_cov_15.318275	712	792	4	7	80	0.0875000
NODE_5385_length_1073_cov_15.318275	765	845	0	65	80	0.8125000
NODE_5385_length_1073_cov_15.318275	765	845	1	15	80	0.1875000
NODE_5386_length_1073_cov_8.376797	287	367	0	1	80	0.0125000
NODE_5386_length_1073_cov_8.376797	287	367	2	79	80	0.9875000
NODE_5386_length_1073_cov_8.376797	340	420	0	54	80	0.6750000
NODE_5386_length_1073_cov_8.376797	340	420	2	26	80	0.3250000
NODE_5387_length_1073_cov_5.749487	257	337	6	48	80	0.6000000
NODE_5387_length_1073_cov_5.749487	257	337	7	19	80	0.2375000
NODE_5387_length_1073_cov_5.749487	257	337	8	13	80	0.1625000
NODE_5387_length_1073_cov_5.749487	310	390	5	49	80	0.6125000
NODE_5387_length_1073_cov_5.749487	310	390	7	23	80	0.2875000
NODE_5387_length_1073_cov_5.749487	310	390	8	8	80	0.1000000
NODE_5388_length_1073_cov_5.156057	408	444	0	36	36	1.0000000
NODE_5390_length_1073_cov_3.019507	1	69	0	29	68	0.4264706
NODE_5390_length_1073_cov_3.019507	1	69	1	38	68	0.5588235
NODE_5390_length_1073_cov_3.019507	1	69	2	1	68	0.0147059
NODE_5390_length_1073_cov_3.019507	42	122	1	26	80	0.3250000
NODE_5390_length_1073_cov_3.019507	42	122	2	54	80	0.6750000
NODE_5399_length_1072_cov_62.729702	351	431	12	8	80	0.1000000
NODE_5399_length_1072_cov_62.729702	351	431	15	7	80	0.0875000
NODE_5399_length_1072_cov_62.729702	351	431	16	1	80	0.0125000
NODE_5399_length_1072_cov_62.729702	351	431	18	1	80	0.0125000
NODE_5399_length_1072_cov_62.729702	351	431	19	13	80	0.1625000
NODE_5399_length_1072_cov_62.729702	351	431	21	1	80	0.0125000
NODE_5399_length_1072_cov_62.729702	351	431	22	7	80	0.0875000
NODE_5399_length_1072_cov_62.729702	351	431	23	5	80	0.0625000
NODE_5399_length_1072_cov_62.729702	351	431	24	22	80	0.2750000
NODE_5399_length_1072_cov_62.729702	351	431	25	7	80	0.0875000
NODE_5399_length_1072_cov_62.729702	351	431	26	8	80	0.1000000
NODE_5399_length_1072_cov_62.729702	404	484	23	7	80	0.0875000
NODE_5399_length_1072_cov_62.729702	404	484	24	12	80	0.1500000
NODE_5399_length_1072_cov_62.729702	404	484	25	29	80	0.3625000
NODE_5399_length_1072_cov_62.729702	404	484	26	12	80	0.1500000
NODE_5399_length_1072_cov_62.729702	404	484	28	8	80	0.1000000
NODE_5399_length_1072_cov_62.729702	404	484	29	12	80	0.1500000
NODE_5399_length_1072_cov_62.729702	480	560	17	23	80	0.2875000
NODE_5399_length_1072_cov_62.729702	480	560	18	16	80	0.2000000
NODE_5399_length_1072_cov_62.729702	480	560	19	5	80	0.0625000
NODE_5399_length_1072_cov_62.729702	480	560	20	2	80	0.0250000
NODE_5399_length_1072_cov_62.729702	480	560	21	4	80	0.0500000
NODE_5399_length_1072_cov_62.729702	480	560	22	4	80	0.0500000
NODE_5399_length_1072_cov_62.729702	480	560	24	13	80	0.1625000
NODE_5399_length_1072_cov_62.729702	480	560	26	9	80	0.1125000
NODE_5399_length_1072_cov_62.729702	480	560	27	2	80	0.0250000
NODE_5399_length_1072_cov_62.729702	480	560	28	2	80	0.0250000
NODE_5399_length_1072_cov_62.729702	533	613	12	1	80	0.0125000
NODE_5399_length_1072_cov_62.729702	533	613	15	2	80	0.0250000
NODE_5399_length_1072_cov_62.729702	533	613	16	40	80	0.5000000
NODE_5399_length_1072_cov_62.729702	533	613	17	29	80	0.3625000
NODE_5399_length_1072_cov_62.729702	533	613	18	7	80	0.0875000
NODE_5399_length_1072_cov_62.729702	533	613	19	1	80	0.0125000
NODE_5400_length_1072_cov_34.045221	430	510	16	5	80	0.0625000
NODE_5400_length_1072_cov_34.045221	430	510	18	16	80	0.2000000
NODE_5400_length_1072_cov_34.045221	430	510	19	2	80	0.0250000
NODE_5400_length_1072_cov_34.045221	430	510	20	3	80	0.0375000
NODE_5400_length_1072_cov_34.045221	430	510	22	3	80	0.0375000
NODE_5400_length_1072_cov_34.045221	430	510	25	4	80	0.0500000
NODE_5400_length_1072_cov_34.045221	430	510	26	4	80	0.0500000
NODE_5400_length_1072_cov_34.045221	430	510	27	16	80	0.2000000
NODE_5400_length_1072_cov_34.045221	430	510	28	14	80	0.1750000
NODE_5400_length_1072_cov_34.045221	430	510	29	13	80	0.1625000
NODE_5400_length_1072_cov_34.045221	483	563	23	1	80	0.0125000
NODE_5400_length_1072_cov_34.045221	483	563	24	13	80	0.1625000
NODE_5400_length_1072_cov_34.045221	483	563	25	24	80	0.3000000
NODE_5400_length_1072_cov_34.045221	483	563	26	4	80	0.0500000
NODE_5400_length_1072_cov_34.045221	483	563	27	4	80	0.0500000
NODE_5400_length_1072_cov_34.045221	483	563	28	20	80	0.2500000
NODE_5400_length_1072_cov_34.045221	483	563	29	14	80	0.1750000
NODE_5401_length_1072_cov_34.006166	342	423	13	5	81	0.0617284
NODE_5401_length_1072_cov_34.006166	342	423	14	7	81	0.0864198
NODE_5401_length_1072_cov_34.006166	342	423	15	29	81	0.3580247
NODE_5401_length_1072_cov_34.006166	342	423	16	19	81	0.2345679
NODE_5401_length_1072_cov_34.006166	342	423	17	21	81	0.2592593
NODE_5401_length_1072_cov_34.006166	396	476	13	3	80	0.0375000
NODE_5401_length_1072_cov_34.006166	396	476	14	9	80	0.1125000
NODE_5401_length_1072_cov_34.006166	396	476	15	37	80	0.4625000
NODE_5401_length_1072_cov_34.006166	396	476	16	26	80	0.3250000
NODE_5401_length_1072_cov_34.006166	396	476	17	5	80	0.0625000
NODE_5401_length_1072_cov_34.006166	472	552	7	24	80	0.3000000
NODE_5401_length_1072_cov_34.006166	472	552	8	6	80	0.0750000
NODE_5401_length_1072_cov_34.006166	472	552	9	4	80	0.0500000
NODE_5401_length_1072_cov_34.006166	472	552	10	5	80	0.0625000
NODE_5401_length_1072_cov_34.006166	472	552	11	25	80	0.3125000
NODE_5401_length_1072_cov_34.006166	472	552	12	12	80	0.1500000
NODE_5401_length_1072_cov_34.006166	472	552	13	2	80	0.0250000
NODE_5401_length_1072_cov_34.006166	472	552	14	2	80	0.0250000
NODE_5401_length_1072_cov_34.006166	525	605	2	10	80	0.1250000
NODE_5401_length_1072_cov_34.006166	525	605	3	5	80	0.0625000
NODE_5401_length_1072_cov_34.006166	525	605	4	5	80	0.0625000
NODE_5401_length_1072_cov_34.006166	525	605	5	21	80	0.2625000
NODE_5401_length_1072_cov_34.006166	525	605	7	36	80	0.4500000
NODE_5401_length_1072_cov_34.006166	525	605	8	3	80	0.0375000
NODE_5403_length_1072_cov_21.852004	300	380	0	80	80	1.0000000
NODE_5403_length_1072_cov_21.852004	353	433	0	80	80	1.0000000
NODE_5404_length_1072_cov_21.532374	476	556	0	80	80	1.0000000
NODE_5404_length_1072_cov_21.532374	529	609	0	80	80	1.0000000
NODE_5405_length_1072_cov_17.018499	415	495	0	80	80	1.0000000
NODE_5405_length_1072_cov_17.018499	468	548	0	80	80	1.0000000
NODE_5410_length_1072_cov_3.302158	388	449	9	34	61	0.5573770
NODE_5410_length_1072_cov_3.302158	388	449	10	6	61	0.0983607
NODE_5410_length_1072_cov_3.302158	388	449	11	21	61	0.3442623
NODE_5410_length_1072_cov_3.302158	422	502	6	1	80	0.0125000
NODE_5410_length_1072_cov_3.302158	422	502	7	2	80	0.0250000
NODE_5410_length_1072_cov_3.302158	422	502	10	6	80	0.0750000
NODE_5410_length_1072_cov_3.302158	422	502	11	71	80	0.8875000
NODE_5414_length_1072_cov_1.773895	114	176	0	62	62	1.0000000
NODE_5417_length_1071_cov_27.565844	312	392	5	10	80	0.1250000
NODE_5417_length_1071_cov_27.565844	312	392	6	10	80	0.1250000
NODE_5417_length_1071_cov_27.565844	312	392	7	60	80	0.7500000
NODE_5417_length_1071_cov_27.565844	365	445	1	27	80	0.3375000
NODE_5417_length_1071_cov_27.565844	365	445	2	2	80	0.0250000
NODE_5417_length_1071_cov_27.565844	365	445	4	1	80	0.0125000
NODE_5417_length_1071_cov_27.565844	365	445	5	33	80	0.4125000
NODE_5417_length_1071_cov_27.565844	365	445	6	10	80	0.1250000
NODE_5417_length_1071_cov_27.565844	365	445	7	7	80	0.0875000
NODE_5419_length_1071_cov_12.666667	480	560	0	15	80	0.1875000
NODE_5419_length_1071_cov_12.666667	480	560	1	10	80	0.1250000
NODE_5419_length_1071_cov_12.666667	480	560	2	55	80	0.6875000
NODE_5419_length_1071_cov_12.666667	533	613	2	80	80	1.0000000
NODE_5421_length_1071_cov_8.942387	418	498	0	80	80	1.0000000
NODE_5421_length_1071_cov_8.942387	471	551	0	80	80	1.0000000
NODE_5427_length_1070_cov_39.255407	591	671	23	9	80	0.1125000
NODE_5427_length_1070_cov_39.255407	591	671	24	1	80	0.0125000
NODE_5427_length_1070_cov_39.255407	591	671	25	5	80	0.0625000
NODE_5427_length_1070_cov_39.255407	591	671	28	7	80	0.0875000
NODE_5427_length_1070_cov_39.255407	591	671	29	1	80	0.0125000
NODE_5427_length_1070_cov_39.255407	591	671	30	20	80	0.2500000
NODE_5427_length_1070_cov_39.255407	591	671	32	21	80	0.2625000
NODE_5427_length_1070_cov_39.255407	591	671	33	6	80	0.0750000
NODE_5427_length_1070_cov_39.255407	591	671	34	6	80	0.0750000
NODE_5427_length_1070_cov_39.255407	591	671	35	3	80	0.0375000
NODE_5427_length_1070_cov_39.255407	591	671	36	1	80	0.0125000
NODE_5427_length_1070_cov_39.255407	644	724	26	8	80	0.1000000
NODE_5427_length_1070_cov_39.255407	644	724	27	1	80	0.0125000
NODE_5427_length_1070_cov_39.255407	644	724	28	7	80	0.0875000
NODE_5427_length_1070_cov_39.255407	644	724	29	7	80	0.0875000
NODE_5427_length_1070_cov_39.255407	644	724	30	23	80	0.2875000
NODE_5427_length_1070_cov_39.255407	644	724	32	24	80	0.3000000
NODE_5427_length_1070_cov_39.255407	644	724	33	5	80	0.0625000
NODE_5427_length_1070_cov_39.255407	644	724	34	1	80	0.0125000
NODE_5427_length_1070_cov_39.255407	644	724	35	3	80	0.0375000
NODE_5427_length_1070_cov_39.255407	644	724	36	1	80	0.0125000
NODE_5428_length_1070_cov_21.903193	430	510	1	65	80	0.8125000
NODE_5428_length_1070_cov_21.903193	430	510	2	15	80	0.1875000
NODE_5428_length_1070_cov_21.903193	483	563	1	62	80	0.7750000
NODE_5428_length_1070_cov_21.903193	483	563	3	18	80	0.2250000
NODE_5428_length_1070_cov_21.903193	559	639	2	20	80	0.2500000
NODE_5428_length_1070_cov_21.903193	559	639	3	25	80	0.3125000
NODE_5428_length_1070_cov_21.903193	559	639	4	35	80	0.4375000
NODE_5428_length_1070_cov_21.903193	612	692	4	80	80	1.0000000
NODE_5429_length_1070_cov_8.963955	871	900	0	2	29	0.0689655
NODE_5429_length_1070_cov_8.963955	871	900	1	3	29	0.1034483
NODE_5429_length_1070_cov_8.963955	871	900	2	4	29	0.1379310
NODE_5429_length_1070_cov_8.963955	871	900	3	17	29	0.5862069
NODE_5429_length_1070_cov_8.963955	871	900	4	3	29	0.1034483
NODE_5429_length_1070_cov_8.963955	873	953	1	3	80	0.0375000
NODE_5429_length_1070_cov_8.963955	873	953	2	4	80	0.0500000
NODE_5429_length_1070_cov_8.963955	873	953	3	17	80	0.2125000
NODE_5429_length_1070_cov_8.963955	873	953	4	56	80	0.7000000
NODE_5433_length_1070_cov_1.659114	1027	1046	0	19	19	1.0000000
NODE_5439_length_1069_cov_40.277320	451	531	17	3	80	0.0375000
NODE_5439_length_1069_cov_40.277320	451	531	18	3	80	0.0375000
NODE_5439_length_1069_cov_40.277320	451	531	19	29	80	0.3625000
NODE_5439_length_1069_cov_40.277320	451	531	20	21	80	0.2625000
NODE_5439_length_1069_cov_40.277320	451	531	21	2	80	0.0250000
NODE_5439_length_1069_cov_40.277320	451	531	22	10	80	0.1250000
NODE_5439_length_1069_cov_40.277320	451	531	23	12	80	0.1500000
NODE_5439_length_1069_cov_40.277320	504	584	9	5	80	0.0625000
NODE_5439_length_1069_cov_40.277320	504	584	10	5	80	0.0625000
NODE_5439_length_1069_cov_40.277320	504	584	12	7	80	0.0875000
NODE_5439_length_1069_cov_40.277320	504	584	13	9	80	0.1125000
NODE_5439_length_1069_cov_40.277320	504	584	15	2	80	0.0250000
NODE_5439_length_1069_cov_40.277320	504	584	17	8	80	0.1000000
NODE_5439_length_1069_cov_40.277320	504	584	18	3	80	0.0375000
NODE_5439_length_1069_cov_40.277320	504	584	19	23	80	0.2875000
NODE_5439_length_1069_cov_40.277320	504	584	20	15	80	0.1875000
NODE_5439_length_1069_cov_40.277320	504	584	22	3	80	0.0375000
NODE_5440_length_1069_cov_23.571134	274	354	10	17	80	0.2125000
NODE_5440_length_1069_cov_23.571134	274	354	11	3	80	0.0375000
NODE_5440_length_1069_cov_23.571134	274	354	12	60	80	0.7500000
NODE_5440_length_1069_cov_23.571134	327	407	3	2	80	0.0250000
NODE_5440_length_1069_cov_23.571134	327	407	4	10	80	0.1250000
NODE_5440_length_1069_cov_23.571134	327	407	7	2	80	0.0250000
NODE_5440_length_1069_cov_23.571134	327	407	8	8	80	0.1000000
NODE_5440_length_1069_cov_23.571134	327	407	9	31	80	0.3875000
NODE_5440_length_1069_cov_23.571134	327	407	10	12	80	0.1500000
NODE_5440_length_1069_cov_23.571134	327	407	11	3	80	0.0375000
NODE_5440_length_1069_cov_23.571134	327	407	12	12	80	0.1500000
NODE_5441_length_1069_cov_22.436082	185	265	6	34	80	0.4250000
NODE_5441_length_1069_cov_22.436082	185	265	7	31	80	0.3875000
NODE_5441_length_1069_cov_22.436082	185	265	8	13	80	0.1625000
NODE_5441_length_1069_cov_22.436082	185	265	12	2	80	0.0250000
NODE_5441_length_1069_cov_22.436082	238	318	6	12	80	0.1500000
NODE_5441_length_1069_cov_22.436082	238	318	7	12	80	0.1500000
NODE_5441_length_1069_cov_22.436082	238	318	8	13	80	0.1625000
NODE_5441_length_1069_cov_22.436082	238	318	9	16	80	0.2000000
NODE_5441_length_1069_cov_22.436082	238	318	10	12	80	0.1500000
NODE_5441_length_1069_cov_22.436082	238	318	11	2	80	0.0250000
NODE_5441_length_1069_cov_22.436082	238	318	12	13	80	0.1625000
NODE_5442_length_1069_cov_18.207216	436	516	5	2	80	0.0250000
NODE_5442_length_1069_cov_18.207216	436	516	6	5	80	0.0625000
NODE_5442_length_1069_cov_18.207216	436	516	8	8	80	0.1000000
NODE_5442_length_1069_cov_18.207216	436	516	10	2	80	0.0250000
NODE_5442_length_1069_cov_18.207216	436	516	11	24	80	0.3000000
NODE_5442_length_1069_cov_18.207216	436	516	12	4	80	0.0500000
NODE_5442_length_1069_cov_18.207216	436	516	13	3	80	0.0375000
NODE_5442_length_1069_cov_18.207216	436	516	15	9	80	0.1125000
NODE_5442_length_1069_cov_18.207216	436	516	16	23	80	0.2875000
NODE_5442_length_1069_cov_18.207216	489	569	15	4	80	0.0500000
NODE_5442_length_1069_cov_18.207216	489	569	16	25	80	0.3125000
NODE_5442_length_1069_cov_18.207216	489	569	17	1	80	0.0125000
NODE_5442_length_1069_cov_18.207216	489	569	18	1	80	0.0125000
NODE_5442_length_1069_cov_18.207216	489	569	19	17	80	0.2125000
NODE_5442_length_1069_cov_18.207216	489	569	20	25	80	0.3125000
NODE_5442_length_1069_cov_18.207216	489	569	21	4	80	0.0500000
NODE_5442_length_1069_cov_18.207216	489	569	22	3	80	0.0375000
NODE_5443_length_1069_cov_17.601031	596	676	12	55	80	0.6875000
NODE_5443_length_1069_cov_17.601031	596	676	14	8	80	0.1000000
NODE_5443_length_1069_cov_17.601031	596	676	15	17	80	0.2125000
NODE_5443_length_1069_cov_17.601031	649	729	6	2	80	0.0250000
NODE_5443_length_1069_cov_17.601031	649	729	8	32	80	0.4000000
NODE_5443_length_1069_cov_17.601031	649	729	9	12	80	0.1500000
NODE_5443_length_1069_cov_17.601031	649	729	10	6	80	0.0750000
NODE_5443_length_1069_cov_17.601031	649	729	12	10	80	0.1250000
NODE_5443_length_1069_cov_17.601031	649	729	14	1	80	0.0125000
NODE_5443_length_1069_cov_17.601031	649	729	15	17	80	0.2125000
NODE_5444_length_1069_cov_16.318557	353	433	1	46	80	0.5750000
NODE_5444_length_1069_cov_16.318557	353	433	2	34	80	0.4250000
NODE_5444_length_1069_cov_16.318557	406	486	2	80	80	1.0000000
NODE_5444_length_1069_cov_16.318557	482	562	0	14	80	0.1750000
NODE_5444_length_1069_cov_16.318557	482	562	1	61	80	0.7625000
NODE_5444_length_1069_cov_16.318557	482	562	2	5	80	0.0625000
NODE_5444_length_1069_cov_16.318557	535	615	0	67	80	0.8375000
NODE_5444_length_1069_cov_16.318557	535	615	1	13	80	0.1625000
NODE_5445_length_1069_cov_13.349485	471	551	3	9	80	0.1125000
NODE_5445_length_1069_cov_13.349485	471	551	4	66	80	0.8250000
NODE_5445_length_1069_cov_13.349485	471	551	5	5	80	0.0625000
NODE_5445_length_1069_cov_13.349485	524	604	2	28	80	0.3500000
NODE_5445_length_1069_cov_13.349485	524	604	3	34	80	0.4250000
NODE_5445_length_1069_cov_13.349485	524	604	4	18	80	0.2250000
NODE_5446_length_1069_cov_13.050515	314	394	10	26	80	0.3250000
NODE_5446_length_1069_cov_13.050515	314	394	11	51	80	0.6375000
NODE_5446_length_1069_cov_13.050515	314	394	13	3	80	0.0375000
NODE_5446_length_1069_cov_13.050515	367	447	10	20	80	0.2500000
NODE_5446_length_1069_cov_13.050515	367	447	11	10	80	0.1250000
NODE_5446_length_1069_cov_13.050515	367	447	12	6	80	0.0750000
NODE_5446_length_1069_cov_13.050515	367	447	13	25	80	0.3125000
NODE_5446_length_1069_cov_13.050515	367	447	14	19	80	0.2375000
NODE_5447_length_1069_cov_12.818557	240	320	3	68	80	0.8500000
NODE_5447_length_1069_cov_12.818557	240	320	4	1	80	0.0125000
NODE_5447_length_1069_cov_12.818557	240	320	6	11	80	0.1375000
NODE_5447_length_1069_cov_12.818557	293	373	3	16	80	0.2000000
NODE_5447_length_1069_cov_12.818557	293	373	6	40	80	0.5000000
NODE_5447_length_1069_cov_12.818557	293	373	7	23	80	0.2875000
NODE_5447_length_1069_cov_12.818557	293	373	8	1	80	0.0125000
NODE_5448_length_1069_cov_11.985567	554	634	4	14	80	0.1750000
NODE_5448_length_1069_cov_11.985567	554	634	6	9	80	0.1125000
NODE_5448_length_1069_cov_11.985567	554	634	8	7	80	0.0875000
NODE_5448_length_1069_cov_11.985567	554	634	12	50	80	0.6250000
NODE_5448_length_1069_cov_11.985567	607	687	8	4	80	0.0500000
NODE_5448_length_1069_cov_11.985567	607	687	12	76	80	0.9500000
NODE_5449_length_1069_cov_10.812371	366	446	1	14	80	0.1750000
NODE_5449_length_1069_cov_10.812371	366	446	2	13	80	0.1625000
NODE_5449_length_1069_cov_10.812371	366	446	3	9	80	0.1125000
NODE_5449_length_1069_cov_10.812371	366	446	6	13	80	0.1625000
NODE_5449_length_1069_cov_10.812371	366	446	9	22	80	0.2750000
NODE_5449_length_1069_cov_10.812371	366	446	10	9	80	0.1125000
NODE_5449_length_1069_cov_10.812371	419	499	9	65	80	0.8125000
NODE_5449_length_1069_cov_10.812371	419	499	10	15	80	0.1875000
NODE_5450_length_1069_cov_7.729897	482	562	0	80	80	1.0000000
NODE_5450_length_1069_cov_7.729897	535	615	0	80	80	1.0000000
NODE_5456_length_1068_cov_31.692466	314	394	2	22	80	0.2750000
NODE_5456_length_1068_cov_31.692466	314	394	3	42	80	0.5250000
NODE_5456_length_1068_cov_31.692466	314	394	4	16	80	0.2000000
NODE_5456_length_1068_cov_31.692466	367	447	2	2	80	0.0250000
NODE_5456_length_1068_cov_31.692466	367	447	3	78	80	0.9750000
NODE_5456_length_1068_cov_31.692466	443	523	2	25	80	0.3125000
NODE_5456_length_1068_cov_31.692466	443	523	3	28	80	0.3500000
NODE_5456_length_1068_cov_31.692466	443	523	4	27	80	0.3375000
NODE_5456_length_1068_cov_31.692466	496	576	2	62	80	0.7750000
NODE_5456_length_1068_cov_31.692466	496	576	3	18	80	0.2250000
NODE_5457_length_1068_cov_29.579979	347	427	2	80	80	1.0000000
NODE_5457_length_1068_cov_29.579979	400	480	0	10	80	0.1250000
NODE_5457_length_1068_cov_29.579979	400	480	2	70	80	0.8750000
NODE_5459_length_1068_cov_23.020640	476	556	4	32	80	0.4000000
NODE_5459_length_1068_cov_23.020640	476	556	5	48	80	0.6000000
NODE_5459_length_1068_cov_23.020640	529	609	1	37	80	0.4625000
NODE_5459_length_1068_cov_23.020640	529	609	2	6	80	0.0750000
NODE_5459_length_1068_cov_23.020640	529	609	3	10	80	0.1250000
NODE_5459_length_1068_cov_23.020640	529	609	4	19	80	0.2375000
NODE_5459_length_1068_cov_23.020640	529	609	5	8	80	0.1000000
NODE_5460_length_1068_cov_15.272446	546	626	2	13	80	0.1625000
NODE_5460_length_1068_cov_15.272446	546	626	3	15	80	0.1875000
NODE_5460_length_1068_cov_15.272446	546	626	4	52	80	0.6500000
NODE_5460_length_1068_cov_15.272446	599	679	2	24	80	0.3000000
NODE_5460_length_1068_cov_15.272446	599	679	3	51	80	0.6375000
NODE_5460_length_1068_cov_15.272446	599	679	4	5	80	0.0625000
NODE_5461_length_1068_cov_13.557276	674	754	0	33	80	0.4125000
NODE_5461_length_1068_cov_13.557276	674	754	1	47	80	0.5875000
NODE_5461_length_1068_cov_13.557276	727	807	0	80	80	1.0000000
NODE_5479_length_1067_cov_48.282025	429	509	9	4	80	0.0500000
NODE_5479_length_1067_cov_48.282025	429	509	10	35	80	0.4375000
NODE_5479_length_1067_cov_48.282025	429	509	11	9	80	0.1125000
NODE_5479_length_1067_cov_48.282025	429	509	12	32	80	0.4000000
NODE_5479_length_1067_cov_48.282025	482	562	2	24	80	0.3000000
NODE_5479_length_1067_cov_48.282025	482	562	3	8	80	0.1000000
NODE_5479_length_1067_cov_48.282025	482	562	4	16	80	0.2000000
NODE_5479_length_1067_cov_48.282025	482	562	5	5	80	0.0625000
NODE_5479_length_1067_cov_48.282025	482	562	9	4	80	0.0500000
NODE_5479_length_1067_cov_48.282025	482	562	10	6	80	0.0750000
NODE_5479_length_1067_cov_48.282025	482	562	11	9	80	0.1125000
NODE_5479_length_1067_cov_48.282025	482	562	12	8	80	0.1000000
NODE_5480_length_1067_cov_41.111570	460	540	16	18	80	0.2250000
NODE_5480_length_1067_cov_41.111570	460	540	17	18	80	0.2250000
NODE_5480_length_1067_cov_41.111570	460	540	18	20	80	0.2500000
NODE_5480_length_1067_cov_41.111570	460	540	19	11	80	0.1375000
NODE_5480_length_1067_cov_41.111570	460	540	20	11	80	0.1375000
NODE_5480_length_1067_cov_41.111570	460	540	21	2	80	0.0250000
NODE_5480_length_1067_cov_41.111570	513	593	13	6	80	0.0750000
NODE_5480_length_1067_cov_41.111570	513	593	14	4	80	0.0500000
NODE_5480_length_1067_cov_41.111570	513	593	15	12	80	0.1500000
NODE_5480_length_1067_cov_41.111570	513	593	16	6	80	0.0750000
NODE_5480_length_1067_cov_41.111570	513	593	17	6	80	0.0750000
NODE_5480_length_1067_cov_41.111570	513	593	18	4	80	0.0500000
NODE_5480_length_1067_cov_41.111570	513	593	19	19	80	0.2375000
NODE_5480_length_1067_cov_41.111570	513	593	20	21	80	0.2625000
NODE_5480_length_1067_cov_41.111570	513	593	21	2	80	0.0250000
NODE_5481_length_1067_cov_39.109504	295	375	5	54	80	0.6750000
NODE_5481_length_1067_cov_39.109504	295	375	6	4	80	0.0500000
NODE_5481_length_1067_cov_39.109504	295	375	7	12	80	0.1500000
NODE_5481_length_1067_cov_39.109504	295	375	8	10	80	0.1250000
NODE_5481_length_1067_cov_39.109504	348	428	5	5	80	0.0625000
NODE_5481_length_1067_cov_39.109504	348	428	7	12	80	0.1500000
NODE_5481_length_1067_cov_39.109504	348	428	8	20	80	0.2500000
NODE_5481_length_1067_cov_39.109504	348	428	9	18	80	0.2250000
NODE_5481_length_1067_cov_39.109504	348	428	10	3	80	0.0375000
NODE_5481_length_1067_cov_39.109504	348	428	11	4	80	0.0500000
NODE_5481_length_1067_cov_39.109504	348	428	12	15	80	0.1875000
NODE_5481_length_1067_cov_39.109504	348	428	13	3	80	0.0375000
NODE_5481_length_1067_cov_39.109504	424	504	9	2	80	0.0250000
NODE_5481_length_1067_cov_39.109504	424	504	10	2	80	0.0250000
NODE_5481_length_1067_cov_39.109504	424	504	11	12	80	0.1500000
NODE_5481_length_1067_cov_39.109504	424	504	12	24	80	0.3000000
NODE_5481_length_1067_cov_39.109504	424	504	13	1	80	0.0125000
NODE_5481_length_1067_cov_39.109504	424	504	15	3	80	0.0375000
NODE_5481_length_1067_cov_39.109504	424	504	16	36	80	0.4500000
NODE_5481_length_1067_cov_39.109504	477	557	7	4	80	0.0500000
NODE_5481_length_1067_cov_39.109504	477	557	8	7	80	0.0875000
NODE_5481_length_1067_cov_39.109504	477	557	9	11	80	0.1375000
NODE_5481_length_1067_cov_39.109504	477	557	10	10	80	0.1250000
NODE_5481_length_1067_cov_39.109504	477	557	11	7	80	0.0875000
NODE_5481_length_1067_cov_39.109504	477	557	13	15	80	0.1875000
NODE_5481_length_1067_cov_39.109504	477	557	16	26	80	0.3250000
NODE_5482_length_1067_cov_35.426653	252	332	0	9	80	0.1125000
NODE_5482_length_1067_cov_35.426653	252	332	1	71	80	0.8875000
NODE_5482_length_1067_cov_35.426653	305	385	1	42	80	0.5250000
NODE_5482_length_1067_cov_35.426653	305	385	2	38	80	0.4750000
NODE_5483_length_1067_cov_29.467975	412	492	3	7	80	0.0875000
NODE_5483_length_1067_cov_29.467975	412	492	4	28	80	0.3500000
NODE_5483_length_1067_cov_29.467975	412	492	5	45	80	0.5625000
NODE_5483_length_1067_cov_29.467975	465	545	5	28	80	0.3500000
NODE_5483_length_1067_cov_29.467975	465	545	6	8	80	0.1000000
NODE_5483_length_1067_cov_29.467975	465	545	7	44	80	0.5500000
NODE_5484_length_1067_cov_20.738636	579	645	7	4	66	0.0606061
NODE_5484_length_1067_cov_20.738636	579	645	10	5	66	0.0757576
NODE_5484_length_1067_cov_20.738636	579	645	12	9	66	0.1363636
NODE_5484_length_1067_cov_20.738636	579	645	14	10	66	0.1515152
NODE_5484_length_1067_cov_20.738636	579	645	18	15	66	0.2272727
NODE_5484_length_1067_cov_20.738636	579	645	19	23	66	0.3484848
NODE_5484_length_1067_cov_20.738636	618	698	18	4	80	0.0500000
NODE_5484_length_1067_cov_20.738636	618	698	19	34	80	0.4250000
NODE_5484_length_1067_cov_20.738636	618	698	20	3	80	0.0375000
NODE_5484_length_1067_cov_20.738636	618	698	22	8	80	0.1000000
NODE_5484_length_1067_cov_20.738636	618	698	23	3	80	0.0375000
NODE_5484_length_1067_cov_20.738636	618	698	25	24	80	0.3000000
NODE_5484_length_1067_cov_20.738636	618	698	26	4	80	0.0500000
NODE_5485_length_1067_cov_15.280992	538	617	0	79	79	1.0000000
NODE_5485_length_1067_cov_15.280992	590	670	0	80	80	1.0000000
NODE_5486_length_1067_cov_13.708678	478	558	7	36	80	0.4500000
NODE_5486_length_1067_cov_13.708678	478	558	8	13	80	0.1625000
NODE_5486_length_1067_cov_13.708678	478	558	10	31	80	0.3875000
NODE_5486_length_1067_cov_13.708678	531	611	5	7	80	0.0875000
NODE_5486_length_1067_cov_13.708678	531	611	6	34	80	0.4250000
NODE_5486_length_1067_cov_13.708678	531	611	7	28	80	0.3500000
NODE_5486_length_1067_cov_13.708678	531	611	8	11	80	0.1375000
NODE_5488_length_1067_cov_9.070248	625	705	10	12	80	0.1500000
NODE_5488_length_1067_cov_9.070248	625	705	11	33	80	0.4125000
NODE_5488_length_1067_cov_9.070248	625	705	12	1	80	0.0125000
NODE_5488_length_1067_cov_9.070248	625	705	14	7	80	0.0875000
NODE_5488_length_1067_cov_9.070248	625	705	16	25	80	0.3125000
NODE_5488_length_1067_cov_9.070248	625	705	17	2	80	0.0250000
NODE_5488_length_1067_cov_9.070248	678	758	15	22	80	0.2750000
NODE_5488_length_1067_cov_9.070248	678	758	16	41	80	0.5125000
NODE_5488_length_1067_cov_9.070248	678	758	17	16	80	0.2000000
NODE_5488_length_1067_cov_9.070248	678	758	18	1	80	0.0125000
NODE_5494_length_1067_cov_1.946281	765	812	0	47	47	1.0000000
NODE_5501_length_1066_cov_54.227508	395	475	5	1	80	0.0125000
NODE_5501_length_1066_cov_54.227508	395	475	6	22	80	0.2750000
NODE_5501_length_1066_cov_54.227508	395	475	8	50	80	0.6250000
NODE_5501_length_1066_cov_54.227508	395	475	9	3	80	0.0375000
NODE_5501_length_1066_cov_54.227508	395	475	10	4	80	0.0500000
NODE_5501_length_1066_cov_54.227508	448	528	6	1	80	0.0125000
NODE_5501_length_1066_cov_54.227508	448	528	7	28	80	0.3500000
NODE_5501_length_1066_cov_54.227508	448	528	8	24	80	0.3000000
NODE_5501_length_1066_cov_54.227508	448	528	9	4	80	0.0500000
NODE_5501_length_1066_cov_54.227508	448	528	10	23	80	0.2875000
NODE_5502_length_1066_cov_33.501551	357	437	10	2	80	0.0250000
NODE_5502_length_1066_cov_33.501551	357	437	11	6	80	0.0750000
NODE_5502_length_1066_cov_33.501551	357	437	12	2	80	0.0250000
NODE_5502_length_1066_cov_33.501551	357	437	13	16	80	0.2000000
NODE_5502_length_1066_cov_33.501551	357	437	14	2	80	0.0250000
NODE_5502_length_1066_cov_33.501551	357	437	15	2	80	0.0250000
NODE_5502_length_1066_cov_33.501551	357	437	16	30	80	0.3750000
NODE_5502_length_1066_cov_33.501551	357	437	18	17	80	0.2125000
NODE_5502_length_1066_cov_33.501551	357	437	19	2	80	0.0250000
NODE_5502_length_1066_cov_33.501551	357	437	20	1	80	0.0125000
NODE_5502_length_1066_cov_33.501551	410	490	16	7	80	0.0875000
NODE_5502_length_1066_cov_33.501551	410	490	18	19	80	0.2375000
NODE_5502_length_1066_cov_33.501551	410	490	19	3	80	0.0375000
NODE_5502_length_1066_cov_33.501551	410	490	20	39	80	0.4875000
NODE_5502_length_1066_cov_33.501551	410	490	22	12	80	0.1500000
NODE_5503_length_1066_cov_33.115822	397	477	3	17	80	0.2125000
NODE_5503_length_1066_cov_33.115822	397	477	4	7	80	0.0875000
NODE_5503_length_1066_cov_33.115822	397	477	6	56	80	0.7000000
NODE_5503_length_1066_cov_33.115822	450	530	4	12	80	0.1500000
NODE_5503_length_1066_cov_33.115822	450	530	5	23	80	0.2875000
NODE_5503_length_1066_cov_33.115822	450	530	6	45	80	0.5625000
NODE_5504_length_1066_cov_26.517063	215	285	11	9	70	0.1285714
NODE_5504_length_1066_cov_26.517063	215	285	12	13	70	0.1857143
NODE_5504_length_1066_cov_26.517063	215	285	13	12	70	0.1714286
NODE_5504_length_1066_cov_26.517063	215	285	14	21	70	0.3000000
NODE_5504_length_1066_cov_26.517063	215	285	15	1	70	0.0142857
NODE_5504_length_1066_cov_26.517063	215	285	16	9	70	0.1285714
NODE_5504_length_1066_cov_26.517063	215	285	17	5	70	0.0714286
NODE_5505_length_1066_cov_16.906929	526	606	0	13	80	0.1625000
NODE_5505_length_1066_cov_16.906929	526	606	1	10	80	0.1250000
NODE_5505_length_1066_cov_16.906929	526	606	2	36	80	0.4500000
NODE_5505_length_1066_cov_16.906929	526	606	3	21	80	0.2625000
NODE_5505_length_1066_cov_16.906929	579	659	2	6	80	0.0750000
NODE_5505_length_1066_cov_16.906929	579	659	3	48	80	0.6000000
NODE_5505_length_1066_cov_16.906929	579	659	4	26	80	0.3250000
NODE_5506_length_1066_cov_16.190279	298	378	4	49	80	0.6125000
NODE_5506_length_1066_cov_16.190279	298	378	5	3	80	0.0375000
NODE_5506_length_1066_cov_16.190279	298	378	7	22	80	0.2750000
NODE_5506_length_1066_cov_16.190279	298	378	9	6	80	0.0750000
NODE_5506_length_1066_cov_16.190279	351	432	6	23	81	0.2839506
NODE_5506_length_1066_cov_16.190279	351	432	7	21	81	0.2592593
NODE_5506_length_1066_cov_16.190279	351	432	9	13	81	0.1604938
NODE_5506_length_1066_cov_16.190279	351	432	10	24	81	0.2962963
NODE_5507_length_1066_cov_15.444674	582	662	7	37	80	0.4625000
NODE_5507_length_1066_cov_15.444674	582	662	8	34	80	0.4250000
NODE_5507_length_1066_cov_15.444674	582	662	9	7	80	0.0875000
NODE_5507_length_1066_cov_15.444674	582	662	10	2	80	0.0250000
NODE_5507_length_1066_cov_15.444674	635	715	3	27	80	0.3375000
NODE_5507_length_1066_cov_15.444674	635	715	8	40	80	0.5000000
NODE_5507_length_1066_cov_15.444674	635	715	9	7	80	0.0875000
NODE_5507_length_1066_cov_15.444674	635	715	10	6	80	0.0750000
NODE_5516_length_1065_cov_51.693582	480	560	7	1	80	0.0125000
NODE_5516_length_1065_cov_51.693582	480	560	8	4	80	0.0500000
NODE_5516_length_1065_cov_51.693582	480	560	9	41	80	0.5125000
NODE_5516_length_1065_cov_51.693582	480	560	10	15	80	0.1875000
NODE_5516_length_1065_cov_51.693582	480	560	12	16	80	0.2000000
NODE_5516_length_1065_cov_51.693582	480	560	13	3	80	0.0375000
NODE_5516_length_1065_cov_51.693582	533	613	9	30	80	0.3750000
NODE_5516_length_1065_cov_51.693582	533	613	10	20	80	0.2500000
NODE_5516_length_1065_cov_51.693582	533	613	11	7	80	0.0875000
NODE_5516_length_1065_cov_51.693582	533	613	12	20	80	0.2500000
NODE_5516_length_1065_cov_51.693582	533	613	13	3	80	0.0375000
NODE_5517_length_1065_cov_33.428571	422	502	2	9	80	0.1125000
NODE_5517_length_1065_cov_33.428571	422	502	3	36	80	0.4500000
NODE_5517_length_1065_cov_33.428571	422	502	4	3	80	0.0375000
NODE_5517_length_1065_cov_33.428571	422	502	5	17	80	0.2125000
NODE_5517_length_1065_cov_33.428571	422	502	6	15	80	0.1875000
NODE_5517_length_1065_cov_33.428571	422	502	2	9	80	0.1125000
NODE_5517_length_1065_cov_33.428571	422	502	3	36	80	0.4500000
NODE_5517_length_1065_cov_33.428571	422	502	4	3	80	0.0375000
NODE_5517_length_1065_cov_33.428571	422	502	5	17	80	0.2125000
NODE_5517_length_1065_cov_33.428571	422	502	6	15	80	0.1875000
NODE_5517_length_1065_cov_33.428571	422	502	2	9	80	0.1125000
NODE_5517_length_1065_cov_33.428571	422	502	3	36	80	0.4500000
NODE_5517_length_1065_cov_33.428571	422	502	4	3	80	0.0375000
NODE_5517_length_1065_cov_33.428571	422	502	5	17	80	0.2125000
NODE_5517_length_1065_cov_33.428571	422	502	6	15	80	0.1875000
NODE_5517_length_1065_cov_33.428571	475	555	4	1	80	0.0125000
NODE_5517_length_1065_cov_33.428571	475	555	5	45	80	0.5625000
NODE_5517_length_1065_cov_33.428571	475	555	6	34	80	0.4250000
NODE_5517_length_1065_cov_33.428571	475	555	4	1	80	0.0125000
NODE_5517_length_1065_cov_33.428571	475	555	5	45	80	0.5625000
NODE_5517_length_1065_cov_33.428571	475	555	6	34	80	0.4250000
NODE_5517_length_1065_cov_33.428571	551	631	2	6	80	0.0750000
NODE_5517_length_1065_cov_33.428571	551	631	3	5	80	0.0625000
NODE_5517_length_1065_cov_33.428571	551	631	4	3	80	0.0375000
NODE_5517_length_1065_cov_33.428571	551	631	5	36	80	0.4500000
NODE_5517_length_1065_cov_33.428571	551	631	6	30	80	0.3750000
NODE_5517_length_1065_cov_33.428571	551	631	2	6	80	0.0750000
NODE_5517_length_1065_cov_33.428571	551	631	3	5	80	0.0625000
NODE_5517_length_1065_cov_33.428571	551	631	4	3	80	0.0375000
NODE_5517_length_1065_cov_33.428571	551	631	5	36	80	0.4500000
NODE_5517_length_1065_cov_33.428571	551	631	6	30	80	0.3750000
NODE_5517_length_1065_cov_33.428571	551	572	6	21	21	1.0000000
NODE_5517_length_1065_cov_33.428571	604	666	1	12	62	0.1935484
NODE_5517_length_1065_cov_33.428571	604	666	2	29	62	0.4677419
NODE_5517_length_1065_cov_33.428571	604	666	3	5	62	0.0806452
NODE_5517_length_1065_cov_33.428571	604	666	4	3	62	0.0483871
NODE_5517_length_1065_cov_33.428571	604	666	5	13	62	0.2096774
NODE_5517_length_1065_cov_33.428571	604	684	1	24	80	0.3000000
NODE_5517_length_1065_cov_33.428571	604	684	2	35	80	0.4375000
NODE_5517_length_1065_cov_33.428571	604	684	3	5	80	0.0625000
NODE_5517_length_1065_cov_33.428571	604	684	4	3	80	0.0375000
NODE_5517_length_1065_cov_33.428571	604	684	5	13	80	0.1625000
NODE_5518_length_1065_cov_31.874741	255	335	3	2	80	0.0250000
NODE_5518_length_1065_cov_31.874741	255	335	5	72	80	0.9000000
NODE_5518_length_1065_cov_31.874741	255	335	8	6	80	0.0750000
NODE_5518_length_1065_cov_31.874741	308	388	3	48	80	0.6000000
NODE_5518_length_1065_cov_31.874741	308	388	5	32	80	0.4000000
NODE_5519_length_1065_cov_21.762940	234	314	1	29	80	0.3625000
NODE_5519_length_1065_cov_21.762940	234	314	2	51	80	0.6375000
NODE_5519_length_1065_cov_21.762940	287	367	0	49	80	0.6125000
NODE_5519_length_1065_cov_21.762940	287	367	1	31	80	0.3875000
NODE_5520_length_1065_cov_19.947205	447	527	7	8	80	0.1000000
NODE_5520_length_1065_cov_19.947205	447	527	9	48	80	0.6000000
NODE_5520_length_1065_cov_19.947205	447	527	11	5	80	0.0625000
NODE_5520_length_1065_cov_19.947205	447	527	14	10	80	0.1250000
NODE_5520_length_1065_cov_19.947205	447	527	15	9	80	0.1125000
NODE_5520_length_1065_cov_19.947205	500	580	9	3	80	0.0375000
NODE_5520_length_1065_cov_19.947205	500	580	11	6	80	0.0750000
NODE_5520_length_1065_cov_19.947205	500	580	12	16	80	0.2000000
NODE_5520_length_1065_cov_19.947205	500	580	13	35	80	0.4375000
NODE_5520_length_1065_cov_19.947205	500	580	14	11	80	0.1375000
NODE_5520_length_1065_cov_19.947205	500	580	15	9	80	0.1125000
NODE_5521_length_1065_cov_14.590062	343	423	8	2	80	0.0250000
NODE_5521_length_1065_cov_14.590062	343	423	9	2	80	0.0250000
NODE_5521_length_1065_cov_14.590062	343	423	10	57	80	0.7125000
NODE_5521_length_1065_cov_14.590062	343	423	11	19	80	0.2375000
NODE_5521_length_1065_cov_14.590062	396	476	5	12	80	0.1500000
NODE_5521_length_1065_cov_14.590062	396	476	6	13	80	0.1625000
NODE_5521_length_1065_cov_14.590062	396	476	8	8	80	0.1000000
NODE_5521_length_1065_cov_14.590062	396	476	9	10	80	0.1250000
NODE_5521_length_1065_cov_14.590062	396	476	10	37	80	0.4625000
NODE_5522_length_1065_cov_13.232919	243	323	14	34	80	0.4250000
NODE_5522_length_1065_cov_13.232919	243	323	15	16	80	0.2000000
NODE_5522_length_1065_cov_13.232919	243	323	18	9	80	0.1125000
NODE_5522_length_1065_cov_13.232919	243	323	19	1	80	0.0125000
NODE_5522_length_1065_cov_13.232919	243	323	21	8	80	0.1000000
NODE_5522_length_1065_cov_13.232919	243	323	23	12	80	0.1500000
NODE_5522_length_1065_cov_13.232919	296	376	15	6	80	0.0750000
NODE_5522_length_1065_cov_13.232919	296	376	18	9	80	0.1125000
NODE_5522_length_1065_cov_13.232919	296	376	21	12	80	0.1500000
NODE_5522_length_1065_cov_13.232919	296	376	23	27	80	0.3375000
NODE_5522_length_1065_cov_13.232919	296	376	25	1	80	0.0125000
NODE_5522_length_1065_cov_13.232919	296	376	27	13	80	0.1625000
NODE_5522_length_1065_cov_13.232919	296	376	28	5	80	0.0625000
NODE_5522_length_1065_cov_13.232919	296	376	30	7	80	0.0875000
NODE_5523_length_1065_cov_10.670807	481	561	12	20	80	0.2500000
NODE_5523_length_1065_cov_10.670807	481	561	14	9	80	0.1125000
NODE_5523_length_1065_cov_10.670807	481	561	15	41	80	0.5125000
NODE_5523_length_1065_cov_10.670807	481	561	16	8	80	0.1000000
NODE_5523_length_1065_cov_10.670807	481	561	17	1	80	0.0125000
NODE_5523_length_1065_cov_10.670807	481	561	18	1	80	0.0125000
NODE_5523_length_1065_cov_10.670807	534	614	12	8	80	0.1000000
NODE_5523_length_1065_cov_10.670807	534	614	14	3	80	0.0375000
NODE_5523_length_1065_cov_10.670807	534	614	15	21	80	0.2625000
NODE_5523_length_1065_cov_10.670807	534	614	16	30	80	0.3750000
NODE_5523_length_1065_cov_10.670807	534	614	17	3	80	0.0375000
NODE_5523_length_1065_cov_10.670807	534	614	18	15	80	0.1875000
NODE_5524_length_1065_cov_10.473085	496	576	0	9	80	0.1125000
NODE_5524_length_1065_cov_10.473085	496	576	1	71	80	0.8875000
NODE_5524_length_1065_cov_10.473085	549	629	0	40	80	0.5000000
NODE_5524_length_1065_cov_10.473085	549	629	1	40	80	0.5000000
NODE_5525_length_1065_cov_9.711180	286	360	3	32	74	0.4324324
NODE_5525_length_1065_cov_9.711180	286	360	4	42	74	0.5675676
NODE_5525_length_1065_cov_9.711180	339	419	2	52	80	0.6500000
NODE_5525_length_1065_cov_9.711180	339	419	3	6	80	0.0750000
NODE_5525_length_1065_cov_9.711180	339	419	4	22	80	0.2750000
NODE_5534_length_1064_cov_59.929534	457	537	4	5	80	0.0625000
NODE_5534_length_1064_cov_59.929534	457	537	5	2	80	0.0250000
NODE_5534_length_1064_cov_59.929534	457	537	6	29	80	0.3625000
NODE_5534_length_1064_cov_59.929534	457	537	9	1	80	0.0125000
NODE_5534_length_1064_cov_59.929534	457	537	10	5	80	0.0625000
NODE_5534_length_1064_cov_59.929534	457	537	11	13	80	0.1625000
NODE_5534_length_1064_cov_59.929534	457	537	12	14	80	0.1750000
NODE_5534_length_1064_cov_59.929534	457	537	13	11	80	0.1375000
NODE_5534_length_1064_cov_59.929534	510	590	9	4	80	0.0500000
NODE_5534_length_1064_cov_59.929534	510	590	10	17	80	0.2125000
NODE_5534_length_1064_cov_59.929534	510	590	11	36	80	0.4500000
NODE_5534_length_1064_cov_59.929534	510	590	12	12	80	0.1500000
NODE_5534_length_1064_cov_59.929534	510	590	13	11	80	0.1375000
NODE_5534_length_1064_cov_59.929534	586	666	3	12	80	0.1500000
NODE_5534_length_1064_cov_59.929534	586	666	4	10	80	0.1250000
NODE_5534_length_1064_cov_59.929534	586	666	5	1	80	0.0125000
NODE_5534_length_1064_cov_59.929534	586	666	8	24	80	0.3000000
NODE_5534_length_1064_cov_59.929534	586	666	9	2	80	0.0250000
NODE_5534_length_1064_cov_59.929534	586	666	10	31	80	0.3875000
NODE_5534_length_1064_cov_59.929534	639	719	2	11	80	0.1375000
NODE_5534_length_1064_cov_59.929534	639	719	3	22	80	0.2750000
NODE_5534_length_1064_cov_59.929534	639	719	4	42	80	0.5250000
NODE_5534_length_1064_cov_59.929534	639	719	5	1	80	0.0125000
NODE_5534_length_1064_cov_59.929534	639	719	8	4	80	0.0500000
NODE_5535_length_1064_cov_36.480829	367	447	3	24	80	0.3000000
NODE_5535_length_1064_cov_36.480829	367	447	4	23	80	0.2875000
NODE_5535_length_1064_cov_36.480829	367	447	5	33	80	0.4125000
NODE_5535_length_1064_cov_36.480829	420	500	1	53	80	0.6625000
NODE_5535_length_1064_cov_36.480829	420	500	3	24	80	0.3000000
NODE_5535_length_1064_cov_36.480829	420	500	5	3	80	0.0375000
NODE_5535_length_1064_cov_36.480829	496	576	0	28	80	0.3500000
NODE_5535_length_1064_cov_36.480829	496	576	1	52	80	0.6500000
NODE_5535_length_1064_cov_36.480829	549	629	0	19	80	0.2375000
NODE_5535_length_1064_cov_36.480829	549	629	1	61	80	0.7625000
NODE_5536_length_1064_cov_32.307772	547	627	8	5	80	0.0625000
NODE_5536_length_1064_cov_32.307772	547	627	10	38	80	0.4750000
NODE_5536_length_1064_cov_32.307772	547	627	12	14	80	0.1750000
NODE_5536_length_1064_cov_32.307772	547	627	13	1	80	0.0125000
NODE_5536_length_1064_cov_32.307772	547	627	15	22	80	0.2750000
NODE_5536_length_1064_cov_32.307772	600	680	12	15	80	0.1875000
NODE_5536_length_1064_cov_32.307772	600	680	13	11	80	0.1375000
NODE_5536_length_1064_cov_32.307772	600	680	14	11	80	0.1375000
NODE_5536_length_1064_cov_32.307772	600	680	15	43	80	0.5375000
NODE_5537_length_1064_cov_25.255959	462	542	3	80	80	1.0000000
NODE_5537_length_1064_cov_25.255959	515	595	0	9	80	0.1125000
NODE_5537_length_1064_cov_25.255959	515	595	3	71	80	0.8875000
NODE_5537_length_1064_cov_25.255959	591	671	0	4	80	0.0500000
NODE_5537_length_1064_cov_25.255959	591	671	1	34	80	0.4250000
NODE_5537_length_1064_cov_25.255959	591	671	2	42	80	0.5250000
NODE_5537_length_1064_cov_25.255959	644	724	2	80	80	1.0000000
NODE_5538_length_1064_cov_23.053886	343	423	5	2	80	0.0250000
NODE_5538_length_1064_cov_23.053886	343	423	6	38	80	0.4750000
NODE_5538_length_1064_cov_23.053886	343	423	7	4	80	0.0500000
NODE_5538_length_1064_cov_23.053886	343	423	8	36	80	0.4500000
NODE_5538_length_1064_cov_23.053886	396	476	6	7	80	0.0875000
NODE_5538_length_1064_cov_23.053886	396	476	7	27	80	0.3375000
NODE_5538_length_1064_cov_23.053886	396	476	8	46	80	0.5750000
NODE_5538_length_1064_cov_23.053886	472	552	0	15	80	0.1875000
NODE_5538_length_1064_cov_23.053886	472	552	1	4	80	0.0500000
NODE_5538_length_1064_cov_23.053886	472	552	2	26	80	0.3250000
NODE_5538_length_1064_cov_23.053886	472	552	3	13	80	0.1625000
NODE_5538_length_1064_cov_23.053886	472	552	4	13	80	0.1625000
NODE_5538_length_1064_cov_23.053886	472	552	5	3	80	0.0375000
NODE_5538_length_1064_cov_23.053886	472	552	6	6	80	0.0750000
NODE_5538_length_1064_cov_23.053886	525	605	0	68	80	0.8500000
NODE_5538_length_1064_cov_23.053886	525	605	1	4	80	0.0500000
NODE_5538_length_1064_cov_23.053886	525	605	2	8	80	0.1000000
NODE_5539_length_1064_cov_22.018653	479	559	0	80	80	1.0000000
NODE_5539_length_1064_cov_22.018653	532	612	0	80	80	1.0000000
NODE_5540_length_1064_cov_12.868394	424	504	4	3	80	0.0375000
NODE_5540_length_1064_cov_12.868394	424	504	5	8	80	0.1000000
NODE_5540_length_1064_cov_12.868394	424	504	6	14	80	0.1750000
NODE_5540_length_1064_cov_12.868394	424	504	7	43	80	0.5375000
NODE_5540_length_1064_cov_12.868394	424	504	8	12	80	0.1500000
NODE_5540_length_1064_cov_12.868394	477	557	2	21	80	0.2625000
NODE_5540_length_1064_cov_12.868394	477	557	5	40	80	0.5000000
NODE_5540_length_1064_cov_12.868394	477	557	7	19	80	0.2375000
NODE_5541_length_1064_cov_10.098446	467	547	2	28	80	0.3500000
NODE_5541_length_1064_cov_10.098446	467	547	4	52	80	0.6500000
NODE_5541_length_1064_cov_10.098446	520	600	2	67	80	0.8375000
NODE_5541_length_1064_cov_10.098446	520	600	4	13	80	0.1625000
NODE_5543_length_1064_cov_2.925389	173	245	0	72	72	1.0000000
NODE_5551_length_1063_cov_104.615145	504	584	27	15	80	0.1875000
NODE_5551_length_1063_cov_104.615145	504	584	28	27	80	0.3375000
NODE_5551_length_1063_cov_104.615145	504	584	29	6	80	0.0750000
NODE_5551_length_1063_cov_104.615145	504	584	30	6	80	0.0750000
NODE_5551_length_1063_cov_104.615145	504	584	31	3	80	0.0375000
NODE_5551_length_1063_cov_104.615145	504	584	32	6	80	0.0750000
NODE_5551_length_1063_cov_104.615145	504	584	33	17	80	0.2125000
NODE_5551_length_1063_cov_104.615145	557	637	22	6	80	0.0750000
NODE_5551_length_1063_cov_104.615145	557	637	26	6	80	0.0750000
NODE_5551_length_1063_cov_104.615145	557	637	28	42	80	0.5250000
NODE_5551_length_1063_cov_104.615145	557	637	29	8	80	0.1000000
NODE_5551_length_1063_cov_104.615145	557	637	30	8	80	0.1000000
NODE_5551_length_1063_cov_104.615145	557	637	32	4	80	0.0500000
NODE_5551_length_1063_cov_104.615145	557	637	33	6	80	0.0750000
NODE_5552_length_1063_cov_36.515560	482	562	2	18	80	0.2250000
NODE_5552_length_1063_cov_36.515560	482	562	3	13	80	0.1625000
NODE_5552_length_1063_cov_36.515560	482	562	4	49	80	0.6125000
NODE_5552_length_1063_cov_36.515560	535	615	2	47	80	0.5875000
NODE_5552_length_1063_cov_36.515560	535	615	3	33	80	0.4125000
NODE_5552_length_1063_cov_36.515560	611	691	2	8	80	0.1000000
NODE_5552_length_1063_cov_36.515560	611	691	3	72	80	0.9000000
NODE_5552_length_1063_cov_36.515560	664	744	1	35	80	0.4375000
NODE_5552_length_1063_cov_36.515560	664	744	2	26	80	0.3250000
NODE_5552_length_1063_cov_36.515560	664	744	3	19	80	0.2375000
NODE_5553_length_1063_cov_30.700207	470	550	1	16	80	0.2000000
NODE_5553_length_1063_cov_30.700207	470	550	2	11	80	0.1375000
NODE_5553_length_1063_cov_30.700207	470	550	3	53	80	0.6625000
NODE_5553_length_1063_cov_30.700207	523	603	3	55	80	0.6875000
NODE_5553_length_1063_cov_30.700207	523	603	4	1	80	0.0125000
NODE_5553_length_1063_cov_30.700207	523	603	6	14	80	0.1750000
NODE_5553_length_1063_cov_30.700207	523	603	7	10	80	0.1250000
NODE_5553_length_1063_cov_30.700207	599	679	6	3	80	0.0375000
NODE_5553_length_1063_cov_30.700207	599	679	7	34	80	0.4250000
NODE_5553_length_1063_cov_30.700207	599	679	8	8	80	0.1000000
NODE_5553_length_1063_cov_30.700207	599	679	14	30	80	0.3750000
NODE_5553_length_1063_cov_30.700207	599	679	15	5	80	0.0625000
NODE_5553_length_1063_cov_30.700207	652	732	11	2	80	0.0250000
NODE_5553_length_1063_cov_30.700207	652	732	13	1	80	0.0125000
NODE_5553_length_1063_cov_30.700207	652	732	14	41	80	0.5125000
NODE_5553_length_1063_cov_30.700207	652	732	15	31	80	0.3875000
NODE_5553_length_1063_cov_30.700207	652	732	19	5	80	0.0625000
NODE_5554_length_1063_cov_24.552905	362	442	3	8	80	0.1000000
NODE_5554_length_1063_cov_24.552905	362	442	4	32	80	0.4000000
NODE_5554_length_1063_cov_24.552905	362	442	6	18	80	0.2250000
NODE_5554_length_1063_cov_24.552905	362	442	7	22	80	0.2750000
NODE_5554_length_1063_cov_24.552905	415	495	4	14	80	0.1750000
NODE_5554_length_1063_cov_24.552905	415	495	5	30	80	0.3750000
NODE_5554_length_1063_cov_24.552905	415	495	6	15	80	0.1875000
NODE_5554_length_1063_cov_24.552905	415	495	7	21	80	0.2625000
NODE_5555_length_1063_cov_21.985477	407	487	1	9	80	0.1125000
NODE_5555_length_1063_cov_21.985477	407	487	3	61	80	0.7625000
NODE_5555_length_1063_cov_21.985477	407	487	4	10	80	0.1250000
NODE_5555_length_1063_cov_21.985477	460	540	1	18	80	0.2250000
NODE_5555_length_1063_cov_21.985477	460	540	2	25	80	0.3125000
NODE_5555_length_1063_cov_21.985477	460	540	3	18	80	0.2250000
NODE_5555_length_1063_cov_21.985477	460	540	4	19	80	0.2375000
NODE_5555_length_1063_cov_21.985477	536	616	4	23	80	0.2875000
NODE_5555_length_1063_cov_21.985477	536	616	5	27	80	0.3375000
NODE_5555_length_1063_cov_21.985477	536	616	8	7	80	0.0875000
NODE_5555_length_1063_cov_21.985477	536	616	9	22	80	0.2750000
NODE_5555_length_1063_cov_21.985477	536	616	11	1	80	0.0125000
NODE_5555_length_1063_cov_21.985477	589	670	8	4	81	0.0493827
NODE_5555_length_1063_cov_21.985477	589	670	9	22	81	0.2716049
NODE_5555_length_1063_cov_21.985477	589	670	11	11	81	0.1358025
NODE_5555_length_1063_cov_21.985477	589	670	12	5	81	0.0617284
NODE_5555_length_1063_cov_21.985477	589	670	13	29	81	0.3580247
NODE_5555_length_1063_cov_21.985477	589	670	14	10	81	0.1234568
NODE_5557_length_1063_cov_15.400415	685	765	7	28	80	0.3500000
NODE_5557_length_1063_cov_15.400415	685	765	8	10	80	0.1250000
NODE_5557_length_1063_cov_15.400415	685	765	9	42	80	0.5250000
NODE_5557_length_1063_cov_15.400415	738	818	7	40	80	0.5000000
NODE_5557_length_1063_cov_15.400415	738	818	8	20	80	0.2500000
NODE_5557_length_1063_cov_15.400415	738	818	9	19	80	0.2375000
NODE_5557_length_1063_cov_15.400415	738	818	10	1	80	0.0125000
NODE_5558_length_1063_cov_13.282158	510	590	8	9	80	0.1125000
NODE_5558_length_1063_cov_13.282158	510	590	9	57	80	0.7125000
NODE_5558_length_1063_cov_13.282158	510	590	10	14	80	0.1750000
NODE_5558_length_1063_cov_13.282158	563	643	2	20	80	0.2500000
NODE_5558_length_1063_cov_13.282158	563	643	4	1	80	0.0125000
NODE_5558_length_1063_cov_13.282158	563	643	5	21	80	0.2625000
NODE_5558_length_1063_cov_13.282158	563	643	9	30	80	0.3750000
NODE_5558_length_1063_cov_13.282158	563	643	10	8	80	0.1000000
NODE_5559_length_1063_cov_12.970954	417	495	6	1	78	0.0128205
NODE_5559_length_1063_cov_12.970954	417	495	7	56	78	0.7179487
NODE_5559_length_1063_cov_12.970954	417	495	8	21	78	0.2692308
NODE_5559_length_1063_cov_12.970954	468	548	6	4	80	0.0500000
NODE_5559_length_1063_cov_12.970954	468	548	7	24	80	0.3000000
NODE_5559_length_1063_cov_12.970954	468	548	8	39	80	0.4875000
NODE_5559_length_1063_cov_12.970954	468	548	9	13	80	0.1625000
NODE_5560_length_1063_cov_7.917012	639	719	3	23	80	0.2875000
NODE_5560_length_1063_cov_7.917012	639	719	4	7	80	0.0875000
NODE_5560_length_1063_cov_7.917012	639	719	5	50	80	0.6250000
NODE_5560_length_1063_cov_7.917012	692	772	4	8	80	0.1000000
NODE_5560_length_1063_cov_7.917012	692	772	5	50	80	0.6250000
NODE_5560_length_1063_cov_7.917012	692	772	6	21	80	0.2625000
NODE_5560_length_1063_cov_7.917012	692	772	7	1	80	0.0125000
NODE_5569_length_1063_cov_1.695021	893	947	0	54	54	1.0000000
NODE_5574_length_1062_cov_43.399792	272	352	14	11	80	0.1375000
NODE_5574_length_1062_cov_43.399792	272	352	15	14	80	0.1750000
NODE_5574_length_1062_cov_43.399792	272	352	16	2	80	0.0250000
NODE_5574_length_1062_cov_43.399792	272	352	17	5	80	0.0625000
NODE_5574_length_1062_cov_43.399792	272	352	18	10	80	0.1250000
NODE_5574_length_1062_cov_43.399792	272	352	19	16	80	0.2000000
NODE_5574_length_1062_cov_43.399792	272	352	20	7	80	0.0875000
NODE_5574_length_1062_cov_43.399792	272	352	21	15	80	0.1875000
NODE_5574_length_1062_cov_43.399792	325	405	13	12	80	0.1500000
NODE_5574_length_1062_cov_43.399792	325	405	14	43	80	0.5375000
NODE_5574_length_1062_cov_43.399792	325	405	15	14	80	0.1750000
NODE_5574_length_1062_cov_43.399792	325	405	16	7	80	0.0875000
NODE_5574_length_1062_cov_43.399792	325	405	17	4	80	0.0500000
NODE_5576_length_1062_cov_19.778816	401	481	9	66	80	0.8250000
NODE_5576_length_1062_cov_19.778816	401	481	10	14	80	0.1750000
NODE_5576_length_1062_cov_19.778816	454	534	1	2	80	0.0250000
NODE_5576_length_1062_cov_19.778816	454	534	2	16	80	0.2000000
NODE_5576_length_1062_cov_19.778816	454	534	3	11	80	0.1375000
NODE_5576_length_1062_cov_19.778816	454	534	4	3	80	0.0375000
NODE_5576_length_1062_cov_19.778816	454	534	5	4	80	0.0500000
NODE_5576_length_1062_cov_19.778816	454	534	9	44	80	0.5500000
NODE_5577_length_1062_cov_16.034268	628	708	5	3	80	0.0375000
NODE_5577_length_1062_cov_16.034268	628	708	6	1	80	0.0125000
NODE_5577_length_1062_cov_16.034268	628	708	7	24	80	0.3000000
NODE_5577_length_1062_cov_16.034268	628	708	8	52	80	0.6500000
NODE_5577_length_1062_cov_16.034268	681	761	5	1	80	0.0125000
NODE_5577_length_1062_cov_16.034268	681	761	7	55	80	0.6875000
NODE_5577_length_1062_cov_16.034268	681	761	8	11	80	0.1375000
NODE_5577_length_1062_cov_16.034268	681	761	9	13	80	0.1625000
NODE_5578_length_1062_cov_13.346833	623	703	6	19	80	0.2375000
NODE_5578_length_1062_cov_13.346833	623	703	7	32	80	0.4000000
NODE_5578_length_1062_cov_13.346833	623	703	8	20	80	0.2500000
NODE_5578_length_1062_cov_13.346833	623	703	10	9	80	0.1125000
NODE_5578_length_1062_cov_13.346833	676	756	6	6	80	0.0750000
NODE_5578_length_1062_cov_13.346833	676	756	7	6	80	0.0750000
NODE_5578_length_1062_cov_13.346833	676	756	8	44	80	0.5500000
NODE_5578_length_1062_cov_13.346833	676	756	10	24	80	0.3000000
NODE_5579_length_1062_cov_9.886812	670	750	0	2	80	0.0250000
NODE_5579_length_1062_cov_9.886812	670	750	1	30	80	0.3750000
NODE_5579_length_1062_cov_9.886812	670	750	2	15	80	0.1875000
NODE_5579_length_1062_cov_9.886812	670	750	3	33	80	0.4125000
NODE_5579_length_1062_cov_9.886812	723	803	3	38	80	0.4750000
NODE_5579_length_1062_cov_9.886812	723	803	4	42	80	0.5250000
NODE_5580_length_1062_cov_9.078920	525	604	0	79	79	1.0000000
NODE_5580_length_1062_cov_9.078920	577	657	0	80	80	1.0000000
NODE_5581_length_1062_cov_8.934579	203	283	1	19	80	0.2375000
NODE_5581_length_1062_cov_8.934579	203	283	3	50	80	0.6250000
NODE_5581_length_1062_cov_8.934579	203	283	4	8	80	0.1000000
NODE_5581_length_1062_cov_8.934579	203	283	5	3	80	0.0375000
NODE_5581_length_1062_cov_8.934579	256	336	1	16	80	0.2000000
NODE_5581_length_1062_cov_8.934579	256	336	3	25	80	0.3125000
NODE_5581_length_1062_cov_8.934579	256	336	4	36	80	0.4500000
NODE_5581_length_1062_cov_8.934579	256	336	5	3	80	0.0375000
NODE_5588_length_1061_cov_22.637214	418	498	4	31	80	0.3875000
NODE_5588_length_1061_cov_22.637214	418	498	5	13	80	0.1625000
NODE_5588_length_1061_cov_22.637214	418	498	6	2	80	0.0250000
NODE_5588_length_1061_cov_22.637214	418	498	7	27	80	0.3375000
NODE_5588_length_1061_cov_22.637214	418	498	8	7	80	0.0875000
NODE_5588_length_1061_cov_22.637214	471	551	3	50	80	0.6250000
NODE_5588_length_1061_cov_22.637214	471	551	4	30	80	0.3750000
NODE_5589_length_1061_cov_22.338877	479	559	3	35	80	0.4375000
NODE_5589_length_1061_cov_22.338877	479	559	4	3	80	0.0375000
NODE_5589_length_1061_cov_22.338877	479	559	7	6	80	0.0750000
NODE_5589_length_1061_cov_22.338877	479	559	9	13	80	0.1625000
NODE_5589_length_1061_cov_22.338877	479	559	10	23	80	0.2875000
NODE_5589_length_1061_cov_22.338877	532	612	9	4	80	0.0500000
NODE_5589_length_1061_cov_22.338877	532	612	10	34	80	0.4250000
NODE_5589_length_1061_cov_22.338877	532	612	12	23	80	0.2875000
NODE_5589_length_1061_cov_22.338877	532	612	13	19	80	0.2375000
NODE_5597_length_1060_cov_31.595213	394	473	5	12	79	0.1518987
NODE_5597_length_1060_cov_31.595213	394	473	6	11	79	0.1392405
NODE_5597_length_1060_cov_31.595213	394	473	7	14	79	0.1772152
NODE_5597_length_1060_cov_31.595213	394	473	8	4	79	0.0506329
NODE_5597_length_1060_cov_31.595213	394	473	9	1	79	0.0126582
NODE_5597_length_1060_cov_31.595213	394	473	10	3	79	0.0379747
NODE_5597_length_1060_cov_31.595213	394	473	11	3	79	0.0379747
NODE_5597_length_1060_cov_31.595213	394	473	13	19	79	0.2405063
NODE_5597_length_1060_cov_31.595213	394	473	14	12	79	0.1518987
NODE_5597_length_1060_cov_31.595213	446	526	13	15	80	0.1875000
NODE_5597_length_1060_cov_31.595213	446	526	14	33	80	0.4125000
NODE_5597_length_1060_cov_31.595213	446	526	15	15	80	0.1875000
NODE_5597_length_1060_cov_31.595213	446	526	16	11	80	0.1375000
NODE_5597_length_1060_cov_31.595213	446	526	17	6	80	0.0750000
NODE_5597_length_1060_cov_31.595213	522	602	6	10	80	0.1250000
NODE_5597_length_1060_cov_31.595213	522	602	8	3	80	0.0375000
NODE_5597_length_1060_cov_31.595213	522	602	9	3	80	0.0375000
NODE_5597_length_1060_cov_31.595213	522	602	10	1	80	0.0125000
NODE_5597_length_1060_cov_31.595213	522	602	11	4	80	0.0500000
NODE_5597_length_1060_cov_31.595213	522	602	12	14	80	0.1750000
NODE_5597_length_1060_cov_31.595213	522	602	13	15	80	0.1875000
NODE_5597_length_1060_cov_31.595213	522	602	14	20	80	0.2500000
NODE_5597_length_1060_cov_31.595213	522	602	15	1	80	0.0125000
NODE_5597_length_1060_cov_31.595213	522	602	16	2	80	0.0250000
NODE_5597_length_1060_cov_31.595213	522	602	17	7	80	0.0875000
NODE_5597_length_1060_cov_31.595213	575	655	5	32	80	0.4000000
NODE_5597_length_1060_cov_31.595213	575	655	6	18	80	0.2250000
NODE_5597_length_1060_cov_31.595213	575	655	7	13	80	0.1625000
NODE_5597_length_1060_cov_31.595213	575	655	8	3	80	0.0375000
NODE_5597_length_1060_cov_31.595213	575	655	9	3	80	0.0375000
NODE_5597_length_1060_cov_31.595213	575	655	10	1	80	0.0125000
NODE_5597_length_1060_cov_31.595213	575	655	11	3	80	0.0375000
NODE_5597_length_1060_cov_31.595213	575	655	12	7	80	0.0875000
NODE_5598_length_1060_cov_26.136316	486	566	10	48	80	0.6000000
NODE_5598_length_1060_cov_26.136316	486	566	11	15	80	0.1875000
NODE_5598_length_1060_cov_26.136316	486	566	12	17	80	0.2125000
NODE_5598_length_1060_cov_26.136316	539	619	6	19	80	0.2375000
NODE_5598_length_1060_cov_26.136316	539	619	7	4	80	0.0500000
NODE_5598_length_1060_cov_26.136316	539	619	8	1	80	0.0125000
NODE_5598_length_1060_cov_26.136316	539	619	10	52	80	0.6500000
NODE_5598_length_1060_cov_26.136316	539	619	11	4	80	0.0500000
NODE_5598_length_1060_cov_26.136316	615	695	3	37	80	0.4625000
NODE_5598_length_1060_cov_26.136316	615	695	4	15	80	0.1875000
NODE_5598_length_1060_cov_26.136316	615	695	5	19	80	0.2375000
NODE_5598_length_1060_cov_26.136316	615	695	6	5	80	0.0625000
NODE_5598_length_1060_cov_26.136316	615	695	7	4	80	0.0500000
NODE_5598_length_1060_cov_26.136316	668	748	1	1	80	0.0125000
NODE_5598_length_1060_cov_26.136316	668	748	3	54	80	0.6750000
NODE_5598_length_1060_cov_26.136316	668	748	4	25	80	0.3125000
NODE_5599_length_1060_cov_25.329865	370	450	7	3	80	0.0375000
NODE_5599_length_1060_cov_25.329865	370	450	8	5	80	0.0625000
NODE_5599_length_1060_cov_25.329865	370	450	9	12	80	0.1500000
NODE_5599_length_1060_cov_25.329865	370	450	10	18	80	0.2250000
NODE_5599_length_1060_cov_25.329865	370	450	12	13	80	0.1625000
NODE_5599_length_1060_cov_25.329865	370	450	13	13	80	0.1625000
NODE_5599_length_1060_cov_25.329865	370	450	14	3	80	0.0375000
NODE_5599_length_1060_cov_25.329865	370	450	15	13	80	0.1625000
NODE_5599_length_1060_cov_25.329865	423	503	11	3	80	0.0375000
NODE_5599_length_1060_cov_25.329865	423	503	12	26	80	0.3250000
NODE_5599_length_1060_cov_25.329865	423	503	13	31	80	0.3875000
NODE_5599_length_1060_cov_25.329865	423	503	14	3	80	0.0375000
NODE_5599_length_1060_cov_25.329865	423	503	15	17	80	0.2125000
NODE_5600_length_1060_cov_16.881374	539	611	0	33	72	0.4583333
NODE_5600_length_1060_cov_16.881374	539	611	3	4	72	0.0555556
NODE_5600_length_1060_cov_16.881374	539	611	8	32	72	0.4444444
NODE_5600_length_1060_cov_16.881374	539	611	9	3	72	0.0416667
NODE_5601_length_1060_cov_14.789802	406	486	2	6	80	0.0750000
NODE_5601_length_1060_cov_14.789802	406	486	3	60	80	0.7500000
NODE_5601_length_1060_cov_14.789802	406	486	4	14	80	0.1750000
NODE_5601_length_1060_cov_14.789802	459	539	0	9	80	0.1125000
NODE_5601_length_1060_cov_14.789802	459	539	2	50	80	0.6250000
NODE_5601_length_1060_cov_14.789802	459	539	3	21	80	0.2625000
NODE_5603_length_1060_cov_5.900104	517	597	2	43	80	0.5375000
NODE_5603_length_1060_cov_5.900104	517	597	3	37	80	0.4625000
NODE_5603_length_1060_cov_5.900104	570	650	1	23	80	0.2875000
NODE_5603_length_1060_cov_5.900104	570	650	2	39	80	0.4875000
NODE_5603_length_1060_cov_5.900104	570	650	3	18	80	0.2250000
NODE_5611_length_1059_cov_16.630208	412	492	3	25	80	0.3125000
NODE_5611_length_1059_cov_16.630208	412	492	6	4	80	0.0500000
NODE_5611_length_1059_cov_16.630208	412	492	7	14	80	0.1750000
NODE_5611_length_1059_cov_16.630208	412	492	10	25	80	0.3125000
NODE_5611_length_1059_cov_16.630208	412	492	11	11	80	0.1375000
NODE_5611_length_1059_cov_16.630208	412	492	14	1	80	0.0125000
NODE_5611_length_1059_cov_16.630208	465	552	10	15	87	0.1724138
NODE_5611_length_1059_cov_16.630208	465	552	11	11	87	0.1264368
NODE_5611_length_1059_cov_16.630208	465	552	12	25	87	0.2873563
NODE_5611_length_1059_cov_16.630208	465	552	13	13	87	0.1494253
NODE_5611_length_1059_cov_16.630208	465	552	14	23	87	0.2643678
NODE_5611_length_1059_cov_16.630208	548	628	7	1	80	0.0125000
NODE_5611_length_1059_cov_16.630208	548	628	8	22	80	0.2750000
NODE_5611_length_1059_cov_16.630208	548	628	11	11	80	0.1375000
NODE_5611_length_1059_cov_16.630208	548	628	13	38	80	0.4750000
NODE_5611_length_1059_cov_16.630208	548	628	14	3	80	0.0375000
NODE_5611_length_1059_cov_16.630208	548	628	15	5	80	0.0625000
NODE_5611_length_1059_cov_16.630208	601	681	3	26	80	0.3250000
NODE_5611_length_1059_cov_16.630208	601	681	4	6	80	0.0750000
NODE_5611_length_1059_cov_16.630208	601	681	6	8	80	0.1000000
NODE_5611_length_1059_cov_16.630208	601	681	7	14	80	0.1750000
NODE_5611_length_1059_cov_16.630208	601	681	8	22	80	0.2750000
NODE_5611_length_1059_cov_16.630208	601	681	11	4	80	0.0500000
NODE_5621_length_1058_cov_60.155370	395	475	12	12	80	0.1500000
NODE_5621_length_1058_cov_60.155370	395	475	13	11	80	0.1375000
NODE_5621_length_1058_cov_60.155370	395	475	14	28	80	0.3500000
NODE_5621_length_1058_cov_60.155370	395	475	15	22	80	0.2750000
NODE_5621_length_1058_cov_60.155370	395	475	16	4	80	0.0500000
NODE_5621_length_1058_cov_60.155370	395	475	18	3	80	0.0375000
NODE_5621_length_1058_cov_60.155370	448	528	10	8	80	0.1000000
NODE_5621_length_1058_cov_60.155370	448	528	11	8	80	0.1000000
NODE_5621_length_1058_cov_60.155370	448	528	13	8	80	0.1000000
NODE_5621_length_1058_cov_60.155370	448	528	14	6	80	0.0750000
NODE_5621_length_1058_cov_60.155370	448	528	15	37	80	0.4625000
NODE_5621_length_1058_cov_60.155370	448	528	16	10	80	0.1250000
NODE_5621_length_1058_cov_60.155370	448	528	18	3	80	0.0375000
NODE_5621_length_1058_cov_60.155370	524	604	9	12	80	0.1500000
NODE_5621_length_1058_cov_60.155370	524	604	10	11	80	0.1375000
NODE_5621_length_1058_cov_60.155370	524	604	11	56	80	0.7000000
NODE_5621_length_1058_cov_60.155370	524	604	12	1	80	0.0125000
NODE_5621_length_1058_cov_60.155370	577	657	4	1	80	0.0125000
NODE_5621_length_1058_cov_60.155370	577	657	5	7	80	0.0875000
NODE_5621_length_1058_cov_60.155370	577	657	6	29	80	0.3625000
NODE_5621_length_1058_cov_60.155370	577	657	8	1	80	0.0125000
NODE_5621_length_1058_cov_60.155370	577	657	9	23	80	0.2875000
NODE_5621_length_1058_cov_60.155370	577	657	10	10	80	0.1250000
NODE_5621_length_1058_cov_60.155370	577	657	11	9	80	0.1125000
NODE_5622_length_1058_cov_31.253389	475	555	0	10	80	0.1250000
NODE_5622_length_1058_cov_31.253389	475	555	1	6	80	0.0750000
NODE_5622_length_1058_cov_31.253389	475	555	2	8	80	0.1000000
NODE_5622_length_1058_cov_31.253389	475	555	3	3	80	0.0375000
NODE_5622_length_1058_cov_31.253389	475	555	4	53	80	0.6625000
NODE_5622_length_1058_cov_31.253389	475	555	0	10	80	0.1250000
NODE_5622_length_1058_cov_31.253389	475	555	1	6	80	0.0750000
NODE_5622_length_1058_cov_31.253389	475	555	2	8	80	0.1000000
NODE_5622_length_1058_cov_31.253389	475	555	3	3	80	0.0375000
NODE_5622_length_1058_cov_31.253389	475	555	4	53	80	0.6625000
NODE_5622_length_1058_cov_31.253389	528	608	0	63	80	0.7875000
NODE_5622_length_1058_cov_31.253389	528	608	1	6	80	0.0750000
NODE_5622_length_1058_cov_31.253389	528	608	2	8	80	0.1000000
NODE_5622_length_1058_cov_31.253389	528	608	3	3	80	0.0375000
NODE_5622_length_1058_cov_31.253389	533	608	0	63	75	0.8400000
NODE_5622_length_1058_cov_31.253389	533	608	1	6	75	0.0800000
NODE_5622_length_1058_cov_31.253389	533	608	2	6	75	0.0800000
NODE_5623_length_1058_cov_24.520334	264	344	2	80	80	1.0000000
NODE_5623_length_1058_cov_24.520334	317	397	0	24	80	0.3000000
NODE_5623_length_1058_cov_24.520334	317	397	1	12	80	0.1500000
NODE_5623_length_1058_cov_24.520334	317	397	2	44	80	0.5500000
NODE_5624_length_1058_cov_24.211679	297	377	0	80	80	1.0000000
NODE_5624_length_1058_cov_24.211679	350	430	0	80	80	1.0000000
NODE_5625_length_1058_cov_18.100104	454	534	16	4	80	0.0500000
NODE_5625_length_1058_cov_18.100104	454	534	17	6	80	0.0750000
NODE_5625_length_1058_cov_18.100104	454	534	18	17	80	0.2125000
NODE_5625_length_1058_cov_18.100104	454	534	19	3	80	0.0375000
NODE_5625_length_1058_cov_18.100104	454	534	20	2	80	0.0250000
NODE_5625_length_1058_cov_18.100104	454	534	21	6	80	0.0750000
NODE_5625_length_1058_cov_18.100104	454	534	22	9	80	0.1125000
NODE_5625_length_1058_cov_18.100104	454	534	23	5	80	0.0625000
NODE_5625_length_1058_cov_18.100104	454	534	24	20	80	0.2500000
NODE_5625_length_1058_cov_18.100104	454	534	25	8	80	0.1000000
NODE_5625_length_1058_cov_18.100104	507	587	14	1	80	0.0125000
NODE_5625_length_1058_cov_18.100104	507	587	15	6	80	0.0750000
NODE_5625_length_1058_cov_18.100104	507	587	16	4	80	0.0500000
NODE_5625_length_1058_cov_18.100104	507	587	17	3	80	0.0375000
NODE_5625_length_1058_cov_18.100104	507	587	18	6	80	0.0750000
NODE_5625_length_1058_cov_18.100104	507	587	19	5	80	0.0625000
NODE_5625_length_1058_cov_18.100104	507	587	20	2	80	0.0250000
NODE_5625_length_1058_cov_18.100104	507	587	21	20	80	0.2500000
NODE_5625_length_1058_cov_18.100104	507	587	23	5	80	0.0625000
NODE_5625_length_1058_cov_18.100104	507	587	24	23	80	0.2875000
NODE_5625_length_1058_cov_18.100104	507	587	25	5	80	0.0625000
NODE_5626_length_1058_cov_11.645464	476	556	0	80	80	1.0000000
NODE_5626_length_1058_cov_11.645464	529	609	0	33	80	0.4125000
NODE_5626_length_1058_cov_11.645464	529	609	1	47	80	0.5875000
NODE_5627_length_1058_cov_9.953076	621	712	5	83	91	0.9120879
NODE_5627_length_1058_cov_9.953076	621	712	7	1	91	0.0109890
NODE_5627_length_1058_cov_9.953076	621	712	8	7	91	0.0769231
NODE_5627_length_1058_cov_9.953076	685	765	3	20	80	0.2500000
NODE_5627_length_1058_cov_9.953076	685	765	5	60	80	0.7500000
NODE_5628_length_1058_cov_6.294056	819	899	0	8	80	0.1000000
NODE_5628_length_1058_cov_6.294056	819	899	4	72	80	0.9000000
NODE_5628_length_1058_cov_6.294056	875	952	4	25	77	0.3246753
NODE_5628_length_1058_cov_6.294056	875	952	7	52	77	0.6753247
NODE_5637_length_1057_cov_43.191023	413	493	4	3	80	0.0375000
NODE_5637_length_1057_cov_43.191023	413	493	5	15	80	0.1875000
NODE_5637_length_1057_cov_43.191023	413	493	7	2	80	0.0250000
NODE_5637_length_1057_cov_43.191023	413	493	8	24	80	0.3000000
NODE_5637_length_1057_cov_43.191023	413	493	9	9	80	0.1125000
NODE_5637_length_1057_cov_43.191023	413	493	10	27	80	0.3375000
NODE_5637_length_1057_cov_43.191023	466	546	8	45	80	0.5625000
NODE_5637_length_1057_cov_43.191023	466	546	9	26	80	0.3250000
NODE_5637_length_1057_cov_43.191023	466	546	10	9	80	0.1125000
NODE_5637_length_1057_cov_43.191023	542	622	3	31	80	0.3875000
NODE_5637_length_1057_cov_43.191023	542	622	4	8	80	0.1000000
NODE_5637_length_1057_cov_43.191023	542	622	6	2	80	0.0250000
NODE_5637_length_1057_cov_43.191023	542	622	8	15	80	0.1875000
NODE_5637_length_1057_cov_43.191023	542	622	9	24	80	0.3000000
NODE_5637_length_1057_cov_43.191023	595	675	0	2	80	0.0250000
NODE_5637_length_1057_cov_43.191023	595	675	2	31	80	0.3875000
NODE_5637_length_1057_cov_43.191023	595	675	3	47	80	0.5875000
NODE_5638_length_1057_cov_27.387265	486	566	3	9	80	0.1125000
NODE_5638_length_1057_cov_27.387265	486	566	4	30	80	0.3750000
NODE_5638_length_1057_cov_27.387265	486	566	5	2	80	0.0250000
NODE_5638_length_1057_cov_27.387265	486	566	6	22	80	0.2750000
NODE_5638_length_1057_cov_27.387265	486	566	8	17	80	0.2125000
NODE_5638_length_1057_cov_27.387265	539	619	6	10	80	0.1250000
NODE_5638_length_1057_cov_27.387265	539	619	7	24	80	0.3000000
NODE_5638_length_1057_cov_27.387265	539	619	8	46	80	0.5750000
NODE_5639_length_1057_cov_16.489562	416	496	4	34	80	0.4250000
NODE_5639_length_1057_cov_16.489562	416	496	5	46	80	0.5750000
NODE_5639_length_1057_cov_16.489562	469	549	1	13	80	0.1625000
NODE_5639_length_1057_cov_16.489562	469	549	3	22	80	0.2750000
NODE_5639_length_1057_cov_16.489562	469	549	4	7	80	0.0875000
NODE_5639_length_1057_cov_16.489562	469	549	5	38	80	0.4750000
NODE_5640_length_1057_cov_13.605428	631	711	8	2	80	0.0250000
NODE_5640_length_1057_cov_13.605428	631	711	9	7	80	0.0875000
NODE_5640_length_1057_cov_13.605428	631	711	10	2	80	0.0250000
NODE_5640_length_1057_cov_13.605428	631	711	11	38	80	0.4750000
NODE_5640_length_1057_cov_13.605428	631	711	12	31	80	0.3875000
NODE_5640_length_1057_cov_13.605428	684	764	7	7	80	0.0875000
NODE_5640_length_1057_cov_13.605428	684	764	8	26	80	0.3250000
NODE_5640_length_1057_cov_13.605428	684	764	10	5	80	0.0625000
NODE_5640_length_1057_cov_13.605428	684	764	11	8	80	0.1000000
NODE_5640_length_1057_cov_13.605428	684	764	12	34	80	0.4250000
NODE_5641_length_1057_cov_12.768267	518	598	7	10	80	0.1250000
NODE_5641_length_1057_cov_12.768267	518	598	8	5	80	0.0625000
NODE_5641_length_1057_cov_12.768267	518	598	9	6	80	0.0750000
NODE_5641_length_1057_cov_12.768267	518	598	11	1	80	0.0125000
NODE_5641_length_1057_cov_12.768267	518	598	12	3	80	0.0375000
NODE_5641_length_1057_cov_12.768267	518	598	13	31	80	0.3875000
NODE_5641_length_1057_cov_12.768267	518	598	14	2	80	0.0250000
NODE_5641_length_1057_cov_12.768267	518	598	15	22	80	0.2750000
NODE_5641_length_1057_cov_12.768267	571	651	8	4	80	0.0500000
NODE_5641_length_1057_cov_12.768267	571	651	9	28	80	0.3500000
NODE_5641_length_1057_cov_12.768267	571	651	13	3	80	0.0375000
NODE_5641_length_1057_cov_12.768267	571	651	14	2	80	0.0250000
NODE_5641_length_1057_cov_12.768267	571	651	15	43	80	0.5375000
NODE_5644_length_1057_cov_7.692067	706	786	3	52	80	0.6500000
NODE_5644_length_1057_cov_7.692067	706	786	5	28	80	0.3500000
NODE_5644_length_1057_cov_7.692067	759	839	2	47	80	0.5875000
NODE_5644_length_1057_cov_7.692067	759	839	3	33	80	0.4125000
NODE_5645_length_1057_cov_6.697286	561	641	0	80	80	1.0000000
NODE_5645_length_1057_cov_6.697286	614	694	0	80	80	1.0000000
NODE_5654_length_1056_cov_57.539185	462	542	18	8	80	0.1000000
NODE_5654_length_1056_cov_57.539185	462	542	19	7	80	0.0875000
NODE_5654_length_1056_cov_57.539185	462	542	20	5	80	0.0625000
NODE_5654_length_1056_cov_57.539185	462	542	21	1	80	0.0125000
NODE_5654_length_1056_cov_57.539185	462	542	22	9	80	0.1125000
NODE_5654_length_1056_cov_57.539185	462	542	26	12	80	0.1500000
NODE_5654_length_1056_cov_57.539185	462	542	27	7	80	0.0875000
NODE_5654_length_1056_cov_57.539185	462	542	28	12	80	0.1500000
NODE_5654_length_1056_cov_57.539185	462	542	29	2	80	0.0250000
NODE_5654_length_1056_cov_57.539185	462	542	30	2	80	0.0250000
NODE_5654_length_1056_cov_57.539185	462	542	31	15	80	0.1875000
NODE_5654_length_1056_cov_57.539185	515	595	24	1	80	0.0125000
NODE_5654_length_1056_cov_57.539185	515	595	25	3	80	0.0375000
NODE_5654_length_1056_cov_57.539185	515	595	26	12	80	0.1500000
NODE_5654_length_1056_cov_57.539185	515	595	27	28	80	0.3500000
NODE_5654_length_1056_cov_57.539185	515	595	28	5	80	0.0625000
NODE_5654_length_1056_cov_57.539185	515	595	29	14	80	0.1750000
NODE_5654_length_1056_cov_57.539185	515	595	30	2	80	0.0250000
NODE_5654_length_1056_cov_57.539185	515	595	31	15	80	0.1875000
NODE_5655_length_1056_cov_35.751306	421	501	17	10	80	0.1250000
NODE_5655_length_1056_cov_35.751306	421	501	18	5	80	0.0625000
NODE_5655_length_1056_cov_35.751306	421	501	19	36	80	0.4500000
NODE_5655_length_1056_cov_35.751306	421	501	20	21	80	0.2625000
NODE_5655_length_1056_cov_35.751306	421	501	22	8	80	0.1000000
NODE_5655_length_1056_cov_35.751306	474	554	11	26	80	0.3250000
NODE_5655_length_1056_cov_35.751306	474	554	13	9	80	0.1125000
NODE_5655_length_1056_cov_35.751306	474	554	14	7	80	0.0875000
NODE_5655_length_1056_cov_35.751306	474	554	17	21	80	0.2625000
NODE_5655_length_1056_cov_35.751306	474	554	19	5	80	0.0625000
NODE_5655_length_1056_cov_35.751306	474	554	20	4	80	0.0500000
NODE_5655_length_1056_cov_35.751306	474	554	22	8	80	0.1000000
NODE_5656_length_1056_cov_29.749216	415	490	12	28	75	0.3733333
NODE_5656_length_1056_cov_29.749216	415	490	15	18	75	0.2400000
NODE_5656_length_1056_cov_29.749216	415	490	16	18	75	0.2400000
NODE_5656_length_1056_cov_29.749216	415	490	17	9	75	0.1200000
NODE_5656_length_1056_cov_29.749216	415	490	18	2	75	0.0266667
NODE_5656_length_1056_cov_29.749216	416	495	12	27	79	0.3417721
NODE_5656_length_1056_cov_29.749216	416	495	15	23	79	0.2911392
NODE_5656_length_1056_cov_29.749216	416	495	16	18	79	0.2278481
NODE_5656_length_1056_cov_29.749216	416	495	17	9	79	0.1139240
NODE_5656_length_1056_cov_29.749216	416	495	18	2	79	0.0253165
NODE_5656_length_1056_cov_29.749216	448	495	15	18	47	0.3829787
NODE_5656_length_1056_cov_29.749216	448	495	16	18	47	0.3829787
NODE_5656_length_1056_cov_29.749216	448	495	17	9	47	0.1914894
NODE_5656_length_1056_cov_29.749216	448	495	18	2	47	0.0425532
NODE_5656_length_1056_cov_29.749216	468	548	14	12	80	0.1500000
NODE_5656_length_1056_cov_29.749216	468	548	15	20	80	0.2500000
NODE_5656_length_1056_cov_29.749216	468	548	16	16	80	0.2000000
NODE_5656_length_1056_cov_29.749216	468	548	17	29	80	0.3625000
NODE_5656_length_1056_cov_29.749216	468	548	18	3	80	0.0375000
NODE_5656_length_1056_cov_29.749216	468	548	14	12	80	0.1500000
NODE_5656_length_1056_cov_29.749216	468	548	15	20	80	0.2500000
NODE_5656_length_1056_cov_29.749216	468	548	16	16	80	0.2000000
NODE_5656_length_1056_cov_29.749216	468	548	17	29	80	0.3625000
NODE_5656_length_1056_cov_29.749216	468	548	18	3	80	0.0375000
NODE_5656_length_1056_cov_29.749216	468	548	14	12	80	0.1500000
NODE_5656_length_1056_cov_29.749216	468	548	15	20	80	0.2500000
NODE_5656_length_1056_cov_29.749216	468	548	16	16	80	0.2000000
NODE_5656_length_1056_cov_29.749216	468	548	17	29	80	0.3625000
NODE_5656_length_1056_cov_29.749216	468	548	18	3	80	0.0375000
NODE_5657_length_1056_cov_25.342738	297	377	0	4	80	0.0500000
NODE_5657_length_1056_cov_25.342738	297	377	2	11	80	0.1375000
NODE_5657_length_1056_cov_25.342738	297	377	6	5	80	0.0625000
NODE_5657_length_1056_cov_25.342738	297	377	9	16	80	0.2000000
NODE_5657_length_1056_cov_25.342738	297	377	12	32	80	0.4000000
NODE_5657_length_1056_cov_25.342738	297	377	15	12	80	0.1500000
NODE_5657_length_1056_cov_25.342738	350	430	12	15	80	0.1875000
NODE_5657_length_1056_cov_25.342738	350	430	15	47	80	0.5875000
NODE_5657_length_1056_cov_25.342738	350	430	18	11	80	0.1375000
NODE_5657_length_1056_cov_25.342738	350	430	21	2	80	0.0250000
NODE_5657_length_1056_cov_25.342738	350	430	22	5	80	0.0625000
NODE_5657_length_1056_cov_25.342738	426	506	9	1	80	0.0125000
NODE_5657_length_1056_cov_25.342738	426	506	10	3	80	0.0375000
NODE_5657_length_1056_cov_25.342738	426	506	11	18	80	0.2250000
NODE_5657_length_1056_cov_25.342738	426	506	13	16	80	0.2000000
NODE_5657_length_1056_cov_25.342738	426	506	14	1	80	0.0125000
NODE_5657_length_1056_cov_25.342738	426	506	16	5	80	0.0625000
NODE_5657_length_1056_cov_25.342738	426	506	20	11	80	0.1375000
NODE_5657_length_1056_cov_25.342738	426	506	22	25	80	0.3125000
NODE_5657_length_1056_cov_25.342738	479	559	9	1	80	0.0125000
NODE_5657_length_1056_cov_25.342738	479	559	10	3	80	0.0375000
NODE_5657_length_1056_cov_25.342738	479	559	11	18	80	0.2250000
NODE_5657_length_1056_cov_25.342738	479	559	13	43	80	0.5375000
NODE_5657_length_1056_cov_25.342738	479	559	14	2	80	0.0250000
NODE_5657_length_1056_cov_25.342738	479	559	15	3	80	0.0375000
NODE_5657_length_1056_cov_25.342738	479	559	16	10	80	0.1250000
NODE_5658_length_1056_cov_24.094044	535	615	16	7	80	0.0875000
NODE_5658_length_1056_cov_24.094044	535	615	18	26	80	0.3250000
NODE_5658_length_1056_cov_24.094044	535	615	19	17	80	0.2125000
NODE_5658_length_1056_cov_24.094044	535	615	21	22	80	0.2750000
NODE_5658_length_1056_cov_24.094044	535	615	22	8	80	0.1000000
NODE_5658_length_1056_cov_24.094044	588	668	6	7	80	0.0875000
NODE_5658_length_1056_cov_24.094044	588	668	7	1	80	0.0125000
NODE_5658_length_1056_cov_24.094044	588	668	8	2	80	0.0250000
NODE_5658_length_1056_cov_24.094044	588	668	9	6	80	0.0750000
NODE_5658_length_1056_cov_24.094044	588	668	13	2	80	0.0250000
NODE_5658_length_1056_cov_24.094044	588	668	15	28	80	0.3500000
NODE_5658_length_1056_cov_24.094044	588	668	16	14	80	0.1750000
NODE_5658_length_1056_cov_24.094044	588	668	19	3	80	0.0375000
NODE_5658_length_1056_cov_24.094044	588	668	21	9	80	0.1125000
NODE_5658_length_1056_cov_24.094044	588	668	22	8	80	0.1000000
NODE_5659_length_1056_cov_20.700104	570	650	0	62	80	0.7750000
NODE_5659_length_1056_cov_20.700104	570	650	1	18	80	0.2250000
NODE_5659_length_1056_cov_20.700104	623	703	0	9	80	0.1125000
NODE_5659_length_1056_cov_20.700104	623	703	1	71	80	0.8875000
NODE_5660_length_1056_cov_14.215256	349	429	0	62	80	0.7750000
NODE_5660_length_1056_cov_14.215256	349	429	1	18	80	0.2250000
NODE_5660_length_1056_cov_14.215256	402	482	0	9	80	0.1125000
NODE_5660_length_1056_cov_14.215256	402	482	1	38	80	0.4750000
NODE_5660_length_1056_cov_14.215256	402	482	2	6	80	0.0750000
NODE_5660_length_1056_cov_14.215256	402	482	3	27	80	0.3375000
NODE_5660_length_1056_cov_14.215256	478	558	3	11	80	0.1375000
NODE_5660_length_1056_cov_14.215256	478	558	4	69	80	0.8625000
NODE_5660_length_1056_cov_14.215256	531	611	1	6	80	0.0750000
NODE_5660_length_1056_cov_14.215256	531	611	2	6	80	0.0750000
NODE_5660_length_1056_cov_14.215256	531	611	3	38	80	0.4750000
NODE_5660_length_1056_cov_14.215256	531	611	4	30	80	0.3750000
NODE_5661_length_1056_cov_13.782654	563	643	8	32	80	0.4000000
NODE_5661_length_1056_cov_13.782654	563	643	9	14	80	0.1750000
NODE_5661_length_1056_cov_13.782654	563	643	10	5	80	0.0625000
NODE_5661_length_1056_cov_13.782654	563	643	11	29	80	0.3625000
NODE_5661_length_1056_cov_13.782654	616	696	4	24	80	0.3000000
NODE_5661_length_1056_cov_13.782654	616	696	6	5	80	0.0625000
NODE_5661_length_1056_cov_13.782654	616	696	7	2	80	0.0250000
NODE_5661_length_1056_cov_13.782654	616	696	8	33	80	0.4125000
NODE_5661_length_1056_cov_13.782654	616	696	9	14	80	0.1750000
NODE_5661_length_1056_cov_13.782654	616	696	10	2	80	0.0250000
NODE_5663_length_1056_cov_9.298851	373	453	0	17	80	0.2125000
NODE_5663_length_1056_cov_9.298851	373	453	1	63	80	0.7875000
NODE_5663_length_1056_cov_9.298851	426	503	0	67	77	0.8701299
NODE_5663_length_1056_cov_9.298851	426	503	1	10	77	0.1298701
NODE_5665_length_1056_cov_6.157785	396	476	0	14	80	0.1750000
NODE_5665_length_1056_cov_6.157785	396	476	1	43	80	0.5375000
NODE_5665_length_1056_cov_6.157785	396	476	2	7	80	0.0875000
NODE_5665_length_1056_cov_6.157785	396	476	3	2	80	0.0250000
NODE_5665_length_1056_cov_6.157785	396	476	4	14	80	0.1750000
NODE_5665_length_1056_cov_6.157785	449	529	1	4	80	0.0500000
NODE_5665_length_1056_cov_6.157785	449	529	2	7	80	0.0875000
NODE_5665_length_1056_cov_6.157785	449	529	3	2	80	0.0250000
NODE_5665_length_1056_cov_6.157785	449	529	4	67	80	0.8375000
NODE_5666_length_1056_cov_6.034483	287	367	1	19	80	0.2375000
NODE_5666_length_1056_cov_6.034483	287	367	2	61	80	0.7625000
NODE_5666_length_1056_cov_6.034483	340	420	0	17	80	0.2125000
NODE_5666_length_1056_cov_6.034483	340	420	1	55	80	0.6875000
NODE_5666_length_1056_cov_6.034483	340	420	2	8	80	0.1000000
NODE_5667_length_1056_cov_3.259143	371	410	0	39	39	1.0000000
NODE_5667_length_1056_cov_3.259143	424	463	0	39	39	1.0000000
NODE_5668_length_1056_cov_2.362591	234	314	0	80	80	1.0000000
NODE_5672_length_1055_cov_36.460251	468	548	1	11	80	0.1375000
NODE_5672_length_1055_cov_36.460251	468	548	2	4	80	0.0500000
NODE_5672_length_1055_cov_36.460251	468	548	4	3	80	0.0375000
NODE_5672_length_1055_cov_36.460251	468	548	5	29	80	0.3625000
NODE_5672_length_1055_cov_36.460251	468	548	6	6	80	0.0750000
NODE_5672_length_1055_cov_36.460251	468	548	7	27	80	0.3375000
NODE_5672_length_1055_cov_36.460251	521	601	6	37	80	0.4625000
NODE_5672_length_1055_cov_36.460251	521	601	7	43	80	0.5375000
NODE_5673_length_1055_cov_31.235356	502	582	17	12	80	0.1500000
NODE_5673_length_1055_cov_31.235356	502	582	19	1	80	0.0125000
NODE_5673_length_1055_cov_31.235356	502	582	21	6	80	0.0750000
NODE_5673_length_1055_cov_31.235356	502	582	22	10	80	0.1250000
NODE_5673_length_1055_cov_31.235356	502	582	23	4	80	0.0500000
NODE_5673_length_1055_cov_31.235356	502	582	24	2	80	0.0250000
NODE_5673_length_1055_cov_31.235356	502	582	25	2	80	0.0250000
NODE_5673_length_1055_cov_31.235356	502	582	26	18	80	0.2250000
NODE_5673_length_1055_cov_31.235356	502	582	27	15	80	0.1875000
NODE_5673_length_1055_cov_31.235356	502	582	28	5	80	0.0625000
NODE_5673_length_1055_cov_31.235356	502	582	29	4	80	0.0500000
NODE_5673_length_1055_cov_31.235356	502	582	30	1	80	0.0125000
NODE_5673_length_1055_cov_31.235356	555	635	22	5	80	0.0625000
NODE_5673_length_1055_cov_31.235356	555	635	23	17	80	0.2125000
NODE_5673_length_1055_cov_31.235356	555	635	24	8	80	0.1000000
NODE_5673_length_1055_cov_31.235356	555	635	25	8	80	0.1000000
NODE_5673_length_1055_cov_31.235356	555	635	26	23	80	0.2875000
NODE_5673_length_1055_cov_31.235356	555	635	27	9	80	0.1125000
NODE_5673_length_1055_cov_31.235356	555	635	28	5	80	0.0625000
NODE_5673_length_1055_cov_31.235356	555	635	29	4	80	0.0500000
NODE_5673_length_1055_cov_31.235356	555	635	30	1	80	0.0125000
NODE_5674_length_1055_cov_23.330544	403	483	7	27	80	0.3375000
NODE_5674_length_1055_cov_23.330544	403	483	8	22	80	0.2750000
NODE_5674_length_1055_cov_23.330544	403	483	9	31	80	0.3875000
NODE_5674_length_1055_cov_23.330544	456	536	5	19	80	0.2375000
NODE_5674_length_1055_cov_23.330544	456	536	7	22	80	0.2750000
NODE_5674_length_1055_cov_23.330544	456	536	8	8	80	0.1000000
NODE_5674_length_1055_cov_23.330544	456	536	9	31	80	0.3875000
NODE_5674_length_1055_cov_23.330544	532	612	5	42	80	0.5250000
NODE_5674_length_1055_cov_23.330544	532	612	6	26	80	0.3250000
NODE_5674_length_1055_cov_23.330544	532	612	7	12	80	0.1500000
NODE_5674_length_1055_cov_23.330544	585	665	3	6	80	0.0750000
NODE_5674_length_1055_cov_23.330544	585	665	4	31	80	0.3875000
NODE_5674_length_1055_cov_23.330544	585	665	5	18	80	0.2250000
NODE_5674_length_1055_cov_23.330544	585	665	6	25	80	0.3125000
NODE_5675_length_1055_cov_19.541841	321	401	0	9	80	0.1125000
NODE_5675_length_1055_cov_19.541841	321	401	1	7	80	0.0875000
NODE_5675_length_1055_cov_19.541841	321	401	2	29	80	0.3625000
NODE_5675_length_1055_cov_19.541841	321	401	3	5	80	0.0625000
NODE_5675_length_1055_cov_19.541841	321	401	4	2	80	0.0250000
NODE_5675_length_1055_cov_19.541841	321	401	6	19	80	0.2375000
NODE_5675_length_1055_cov_19.541841	321	401	8	9	80	0.1125000
NODE_5675_length_1055_cov_19.541841	374	454	6	18	80	0.2250000
NODE_5675_length_1055_cov_19.541841	374	454	8	37	80	0.4625000
NODE_5675_length_1055_cov_19.541841	374	454	10	25	80	0.3125000
NODE_5676_length_1055_cov_15.744770	525	605	0	80	80	1.0000000
NODE_5676_length_1055_cov_15.744770	578	658	0	80	80	1.0000000
NODE_5677_length_1055_cov_10.729079	335	415	0	80	80	1.0000000
NODE_5677_length_1055_cov_10.729079	388	468	0	80	80	1.0000000
NODE_5678_length_1055_cov_7.525105	575	655	0	1	80	0.0125000
NODE_5678_length_1055_cov_7.525105	575	655	1	58	80	0.7250000
NODE_5678_length_1055_cov_7.525105	575	655	2	1	80	0.0125000
NODE_5678_length_1055_cov_7.525105	575	655	4	20	80	0.2500000
NODE_5678_length_1055_cov_7.525105	628	708	1	6	80	0.0750000
NODE_5678_length_1055_cov_7.525105	628	708	2	1	80	0.0125000
NODE_5678_length_1055_cov_7.525105	628	708	4	73	80	0.9125000
NODE_5688_length_1054_cov_45.920419	371	451	16	24	80	0.3000000
NODE_5688_length_1054_cov_45.920419	371	451	17	5	80	0.0625000
NODE_5688_length_1054_cov_45.920419	371	451	18	5	80	0.0625000
NODE_5688_length_1054_cov_45.920419	371	451	19	31	80	0.3875000
NODE_5688_length_1054_cov_45.920419	371	451	20	10	80	0.1250000
NODE_5688_length_1054_cov_45.920419	371	451	22	5	80	0.0625000
NODE_5688_length_1054_cov_45.920419	424	505	13	1	81	0.0123457
NODE_5688_length_1054_cov_45.920419	424	505	14	22	81	0.2716049
NODE_5688_length_1054_cov_45.920419	424	505	16	22	81	0.2716049
NODE_5688_length_1054_cov_45.920419	424	505	17	14	81	0.1728395
NODE_5688_length_1054_cov_45.920419	424	505	18	4	81	0.0493827
NODE_5688_length_1054_cov_45.920419	424	505	19	4	81	0.0493827
NODE_5688_length_1054_cov_45.920419	424	505	20	10	81	0.1234568
NODE_5688_length_1054_cov_45.920419	424	505	22	4	81	0.0493827
NODE_5689_length_1054_cov_30.545550	499	578	8	6	79	0.0759494
NODE_5689_length_1054_cov_30.545550	499	578	10	11	79	0.1392405
NODE_5689_length_1054_cov_30.545550	499	578	11	21	79	0.2658228
NODE_5689_length_1054_cov_30.545550	499	578	12	41	79	0.5189874
NODE_5689_length_1054_cov_30.545550	552	631	6	38	79	0.4810127
NODE_5689_length_1054_cov_30.545550	552	631	7	10	79	0.1265823
NODE_5689_length_1054_cov_30.545550	552	631	8	11	79	0.1392405
NODE_5689_length_1054_cov_30.545550	552	631	10	5	79	0.0632911
NODE_5689_length_1054_cov_30.545550	552	631	11	15	79	0.1898734
NODE_5689_length_1054_cov_30.545550	627	707	2	49	80	0.6125000
NODE_5689_length_1054_cov_30.545550	627	707	3	4	80	0.0500000
NODE_5689_length_1054_cov_30.545550	627	707	4	23	80	0.2875000
NODE_5689_length_1054_cov_30.545550	627	707	6	2	80	0.0250000
NODE_5689_length_1054_cov_30.545550	627	707	7	2	80	0.0250000
NODE_5689_length_1054_cov_30.545550	680	760	1	16	80	0.2000000
NODE_5689_length_1054_cov_30.545550	680	760	2	64	80	0.8000000
NODE_5690_length_1054_cov_16.606283	347	427	1	71	80	0.8875000
NODE_5690_length_1054_cov_16.606283	347	427	2	9	80	0.1125000
NODE_5690_length_1054_cov_16.606283	400	480	1	23	80	0.2875000
NODE_5690_length_1054_cov_16.606283	400	480	2	43	80	0.5375000
NODE_5690_length_1054_cov_16.606283	400	480	3	14	80	0.1750000
NODE_5691_length_1054_cov_11.637696	244	316	1	66	72	0.9166667
NODE_5691_length_1054_cov_11.637696	244	316	2	6	72	0.0833333
NODE_5691_length_1054_cov_11.637696	312	392	2	55	80	0.6875000
NODE_5691_length_1054_cov_11.637696	312	392	3	8	80	0.1000000
NODE_5691_length_1054_cov_11.637696	312	392	4	17	80	0.2125000
NODE_5691_length_1054_cov_11.637696	365	445	2	2	80	0.0250000
NODE_5691_length_1054_cov_11.637696	365	445	3	36	80	0.4500000
NODE_5691_length_1054_cov_11.637696	365	445	4	17	80	0.2125000
NODE_5691_length_1054_cov_11.637696	365	445	5	8	80	0.1000000
NODE_5691_length_1054_cov_11.637696	365	445	7	17	80	0.2125000
NODE_5692_length_1054_cov_10.381152	493	573	1	14	80	0.1750000
NODE_5692_length_1054_cov_10.381152	493	573	2	66	80	0.8250000
NODE_5692_length_1054_cov_10.381152	546	626	1	28	80	0.3500000
NODE_5692_length_1054_cov_10.381152	546	626	2	52	80	0.6500000
NODE_5703_length_1053_cov_57.660377	445	527	6	23	82	0.2804878
NODE_5703_length_1053_cov_57.660377	445	527	9	2	82	0.0243902
NODE_5703_length_1053_cov_57.660377	445	527	10	57	82	0.6951219
NODE_5703_length_1053_cov_57.660377	500	580	9	4	80	0.0500000
NODE_5703_length_1053_cov_57.660377	500	580	10	31	80	0.3875000
NODE_5703_length_1053_cov_57.660377	500	580	11	13	80	0.1625000
NODE_5703_length_1053_cov_57.660377	500	580	12	1	80	0.0125000
NODE_5703_length_1053_cov_57.660377	500	580	13	31	80	0.3875000
NODE_5704_length_1053_cov_33.518868	329	409	2	66	80	0.8250000
NODE_5704_length_1053_cov_33.518868	329	409	4	14	80	0.1750000
NODE_5704_length_1053_cov_33.518868	382	462	2	80	80	1.0000000
NODE_5704_length_1053_cov_33.518868	458	538	0	23	80	0.2875000
NODE_5704_length_1053_cov_33.518868	458	538	2	57	80	0.7125000
NODE_5704_length_1053_cov_33.518868	511	591	0	12	80	0.1500000
NODE_5704_length_1053_cov_33.518868	511	591	2	68	80	0.8500000
NODE_5705_length_1053_cov_32.412998	375	455	3	2	80	0.0250000
NODE_5705_length_1053_cov_32.412998	375	455	4	12	80	0.1500000
NODE_5705_length_1053_cov_32.412998	375	455	8	14	80	0.1750000
NODE_5705_length_1053_cov_32.412998	375	455	9	4	80	0.0500000
NODE_5705_length_1053_cov_32.412998	375	455	11	4	80	0.0500000
NODE_5705_length_1053_cov_32.412998	375	455	14	13	80	0.1625000
NODE_5705_length_1053_cov_32.412998	375	455	15	1	80	0.0125000
NODE_5705_length_1053_cov_32.412998	375	455	16	7	80	0.0875000
NODE_5705_length_1053_cov_32.412998	375	455	17	10	80	0.1250000
NODE_5705_length_1053_cov_32.412998	375	455	18	10	80	0.1250000
NODE_5705_length_1053_cov_32.412998	375	455	19	3	80	0.0375000
NODE_5705_length_1053_cov_32.412998	428	508	16	4	80	0.0500000
NODE_5705_length_1053_cov_32.412998	428	508	17	10	80	0.1250000
NODE_5705_length_1053_cov_32.412998	428	508	18	20	80	0.2500000
NODE_5705_length_1053_cov_32.412998	428	508	19	5	80	0.0625000
NODE_5705_length_1053_cov_32.412998	428	508	21	9	80	0.1125000
NODE_5705_length_1053_cov_32.412998	428	508	22	6	80	0.0750000
NODE_5705_length_1053_cov_32.412998	428	508	23	2	80	0.0250000
NODE_5705_length_1053_cov_32.412998	428	508	24	17	80	0.2125000
NODE_5705_length_1053_cov_32.412998	428	508	25	7	80	0.0875000
NODE_5705_length_1053_cov_32.412998	504	584	17	2	80	0.0250000
NODE_5705_length_1053_cov_32.412998	504	584	18	8	80	0.1000000
NODE_5705_length_1053_cov_32.412998	504	584	20	14	80	0.1750000
NODE_5705_length_1053_cov_32.412998	504	584	21	2	80	0.0250000
NODE_5705_length_1053_cov_32.412998	504	584	22	1	80	0.0125000
NODE_5705_length_1053_cov_32.412998	504	584	23	4	80	0.0500000
NODE_5705_length_1053_cov_32.412998	504	584	24	35	80	0.4375000
NODE_5705_length_1053_cov_32.412998	504	584	25	4	80	0.0500000
NODE_5705_length_1053_cov_32.412998	504	584	26	10	80	0.1250000
NODE_5705_length_1053_cov_32.412998	557	637	17	9	80	0.1125000
NODE_5705_length_1053_cov_32.412998	557	637	18	8	80	0.1000000
NODE_5705_length_1053_cov_32.412998	557	637	20	23	80	0.2875000
NODE_5705_length_1053_cov_32.412998	557	637	21	7	80	0.0875000
NODE_5705_length_1053_cov_32.412998	557	637	22	11	80	0.1375000
NODE_5705_length_1053_cov_32.412998	557	637	23	18	80	0.2250000
NODE_5705_length_1053_cov_32.412998	557	637	25	1	80	0.0125000
NODE_5705_length_1053_cov_32.412998	557	637	26	3	80	0.0375000
NODE_5706_length_1053_cov_26.545073	456	536	5	54	80	0.6750000
NODE_5706_length_1053_cov_26.545073	456	536	6	2	80	0.0250000
NODE_5706_length_1053_cov_26.545073	456	536	7	1	80	0.0125000
NODE_5706_length_1053_cov_26.545073	456	536	8	23	80	0.2875000
NODE_5706_length_1053_cov_26.545073	509	589	4	28	80	0.3500000
NODE_5706_length_1053_cov_26.545073	509	589	5	25	80	0.3125000
NODE_5706_length_1053_cov_26.545073	509	589	6	27	80	0.3375000
NODE_5706_length_1053_cov_26.545073	585	665	4	42	80	0.5250000
NODE_5706_length_1053_cov_26.545073	585	665	5	14	80	0.1750000
NODE_5706_length_1053_cov_26.545073	585	665	6	24	80	0.3000000
NODE_5706_length_1053_cov_26.545073	638	718	4	3	80	0.0375000
NODE_5706_length_1053_cov_26.545073	638	718	5	2	80	0.0250000
NODE_5706_length_1053_cov_26.545073	638	718	6	65	80	0.8125000
NODE_5706_length_1053_cov_26.545073	638	718	7	10	80	0.1250000
NODE_5707_length_1053_cov_20.346960	543	623	12	18	80	0.2250000
NODE_5707_length_1053_cov_20.346960	543	623	13	23	80	0.2875000
NODE_5707_length_1053_cov_20.346960	543	623	14	22	80	0.2750000
NODE_5707_length_1053_cov_20.346960	543	623	15	3	80	0.0375000
NODE_5707_length_1053_cov_20.346960	543	623	16	14	80	0.1750000
NODE_5707_length_1053_cov_20.346960	596	677	9	10	81	0.1234568
NODE_5707_length_1053_cov_20.346960	596	677	13	9	81	0.1111111
NODE_5707_length_1053_cov_20.346960	596	677	14	10	81	0.1234568
NODE_5707_length_1053_cov_20.346960	596	677	15	16	81	0.1975309
NODE_5707_length_1053_cov_20.346960	596	677	16	14	81	0.1728395
NODE_5707_length_1053_cov_20.346960	596	677	17	16	81	0.1975309
NODE_5707_length_1053_cov_20.346960	596	677	18	6	81	0.0740741
NODE_5708_length_1053_cov_11.655136	393	473	13	33	80	0.4125000
NODE_5708_length_1053_cov_11.655136	393	473	14	27	80	0.3375000
NODE_5708_length_1053_cov_11.655136	393	473	15	20	80	0.2500000
NODE_5708_length_1053_cov_11.655136	446	526	14	7	80	0.0875000
NODE_5708_length_1053_cov_11.655136	446	526	15	40	80	0.5000000
NODE_5708_length_1053_cov_11.655136	446	526	18	33	80	0.4125000
NODE_5710_length_1053_cov_4.771488	84	149	3	12	65	0.1846154
NODE_5710_length_1053_cov_4.771488	84	149	6	53	65	0.8153846
NODE_5718_length_1052_cov_18.469045	448	528	0	80	80	1.0000000
NODE_5718_length_1052_cov_18.469045	501	581	0	48	80	0.6000000
NODE_5718_length_1052_cov_18.469045	501	581	4	32	80	0.4000000
NODE_5719_length_1052_cov_13.136411	425	505	11	3	80	0.0375000
NODE_5719_length_1052_cov_13.136411	425	505	12	14	80	0.1750000
NODE_5719_length_1052_cov_13.136411	425	505	13	43	80	0.5375000
NODE_5719_length_1052_cov_13.136411	425	505	17	20	80	0.2500000
NODE_5719_length_1052_cov_13.136411	478	558	3	9	80	0.1125000
NODE_5719_length_1052_cov_13.136411	478	558	5	14	80	0.1750000
NODE_5719_length_1052_cov_13.136411	478	558	9	1	80	0.0125000
NODE_5719_length_1052_cov_13.136411	478	558	12	43	80	0.5375000
NODE_5719_length_1052_cov_13.136411	478	558	13	13	80	0.1625000
NODE_5722_length_1052_cov_3.082896	607	687	2	71	80	0.8875000
NODE_5722_length_1052_cov_3.082896	607	687	4	9	80	0.1125000
NODE_5722_length_1052_cov_3.082896	660	740	2	31	80	0.3875000
NODE_5722_length_1052_cov_3.082896	660	740	4	49	80	0.6125000
NODE_5729_length_1051_cov_34.868697	472	552	19	15	80	0.1875000
NODE_5729_length_1051_cov_34.868697	472	552	20	1	80	0.0125000
NODE_5729_length_1051_cov_34.868697	472	552	21	2	80	0.0250000
NODE_5729_length_1051_cov_34.868697	472	552	22	8	80	0.1000000
NODE_5729_length_1051_cov_34.868697	472	552	23	4	80	0.0500000
NODE_5729_length_1051_cov_34.868697	472	552	24	3	80	0.0375000
NODE_5729_length_1051_cov_34.868697	472	552	25	45	80	0.5625000
NODE_5729_length_1051_cov_34.868697	472	552	26	2	80	0.0250000
NODE_5729_length_1051_cov_34.868697	525	605	13	22	80	0.2750000
NODE_5729_length_1051_cov_34.868697	525	605	14	5	80	0.0625000
NODE_5729_length_1051_cov_34.868697	525	605	15	7	80	0.0875000
NODE_5729_length_1051_cov_34.868697	525	605	17	9	80	0.1125000
NODE_5729_length_1051_cov_34.868697	525	605	18	5	80	0.0625000
NODE_5729_length_1051_cov_34.868697	525	605	19	17	80	0.2125000
NODE_5729_length_1051_cov_34.868697	525	605	20	3	80	0.0375000
NODE_5729_length_1051_cov_34.868697	525	605	21	3	80	0.0375000
NODE_5729_length_1051_cov_34.868697	525	605	22	5	80	0.0625000
NODE_5729_length_1051_cov_34.868697	525	605	25	4	80	0.0500000
NODE_5730_length_1051_cov_19.446429	549	629	4	20	80	0.2500000
NODE_5730_length_1051_cov_19.446429	549	629	5	10	80	0.1250000
NODE_5730_length_1051_cov_19.446429	549	629	6	6	80	0.0750000
NODE_5730_length_1051_cov_19.446429	549	629	7	11	80	0.1375000
NODE_5730_length_1051_cov_19.446429	549	629	8	1	80	0.0125000
NODE_5730_length_1051_cov_19.446429	549	629	9	9	80	0.1125000
NODE_5730_length_1051_cov_19.446429	549	629	13	1	80	0.0125000
NODE_5730_length_1051_cov_19.446429	549	629	14	5	80	0.0625000
NODE_5730_length_1051_cov_19.446429	549	629	15	17	80	0.2125000
NODE_5730_length_1051_cov_19.446429	602	682	9	4	80	0.0500000
NODE_5730_length_1051_cov_19.446429	602	682	13	10	80	0.1250000
NODE_5730_length_1051_cov_19.446429	602	682	14	19	80	0.2375000
NODE_5730_length_1051_cov_19.446429	602	682	15	42	80	0.5250000
NODE_5730_length_1051_cov_19.446429	602	682	16	5	80	0.0625000
NODE_5731_length_1051_cov_4.022059	600	680	0	80	80	1.0000000
NODE_5736_length_1050_cov_31.556257	429	509	7	24	80	0.3000000
NODE_5736_length_1050_cov_31.556257	429	509	8	29	80	0.3625000
NODE_5736_length_1050_cov_31.556257	429	509	9	19	80	0.2375000
NODE_5736_length_1050_cov_31.556257	429	509	10	7	80	0.0875000
NODE_5736_length_1050_cov_31.556257	429	509	11	1	80	0.0125000
NODE_5736_length_1050_cov_31.556257	482	562	4	9	80	0.1125000
NODE_5736_length_1050_cov_31.556257	482	562	6	25	80	0.3125000
NODE_5736_length_1050_cov_31.556257	482	562	7	43	80	0.5375000
NODE_5736_length_1050_cov_31.556257	482	562	8	1	80	0.0125000
NODE_5736_length_1050_cov_31.556257	482	562	9	2	80	0.0250000
NODE_5736_length_1050_cov_31.556257	558	638	2	31	80	0.3875000
NODE_5736_length_1050_cov_31.556257	558	638	4	47	80	0.5875000
NODE_5736_length_1050_cov_31.556257	558	638	5	2	80	0.0250000
NODE_5736_length_1050_cov_31.556257	611	691	2	58	80	0.7250000
NODE_5736_length_1050_cov_31.556257	611	691	3	22	80	0.2750000
NODE_5737_length_1050_cov_16.337539	398	478	9	11	80	0.1375000
NODE_5737_length_1050_cov_16.337539	398	478	10	36	80	0.4500000
NODE_5737_length_1050_cov_16.337539	398	478	11	3	80	0.0375000
NODE_5737_length_1050_cov_16.337539	398	478	12	4	80	0.0500000
NODE_5737_length_1050_cov_16.337539	398	478	14	25	80	0.3125000
NODE_5737_length_1050_cov_16.337539	398	478	16	1	80	0.0125000
NODE_5737_length_1050_cov_16.337539	451	531	10	1	80	0.0125000
NODE_5737_length_1050_cov_16.337539	451	531	11	47	80	0.5875000
NODE_5737_length_1050_cov_16.337539	451	531	12	1	80	0.0125000
NODE_5737_length_1050_cov_16.337539	451	531	13	4	80	0.0500000
NODE_5737_length_1050_cov_16.337539	451	531	14	26	80	0.3250000
NODE_5737_length_1050_cov_16.337539	451	531	16	1	80	0.0125000
NODE_5738_length_1050_cov_13.290221	507	587	2	30	80	0.3750000
NODE_5738_length_1050_cov_13.290221	507	587	5	23	80	0.2875000
NODE_5738_length_1050_cov_13.290221	507	587	6	27	80	0.3375000
NODE_5738_length_1050_cov_13.290221	560	640	4	26	80	0.3250000
NODE_5738_length_1050_cov_13.290221	560	640	5	43	80	0.5375000
NODE_5738_length_1050_cov_13.290221	560	640	6	4	80	0.0500000
NODE_5738_length_1050_cov_13.290221	560	640	7	1	80	0.0125000
NODE_5738_length_1050_cov_13.290221	560	640	8	6	80	0.0750000
NODE_5739_length_1050_cov_11.389064	532	612	1	10	80	0.1250000
NODE_5739_length_1050_cov_11.389064	532	612	2	31	80	0.3875000
NODE_5739_length_1050_cov_11.389064	532	612	4	39	80	0.4875000
NODE_5739_length_1050_cov_11.389064	585	665	3	12	80	0.1500000
NODE_5739_length_1050_cov_11.389064	585	665	4	68	80	0.8500000
NODE_5740_length_1050_cov_11.091483	259	321	0	16	62	0.2580645
NODE_5740_length_1050_cov_11.091483	259	321	2	46	62	0.7419355
NODE_5740_length_1050_cov_11.091483	294	374	2	29	80	0.3625000
NODE_5740_length_1050_cov_11.091483	294	374	4	51	80	0.6375000
NODE_5740_length_1050_cov_11.091483	370	450	3	25	80	0.3125000
NODE_5740_length_1050_cov_11.091483	370	450	4	33	80	0.4125000
NODE_5740_length_1050_cov_11.091483	370	450	5	22	80	0.2750000
NODE_5740_length_1050_cov_11.091483	423	503	1	8	80	0.1000000
NODE_5740_length_1050_cov_11.091483	423	503	2	22	80	0.2750000
NODE_5740_length_1050_cov_11.091483	423	503	3	48	80	0.6000000
NODE_5740_length_1050_cov_11.091483	423	503	5	2	80	0.0250000
NODE_5742_length_1050_cov_2.201893	928	990	0	62	62	1.0000000
NODE_5742_length_1050_cov_2.201893	981	1043	0	62	62	1.0000000
NODE_5748_length_1050_cov_1.241851	935	990	0	55	55	1.0000000
NODE_5748_length_1050_cov_1.241851	956	1036	0	80	80	1.0000000
NODE_5752_length_1049_cov_28.174737	446	526	3	11	80	0.1375000
NODE_5752_length_1049_cov_28.174737	446	526	4	10	80	0.1250000
NODE_5752_length_1049_cov_28.174737	446	526	5	7	80	0.0875000
NODE_5752_length_1049_cov_28.174737	446	526	6	12	80	0.1500000
NODE_5752_length_1049_cov_28.174737	446	526	7	29	80	0.3625000
NODE_5752_length_1049_cov_28.174737	446	526	8	11	80	0.1375000
NODE_5752_length_1049_cov_28.174737	499	579	7	26	80	0.3250000
NODE_5752_length_1049_cov_28.174737	499	579	8	30	80	0.3750000
NODE_5752_length_1049_cov_28.174737	499	579	9	24	80	0.3000000
NODE_5753_length_1049_cov_23.186316	389	469	5	14	80	0.1750000
NODE_5753_length_1049_cov_23.186316	389	469	6	26	80	0.3250000
NODE_5753_length_1049_cov_23.186316	389	469	7	25	80	0.3125000
NODE_5753_length_1049_cov_23.186316	389	469	8	15	80	0.1875000
NODE_5753_length_1049_cov_23.186316	442	522	5	3	80	0.0375000
NODE_5753_length_1049_cov_23.186316	442	522	6	17	80	0.2125000
NODE_5753_length_1049_cov_23.186316	442	522	7	34	80	0.4250000
NODE_5753_length_1049_cov_23.186316	442	522	8	26	80	0.3250000
NODE_5753_length_1049_cov_23.186316	518	595	2	19	77	0.2467532
NODE_5753_length_1049_cov_23.186316	518	595	4	23	77	0.2987013
NODE_5753_length_1049_cov_23.186316	518	595	5	34	77	0.4415585
NODE_5753_length_1049_cov_23.186316	518	595	6	1	77	0.0129870
NODE_5753_length_1049_cov_23.186316	568	648	0	1	80	0.0125000
NODE_5753_length_1049_cov_23.186316	568	648	1	46	80	0.5750000
NODE_5753_length_1049_cov_23.186316	568	648	2	25	80	0.3125000
NODE_5753_length_1049_cov_23.186316	568	648	4	8	80	0.1000000
NODE_5754_length_1049_cov_21.097895	532	612	8	17	80	0.2125000
NODE_5754_length_1049_cov_21.097895	532	612	9	12	80	0.1500000
NODE_5754_length_1049_cov_21.097895	532	612	10	14	80	0.1750000
NODE_5754_length_1049_cov_21.097895	532	612	13	20	80	0.2500000
NODE_5754_length_1049_cov_21.097895	532	612	14	17	80	0.2125000
NODE_5754_length_1049_cov_21.097895	585	665	7	12	80	0.1500000
NODE_5754_length_1049_cov_21.097895	585	665	8	3	80	0.0375000
NODE_5754_length_1049_cov_21.097895	585	665	13	10	80	0.1250000
NODE_5754_length_1049_cov_21.097895	585	665	14	36	80	0.4500000
NODE_5754_length_1049_cov_21.097895	585	665	15	19	80	0.2375000
NODE_5755_length_1049_cov_18.964211	375	466	3	5	91	0.0549451
NODE_5755_length_1049_cov_18.964211	375	466	4	47	91	0.5164835
NODE_5755_length_1049_cov_18.964211	375	466	7	35	91	0.3846154
NODE_5755_length_1049_cov_18.964211	375	466	8	4	91	0.0439560
NODE_5755_length_1049_cov_18.964211	439	519	2	4	80	0.0500000
NODE_5755_length_1049_cov_18.964211	439	519	3	54	80	0.6750000
NODE_5755_length_1049_cov_18.964211	439	519	4	22	80	0.2750000
NODE_5755_length_1049_cov_18.964211	515	595	0	68	80	0.8500000
NODE_5755_length_1049_cov_18.964211	515	595	1	1	80	0.0125000
NODE_5755_length_1049_cov_18.964211	515	595	2	11	80	0.1375000
NODE_5755_length_1049_cov_18.964211	568	648	0	80	80	1.0000000
NODE_5756_length_1049_cov_18.075789	437	517	7	36	80	0.4500000
NODE_5756_length_1049_cov_18.075789	437	517	10	44	80	0.5500000
NODE_5756_length_1049_cov_18.075789	490	570	6	23	80	0.2875000
NODE_5756_length_1049_cov_18.075789	490	570	7	41	80	0.5125000
NODE_5756_length_1049_cov_18.075789	490	570	8	10	80	0.1250000
NODE_5756_length_1049_cov_18.075789	490	570	10	6	80	0.0750000
NODE_5756_length_1049_cov_18.075789	566	644	7	1	78	0.0128205
NODE_5756_length_1049_cov_18.075789	566	644	8	17	78	0.2179487
NODE_5756_length_1049_cov_18.075789	566	644	9	12	78	0.1538462
NODE_5756_length_1049_cov_18.075789	566	644	10	3	78	0.0384615
NODE_5756_length_1049_cov_18.075789	566	644	11	45	78	0.5769231
NODE_5756_length_1049_cov_18.075789	620	695	7	1	75	0.0133333
NODE_5756_length_1049_cov_18.075789	620	695	8	13	75	0.1733333
NODE_5756_length_1049_cov_18.075789	620	695	11	29	75	0.3866667
NODE_5756_length_1049_cov_18.075789	620	695	12	32	75	0.4266667
NODE_5757_length_1049_cov_16.194737	569	650	4	6	81	0.0740741
NODE_5757_length_1049_cov_16.194737	569	650	8	23	81	0.2839506
NODE_5757_length_1049_cov_16.194737	569	650	9	12	81	0.1481481
NODE_5757_length_1049_cov_16.194737	569	650	11	24	81	0.2962963
NODE_5757_length_1049_cov_16.194737	569	650	12	16	81	0.1975309
NODE_5757_length_1049_cov_16.194737	623	703	3	35	80	0.4375000
NODE_5757_length_1049_cov_16.194737	623	703	4	24	80	0.3000000
NODE_5757_length_1049_cov_16.194737	623	703	8	13	80	0.1625000
NODE_5757_length_1049_cov_16.194737	623	703	12	8	80	0.1000000
NODE_5757_length_1049_cov_16.194737	699	779	1	14	80	0.1750000
NODE_5757_length_1049_cov_16.194737	699	779	2	30	80	0.3750000
NODE_5757_length_1049_cov_16.194737	699	779	3	21	80	0.2625000
NODE_5757_length_1049_cov_16.194737	699	779	4	15	80	0.1875000
NODE_5757_length_1049_cov_16.194737	752	832	1	67	80	0.8375000
NODE_5757_length_1049_cov_16.194737	752	832	2	13	80	0.1625000
NODE_5759_length_1049_cov_6.323158	588	668	6	13	80	0.1625000
NODE_5759_length_1049_cov_6.323158	588	668	7	39	80	0.4875000
NODE_5759_length_1049_cov_6.323158	588	668	10	28	80	0.3500000
NODE_5759_length_1049_cov_6.323158	641	721	4	10	80	0.1250000
NODE_5759_length_1049_cov_6.323158	641	721	5	27	80	0.3375000
NODE_5759_length_1049_cov_6.323158	641	721	6	11	80	0.1375000
NODE_5759_length_1049_cov_6.323158	641	721	7	1	80	0.0125000
NODE_5759_length_1049_cov_6.323158	641	721	10	31	80	0.3875000
NODE_5770_length_1048_cov_73.887250	535	615	18	1	80	0.0125000
NODE_5770_length_1048_cov_73.887250	535	615	20	4	80	0.0500000
NODE_5770_length_1048_cov_73.887250	535	615	21	18	80	0.2250000
NODE_5770_length_1048_cov_73.887250	535	615	22	35	80	0.4375000
NODE_5770_length_1048_cov_73.887250	535	615	23	9	80	0.1125000
NODE_5770_length_1048_cov_73.887250	535	615	25	5	80	0.0625000
NODE_5770_length_1048_cov_73.887250	535	615	26	8	80	0.1000000
NODE_5770_length_1048_cov_73.887250	588	668	18	1	80	0.0125000
NODE_5770_length_1048_cov_73.887250	588	668	19	10	80	0.1250000
NODE_5770_length_1048_cov_73.887250	588	668	21	4	80	0.0500000
NODE_5770_length_1048_cov_73.887250	588	668	22	17	80	0.2125000
NODE_5770_length_1048_cov_73.887250	588	668	23	3	80	0.0375000
NODE_5770_length_1048_cov_73.887250	588	668	24	1	80	0.0125000
NODE_5770_length_1048_cov_73.887250	588	668	25	32	80	0.4000000
NODE_5770_length_1048_cov_73.887250	588	668	26	12	80	0.1500000
NODE_5770_length_1048_cov_73.887250	664	744	10	4	80	0.0500000
NODE_5770_length_1048_cov_73.887250	664	744	11	31	80	0.3875000
NODE_5770_length_1048_cov_73.887250	664	744	12	14	80	0.1750000
NODE_5770_length_1048_cov_73.887250	664	744	13	5	80	0.0625000
NODE_5770_length_1048_cov_73.887250	664	744	14	6	80	0.0750000
NODE_5770_length_1048_cov_73.887250	664	744	15	10	80	0.1250000
NODE_5770_length_1048_cov_73.887250	664	744	17	3	80	0.0375000
NODE_5770_length_1048_cov_73.887250	664	744	18	1	80	0.0125000
NODE_5770_length_1048_cov_73.887250	664	744	19	6	80	0.0750000
NODE_5770_length_1048_cov_73.887250	717	797	5	40	80	0.5000000
NODE_5770_length_1048_cov_73.887250	717	797	6	5	80	0.0625000
NODE_5770_length_1048_cov_73.887250	717	797	10	12	80	0.1500000
NODE_5770_length_1048_cov_73.887250	717	797	11	22	80	0.2750000
NODE_5770_length_1048_cov_73.887250	717	797	12	1	80	0.0125000
NODE_5770_length_1048_cov_73.887250	899	979	0	11	80	0.1375000
NODE_5770_length_1048_cov_73.887250	899	979	1	69	80	0.8625000
NODE_5771_length_1048_cov_48.242360	407	487	5	15	80	0.1875000
NODE_5771_length_1048_cov_48.242360	407	487	6	43	80	0.5375000
NODE_5771_length_1048_cov_48.242360	407	487	7	4	80	0.0500000
NODE_5771_length_1048_cov_48.242360	407	487	8	18	80	0.2250000
NODE_5771_length_1048_cov_48.242360	460	540	6	13	80	0.1625000
NODE_5771_length_1048_cov_48.242360	460	540	7	31	80	0.3875000
NODE_5771_length_1048_cov_48.242360	460	540	8	36	80	0.4500000
NODE_5771_length_1048_cov_48.242360	536	616	6	6	80	0.0750000
NODE_5771_length_1048_cov_48.242360	536	616	7	9	80	0.1125000
NODE_5771_length_1048_cov_48.242360	536	616	8	9	80	0.1125000
NODE_5771_length_1048_cov_48.242360	536	616	9	20	80	0.2500000
NODE_5771_length_1048_cov_48.242360	536	616	10	8	80	0.1000000
NODE_5771_length_1048_cov_48.242360	536	616	11	28	80	0.3500000
NODE_5771_length_1048_cov_48.242360	589	669	8	36	80	0.4500000
NODE_5771_length_1048_cov_48.242360	589	669	9	22	80	0.2750000
NODE_5771_length_1048_cov_48.242360	589	669	11	22	80	0.2750000
NODE_5772_length_1048_cov_38.430980	352	432	3	8	80	0.1000000
NODE_5772_length_1048_cov_38.430980	352	432	4	5	80	0.0625000
NODE_5772_length_1048_cov_38.430980	352	432	6	2	80	0.0250000
NODE_5772_length_1048_cov_38.430980	352	432	8	61	80	0.7625000
NODE_5772_length_1048_cov_38.430980	352	432	9	2	80	0.0250000
NODE_5772_length_1048_cov_38.430980	352	432	11	2	80	0.0250000
NODE_5772_length_1048_cov_38.430980	405	485	3	11	80	0.1375000
NODE_5772_length_1048_cov_38.430980	405	485	4	55	80	0.6875000
NODE_5772_length_1048_cov_38.430980	405	485	6	2	80	0.0250000
NODE_5772_length_1048_cov_38.430980	405	485	8	12	80	0.1500000
NODE_5773_length_1048_cov_28.179136	548	628	3	46	80	0.5750000
NODE_5773_length_1048_cov_28.179136	548	628	4	28	80	0.3500000
NODE_5773_length_1048_cov_28.179136	548	628	5	6	80	0.0750000
NODE_5773_length_1048_cov_28.179136	601	681	3	21	80	0.2625000
NODE_5773_length_1048_cov_28.179136	601	681	5	18	80	0.2250000
NODE_5773_length_1048_cov_28.179136	601	681	6	19	80	0.2375000
NODE_5773_length_1048_cov_28.179136	601	681	7	4	80	0.0500000
NODE_5773_length_1048_cov_28.179136	601	681	8	18	80	0.2250000
NODE_5773_length_1048_cov_28.179136	677	757	6	9	80	0.1125000
NODE_5773_length_1048_cov_28.179136	677	757	7	17	80	0.2125000
NODE_5773_length_1048_cov_28.179136	677	757	8	44	80	0.5500000
NODE_5773_length_1048_cov_28.179136	677	757	9	10	80	0.1250000
NODE_5773_length_1048_cov_28.179136	730	810	3	19	80	0.2375000
NODE_5773_length_1048_cov_28.179136	730	810	5	1	80	0.0125000
NODE_5773_length_1048_cov_28.179136	730	810	6	22	80	0.2750000
NODE_5773_length_1048_cov_28.179136	730	810	8	38	80	0.4750000
NODE_5774_length_1048_cov_22.985248	409	489	5	2	80	0.0250000
NODE_5774_length_1048_cov_22.985248	409	489	6	5	80	0.0625000
NODE_5774_length_1048_cov_22.985248	409	489	7	11	80	0.1375000
NODE_5774_length_1048_cov_22.985248	409	489	8	57	80	0.7125000
NODE_5774_length_1048_cov_22.985248	409	489	9	5	80	0.0625000
NODE_5774_length_1048_cov_22.985248	462	542	4	2	80	0.0250000
NODE_5774_length_1048_cov_22.985248	462	542	5	3	80	0.0375000
NODE_5774_length_1048_cov_22.985248	462	542	6	23	80	0.2875000
NODE_5774_length_1048_cov_22.985248	462	542	8	52	80	0.6500000
NODE_5774_length_1048_cov_22.985248	538	618	1	33	80	0.4125000
NODE_5774_length_1048_cov_22.985248	538	618	2	8	80	0.1000000
NODE_5774_length_1048_cov_22.985248	538	618	3	11	80	0.1375000
NODE_5774_length_1048_cov_22.985248	538	618	4	6	80	0.0750000
NODE_5774_length_1048_cov_22.985248	538	618	5	22	80	0.2750000
NODE_5774_length_1048_cov_22.985248	591	671	1	80	80	1.0000000
NODE_5775_length_1048_cov_17.883035	500	580	17	17	80	0.2125000
NODE_5775_length_1048_cov_17.883035	500	580	18	10	80	0.1250000
NODE_5775_length_1048_cov_17.883035	500	580	19	15	80	0.1875000
NODE_5775_length_1048_cov_17.883035	500	580	21	11	80	0.1375000
NODE_5775_length_1048_cov_17.883035	500	580	22	5	80	0.0625000
NODE_5775_length_1048_cov_17.883035	500	580	24	20	80	0.2500000
NODE_5775_length_1048_cov_17.883035	500	580	26	2	80	0.0250000
NODE_5775_length_1048_cov_17.883035	553	633	10	4	80	0.0500000
NODE_5775_length_1048_cov_17.883035	553	633	15	1	80	0.0125000
NODE_5775_length_1048_cov_17.883035	553	633	17	3	80	0.0375000
NODE_5775_length_1048_cov_17.883035	553	633	19	1	80	0.0125000
NODE_5775_length_1048_cov_17.883035	553	633	21	55	80	0.6875000
NODE_5775_length_1048_cov_17.883035	553	633	22	5	80	0.0625000
NODE_5775_length_1048_cov_17.883035	553	633	24	11	80	0.1375000
NODE_5776_length_1048_cov_17.444679	377	457	5	1	80	0.0125000
NODE_5776_length_1048_cov_17.444679	377	457	7	17	80	0.2125000
NODE_5776_length_1048_cov_17.444679	377	457	8	48	80	0.6000000
NODE_5776_length_1048_cov_17.444679	377	457	9	11	80	0.1375000
NODE_5776_length_1048_cov_17.444679	377	457	10	3	80	0.0375000
NODE_5776_length_1048_cov_17.444679	430	510	2	35	80	0.4375000
NODE_5776_length_1048_cov_17.444679	430	510	3	17	80	0.2125000
NODE_5776_length_1048_cov_17.444679	430	510	5	2	80	0.0250000
NODE_5776_length_1048_cov_17.444679	430	510	7	17	80	0.2125000
NODE_5776_length_1048_cov_17.444679	430	510	8	1	80	0.0125000
NODE_5776_length_1048_cov_17.444679	430	510	9	7	80	0.0875000
NODE_5776_length_1048_cov_17.444679	430	510	10	1	80	0.0125000
NODE_5777_length_1048_cov_13.387777	518	598	14	11	80	0.1375000
NODE_5777_length_1048_cov_13.387777	518	598	15	22	80	0.2750000
NODE_5777_length_1048_cov_13.387777	518	598	17	11	80	0.1375000
NODE_5777_length_1048_cov_13.387777	518	598	18	34	80	0.4250000
NODE_5777_length_1048_cov_13.387777	518	598	19	2	80	0.0250000
NODE_5777_length_1048_cov_13.387777	571	651	8	15	80	0.1875000
NODE_5777_length_1048_cov_13.387777	571	651	10	8	80	0.1000000
NODE_5777_length_1048_cov_13.387777	571	651	11	12	80	0.1500000
NODE_5777_length_1048_cov_13.387777	571	651	12	7	80	0.0875000
NODE_5777_length_1048_cov_13.387777	571	651	13	8	80	0.1000000
NODE_5777_length_1048_cov_13.387777	571	651	14	14	80	0.1750000
NODE_5777_length_1048_cov_13.387777	571	651	15	16	80	0.2000000
NODE_5778_length_1048_cov_12.934668	716	796	2	6	80	0.0750000
NODE_5778_length_1048_cov_12.934668	716	796	3	36	80	0.4500000
NODE_5778_length_1048_cov_12.934668	716	796	4	38	80	0.4750000
NODE_5778_length_1048_cov_12.934668	769	849	2	34	80	0.4250000
NODE_5778_length_1048_cov_12.934668	769	849	3	9	80	0.1125000
NODE_5778_length_1048_cov_12.934668	769	849	4	37	80	0.4625000
NODE_5778_length_1048_cov_12.934668	845	925	0	16	80	0.2000000
NODE_5778_length_1048_cov_12.934668	845	925	1	36	80	0.4500000
NODE_5778_length_1048_cov_12.934668	845	925	2	28	80	0.3500000
NODE_5778_length_1048_cov_12.934668	898	975	0	66	77	0.8571429
NODE_5778_length_1048_cov_12.934668	898	975	1	11	77	0.1428571
NODE_5779_length_1048_cov_12.712329	330	410	2	50	80	0.6250000
NODE_5779_length_1048_cov_12.712329	330	410	3	30	80	0.3750000
NODE_5779_length_1048_cov_12.712329	384	463	2	21	79	0.2658228
NODE_5779_length_1048_cov_12.712329	384	463	3	46	79	0.5822785
NODE_5779_length_1048_cov_12.712329	384	463	7	1	79	0.0126582
NODE_5779_length_1048_cov_12.712329	384	463	8	1	79	0.0126582
NODE_5779_length_1048_cov_12.712329	384	463	10	10	79	0.1265823
NODE_5779_length_1048_cov_12.712329	459	539	9	6	80	0.0750000
NODE_5779_length_1048_cov_12.712329	459	539	10	22	80	0.2750000
NODE_5779_length_1048_cov_12.712329	459	539	11	35	80	0.4375000
NODE_5779_length_1048_cov_12.712329	459	539	12	1	80	0.0125000
NODE_5779_length_1048_cov_12.712329	459	539	13	1	80	0.0125000
NODE_5779_length_1048_cov_12.712329	459	539	14	10	80	0.1250000
NODE_5779_length_1048_cov_12.712329	459	539	15	2	80	0.0250000
NODE_5779_length_1048_cov_12.712329	459	539	17	3	80	0.0375000
NODE_5779_length_1048_cov_12.712329	512	592	10	3	80	0.0375000
NODE_5779_length_1048_cov_12.712329	512	592	11	8	80	0.1000000
NODE_5779_length_1048_cov_12.712329	512	592	13	1	80	0.0125000
NODE_5779_length_1048_cov_12.712329	512	592	14	10	80	0.1250000
NODE_5779_length_1048_cov_12.712329	512	592	15	2	80	0.0250000
NODE_5779_length_1048_cov_12.712329	512	592	17	5	80	0.0625000
NODE_5779_length_1048_cov_12.712329	512	592	18	37	80	0.4625000
NODE_5779_length_1048_cov_12.712329	512	592	19	14	80	0.1750000
NODE_5780_length_1048_cov_9.232877	305	355	0	50	50	1.0000000
NODE_5786_length_1047_cov_79.917722	540	620	4	8	80	0.1000000
NODE_5786_length_1047_cov_79.917722	540	620	5	42	80	0.5250000
NODE_5786_length_1047_cov_79.917722	540	620	6	17	80	0.2125000
NODE_5786_length_1047_cov_79.917722	540	620	8	13	80	0.1625000
NODE_5786_length_1047_cov_79.917722	593	673	6	34	80	0.4250000
NODE_5786_length_1047_cov_79.917722	593	673	8	15	80	0.1875000
NODE_5786_length_1047_cov_79.917722	593	673	10	31	80	0.3875000
NODE_5787_length_1047_cov_28.527426	582	662	10	1	80	0.0125000
NODE_5787_length_1047_cov_28.527426	582	662	11	11	80	0.1375000
NODE_5787_length_1047_cov_28.527426	582	662	12	2	80	0.0250000
NODE_5787_length_1047_cov_28.527426	582	662	14	1	80	0.0125000
NODE_5787_length_1047_cov_28.527426	582	662	15	15	80	0.1875000
NODE_5787_length_1047_cov_28.527426	582	662	16	28	80	0.3500000
NODE_5787_length_1047_cov_28.527426	582	662	18	9	80	0.1125000
NODE_5787_length_1047_cov_28.527426	582	662	19	11	80	0.1375000
NODE_5787_length_1047_cov_28.527426	582	662	20	2	80	0.0250000
NODE_5787_length_1047_cov_28.527426	635	715	16	8	80	0.1000000
NODE_5787_length_1047_cov_28.527426	635	715	17	25	80	0.3125000
NODE_5787_length_1047_cov_28.527426	635	715	18	9	80	0.1125000
NODE_5787_length_1047_cov_28.527426	635	715	19	11	80	0.1375000
NODE_5787_length_1047_cov_28.527426	635	715	20	16	80	0.2000000
NODE_5787_length_1047_cov_28.527426	635	715	22	4	80	0.0500000
NODE_5787_length_1047_cov_28.527426	635	715	23	7	80	0.0875000
NODE_5788_length_1047_cov_26.068565	372	452	16	14	80	0.1750000
NODE_5788_length_1047_cov_26.068565	372	452	17	38	80	0.4750000
NODE_5788_length_1047_cov_26.068565	372	452	18	13	80	0.1625000
NODE_5788_length_1047_cov_26.068565	372	452	19	15	80	0.1875000
NODE_5788_length_1047_cov_26.068565	425	505	9	4	80	0.0500000
NODE_5788_length_1047_cov_26.068565	425	505	10	4	80	0.0500000
NODE_5788_length_1047_cov_26.068565	425	505	12	25	80	0.3125000
NODE_5788_length_1047_cov_26.068565	425	505	15	20	80	0.2500000
NODE_5788_length_1047_cov_26.068565	425	505	16	14	80	0.1750000
NODE_5788_length_1047_cov_26.068565	425	505	17	7	80	0.0875000
NODE_5788_length_1047_cov_26.068565	425	505	19	6	80	0.0750000
NODE_5789_length_1047_cov_25.946203	424	504	2	25	80	0.3125000
NODE_5789_length_1047_cov_25.946203	424	504	5	55	80	0.6875000
NODE_5789_length_1047_cov_25.946203	477	557	5	80	80	1.0000000
NODE_5790_length_1047_cov_19.255274	458	538	2	22	80	0.2750000
NODE_5790_length_1047_cov_19.255274	458	538	3	5	80	0.0625000
NODE_5790_length_1047_cov_19.255274	458	538	4	11	80	0.1375000
NODE_5790_length_1047_cov_19.255274	458	538	6	42	80	0.5250000
NODE_5790_length_1047_cov_19.255274	511	591	5	7	80	0.0875000
NODE_5790_length_1047_cov_19.255274	511	591	6	58	80	0.7250000
NODE_5790_length_1047_cov_19.255274	511	591	7	15	80	0.1875000
NODE_5791_length_1047_cov_16.618143	467	547	0	80	80	1.0000000
NODE_5791_length_1047_cov_16.618143	520	600	0	80	80	1.0000000
NODE_5792_length_1047_cov_14.246835	643	723	0	8	80	0.1000000
NODE_5792_length_1047_cov_14.246835	643	723	1	69	80	0.8625000
NODE_5792_length_1047_cov_14.246835	643	723	2	3	80	0.0375000
NODE_5792_length_1047_cov_14.246835	696	776	1	24	80	0.3000000
NODE_5792_length_1047_cov_14.246835	696	776	2	56	80	0.7000000
NODE_5793_length_1047_cov_9.869198	414	494	2	2	80	0.0250000
NODE_5793_length_1047_cov_9.869198	414	494	3	1	80	0.0125000
NODE_5793_length_1047_cov_9.869198	414	494	4	38	80	0.4750000
NODE_5793_length_1047_cov_9.869198	414	494	5	5	80	0.0625000
NODE_5793_length_1047_cov_9.869198	414	494	6	34	80	0.4250000
NODE_5793_length_1047_cov_9.869198	467	547	6	80	80	1.0000000
NODE_5794_length_1047_cov_8.513713	300	380	0	7	80	0.0875000
NODE_5794_length_1047_cov_8.513713	300	380	2	73	80	0.9125000
NODE_5794_length_1047_cov_8.513713	353	433	0	60	80	0.7500000
NODE_5794_length_1047_cov_8.513713	353	433	2	20	80	0.2500000
NODE_5795_length_1047_cov_7.412447	442	522	0	4	80	0.0500000
NODE_5795_length_1047_cov_7.412447	442	522	1	76	80	0.9500000
NODE_5795_length_1047_cov_7.412447	495	575	1	28	80	0.3500000
NODE_5795_length_1047_cov_7.412447	495	575	2	52	80	0.6500000
NODE_5803_length_1046_cov_41.392819	587	667	14	14	80	0.1750000
NODE_5803_length_1046_cov_41.392819	587	667	15	4	80	0.0500000
NODE_5803_length_1046_cov_41.392819	587	667	16	1	80	0.0125000
NODE_5803_length_1046_cov_41.392819	587	667	17	3	80	0.0375000
NODE_5803_length_1046_cov_41.392819	587	667	18	8	80	0.1000000
NODE_5803_length_1046_cov_41.392819	587	667	19	41	80	0.5125000
NODE_5803_length_1046_cov_41.392819	587	667	20	9	80	0.1125000
NODE_5803_length_1046_cov_41.392819	640	720	13	27	80	0.3375000
NODE_5803_length_1046_cov_41.392819	640	720	14	5	80	0.0625000
NODE_5803_length_1046_cov_41.392819	640	720	15	10	80	0.1250000
NODE_5803_length_1046_cov_41.392819	640	720	18	21	80	0.2625000
NODE_5803_length_1046_cov_41.392819	640	720	19	15	80	0.1875000
NODE_5803_length_1046_cov_41.392819	640	720	20	2	80	0.0250000
NODE_5804_length_1046_cov_30.317846	382	462	8	2	80	0.0250000
NODE_5804_length_1046_cov_30.317846	382	462	9	4	80	0.0500000
NODE_5804_length_1046_cov_30.317846	382	462	11	1	80	0.0125000
NODE_5804_length_1046_cov_30.317846	382	462	12	5	80	0.0625000
NODE_5804_length_1046_cov_30.317846	382	462	13	7	80	0.0875000
NODE_5804_length_1046_cov_30.317846	382	462	14	10	80	0.1250000
NODE_5804_length_1046_cov_30.317846	382	462	16	7	80	0.0875000
NODE_5804_length_1046_cov_30.317846	382	462	17	2	80	0.0250000
NODE_5804_length_1046_cov_30.317846	382	462	18	2	80	0.0250000
NODE_5804_length_1046_cov_30.317846	382	462	19	13	80	0.1625000
NODE_5804_length_1046_cov_30.317846	382	462	20	2	80	0.0250000
NODE_5804_length_1046_cov_30.317846	382	462	21	4	80	0.0500000
NODE_5804_length_1046_cov_30.317846	382	462	23	15	80	0.1875000
NODE_5804_length_1046_cov_30.317846	382	462	24	6	80	0.0750000
NODE_5804_length_1046_cov_30.317846	435	515	20	2	80	0.0250000
NODE_5804_length_1046_cov_30.317846	435	515	21	4	80	0.0500000
NODE_5804_length_1046_cov_30.317846	435	515	23	15	80	0.1875000
NODE_5804_length_1046_cov_30.317846	435	515	24	14	80	0.1750000
NODE_5804_length_1046_cov_30.317846	435	515	25	29	80	0.3625000
NODE_5804_length_1046_cov_30.317846	435	515	26	16	80	0.2000000
NODE_5805_length_1046_cov_28.184794	346	426	19	12	80	0.1500000
NODE_5805_length_1046_cov_28.184794	346	426	20	4	80	0.0500000
NODE_5805_length_1046_cov_28.184794	346	426	21	39	80	0.4875000
NODE_5805_length_1046_cov_28.184794	346	426	23	20	80	0.2500000
NODE_5805_length_1046_cov_28.184794	346	426	25	5	80	0.0625000
NODE_5805_length_1046_cov_28.184794	399	479	19	12	80	0.1500000
NODE_5805_length_1046_cov_28.184794	399	479	21	22	80	0.2750000
NODE_5805_length_1046_cov_28.184794	399	479	22	3	80	0.0375000
NODE_5805_length_1046_cov_28.184794	399	479	23	13	80	0.1625000
NODE_5805_length_1046_cov_28.184794	399	479	24	2	80	0.0250000
NODE_5805_length_1046_cov_28.184794	399	479	25	11	80	0.1375000
NODE_5805_length_1046_cov_28.184794	399	479	26	17	80	0.2125000
NODE_5806_length_1046_cov_24.595565	501	581	12	5	80	0.0625000
NODE_5806_length_1046_cov_24.595565	501	581	14	7	80	0.0875000
NODE_5806_length_1046_cov_24.595565	501	581	15	8	80	0.1000000
NODE_5806_length_1046_cov_24.595565	501	581	18	1	80	0.0125000
NODE_5806_length_1046_cov_24.595565	501	581	19	22	80	0.2750000
NODE_5806_length_1046_cov_24.595565	501	581	20	4	80	0.0500000
NODE_5806_length_1046_cov_24.595565	501	581	21	33	80	0.4125000
NODE_5806_length_1046_cov_24.595565	554	634	12	4	80	0.0500000
NODE_5806_length_1046_cov_24.595565	554	634	14	6	80	0.0750000
NODE_5806_length_1046_cov_24.595565	554	634	16	10	80	0.1250000
NODE_5806_length_1046_cov_24.595565	554	634	17	20	80	0.2500000
NODE_5806_length_1046_cov_24.595565	554	634	18	10	80	0.1250000
NODE_5806_length_1046_cov_24.595565	554	634	19	7	80	0.0875000
NODE_5806_length_1046_cov_24.595565	554	634	20	4	80	0.0500000
NODE_5806_length_1046_cov_24.595565	554	634	21	19	80	0.2375000
NODE_5807_length_1046_cov_17.958817	447	527	4	30	80	0.3750000
NODE_5807_length_1046_cov_17.958817	447	527	5	10	80	0.1250000
NODE_5807_length_1046_cov_17.958817	447	527	6	39	80	0.4875000
NODE_5807_length_1046_cov_17.958817	447	527	7	1	80	0.0125000
NODE_5807_length_1046_cov_17.958817	500	580	4	80	80	1.0000000
NODE_5808_length_1046_cov_15.494192	385	465	0	80	80	1.0000000
NODE_5808_length_1046_cov_15.494192	438	518	0	80	80	1.0000000
NODE_5809_length_1046_cov_12.639916	554	634	0	12	80	0.1500000
NODE_5809_length_1046_cov_12.639916	554	634	2	6	80	0.0750000
NODE_5809_length_1046_cov_12.639916	554	634	6	7	80	0.0875000
NODE_5809_length_1046_cov_12.639916	554	634	7	27	80	0.3375000
NODE_5809_length_1046_cov_12.639916	554	634	8	24	80	0.3000000
NODE_5809_length_1046_cov_12.639916	554	634	9	4	80	0.0500000
NODE_5809_length_1046_cov_12.639916	607	687	0	65	80	0.8125000
NODE_5809_length_1046_cov_12.639916	607	687	2	6	80	0.0750000
NODE_5809_length_1046_cov_12.639916	607	687	6	7	80	0.0875000
NODE_5809_length_1046_cov_12.639916	607	687	7	2	80	0.0250000
NODE_5810_length_1046_cov_11.238648	471	551	9	36	80	0.4500000
NODE_5810_length_1046_cov_11.238648	471	551	10	9	80	0.1125000
NODE_5810_length_1046_cov_11.238648	471	551	11	14	80	0.1750000
NODE_5810_length_1046_cov_11.238648	471	551	12	21	80	0.2625000
NODE_5810_length_1046_cov_11.238648	524	604	5	20	80	0.2500000
NODE_5810_length_1046_cov_11.238648	524	604	6	7	80	0.0875000
NODE_5810_length_1046_cov_11.238648	524	604	7	11	80	0.1375000
NODE_5810_length_1046_cov_11.238648	524	604	8	7	80	0.0875000
NODE_5810_length_1046_cov_11.238648	524	604	9	20	80	0.2500000
NODE_5810_length_1046_cov_11.238648	524	604	10	5	80	0.0625000
NODE_5810_length_1046_cov_11.238648	524	604	11	10	80	0.1250000
NODE_5811_length_1046_cov_10.744456	459	539	2	80	80	1.0000000
NODE_5811_length_1046_cov_10.744456	512	592	0	37	80	0.4625000
NODE_5811_length_1046_cov_10.744456	512	592	2	43	80	0.5375000
NODE_5812_length_1046_cov_8.689546	302	382	9	62	80	0.7750000
NODE_5812_length_1046_cov_8.689546	302	382	10	14	80	0.1750000
NODE_5812_length_1046_cov_8.689546	302	382	11	4	80	0.0500000
NODE_5812_length_1046_cov_8.689546	355	435	4	1	80	0.0125000
NODE_5812_length_1046_cov_8.689546	355	435	5	17	80	0.2125000
NODE_5812_length_1046_cov_8.689546	355	435	6	12	80	0.1500000
NODE_5812_length_1046_cov_8.689546	355	435	7	10	80	0.1250000
NODE_5812_length_1046_cov_8.689546	355	435	8	7	80	0.0875000
NODE_5812_length_1046_cov_8.689546	355	435	9	33	80	0.4125000
NODE_5823_length_1045_cov_75.975687	359	440	15	1	81	0.0123457
NODE_5823_length_1045_cov_75.975687	359	440	16	18	81	0.2222222
NODE_5823_length_1045_cov_75.975687	359	440	17	7	81	0.0864198
NODE_5823_length_1045_cov_75.975687	359	440	18	4	81	0.0493827
NODE_5823_length_1045_cov_75.975687	359	440	19	9	81	0.1111111
NODE_5823_length_1045_cov_75.975687	359	440	22	1	81	0.0123457
NODE_5823_length_1045_cov_75.975687	359	440	23	3	81	0.0370370
NODE_5823_length_1045_cov_75.975687	359	440	24	3	81	0.0370370
NODE_5823_length_1045_cov_75.975687	359	440	25	20	81	0.2469136
NODE_5823_length_1045_cov_75.975687	359	440	26	14	81	0.1728395
NODE_5823_length_1045_cov_75.975687	359	440	27	1	81	0.0123457
NODE_5823_length_1045_cov_75.975687	412	493	25	13	81	0.1604938
NODE_5823_length_1045_cov_75.975687	412	493	26	27	81	0.3333333
NODE_5823_length_1045_cov_75.975687	412	493	27	17	81	0.2098765
NODE_5823_length_1045_cov_75.975687	412	493	30	7	81	0.0864198
NODE_5823_length_1045_cov_75.975687	412	493	31	1	81	0.0123457
NODE_5823_length_1045_cov_75.975687	412	493	32	16	81	0.1975309
NODE_5823_length_1045_cov_75.975687	489	569	16	15	80	0.1875000
NODE_5823_length_1045_cov_75.975687	489	569	17	5	80	0.0625000
NODE_5823_length_1045_cov_75.975687	489	569	21	3	80	0.0375000
NODE_5823_length_1045_cov_75.975687	489	569	22	4	80	0.0500000
NODE_5823_length_1045_cov_75.975687	489	569	23	13	80	0.1625000
NODE_5823_length_1045_cov_75.975687	489	569	24	17	80	0.2125000
NODE_5823_length_1045_cov_75.975687	489	569	25	15	80	0.1875000
NODE_5823_length_1045_cov_75.975687	489	569	26	8	80	0.1000000
NODE_5823_length_1045_cov_75.975687	542	622	6	22	80	0.2750000
NODE_5823_length_1045_cov_75.975687	542	622	9	4	80	0.0500000
NODE_5823_length_1045_cov_75.975687	542	622	10	10	80	0.1250000
NODE_5823_length_1045_cov_75.975687	542	622	11	3	80	0.0375000
NODE_5823_length_1045_cov_75.975687	542	622	13	10	80	0.1250000
NODE_5823_length_1045_cov_75.975687	542	622	15	3	80	0.0375000
NODE_5823_length_1045_cov_75.975687	542	622	16	16	80	0.2000000
NODE_5823_length_1045_cov_75.975687	542	622	17	5	80	0.0625000
NODE_5823_length_1045_cov_75.975687	542	622	21	3	80	0.0375000
NODE_5823_length_1045_cov_75.975687	542	622	22	4	80	0.0500000
NODE_5824_length_1045_cov_54.419662	434	514	2	2	80	0.0250000
NODE_5824_length_1045_cov_54.419662	434	514	3	78	80	0.9750000
NODE_5824_length_1045_cov_54.419662	487	567	2	21	80	0.2625000
NODE_5824_length_1045_cov_54.419662	487	567	3	46	80	0.5750000
NODE_5824_length_1045_cov_54.419662	487	567	4	13	80	0.1625000
NODE_5824_length_1045_cov_54.419662	563	639	4	10	76	0.1315790
NODE_5824_length_1045_cov_54.419662	563	639	5	1	76	0.0131579
NODE_5824_length_1045_cov_54.419662	563	639	6	13	76	0.1710526
NODE_5824_length_1045_cov_54.419662	563	639	7	3	76	0.0394737
NODE_5824_length_1045_cov_54.419662	563	639	8	10	76	0.1315790
NODE_5824_length_1045_cov_54.419662	563	639	10	6	76	0.0789474
NODE_5824_length_1045_cov_54.419662	563	639	11	5	76	0.0657895
NODE_5824_length_1045_cov_54.419662	563	639	12	28	76	0.3684210
NODE_5824_length_1045_cov_54.419662	616	696	12	39	80	0.4875000
NODE_5824_length_1045_cov_54.419662	616	696	13	40	80	0.5000000
NODE_5824_length_1045_cov_54.419662	616	696	14	1	80	0.0125000
NODE_5825_length_1045_cov_23.188161	395	475	14	11	80	0.1375000
NODE_5825_length_1045_cov_23.188161	395	475	15	30	80	0.3750000
NODE_5825_length_1045_cov_23.188161	395	475	16	6	80	0.0750000
NODE_5825_length_1045_cov_23.188161	395	475	17	14	80	0.1750000
NODE_5825_length_1045_cov_23.188161	395	475	18	5	80	0.0625000
NODE_5825_length_1045_cov_23.188161	395	475	19	14	80	0.1750000
NODE_5825_length_1045_cov_23.188161	448	528	13	30	80	0.3750000
NODE_5825_length_1045_cov_23.188161	448	528	17	9	80	0.1125000
NODE_5825_length_1045_cov_23.188161	448	528	18	27	80	0.3375000
NODE_5825_length_1045_cov_23.188161	448	528	19	14	80	0.1750000
NODE_5826_length_1045_cov_19.686047	571	651	22	12	80	0.1500000
NODE_5826_length_1045_cov_19.686047	571	651	24	16	80	0.2000000
NODE_5826_length_1045_cov_19.686047	571	651	25	33	80	0.4125000
NODE_5826_length_1045_cov_19.686047	571	651	26	3	80	0.0375000
NODE_5826_length_1045_cov_19.686047	571	651	27	13	80	0.1625000
NODE_5826_length_1045_cov_19.686047	571	651	29	3	80	0.0375000
NODE_5826_length_1045_cov_19.686047	624	704	12	4	80	0.0500000
NODE_5826_length_1045_cov_19.686047	624	704	14	1	80	0.0125000
NODE_5826_length_1045_cov_19.686047	624	704	18	6	80	0.0750000
NODE_5826_length_1045_cov_19.686047	624	704	19	1	80	0.0125000
NODE_5826_length_1045_cov_19.686047	624	704	20	16	80	0.2000000
NODE_5826_length_1045_cov_19.686047	624	704	22	12	80	0.1500000
NODE_5826_length_1045_cov_19.686047	624	704	24	5	80	0.0625000
NODE_5826_length_1045_cov_19.686047	624	704	25	31	80	0.3875000
NODE_5826_length_1045_cov_19.686047	624	704	27	4	80	0.0500000
NODE_5827_length_1045_cov_19.378436	478	558	2	1	80	0.0125000
NODE_5827_length_1045_cov_19.378436	478	558	3	4	80	0.0500000
NODE_5827_length_1045_cov_19.378436	478	558	5	17	80	0.2125000
NODE_5827_length_1045_cov_19.378436	478	558	6	27	80	0.3375000
NODE_5827_length_1045_cov_19.378436	478	558	8	31	80	0.3875000
NODE_5827_length_1045_cov_19.378436	531	611	8	79	80	0.9875000
NODE_5827_length_1045_cov_19.378436	531	611	10	1	80	0.0125000
NODE_5828_length_1045_cov_17.601480	359	439	4	12	80	0.1500000
NODE_5828_length_1045_cov_17.601480	359	439	6	68	80	0.8500000
NODE_5828_length_1045_cov_17.601480	412	492	3	15	80	0.1875000
NODE_5828_length_1045_cov_17.601480	412	492	4	50	80	0.6250000
NODE_5828_length_1045_cov_17.601480	412	492	6	15	80	0.1875000
NODE_5829_length_1045_cov_17.372093	633	713	0	80	80	1.0000000
NODE_5829_length_1045_cov_17.372093	686	766	0	80	80	1.0000000
NODE_5830_length_1045_cov_14.828753	433	513	5	11	80	0.1375000
NODE_5830_length_1045_cov_14.828753	433	513	6	27	80	0.3375000
NODE_5830_length_1045_cov_14.828753	433	513	7	42	80	0.5250000
NODE_5830_length_1045_cov_14.828753	486	566	4	12	80	0.1500000
NODE_5830_length_1045_cov_14.828753	486	566	5	1	80	0.0125000
NODE_5830_length_1045_cov_14.828753	486	566	6	67	80	0.8375000
NODE_5831_length_1045_cov_11.673362	664	744	3	42	80	0.5250000
NODE_5831_length_1045_cov_11.673362	664	744	4	13	80	0.1625000
NODE_5831_length_1045_cov_11.673362	664	744	5	25	80	0.3125000
NODE_5831_length_1045_cov_11.673362	717	797	3	47	80	0.5875000
NODE_5831_length_1045_cov_11.673362	717	797	4	32	80	0.4000000
NODE_5831_length_1045_cov_11.673362	717	797	5	1	80	0.0125000
NODE_5843_length_1044_cov_42.600000	344	424	7	7	80	0.0875000
NODE_5843_length_1044_cov_42.600000	344	424	8	6	80	0.0750000
NODE_5843_length_1044_cov_42.600000	344	424	9	9	80	0.1125000
NODE_5843_length_1044_cov_42.600000	344	424	10	1	80	0.0125000
NODE_5843_length_1044_cov_42.600000	344	424	11	25	80	0.3125000
NODE_5843_length_1044_cov_42.600000	344	424	12	2	80	0.0250000
NODE_5843_length_1044_cov_42.600000	344	424	14	23	80	0.2875000
NODE_5843_length_1044_cov_42.600000	344	424	15	4	80	0.0500000
NODE_5843_length_1044_cov_42.600000	344	424	16	3	80	0.0375000
NODE_5843_length_1044_cov_42.600000	397	477	11	20	80	0.2500000
NODE_5843_length_1044_cov_42.600000	397	477	12	11	80	0.1375000
NODE_5843_length_1044_cov_42.600000	397	477	13	19	80	0.2375000
NODE_5843_length_1044_cov_42.600000	397	477	14	20	80	0.2500000
NODE_5843_length_1044_cov_42.600000	397	477	15	4	80	0.0500000
NODE_5843_length_1044_cov_42.600000	397	477	16	6	80	0.0750000
NODE_5844_length_1044_cov_27.653968	454	534	19	7	80	0.0875000
NODE_5844_length_1044_cov_27.653968	454	534	20	20	80	0.2500000
NODE_5844_length_1044_cov_27.653968	454	534	21	2	80	0.0250000
NODE_5844_length_1044_cov_27.653968	454	534	22	4	80	0.0500000
NODE_5844_length_1044_cov_27.653968	454	534	26	5	80	0.0625000
NODE_5844_length_1044_cov_27.653968	454	534	28	5	80	0.0625000
NODE_5844_length_1044_cov_27.653968	454	534	29	15	80	0.1875000
NODE_5844_length_1044_cov_27.653968	454	534	30	8	80	0.1000000
NODE_5844_length_1044_cov_27.653968	454	534	31	11	80	0.1375000
NODE_5844_length_1044_cov_27.653968	454	534	32	3	80	0.0375000
NODE_5844_length_1044_cov_27.653968	507	587	13	3	80	0.0375000
NODE_5844_length_1044_cov_27.653968	507	587	14	10	80	0.1250000
NODE_5844_length_1044_cov_27.653968	507	587	16	2	80	0.0250000
NODE_5844_length_1044_cov_27.653968	507	587	17	7	80	0.0875000
NODE_5844_length_1044_cov_27.653968	507	587	18	3	80	0.0375000
NODE_5844_length_1044_cov_27.653968	507	587	19	10	80	0.1250000
NODE_5844_length_1044_cov_27.653968	507	587	20	32	80	0.4000000
NODE_5844_length_1044_cov_27.653968	507	587	21	13	80	0.1625000
NODE_5845_length_1044_cov_24.561905	297	375	6	37	78	0.4743590
NODE_5845_length_1044_cov_24.561905	297	375	7	1	78	0.0128205
NODE_5845_length_1044_cov_24.561905	297	375	8	18	78	0.2307692
NODE_5845_length_1044_cov_24.561905	297	375	9	22	78	0.2820513
NODE_5845_length_1044_cov_24.561905	348	428	7	1	80	0.0125000
NODE_5845_length_1044_cov_24.561905	348	428	8	61	80	0.7625000
NODE_5845_length_1044_cov_24.561905	348	428	9	18	80	0.2250000
NODE_5845_length_1044_cov_24.561905	424	504	3	20	80	0.2500000
NODE_5845_length_1044_cov_24.561905	424	504	4	1	80	0.0125000
NODE_5845_length_1044_cov_24.561905	424	504	6	52	80	0.6500000
NODE_5845_length_1044_cov_24.561905	424	504	8	7	80	0.0875000
NODE_5845_length_1044_cov_24.561905	477	557	0	6	80	0.0750000
NODE_5845_length_1044_cov_24.561905	477	557	1	24	80	0.3000000
NODE_5845_length_1044_cov_24.561905	477	557	3	43	80	0.5375000
NODE_5845_length_1044_cov_24.561905	477	557	4	1	80	0.0125000
NODE_5845_length_1044_cov_24.561905	477	557	6	6	80	0.0750000
NODE_5846_length_1044_cov_23.720635	294	374	1	24	80	0.3000000
NODE_5846_length_1044_cov_23.720635	294	374	4	32	80	0.4000000
NODE_5846_length_1044_cov_23.720635	294	374	5	24	80	0.3000000
NODE_5846_length_1044_cov_23.720635	347	427	4	3	80	0.0375000
NODE_5846_length_1044_cov_23.720635	347	427	5	37	80	0.4625000
NODE_5846_length_1044_cov_23.720635	347	427	6	18	80	0.2250000
NODE_5846_length_1044_cov_23.720635	347	427	9	7	80	0.0875000
NODE_5846_length_1044_cov_23.720635	347	427	10	3	80	0.0375000
NODE_5846_length_1044_cov_23.720635	347	427	11	11	80	0.1375000
NODE_5846_length_1044_cov_23.720635	347	427	12	1	80	0.0125000
NODE_5846_length_1044_cov_23.720635	423	503	11	3	80	0.0375000
NODE_5846_length_1044_cov_23.720635	423	503	12	23	80	0.2875000
NODE_5846_length_1044_cov_23.720635	423	503	13	35	80	0.4375000
NODE_5846_length_1044_cov_23.720635	423	503	14	4	80	0.0500000
NODE_5846_length_1044_cov_23.720635	423	503	15	15	80	0.1875000
NODE_5846_length_1044_cov_23.720635	476	556	12	4	80	0.0500000
NODE_5846_length_1044_cov_23.720635	476	556	13	8	80	0.1000000
NODE_5846_length_1044_cov_23.720635	476	556	14	22	80	0.2750000
NODE_5846_length_1044_cov_23.720635	476	556	15	16	80	0.2000000
NODE_5846_length_1044_cov_23.720635	476	556	16	13	80	0.1625000
NODE_5846_length_1044_cov_23.720635	476	556	17	12	80	0.1500000
NODE_5846_length_1044_cov_23.720635	476	556	18	5	80	0.0625000
NODE_5847_length_1044_cov_20.871958	462	542	13	38	80	0.4750000
NODE_5847_length_1044_cov_20.871958	462	542	17	1	80	0.0125000
NODE_5847_length_1044_cov_20.871958	462	542	18	7	80	0.0875000
NODE_5847_length_1044_cov_20.871958	462	542	19	20	80	0.2500000
NODE_5847_length_1044_cov_20.871958	462	542	20	1	80	0.0125000
NODE_5847_length_1044_cov_20.871958	462	542	21	13	80	0.1625000
NODE_5847_length_1044_cov_20.871958	515	595	7	1	80	0.0125000
NODE_5847_length_1044_cov_20.871958	515	595	8	2	80	0.0250000
NODE_5847_length_1044_cov_20.871958	515	595	9	5	80	0.0625000
NODE_5847_length_1044_cov_20.871958	515	595	11	7	80	0.0875000
NODE_5847_length_1044_cov_20.871958	515	595	13	43	80	0.5375000
NODE_5847_length_1044_cov_20.871958	515	595	14	22	80	0.2750000
NODE_5847_length_1044_cov_20.871958	591	671	3	5	80	0.0625000
NODE_5847_length_1044_cov_20.871958	591	671	4	1	80	0.0125000
NODE_5847_length_1044_cov_20.871958	591	671	5	31	80	0.3875000
NODE_5847_length_1044_cov_20.871958	591	671	7	2	80	0.0250000
NODE_5847_length_1044_cov_20.871958	591	671	8	24	80	0.3000000
NODE_5847_length_1044_cov_20.871958	591	671	9	1	80	0.0125000
NODE_5847_length_1044_cov_20.871958	591	671	10	16	80	0.2000000
NODE_5847_length_1044_cov_20.871958	644	724	8	11	80	0.1375000
NODE_5847_length_1044_cov_20.871958	644	724	9	22	80	0.2750000
NODE_5847_length_1044_cov_20.871958	644	724	10	47	80	0.5875000
NODE_5848_length_1044_cov_18.596825	433	513	2	49	80	0.6125000
NODE_5848_length_1044_cov_18.596825	433	513	3	2	80	0.0250000
NODE_5848_length_1044_cov_18.596825	433	513	4	29	80	0.3625000
NODE_5848_length_1044_cov_18.596825	486	566	2	12	80	0.1500000
NODE_5848_length_1044_cov_18.596825	486	566	3	19	80	0.2375000
NODE_5848_length_1044_cov_18.596825	486	566	4	49	80	0.6125000
NODE_5849_length_1044_cov_16.102646	414	494	6	40	80	0.5000000
NODE_5849_length_1044_cov_16.102646	414	494	7	40	80	0.5000000
NODE_5849_length_1044_cov_16.102646	467	547	1	18	80	0.2250000
NODE_5849_length_1044_cov_16.102646	467	547	2	2	80	0.0250000
NODE_5849_length_1044_cov_16.102646	467	547	3	24	80	0.3000000
NODE_5849_length_1044_cov_16.102646	467	547	6	34	80	0.4250000
NODE_5849_length_1044_cov_16.102646	467	547	7	2	80	0.0250000
NODE_5850_length_1044_cov_12.156614	578	658	5	4	80	0.0500000
NODE_5850_length_1044_cov_12.156614	578	658	6	1	80	0.0125000
NODE_5850_length_1044_cov_12.156614	578	658	7	18	80	0.2250000
NODE_5850_length_1044_cov_12.156614	578	658	8	11	80	0.1375000
NODE_5850_length_1044_cov_12.156614	578	658	9	46	80	0.5750000
NODE_5850_length_1044_cov_12.156614	631	711	8	10	80	0.1250000
NODE_5850_length_1044_cov_12.156614	631	711	9	45	80	0.5625000
NODE_5850_length_1044_cov_12.156614	631	711	10	20	80	0.2500000
NODE_5850_length_1044_cov_12.156614	631	711	11	5	80	0.0625000
NODE_5851_length_1044_cov_10.661376	506	586	6	6	80	0.0750000
NODE_5851_length_1044_cov_10.661376	506	586	8	21	80	0.2625000
NODE_5851_length_1044_cov_10.661376	506	586	9	11	80	0.1375000
NODE_5851_length_1044_cov_10.661376	506	586	10	21	80	0.2625000
NODE_5851_length_1044_cov_10.661376	506	586	11	13	80	0.1625000
NODE_5851_length_1044_cov_10.661376	506	586	13	1	80	0.0125000
NODE_5851_length_1044_cov_10.661376	506	586	15	7	80	0.0875000
NODE_5851_length_1044_cov_10.661376	559	639	8	3	80	0.0375000
NODE_5851_length_1044_cov_10.661376	559	639	10	3	80	0.0375000
NODE_5851_length_1044_cov_10.661376	559	639	11	13	80	0.1625000
NODE_5851_length_1044_cov_10.661376	559	639	13	27	80	0.3375000
NODE_5851_length_1044_cov_10.661376	559	639	15	14	80	0.1750000
NODE_5851_length_1044_cov_10.661376	559	639	17	20	80	0.2500000
NODE_5852_length_1044_cov_9.534392	461	541	8	9	80	0.1125000
NODE_5852_length_1044_cov_9.534392	461	541	9	14	80	0.1750000
NODE_5852_length_1044_cov_9.534392	461	541	12	1	80	0.0125000
NODE_5852_length_1044_cov_9.534392	461	541	13	23	80	0.2875000
NODE_5852_length_1044_cov_9.534392	461	541	15	1	80	0.0125000
NODE_5852_length_1044_cov_9.534392	461	541	18	1	80	0.0125000
NODE_5852_length_1044_cov_9.534392	461	541	21	3	80	0.0375000
NODE_5852_length_1044_cov_9.534392	461	541	22	15	80	0.1875000
NODE_5852_length_1044_cov_9.534392	461	541	23	13	80	0.1625000
NODE_5852_length_1044_cov_9.534392	514	594	19	4	80	0.0500000
NODE_5852_length_1044_cov_9.534392	514	594	20	13	80	0.1625000
NODE_5852_length_1044_cov_9.534392	514	594	22	43	80	0.5375000
NODE_5852_length_1044_cov_9.534392	514	594	23	18	80	0.2250000
NODE_5852_length_1044_cov_9.534392	514	594	24	2	80	0.0250000
NODE_5853_length_1044_cov_5.517460	434	514	1	80	80	1.0000000
NODE_5853_length_1044_cov_5.517460	487	567	0	5	80	0.0625000
NODE_5853_length_1044_cov_5.517460	487	567	1	75	80	0.9375000
NODE_5856_length_1044_cov_1.502646	769	845	0	76	76	1.0000000
NODE_5860_length_1043_cov_42.288136	452	532	0	12	80	0.1500000
NODE_5860_length_1043_cov_42.288136	452	532	1	18	80	0.2250000
NODE_5860_length_1043_cov_42.288136	452	532	3	50	80	0.6250000
NODE_5860_length_1043_cov_42.288136	505	585	0	15	80	0.1875000
NODE_5860_length_1043_cov_42.288136	505	585	1	15	80	0.1875000
NODE_5860_length_1043_cov_42.288136	505	585	2	50	80	0.6250000
NODE_5861_length_1043_cov_25.987288	350	430	1	34	80	0.4250000
NODE_5861_length_1043_cov_25.987288	350	430	2	34	80	0.4250000
NODE_5861_length_1043_cov_25.987288	350	430	3	12	80	0.1500000
NODE_5861_length_1043_cov_25.987288	403	483	2	15	80	0.1875000
NODE_5861_length_1043_cov_25.987288	403	483	3	26	80	0.3250000
NODE_5861_length_1043_cov_25.987288	403	483	4	1	80	0.0125000
NODE_5861_length_1043_cov_25.987288	403	483	5	8	80	0.1000000
NODE_5861_length_1043_cov_25.987288	403	483	6	11	80	0.1375000
NODE_5861_length_1043_cov_25.987288	403	483	7	5	80	0.0625000
NODE_5861_length_1043_cov_25.987288	403	483	8	14	80	0.1750000
NODE_5861_length_1043_cov_25.987288	479	559	8	21	80	0.2625000
NODE_5861_length_1043_cov_25.987288	479	559	9	16	80	0.2000000
NODE_5861_length_1043_cov_25.987288	479	559	10	43	80	0.5375000
NODE_5861_length_1043_cov_25.987288	532	612	7	12	80	0.1500000
NODE_5861_length_1043_cov_25.987288	532	612	8	6	80	0.0750000
NODE_5861_length_1043_cov_25.987288	532	612	9	28	80	0.3500000
NODE_5861_length_1043_cov_25.987288	532	612	10	34	80	0.4250000
NODE_5862_length_1043_cov_20.838983	561	641	1	12	80	0.1500000
NODE_5862_length_1043_cov_20.838983	561	641	2	28	80	0.3500000
NODE_5862_length_1043_cov_20.838983	561	641	3	13	80	0.1625000
NODE_5862_length_1043_cov_20.838983	561	641	4	27	80	0.3375000
NODE_5862_length_1043_cov_20.838983	614	694	3	10	80	0.1250000
NODE_5862_length_1043_cov_20.838983	614	694	4	70	80	0.8750000
NODE_5863_length_1043_cov_20.312500	489	569	2	14	80	0.1750000
NODE_5863_length_1043_cov_20.312500	489	569	3	27	80	0.3375000
NODE_5863_length_1043_cov_20.312500	489	569	4	39	80	0.4875000
NODE_5863_length_1043_cov_20.312500	542	622	3	80	80	1.0000000
NODE_5864_length_1043_cov_16.320975	569	649	2	11	80	0.1375000
NODE_5864_length_1043_cov_16.320975	569	649	3	28	80	0.3500000
NODE_5864_length_1043_cov_16.320975	569	649	4	41	80	0.5125000
NODE_5864_length_1043_cov_16.320975	622	702	3	65	80	0.8125000
NODE_5864_length_1043_cov_16.320975	622	702	4	15	80	0.1875000
NODE_5865_length_1043_cov_11.176907	521	601	3	46	80	0.5750000
NODE_5865_length_1043_cov_11.176907	521	601	4	12	80	0.1500000
NODE_5865_length_1043_cov_11.176907	521	601	5	20	80	0.2500000
NODE_5865_length_1043_cov_11.176907	521	601	6	2	80	0.0250000
NODE_5865_length_1043_cov_11.176907	574	654	3	25	80	0.3125000
NODE_5865_length_1043_cov_11.176907	574	654	6	55	80	0.6875000
NODE_5866_length_1043_cov_8.146186	530	596	2	1	66	0.0151515
NODE_5866_length_1043_cov_8.146186	530	596	6	3	66	0.0454545
NODE_5866_length_1043_cov_8.146186	530	596	7	16	66	0.2424242
NODE_5866_length_1043_cov_8.146186	530	596	10	46	66	0.6969697
NODE_5866_length_1043_cov_8.146186	569	649	2	11	80	0.1375000
NODE_5866_length_1043_cov_8.146186	569	649	6	46	80	0.5750000
NODE_5866_length_1043_cov_8.146186	569	649	7	16	80	0.2000000
NODE_5866_length_1043_cov_8.146186	569	649	10	7	80	0.0875000
NODE_5868_length_1043_cov_5.347458	646	726	0	80	80	1.0000000
NODE_5868_length_1043_cov_5.347458	699	779	0	80	80	1.0000000
NODE_5879_length_1042_cov_242.728526	820	900	81	1	80	0.0125000
NODE_5879_length_1042_cov_242.728526	820	900	83	4	80	0.0500000
NODE_5879_length_1042_cov_242.728526	820	900	86	6	80	0.0750000
NODE_5879_length_1042_cov_242.728526	820	900	87	8	80	0.1000000
NODE_5879_length_1042_cov_242.728526	820	900	88	1	80	0.0125000
NODE_5879_length_1042_cov_242.728526	820	900	89	20	80	0.2500000
NODE_5879_length_1042_cov_242.728526	820	900	90	12	80	0.1500000
NODE_5879_length_1042_cov_242.728526	820	900	91	6	80	0.0750000
NODE_5879_length_1042_cov_242.728526	820	900	92	6	80	0.0750000
NODE_5879_length_1042_cov_242.728526	820	900	93	3	80	0.0375000
NODE_5879_length_1042_cov_242.728526	820	900	94	3	80	0.0375000
NODE_5879_length_1042_cov_242.728526	820	900	95	10	80	0.1250000
NODE_5879_length_1042_cov_242.728526	873	903	81	1	30	0.0333333
NODE_5879_length_1042_cov_242.728526	873	903	83	4	30	0.1333333
NODE_5879_length_1042_cov_242.728526	873	903	84	1	30	0.0333333
NODE_5879_length_1042_cov_242.728526	873	903	85	2	30	0.0666667
NODE_5879_length_1042_cov_242.728526	873	903	89	5	30	0.1666667
NODE_5879_length_1042_cov_242.728526	873	903	92	2	30	0.0666667
NODE_5879_length_1042_cov_242.728526	873	903	93	3	30	0.1000000
NODE_5879_length_1042_cov_242.728526	873	903	94	2	30	0.0666667
NODE_5879_length_1042_cov_242.728526	873	903	95	10	30	0.3333333
NODE_5880_length_1042_cov_63.214210	355	435	12	24	80	0.3000000
NODE_5880_length_1042_cov_63.214210	355	435	13	33	80	0.4125000
NODE_5880_length_1042_cov_63.214210	355	435	14	17	80	0.2125000
NODE_5880_length_1042_cov_63.214210	355	435	17	6	80	0.0750000
NODE_5880_length_1042_cov_63.214210	408	488	2	8	80	0.1000000
NODE_5880_length_1042_cov_63.214210	408	488	7	1	80	0.0125000
NODE_5880_length_1042_cov_63.214210	408	488	8	18	80	0.2250000
NODE_5880_length_1042_cov_63.214210	408	488	11	9	80	0.1125000
NODE_5880_length_1042_cov_63.214210	408	488	12	38	80	0.4750000
NODE_5880_length_1042_cov_63.214210	408	488	13	6	80	0.0750000
NODE_5881_length_1042_cov_29.581124	497	577	0	42	80	0.5250000
NODE_5881_length_1042_cov_29.581124	497	577	2	38	80	0.4750000
NODE_5881_length_1042_cov_29.581124	550	630	2	80	80	1.0000000
NODE_5882_length_1042_cov_23.861082	519	599	2	10	80	0.1250000
NODE_5882_length_1042_cov_23.861082	519	599	4	52	80	0.6500000
NODE_5882_length_1042_cov_23.861082	519	599	5	18	80	0.2250000
NODE_5882_length_1042_cov_23.861082	572	652	2	20	80	0.2500000
NODE_5882_length_1042_cov_23.861082	572	652	3	31	80	0.3875000
NODE_5882_length_1042_cov_23.861082	572	652	4	29	80	0.3625000
NODE_5882_length_1042_cov_23.861082	648	728	2	5	80	0.0625000
NODE_5882_length_1042_cov_23.861082	648	728	4	1	80	0.0125000
NODE_5882_length_1042_cov_23.861082	648	728	5	4	80	0.0500000
NODE_5882_length_1042_cov_23.861082	648	728	6	16	80	0.2000000
NODE_5882_length_1042_cov_23.861082	648	728	7	54	80	0.6750000
NODE_5882_length_1042_cov_23.861082	701	781	5	4	80	0.0500000
NODE_5882_length_1042_cov_23.861082	701	781	6	10	80	0.1250000
NODE_5882_length_1042_cov_23.861082	701	781	7	17	80	0.2125000
NODE_5882_length_1042_cov_23.861082	701	781	9	41	80	0.5125000
NODE_5882_length_1042_cov_23.861082	701	781	10	8	80	0.1000000
NODE_5883_length_1042_cov_22.247084	555	635	0	57	80	0.7125000
NODE_5883_length_1042_cov_22.247084	555	635	1	8	80	0.1000000
NODE_5883_length_1042_cov_22.247084	555	635	2	15	80	0.1875000
NODE_5883_length_1042_cov_22.247084	608	688	0	4	80	0.0500000
NODE_5883_length_1042_cov_22.247084	608	688	1	8	80	0.1000000
NODE_5883_length_1042_cov_22.247084	608	688	2	42	80	0.5250000
NODE_5883_length_1042_cov_22.247084	608	688	3	14	80	0.1750000
NODE_5883_length_1042_cov_22.247084	608	688	4	12	80	0.1500000
NODE_5884_length_1042_cov_22.117709	335	415	1	5	80	0.0625000
NODE_5884_length_1042_cov_22.117709	335	415	2	2	80	0.0250000
NODE_5884_length_1042_cov_22.117709	335	415	3	22	80	0.2750000
NODE_5884_length_1042_cov_22.117709	335	415	4	51	80	0.6375000
NODE_5884_length_1042_cov_22.117709	388	468	0	33	80	0.4125000
NODE_5884_length_1042_cov_22.117709	388	468	1	25	80	0.3125000
NODE_5884_length_1042_cov_22.117709	388	468	2	2	80	0.0250000
NODE_5884_length_1042_cov_22.117709	388	468	3	20	80	0.2500000
NODE_5884_length_1042_cov_22.117709	464	544	0	80	80	1.0000000
NODE_5884_length_1042_cov_22.117709	517	597	0	80	80	1.0000000
NODE_5885_length_1042_cov_16.831389	27	97	0	70	70	1.0000000
NODE_5885_length_1042_cov_16.831389	372	452	3	69	80	0.8625000
NODE_5885_length_1042_cov_16.831389	372	452	4	11	80	0.1375000
NODE_5885_length_1042_cov_16.831389	425	505	1	30	80	0.3750000
NODE_5885_length_1042_cov_16.831389	425	505	2	1	80	0.0125000
NODE_5885_length_1042_cov_16.831389	425	505	3	16	80	0.2000000
NODE_5885_length_1042_cov_16.831389	425	505	4	33	80	0.4125000
NODE_5886_length_1042_cov_16.662778	416	496	20	9	80	0.1125000
NODE_5886_length_1042_cov_16.662778	416	496	21	9	80	0.1125000
NODE_5886_length_1042_cov_16.662778	416	496	22	22	80	0.2750000
NODE_5886_length_1042_cov_16.662778	416	496	23	20	80	0.2500000
NODE_5886_length_1042_cov_16.662778	416	496	24	15	80	0.1875000
NODE_5886_length_1042_cov_16.662778	416	496	25	5	80	0.0625000
NODE_5886_length_1042_cov_16.662778	469	549	9	1	80	0.0125000
NODE_5886_length_1042_cov_16.662778	469	549	10	1	80	0.0125000
NODE_5886_length_1042_cov_16.662778	469	549	12	2	80	0.0250000
NODE_5886_length_1042_cov_16.662778	469	549	17	6	80	0.0750000
NODE_5886_length_1042_cov_16.662778	469	549	20	7	80	0.0875000
NODE_5886_length_1042_cov_16.662778	469	549	21	4	80	0.0500000
NODE_5886_length_1042_cov_16.662778	469	549	22	14	80	0.1750000
NODE_5886_length_1042_cov_16.662778	469	549	23	8	80	0.1000000
NODE_5886_length_1042_cov_16.662778	469	549	24	28	80	0.3500000
NODE_5886_length_1042_cov_16.662778	469	549	25	5	80	0.0625000
NODE_5886_length_1042_cov_16.662778	469	549	26	4	80	0.0500000
NODE_5887_length_1042_cov_9.474019	361	441	4	17	80	0.2125000
NODE_5887_length_1042_cov_9.474019	361	441	5	20	80	0.2500000
NODE_5887_length_1042_cov_9.474019	361	441	6	23	80	0.2875000
NODE_5887_length_1042_cov_9.474019	361	441	7	7	80	0.0875000
NODE_5887_length_1042_cov_9.474019	361	441	8	13	80	0.1625000
NODE_5887_length_1042_cov_9.474019	414	494	5	4	80	0.0500000
NODE_5887_length_1042_cov_9.474019	414	494	6	32	80	0.4000000
NODE_5887_length_1042_cov_9.474019	414	494	7	44	80	0.5500000
NODE_5888_length_1042_cov_6.725345	356	419	0	63	63	1.0000000
NODE_5888_length_1042_cov_6.725345	392	472	0	80	80	1.0000000
NODE_5896_length_1041_cov_42.960722	335	415	0	71	80	0.8875000
NODE_5896_length_1041_cov_42.960722	335	415	3	9	80	0.1125000
NODE_5896_length_1041_cov_42.960722	388	468	0	18	80	0.2250000
NODE_5896_length_1041_cov_42.960722	388	468	3	19	80	0.2375000
NODE_5896_length_1041_cov_42.960722	388	468	5	9	80	0.1125000
NODE_5896_length_1041_cov_42.960722	388	468	6	5	80	0.0625000
NODE_5896_length_1041_cov_42.960722	388	468	8	14	80	0.1750000
NODE_5896_length_1041_cov_42.960722	388	468	9	15	80	0.1875000
NODE_5896_length_1041_cov_42.960722	464	544	9	10	80	0.1250000
NODE_5896_length_1041_cov_42.960722	464	544	10	9	80	0.1125000
NODE_5896_length_1041_cov_42.960722	464	544	12	1	80	0.0125000
NODE_5896_length_1041_cov_42.960722	464	544	13	1	80	0.0125000
NODE_5896_length_1041_cov_42.960722	464	544	15	8	80	0.1000000
NODE_5896_length_1041_cov_42.960722	464	544	16	41	80	0.5125000
NODE_5896_length_1041_cov_42.960722	464	544	17	6	80	0.0750000
NODE_5896_length_1041_cov_42.960722	464	544	18	4	80	0.0500000
NODE_5896_length_1041_cov_42.960722	517	597	12	8	80	0.1000000
NODE_5896_length_1041_cov_42.960722	517	597	13	1	80	0.0125000
NODE_5896_length_1041_cov_42.960722	517	597	14	4	80	0.0500000
NODE_5896_length_1041_cov_42.960722	517	597	15	9	80	0.1125000
NODE_5896_length_1041_cov_42.960722	517	597	16	35	80	0.4375000
NODE_5896_length_1041_cov_42.960722	517	597	17	7	80	0.0875000
NODE_5896_length_1041_cov_42.960722	517	597	18	15	80	0.1875000
NODE_5896_length_1041_cov_42.960722	517	597	19	1	80	0.0125000
NODE_5897_length_1041_cov_37.331210	513	593	5	9	80	0.1125000
NODE_5897_length_1041_cov_37.331210	513	593	6	7	80	0.0875000
NODE_5897_length_1041_cov_37.331210	513	593	7	11	80	0.1375000
NODE_5897_length_1041_cov_37.331210	513	593	8	11	80	0.1375000
NODE_5897_length_1041_cov_37.331210	513	593	9	21	80	0.2625000
NODE_5897_length_1041_cov_37.331210	513	593	11	3	80	0.0375000
NODE_5897_length_1041_cov_37.331210	513	593	12	14	80	0.1750000
NODE_5897_length_1041_cov_37.331210	513	593	13	4	80	0.0500000
NODE_5897_length_1041_cov_37.331210	566	646	8	1	80	0.0125000
NODE_5897_length_1041_cov_37.331210	566	646	9	5	80	0.0625000
NODE_5897_length_1041_cov_37.331210	566	646	11	3	80	0.0375000
NODE_5897_length_1041_cov_37.331210	566	646	12	14	80	0.1750000
NODE_5897_length_1041_cov_37.331210	566	646	13	14	80	0.1750000
NODE_5897_length_1041_cov_37.331210	566	646	14	43	80	0.5375000
NODE_5897_length_1041_cov_37.331210	642	722	14	5	80	0.0625000
NODE_5897_length_1041_cov_37.331210	642	722	15	7	80	0.0875000
NODE_5897_length_1041_cov_37.331210	642	722	17	10	80	0.1250000
NODE_5897_length_1041_cov_37.331210	642	722	18	21	80	0.2625000
NODE_5897_length_1041_cov_37.331210	642	722	19	22	80	0.2750000
NODE_5897_length_1041_cov_37.331210	642	722	20	15	80	0.1875000
NODE_5897_length_1041_cov_37.331210	695	775	12	3	80	0.0375000
NODE_5897_length_1041_cov_37.331210	695	775	13	19	80	0.2375000
NODE_5897_length_1041_cov_37.331210	695	775	14	14	80	0.1750000
NODE_5897_length_1041_cov_37.331210	695	775	15	14	80	0.1750000
NODE_5897_length_1041_cov_37.331210	695	775	16	3	80	0.0375000
NODE_5897_length_1041_cov_37.331210	695	775	18	11	80	0.1375000
NODE_5897_length_1041_cov_37.331210	695	775	19	5	80	0.0625000
NODE_5897_length_1041_cov_37.331210	695	775	20	11	80	0.1375000
NODE_5898_length_1041_cov_36.477707	455	535	18	6	80	0.0750000
NODE_5898_length_1041_cov_36.477707	455	535	19	10	80	0.1250000
NODE_5898_length_1041_cov_36.477707	455	535	20	2	80	0.0250000
NODE_5898_length_1041_cov_36.477707	455	535	21	3	80	0.0375000
NODE_5898_length_1041_cov_36.477707	455	535	23	1	80	0.0125000
NODE_5898_length_1041_cov_36.477707	455	535	24	17	80	0.2125000
NODE_5898_length_1041_cov_36.477707	455	535	25	20	80	0.2500000
NODE_5898_length_1041_cov_36.477707	455	535	26	18	80	0.2250000
NODE_5898_length_1041_cov_36.477707	455	535	27	2	80	0.0250000
NODE_5898_length_1041_cov_36.477707	455	535	28	1	80	0.0125000
NODE_5898_length_1041_cov_36.477707	508	588	13	4	80	0.0500000
NODE_5898_length_1041_cov_36.477707	508	588	14	2	80	0.0250000
NODE_5898_length_1041_cov_36.477707	508	588	15	14	80	0.1750000
NODE_5898_length_1041_cov_36.477707	508	588	17	9	80	0.1125000
NODE_5898_length_1041_cov_36.477707	508	588	18	30	80	0.3750000
NODE_5898_length_1041_cov_36.477707	508	588	19	10	80	0.1250000
NODE_5898_length_1041_cov_36.477707	508	588	20	2	80	0.0250000
NODE_5898_length_1041_cov_36.477707	508	588	21	3	80	0.0375000
NODE_5898_length_1041_cov_36.477707	508	588	25	6	80	0.0750000
NODE_5898_length_1041_cov_36.477707	584	664	3	20	80	0.2500000
NODE_5898_length_1041_cov_36.477707	584	664	4	10	80	0.1250000
NODE_5898_length_1041_cov_36.477707	584	664	6	38	80	0.4750000
NODE_5898_length_1041_cov_36.477707	584	664	7	2	80	0.0250000
NODE_5898_length_1041_cov_36.477707	584	664	11	4	80	0.0500000
NODE_5898_length_1041_cov_36.477707	584	664	13	6	80	0.0750000
NODE_5898_length_1041_cov_36.477707	637	717	2	4	80	0.0500000
NODE_5898_length_1041_cov_36.477707	637	717	3	22	80	0.2750000
NODE_5898_length_1041_cov_36.477707	637	717	4	23	80	0.2875000
NODE_5898_length_1041_cov_36.477707	637	717	5	31	80	0.3875000
NODE_5898_length_1041_cov_36.477707	753	799	3	46	46	1.0000000
NODE_5899_length_1041_cov_19.286624	468	548	13	1	80	0.0125000
NODE_5899_length_1041_cov_19.286624	468	548	14	7	80	0.0875000
NODE_5899_length_1041_cov_19.286624	468	548	15	25	80	0.3125000
NODE_5899_length_1041_cov_19.286624	468	548	16	4	80	0.0500000
NODE_5899_length_1041_cov_19.286624	468	548	18	43	80	0.5375000
NODE_5899_length_1041_cov_19.286624	521	601	11	4	80	0.0500000
NODE_5899_length_1041_cov_19.286624	521	601	12	4	80	0.0500000
NODE_5899_length_1041_cov_19.286624	521	601	13	6	80	0.0750000
NODE_5899_length_1041_cov_19.286624	521	601	15	16	80	0.2000000
NODE_5899_length_1041_cov_19.286624	521	601	16	1	80	0.0125000
NODE_5899_length_1041_cov_19.286624	521	601	17	1	80	0.0125000
NODE_5899_length_1041_cov_19.286624	521	601	18	29	80	0.3625000
NODE_5899_length_1041_cov_19.286624	521	601	19	1	80	0.0125000
NODE_5899_length_1041_cov_19.286624	521	601	20	18	80	0.2250000
NODE_5900_length_1041_cov_17.072187	578	658	5	10	80	0.1250000
NODE_5900_length_1041_cov_17.072187	578	658	6	26	80	0.3250000
NODE_5900_length_1041_cov_17.072187	578	658	7	39	80	0.4875000
NODE_5900_length_1041_cov_17.072187	578	658	8	5	80	0.0625000
NODE_5900_length_1041_cov_17.072187	631	711	5	49	80	0.6125000
NODE_5900_length_1041_cov_17.072187	631	711	6	17	80	0.2125000
NODE_5900_length_1041_cov_17.072187	631	711	7	9	80	0.1125000
NODE_5900_length_1041_cov_17.072187	631	711	8	5	80	0.0625000
NODE_5901_length_1041_cov_11.887473	437	517	15	1	80	0.0125000
NODE_5901_length_1041_cov_11.887473	437	517	16	15	80	0.1875000
NODE_5901_length_1041_cov_11.887473	437	517	17	14	80	0.1750000
NODE_5901_length_1041_cov_11.887473	437	517	18	48	80	0.6000000
NODE_5901_length_1041_cov_11.887473	437	517	19	2	80	0.0250000
NODE_5901_length_1041_cov_11.887473	490	570	13	43	80	0.5375000
NODE_5901_length_1041_cov_11.887473	490	570	15	8	80	0.1000000
NODE_5901_length_1041_cov_11.887473	490	570	16	10	80	0.1250000
NODE_5901_length_1041_cov_11.887473	490	570	17	6	80	0.0750000
NODE_5901_length_1041_cov_11.887473	490	570	18	13	80	0.1625000
NODE_5902_length_1041_cov_6.957537	354	434	1	7	80	0.0875000
NODE_5902_length_1041_cov_6.957537	354	434	2	73	80	0.9125000
NODE_5902_length_1041_cov_6.957537	407	487	0	5	80	0.0625000
NODE_5902_length_1041_cov_6.957537	407	487	1	55	80	0.6875000
NODE_5902_length_1041_cov_6.957537	407	487	2	20	80	0.2500000
NODE_5913_length_1040_cov_34.618491	478	558	4	4	80	0.0500000
NODE_5913_length_1040_cov_34.618491	478	558	5	4	80	0.0500000
NODE_5913_length_1040_cov_34.618491	478	558	6	19	80	0.2375000
NODE_5913_length_1040_cov_34.618491	478	558	8	21	80	0.2625000
NODE_5913_length_1040_cov_34.618491	478	558	10	7	80	0.0875000
NODE_5913_length_1040_cov_34.618491	478	558	11	2	80	0.0250000
NODE_5913_length_1040_cov_34.618491	478	558	12	23	80	0.2875000
NODE_5913_length_1040_cov_34.618491	531	611	10	2	80	0.0250000
NODE_5913_length_1040_cov_34.618491	531	611	11	2	80	0.0250000
NODE_5913_length_1040_cov_34.618491	531	611	12	26	80	0.3250000
NODE_5913_length_1040_cov_34.618491	531	611	14	21	80	0.2625000
NODE_5913_length_1040_cov_34.618491	531	611	15	3	80	0.0375000
NODE_5913_length_1040_cov_34.618491	531	611	16	26	80	0.3250000
NODE_5914_length_1040_cov_33.061637	485	565	2	2	80	0.0250000
NODE_5914_length_1040_cov_33.061637	485	565	4	43	80	0.5375000
NODE_5914_length_1040_cov_33.061637	485	565	5	15	80	0.1875000
NODE_5914_length_1040_cov_33.061637	485	565	6	14	80	0.1750000
NODE_5914_length_1040_cov_33.061637	485	565	7	6	80	0.0750000
NODE_5914_length_1040_cov_33.061637	538	618	5	7	80	0.0875000
NODE_5914_length_1040_cov_33.061637	538	618	6	44	80	0.5500000
NODE_5914_length_1040_cov_33.061637	538	618	7	29	80	0.3625000
NODE_5915_length_1040_cov_27.818278	402	482	5	34	80	0.4250000
NODE_5915_length_1040_cov_27.818278	402	482	8	28	80	0.3500000
NODE_5915_length_1040_cov_27.818278	402	482	9	18	80	0.2250000
NODE_5915_length_1040_cov_27.818278	455	535	6	25	80	0.3125000
NODE_5915_length_1040_cov_27.818278	455	535	7	27	80	0.3375000
NODE_5915_length_1040_cov_27.818278	455	535	8	24	80	0.3000000
NODE_5915_length_1040_cov_27.818278	455	535	9	4	80	0.0500000
NODE_5916_length_1040_cov_17.933050	487	567	9	21	80	0.2625000
NODE_5916_length_1040_cov_17.933050	487	567	10	15	80	0.1875000
NODE_5916_length_1040_cov_17.933050	487	567	11	1	80	0.0125000
NODE_5916_length_1040_cov_17.933050	487	567	12	31	80	0.3875000
NODE_5916_length_1040_cov_17.933050	487	567	13	12	80	0.1500000
NODE_5916_length_1040_cov_17.933050	540	620	10	15	80	0.1875000
NODE_5916_length_1040_cov_17.933050	540	620	11	7	80	0.0875000
NODE_5916_length_1040_cov_17.933050	540	620	12	18	80	0.2250000
NODE_5916_length_1040_cov_17.933050	540	620	13	40	80	0.5000000
NODE_5917_length_1040_cov_14.327311	237	317	0	80	80	1.0000000
NODE_5917_length_1040_cov_14.327311	290	370	0	80	80	1.0000000
NODE_5917_length_1040_cov_14.327311	366	446	0	80	80	1.0000000
NODE_5917_length_1040_cov_14.327311	419	499	0	27	80	0.3375000
NODE_5917_length_1040_cov_14.327311	419	499	2	53	80	0.6625000
NODE_5918_length_1040_cov_11.910733	369	449	2	80	80	1.0000000
NODE_5918_length_1040_cov_11.910733	422	502	0	51	80	0.6375000
NODE_5918_length_1040_cov_11.910733	422	502	2	29	80	0.3625000
NODE_5919_length_1040_cov_11.521785	355	435	5	16	80	0.2000000
NODE_5919_length_1040_cov_11.521785	355	435	6	18	80	0.2250000
NODE_5919_length_1040_cov_11.521785	355	435	7	9	80	0.1125000
NODE_5919_length_1040_cov_11.521785	355	435	8	19	80	0.2375000
NODE_5919_length_1040_cov_11.521785	355	435	9	6	80	0.0750000
NODE_5919_length_1040_cov_11.521785	355	435	10	3	80	0.0375000
NODE_5919_length_1040_cov_11.521785	355	435	11	9	80	0.1125000
NODE_5919_length_1040_cov_11.521785	408	488	8	9	80	0.1125000
NODE_5919_length_1040_cov_11.521785	408	488	9	23	80	0.2875000
NODE_5919_length_1040_cov_11.521785	408	488	10	5	80	0.0625000
NODE_5919_length_1040_cov_11.521785	408	488	11	43	80	0.5375000
NODE_5920_length_1040_cov_9.573858	632	712	8	14	80	0.1750000
NODE_5920_length_1040_cov_9.573858	632	712	9	66	80	0.8250000
NODE_5920_length_1040_cov_9.573858	685	765	1	18	80	0.2250000
NODE_5920_length_1040_cov_9.573858	685	765	4	1	80	0.0125000
NODE_5920_length_1040_cov_9.573858	685	765	5	1	80	0.0125000
NODE_5920_length_1040_cov_9.573858	685	765	6	3	80	0.0375000
NODE_5920_length_1040_cov_9.573858	685	765	7	16	80	0.2000000
NODE_5920_length_1040_cov_9.573858	685	765	8	28	80	0.3500000
NODE_5920_length_1040_cov_9.573858	685	765	9	13	80	0.1625000
NODE_5921_length_1040_cov_8.148778	349	429	0	80	80	1.0000000
NODE_5921_length_1040_cov_8.148778	402	482	0	80	80	1.0000000
NODE_5922_length_1040_cov_7.927736	282	362	3	19	80	0.2375000
NODE_5922_length_1040_cov_7.927736	282	362	4	2	80	0.0250000
NODE_5922_length_1040_cov_7.927736	282	362	6	33	80	0.4125000
NODE_5922_length_1040_cov_7.927736	282	362	7	26	80	0.3250000
NODE_5922_length_1040_cov_7.927736	335	415	5	1	80	0.0125000
NODE_5922_length_1040_cov_7.927736	335	415	6	79	80	0.9875000
NODE_5927_length_1040_cov_2.317747	2	78	0	76	76	1.0000000
NODE_5934_length_1039_cov_40.150000	487	567	2	36	80	0.4500000
NODE_5934_length_1039_cov_40.150000	487	567	4	44	80	0.5500000
NODE_5934_length_1039_cov_40.150000	540	620	4	42	80	0.5250000
NODE_5934_length_1039_cov_40.150000	540	620	5	3	80	0.0375000
NODE_5934_length_1039_cov_40.150000	540	620	6	14	80	0.1750000
NODE_5934_length_1039_cov_40.150000	540	620	7	19	80	0.2375000
NODE_5934_length_1039_cov_40.150000	540	620	8	2	80	0.0250000
NODE_5934_length_1039_cov_40.150000	616	696	7	2	80	0.0250000
NODE_5934_length_1039_cov_40.150000	616	696	8	2	80	0.0250000
NODE_5934_length_1039_cov_40.150000	616	696	9	25	80	0.3125000
NODE_5934_length_1039_cov_40.150000	616	696	10	7	80	0.0875000
NODE_5934_length_1039_cov_40.150000	616	696	11	14	80	0.1750000
NODE_5934_length_1039_cov_40.150000	616	696	12	2	80	0.0250000
NODE_5934_length_1039_cov_40.150000	616	696	13	2	80	0.0250000
NODE_5934_length_1039_cov_40.150000	616	696	14	8	80	0.1000000
NODE_5934_length_1039_cov_40.150000	616	696	15	8	80	0.1000000
NODE_5934_length_1039_cov_40.150000	616	696	16	10	80	0.1250000
NODE_5934_length_1039_cov_40.150000	669	739	12	2	70	0.0285714
NODE_5934_length_1039_cov_40.150000	669	739	14	11	70	0.1571429
NODE_5934_length_1039_cov_40.150000	669	739	15	11	70	0.1571429
NODE_5934_length_1039_cov_40.150000	669	739	16	46	70	0.6571429
NODE_5935_length_1039_cov_37.940426	175	255	2	1	80	0.0125000
NODE_5935_length_1039_cov_37.940426	175	255	3	21	80	0.2625000
NODE_5935_length_1039_cov_37.940426	175	255	5	22	80	0.2750000
NODE_5935_length_1039_cov_37.940426	175	255	7	16	80	0.2000000
NODE_5935_length_1039_cov_37.940426	175	255	9	20	80	0.2500000
NODE_5935_length_1039_cov_37.940426	228	308	7	7	80	0.0875000
NODE_5935_length_1039_cov_37.940426	228	308	9	26	80	0.3250000
NODE_5935_length_1039_cov_37.940426	228	308	10	10	80	0.1250000
NODE_5935_length_1039_cov_37.940426	228	308	11	17	80	0.2125000
NODE_5935_length_1039_cov_37.940426	228	308	12	15	80	0.1875000
NODE_5935_length_1039_cov_37.940426	228	308	13	4	80	0.0500000
NODE_5935_length_1039_cov_37.940426	228	308	15	1	80	0.0125000
NODE_5935_length_1039_cov_37.940426	304	384	13	3	80	0.0375000
NODE_5935_length_1039_cov_37.940426	304	384	14	20	80	0.2500000
NODE_5935_length_1039_cov_37.940426	304	384	15	34	80	0.4250000
NODE_5935_length_1039_cov_37.940426	304	384	16	23	80	0.2875000
NODE_5935_length_1039_cov_37.940426	357	437	9	16	80	0.2000000
NODE_5935_length_1039_cov_37.940426	357	437	11	10	80	0.1250000
NODE_5935_length_1039_cov_37.940426	357	437	12	26	80	0.3250000
NODE_5935_length_1039_cov_37.940426	357	437	14	16	80	0.2000000
NODE_5935_length_1039_cov_37.940426	357	437	16	12	80	0.1500000
NODE_5936_length_1039_cov_24.567021	371	451	11	1	80	0.0125000
NODE_5936_length_1039_cov_24.567021	371	451	12	21	80	0.2625000
NODE_5936_length_1039_cov_24.567021	371	451	13	10	80	0.1250000
NODE_5936_length_1039_cov_24.567021	371	451	14	45	80	0.5625000
NODE_5936_length_1039_cov_24.567021	371	451	15	3	80	0.0375000
NODE_5936_length_1039_cov_24.567021	424	504	9	25	80	0.3125000
NODE_5936_length_1039_cov_24.567021	424	504	11	1	80	0.0125000
NODE_5936_length_1039_cov_24.567021	424	504	12	17	80	0.2125000
NODE_5936_length_1039_cov_24.567021	424	504	14	34	80	0.4250000
NODE_5936_length_1039_cov_24.567021	424	504	15	3	80	0.0375000
NODE_5937_length_1039_cov_15.790426	293	373	8	4	80	0.0500000
NODE_5937_length_1039_cov_15.790426	293	373	9	29	80	0.3625000
NODE_5937_length_1039_cov_15.790426	293	373	10	44	80	0.5500000
NODE_5937_length_1039_cov_15.790426	293	373	11	2	80	0.0250000
NODE_5937_length_1039_cov_15.790426	293	373	12	1	80	0.0125000
NODE_5937_length_1039_cov_15.790426	346	426	5	30	80	0.3750000
NODE_5937_length_1039_cov_15.790426	346	426	8	26	80	0.3250000
NODE_5937_length_1039_cov_15.790426	346	426	9	24	80	0.3000000
NODE_5938_length_1039_cov_14.670213	591	671	4	2	80	0.0250000
NODE_5938_length_1039_cov_14.670213	591	671	5	7	80	0.0875000
NODE_5938_length_1039_cov_14.670213	591	671	6	36	80	0.4500000
NODE_5938_length_1039_cov_14.670213	591	671	7	12	80	0.1500000
NODE_5938_length_1039_cov_14.670213	591	671	8	4	80	0.0500000
NODE_5938_length_1039_cov_14.670213	591	671	9	19	80	0.2375000
NODE_5938_length_1039_cov_14.670213	644	724	6	19	80	0.2375000
NODE_5938_length_1039_cov_14.670213	644	724	8	4	80	0.0500000
NODE_5938_length_1039_cov_14.670213	644	724	9	57	80	0.7125000
NODE_5939_length_1039_cov_11.568085	439	519	2	1	80	0.0125000
NODE_5939_length_1039_cov_11.568085	439	519	5	25	80	0.3125000
NODE_5939_length_1039_cov_11.568085	439	519	6	18	80	0.2250000
NODE_5939_length_1039_cov_11.568085	439	519	7	36	80	0.4500000
NODE_5939_length_1039_cov_11.568085	492	571	6	18	79	0.2278481
NODE_5939_length_1039_cov_11.568085	492	571	7	9	79	0.1139240
NODE_5939_length_1039_cov_11.568085	492	571	8	26	79	0.3291139
NODE_5939_length_1039_cov_11.568085	492	571	9	6	79	0.0759494
NODE_5939_length_1039_cov_11.568085	492	571	10	20	79	0.2531646
NODE_5947_length_1038_cov_17.191693	549	629	2	18	80	0.2250000
NODE_5947_length_1038_cov_17.191693	549	629	3	4	80	0.0500000
NODE_5947_length_1038_cov_17.191693	549	629	4	22	80	0.2750000
NODE_5947_length_1038_cov_17.191693	549	629	5	36	80	0.4500000
NODE_5947_length_1038_cov_17.191693	602	682	3	16	80	0.2000000
NODE_5947_length_1038_cov_17.191693	602	682	4	18	80	0.2250000
NODE_5947_length_1038_cov_17.191693	602	682	5	28	80	0.3500000
NODE_5947_length_1038_cov_17.191693	602	682	6	18	80	0.2250000
NODE_5948_length_1038_cov_13.520767	516	596	0	80	80	1.0000000
NODE_5948_length_1038_cov_13.520767	569	649	0	80	80	1.0000000
NODE_5949_length_1038_cov_10.541001	487	567	5	12	80	0.1500000
NODE_5949_length_1038_cov_10.541001	487	567	6	8	80	0.1000000
NODE_5949_length_1038_cov_10.541001	487	567	7	7	80	0.0875000
NODE_5949_length_1038_cov_10.541001	487	567	8	25	80	0.3125000
NODE_5949_length_1038_cov_10.541001	487	567	9	18	80	0.2250000
NODE_5949_length_1038_cov_10.541001	487	567	10	10	80	0.1250000
NODE_5949_length_1038_cov_10.541001	540	620	3	36	80	0.4500000
NODE_5949_length_1038_cov_10.541001	540	620	4	6	80	0.0750000
NODE_5949_length_1038_cov_10.541001	540	620	5	23	80	0.2875000
NODE_5949_length_1038_cov_10.541001	540	620	6	8	80	0.1000000
NODE_5949_length_1038_cov_10.541001	540	620	8	7	80	0.0875000
NODE_5950_length_1038_cov_8.826411	432	512	1	2	80	0.0250000
NODE_5950_length_1038_cov_8.826411	432	512	2	78	80	0.9750000
NODE_5950_length_1038_cov_8.826411	485	565	0	13	80	0.1625000
NODE_5950_length_1038_cov_8.826411	485	565	1	42	80	0.5250000
NODE_5950_length_1038_cov_8.826411	485	565	2	25	80	0.3125000
NODE_5952_length_1038_cov_2.587859	673	753	0	80	80	1.0000000
NODE_5952_length_1038_cov_2.587859	726	806	0	80	80	1.0000000
NODE_5963_length_1037_cov_66.968017	402	482	0	4	80	0.0500000
NODE_5963_length_1037_cov_66.968017	402	482	5	27	80	0.3375000
NODE_5963_length_1037_cov_66.968017	402	482	6	11	80	0.1375000
NODE_5963_length_1037_cov_66.968017	402	482	8	24	80	0.3000000
NODE_5963_length_1037_cov_66.968017	402	482	9	14	80	0.1750000
NODE_5963_length_1037_cov_66.968017	455	535	8	13	80	0.1625000
NODE_5963_length_1037_cov_66.968017	455	535	9	30	80	0.3750000
NODE_5963_length_1037_cov_66.968017	455	535	13	1	80	0.0125000
NODE_5963_length_1037_cov_66.968017	455	535	14	36	80	0.4500000
NODE_5964_length_1037_cov_53.639659	527	607	22	1	80	0.0125000
NODE_5964_length_1037_cov_53.639659	527	607	24	2	80	0.0250000
NODE_5964_length_1037_cov_53.639659	527	607	26	1	80	0.0125000
NODE_5964_length_1037_cov_53.639659	527	607	27	1	80	0.0125000
NODE_5964_length_1037_cov_53.639659	527	607	28	1	80	0.0125000
NODE_5964_length_1037_cov_53.639659	527	607	29	6	80	0.0750000
NODE_5964_length_1037_cov_53.639659	527	607	31	1	80	0.0125000
NODE_5964_length_1037_cov_53.639659	527	607	32	2	80	0.0250000
NODE_5964_length_1037_cov_53.639659	527	607	33	11	80	0.1375000
NODE_5964_length_1037_cov_53.639659	527	607	34	7	80	0.0875000
NODE_5964_length_1037_cov_53.639659	527	607	35	7	80	0.0875000
NODE_5964_length_1037_cov_53.639659	527	607	36	12	80	0.1500000
NODE_5964_length_1037_cov_53.639659	527	607	38	7	80	0.0875000
NODE_5964_length_1037_cov_53.639659	527	607	39	21	80	0.2625000
NODE_5964_length_1037_cov_53.639659	580	660	28	5	80	0.0625000
NODE_5964_length_1037_cov_53.639659	580	660	29	1	80	0.0125000
NODE_5964_length_1037_cov_53.639659	580	660	30	16	80	0.2000000
NODE_5964_length_1037_cov_53.639659	580	660	31	9	80	0.1125000
NODE_5964_length_1037_cov_53.639659	580	660	33	1	80	0.0125000
NODE_5964_length_1037_cov_53.639659	580	660	34	4	80	0.0500000
NODE_5964_length_1037_cov_53.639659	580	660	36	14	80	0.1750000
NODE_5964_length_1037_cov_53.639659	580	660	37	2	80	0.0250000
NODE_5964_length_1037_cov_53.639659	580	660	38	7	80	0.0875000
NODE_5964_length_1037_cov_53.639659	580	660	39	21	80	0.2625000
NODE_5965_length_1037_cov_45.353945	542	622	9	2	80	0.0250000
NODE_5965_length_1037_cov_45.353945	542	622	10	7	80	0.0875000
NODE_5965_length_1037_cov_45.353945	542	622	11	18	80	0.2250000
NODE_5965_length_1037_cov_45.353945	542	622	12	3	80	0.0375000
NODE_5965_length_1037_cov_45.353945	542	622	13	43	80	0.5375000
NODE_5965_length_1037_cov_45.353945	542	622	14	7	80	0.0875000
NODE_5965_length_1037_cov_45.353945	595	675	5	2	80	0.0250000
NODE_5965_length_1037_cov_45.353945	595	675	6	24	80	0.3000000
NODE_5965_length_1037_cov_45.353945	595	675	7	3	80	0.0375000
NODE_5965_length_1037_cov_45.353945	595	675	8	13	80	0.1625000
NODE_5965_length_1037_cov_45.353945	595	675	9	1	80	0.0125000
NODE_5965_length_1037_cov_45.353945	595	675	10	2	80	0.0250000
NODE_5965_length_1037_cov_45.353945	595	675	11	16	80	0.2000000
NODE_5965_length_1037_cov_45.353945	595	675	13	19	80	0.2375000
NODE_5966_length_1037_cov_31.078891	356	436	0	42	80	0.5250000
NODE_5966_length_1037_cov_31.078891	356	436	6	2	80	0.0250000
NODE_5966_length_1037_cov_31.078891	356	436	7	36	80	0.4500000
NODE_5966_length_1037_cov_31.078891	409	489	0	80	80	1.0000000
NODE_5967_length_1037_cov_25.453092	421	501	12	17	80	0.2125000
NODE_5967_length_1037_cov_25.453092	421	501	13	12	80	0.1500000
NODE_5967_length_1037_cov_25.453092	421	501	14	10	80	0.1250000
NODE_5967_length_1037_cov_25.453092	421	501	15	2	80	0.0250000
NODE_5967_length_1037_cov_25.453092	421	501	17	10	80	0.1250000
NODE_5967_length_1037_cov_25.453092	421	501	19	29	80	0.3625000
NODE_5967_length_1037_cov_25.453092	474	554	7	19	80	0.2375000
NODE_5967_length_1037_cov_25.453092	474	554	10	18	80	0.2250000
NODE_5967_length_1037_cov_25.453092	474	554	11	8	80	0.1000000
NODE_5967_length_1037_cov_25.453092	474	554	12	16	80	0.2000000
NODE_5967_length_1037_cov_25.453092	474	554	13	19	80	0.2375000
NODE_5967_length_1037_cov_25.453092	550	573	3	13	23	0.5652174
NODE_5967_length_1037_cov_25.453092	550	573	7	10	23	0.4347826
NODE_5968_length_1037_cov_13.740938	348	428	1	25	80	0.3125000
NODE_5968_length_1037_cov_13.740938	348	428	2	10	80	0.1250000
NODE_5968_length_1037_cov_13.740938	348	428	3	11	80	0.1375000
NODE_5968_length_1037_cov_13.740938	348	428	6	34	80	0.4250000
NODE_5968_length_1037_cov_13.740938	401	481	6	54	80	0.6750000
NODE_5968_length_1037_cov_13.740938	401	481	7	26	80	0.3250000
NODE_5969_length_1037_cov_12.632196	564	644	1	26	80	0.3250000
NODE_5969_length_1037_cov_12.632196	564	644	2	32	80	0.4000000
NODE_5969_length_1037_cov_12.632196	564	644	3	22	80	0.2750000
NODE_5969_length_1037_cov_12.632196	617	697	1	5	80	0.0625000
NODE_5969_length_1037_cov_12.632196	617	697	2	46	80	0.5750000
NODE_5969_length_1037_cov_12.632196	617	697	3	29	80	0.3625000
NODE_5970_length_1037_cov_8.904051	640	720	2	19	80	0.2375000
NODE_5970_length_1037_cov_8.904051	640	720	4	61	80	0.7625000
NODE_5970_length_1037_cov_8.904051	693	773	2	65	80	0.8125000
NODE_5970_length_1037_cov_8.904051	693	773	4	8	80	0.1000000
NODE_5970_length_1037_cov_8.904051	693	773	6	7	80	0.0875000
NODE_5978_length_1037_cov_1.859275	31	91	3	60	60	1.0000000
NODE_5986_length_1036_cov_52.270011	493	573	16	10	80	0.1250000
NODE_5986_length_1036_cov_52.270011	493	573	17	14	80	0.1750000
NODE_5986_length_1036_cov_52.270011	493	573	20	4	80	0.0500000
NODE_5986_length_1036_cov_52.270011	493	573	21	12	80	0.1500000
NODE_5986_length_1036_cov_52.270011	493	573	22	13	80	0.1625000
NODE_5986_length_1036_cov_52.270011	493	573	23	11	80	0.1375000
NODE_5986_length_1036_cov_52.270011	493	573	24	16	80	0.2000000
NODE_5986_length_1036_cov_52.270011	546	626	18	13	80	0.1625000
NODE_5986_length_1036_cov_52.270011	546	626	19	10	80	0.1250000
NODE_5986_length_1036_cov_52.270011	546	626	20	21	80	0.2625000
NODE_5986_length_1036_cov_52.270011	546	626	21	21	80	0.2625000
NODE_5986_length_1036_cov_52.270011	546	626	22	9	80	0.1125000
NODE_5986_length_1036_cov_52.270011	546	626	23	6	80	0.0750000
NODE_5987_length_1036_cov_24.080043	369	449	0	68	80	0.8500000
NODE_5987_length_1036_cov_24.080043	369	449	1	12	80	0.1500000
NODE_5987_length_1036_cov_24.080043	422	502	0	15	80	0.1875000
NODE_5987_length_1036_cov_24.080043	422	502	1	54	80	0.6750000
NODE_5987_length_1036_cov_24.080043	422	502	2	11	80	0.1375000
NODE_5988_length_1036_cov_20.533618	513	593	1	15	80	0.1875000
NODE_5988_length_1036_cov_20.533618	513	593	2	1	80	0.0125000
NODE_5988_length_1036_cov_20.533618	513	593	3	7	80	0.0875000
NODE_5988_length_1036_cov_20.533618	513	593	4	3	80	0.0375000
NODE_5988_length_1036_cov_20.533618	513	593	5	42	80	0.5250000
NODE_5988_length_1036_cov_20.533618	513	593	6	9	80	0.1125000
NODE_5988_length_1036_cov_20.533618	513	593	8	3	80	0.0375000
NODE_5988_length_1036_cov_20.533618	566	645	5	15	79	0.1898734
NODE_5988_length_1036_cov_20.533618	566	645	6	9	79	0.1139240
NODE_5988_length_1036_cov_20.533618	566	645	8	41	79	0.5189874
NODE_5988_length_1036_cov_20.533618	566	645	10	10	79	0.1265823
NODE_5988_length_1036_cov_20.533618	566	645	12	1	79	0.0126582
NODE_5988_length_1036_cov_20.533618	566	645	13	3	79	0.0379747
NODE_5988_length_1036_cov_20.533618	648	728	8	41	80	0.5125000
NODE_5988_length_1036_cov_20.533618	648	728	9	4	80	0.0500000
NODE_5988_length_1036_cov_20.533618	648	728	10	6	80	0.0750000
NODE_5988_length_1036_cov_20.533618	648	728	11	1	80	0.0125000
NODE_5988_length_1036_cov_20.533618	648	728	12	28	80	0.3500000
NODE_5988_length_1036_cov_20.533618	701	781	7	5	80	0.0625000
NODE_5988_length_1036_cov_20.533618	701	781	8	70	80	0.8750000
NODE_5988_length_1036_cov_20.533618	701	781	10	5	80	0.0625000
NODE_5989_length_1036_cov_19.715048	467	547	13	23	80	0.2875000
NODE_5989_length_1036_cov_19.715048	467	547	14	14	80	0.1750000
NODE_5989_length_1036_cov_19.715048	467	547	15	2	80	0.0250000
NODE_5989_length_1036_cov_19.715048	467	547	16	2	80	0.0250000
NODE_5989_length_1036_cov_19.715048	467	547	17	39	80	0.4875000
NODE_5989_length_1036_cov_19.715048	520	600	8	12	80	0.1500000
NODE_5989_length_1036_cov_19.715048	520	600	9	2	80	0.0250000
NODE_5989_length_1036_cov_19.715048	520	600	10	18	80	0.2250000
NODE_5989_length_1036_cov_19.715048	520	600	12	3	80	0.0375000
NODE_5989_length_1036_cov_19.715048	520	600	13	6	80	0.0750000
NODE_5989_length_1036_cov_19.715048	520	600	14	26	80	0.3250000
NODE_5989_length_1036_cov_19.715048	520	600	17	13	80	0.1625000
NODE_5990_length_1036_cov_19.452508	399	479	0	80	80	1.0000000
NODE_5990_length_1036_cov_19.452508	452	532	0	80	80	1.0000000
NODE_5990_length_1036_cov_19.452508	528	608	0	80	80	1.0000000
NODE_5990_length_1036_cov_19.452508	581	661	0	80	80	1.0000000
NODE_5991_length_1036_cov_13.840982	635	715	3	75	80	0.9375000
NODE_5991_length_1036_cov_13.840982	635	715	4	5	80	0.0625000
NODE_5991_length_1036_cov_13.840982	688	768	1	21	80	0.2625000
NODE_5991_length_1036_cov_13.840982	688	768	2	21	80	0.2625000
NODE_5991_length_1036_cov_13.840982	688	768	3	38	80	0.4750000
NODE_5992_length_1036_cov_6.913554	424	504	3	17	80	0.2125000
NODE_5992_length_1036_cov_6.913554	424	504	4	33	80	0.4125000
NODE_5992_length_1036_cov_6.913554	424	504	5	1	80	0.0125000
NODE_5992_length_1036_cov_6.913554	424	504	7	7	80	0.0875000
NODE_5992_length_1036_cov_6.913554	424	504	8	6	80	0.0750000
NODE_5992_length_1036_cov_6.913554	424	504	9	16	80	0.2000000
NODE_5992_length_1036_cov_6.913554	477	557	7	5	80	0.0625000
NODE_5992_length_1036_cov_6.913554	477	557	8	17	80	0.2125000
NODE_5992_length_1036_cov_6.913554	477	557	9	58	80	0.7250000
NODE_5993_length_1036_cov_5.880470	436	516	1	9	80	0.1125000
NODE_5993_length_1036_cov_5.880470	436	516	2	71	80	0.8875000
NODE_5993_length_1036_cov_5.880470	489	569	1	61	80	0.7625000
NODE_5993_length_1036_cov_5.880470	489	569	2	19	80	0.2375000
NODE_5994_length_1036_cov_4.638207	531	611	1	33	80	0.4125000
NODE_5994_length_1036_cov_4.638207	531	611	2	47	80	0.5875000
NODE_5994_length_1036_cov_4.638207	584	664	2	80	80	1.0000000
NODE_5998_length_1036_cov_1.293490	19	69	0	50	50	1.0000000
NODE_6001_length_1035_cov_31.941239	590	670	15	1	80	0.0125000
NODE_6001_length_1035_cov_31.941239	590	670	16	2	80	0.0250000
NODE_6001_length_1035_cov_31.941239	590	670	17	23	80	0.2875000
NODE_6001_length_1035_cov_31.941239	590	670	18	5	80	0.0625000
NODE_6001_length_1035_cov_31.941239	590	670	19	30	80	0.3750000
NODE_6001_length_1035_cov_31.941239	590	670	21	19	80	0.2375000
NODE_6001_length_1035_cov_31.941239	643	723	14	9	80	0.1125000
NODE_6001_length_1035_cov_31.941239	643	723	15	13	80	0.1625000
NODE_6001_length_1035_cov_31.941239	643	723	16	1	80	0.0125000
NODE_6001_length_1035_cov_31.941239	643	723	17	36	80	0.4500000
NODE_6001_length_1035_cov_31.941239	643	723	18	7	80	0.0875000
NODE_6001_length_1035_cov_31.941239	643	723	19	14	80	0.1750000
NODE_6002_length_1035_cov_14.917735	396	476	5	34	80	0.4250000
NODE_6002_length_1035_cov_14.917735	396	476	6	25	80	0.3125000
NODE_6002_length_1035_cov_14.917735	396	476	7	21	80	0.2625000
NODE_6002_length_1035_cov_14.917735	449	529	2	3	80	0.0375000
NODE_6002_length_1035_cov_14.917735	449	529	3	18	80	0.2250000
NODE_6002_length_1035_cov_14.917735	449	529	4	22	80	0.2750000
NODE_6002_length_1035_cov_14.917735	449	529	5	37	80	0.4625000
NODE_6003_length_1035_cov_12.552350	467	547	2	18	80	0.2250000
NODE_6003_length_1035_cov_12.552350	467	547	4	9	80	0.1125000
NODE_6003_length_1035_cov_12.552350	467	547	5	2	80	0.0250000
NODE_6003_length_1035_cov_12.552350	467	547	6	40	80	0.5000000
NODE_6003_length_1035_cov_12.552350	467	547	7	11	80	0.1375000
NODE_6003_length_1035_cov_12.552350	520	600	6	18	80	0.2250000
NODE_6003_length_1035_cov_12.552350	520	600	7	36	80	0.4500000
NODE_6003_length_1035_cov_12.552350	520	600	9	26	80	0.3250000
NODE_6004_length_1035_cov_12.050214	40	103	0	63	63	1.0000000
NODE_6004_length_1035_cov_12.050214	138	219	0	81	81	1.0000000
NODE_6005_length_1035_cov_7.020299	350	430	0	80	80	1.0000000
NODE_6005_length_1035_cov_7.020299	403	483	0	80	80	1.0000000
NODE_6006_length_1035_cov_4.726496	531	611	1	41	80	0.5125000
NODE_6006_length_1035_cov_4.726496	531	611	2	39	80	0.4875000
NODE_6006_length_1035_cov_4.726496	584	664	1	68	80	0.8500000
NODE_6006_length_1035_cov_4.726496	584	664	2	12	80	0.1500000
NODE_6018_length_1034_cov_26.810695	322	402	1	54	80	0.6750000
NODE_6018_length_1034_cov_26.810695	322	402	2	26	80	0.3250000
NODE_6018_length_1034_cov_26.810695	375	455	1	4	80	0.0500000
NODE_6018_length_1034_cov_26.810695	375	455	2	76	80	0.9500000
NODE_6018_length_1034_cov_26.810695	451	531	0	5	80	0.0625000
NODE_6018_length_1034_cov_26.810695	451	531	1	74	80	0.9250000
NODE_6018_length_1034_cov_26.810695	451	531	2	1	80	0.0125000
NODE_6018_length_1034_cov_26.810695	504	584	0	58	80	0.7250000
NODE_6018_length_1034_cov_26.810695	504	584	1	22	80	0.2750000
NODE_6032_length_1033_cov_42.574946	462	542	6	11	80	0.1375000
NODE_6032_length_1033_cov_42.574946	462	542	7	44	80	0.5500000
NODE_6032_length_1033_cov_42.574946	462	542	8	25	80	0.3125000
NODE_6032_length_1033_cov_42.574946	515	595	5	32	80	0.4000000
NODE_6032_length_1033_cov_42.574946	515	595	7	48	80	0.6000000
NODE_6033_length_1033_cov_17.073876	464	544	3	6	80	0.0750000
NODE_6033_length_1033_cov_17.073876	464	544	4	4	80	0.0500000
NODE_6033_length_1033_cov_17.073876	464	544	5	2	80	0.0250000
NODE_6033_length_1033_cov_17.073876	464	544	7	26	80	0.3250000
NODE_6033_length_1033_cov_17.073876	464	544	9	4	80	0.0500000
NODE_6033_length_1033_cov_17.073876	464	544	10	38	80	0.4750000
NODE_6033_length_1033_cov_17.073876	517	597	9	49	80	0.6125000
NODE_6033_length_1033_cov_17.073876	517	597	10	23	80	0.2875000
NODE_6033_length_1033_cov_17.073876	517	597	11	1	80	0.0125000
NODE_6033_length_1033_cov_17.073876	517	597	13	3	80	0.0375000
NODE_6033_length_1033_cov_17.073876	517	597	15	4	80	0.0500000
NODE_6034_length_1033_cov_15.791221	309	386	0	33	77	0.4285714
NODE_6034_length_1033_cov_15.791221	309	386	2	16	77	0.2077922
NODE_6034_length_1033_cov_15.791221	309	386	4	28	77	0.3636364
NODE_6034_length_1033_cov_15.791221	359	439	4	80	80	1.0000000
NODE_6035_length_1033_cov_11.340471	437	517	1	20	80	0.2500000
NODE_6035_length_1033_cov_11.340471	437	517	3	60	80	0.7500000
NODE_6035_length_1033_cov_11.340471	490	570	0	51	80	0.6375000
NODE_6035_length_1033_cov_11.340471	490	570	1	22	80	0.2750000
NODE_6035_length_1033_cov_11.340471	490	570	3	7	80	0.0875000
NODE_6045_length_1032_cov_56.511254	466	546	11	27	80	0.3375000
NODE_6045_length_1032_cov_56.511254	466	546	12	3	80	0.0375000
NODE_6045_length_1032_cov_56.511254	466	546	13	25	80	0.3125000
NODE_6045_length_1032_cov_56.511254	466	546	14	22	80	0.2750000
NODE_6045_length_1032_cov_56.511254	466	546	15	1	80	0.0125000
NODE_6045_length_1032_cov_56.511254	466	546	16	2	80	0.0250000
NODE_6045_length_1032_cov_56.511254	519	599	13	5	80	0.0625000
NODE_6045_length_1032_cov_56.511254	519	599	14	46	80	0.5750000
NODE_6045_length_1032_cov_56.511254	519	599	15	17	80	0.2125000
NODE_6045_length_1032_cov_56.511254	519	599	16	12	80	0.1500000
NODE_6046_length_1032_cov_20.752412	479	559	9	19	80	0.2375000
NODE_6046_length_1032_cov_20.752412	479	559	12	1	80	0.0125000
NODE_6046_length_1032_cov_20.752412	479	559	13	37	80	0.4625000
NODE_6046_length_1032_cov_20.752412	479	559	14	23	80	0.2875000
NODE_6046_length_1032_cov_20.752412	532	612	6	23	80	0.2875000
NODE_6046_length_1032_cov_20.752412	532	612	8	13	80	0.1625000
NODE_6046_length_1032_cov_20.752412	532	612	9	24	80	0.3000000
NODE_6046_length_1032_cov_20.752412	532	612	12	1	80	0.0125000
NODE_6046_length_1032_cov_20.752412	532	612	13	19	80	0.2375000
NODE_6047_length_1032_cov_8.166131	257	337	0	29	80	0.3625000
NODE_6047_length_1032_cov_8.166131	257	337	1	18	80	0.2250000
NODE_6047_length_1032_cov_8.166131	257	337	2	33	80	0.4125000
NODE_6047_length_1032_cov_8.166131	310	390	0	80	80	1.0000000
NODE_6048_length_1032_cov_7.991426	277	357	0	10	80	0.1250000
NODE_6048_length_1032_cov_7.991426	277	357	8	70	80	0.8750000
NODE_6048_length_1032_cov_7.991426	330	410	8	80	80	1.0000000
NODE_6049_length_1032_cov_5.276527	371	451	1	45	80	0.5625000
NODE_6049_length_1032_cov_5.276527	371	451	2	14	80	0.1750000
NODE_6049_length_1032_cov_5.276527	371	451	3	21	80	0.2625000
NODE_6049_length_1032_cov_5.276527	424	504	2	6	80	0.0750000
NODE_6049_length_1032_cov_5.276527	424	504	3	74	80	0.9250000
NODE_6055_length_1031_cov_71.154506	586	654	25	5	68	0.0735294
NODE_6055_length_1031_cov_71.154506	586	654	26	5	68	0.0735294
NODE_6055_length_1031_cov_71.154506	586	654	27	17	68	0.2500000
NODE_6055_length_1031_cov_71.154506	586	654	29	2	68	0.0294118
NODE_6055_length_1031_cov_71.154506	586	654	34	4	68	0.0588235
NODE_6055_length_1031_cov_71.154506	586	654	35	12	68	0.1764706
NODE_6055_length_1031_cov_71.154506	586	654	36	4	68	0.0588235
NODE_6055_length_1031_cov_71.154506	586	654	37	16	68	0.2352941
NODE_6055_length_1031_cov_71.154506	586	654	38	3	68	0.0441176
NODE_6055_length_1031_cov_71.154506	616	696	31	11	80	0.1375000
NODE_6055_length_1031_cov_71.154506	616	696	33	2	80	0.0250000
NODE_6055_length_1031_cov_71.154506	616	696	34	3	80	0.0375000
NODE_6055_length_1031_cov_71.154506	616	696	35	16	80	0.2000000
NODE_6055_length_1031_cov_71.154506	616	696	36	6	80	0.0750000
NODE_6055_length_1031_cov_71.154506	616	696	37	26	80	0.3250000
NODE_6055_length_1031_cov_71.154506	616	696	38	11	80	0.1375000
NODE_6055_length_1031_cov_71.154506	616	696	40	5	80	0.0625000
NODE_6055_length_1031_cov_71.154506	669	749	27	3	80	0.0375000
NODE_6055_length_1031_cov_71.154506	669	749	28	5	80	0.0625000
NODE_6055_length_1031_cov_71.154506	669	749	29	3	80	0.0375000
NODE_6055_length_1031_cov_71.154506	669	749	30	6	80	0.0750000
NODE_6055_length_1031_cov_71.154506	669	749	31	30	80	0.3750000
NODE_6055_length_1031_cov_71.154506	669	749	33	4	80	0.0500000
NODE_6055_length_1031_cov_71.154506	669	749	34	2	80	0.0250000
NODE_6055_length_1031_cov_71.154506	669	749	35	5	80	0.0625000
NODE_6055_length_1031_cov_71.154506	669	749	36	9	80	0.1125000
NODE_6055_length_1031_cov_71.154506	669	749	37	4	80	0.0500000
NODE_6055_length_1031_cov_71.154506	669	749	38	4	80	0.0500000
NODE_6055_length_1031_cov_71.154506	669	749	40	5	80	0.0625000
NODE_6056_length_1031_cov_70.221030	409	489	16	9	80	0.1125000
NODE_6056_length_1031_cov_70.221030	409	489	17	1	80	0.0125000
NODE_6056_length_1031_cov_70.221030	409	489	19	5	80	0.0625000
NODE_6056_length_1031_cov_70.221030	409	489	20	2	80	0.0250000
NODE_6056_length_1031_cov_70.221030	409	489	21	3	80	0.0375000
NODE_6056_length_1031_cov_70.221030	409	489	23	4	80	0.0500000
NODE_6056_length_1031_cov_70.221030	409	489	24	19	80	0.2375000
NODE_6056_length_1031_cov_70.221030	409	489	25	18	80	0.2250000
NODE_6056_length_1031_cov_70.221030	409	489	26	15	80	0.1875000
NODE_6056_length_1031_cov_70.221030	409	489	27	4	80	0.0500000
NODE_6056_length_1031_cov_70.221030	462	542	24	3	80	0.0375000
NODE_6056_length_1031_cov_70.221030	462	542	25	14	80	0.1750000
NODE_6056_length_1031_cov_70.221030	462	542	26	16	80	0.2000000
NODE_6056_length_1031_cov_70.221030	462	542	27	9	80	0.1125000
NODE_6056_length_1031_cov_70.221030	462	542	28	3	80	0.0375000
NODE_6056_length_1031_cov_70.221030	462	542	30	5	80	0.0625000
NODE_6056_length_1031_cov_70.221030	462	542	32	7	80	0.0875000
NODE_6056_length_1031_cov_70.221030	462	542	33	15	80	0.1875000
NODE_6056_length_1031_cov_70.221030	462	542	35	5	80	0.0625000
NODE_6056_length_1031_cov_70.221030	462	542	36	3	80	0.0375000
NODE_6056_length_1031_cov_70.221030	538	618	31	4	80	0.0500000
NODE_6056_length_1031_cov_70.221030	538	618	32	20	80	0.2500000
NODE_6056_length_1031_cov_70.221030	538	618	33	5	80	0.0625000
NODE_6056_length_1031_cov_70.221030	538	618	34	7	80	0.0875000
NODE_6056_length_1031_cov_70.221030	538	618	35	1	80	0.0125000
NODE_6056_length_1031_cov_70.221030	538	618	36	13	80	0.1625000
NODE_6056_length_1031_cov_70.221030	538	618	37	1	80	0.0125000
NODE_6056_length_1031_cov_70.221030	538	618	38	17	80	0.2125000
NODE_6056_length_1031_cov_70.221030	538	618	39	8	80	0.1000000
NODE_6056_length_1031_cov_70.221030	538	618	40	2	80	0.0250000
NODE_6056_length_1031_cov_70.221030	538	618	41	2	80	0.0250000
NODE_6056_length_1031_cov_70.221030	591	671	19	2	80	0.0250000
NODE_6056_length_1031_cov_70.221030	591	671	20	7	80	0.0875000
NODE_6056_length_1031_cov_70.221030	591	671	25	1	80	0.0125000
NODE_6056_length_1031_cov_70.221030	591	671	26	13	80	0.1625000
NODE_6056_length_1031_cov_70.221030	591	671	28	3	80	0.0375000
NODE_6056_length_1031_cov_70.221030	591	671	31	5	80	0.0625000
NODE_6056_length_1031_cov_70.221030	591	671	32	23	80	0.2875000
NODE_6056_length_1031_cov_70.221030	591	671	33	2	80	0.0250000
NODE_6056_length_1031_cov_70.221030	591	671	34	7	80	0.0875000
NODE_6056_length_1031_cov_70.221030	591	671	35	13	80	0.1625000
NODE_6056_length_1031_cov_70.221030	591	671	36	4	80	0.0500000
NODE_6057_length_1031_cov_43.618026	462	542	19	13	80	0.1625000
NODE_6057_length_1031_cov_43.618026	462	542	20	22	80	0.2750000
NODE_6057_length_1031_cov_43.618026	462	542	22	10	80	0.1250000
NODE_6057_length_1031_cov_43.618026	462	542	23	21	80	0.2625000
NODE_6057_length_1031_cov_43.618026	462	542	24	14	80	0.1750000
NODE_6057_length_1031_cov_43.618026	515	595	12	4	80	0.0500000
NODE_6057_length_1031_cov_43.618026	515	595	15	31	80	0.3875000
NODE_6057_length_1031_cov_43.618026	515	595	18	1	80	0.0125000
NODE_6057_length_1031_cov_43.618026	515	595	19	4	80	0.0500000
NODE_6057_length_1031_cov_43.618026	515	595	21	10	80	0.1250000
NODE_6057_length_1031_cov_43.618026	515	595	22	1	80	0.0125000
NODE_6057_length_1031_cov_43.618026	515	595	23	21	80	0.2625000
NODE_6057_length_1031_cov_43.618026	515	595	24	8	80	0.1000000
NODE_6058_length_1031_cov_43.581545	303	383	2	58	80	0.7250000
NODE_6058_length_1031_cov_43.581545	303	383	3	22	80	0.2750000
NODE_6058_length_1031_cov_43.581545	356	436	2	26	80	0.3250000
NODE_6058_length_1031_cov_43.581545	356	436	3	44	80	0.5500000
NODE_6058_length_1031_cov_43.581545	356	436	7	10	80	0.1250000
NODE_6058_length_1031_cov_43.581545	432	512	7	11	80	0.1375000
NODE_6058_length_1031_cov_43.581545	432	512	8	26	80	0.3250000
NODE_6058_length_1031_cov_43.581545	432	512	9	22	80	0.2750000
NODE_6058_length_1031_cov_43.581545	432	512	10	21	80	0.2625000
NODE_6058_length_1031_cov_43.581545	485	565	4	15	80	0.1875000
NODE_6058_length_1031_cov_43.581545	485	565	8	7	80	0.0875000
NODE_6058_length_1031_cov_43.581545	485	565	9	48	80	0.6000000
NODE_6058_length_1031_cov_43.581545	485	565	10	10	80	0.1250000
NODE_6059_length_1031_cov_22.310086	382	462	7	1	80	0.0125000
NODE_6059_length_1031_cov_22.310086	382	462	9	29	80	0.3625000
NODE_6059_length_1031_cov_22.310086	382	462	10	17	80	0.2125000
NODE_6059_length_1031_cov_22.310086	382	462	11	11	80	0.1375000
NODE_6059_length_1031_cov_22.310086	382	462	12	22	80	0.2750000
NODE_6059_length_1031_cov_22.310086	435	515	3	6	80	0.0750000
NODE_6059_length_1031_cov_22.310086	435	515	5	21	80	0.2625000
NODE_6059_length_1031_cov_22.310086	435	515	7	27	80	0.3375000
NODE_6059_length_1031_cov_22.310086	435	515	10	17	80	0.2125000
NODE_6059_length_1031_cov_22.310086	435	515	11	3	80	0.0375000
NODE_6059_length_1031_cov_22.310086	435	515	12	6	80	0.0750000
NODE_6060_length_1031_cov_11.547210	481	561	6	24	80	0.3000000
NODE_6060_length_1031_cov_11.547210	481	561	7	3	80	0.0375000
NODE_6060_length_1031_cov_11.547210	481	561	8	15	80	0.1875000
NODE_6060_length_1031_cov_11.547210	481	561	11	22	80	0.2750000
NODE_6060_length_1031_cov_11.547210	481	561	12	16	80	0.2000000
NODE_6060_length_1031_cov_11.547210	534	614	6	67	80	0.8375000
NODE_6060_length_1031_cov_11.547210	534	614	7	3	80	0.0375000
NODE_6060_length_1031_cov_11.547210	534	614	8	3	80	0.0375000
NODE_6060_length_1031_cov_11.547210	534	614	11	7	80	0.0875000
NODE_6066_length_1030_cov_54.380236	363	443	10	4	80	0.0500000
NODE_6066_length_1030_cov_54.380236	363	443	11	20	80	0.2500000
NODE_6066_length_1030_cov_54.380236	363	443	12	8	80	0.1000000
NODE_6066_length_1030_cov_54.380236	363	443	13	1	80	0.0125000
NODE_6066_length_1030_cov_54.380236	363	443	16	15	80	0.1875000
NODE_6066_length_1030_cov_54.380236	363	443	17	4	80	0.0500000
NODE_6066_length_1030_cov_54.380236	363	443	18	28	80	0.3500000
NODE_6066_length_1030_cov_54.380236	416	496	16	12	80	0.1500000
NODE_6066_length_1030_cov_54.380236	416	496	17	10	80	0.1250000
NODE_6066_length_1030_cov_54.380236	416	496	18	18	80	0.2250000
NODE_6066_length_1030_cov_54.380236	416	496	22	1	80	0.0125000
NODE_6066_length_1030_cov_54.380236	416	496	23	10	80	0.1250000
NODE_6066_length_1030_cov_54.380236	416	496	24	29	80	0.3625000
NODE_6066_length_1030_cov_54.380236	492	572	12	2	80	0.0250000
NODE_6066_length_1030_cov_54.380236	492	572	13	21	80	0.2625000
NODE_6066_length_1030_cov_54.380236	492	572	15	3	80	0.0375000
NODE_6066_length_1030_cov_54.380236	492	572	17	1	80	0.0125000
NODE_6066_length_1030_cov_54.380236	492	572	19	1	80	0.0125000
NODE_6066_length_1030_cov_54.380236	492	572	20	27	80	0.3375000
NODE_6066_length_1030_cov_54.380236	492	572	21	5	80	0.0625000
NODE_6066_length_1030_cov_54.380236	492	572	22	1	80	0.0125000
NODE_6066_length_1030_cov_54.380236	492	572	23	1	80	0.0125000
NODE_6066_length_1030_cov_54.380236	492	572	24	14	80	0.1750000
NODE_6066_length_1030_cov_54.380236	492	572	26	4	80	0.0500000
NODE_6066_length_1030_cov_54.380236	545	625	5	1	80	0.0125000
NODE_6066_length_1030_cov_54.380236	545	625	6	12	80	0.1500000
NODE_6066_length_1030_cov_54.380236	545	625	7	5	80	0.0625000
NODE_6066_length_1030_cov_54.380236	545	625	8	1	80	0.0125000
NODE_6066_length_1030_cov_54.380236	545	625	12	21	80	0.2625000
NODE_6066_length_1030_cov_54.380236	545	625	13	27	80	0.3375000
NODE_6066_length_1030_cov_54.380236	545	625	14	9	80	0.1125000
NODE_6066_length_1030_cov_54.380236	545	625	15	3	80	0.0375000
NODE_6066_length_1030_cov_54.380236	545	625	17	1	80	0.0125000
NODE_6067_length_1030_cov_45.040816	334	414	12	1	80	0.0125000
NODE_6067_length_1030_cov_45.040816	334	414	13	7	80	0.0875000
NODE_6067_length_1030_cov_45.040816	334	414	14	15	80	0.1875000
NODE_6067_length_1030_cov_45.040816	334	414	17	12	80	0.1500000
NODE_6067_length_1030_cov_45.040816	334	414	18	20	80	0.2500000
NODE_6067_length_1030_cov_45.040816	334	414	20	13	80	0.1625000
NODE_6067_length_1030_cov_45.040816	334	414	22	12	80	0.1500000
NODE_6067_length_1030_cov_45.040816	387	467	13	1	80	0.0125000
NODE_6067_length_1030_cov_45.040816	387	467	14	11	80	0.1375000
NODE_6067_length_1030_cov_45.040816	387	467	15	10	80	0.1250000
NODE_6067_length_1030_cov_45.040816	387	467	16	20	80	0.2500000
NODE_6067_length_1030_cov_45.040816	387	467	18	5	80	0.0625000
NODE_6067_length_1030_cov_45.040816	387	467	20	13	80	0.1625000
NODE_6067_length_1030_cov_45.040816	387	467	22	20	80	0.2500000
NODE_6067_length_1030_cov_45.040816	463	543	11	16	80	0.2000000
NODE_6067_length_1030_cov_45.040816	463	543	12	12	80	0.1500000
NODE_6067_length_1030_cov_45.040816	463	543	13	12	80	0.1500000
NODE_6067_length_1030_cov_45.040816	463	543	14	18	80	0.2250000
NODE_6067_length_1030_cov_45.040816	463	543	15	6	80	0.0750000
NODE_6067_length_1030_cov_45.040816	463	543	16	5	80	0.0625000
NODE_6067_length_1030_cov_45.040816	463	543	17	8	80	0.1000000
NODE_6067_length_1030_cov_45.040816	463	543	18	3	80	0.0375000
NODE_6067_length_1030_cov_45.040816	516	596	9	15	80	0.1875000
NODE_6067_length_1030_cov_45.040816	516	596	10	30	80	0.3750000
NODE_6067_length_1030_cov_45.040816	516	596	11	24	80	0.3000000
NODE_6067_length_1030_cov_45.040816	516	596	12	3	80	0.0375000
NODE_6067_length_1030_cov_45.040816	516	596	13	8	80	0.1000000
NODE_6068_length_1030_cov_20.491944	511	591	24	2	80	0.0250000
NODE_6068_length_1030_cov_20.491944	511	591	25	1	80	0.0125000
NODE_6068_length_1030_cov_20.491944	511	591	26	40	80	0.5000000
NODE_6068_length_1030_cov_20.491944	511	591	27	19	80	0.2375000
NODE_6068_length_1030_cov_20.491944	511	591	28	14	80	0.1750000
NODE_6068_length_1030_cov_20.491944	511	591	29	4	80	0.0500000
NODE_6068_length_1030_cov_20.491944	564	644	13	1	80	0.0125000
NODE_6068_length_1030_cov_20.491944	564	644	14	2	80	0.0250000
NODE_6068_length_1030_cov_20.491944	564	644	15	8	80	0.1000000
NODE_6068_length_1030_cov_20.491944	564	644	17	2	80	0.0250000
NODE_6068_length_1030_cov_20.491944	564	644	18	1	80	0.0125000
NODE_6068_length_1030_cov_20.491944	564	644	19	4	80	0.0500000
NODE_6068_length_1030_cov_20.491944	564	644	20	1	80	0.0125000
NODE_6068_length_1030_cov_20.491944	564	644	21	5	80	0.0625000
NODE_6068_length_1030_cov_20.491944	564	644	23	2	80	0.0250000
NODE_6068_length_1030_cov_20.491944	564	644	24	7	80	0.0875000
NODE_6068_length_1030_cov_20.491944	564	644	25	3	80	0.0375000
NODE_6068_length_1030_cov_20.491944	564	644	26	16	80	0.2000000
NODE_6068_length_1030_cov_20.491944	564	644	28	24	80	0.3000000
NODE_6068_length_1030_cov_20.491944	564	644	29	4	80	0.0500000
NODE_6069_length_1030_cov_17.253491	524	604	6	25	80	0.3125000
NODE_6069_length_1030_cov_17.253491	524	604	7	55	80	0.6875000
NODE_6069_length_1030_cov_17.253491	577	657	6	59	80	0.7375000
NODE_6069_length_1030_cov_17.253491	577	657	7	2	80	0.0250000
NODE_6069_length_1030_cov_17.253491	577	657	8	1	80	0.0125000
NODE_6069_length_1030_cov_17.253491	577	657	9	18	80	0.2250000
NODE_6070_length_1030_cov_14.337272	564	644	4	13	80	0.1625000
NODE_6070_length_1030_cov_14.337272	564	644	5	23	80	0.2875000
NODE_6070_length_1030_cov_14.337272	564	644	6	9	80	0.1125000
NODE_6070_length_1030_cov_14.337272	564	644	8	35	80	0.4375000
NODE_6070_length_1030_cov_14.337272	617	697	8	37	80	0.4625000
NODE_6070_length_1030_cov_14.337272	617	697	9	16	80	0.2000000
NODE_6070_length_1030_cov_14.337272	617	697	10	27	80	0.3375000
NODE_6071_length_1030_cov_5.742213	474	554	1	24	80	0.3000000
NODE_6071_length_1030_cov_5.742213	474	554	2	56	80	0.7000000
NODE_6071_length_1030_cov_5.742213	527	607	1	38	80	0.4750000
NODE_6071_length_1030_cov_5.742213	527	607	2	42	80	0.5250000
NODE_6073_length_1030_cov_5.208378	978	1030	0	52	52	1.0000000
NODE_6077_length_1030_cov_2.146079	979	1010	0	31	31	1.0000000
NODE_6083_length_1029_cov_236.527957	584	666	11	27	82	0.3292683
NODE_6083_length_1029_cov_236.527957	584	666	12	18	82	0.2195122
NODE_6083_length_1029_cov_236.527957	584	666	14	21	82	0.2560976
NODE_6083_length_1029_cov_236.527957	584	666	15	16	82	0.1951219
NODE_6083_length_1029_cov_236.527957	639	702	8	8	63	0.1269841
NODE_6083_length_1029_cov_236.527957	639	702	9	16	63	0.2539683
NODE_6083_length_1029_cov_236.527957	639	702	10	10	63	0.1587302
NODE_6083_length_1029_cov_236.527957	639	702	11	2	63	0.0317460
NODE_6083_length_1029_cov_236.527957	639	702	12	13	63	0.2063492
NODE_6083_length_1029_cov_236.527957	639	702	14	14	63	0.2222222
NODE_6084_length_1029_cov_41.650538	364	444	6	21	80	0.2625000
NODE_6084_length_1029_cov_41.650538	364	444	7	16	80	0.2000000
NODE_6084_length_1029_cov_41.650538	364	444	8	43	80	0.5375000
NODE_6084_length_1029_cov_41.650538	417	497	6	14	80	0.1750000
NODE_6084_length_1029_cov_41.650538	417	497	7	26	80	0.3250000
NODE_6084_length_1029_cov_41.650538	417	497	8	19	80	0.2375000
NODE_6084_length_1029_cov_41.650538	417	497	9	21	80	0.2625000
NODE_6084_length_1029_cov_41.650538	493	573	6	27	80	0.3375000
NODE_6084_length_1029_cov_41.650538	493	573	8	30	80	0.3750000
NODE_6084_length_1029_cov_41.650538	493	573	9	23	80	0.2875000
NODE_6084_length_1029_cov_41.650538	546	626	3	28	80	0.3500000
NODE_6084_length_1029_cov_41.650538	546	626	5	1	80	0.0125000
NODE_6084_length_1029_cov_41.650538	546	626	6	4	80	0.0500000
NODE_6084_length_1029_cov_41.650538	546	626	7	19	80	0.2375000
NODE_6084_length_1029_cov_41.650538	546	626	9	28	80	0.3500000
NODE_6085_length_1029_cov_34.940860	314	360	8	4	46	0.0869565
NODE_6085_length_1029_cov_34.940860	314	360	9	8	46	0.1739130
NODE_6085_length_1029_cov_34.940860	314	360	10	2	46	0.0434783
NODE_6085_length_1029_cov_34.940860	314	360	11	25	46	0.5434783
NODE_6085_length_1029_cov_34.940860	314	360	14	7	46	0.1521739
NODE_6085_length_1029_cov_34.940860	371	451	0	7	80	0.0875000
NODE_6085_length_1029_cov_34.940860	371	451	1	18	80	0.2250000
NODE_6085_length_1029_cov_34.940860	371	451	4	55	80	0.6875000
NODE_6085_length_1029_cov_34.940860	424	502	0	7	78	0.0897436
NODE_6085_length_1029_cov_34.940860	424	502	1	20	78	0.2564103
NODE_6085_length_1029_cov_34.940860	424	502	3	13	78	0.1666667
NODE_6085_length_1029_cov_34.940860	424	502	4	12	78	0.1538462
NODE_6085_length_1029_cov_34.940860	424	502	8	1	78	0.0128205
NODE_6085_length_1029_cov_34.940860	424	502	11	4	78	0.0512821
NODE_6085_length_1029_cov_34.940860	424	502	12	21	78	0.2692308
NODE_6086_length_1029_cov_28.752688	255	335	5	33	80	0.4125000
NODE_6086_length_1029_cov_28.752688	255	335	7	27	80	0.3375000
NODE_6086_length_1029_cov_28.752688	255	335	8	20	80	0.2500000
NODE_6086_length_1029_cov_28.752688	308	388	2	23	80	0.2875000
NODE_6086_length_1029_cov_28.752688	308	388	3	10	80	0.1250000
NODE_6086_length_1029_cov_28.752688	308	388	5	47	80	0.5875000
NODE_6086_length_1029_cov_28.752688	384	464	2	16	80	0.2000000
NODE_6086_length_1029_cov_28.752688	384	464	3	7	80	0.0875000
NODE_6086_length_1029_cov_28.752688	384	464	4	10	80	0.1250000
NODE_6086_length_1029_cov_28.752688	384	464	5	6	80	0.0750000
NODE_6086_length_1029_cov_28.752688	384	464	6	3	80	0.0375000
NODE_6086_length_1029_cov_28.752688	384	464	7	1	80	0.0125000
NODE_6086_length_1029_cov_28.752688	384	464	8	2	80	0.0250000
NODE_6086_length_1029_cov_28.752688	384	464	10	35	80	0.4375000
NODE_6086_length_1029_cov_28.752688	437	517	10	28	80	0.3500000
NODE_6086_length_1029_cov_28.752688	437	517	11	37	80	0.4625000
NODE_6086_length_1029_cov_28.752688	437	517	13	15	80	0.1875000
NODE_6087_length_1029_cov_28.523656	409	489	8	6	80	0.0750000
NODE_6087_length_1029_cov_28.523656	409	489	9	2	80	0.0250000
NODE_6087_length_1029_cov_28.523656	409	489	10	50	80	0.6250000
NODE_6087_length_1029_cov_28.523656	409	489	11	22	80	0.2750000
NODE_6087_length_1029_cov_28.523656	462	542	6	7	80	0.0875000
NODE_6087_length_1029_cov_28.523656	462	542	7	35	80	0.4375000
NODE_6087_length_1029_cov_28.523656	462	542	8	14	80	0.1750000
NODE_6087_length_1029_cov_28.523656	462	542	9	5	80	0.0625000
NODE_6087_length_1029_cov_28.523656	462	542	10	12	80	0.1500000
NODE_6087_length_1029_cov_28.523656	462	542	11	7	80	0.0875000
NODE_6088_length_1029_cov_28.283871	281	361	3	1	80	0.0125000
NODE_6088_length_1029_cov_28.283871	281	361	4	17	80	0.2125000
NODE_6088_length_1029_cov_28.283871	281	361	5	11	80	0.1375000
NODE_6088_length_1029_cov_28.283871	281	361	6	39	80	0.4875000
NODE_6088_length_1029_cov_28.283871	281	361	7	12	80	0.1500000
NODE_6088_length_1029_cov_28.283871	334	414	3	6	80	0.0750000
NODE_6088_length_1029_cov_28.283871	334	414	4	18	80	0.2250000
NODE_6088_length_1029_cov_28.283871	334	414	6	15	80	0.1875000
NODE_6088_length_1029_cov_28.283871	334	414	7	41	80	0.5125000
NODE_6088_length_1029_cov_28.283871	410	490	6	10	80	0.1250000
NODE_6088_length_1029_cov_28.283871	410	490	7	69	80	0.8625000
NODE_6088_length_1029_cov_28.283871	410	490	8	1	80	0.0125000
NODE_6088_length_1029_cov_28.283871	463	546	1	2	83	0.0240964
NODE_6088_length_1029_cov_28.283871	463	546	2	19	83	0.2289157
NODE_6088_length_1029_cov_28.283871	463	546	3	9	83	0.1084337
NODE_6088_length_1029_cov_28.283871	463	546	6	36	83	0.4337350
NODE_6088_length_1029_cov_28.283871	463	546	7	17	83	0.2048193
NODE_6089_length_1029_cov_26.883871	434	514	6	5	80	0.0625000
NODE_6089_length_1029_cov_26.883871	434	514	7	10	80	0.1250000
NODE_6089_length_1029_cov_26.883871	434	514	9	10	80	0.1250000
NODE_6089_length_1029_cov_26.883871	434	514	10	1	80	0.0125000
NODE_6089_length_1029_cov_26.883871	434	514	11	43	80	0.5375000
NODE_6089_length_1029_cov_26.883871	434	514	12	11	80	0.1375000
NODE_6089_length_1029_cov_26.883871	487	567	4	30	80	0.3750000
NODE_6089_length_1029_cov_26.883871	487	567	6	28	80	0.3500000
NODE_6089_length_1029_cov_26.883871	487	567	7	10	80	0.1250000
NODE_6089_length_1029_cov_26.883871	487	567	9	10	80	0.1250000
NODE_6089_length_1029_cov_26.883871	487	567	11	2	80	0.0250000
NODE_6090_length_1029_cov_23.552688	305	385	2	31	80	0.3875000
NODE_6090_length_1029_cov_23.552688	305	385	3	16	80	0.2000000
NODE_6090_length_1029_cov_23.552688	305	385	6	28	80	0.3500000
NODE_6090_length_1029_cov_23.552688	305	385	7	5	80	0.0625000
NODE_6090_length_1029_cov_23.552688	358	438	6	22	80	0.2750000
NODE_6090_length_1029_cov_23.552688	358	438	7	58	80	0.7250000
NODE_6090_length_1029_cov_23.552688	434	514	5	19	80	0.2375000
NODE_6090_length_1029_cov_23.552688	434	514	6	12	80	0.1500000
NODE_6090_length_1029_cov_23.552688	434	514	7	16	80	0.2000000
NODE_6090_length_1029_cov_23.552688	434	514	8	8	80	0.1000000
NODE_6090_length_1029_cov_23.552688	434	514	9	22	80	0.2750000
NODE_6090_length_1029_cov_23.552688	434	514	10	3	80	0.0375000
NODE_6090_length_1029_cov_23.552688	487	567	4	37	80	0.4625000
NODE_6090_length_1029_cov_23.552688	487	567	6	28	80	0.3500000
NODE_6090_length_1029_cov_23.552688	487	567	9	15	80	0.1875000
NODE_6091_length_1029_cov_22.520430	434	514	3	19	80	0.2375000
NODE_6091_length_1029_cov_22.520430	434	514	5	2	80	0.0250000
NODE_6091_length_1029_cov_22.520430	434	514	6	4	80	0.0500000
NODE_6091_length_1029_cov_22.520430	434	514	7	11	80	0.1375000
NODE_6091_length_1029_cov_22.520430	434	514	11	34	80	0.4250000
NODE_6091_length_1029_cov_22.520430	434	514	12	1	80	0.0125000
NODE_6091_length_1029_cov_22.520430	434	514	15	9	80	0.1125000
NODE_6091_length_1029_cov_22.520430	487	567	11	17	80	0.2125000
NODE_6091_length_1029_cov_22.520430	487	567	12	1	80	0.0125000
NODE_6091_length_1029_cov_22.520430	487	567	15	31	80	0.3875000
NODE_6091_length_1029_cov_22.520430	487	567	16	18	80	0.2250000
NODE_6091_length_1029_cov_22.520430	487	567	17	13	80	0.1625000
NODE_6092_length_1029_cov_21.924731	335	415	4	75	80	0.9375000
NODE_6092_length_1029_cov_21.924731	335	415	5	2	80	0.0250000
NODE_6092_length_1029_cov_21.924731	335	415	6	3	80	0.0375000
NODE_6092_length_1029_cov_21.924731	388	468	0	24	80	0.3000000
NODE_6092_length_1029_cov_21.924731	388	468	1	1	80	0.0125000
NODE_6092_length_1029_cov_21.924731	388	468	2	3	80	0.0375000
NODE_6092_length_1029_cov_21.924731	388	468	3	20	80	0.2500000
NODE_6092_length_1029_cov_21.924731	388	468	4	32	80	0.4000000
NODE_6093_length_1029_cov_17.101075	501	581	5	19	80	0.2375000
NODE_6093_length_1029_cov_17.101075	501	581	6	1	80	0.0125000
NODE_6093_length_1029_cov_17.101075	501	581	7	35	80	0.4375000
NODE_6093_length_1029_cov_17.101075	501	581	8	19	80	0.2375000
NODE_6093_length_1029_cov_17.101075	501	581	9	6	80	0.0750000
NODE_6093_length_1029_cov_17.101075	554	634	5	65	80	0.8125000
NODE_6093_length_1029_cov_17.101075	554	634	7	15	80	0.1875000
NODE_6093_length_1029_cov_17.101075	630	710	2	11	80	0.1375000
NODE_6093_length_1029_cov_17.101075	630	710	3	28	80	0.3500000
NODE_6093_length_1029_cov_17.101075	630	710	4	19	80	0.2375000
NODE_6093_length_1029_cov_17.101075	630	710	5	22	80	0.2750000
NODE_6093_length_1029_cov_17.101075	683	755	2	56	72	0.7777778
NODE_6093_length_1029_cov_17.101075	683	755	3	16	72	0.2222222
NODE_6094_length_1029_cov_14.052688	405	485	4	22	80	0.2750000
NODE_6094_length_1029_cov_14.052688	405	485	5	4	80	0.0500000
NODE_6094_length_1029_cov_14.052688	405	485	6	2	80	0.0250000
NODE_6094_length_1029_cov_14.052688	405	485	9	3	80	0.0375000
NODE_6094_length_1029_cov_14.052688	405	485	10	38	80	0.4750000
NODE_6094_length_1029_cov_14.052688	405	485	13	11	80	0.1375000
NODE_6094_length_1029_cov_14.052688	458	538	10	79	80	0.9875000
NODE_6094_length_1029_cov_14.052688	458	538	13	1	80	0.0125000
NODE_6095_length_1029_cov_11.119355	291	369	2	2	78	0.0256410
NODE_6095_length_1029_cov_11.119355	291	369	4	8	78	0.1025641
NODE_6095_length_1029_cov_11.119355	291	369	5	36	78	0.4615385
NODE_6095_length_1029_cov_11.119355	291	369	6	12	78	0.1538462
NODE_6095_length_1029_cov_11.119355	291	369	7	3	78	0.0384615
NODE_6095_length_1029_cov_11.119355	291	369	8	17	78	0.2179487
NODE_6095_length_1029_cov_11.119355	342	422	6	7	80	0.0875000
NODE_6095_length_1029_cov_11.119355	342	422	7	3	80	0.0375000
NODE_6095_length_1029_cov_11.119355	342	422	8	17	80	0.2125000
NODE_6095_length_1029_cov_11.119355	342	422	9	10	80	0.1250000
NODE_6095_length_1029_cov_11.119355	342	422	10	8	80	0.1000000
NODE_6095_length_1029_cov_11.119355	342	422	12	35	80	0.4375000
NODE_6097_length_1029_cov_3.850538	231	311	1	80	80	1.0000000
NODE_6097_length_1029_cov_3.850538	284	364	0	19	80	0.2375000
NODE_6097_length_1029_cov_3.850538	284	364	1	61	80	0.7625000
NODE_6104_length_1028_cov_19.625404	495	575	13	6	80	0.0750000
NODE_6104_length_1028_cov_19.625404	495	575	15	7	80	0.0875000
NODE_6104_length_1028_cov_19.625404	495	575	18	14	80	0.1750000
NODE_6104_length_1028_cov_19.625404	495	575	20	4	80	0.0500000
NODE_6104_length_1028_cov_19.625404	495	575	23	10	80	0.1250000
NODE_6104_length_1028_cov_19.625404	495	575	25	4	80	0.0500000
NODE_6104_length_1028_cov_19.625404	495	575	26	6	80	0.0750000
NODE_6104_length_1028_cov_19.625404	495	575	27	20	80	0.2500000
NODE_6104_length_1028_cov_19.625404	495	575	28	9	80	0.1125000
NODE_6104_length_1028_cov_19.625404	548	628	23	1	80	0.0125000
NODE_6104_length_1028_cov_19.625404	548	628	24	2	80	0.0250000
NODE_6104_length_1028_cov_19.625404	548	628	25	10	80	0.1250000
NODE_6104_length_1028_cov_19.625404	548	628	26	10	80	0.1250000
NODE_6104_length_1028_cov_19.625404	548	628	27	8	80	0.1000000
NODE_6104_length_1028_cov_19.625404	548	628	28	19	80	0.2375000
NODE_6104_length_1028_cov_19.625404	548	628	30	3	80	0.0375000
NODE_6104_length_1028_cov_19.625404	548	628	31	27	80	0.3375000
NODE_6105_length_1028_cov_17.497309	533	613	11	20	80	0.2500000
NODE_6105_length_1028_cov_17.497309	533	613	12	9	80	0.1125000
NODE_6105_length_1028_cov_17.497309	533	613	14	4	80	0.0500000
NODE_6105_length_1028_cov_17.497309	533	613	15	47	80	0.5875000
NODE_6105_length_1028_cov_17.497309	586	666	3	2	80	0.0250000
NODE_6105_length_1028_cov_17.497309	586	666	4	3	80	0.0375000
NODE_6105_length_1028_cov_17.497309	586	666	8	9	80	0.1125000
NODE_6105_length_1028_cov_17.497309	586	666	10	34	80	0.4250000
NODE_6105_length_1028_cov_17.497309	586	666	11	10	80	0.1250000
NODE_6105_length_1028_cov_17.497309	586	666	15	22	80	0.2750000
NODE_6106_length_1028_cov_16.528525	497	577	0	1	80	0.0125000
NODE_6106_length_1028_cov_16.528525	497	577	2	9	80	0.1125000
NODE_6106_length_1028_cov_16.528525	497	577	4	38	80	0.4750000
NODE_6106_length_1028_cov_16.528525	497	577	6	4	80	0.0500000
NODE_6106_length_1028_cov_16.528525	497	577	8	28	80	0.3500000
NODE_6106_length_1028_cov_16.528525	550	630	6	12	80	0.1500000
NODE_6106_length_1028_cov_16.528525	550	630	8	68	80	0.8500000
NODE_6107_length_1028_cov_10.212056	463	543	0	80	80	1.0000000
NODE_6107_length_1028_cov_10.212056	516	596	0	80	80	1.0000000
NODE_6108_length_1028_cov_10.131324	399	479	0	1	80	0.0125000
NODE_6108_length_1028_cov_10.131324	399	479	1	23	80	0.2875000
NODE_6108_length_1028_cov_10.131324	399	479	2	56	80	0.7000000
NODE_6108_length_1028_cov_10.131324	452	532	0	1	80	0.0125000
NODE_6108_length_1028_cov_10.131324	452	532	1	72	80	0.9000000
NODE_6108_length_1028_cov_10.131324	452	532	2	7	80	0.0875000
NODE_6109_length_1028_cov_9.773950	482	562	10	11	80	0.1375000
NODE_6109_length_1028_cov_9.773950	482	562	11	11	80	0.1375000
NODE_6109_length_1028_cov_9.773950	482	562	12	5	80	0.0625000
NODE_6109_length_1028_cov_9.773950	482	562	15	5	80	0.0625000
NODE_6109_length_1028_cov_9.773950	482	562	16	6	80	0.0750000
NODE_6109_length_1028_cov_9.773950	482	562	17	22	80	0.2750000
NODE_6109_length_1028_cov_9.773950	482	562	18	20	80	0.2500000
NODE_6109_length_1028_cov_9.773950	535	615	13	4	80	0.0500000
NODE_6109_length_1028_cov_9.773950	535	615	14	24	80	0.3000000
NODE_6109_length_1028_cov_9.773950	535	615	15	15	80	0.1875000
NODE_6109_length_1028_cov_9.773950	535	615	16	15	80	0.1875000
NODE_6109_length_1028_cov_9.773950	535	615	17	2	80	0.0250000
NODE_6109_length_1028_cov_9.773950	535	615	18	20	80	0.2500000
NODE_6110_length_1028_cov_8.079656	399	479	2	23	80	0.2875000
NODE_6110_length_1028_cov_8.079656	399	479	3	48	80	0.6000000
NODE_6110_length_1028_cov_8.079656	399	479	5	8	80	0.1000000
NODE_6110_length_1028_cov_8.079656	399	479	6	1	80	0.0125000
NODE_6110_length_1028_cov_8.079656	452	532	3	18	80	0.2250000
NODE_6110_length_1028_cov_8.079656	452	532	4	8	80	0.1000000
NODE_6110_length_1028_cov_8.079656	452	532	5	48	80	0.6000000
NODE_6110_length_1028_cov_8.079656	452	532	6	6	80	0.0750000
NODE_6111_length_1028_cov_7.092573	439	519	4	73	80	0.9125000
NODE_6111_length_1028_cov_7.092573	439	519	5	6	80	0.0750000
NODE_6111_length_1028_cov_7.092573	439	519	6	1	80	0.0125000
NODE_6111_length_1028_cov_7.092573	492	572	1	4	80	0.0500000
NODE_6111_length_1028_cov_7.092573	492	572	3	23	80	0.2875000
NODE_6111_length_1028_cov_7.092573	492	572	4	53	80	0.6625000
NODE_6112_length_1028_cov_4.727664	416	488	2	3	72	0.0416667
NODE_6112_length_1028_cov_4.727664	416	488	3	16	72	0.2222222
NODE_6112_length_1028_cov_4.727664	416	488	4	53	72	0.7361111
NODE_6112_length_1028_cov_4.727664	461	541	2	11	80	0.1375000
NODE_6112_length_1028_cov_4.727664	461	541	3	14	80	0.1750000
NODE_6112_length_1028_cov_4.727664	461	541	4	55	80	0.6875000
NODE_6125_length_1027_cov_51.341595	399	479	2	80	80	1.0000000
NODE_6125_length_1027_cov_51.341595	452	532	1	16	80	0.2000000
NODE_6125_length_1027_cov_51.341595	452	532	2	64	80	0.8000000
NODE_6125_length_1027_cov_51.341595	528	608	2	80	80	1.0000000
NODE_6125_length_1027_cov_51.341595	581	661	0	5	80	0.0625000
NODE_6125_length_1027_cov_51.341595	581	661	1	2	80	0.0250000
NODE_6125_length_1027_cov_51.341595	581	661	2	73	80	0.9125000
NODE_6126_length_1027_cov_45.613147	347	427	13	3	80	0.0375000
NODE_6126_length_1027_cov_45.613147	347	427	14	31	80	0.3875000
NODE_6126_length_1027_cov_45.613147	347	427	15	20	80	0.2500000
NODE_6126_length_1027_cov_45.613147	347	427	16	21	80	0.2625000
NODE_6126_length_1027_cov_45.613147	347	427	17	5	80	0.0625000
NODE_6126_length_1027_cov_45.613147	400	480	8	3	80	0.0375000
NODE_6126_length_1027_cov_45.613147	400	480	10	5	80	0.0625000
NODE_6126_length_1027_cov_45.613147	400	480	12	2	80	0.0250000
NODE_6126_length_1027_cov_45.613147	400	480	13	10	80	0.1250000
NODE_6126_length_1027_cov_45.613147	400	480	14	13	80	0.1625000
NODE_6126_length_1027_cov_45.613147	400	480	15	29	80	0.3625000
NODE_6126_length_1027_cov_45.613147	400	480	16	13	80	0.1625000
NODE_6126_length_1027_cov_45.613147	400	480	17	5	80	0.0625000
NODE_6126_length_1027_cov_45.613147	476	556	8	1	80	0.0125000
NODE_6126_length_1027_cov_45.613147	476	556	10	14	80	0.1750000
NODE_6126_length_1027_cov_45.613147	476	556	11	29	80	0.3625000
NODE_6126_length_1027_cov_45.613147	476	556	12	36	80	0.4500000
NODE_6126_length_1027_cov_45.613147	529	609	9	3	80	0.0375000
NODE_6126_length_1027_cov_45.613147	529	609	10	61	80	0.7625000
NODE_6126_length_1027_cov_45.613147	529	609	11	5	80	0.0625000
NODE_6126_length_1027_cov_45.613147	529	609	12	11	80	0.1375000
NODE_6127_length_1027_cov_35.435345	431	511	8	13	80	0.1625000
NODE_6127_length_1027_cov_35.435345	431	511	9	36	80	0.4500000
NODE_6127_length_1027_cov_35.435345	431	511	10	31	80	0.3875000
NODE_6127_length_1027_cov_35.435345	484	564	4	19	80	0.2375000
NODE_6127_length_1027_cov_35.435345	484	564	6	32	80	0.4000000
NODE_6127_length_1027_cov_35.435345	484	564	8	12	80	0.1500000
NODE_6127_length_1027_cov_35.435345	484	564	9	17	80	0.2125000
NODE_6135_length_1026_cov_39.737864	374	454	2	23	80	0.2875000
NODE_6135_length_1026_cov_39.737864	374	454	3	26	80	0.3250000
NODE_6135_length_1026_cov_39.737864	374	454	4	20	80	0.2500000
NODE_6135_length_1026_cov_39.737864	374	454	6	11	80	0.1375000
NODE_6135_length_1026_cov_39.737864	427	509	4	16	82	0.1951219
NODE_6135_length_1026_cov_39.737864	427	509	6	23	82	0.2804878
NODE_6135_length_1026_cov_39.737864	427	509	7	26	82	0.3170732
NODE_6135_length_1026_cov_39.737864	427	509	8	11	82	0.1341463
NODE_6135_length_1026_cov_39.737864	427	509	9	6	82	0.0731707
NODE_6135_length_1026_cov_39.737864	505	585	8	12	80	0.1500000
NODE_6135_length_1026_cov_39.737864	505	585	9	19	80	0.2375000
NODE_6135_length_1026_cov_39.737864	505	585	10	49	80	0.6125000
NODE_6135_length_1026_cov_39.737864	558	638	4	12	80	0.1500000
NODE_6135_length_1026_cov_39.737864	558	638	5	15	80	0.1875000
NODE_6135_length_1026_cov_39.737864	558	638	6	18	80	0.2250000
NODE_6135_length_1026_cov_39.737864	558	638	8	20	80	0.2500000
NODE_6135_length_1026_cov_39.737864	558	638	9	2	80	0.0250000
NODE_6135_length_1026_cov_39.737864	558	638	10	13	80	0.1625000
NODE_6136_length_1026_cov_26.400216	423	503	6	6	80	0.0750000
NODE_6136_length_1026_cov_26.400216	423	503	7	61	80	0.7625000
NODE_6136_length_1026_cov_26.400216	423	503	8	13	80	0.1625000
NODE_6136_length_1026_cov_26.400216	476	556	3	26	80	0.3250000
NODE_6136_length_1026_cov_26.400216	476	556	4	22	80	0.2750000
NODE_6136_length_1026_cov_26.400216	476	556	7	18	80	0.2250000
NODE_6136_length_1026_cov_26.400216	476	556	8	14	80	0.1750000
NODE_6137_length_1026_cov_25.325782	477	557	11	11	80	0.1375000
NODE_6137_length_1026_cov_25.325782	477	557	12	26	80	0.3250000
NODE_6137_length_1026_cov_25.325782	477	557	15	27	80	0.3375000
NODE_6137_length_1026_cov_25.325782	477	557	16	13	80	0.1625000
NODE_6137_length_1026_cov_25.325782	477	557	17	3	80	0.0375000
NODE_6137_length_1026_cov_25.325782	530	610	10	7	80	0.0875000
NODE_6137_length_1026_cov_25.325782	530	610	12	9	80	0.1125000
NODE_6137_length_1026_cov_25.325782	530	610	14	5	80	0.0625000
NODE_6137_length_1026_cov_25.325782	530	610	15	47	80	0.5875000
NODE_6137_length_1026_cov_25.325782	530	610	16	12	80	0.1500000
NODE_6137_length_1026_cov_25.325782	606	686	6	10	80	0.1250000
NODE_6137_length_1026_cov_25.325782	606	686	8	12	80	0.1500000
NODE_6137_length_1026_cov_25.325782	606	686	9	5	80	0.0625000
NODE_6137_length_1026_cov_25.325782	606	686	10	13	80	0.1625000
NODE_6137_length_1026_cov_25.325782	606	686	11	26	80	0.3250000
NODE_6137_length_1026_cov_25.325782	606	686	12	14	80	0.1750000
NODE_6137_length_1026_cov_25.325782	659	739	5	12	80	0.1500000
NODE_6137_length_1026_cov_25.325782	659	739	6	18	80	0.2250000
NODE_6137_length_1026_cov_25.325782	659	739	7	21	80	0.2625000
NODE_6137_length_1026_cov_25.325782	659	739	8	24	80	0.3000000
NODE_6137_length_1026_cov_25.325782	659	739	11	5	80	0.0625000
NODE_6138_length_1026_cov_22.218986	408	488	4	19	80	0.2375000
NODE_6138_length_1026_cov_22.218986	408	488	5	41	80	0.5125000
NODE_6138_length_1026_cov_22.218986	408	488	6	20	80	0.2500000
NODE_6138_length_1026_cov_22.218986	461	541	1	22	80	0.2750000
NODE_6138_length_1026_cov_22.218986	461	541	2	20	80	0.2500000
NODE_6138_length_1026_cov_22.218986	461	541	3	7	80	0.0875000
NODE_6138_length_1026_cov_22.218986	461	541	4	23	80	0.2875000
NODE_6138_length_1026_cov_22.218986	461	541	6	8	80	0.1000000
NODE_6138_length_1026_cov_22.218986	537	617	0	12	80	0.1500000
NODE_6138_length_1026_cov_22.218986	537	617	1	68	80	0.8500000
NODE_6138_length_1026_cov_22.218986	590	670	0	65	80	0.8125000
NODE_6138_length_1026_cov_22.218986	590	670	1	15	80	0.1875000
NODE_6139_length_1026_cov_15.640777	450	530	0	80	80	1.0000000
NODE_6139_length_1026_cov_15.640777	503	583	0	40	80	0.5000000
NODE_6139_length_1026_cov_15.640777	503	583	1	3	80	0.0375000
NODE_6139_length_1026_cov_15.640777	503	583	2	37	80	0.4625000
NODE_6140_length_1026_cov_12.062567	165	245	0	43	80	0.5375000
NODE_6140_length_1026_cov_12.062567	165	245	4	22	80	0.2750000
NODE_6140_length_1026_cov_12.062567	165	245	6	15	80	0.1875000
NODE_6140_length_1026_cov_12.062567	218	298	4	12	80	0.1500000
NODE_6140_length_1026_cov_12.062567	218	298	6	20	80	0.2500000
NODE_6140_length_1026_cov_12.062567	218	298	8	16	80	0.2000000
NODE_6140_length_1026_cov_12.062567	218	298	11	1	80	0.0125000
NODE_6140_length_1026_cov_12.062567	218	298	12	31	80	0.3875000
NODE_6142_length_1026_cov_5.002157	335	415	2	80	80	1.0000000
NODE_6142_length_1026_cov_5.002157	388	468	0	26	80	0.3250000
NODE_6142_length_1026_cov_5.002157	388	468	2	54	80	0.6750000
NODE_6155_length_1025_cov_52.053996	366	446	10	12	80	0.1500000
NODE_6155_length_1025_cov_52.053996	366	446	11	19	80	0.2375000
NODE_6155_length_1025_cov_52.053996	366	446	12	4	80	0.0500000
NODE_6155_length_1025_cov_52.053996	366	446	13	1	80	0.0125000
NODE_6155_length_1025_cov_52.053996	366	446	14	5	80	0.0625000
NODE_6155_length_1025_cov_52.053996	366	446	15	5	80	0.0625000
NODE_6155_length_1025_cov_52.053996	366	446	16	3	80	0.0375000
NODE_6155_length_1025_cov_52.053996	366	446	17	17	80	0.2125000
NODE_6155_length_1025_cov_52.053996	366	446	18	4	80	0.0500000
NODE_6155_length_1025_cov_52.053996	366	446	19	10	80	0.1250000
NODE_6155_length_1025_cov_52.053996	419	499	15	4	80	0.0500000
NODE_6155_length_1025_cov_52.053996	419	499	16	13	80	0.1625000
NODE_6155_length_1025_cov_52.053996	419	499	17	42	80	0.5250000
NODE_6155_length_1025_cov_52.053996	419	499	18	4	80	0.0500000
NODE_6155_length_1025_cov_52.053996	419	499	19	17	80	0.2125000
NODE_6155_length_1025_cov_52.053996	495	575	9	11	80	0.1375000
NODE_6155_length_1025_cov_52.053996	495	575	11	7	80	0.0875000
NODE_6155_length_1025_cov_52.053996	495	575	12	5	80	0.0625000
NODE_6155_length_1025_cov_52.053996	495	575	13	17	80	0.2125000
NODE_6155_length_1025_cov_52.053996	495	575	14	18	80	0.2250000
NODE_6155_length_1025_cov_52.053996	495	575	15	21	80	0.2625000
NODE_6155_length_1025_cov_52.053996	495	575	17	1	80	0.0125000
NODE_6155_length_1025_cov_52.053996	548	628	5	12	80	0.1500000
NODE_6155_length_1025_cov_52.053996	548	628	6	9	80	0.1125000
NODE_6155_length_1025_cov_52.053996	548	628	8	1	80	0.0125000
NODE_6155_length_1025_cov_52.053996	548	628	9	42	80	0.5250000
NODE_6155_length_1025_cov_52.053996	548	628	11	7	80	0.0875000
NODE_6155_length_1025_cov_52.053996	548	628	12	5	80	0.0625000
NODE_6155_length_1025_cov_52.053996	548	628	13	1	80	0.0125000
NODE_6155_length_1025_cov_52.053996	548	628	14	3	80	0.0375000
NODE_6156_length_1025_cov_35.980562	318	375	17	13	57	0.2280702
NODE_6156_length_1025_cov_35.980562	318	375	18	5	57	0.0877193
NODE_6156_length_1025_cov_35.980562	318	375	20	25	57	0.4385965
NODE_6156_length_1025_cov_35.980562	318	375	21	9	57	0.1578947
NODE_6156_length_1025_cov_35.980562	318	375	23	5	57	0.0877193
NODE_6156_length_1025_cov_35.980562	348	428	17	58	80	0.7250000
NODE_6156_length_1025_cov_35.980562	348	428	18	5	80	0.0625000
NODE_6156_length_1025_cov_35.980562	348	428	20	17	80	0.2125000
NODE_6156_length_1025_cov_35.980562	425	482	4	28	57	0.4912281
NODE_6156_length_1025_cov_35.980562	425	482	7	5	57	0.0877193
NODE_6156_length_1025_cov_35.980562	425	482	10	13	57	0.2280702
NODE_6156_length_1025_cov_35.980562	425	482	14	4	57	0.0701754
NODE_6156_length_1025_cov_35.980562	425	482	17	7	57	0.1228070
NODE_6156_length_1025_cov_35.980562	455	521	0	1	66	0.0151515
NODE_6156_length_1025_cov_35.980562	455	521	2	3	66	0.0454545
NODE_6156_length_1025_cov_35.980562	455	521	3	35	66	0.5303030
NODE_6156_length_1025_cov_35.980562	455	521	4	27	66	0.4090909
NODE_6157_length_1025_cov_26.954644	607	687	2	1	80	0.0125000
NODE_6157_length_1025_cov_26.954644	607	687	3	18	80	0.2250000
NODE_6157_length_1025_cov_26.954644	607	687	4	61	80	0.7625000
NODE_6157_length_1025_cov_26.954644	660	740	2	1	80	0.0125000
NODE_6157_length_1025_cov_26.954644	660	740	3	42	80	0.5250000
NODE_6157_length_1025_cov_26.954644	660	740	4	37	80	0.4625000
NODE_6158_length_1025_cov_20.576674	428	508	6	80	80	1.0000000
NODE_6158_length_1025_cov_20.576674	481	561	0	28	80	0.3500000
NODE_6158_length_1025_cov_20.576674	481	561	3	2	80	0.0250000
NODE_6158_length_1025_cov_20.576674	481	561	6	50	80	0.6250000
NODE_6159_length_1025_cov_15.525918	415	495	0	23	80	0.2875000
NODE_6159_length_1025_cov_15.525918	415	495	1	31	80	0.3875000
NODE_6159_length_1025_cov_15.525918	415	495	2	26	80	0.3250000
NODE_6159_length_1025_cov_15.525918	468	548	1	1	80	0.0125000
NODE_6159_length_1025_cov_15.525918	468	548	2	79	80	0.9875000
NODE_6160_length_1025_cov_7.044276	240	320	1	41	80	0.5125000
NODE_6160_length_1025_cov_7.044276	240	320	3	39	80	0.4875000
NODE_6161_length_1025_cov_6.688985	334	414	0	80	80	1.0000000
NODE_6161_length_1025_cov_6.688985	387	467	0	80	80	1.0000000
NODE_6170_length_1024_cov_28.681081	264	344	0	80	80	1.0000000
NODE_6170_length_1024_cov_28.681081	317	397	0	80	80	1.0000000
NODE_6170_length_1024_cov_28.681081	393	477	0	84	84	1.0000000
NODE_6171_length_1024_cov_17.922162	324	404	12	7	80	0.0875000
NODE_6171_length_1024_cov_17.922162	324	404	13	7	80	0.0875000
NODE_6171_length_1024_cov_17.922162	324	404	14	10	80	0.1250000
NODE_6171_length_1024_cov_17.922162	324	404	15	56	80	0.7000000
NODE_6171_length_1024_cov_17.922162	377	457	7	8	80	0.1000000
NODE_6171_length_1024_cov_17.922162	377	457	8	4	80	0.0500000
NODE_6171_length_1024_cov_17.922162	377	457	11	4	80	0.0500000
NODE_6171_length_1024_cov_17.922162	377	457	12	4	80	0.0500000
NODE_6171_length_1024_cov_17.922162	377	457	14	22	80	0.2750000
NODE_6171_length_1024_cov_17.922162	377	457	15	36	80	0.4500000
NODE_6171_length_1024_cov_17.922162	377	457	16	2	80	0.0250000
NODE_6173_length_1024_cov_12.018378	368	448	7	4	80	0.0500000
NODE_6173_length_1024_cov_12.018378	368	448	8	9	80	0.1125000
NODE_6173_length_1024_cov_12.018378	368	448	9	6	80	0.0750000
NODE_6173_length_1024_cov_12.018378	368	448	10	10	80	0.1250000
NODE_6173_length_1024_cov_12.018378	368	448	11	2	80	0.0250000
NODE_6173_length_1024_cov_12.018378	368	448	12	8	80	0.1000000
NODE_6173_length_1024_cov_12.018378	368	448	13	41	80	0.5125000
NODE_6173_length_1024_cov_12.018378	421	501	13	39	80	0.4875000
NODE_6173_length_1024_cov_12.018378	421	501	14	17	80	0.2125000
NODE_6173_length_1024_cov_12.018378	421	501	15	17	80	0.2125000
NODE_6173_length_1024_cov_12.018378	421	501	16	7	80	0.0875000
NODE_6174_length_1024_cov_8.800000	517	597	0	65	80	0.8125000
NODE_6174_length_1024_cov_8.800000	517	597	1	15	80	0.1875000
NODE_6174_length_1024_cov_8.800000	570	650	0	12	80	0.1500000
NODE_6174_length_1024_cov_8.800000	570	650	1	68	80	0.8500000
NODE_6175_length_1024_cov_6.207568	318	398	2	80	80	1.0000000
NODE_6175_length_1024_cov_6.207568	371	451	2	80	80	1.0000000
NODE_6178_length_1024_cov_2.468108	274	324	0	50	50	1.0000000
NODE_6178_length_1024_cov_2.468108	274	322	0	48	48	1.0000000
NODE_6178_length_1024_cov_2.468108	274	324	0	50	50	1.0000000
NODE_6178_length_1024_cov_2.468108	274	323	0	49	49	1.0000000
NODE_6178_length_1024_cov_2.468108	274	322	0	48	48	1.0000000
NODE_6185_length_1023_cov_100.366883	441	521	36	2	80	0.0250000
NODE_6185_length_1023_cov_100.366883	441	521	37	1	80	0.0125000
NODE_6185_length_1023_cov_100.366883	441	521	38	11	80	0.1375000
NODE_6185_length_1023_cov_100.366883	441	521	39	10	80	0.1250000
NODE_6185_length_1023_cov_100.366883	441	521	43	9	80	0.1125000
NODE_6185_length_1023_cov_100.366883	441	521	44	3	80	0.0375000
NODE_6185_length_1023_cov_100.366883	441	521	45	4	80	0.0500000
NODE_6185_length_1023_cov_100.366883	441	521	46	2	80	0.0250000
NODE_6185_length_1023_cov_100.366883	441	521	48	12	80	0.1500000
NODE_6185_length_1023_cov_100.366883	441	521	49	9	80	0.1125000
NODE_6185_length_1023_cov_100.366883	441	521	50	1	80	0.0125000
NODE_6185_length_1023_cov_100.366883	441	521	51	2	80	0.0250000
NODE_6185_length_1023_cov_100.366883	441	521	52	1	80	0.0125000
NODE_6185_length_1023_cov_100.366883	441	521	53	13	80	0.1625000
NODE_6185_length_1023_cov_100.366883	494	574	35	3	80	0.0375000
NODE_6185_length_1023_cov_100.366883	494	574	36	18	80	0.2250000
NODE_6185_length_1023_cov_100.366883	494	574	37	7	80	0.0875000
NODE_6185_length_1023_cov_100.366883	494	574	39	1	80	0.0125000
NODE_6185_length_1023_cov_100.366883	494	574	40	1	80	0.0125000
NODE_6185_length_1023_cov_100.366883	494	574	41	2	80	0.0250000
NODE_6185_length_1023_cov_100.366883	494	574	43	4	80	0.0500000
NODE_6185_length_1023_cov_100.366883	494	574	44	15	80	0.1875000
NODE_6185_length_1023_cov_100.366883	494	574	46	4	80	0.0500000
NODE_6185_length_1023_cov_100.366883	494	574	48	1	80	0.0125000
NODE_6185_length_1023_cov_100.366883	494	574	49	8	80	0.1000000
NODE_6185_length_1023_cov_100.366883	494	574	51	2	80	0.0250000
NODE_6185_length_1023_cov_100.366883	494	574	52	1	80	0.0125000
NODE_6185_length_1023_cov_100.366883	494	574	53	13	80	0.1625000
NODE_6186_length_1023_cov_64.271645	349	429	0	80	80	1.0000000
NODE_6186_length_1023_cov_64.271645	402	482	0	30	80	0.3750000
NODE_6186_length_1023_cov_64.271645	402	482	1	1	80	0.0125000
NODE_6186_length_1023_cov_64.271645	402	482	2	49	80	0.6125000
NODE_6186_length_1023_cov_64.271645	478	558	2	33	80	0.4125000
NODE_6186_length_1023_cov_64.271645	478	558	5	15	80	0.1875000
NODE_6186_length_1023_cov_64.271645	478	558	6	18	80	0.2250000
NODE_6186_length_1023_cov_64.271645	478	558	8	14	80	0.1750000
NODE_6186_length_1023_cov_64.271645	531	611	6	13	80	0.1625000
NODE_6186_length_1023_cov_64.271645	531	611	7	5	80	0.0625000
NODE_6186_length_1023_cov_64.271645	531	611	8	50	80	0.6250000
NODE_6186_length_1023_cov_64.271645	531	611	9	12	80	0.1500000
NODE_6187_length_1023_cov_32.695887	318	398	17	8	80	0.1000000
NODE_6187_length_1023_cov_32.695887	318	398	18	24	80	0.3000000
NODE_6187_length_1023_cov_32.695887	318	398	19	11	80	0.1375000
NODE_6187_length_1023_cov_32.695887	318	398	20	18	80	0.2250000
NODE_6187_length_1023_cov_32.695887	318	398	21	19	80	0.2375000
NODE_6187_length_1023_cov_32.695887	371	451	15	7	80	0.0875000
NODE_6187_length_1023_cov_32.695887	371	451	16	13	80	0.1625000
NODE_6187_length_1023_cov_32.695887	371	451	17	21	80	0.2625000
NODE_6187_length_1023_cov_32.695887	371	451	18	20	80	0.2500000
NODE_6187_length_1023_cov_32.695887	371	451	19	11	80	0.1375000
NODE_6187_length_1023_cov_32.695887	371	451	20	1	80	0.0125000
NODE_6187_length_1023_cov_32.695887	371	451	21	7	80	0.0875000
NODE_6187_length_1023_cov_32.695887	447	527	18	4	80	0.0500000
NODE_6187_length_1023_cov_32.695887	447	527	19	4	80	0.0500000
NODE_6187_length_1023_cov_32.695887	447	527	20	2	80	0.0250000
NODE_6187_length_1023_cov_32.695887	447	527	21	24	80	0.3000000
NODE_6187_length_1023_cov_32.695887	447	527	22	5	80	0.0625000
NODE_6187_length_1023_cov_32.695887	447	527	23	15	80	0.1875000
NODE_6187_length_1023_cov_32.695887	447	527	25	2	80	0.0250000
NODE_6187_length_1023_cov_32.695887	447	527	27	23	80	0.2875000
NODE_6187_length_1023_cov_32.695887	447	527	28	1	80	0.0125000
NODE_6187_length_1023_cov_32.695887	500	580	23	9	80	0.1125000
NODE_6187_length_1023_cov_32.695887	500	580	24	9	80	0.1125000
NODE_6187_length_1023_cov_32.695887	500	580	25	18	80	0.2250000
NODE_6187_length_1023_cov_32.695887	500	580	26	11	80	0.1375000
NODE_6187_length_1023_cov_32.695887	500	580	27	32	80	0.4000000
NODE_6187_length_1023_cov_32.695887	500	580	28	1	80	0.0125000
NODE_6188_length_1023_cov_16.244589	601	681	7	70	80	0.8750000
NODE_6188_length_1023_cov_16.244589	601	681	8	5	80	0.0625000
NODE_6188_length_1023_cov_16.244589	601	681	9	5	80	0.0625000
NODE_6188_length_1023_cov_16.244589	654	734	4	9	80	0.1125000
NODE_6188_length_1023_cov_16.244589	654	734	5	5	80	0.0625000
NODE_6188_length_1023_cov_16.244589	654	734	6	4	80	0.0500000
NODE_6188_length_1023_cov_16.244589	654	734	7	22	80	0.2750000
NODE_6188_length_1023_cov_16.244589	654	734	8	18	80	0.2250000
NODE_6188_length_1023_cov_16.244589	654	734	9	22	80	0.2750000
NODE_6189_length_1023_cov_15.876623	371	451	5	17	80	0.2125000
NODE_6189_length_1023_cov_15.876623	371	451	6	27	80	0.3375000
NODE_6189_length_1023_cov_15.876623	371	451	7	35	80	0.4375000
NODE_6189_length_1023_cov_15.876623	371	451	8	1	80	0.0125000
NODE_6189_length_1023_cov_15.876623	424	504	3	3	80	0.0375000
NODE_6189_length_1023_cov_15.876623	424	504	4	27	80	0.3375000
NODE_6189_length_1023_cov_15.876623	424	504	5	40	80	0.5000000
NODE_6189_length_1023_cov_15.876623	424	504	7	9	80	0.1125000
NODE_6189_length_1023_cov_15.876623	424	504	8	1	80	0.0125000
NODE_6189_length_1023_cov_15.876623	500	580	4	34	80	0.4250000
NODE_6189_length_1023_cov_15.876623	500	580	5	46	80	0.5750000
NODE_6189_length_1023_cov_15.876623	553	633	3	22	80	0.2750000
NODE_6189_length_1023_cov_15.876623	553	633	4	46	80	0.5750000
NODE_6189_length_1023_cov_15.876623	553	633	5	12	80	0.1500000
NODE_6190_length_1023_cov_14.678571	555	635	3	18	80	0.2250000
NODE_6190_length_1023_cov_14.678571	555	635	4	6	80	0.0750000
NODE_6190_length_1023_cov_14.678571	555	635	5	14	80	0.1750000
NODE_6190_length_1023_cov_14.678571	555	635	6	42	80	0.5250000
NODE_6190_length_1023_cov_14.678571	608	688	3	34	80	0.4250000
NODE_6190_length_1023_cov_14.678571	608	688	5	4	80	0.0500000
NODE_6190_length_1023_cov_14.678571	608	688	6	42	80	0.5250000
NODE_6191_length_1023_cov_14.443723	406	486	9	69	80	0.8625000
NODE_6191_length_1023_cov_14.443723	406	486	10	11	80	0.1375000
NODE_6191_length_1023_cov_14.443723	459	539	9	52	80	0.6500000
NODE_6191_length_1023_cov_14.443723	459	539	11	2	80	0.0250000
NODE_6191_length_1023_cov_14.443723	459	539	12	26	80	0.3250000
NODE_6192_length_1023_cov_10.984848	590	670	0	80	80	1.0000000
NODE_6192_length_1023_cov_10.984848	643	723	0	80	80	1.0000000
NODE_6202_length_1022_cov_42.952329	555	636	22	2	81	0.0246914
NODE_6202_length_1022_cov_42.952329	555	636	23	5	81	0.0617284
NODE_6202_length_1022_cov_42.952329	555	636	24	22	81	0.2716049
NODE_6202_length_1022_cov_42.952329	555	636	25	10	81	0.1234568
NODE_6202_length_1022_cov_42.952329	555	636	26	1	81	0.0123457
NODE_6202_length_1022_cov_42.952329	555	636	27	3	81	0.0370370
NODE_6202_length_1022_cov_42.952329	555	636	29	8	81	0.0987654
NODE_6202_length_1022_cov_42.952329	555	636	30	5	81	0.0617284
NODE_6202_length_1022_cov_42.952329	555	636	31	3	81	0.0370370
NODE_6202_length_1022_cov_42.952329	555	636	32	3	81	0.0370370
NODE_6202_length_1022_cov_42.952329	555	636	33	14	81	0.1728395
NODE_6202_length_1022_cov_42.952329	555	636	34	2	81	0.0246914
NODE_6202_length_1022_cov_42.952329	555	636	35	3	81	0.0370370
NODE_6202_length_1022_cov_42.952329	609	689	28	4	80	0.0500000
NODE_6202_length_1022_cov_42.952329	609	689	29	4	80	0.0500000
NODE_6202_length_1022_cov_42.952329	609	689	30	13	80	0.1625000
NODE_6202_length_1022_cov_42.952329	609	689	31	21	80	0.2625000
NODE_6202_length_1022_cov_42.952329	609	689	32	12	80	0.1500000
NODE_6202_length_1022_cov_42.952329	609	689	33	19	80	0.2375000
NODE_6202_length_1022_cov_42.952329	609	689	34	2	80	0.0250000
NODE_6202_length_1022_cov_42.952329	609	689	35	5	80	0.0625000
NODE_6202_length_1022_cov_42.952329	685	765	17	1	80	0.0125000
NODE_6202_length_1022_cov_42.952329	685	765	18	3	80	0.0375000
NODE_6202_length_1022_cov_42.952329	685	765	20	13	80	0.1625000
NODE_6202_length_1022_cov_42.952329	685	765	22	4	80	0.0500000
NODE_6202_length_1022_cov_42.952329	685	765	24	1	80	0.0125000
NODE_6202_length_1022_cov_42.952329	685	765	25	33	80	0.4125000
NODE_6202_length_1022_cov_42.952329	685	765	26	1	80	0.0125000
NODE_6202_length_1022_cov_42.952329	685	765	27	17	80	0.2125000
NODE_6202_length_1022_cov_42.952329	685	765	29	4	80	0.0500000
NODE_6202_length_1022_cov_42.952329	685	765	31	3	80	0.0375000
NODE_6202_length_1022_cov_42.952329	738	818	6	6	80	0.0750000
NODE_6202_length_1022_cov_42.952329	738	818	8	1	80	0.0125000
NODE_6202_length_1022_cov_42.952329	738	818	9	6	80	0.0750000
NODE_6202_length_1022_cov_42.952329	738	818	10	6	80	0.0750000
NODE_6202_length_1022_cov_42.952329	738	818	11	2	80	0.0250000
NODE_6202_length_1022_cov_42.952329	738	818	13	1	80	0.0125000
NODE_6202_length_1022_cov_42.952329	738	818	14	13	80	0.1625000
NODE_6202_length_1022_cov_42.952329	738	818	16	7	80	0.0875000
NODE_6202_length_1022_cov_42.952329	738	818	17	12	80	0.1500000
NODE_6202_length_1022_cov_42.952329	738	818	18	3	80	0.0375000
NODE_6202_length_1022_cov_42.952329	738	818	20	13	80	0.1625000
NODE_6202_length_1022_cov_42.952329	738	818	22	4	80	0.0500000
NODE_6202_length_1022_cov_42.952329	738	818	24	1	80	0.0125000
NODE_6202_length_1022_cov_42.952329	738	818	25	5	80	0.0625000
NODE_6203_length_1022_cov_29.949079	510	590	6	18	80	0.2250000
NODE_6203_length_1022_cov_29.949079	510	590	7	8	80	0.1000000
NODE_6203_length_1022_cov_29.949079	510	590	8	41	80	0.5125000
NODE_6203_length_1022_cov_29.949079	510	590	9	13	80	0.1625000
NODE_6203_length_1022_cov_29.949079	563	643	4	2	80	0.0250000
NODE_6203_length_1022_cov_29.949079	563	643	5	45	80	0.5625000
NODE_6203_length_1022_cov_29.949079	563	643	6	7	80	0.0875000
NODE_6203_length_1022_cov_29.949079	563	643	7	1	80	0.0125000
NODE_6203_length_1022_cov_29.949079	563	643	8	19	80	0.2375000
NODE_6203_length_1022_cov_29.949079	563	643	9	6	80	0.0750000
NODE_6204_length_1022_cov_7.672806	461	541	0	10	80	0.1250000
NODE_6204_length_1022_cov_7.672806	461	541	1	70	80	0.8750000
NODE_6204_length_1022_cov_7.672806	514	594	1	80	80	1.0000000
NODE_6213_length_1021_cov_47.379610	341	421	4	7	80	0.0875000
NODE_6213_length_1021_cov_47.379610	341	421	5	62	80	0.7750000
NODE_6213_length_1021_cov_47.379610	341	421	6	11	80	0.1375000
NODE_6213_length_1021_cov_47.379610	394	474	1	15	80	0.1875000
NODE_6213_length_1021_cov_47.379610	394	474	2	18	80	0.2250000
NODE_6213_length_1021_cov_47.379610	394	474	3	7	80	0.0875000
NODE_6213_length_1021_cov_47.379610	394	474	4	20	80	0.2500000
NODE_6213_length_1021_cov_47.379610	394	474	5	20	80	0.2500000
NODE_6213_length_1021_cov_47.379610	470	550	1	21	80	0.2625000
NODE_6213_length_1021_cov_47.379610	470	550	2	59	80	0.7375000
NODE_6213_length_1021_cov_47.379610	523	603	1	4	80	0.0500000
NODE_6213_length_1021_cov_47.379610	523	603	2	76	80	0.9500000
NODE_6214_length_1021_cov_33.255965	588	668	7	18	80	0.2250000
NODE_6214_length_1021_cov_33.255965	588	668	8	10	80	0.1250000
NODE_6214_length_1021_cov_33.255965	588	668	9	1	80	0.0125000
NODE_6214_length_1021_cov_33.255965	588	668	10	27	80	0.3375000
NODE_6214_length_1021_cov_33.255965	588	668	13	10	80	0.1250000
NODE_6214_length_1021_cov_33.255965	588	668	15	2	80	0.0250000
NODE_6214_length_1021_cov_33.255965	588	668	16	12	80	0.1500000
NODE_6214_length_1021_cov_33.255965	641	721	9	1	80	0.0125000
NODE_6214_length_1021_cov_33.255965	641	721	10	2	80	0.0250000
NODE_6214_length_1021_cov_33.255965	641	721	13	26	80	0.3250000
NODE_6214_length_1021_cov_33.255965	641	721	14	4	80	0.0500000
NODE_6214_length_1021_cov_33.255965	641	721	15	28	80	0.3500000
NODE_6214_length_1021_cov_33.255965	641	721	16	19	80	0.2375000
NODE_6227_length_1020_cov_24.565689	485	565	15	32	80	0.4000000
NODE_6227_length_1020_cov_24.565689	485	565	16	9	80	0.1125000
NODE_6227_length_1020_cov_24.565689	485	565	17	2	80	0.0250000
NODE_6227_length_1020_cov_24.565689	485	565	18	34	80	0.4250000
NODE_6227_length_1020_cov_24.565689	485	565	19	3	80	0.0375000
NODE_6227_length_1020_cov_24.565689	538	618	10	4	80	0.0500000
NODE_6227_length_1020_cov_24.565689	538	618	12	14	80	0.1750000
NODE_6227_length_1020_cov_24.565689	538	618	13	3	80	0.0375000
NODE_6227_length_1020_cov_24.565689	538	618	14	20	80	0.2500000
NODE_6227_length_1020_cov_24.565689	538	618	15	2	80	0.0250000
NODE_6227_length_1020_cov_24.565689	538	618	16	19	80	0.2375000
NODE_6227_length_1020_cov_24.565689	538	618	17	2	80	0.0250000
NODE_6227_length_1020_cov_24.565689	538	618	18	13	80	0.1625000
NODE_6227_length_1020_cov_24.565689	538	618	19	3	80	0.0375000
NODE_6228_length_1020_cov_20.825190	395	475	8	3	80	0.0375000
NODE_6228_length_1020_cov_20.825190	395	475	9	7	80	0.0875000
NODE_6228_length_1020_cov_20.825190	395	475	10	70	80	0.8750000
NODE_6228_length_1020_cov_20.825190	448	528	7	20	80	0.2500000
NODE_6228_length_1020_cov_20.825190	448	528	9	17	80	0.2125000
NODE_6228_length_1020_cov_20.825190	448	528	10	41	80	0.5125000
NODE_6228_length_1020_cov_20.825190	448	528	11	2	80	0.0250000
NODE_6229_length_1020_cov_20.305103	285	365	0	58	80	0.7250000
NODE_6229_length_1020_cov_20.305103	285	365	2	22	80	0.2750000
NODE_6229_length_1020_cov_20.305103	338	418	0	5	80	0.0625000
NODE_6229_length_1020_cov_20.305103	338	418	2	75	80	0.9375000
NODE_6229_length_1020_cov_20.305103	414	494	0	7	80	0.0875000
NODE_6229_length_1020_cov_20.305103	414	494	1	2	80	0.0250000
NODE_6229_length_1020_cov_20.305103	414	494	2	71	80	0.8875000
NODE_6229_length_1020_cov_20.305103	467	548	0	61	81	0.7530864
NODE_6229_length_1020_cov_20.305103	467	548	1	2	81	0.0246914
NODE_6229_length_1020_cov_20.305103	467	548	2	18	81	0.2222222
NODE_6230_length_1020_cov_17.919653	408	488	14	1	80	0.0125000
NODE_6230_length_1020_cov_17.919653	408	488	15	15	80	0.1875000
NODE_6230_length_1020_cov_17.919653	408	488	16	2	80	0.0250000
NODE_6230_length_1020_cov_17.919653	408	488	17	2	80	0.0250000
NODE_6230_length_1020_cov_17.919653	408	488	19	8	80	0.1000000
NODE_6230_length_1020_cov_17.919653	408	488	21	6	80	0.0750000
NODE_6230_length_1020_cov_17.919653	408	488	22	2	80	0.0250000
NODE_6230_length_1020_cov_17.919653	408	488	23	6	80	0.0750000
NODE_6230_length_1020_cov_17.919653	408	488	24	34	80	0.4250000
NODE_6230_length_1020_cov_17.919653	408	488	25	4	80	0.0500000
NODE_6230_length_1020_cov_17.919653	461	541	16	17	80	0.2125000
NODE_6230_length_1020_cov_17.919653	461	541	19	8	80	0.1000000
NODE_6230_length_1020_cov_17.919653	461	541	21	8	80	0.1000000
NODE_6230_length_1020_cov_17.919653	461	541	22	15	80	0.1875000
NODE_6230_length_1020_cov_17.919653	461	541	23	3	80	0.0375000
NODE_6230_length_1020_cov_17.919653	461	541	24	29	80	0.3625000
NODE_6231_length_1020_cov_13.972856	436	516	8	14	80	0.1750000
NODE_6231_length_1020_cov_13.972856	436	516	10	20	80	0.2500000
NODE_6231_length_1020_cov_13.972856	436	516	11	4	80	0.0500000
NODE_6231_length_1020_cov_13.972856	436	516	12	24	80	0.3000000
NODE_6231_length_1020_cov_13.972856	436	516	13	18	80	0.2250000
NODE_6231_length_1020_cov_13.972856	489	569	11	2	80	0.0250000
NODE_6231_length_1020_cov_13.972856	489	569	12	24	80	0.3000000
NODE_6231_length_1020_cov_13.972856	489	569	13	54	80	0.6750000
NODE_6232_length_1020_cov_10.472313	407	487	7	21	80	0.2625000
NODE_6232_length_1020_cov_10.472313	407	487	8	43	80	0.5375000
NODE_6232_length_1020_cov_10.472313	407	487	9	16	80	0.2000000
NODE_6232_length_1020_cov_10.472313	460	540	7	16	80	0.2000000
NODE_6232_length_1020_cov_10.472313	460	540	8	14	80	0.1750000
NODE_6232_length_1020_cov_10.472313	460	540	9	50	80	0.6250000
NODE_6235_length_1020_cov_3.707926	821	901	4	7	80	0.0875000
NODE_6235_length_1020_cov_3.707926	821	901	5	1	80	0.0125000
NODE_6235_length_1020_cov_3.707926	821	901	6	20	80	0.2500000
NODE_6235_length_1020_cov_3.707926	821	901	7	2	80	0.0250000
NODE_6235_length_1020_cov_3.707926	821	901	8	34	80	0.4250000
NODE_6235_length_1020_cov_3.707926	821	901	9	16	80	0.2000000
NODE_6235_length_1020_cov_3.707926	874	954	6	18	80	0.2250000
NODE_6235_length_1020_cov_3.707926	874	954	7	37	80	0.4625000
NODE_6235_length_1020_cov_3.707926	874	954	8	9	80	0.1125000
NODE_6235_length_1020_cov_3.707926	874	954	9	16	80	0.2000000
NODE_6238_length_1020_cov_2.648208	0	70	0	70	70	1.0000000
NODE_6238_length_1020_cov_2.648208	43	88	0	45	45	1.0000000
NODE_6248_length_1019_cov_30.164130	476	556	9	6	80	0.0750000
NODE_6248_length_1019_cov_30.164130	476	556	10	7	80	0.0875000
NODE_6248_length_1019_cov_30.164130	476	556	11	13	80	0.1625000
NODE_6248_length_1019_cov_30.164130	476	556	12	4	80	0.0500000
NODE_6248_length_1019_cov_30.164130	476	556	13	20	80	0.2500000
NODE_6248_length_1019_cov_30.164130	476	556	15	30	80	0.3750000
NODE_6248_length_1019_cov_30.164130	529	609	12	11	80	0.1375000
NODE_6248_length_1019_cov_30.164130	529	609	14	14	80	0.1750000
NODE_6248_length_1019_cov_30.164130	529	609	15	43	80	0.5375000
NODE_6248_length_1019_cov_30.164130	529	609	16	6	80	0.0750000
NODE_6248_length_1019_cov_30.164130	529	609	17	6	80	0.0750000
NODE_6248_length_1019_cov_30.164130	605	685	7	8	80	0.1000000
NODE_6248_length_1019_cov_30.164130	605	685	8	2	80	0.0250000
NODE_6248_length_1019_cov_30.164130	605	685	9	13	80	0.1625000
NODE_6248_length_1019_cov_30.164130	605	685	10	7	80	0.0875000
NODE_6248_length_1019_cov_30.164130	605	685	11	5	80	0.0625000
NODE_6248_length_1019_cov_30.164130	605	685	12	23	80	0.2875000
NODE_6248_length_1019_cov_30.164130	605	685	13	8	80	0.1000000
NODE_6248_length_1019_cov_30.164130	605	685	14	11	80	0.1375000
NODE_6248_length_1019_cov_30.164130	605	685	15	3	80	0.0375000
NODE_6248_length_1019_cov_30.164130	658	738	7	4	80	0.0500000
NODE_6248_length_1019_cov_30.164130	658	738	9	7	80	0.0875000
NODE_6248_length_1019_cov_30.164130	658	738	10	6	80	0.0750000
NODE_6248_length_1019_cov_30.164130	658	738	11	13	80	0.1625000
NODE_6248_length_1019_cov_30.164130	658	738	12	50	80	0.6250000
NODE_6249_length_1019_cov_22.845652	343	423	8	16	80	0.2000000
NODE_6249_length_1019_cov_22.845652	343	423	9	64	80	0.8000000
NODE_6249_length_1019_cov_22.845652	396	476	9	28	80	0.3500000
NODE_6249_length_1019_cov_22.845652	396	476	10	22	80	0.2750000
NODE_6249_length_1019_cov_22.845652	396	476	11	1	80	0.0125000
NODE_6249_length_1019_cov_22.845652	396	476	12	25	80	0.3125000
NODE_6249_length_1019_cov_22.845652	396	476	13	4	80	0.0500000
NODE_6249_length_1019_cov_22.845652	472	552	4	28	80	0.3500000
NODE_6249_length_1019_cov_22.845652	472	552	5	22	80	0.2750000
NODE_6249_length_1019_cov_22.845652	472	552	6	13	80	0.1625000
NODE_6249_length_1019_cov_22.845652	472	552	7	12	80	0.1500000
NODE_6249_length_1019_cov_22.845652	472	552	9	1	80	0.0125000
NODE_6249_length_1019_cov_22.845652	472	552	10	4	80	0.0500000
NODE_6249_length_1019_cov_22.845652	525	605	0	13	80	0.1625000
NODE_6249_length_1019_cov_22.845652	525	605	3	18	80	0.2250000
NODE_6249_length_1019_cov_22.845652	525	605	4	49	80	0.6125000
NODE_6250_length_1019_cov_8.098913	523	601	0	78	78	1.0000000
NODE_6250_length_1019_cov_8.098913	574	654	0	80	80	1.0000000
NODE_6251_length_1019_cov_7.896739	423	503	6	8	80	0.1000000
NODE_6251_length_1019_cov_7.896739	423	503	10	28	80	0.3500000
NODE_6251_length_1019_cov_7.896739	423	503	11	10	80	0.1250000
NODE_6251_length_1019_cov_7.896739	423	503	12	34	80	0.4250000
NODE_6251_length_1019_cov_7.896739	476	556	5	11	80	0.1375000
NODE_6251_length_1019_cov_7.896739	476	556	6	21	80	0.2625000
NODE_6251_length_1019_cov_7.896739	476	556	7	29	80	0.3625000
NODE_6251_length_1019_cov_7.896739	476	556	10	19	80	0.2375000
NODE_6252_length_1019_cov_4.597826	625	696	0	14	71	0.1971831
NODE_6252_length_1019_cov_4.597826	625	696	1	12	71	0.1690141
NODE_6252_length_1019_cov_4.597826	625	696	2	12	71	0.1690141
NODE_6252_length_1019_cov_4.597826	625	696	4	31	71	0.4366197
NODE_6252_length_1019_cov_4.597826	625	696	5	2	71	0.0281690
NODE_6263_length_1019_cov_1.139130	89	165	0	76	76	1.0000000
NODE_6265_length_1018_cov_33.494015	212	292	4	25	80	0.3125000
NODE_6265_length_1018_cov_33.494015	212	292	5	8	80	0.1000000
NODE_6265_length_1018_cov_33.494015	212	292	6	47	80	0.5875000
NODE_6265_length_1018_cov_33.494015	265	345	4	31	80	0.3875000
NODE_6265_length_1018_cov_33.494015	265	345	5	5	80	0.0625000
NODE_6265_length_1018_cov_33.494015	265	345	6	16	80	0.2000000
NODE_6265_length_1018_cov_33.494015	265	345	11	28	80	0.3500000
NODE_6266_length_1018_cov_22.776931	372	452	0	65	80	0.8125000
NODE_6266_length_1018_cov_22.776931	372	452	1	1	80	0.0125000
NODE_6266_length_1018_cov_22.776931	372	452	2	14	80	0.1750000
NODE_6266_length_1018_cov_22.776931	425	505	0	12	80	0.1500000
NODE_6266_length_1018_cov_22.776931	425	505	1	1	80	0.0125000
NODE_6266_length_1018_cov_22.776931	425	505	2	35	80	0.4375000
NODE_6266_length_1018_cov_22.776931	425	505	4	32	80	0.4000000
NODE_6268_length_1018_cov_8.486398	404	484	3	14	80	0.1750000
NODE_6268_length_1018_cov_8.486398	404	484	4	14	80	0.1750000
NODE_6268_length_1018_cov_8.486398	404	484	5	22	80	0.2750000
NODE_6268_length_1018_cov_8.486398	404	484	6	30	80	0.3750000
NODE_6268_length_1018_cov_8.486398	457	537	3	10	80	0.1250000
NODE_6268_length_1018_cov_8.486398	457	537	4	8	80	0.1000000
NODE_6268_length_1018_cov_8.486398	457	537	5	1	80	0.0125000
NODE_6268_length_1018_cov_8.486398	457	537	6	29	80	0.3625000
NODE_6268_length_1018_cov_8.486398	457	537	7	32	80	0.4000000
NODE_6270_length_1018_cov_7.737758	357	437	1	61	80	0.7625000
NODE_6270_length_1018_cov_7.737758	357	437	2	19	80	0.2375000
NODE_6270_length_1018_cov_7.737758	410	490	1	8	80	0.1000000
NODE_6270_length_1018_cov_7.737758	410	490	2	37	80	0.4625000
NODE_6270_length_1018_cov_7.737758	410	490	3	35	80	0.4375000
NODE_6286_length_1017_cov_207.523965	0	41	14	14	41	0.3414634
NODE_6286_length_1017_cov_207.523965	0	41	17	1	41	0.0243902
NODE_6286_length_1017_cov_207.523965	0	41	18	13	41	0.3170732
NODE_6286_length_1017_cov_207.523965	0	41	20	6	41	0.1463415
NODE_6286_length_1017_cov_207.523965	0	41	21	7	41	0.1707317
NODE_6286_length_1017_cov_207.523965	14	94	17	1	80	0.0125000
NODE_6286_length_1017_cov_207.523965	14	94	18	13	80	0.1625000
NODE_6286_length_1017_cov_207.523965	14	94	20	6	80	0.0750000
NODE_6286_length_1017_cov_207.523965	14	94	21	9	80	0.1125000
NODE_6286_length_1017_cov_207.523965	14	94	24	8	80	0.1000000
NODE_6286_length_1017_cov_207.523965	14	94	25	1	80	0.0125000
NODE_6286_length_1017_cov_207.523965	14	94	26	12	80	0.1500000
NODE_6286_length_1017_cov_207.523965	14	94	28	1	80	0.0125000
NODE_6286_length_1017_cov_207.523965	14	94	29	8	80	0.1000000
NODE_6286_length_1017_cov_207.523965	14	94	30	1	80	0.0125000
NODE_6286_length_1017_cov_207.523965	14	94	31	14	80	0.1750000
NODE_6286_length_1017_cov_207.523965	14	94	32	6	80	0.0750000
NODE_6287_length_1017_cov_18.824619	490	570	8	9	80	0.1125000
NODE_6287_length_1017_cov_18.824619	490	570	9	27	80	0.3375000
NODE_6287_length_1017_cov_18.824619	490	570	10	39	80	0.4875000
NODE_6287_length_1017_cov_18.824619	490	570	12	5	80	0.0625000
NODE_6287_length_1017_cov_18.824619	543	623	6	8	80	0.1000000
NODE_6287_length_1017_cov_18.824619	543	623	8	9	80	0.1125000
NODE_6287_length_1017_cov_18.824619	543	623	9	1	80	0.0125000
NODE_6287_length_1017_cov_18.824619	543	623	10	57	80	0.7125000
NODE_6287_length_1017_cov_18.824619	543	623	12	5	80	0.0625000
NODE_6288_length_1017_cov_14.794118	428	508	5	1	80	0.0125000
NODE_6288_length_1017_cov_14.794118	428	508	6	4	80	0.0500000
NODE_6288_length_1017_cov_14.794118	428	508	7	9	80	0.1125000
NODE_6288_length_1017_cov_14.794118	428	508	8	23	80	0.2875000
NODE_6288_length_1017_cov_14.794118	428	508	9	25	80	0.3125000
NODE_6288_length_1017_cov_14.794118	428	508	10	18	80	0.2250000
NODE_6288_length_1017_cov_14.794118	481	561	7	10	80	0.1250000
NODE_6288_length_1017_cov_14.794118	481	561	8	46	80	0.5750000
NODE_6288_length_1017_cov_14.794118	481	561	9	9	80	0.1125000
NODE_6288_length_1017_cov_14.794118	481	561	11	15	80	0.1875000
NODE_6288_length_1017_cov_14.794118	557	637	4	6	80	0.0750000
NODE_6288_length_1017_cov_14.794118	557	637	6	4	80	0.0500000
NODE_6288_length_1017_cov_14.794118	557	637	7	8	80	0.1000000
NODE_6288_length_1017_cov_14.794118	557	637	8	16	80	0.2000000
NODE_6288_length_1017_cov_14.794118	557	637	9	46	80	0.5750000
NODE_6288_length_1017_cov_14.794118	610	690	0	3	80	0.0375000
NODE_6288_length_1017_cov_14.794118	610	690	2	8	80	0.1000000
NODE_6288_length_1017_cov_14.794118	610	690	3	20	80	0.2500000
NODE_6288_length_1017_cov_14.794118	610	690	4	28	80	0.3500000
NODE_6288_length_1017_cov_14.794118	610	690	6	4	80	0.0500000
NODE_6288_length_1017_cov_14.794118	610	690	7	8	80	0.1000000
NODE_6288_length_1017_cov_14.794118	610	690	8	9	80	0.1125000
NODE_6297_length_1016_cov_22.267176	577	657	10	26	80	0.3250000
NODE_6297_length_1016_cov_22.267176	577	657	11	9	80	0.1125000
NODE_6297_length_1016_cov_22.267176	577	657	12	18	80	0.2250000
NODE_6297_length_1016_cov_22.267176	577	657	13	9	80	0.1125000
NODE_6297_length_1016_cov_22.267176	577	657	14	9	80	0.1125000
NODE_6297_length_1016_cov_22.267176	577	657	15	9	80	0.1125000
NODE_6297_length_1016_cov_22.267176	630	710	8	21	80	0.2625000
NODE_6297_length_1016_cov_22.267176	630	710	9	16	80	0.2000000
NODE_6297_length_1016_cov_22.267176	630	710	10	32	80	0.4000000
NODE_6297_length_1016_cov_22.267176	630	710	13	8	80	0.1000000
NODE_6297_length_1016_cov_22.267176	630	710	14	1	80	0.0125000
NODE_6297_length_1016_cov_22.267176	630	710	15	2	80	0.0250000
NODE_6298_length_1016_cov_21.134133	625	705	1	51	80	0.6375000
NODE_6298_length_1016_cov_21.134133	625	705	2	29	80	0.3625000
NODE_6298_length_1016_cov_21.134133	678	758	0	35	80	0.4375000
NODE_6298_length_1016_cov_21.134133	678	758	1	45	80	0.5625000
NODE_6299_length_1016_cov_20.392585	504	584	1	9	80	0.1125000
NODE_6299_length_1016_cov_20.392585	504	584	2	71	80	0.8875000
NODE_6299_length_1016_cov_20.392585	557	637	0	36	80	0.4500000
NODE_6299_length_1016_cov_20.392585	557	637	1	26	80	0.3250000
NODE_6299_length_1016_cov_20.392585	557	637	2	18	80	0.2250000
NODE_6299_length_1016_cov_20.392585	633	713	0	80	80	1.0000000
NODE_6299_length_1016_cov_20.392585	686	766	0	80	80	1.0000000
NODE_6300_length_1016_cov_16.917121	524	604	2	26	80	0.3250000
NODE_6300_length_1016_cov_16.917121	524	604	3	13	80	0.1625000
NODE_6300_length_1016_cov_16.917121	524	604	5	41	80	0.5125000
NODE_6300_length_1016_cov_16.917121	577	657	1	2	80	0.0250000
NODE_6300_length_1016_cov_16.917121	577	657	2	15	80	0.1875000
NODE_6300_length_1016_cov_16.917121	577	657	3	52	80	0.6500000
NODE_6300_length_1016_cov_16.917121	577	657	4	11	80	0.1375000
NODE_6301_length_1016_cov_8.243184	438	518	0	16	80	0.2000000
NODE_6301_length_1016_cov_8.243184	438	518	1	64	80	0.8000000
NODE_6301_length_1016_cov_8.243184	491	571	0	69	80	0.8625000
NODE_6301_length_1016_cov_8.243184	491	571	1	11	80	0.1375000
NODE_6301_length_1016_cov_8.243184	567	647	0	80	80	1.0000000
NODE_6301_length_1016_cov_8.243184	620	700	0	80	80	1.0000000
NODE_6302_length_1016_cov_8.141767	166	256	1	1	90	0.0111111
NODE_6302_length_1016_cov_8.141767	166	256	3	6	90	0.0666667
NODE_6302_length_1016_cov_8.141767	166	256	5	13	90	0.1444445
NODE_6302_length_1016_cov_8.141767	166	256	6	31	90	0.3444445
NODE_6302_length_1016_cov_8.141767	166	256	8	17	90	0.1888889
NODE_6302_length_1016_cov_8.141767	166	256	9	3	90	0.0333333
NODE_6302_length_1016_cov_8.141767	166	256	10	19	90	0.2111111
NODE_6303_length_1016_cov_7.466739	576	656	2	18	80	0.2250000
NODE_6303_length_1016_cov_7.466739	576	656	3	13	80	0.1625000
NODE_6303_length_1016_cov_7.466739	576	656	4	49	80	0.6125000
NODE_6303_length_1016_cov_7.466739	629	709	3	37	80	0.4625000
NODE_6303_length_1016_cov_7.466739	629	709	4	43	80	0.5375000
NODE_6318_length_1015_cov_24.680131	459	539	3	33	80	0.4125000
NODE_6318_length_1015_cov_24.680131	459	539	5	11	80	0.1375000
NODE_6318_length_1015_cov_24.680131	459	539	7	5	80	0.0625000
NODE_6318_length_1015_cov_24.680131	459	539	9	31	80	0.3875000
NODE_6318_length_1015_cov_24.680131	512	592	9	46	80	0.5750000
NODE_6318_length_1015_cov_24.680131	512	592	12	28	80	0.3500000
NODE_6318_length_1015_cov_24.680131	512	592	13	6	80	0.0750000
NODE_6318_length_1015_cov_24.680131	588	668	6	10	80	0.1250000
NODE_6318_length_1015_cov_24.680131	588	668	8	5	80	0.0625000
NODE_6318_length_1015_cov_24.680131	588	668	10	11	80	0.1375000
NODE_6318_length_1015_cov_24.680131	588	668	11	9	80	0.1125000
NODE_6318_length_1015_cov_24.680131	588	668	12	45	80	0.5625000
NODE_6318_length_1015_cov_24.680131	641	721	1	6	80	0.0750000
NODE_6318_length_1015_cov_24.680131	641	721	2	7	80	0.0875000
NODE_6318_length_1015_cov_24.680131	641	721	6	50	80	0.6250000
NODE_6318_length_1015_cov_24.680131	641	721	8	5	80	0.0625000
NODE_6318_length_1015_cov_24.680131	641	721	10	11	80	0.1375000
NODE_6318_length_1015_cov_24.680131	641	721	11	1	80	0.0125000
NODE_6319_length_1015_cov_23.198690	407	487	0	10	80	0.1250000
NODE_6319_length_1015_cov_23.198690	407	487	2	9	80	0.1125000
NODE_6319_length_1015_cov_23.198690	407	487	4	1	80	0.0125000
NODE_6319_length_1015_cov_23.198690	407	487	5	60	80	0.7500000
NODE_6319_length_1015_cov_23.198690	460	540	0	22	80	0.2750000
NODE_6319_length_1015_cov_23.198690	460	540	1	41	80	0.5125000
NODE_6319_length_1015_cov_23.198690	460	540	2	9	80	0.1125000
NODE_6319_length_1015_cov_23.198690	460	540	4	1	80	0.0125000
NODE_6319_length_1015_cov_23.198690	460	540	5	7	80	0.0875000
NODE_6319_length_1015_cov_23.198690	536	616	1	10	80	0.1250000
NODE_6319_length_1015_cov_23.198690	536	616	4	44	80	0.5500000
NODE_6319_length_1015_cov_23.198690	536	616	5	26	80	0.3250000
NODE_6319_length_1015_cov_23.198690	589	669	4	21	80	0.2625000
NODE_6319_length_1015_cov_23.198690	589	669	5	59	80	0.7375000
NODE_6320_length_1015_cov_22.544760	490	570	6	66	80	0.8250000
NODE_6320_length_1015_cov_22.544760	490	570	7	3	80	0.0375000
NODE_6320_length_1015_cov_22.544760	490	570	8	11	80	0.1375000
NODE_6320_length_1015_cov_22.544760	543	623	6	25	80	0.3125000
NODE_6320_length_1015_cov_22.544760	543	623	7	21	80	0.2625000
NODE_6320_length_1015_cov_22.544760	543	623	8	30	80	0.3750000
NODE_6320_length_1015_cov_22.544760	543	623	9	4	80	0.0500000
NODE_6321_length_1015_cov_17.994541	510	590	0	80	80	1.0000000
NODE_6321_length_1015_cov_17.994541	563	643	0	80	80	1.0000000
NODE_6322_length_1015_cov_16.594978	437	517	6	34	80	0.4250000
NODE_6322_length_1015_cov_16.594978	437	517	8	4	80	0.0500000
NODE_6322_length_1015_cov_16.594978	437	517	9	42	80	0.5250000
NODE_6322_length_1015_cov_16.594978	490	570	2	1	80	0.0125000
NODE_6322_length_1015_cov_16.594978	490	570	4	29	80	0.3625000
NODE_6322_length_1015_cov_16.594978	490	570	6	48	80	0.6000000
NODE_6322_length_1015_cov_16.594978	490	570	7	2	80	0.0250000
NODE_6323_length_1015_cov_14.000000	505	585	3	47	80	0.5875000
NODE_6323_length_1015_cov_14.000000	505	585	4	16	80	0.2000000
NODE_6323_length_1015_cov_14.000000	505	585	6	17	80	0.2125000
NODE_6323_length_1015_cov_14.000000	558	638	3	42	80	0.5250000
NODE_6323_length_1015_cov_14.000000	558	638	4	38	80	0.4750000
NODE_6324_length_1015_cov_9.978166	345	425	8	7	80	0.0875000
NODE_6324_length_1015_cov_9.978166	345	425	9	13	80	0.1625000
NODE_6324_length_1015_cov_9.978166	345	425	10	23	80	0.2875000
NODE_6324_length_1015_cov_9.978166	345	425	11	37	80	0.4625000
NODE_6324_length_1015_cov_9.978166	398	478	2	16	80	0.2000000
NODE_6324_length_1015_cov_9.978166	398	478	11	64	80	0.8000000
NODE_6325_length_1015_cov_6.844978	393	473	0	80	80	1.0000000
NODE_6325_length_1015_cov_6.844978	446	526	0	80	80	1.0000000
NODE_6337_length_1014_cov_95.709290	259	335	10	3	76	0.0394737
NODE_6337_length_1014_cov_95.709290	259	335	12	9	76	0.1184211
NODE_6337_length_1014_cov_95.709290	259	335	13	7	76	0.0921053
NODE_6337_length_1014_cov_95.709290	259	335	14	19	76	0.2500000
NODE_6337_length_1014_cov_95.709290	259	335	15	13	76	0.1710526
NODE_6337_length_1014_cov_95.709290	259	335	16	11	76	0.1447368
NODE_6337_length_1014_cov_95.709290	259	335	17	4	76	0.0526316
NODE_6337_length_1014_cov_95.709290	259	335	18	2	76	0.0263158
NODE_6337_length_1014_cov_95.709290	259	335	19	1	76	0.0131579
NODE_6337_length_1014_cov_95.709290	259	335	20	1	76	0.0131579
NODE_6337_length_1014_cov_95.709290	259	335	29	6	76	0.0789474
NODE_6337_length_1014_cov_95.709290	310	390	16	11	80	0.1375000
NODE_6337_length_1014_cov_95.709290	310	390	17	4	80	0.0500000
NODE_6337_length_1014_cov_95.709290	310	390	18	2	80	0.0250000
NODE_6337_length_1014_cov_95.709290	310	390	19	1	80	0.0125000
NODE_6337_length_1014_cov_95.709290	310	390	20	1	80	0.0125000
NODE_6337_length_1014_cov_95.709290	310	390	29	10	80	0.1250000
NODE_6337_length_1014_cov_95.709290	310	390	30	3	80	0.0375000
NODE_6337_length_1014_cov_95.709290	310	390	31	6	80	0.0750000
NODE_6337_length_1014_cov_95.709290	310	390	32	1	80	0.0125000
NODE_6337_length_1014_cov_95.709290	310	390	34	22	80	0.2750000
NODE_6337_length_1014_cov_95.709290	310	390	35	15	80	0.1875000
NODE_6337_length_1014_cov_95.709290	310	390	36	1	80	0.0125000
NODE_6337_length_1014_cov_95.709290	310	390	37	3	80	0.0375000
NODE_6337_length_1014_cov_95.709290	386	466	30	6	80	0.0750000
NODE_6337_length_1014_cov_95.709290	386	466	32	2	80	0.0250000
NODE_6337_length_1014_cov_95.709290	386	466	34	3	80	0.0375000
NODE_6337_length_1014_cov_95.709290	386	466	35	5	80	0.0625000
NODE_6337_length_1014_cov_95.709290	386	466	36	8	80	0.1000000
NODE_6337_length_1014_cov_95.709290	386	466	37	3	80	0.0375000
NODE_6337_length_1014_cov_95.709290	386	466	38	13	80	0.1625000
NODE_6337_length_1014_cov_95.709290	386	466	40	7	80	0.0875000
NODE_6337_length_1014_cov_95.709290	386	466	41	13	80	0.1625000
NODE_6337_length_1014_cov_95.709290	386	466	42	10	80	0.1250000
NODE_6337_length_1014_cov_95.709290	386	466	43	1	80	0.0125000
NODE_6337_length_1014_cov_95.709290	386	466	44	9	80	0.1125000
NODE_6337_length_1014_cov_95.709290	439	519	23	9	80	0.1125000
NODE_6337_length_1014_cov_95.709290	439	519	24	15	80	0.1875000
NODE_6337_length_1014_cov_95.709290	439	519	26	6	80	0.0750000
NODE_6337_length_1014_cov_95.709290	439	519	28	10	80	0.1250000
NODE_6337_length_1014_cov_95.709290	439	519	37	1	80	0.0125000
NODE_6337_length_1014_cov_95.709290	439	519	38	1	80	0.0125000
NODE_6337_length_1014_cov_95.709290	439	519	39	2	80	0.0250000
NODE_6337_length_1014_cov_95.709290	439	519	40	12	80	0.1500000
NODE_6337_length_1014_cov_95.709290	439	519	41	14	80	0.1750000
NODE_6337_length_1014_cov_95.709290	439	519	42	10	80	0.1250000
NODE_6338_length_1014_cov_67.918033	182	262	18	10	80	0.1250000
NODE_6338_length_1014_cov_67.918033	182	262	19	8	80	0.1000000
NODE_6338_length_1014_cov_67.918033	182	262	20	4	80	0.0500000
NODE_6338_length_1014_cov_67.918033	182	262	22	11	80	0.1375000
NODE_6338_length_1014_cov_67.918033	182	262	24	19	80	0.2375000
NODE_6338_length_1014_cov_67.918033	182	262	25	18	80	0.2250000
NODE_6338_length_1014_cov_67.918033	182	262	26	8	80	0.1000000
NODE_6338_length_1014_cov_67.918033	182	262	28	2	80	0.0250000
NODE_6338_length_1014_cov_67.918033	235	315	23	4	80	0.0500000
NODE_6338_length_1014_cov_67.918033	235	315	24	7	80	0.0875000
NODE_6338_length_1014_cov_67.918033	235	315	25	29	80	0.3625000
NODE_6338_length_1014_cov_67.918033	235	315	26	3	80	0.0375000
NODE_6338_length_1014_cov_67.918033	235	315	27	1	80	0.0125000
NODE_6338_length_1014_cov_67.918033	235	315	28	12	80	0.1500000
NODE_6338_length_1014_cov_67.918033	235	315	29	6	80	0.0750000
NODE_6338_length_1014_cov_67.918033	235	315	30	10	80	0.1250000
NODE_6338_length_1014_cov_67.918033	235	315	32	6	80	0.0750000
NODE_6338_length_1014_cov_67.918033	235	315	34	2	80	0.0250000
NODE_6338_length_1014_cov_67.918033	311	391	26	10	80	0.1250000
NODE_6338_length_1014_cov_67.918033	311	391	27	4	80	0.0500000
NODE_6338_length_1014_cov_67.918033	311	391	28	32	80	0.4000000
NODE_6338_length_1014_cov_67.918033	311	391	29	15	80	0.1875000
NODE_6338_length_1014_cov_67.918033	311	391	30	17	80	0.2125000
NODE_6338_length_1014_cov_67.918033	311	391	31	2	80	0.0250000
NODE_6338_length_1014_cov_67.918033	364	444	25	11	80	0.1375000
NODE_6338_length_1014_cov_67.918033	364	444	26	10	80	0.1250000
NODE_6338_length_1014_cov_67.918033	364	444	27	4	80	0.0500000
NODE_6338_length_1014_cov_67.918033	364	444	28	9	80	0.1125000
NODE_6338_length_1014_cov_67.918033	364	444	29	9	80	0.1125000
NODE_6338_length_1014_cov_67.918033	364	444	30	5	80	0.0625000
NODE_6338_length_1014_cov_67.918033	364	444	31	4	80	0.0500000
NODE_6338_length_1014_cov_67.918033	364	444	32	2	80	0.0250000
NODE_6338_length_1014_cov_67.918033	364	444	34	20	80	0.2500000
NODE_6338_length_1014_cov_67.918033	364	444	35	4	80	0.0500000
NODE_6338_length_1014_cov_67.918033	364	444	37	2	80	0.0250000
NODE_6339_length_1014_cov_44.802186	418	498	8	2	80	0.0250000
NODE_6339_length_1014_cov_44.802186	418	498	9	12	80	0.1500000
NODE_6339_length_1014_cov_44.802186	418	498	12	66	80	0.8250000
NODE_6339_length_1014_cov_44.802186	471	551	4	2	80	0.0250000
NODE_6339_length_1014_cov_44.802186	471	551	5	4	80	0.0500000
NODE_6339_length_1014_cov_44.802186	471	551	6	1	80	0.0125000
NODE_6339_length_1014_cov_44.802186	471	551	7	5	80	0.0625000
NODE_6339_length_1014_cov_44.802186	471	551	8	14	80	0.1750000
NODE_6339_length_1014_cov_44.802186	471	551	9	4	80	0.0500000
NODE_6339_length_1014_cov_44.802186	471	551	10	7	80	0.0875000
NODE_6339_length_1014_cov_44.802186	471	551	12	43	80	0.5375000
NODE_6340_length_1014_cov_36.349727	369	449	7	16	80	0.2000000
NODE_6340_length_1014_cov_36.349727	369	449	8	7	80	0.0875000
NODE_6340_length_1014_cov_36.349727	369	449	9	8	80	0.1000000
NODE_6340_length_1014_cov_36.349727	369	449	10	47	80	0.5875000
NODE_6340_length_1014_cov_36.349727	369	449	11	2	80	0.0250000
NODE_6340_length_1014_cov_36.349727	422	502	7	16	80	0.2000000
NODE_6340_length_1014_cov_36.349727	422	502	8	11	80	0.1375000
NODE_6340_length_1014_cov_36.349727	422	502	9	40	80	0.5000000
NODE_6340_length_1014_cov_36.349727	422	502	10	12	80	0.1500000
NODE_6340_length_1014_cov_36.349727	422	502	11	1	80	0.0125000
NODE_6340_length_1014_cov_36.349727	498	578	7	21	80	0.2625000
NODE_6340_length_1014_cov_36.349727	498	578	8	8	80	0.1000000
NODE_6340_length_1014_cov_36.349727	498	578	9	19	80	0.2375000
NODE_6340_length_1014_cov_36.349727	498	578	10	32	80	0.4000000
NODE_6340_length_1014_cov_36.349727	551	631	4	7	80	0.0875000
NODE_6340_length_1014_cov_36.349727	551	631	5	14	80	0.1750000
NODE_6340_length_1014_cov_36.349727	551	631	6	7	80	0.0875000
NODE_6340_length_1014_cov_36.349727	551	631	9	12	80	0.1500000
NODE_6340_length_1014_cov_36.349727	551	631	10	40	80	0.5000000
NODE_6341_length_1014_cov_35.547541	363	441	6	45	78	0.5769231
NODE_6341_length_1014_cov_35.547541	363	441	10	33	78	0.4230769
NODE_6341_length_1014_cov_35.547541	416	494	4	4	78	0.0512821
NODE_6341_length_1014_cov_35.547541	416	494	5	47	78	0.6025641
NODE_6341_length_1014_cov_35.547541	416	494	9	2	78	0.0256410
NODE_6341_length_1014_cov_35.547541	416	494	10	25	78	0.3205128
NODE_6342_length_1014_cov_32.266667	428	508	26	4	80	0.0500000
NODE_6342_length_1014_cov_32.266667	428	508	28	14	80	0.1750000
NODE_6342_length_1014_cov_32.266667	428	508	30	1	80	0.0125000
NODE_6342_length_1014_cov_32.266667	428	508	31	61	80	0.7625000
NODE_6342_length_1014_cov_32.266667	481	561	12	3	80	0.0375000
NODE_6342_length_1014_cov_32.266667	481	561	13	3	80	0.0375000
NODE_6342_length_1014_cov_32.266667	481	561	16	15	80	0.1875000
NODE_6342_length_1014_cov_32.266667	481	561	19	1	80	0.0125000
NODE_6342_length_1014_cov_32.266667	481	561	20	4	80	0.0500000
NODE_6342_length_1014_cov_32.266667	481	561	22	4	80	0.0500000
NODE_6342_length_1014_cov_32.266667	481	561	23	3	80	0.0375000
NODE_6342_length_1014_cov_32.266667	481	561	24	8	80	0.1000000
NODE_6342_length_1014_cov_32.266667	481	561	26	16	80	0.2000000
NODE_6342_length_1014_cov_32.266667	481	561	28	1	80	0.0125000
NODE_6342_length_1014_cov_32.266667	481	561	31	22	80	0.2750000
NODE_6343_length_1014_cov_28.493989	480	560	12	3	80	0.0375000
NODE_6343_length_1014_cov_28.493989	480	560	13	7	80	0.0875000
NODE_6343_length_1014_cov_28.493989	480	560	14	31	80	0.3875000
NODE_6343_length_1014_cov_28.493989	480	560	15	29	80	0.3625000
NODE_6343_length_1014_cov_28.493989	480	560	16	10	80	0.1250000
NODE_6343_length_1014_cov_28.493989	533	613	12	10	80	0.1250000
NODE_6343_length_1014_cov_28.493989	533	613	13	6	80	0.0750000
NODE_6343_length_1014_cov_28.493989	533	613	14	3	80	0.0375000
NODE_6343_length_1014_cov_28.493989	533	613	15	19	80	0.2375000
NODE_6343_length_1014_cov_28.493989	533	613	16	15	80	0.1875000
NODE_6343_length_1014_cov_28.493989	533	613	17	3	80	0.0375000
NODE_6343_length_1014_cov_28.493989	533	613	19	24	80	0.3000000
NODE_6343_length_1014_cov_28.493989	609	689	8	1	80	0.0125000
NODE_6343_length_1014_cov_28.493989	609	689	9	27	80	0.3375000
NODE_6343_length_1014_cov_28.493989	609	689	10	25	80	0.3125000
NODE_6343_length_1014_cov_28.493989	609	689	11	2	80	0.0250000
NODE_6343_length_1014_cov_28.493989	609	689	12	16	80	0.2000000
NODE_6343_length_1014_cov_28.493989	609	689	15	3	80	0.0375000
NODE_6343_length_1014_cov_28.493989	609	689	16	6	80	0.0750000
NODE_6343_length_1014_cov_28.493989	662	742	3	2	80	0.0250000
NODE_6343_length_1014_cov_28.493989	662	742	5	15	80	0.1875000
NODE_6343_length_1014_cov_28.493989	662	742	6	4	80	0.0500000
NODE_6343_length_1014_cov_28.493989	662	742	7	1	80	0.0125000
NODE_6343_length_1014_cov_28.493989	662	742	8	32	80	0.4000000
NODE_6343_length_1014_cov_28.493989	662	742	10	24	80	0.3000000
NODE_6343_length_1014_cov_28.493989	662	742	11	2	80	0.0250000
NODE_6344_length_1014_cov_25.171585	500	580	13	2	80	0.0250000
NODE_6344_length_1014_cov_25.171585	500	580	14	58	80	0.7250000
NODE_6344_length_1014_cov_25.171585	500	580	15	14	80	0.1750000
NODE_6344_length_1014_cov_25.171585	500	580	16	3	80	0.0375000
NODE_6344_length_1014_cov_25.171585	500	580	17	1	80	0.0125000
NODE_6344_length_1014_cov_25.171585	500	580	18	2	80	0.0250000
NODE_6344_length_1014_cov_25.171585	553	633	7	26	80	0.3250000
NODE_6344_length_1014_cov_25.171585	553	633	9	1	80	0.0125000
NODE_6344_length_1014_cov_25.171585	553	633	10	6	80	0.0750000
NODE_6344_length_1014_cov_25.171585	553	633	12	8	80	0.1000000
NODE_6344_length_1014_cov_25.171585	553	633	13	6	80	0.0750000
NODE_6344_length_1014_cov_25.171585	553	633	14	16	80	0.2000000
NODE_6344_length_1014_cov_25.171585	553	633	15	13	80	0.1625000
NODE_6344_length_1014_cov_25.171585	553	633	16	1	80	0.0125000
NODE_6344_length_1014_cov_25.171585	553	633	17	1	80	0.0125000
NODE_6344_length_1014_cov_25.171585	553	633	18	2	80	0.0250000
NODE_6345_length_1014_cov_22.437158	534	614	8	15	80	0.1875000
NODE_6345_length_1014_cov_22.437158	534	614	9	20	80	0.2500000
NODE_6345_length_1014_cov_22.437158	534	614	11	4	80	0.0500000
NODE_6345_length_1014_cov_22.437158	534	614	13	10	80	0.1250000
NODE_6345_length_1014_cov_22.437158	534	614	14	1	80	0.0125000
NODE_6345_length_1014_cov_22.437158	534	614	15	8	80	0.1000000
NODE_6345_length_1014_cov_22.437158	534	614	17	4	80	0.0500000
NODE_6345_length_1014_cov_22.437158	534	614	18	18	80	0.2250000
NODE_6345_length_1014_cov_22.437158	587	667	13	5	80	0.0625000
NODE_6345_length_1014_cov_22.437158	587	667	14	7	80	0.0875000
NODE_6345_length_1014_cov_22.437158	587	667	15	21	80	0.2625000
NODE_6345_length_1014_cov_22.437158	587	667	16	5	80	0.0625000
NODE_6345_length_1014_cov_22.437158	587	667	17	4	80	0.0500000
NODE_6345_length_1014_cov_22.437158	587	667	18	38	80	0.4750000
NODE_6346_length_1014_cov_19.238251	379	459	1	80	80	1.0000000
NODE_6346_length_1014_cov_19.238251	432	512	1	75	80	0.9375000
NODE_6346_length_1014_cov_19.238251	432	512	2	5	80	0.0625000
NODE_6346_length_1014_cov_19.238251	508	585	1	77	77	1.0000000
NODE_6346_length_1014_cov_19.238251	558	638	0	25	80	0.3125000
NODE_6346_length_1014_cov_19.238251	558	638	1	55	80	0.6875000
NODE_6347_length_1014_cov_15.926776	594	674	1	40	80	0.5000000
NODE_6347_length_1014_cov_15.926776	594	674	2	5	80	0.0625000
NODE_6347_length_1014_cov_15.926776	594	674	3	18	80	0.2250000
NODE_6347_length_1014_cov_15.926776	594	674	5	5	80	0.0625000
NODE_6347_length_1014_cov_15.926776	594	674	6	12	80	0.1500000
NODE_6347_length_1014_cov_15.926776	647	727	3	10	80	0.1250000
NODE_6347_length_1014_cov_15.926776	647	727	5	46	80	0.5750000
NODE_6347_length_1014_cov_15.926776	647	727	6	24	80	0.3000000
NODE_6348_length_1014_cov_8.691803	285	365	0	29	80	0.3625000
NODE_6348_length_1014_cov_8.691803	285	365	1	43	80	0.5375000
NODE_6348_length_1014_cov_8.691803	285	365	2	8	80	0.1000000
NODE_6348_length_1014_cov_8.691803	338	418	1	19	80	0.2375000
NODE_6348_length_1014_cov_8.691803	338	418	2	61	80	0.7625000
NODE_6349_length_1014_cov_7.959563	531	611	2	80	80	1.0000000
NODE_6349_length_1014_cov_7.959563	584	664	0	4	80	0.0500000
NODE_6349_length_1014_cov_7.959563	584	664	2	76	80	0.9500000
NODE_6351_length_1014_cov_7.608743	298	378	2	30	80	0.3750000
NODE_6351_length_1014_cov_7.608743	298	378	4	37	80	0.4625000
NODE_6351_length_1014_cov_7.608743	298	378	5	13	80	0.1625000
NODE_6351_length_1014_cov_7.608743	351	431	1	23	80	0.2875000
NODE_6351_length_1014_cov_7.608743	351	431	2	43	80	0.5375000
NODE_6351_length_1014_cov_7.608743	351	431	3	6	80	0.0750000
NODE_6351_length_1014_cov_7.608743	351	431	4	8	80	0.1000000
NODE_6352_length_1014_cov_6.209836	321	401	1	60	80	0.7500000
NODE_6352_length_1014_cov_6.209836	321	401	2	20	80	0.2500000
NODE_6352_length_1014_cov_6.209836	374	454	0	1	80	0.0125000
NODE_6352_length_1014_cov_6.209836	374	454	1	79	80	0.9875000
NODE_6364_length_1013_cov_32.695842	423	503	6	32	80	0.4000000
NODE_6364_length_1013_cov_32.695842	423	503	7	48	80	0.6000000
NODE_6364_length_1013_cov_32.695842	476	556	0	9	80	0.1125000
NODE_6364_length_1013_cov_32.695842	476	556	3	3	80	0.0375000
NODE_6364_length_1013_cov_32.695842	476	556	4	13	80	0.1625000
NODE_6364_length_1013_cov_32.695842	476	556	5	7	80	0.0875000
NODE_6364_length_1013_cov_32.695842	476	556	6	43	80	0.5375000
NODE_6364_length_1013_cov_32.695842	476	556	8	5	80	0.0625000
NODE_6364_length_1013_cov_32.695842	552	632	8	11	80	0.1375000
NODE_6364_length_1013_cov_32.695842	552	632	9	6	80	0.0750000
NODE_6364_length_1013_cov_32.695842	552	632	14	1	80	0.0125000
NODE_6364_length_1013_cov_32.695842	552	632	15	9	80	0.1125000
NODE_6364_length_1013_cov_32.695842	552	632	18	13	80	0.1625000
NODE_6364_length_1013_cov_32.695842	552	632	20	4	80	0.0500000
NODE_6364_length_1013_cov_32.695842	552	632	23	36	80	0.4500000
NODE_6364_length_1013_cov_32.695842	605	685	19	1	80	0.0125000
NODE_6364_length_1013_cov_32.695842	605	685	20	3	80	0.0375000
NODE_6364_length_1013_cov_32.695842	605	685	23	76	80	0.9500000
NODE_6365_length_1013_cov_21.935449	424	503	0	29	79	0.3670886
NODE_6365_length_1013_cov_21.935449	424	503	5	17	79	0.2151899
NODE_6365_length_1013_cov_21.935449	424	503	7	1	79	0.0126582
NODE_6365_length_1013_cov_21.935449	424	503	8	32	79	0.4050633
NODE_6365_length_1013_cov_21.935449	476	556	8	46	80	0.5750000
NODE_6365_length_1013_cov_21.935449	476	556	10	2	80	0.0250000
NODE_6365_length_1013_cov_21.935449	476	556	13	29	80	0.3625000
NODE_6365_length_1013_cov_21.935449	476	556	16	3	80	0.0375000
NODE_6366_length_1013_cov_17.532823	440	520	2	16	80	0.2000000
NODE_6366_length_1013_cov_17.532823	440	520	4	63	80	0.7875000
NODE_6366_length_1013_cov_17.532823	440	520	6	1	80	0.0125000
NODE_6366_length_1013_cov_17.532823	493	573	2	69	80	0.8625000
NODE_6366_length_1013_cov_17.532823	493	573	4	11	80	0.1375000
NODE_6367_length_1013_cov_14.555799	478	558	2	10	80	0.1250000
NODE_6367_length_1013_cov_14.555799	478	558	3	1	80	0.0125000
NODE_6367_length_1013_cov_14.555799	478	558	4	12	80	0.1500000
NODE_6367_length_1013_cov_14.555799	478	558	5	57	80	0.7125000
NODE_6367_length_1013_cov_14.555799	531	611	3	28	80	0.3500000
NODE_6367_length_1013_cov_14.555799	531	611	4	27	80	0.3375000
NODE_6367_length_1013_cov_14.555799	531	611	5	25	80	0.3125000
NODE_6368_length_1013_cov_13.142232	476	556	3	26	80	0.3250000
NODE_6368_length_1013_cov_13.142232	476	556	4	28	80	0.3500000
NODE_6368_length_1013_cov_13.142232	476	556	5	26	80	0.3250000
NODE_6368_length_1013_cov_13.142232	529	609	3	1	80	0.0125000
NODE_6368_length_1013_cov_13.142232	529	609	4	44	80	0.5500000
NODE_6368_length_1013_cov_13.142232	529	609	5	35	80	0.4375000
NODE_6369_length_1013_cov_7.756018	538	618	0	80	80	1.0000000
NODE_6369_length_1013_cov_7.756018	591	671	0	80	80	1.0000000
NODE_6371_length_1013_cov_4.368709	550	630	1	2	80	0.0250000
NODE_6371_length_1013_cov_4.368709	550	630	2	18	80	0.2250000
NODE_6371_length_1013_cov_4.368709	550	630	3	20	80	0.2500000
NODE_6371_length_1013_cov_4.368709	550	630	4	40	80	0.5000000
NODE_6371_length_1013_cov_4.368709	603	683	1	55	80	0.6875000
NODE_6371_length_1013_cov_4.368709	603	683	2	18	80	0.2250000
NODE_6371_length_1013_cov_4.368709	603	683	3	7	80	0.0875000
NODE_6380_length_1012_cov_91.547645	378	458	9	2	80	0.0250000
NODE_6380_length_1012_cov_91.547645	378	458	21	4	80	0.0500000
NODE_6380_length_1012_cov_91.547645	378	458	26	9	80	0.1125000
NODE_6380_length_1012_cov_91.547645	378	458	28	18	80	0.2250000
NODE_6380_length_1012_cov_91.547645	378	458	33	3	80	0.0375000
NODE_6380_length_1012_cov_91.547645	378	458	34	41	80	0.5125000
NODE_6380_length_1012_cov_91.547645	378	458	35	2	80	0.0250000
NODE_6380_length_1012_cov_91.547645	378	458	36	1	80	0.0125000
NODE_6380_length_1012_cov_91.547645	431	511	31	6	80	0.0750000
NODE_6380_length_1012_cov_91.547645	431	511	32	4	80	0.0500000
NODE_6380_length_1012_cov_91.547645	431	511	33	20	80	0.2500000
NODE_6380_length_1012_cov_91.547645	431	511	34	24	80	0.3000000
NODE_6380_length_1012_cov_91.547645	431	511	35	3	80	0.0375000
NODE_6380_length_1012_cov_91.547645	431	511	36	2	80	0.0250000
NODE_6380_length_1012_cov_91.547645	431	511	37	3	80	0.0375000
NODE_6380_length_1012_cov_91.547645	431	511	46	11	80	0.1375000
NODE_6380_length_1012_cov_91.547645	431	511	47	1	80	0.0125000
NODE_6380_length_1012_cov_91.547645	431	511	49	2	80	0.0250000
NODE_6380_length_1012_cov_91.547645	431	511	51	4	80	0.0500000
NODE_6380_length_1012_cov_91.547645	507	587	27	8	80	0.1000000
NODE_6380_length_1012_cov_91.547645	507	587	28	3	80	0.0375000
NODE_6380_length_1012_cov_91.547645	507	587	29	15	80	0.1875000
NODE_6380_length_1012_cov_91.547645	507	587	31	13	80	0.1625000
NODE_6380_length_1012_cov_91.547645	507	587	32	5	80	0.0625000
NODE_6380_length_1012_cov_91.547645	507	587	33	9	80	0.1125000
NODE_6380_length_1012_cov_91.547645	507	587	38	4	80	0.0500000
NODE_6380_length_1012_cov_91.547645	507	587	40	1	80	0.0125000
NODE_6380_length_1012_cov_91.547645	507	587	41	4	80	0.0500000
NODE_6380_length_1012_cov_91.547645	507	587	42	5	80	0.0625000
NODE_6380_length_1012_cov_91.547645	507	587	45	2	80	0.0250000
NODE_6380_length_1012_cov_91.547645	507	587	46	6	80	0.0750000
NODE_6380_length_1012_cov_91.547645	507	587	47	3	80	0.0375000
NODE_6380_length_1012_cov_91.547645	507	587	49	2	80	0.0250000
NODE_6380_length_1012_cov_91.547645	560	640	22	4	80	0.0500000
NODE_6380_length_1012_cov_91.547645	560	640	27	25	80	0.3125000
NODE_6380_length_1012_cov_91.547645	560	640	28	35	80	0.4375000
NODE_6380_length_1012_cov_91.547645	560	640	29	15	80	0.1875000
NODE_6380_length_1012_cov_91.547645	560	640	32	1	80	0.0125000
NODE_6381_length_1012_cov_64.409639	345	425	25	11	80	0.1375000
NODE_6381_length_1012_cov_64.409639	345	425	26	26	80	0.3250000
NODE_6381_length_1012_cov_64.409639	345	425	27	10	80	0.1250000
NODE_6381_length_1012_cov_64.409639	345	425	28	18	80	0.2250000
NODE_6381_length_1012_cov_64.409639	345	425	29	11	80	0.1375000
NODE_6381_length_1012_cov_64.409639	345	425	31	2	80	0.0250000
NODE_6381_length_1012_cov_64.409639	345	425	33	2	80	0.0250000
NODE_6381_length_1012_cov_64.409639	398	478	25	8	80	0.1000000
NODE_6381_length_1012_cov_64.409639	398	478	26	2	80	0.0250000
NODE_6381_length_1012_cov_64.409639	398	478	27	29	80	0.3625000
NODE_6381_length_1012_cov_64.409639	398	478	28	14	80	0.1750000
NODE_6381_length_1012_cov_64.409639	398	478	29	17	80	0.2125000
NODE_6381_length_1012_cov_64.409639	398	478	31	4	80	0.0500000
NODE_6381_length_1012_cov_64.409639	398	478	33	6	80	0.0750000
NODE_6382_length_1012_cov_63.035049	438	518	9	3	80	0.0375000
NODE_6382_length_1012_cov_63.035049	438	518	10	1	80	0.0125000
NODE_6382_length_1012_cov_63.035049	438	518	11	4	80	0.0500000
NODE_6382_length_1012_cov_63.035049	438	518	12	1	80	0.0125000
NODE_6382_length_1012_cov_63.035049	438	518	13	14	80	0.1750000
NODE_6382_length_1012_cov_63.035049	438	518	14	1	80	0.0125000
NODE_6382_length_1012_cov_63.035049	438	518	15	28	80	0.3500000
NODE_6382_length_1012_cov_63.035049	438	518	20	4	80	0.0500000
NODE_6382_length_1012_cov_63.035049	438	518	21	24	80	0.3000000
NODE_6382_length_1012_cov_63.035049	491	571	20	3	80	0.0375000
NODE_6382_length_1012_cov_63.035049	491	571	21	57	80	0.7125000
NODE_6382_length_1012_cov_63.035049	491	571	23	7	80	0.0875000
NODE_6382_length_1012_cov_63.035049	491	571	25	9	80	0.1125000
NODE_6382_length_1012_cov_63.035049	491	571	26	4	80	0.0500000
NODE_6383_length_1012_cov_53.686747	276	356	2	80	80	1.0000000
NODE_6383_length_1012_cov_53.686747	329	409	2	60	80	0.7500000
NODE_6383_length_1012_cov_53.686747	329	409	3	14	80	0.1750000
NODE_6383_length_1012_cov_53.686747	329	409	4	4	80	0.0500000
NODE_6383_length_1012_cov_53.686747	329	409	5	2	80	0.0250000
NODE_6383_length_1012_cov_53.686747	405	485	3	2	80	0.0250000
NODE_6383_length_1012_cov_53.686747	405	485	5	6	80	0.0750000
NODE_6383_length_1012_cov_53.686747	405	485	6	5	80	0.0625000
NODE_6383_length_1012_cov_53.686747	405	485	7	27	80	0.3375000
NODE_6383_length_1012_cov_53.686747	405	485	9	13	80	0.1625000
NODE_6383_length_1012_cov_53.686747	405	485	10	25	80	0.3125000
NODE_6383_length_1012_cov_53.686747	405	485	11	2	80	0.0250000
NODE_6383_length_1012_cov_53.686747	458	538	10	25	80	0.3125000
NODE_6383_length_1012_cov_53.686747	458	538	11	50	80	0.6250000
NODE_6383_length_1012_cov_53.686747	458	538	13	5	80	0.0625000
NODE_6384_length_1012_cov_35.861993	453	533	0	80	80	1.0000000
NODE_6384_length_1012_cov_35.861993	506	581	0	62	75	0.8266667
NODE_6384_length_1012_cov_35.861993	506	581	4	13	75	0.1733333
NODE_6385_length_1012_cov_16.125958	510	590	5	2	80	0.0250000
NODE_6385_length_1012_cov_16.125958	510	590	6	25	80	0.3125000
NODE_6385_length_1012_cov_16.125958	510	590	7	11	80	0.1375000
NODE_6385_length_1012_cov_16.125958	510	590	8	4	80	0.0500000
NODE_6385_length_1012_cov_16.125958	510	590	9	38	80	0.4750000
NODE_6385_length_1012_cov_16.125958	563	643	7	22	80	0.2750000
NODE_6385_length_1012_cov_16.125958	563	643	8	26	80	0.3250000
NODE_6385_length_1012_cov_16.125958	563	643	9	18	80	0.2250000
NODE_6385_length_1012_cov_16.125958	563	643	10	14	80	0.1750000
NODE_6386_length_1012_cov_15.395400	501	581	0	7	80	0.0875000
NODE_6386_length_1012_cov_15.395400	501	581	1	29	80	0.3625000
NODE_6386_length_1012_cov_15.395400	501	581	4	14	80	0.1750000
NODE_6386_length_1012_cov_15.395400	501	581	5	30	80	0.3750000
NODE_6386_length_1012_cov_15.395400	554	634	5	80	80	1.0000000
NODE_6388_length_1012_cov_6.409639	528	608	1	35	80	0.4375000
NODE_6388_length_1012_cov_6.409639	528	608	2	45	80	0.5625000
NODE_6388_length_1012_cov_6.409639	581	661	0	48	80	0.6000000
NODE_6388_length_1012_cov_6.409639	581	661	1	32	80	0.4000000
NODE_6398_length_1011_cov_53.032895	515	595	66	1	80	0.0125000
NODE_6398_length_1011_cov_53.032895	515	595	67	10	80	0.1250000
NODE_6398_length_1011_cov_53.032895	515	595	68	9	80	0.1125000
NODE_6398_length_1011_cov_53.032895	515	595	69	11	80	0.1375000
NODE_6398_length_1011_cov_53.032895	515	595	70	8	80	0.1000000
NODE_6398_length_1011_cov_53.032895	515	595	71	5	80	0.0625000
NODE_6398_length_1011_cov_53.032895	515	595	72	15	80	0.1875000
NODE_6398_length_1011_cov_53.032895	515	595	73	6	80	0.0750000
NODE_6398_length_1011_cov_53.032895	515	595	74	6	80	0.0750000
NODE_6398_length_1011_cov_53.032895	515	595	75	9	80	0.1125000
NODE_6398_length_1011_cov_53.032895	568	648	49	1	80	0.0125000
NODE_6398_length_1011_cov_53.032895	568	648	55	2	80	0.0250000
NODE_6398_length_1011_cov_53.032895	568	648	56	10	80	0.1250000
NODE_6398_length_1011_cov_53.032895	568	648	57	9	80	0.1125000
NODE_6398_length_1011_cov_53.032895	568	648	58	4	80	0.0500000
NODE_6398_length_1011_cov_53.032895	568	648	62	2	80	0.0250000
NODE_6398_length_1011_cov_53.032895	568	648	64	8	80	0.1000000
NODE_6398_length_1011_cov_53.032895	568	648	66	7	80	0.0875000
NODE_6398_length_1011_cov_53.032895	568	648	71	7	80	0.0875000
NODE_6398_length_1011_cov_53.032895	568	648	72	14	80	0.1750000
NODE_6398_length_1011_cov_53.032895	568	648	73	5	80	0.0625000
NODE_6398_length_1011_cov_53.032895	568	648	74	5	80	0.0625000
NODE_6398_length_1011_cov_53.032895	568	648	75	6	80	0.0750000
NODE_6399_length_1011_cov_25.838816	366	446	11	1	80	0.0125000
NODE_6399_length_1011_cov_25.838816	366	446	12	30	80	0.3750000
NODE_6399_length_1011_cov_25.838816	366	446	13	1	80	0.0125000
NODE_6399_length_1011_cov_25.838816	366	446	15	23	80	0.2875000
NODE_6399_length_1011_cov_25.838816	366	446	16	1	80	0.0125000
NODE_6399_length_1011_cov_25.838816	366	446	17	22	80	0.2750000
NODE_6399_length_1011_cov_25.838816	366	446	18	2	80	0.0250000
NODE_6399_length_1011_cov_25.838816	419	499	13	35	80	0.4375000
NODE_6399_length_1011_cov_25.838816	419	499	14	8	80	0.1000000
NODE_6399_length_1011_cov_25.838816	419	499	15	2	80	0.0250000
NODE_6399_length_1011_cov_25.838816	419	499	16	11	80	0.1375000
NODE_6399_length_1011_cov_25.838816	419	499	17	22	80	0.2750000
NODE_6399_length_1011_cov_25.838816	419	499	18	2	80	0.0250000
NODE_6400_length_1011_cov_22.734649	426	506	0	59	80	0.7375000
NODE_6400_length_1011_cov_22.734649	426	506	1	21	80	0.2625000
NODE_6400_length_1011_cov_22.734649	479	559	0	6	80	0.0750000
NODE_6400_length_1011_cov_22.734649	479	559	1	24	80	0.3000000
NODE_6400_length_1011_cov_22.734649	479	559	2	15	80	0.1875000
NODE_6400_length_1011_cov_22.734649	479	559	3	35	80	0.4375000
NODE_6400_length_1011_cov_22.734649	555	636	3	34	81	0.4197531
NODE_6400_length_1011_cov_22.734649	555	636	4	47	81	0.5802469
NODE_6400_length_1011_cov_22.734649	609	689	2	15	80	0.1875000
NODE_6400_length_1011_cov_22.734649	609	689	3	35	80	0.4375000
NODE_6400_length_1011_cov_22.734649	609	689	4	30	80	0.3750000
NODE_6401_length_1011_cov_18.127193	389	469	6	36	80	0.4500000
NODE_6401_length_1011_cov_18.127193	389	469	8	24	80	0.3000000
NODE_6401_length_1011_cov_18.127193	389	469	9	20	80	0.2500000
NODE_6401_length_1011_cov_18.127193	442	520	8	7	78	0.0897436
NODE_6401_length_1011_cov_18.127193	442	520	9	35	78	0.4487180
NODE_6401_length_1011_cov_18.127193	442	520	10	26	78	0.3333333
NODE_6401_length_1011_cov_18.127193	442	520	11	9	78	0.1153846
NODE_6401_length_1011_cov_18.127193	442	520	14	1	78	0.0128205
NODE_6401_length_1011_cov_18.127193	516	596	9	24	80	0.3000000
NODE_6401_length_1011_cov_18.127193	516	596	10	12	80	0.1500000
NODE_6401_length_1011_cov_18.127193	516	596	11	29	80	0.3625000
NODE_6401_length_1011_cov_18.127193	516	596	14	15	80	0.1875000
NODE_6401_length_1011_cov_18.127193	569	649	7	19	80	0.2375000
NODE_6401_length_1011_cov_18.127193	569	649	8	31	80	0.3875000
NODE_6401_length_1011_cov_18.127193	569	649	9	24	80	0.3000000
NODE_6401_length_1011_cov_18.127193	569	649	11	6	80	0.0750000
NODE_6402_length_1011_cov_12.709430	309	389	6	18	80	0.2250000
NODE_6402_length_1011_cov_12.709430	309	389	7	41	80	0.5125000
NODE_6402_length_1011_cov_12.709430	309	389	8	1	80	0.0125000
NODE_6402_length_1011_cov_12.709430	309	389	9	14	80	0.1750000
NODE_6402_length_1011_cov_12.709430	309	389	10	6	80	0.0750000
NODE_6402_length_1011_cov_12.709430	362	442	7	6	80	0.0750000
NODE_6402_length_1011_cov_12.709430	362	442	8	47	80	0.5875000
NODE_6402_length_1011_cov_12.709430	362	442	9	21	80	0.2625000
NODE_6402_length_1011_cov_12.709430	362	442	10	6	80	0.0750000
NODE_6403_length_1011_cov_8.731360	441	521	5	1	80	0.0125000
NODE_6403_length_1011_cov_8.731360	441	521	6	17	80	0.2125000
NODE_6403_length_1011_cov_8.731360	441	521	7	62	80	0.7750000
NODE_6403_length_1011_cov_8.731360	494	574	3	22	80	0.2750000
NODE_6403_length_1011_cov_8.731360	494	574	4	19	80	0.2375000
NODE_6403_length_1011_cov_8.731360	494	574	6	5	80	0.0625000
NODE_6403_length_1011_cov_8.731360	494	574	7	34	80	0.4250000
NODE_6405_length_1011_cov_7.212719	219	299	1	37	80	0.4625000
NODE_6405_length_1011_cov_7.212719	219	299	2	11	80	0.1375000
NODE_6405_length_1011_cov_7.212719	219	299	3	32	80	0.4000000
NODE_6408_length_1011_cov_3.569079	173	253	0	80	80	1.0000000
NODE_6408_length_1011_cov_3.569079	226	306	0	80	80	1.0000000
NODE_6409_length_1011_cov_1.703947	779	851	0	72	72	1.0000000
NODE_6416_length_1010_cov_51.841932	335	415	1	80	80	1.0000000
NODE_6416_length_1010_cov_51.841932	388	468	0	6	80	0.0750000
NODE_6416_length_1010_cov_51.841932	388	468	1	74	80	0.9250000
NODE_6417_length_1010_cov_35.860593	576	656	7	2	80	0.0250000
NODE_6417_length_1010_cov_35.860593	576	656	8	18	80	0.2250000
NODE_6417_length_1010_cov_35.860593	576	656	11	5	80	0.0625000
NODE_6417_length_1010_cov_35.860593	576	656	12	1	80	0.0125000
NODE_6417_length_1010_cov_35.860593	576	656	13	47	80	0.5875000
NODE_6417_length_1010_cov_35.860593	576	656	17	7	80	0.0875000
NODE_6417_length_1010_cov_35.860593	629	709	7	45	80	0.5625000
NODE_6417_length_1010_cov_35.860593	629	709	8	28	80	0.3500000
NODE_6417_length_1010_cov_35.860593	629	709	17	7	80	0.0875000
NODE_6418_length_1010_cov_30.043908	509	589	5	2	80	0.0250000
NODE_6418_length_1010_cov_30.043908	509	589	8	15	80	0.1875000
NODE_6418_length_1010_cov_30.043908	509	589	9	9	80	0.1125000
NODE_6418_length_1010_cov_30.043908	509	589	10	16	80	0.2000000
NODE_6418_length_1010_cov_30.043908	509	589	11	38	80	0.4750000
NODE_6418_length_1010_cov_30.043908	562	642	9	1	80	0.0125000
NODE_6418_length_1010_cov_30.043908	562	642	10	67	80	0.8375000
NODE_6418_length_1010_cov_30.043908	562	642	11	12	80	0.1500000
NODE_6418_length_1010_cov_30.043908	638	718	1	32	80	0.4000000
NODE_6418_length_1010_cov_30.043908	638	718	2	1	80	0.0125000
NODE_6418_length_1010_cov_30.043908	638	718	4	10	80	0.1250000
NODE_6418_length_1010_cov_30.043908	638	718	5	14	80	0.1750000
NODE_6418_length_1010_cov_30.043908	638	718	8	18	80	0.2250000
NODE_6418_length_1010_cov_30.043908	638	718	10	5	80	0.0625000
NODE_6418_length_1010_cov_30.043908	691	771	1	29	80	0.3625000
NODE_6418_length_1010_cov_30.043908	691	771	3	28	80	0.3500000
NODE_6418_length_1010_cov_30.043908	691	771	4	23	80	0.2875000
NODE_6420_length_1010_cov_15.156970	364	444	6	18	80	0.2250000
NODE_6420_length_1010_cov_15.156970	364	444	7	13	80	0.1625000
NODE_6420_length_1010_cov_15.156970	364	444	8	42	80	0.5250000
NODE_6420_length_1010_cov_15.156970	364	444	9	7	80	0.0875000
NODE_6420_length_1010_cov_15.156970	417	497	5	12	80	0.1500000
NODE_6420_length_1010_cov_15.156970	417	497	7	3	80	0.0375000
NODE_6420_length_1010_cov_15.156970	417	497	8	20	80	0.2500000
NODE_6420_length_1010_cov_15.156970	417	497	9	8	80	0.1000000
NODE_6420_length_1010_cov_15.156970	417	497	10	6	80	0.0750000
NODE_6420_length_1010_cov_15.156970	417	497	11	16	80	0.2000000
NODE_6420_length_1010_cov_15.156970	417	497	12	15	80	0.1875000
NODE_6421_length_1010_cov_13.546652	385	465	2	80	80	1.0000000
NODE_6421_length_1010_cov_13.546652	438	518	0	24	80	0.3000000
NODE_6421_length_1010_cov_13.546652	438	518	1	4	80	0.0500000
NODE_6421_length_1010_cov_13.546652	438	518	2	52	80	0.6500000
NODE_6422_length_1010_cov_13.317234	480	560	2	1	80	0.0125000
NODE_6422_length_1010_cov_13.317234	480	560	4	79	80	0.9875000
NODE_6422_length_1010_cov_13.317234	533	613	2	33	80	0.4125000
NODE_6422_length_1010_cov_13.317234	533	613	4	47	80	0.5875000
NODE_6423_length_1010_cov_12.900110	427	507	0	1	80	0.0125000
NODE_6423_length_1010_cov_12.900110	427	507	2	79	80	0.9875000
NODE_6423_length_1010_cov_12.900110	480	560	2	70	80	0.8750000
NODE_6423_length_1010_cov_12.900110	480	560	6	1	80	0.0125000
NODE_6423_length_1010_cov_12.900110	480	560	7	9	80	0.1125000
NODE_6424_length_1010_cov_11.423710	631	711	0	19	80	0.2375000
NODE_6424_length_1010_cov_11.423710	631	711	1	61	80	0.7625000
NODE_6424_length_1010_cov_11.423710	684	764	0	72	80	0.9000000
NODE_6424_length_1010_cov_11.423710	684	764	1	8	80	0.1000000
NODE_6425_length_1010_cov_11.256861	492	572	9	1	80	0.0125000
NODE_6425_length_1010_cov_11.256861	492	572	11	1	80	0.0125000
NODE_6425_length_1010_cov_11.256861	492	572	12	14	80	0.1750000
NODE_6425_length_1010_cov_11.256861	492	572	13	28	80	0.3500000
NODE_6425_length_1010_cov_11.256861	492	572	14	25	80	0.3125000
NODE_6425_length_1010_cov_11.256861	492	572	16	11	80	0.1375000
NODE_6425_length_1010_cov_11.256861	545	625	8	10	80	0.1250000
NODE_6425_length_1010_cov_11.256861	545	625	9	5	80	0.0625000
NODE_6425_length_1010_cov_11.256861	545	625	10	39	80	0.4875000
NODE_6425_length_1010_cov_11.256861	545	625	11	1	80	0.0125000
NODE_6425_length_1010_cov_11.256861	545	625	13	25	80	0.3125000
NODE_6426_length_1010_cov_11.000000	455	535	2	52	80	0.6500000
NODE_6426_length_1010_cov_11.000000	455	535	3	13	80	0.1625000
NODE_6426_length_1010_cov_11.000000	455	535	4	15	80	0.1875000
NODE_6426_length_1010_cov_11.000000	508	588	0	7	80	0.0875000
NODE_6426_length_1010_cov_11.000000	508	588	1	43	80	0.5375000
NODE_6426_length_1010_cov_11.000000	508	588	2	30	80	0.3750000
NODE_6428_length_1010_cov_4.990121	476	556	2	16	80	0.2000000
NODE_6428_length_1010_cov_4.990121	476	556	4	64	80	0.8000000
NODE_6428_length_1010_cov_4.990121	529	609	2	22	80	0.2750000
NODE_6428_length_1010_cov_4.990121	529	609	4	58	80	0.7250000
NODE_6430_length_1010_cov_4.892426	476	556	0	13	80	0.1625000
NODE_6430_length_1010_cov_4.892426	476	556	2	67	80	0.8375000
NODE_6430_length_1010_cov_4.892426	529	609	2	80	80	1.0000000
NODE_6431_length_1010_cov_3.624588	157	196	0	39	39	1.0000000
NODE_6435_length_1010_cov_1.440176	1	58	0	57	57	1.0000000
NODE_6436_length_1009_cov_44.626374	288	362	2	2	74	0.0270270
NODE_6436_length_1009_cov_44.626374	288	362	3	1	74	0.0135135
NODE_6436_length_1009_cov_44.626374	288	362	4	53	74	0.7162162
NODE_6436_length_1009_cov_44.626374	288	362	5	18	74	0.2432432
NODE_6436_length_1009_cov_44.626374	335	415	3	10	80	0.1250000
NODE_6436_length_1009_cov_44.626374	335	415	4	52	80	0.6500000
NODE_6436_length_1009_cov_44.626374	335	415	5	18	80	0.2250000
NODE_6436_length_1009_cov_44.626374	411	491	2	51	80	0.6375000
NODE_6436_length_1009_cov_44.626374	411	491	4	29	80	0.3625000
NODE_6436_length_1009_cov_44.626374	464	544	0	23	80	0.2875000
NODE_6436_length_1009_cov_44.626374	464	544	1	28	80	0.3500000
NODE_6436_length_1009_cov_44.626374	464	544	2	29	80	0.3625000
NODE_6437_length_1009_cov_31.828571	412	492	4	55	80	0.6875000
NODE_6437_length_1009_cov_31.828571	412	492	6	25	80	0.3125000
NODE_6437_length_1009_cov_31.828571	465	545	4	13	80	0.1625000
NODE_6437_length_1009_cov_31.828571	465	545	6	35	80	0.4375000
NODE_6437_length_1009_cov_31.828571	465	545	7	15	80	0.1875000
NODE_6437_length_1009_cov_31.828571	465	545	8	17	80	0.2125000
NODE_6438_length_1009_cov_28.539560	571	651	9	8	80	0.1000000
NODE_6438_length_1009_cov_28.539560	571	651	10	6	80	0.0750000
NODE_6438_length_1009_cov_28.539560	571	651	13	3	80	0.0375000
NODE_6438_length_1009_cov_28.539560	571	651	14	2	80	0.0250000
NODE_6438_length_1009_cov_28.539560	571	651	15	22	80	0.2750000
NODE_6438_length_1009_cov_28.539560	571	651	16	26	80	0.3250000
NODE_6438_length_1009_cov_28.539560	571	651	18	13	80	0.1625000
NODE_6438_length_1009_cov_28.539560	624	704	4	11	80	0.1375000
NODE_6438_length_1009_cov_28.539560	624	704	5	9	80	0.1125000
NODE_6438_length_1009_cov_28.539560	624	704	6	25	80	0.3125000
NODE_6438_length_1009_cov_28.539560	624	704	8	1	80	0.0125000
NODE_6438_length_1009_cov_28.539560	624	704	9	9	80	0.1125000
NODE_6438_length_1009_cov_28.539560	624	704	10	12	80	0.1500000
NODE_6438_length_1009_cov_28.539560	624	704	13	3	80	0.0375000
NODE_6438_length_1009_cov_28.539560	624	704	14	2	80	0.0250000
NODE_6438_length_1009_cov_28.539560	624	704	16	8	80	0.1000000
NODE_6439_length_1009_cov_20.281319	577	657	8	5	80	0.0625000
NODE_6439_length_1009_cov_20.281319	577	657	10	12	80	0.1500000
NODE_6439_length_1009_cov_20.281319	577	657	11	6	80	0.0750000
NODE_6439_length_1009_cov_20.281319	577	657	12	12	80	0.1500000
NODE_6439_length_1009_cov_20.281319	577	657	13	22	80	0.2750000
NODE_6439_length_1009_cov_20.281319	577	657	14	4	80	0.0500000
NODE_6439_length_1009_cov_20.281319	577	657	15	15	80	0.1875000
NODE_6439_length_1009_cov_20.281319	577	657	16	4	80	0.0500000
NODE_6439_length_1009_cov_20.281319	630	710	12	6	80	0.0750000
NODE_6439_length_1009_cov_20.281319	630	710	13	6	80	0.0750000
NODE_6439_length_1009_cov_20.281319	630	710	14	12	80	0.1500000
NODE_6439_length_1009_cov_20.281319	630	710	15	23	80	0.2875000
NODE_6439_length_1009_cov_20.281319	630	710	16	33	80	0.4125000
NODE_6440_length_1009_cov_18.649451	430	510	17	2	80	0.0250000
NODE_6440_length_1009_cov_18.649451	430	510	22	12	80	0.1500000
NODE_6440_length_1009_cov_18.649451	430	510	23	39	80	0.4875000
NODE_6440_length_1009_cov_18.649451	430	510	25	27	80	0.3375000
NODE_6440_length_1009_cov_18.649451	483	563	4	4	80	0.0500000
NODE_6440_length_1009_cov_18.649451	483	563	7	8	80	0.1000000
NODE_6440_length_1009_cov_18.649451	483	563	8	1	80	0.0125000
NODE_6440_length_1009_cov_18.649451	483	563	9	1	80	0.0125000
NODE_6440_length_1009_cov_18.649451	483	563	11	1	80	0.0125000
NODE_6440_length_1009_cov_18.649451	483	563	12	10	80	0.1250000
NODE_6440_length_1009_cov_18.649451	483	563	13	2	80	0.0250000
NODE_6440_length_1009_cov_18.649451	483	563	14	1	80	0.0125000
NODE_6440_length_1009_cov_18.649451	483	563	16	4	80	0.0500000
NODE_6440_length_1009_cov_18.649451	483	563	17	23	80	0.2875000
NODE_6440_length_1009_cov_18.649451	483	563	22	12	80	0.1500000
NODE_6440_length_1009_cov_18.649451	483	563	23	9	80	0.1125000
NODE_6440_length_1009_cov_18.649451	483	563	25	4	80	0.0500000
NODE_6442_length_1009_cov_3.767033	647	727	0	80	80	1.0000000
NODE_6442_length_1009_cov_3.767033	700	780	0	80	80	1.0000000
NODE_6443_length_1009_cov_2.903297	36	63	0	27	27	1.0000000
NODE_6451_length_1008_cov_44.825083	399	479	8	14	80	0.1750000
NODE_6451_length_1008_cov_44.825083	399	479	9	2	80	0.0250000
NODE_6451_length_1008_cov_44.825083	399	479	12	3	80	0.0375000
NODE_6451_length_1008_cov_44.825083	399	479	15	27	80	0.3375000
NODE_6451_length_1008_cov_44.825083	399	479	16	10	80	0.1250000
NODE_6451_length_1008_cov_44.825083	399	479	18	3	80	0.0375000
NODE_6451_length_1008_cov_44.825083	399	479	19	11	80	0.1375000
NODE_6451_length_1008_cov_44.825083	399	479	22	1	80	0.0125000
NODE_6451_length_1008_cov_44.825083	399	479	23	5	80	0.0625000
NODE_6451_length_1008_cov_44.825083	399	479	26	4	80	0.0500000
NODE_6451_length_1008_cov_44.825083	452	532	16	3	80	0.0375000
NODE_6451_length_1008_cov_44.825083	452	532	18	3	80	0.0375000
NODE_6451_length_1008_cov_44.825083	452	532	19	11	80	0.1375000
NODE_6451_length_1008_cov_44.825083	452	532	21	13	80	0.1625000
NODE_6451_length_1008_cov_44.825083	452	532	22	6	80	0.0750000
NODE_6451_length_1008_cov_44.825083	452	532	23	16	80	0.2000000
NODE_6451_length_1008_cov_44.825083	452	532	24	8	80	0.1000000
NODE_6451_length_1008_cov_44.825083	452	532	25	12	80	0.1500000
NODE_6451_length_1008_cov_44.825083	452	532	26	8	80	0.1000000
NODE_6452_length_1008_cov_41.030803	280	360	5	22	80	0.2750000
NODE_6452_length_1008_cov_41.030803	280	360	6	26	80	0.3250000
NODE_6452_length_1008_cov_41.030803	280	360	8	1	80	0.0125000
NODE_6452_length_1008_cov_41.030803	280	360	9	8	80	0.1000000
NODE_6452_length_1008_cov_41.030803	280	360	10	20	80	0.2500000
NODE_6452_length_1008_cov_41.030803	280	360	11	3	80	0.0375000
NODE_6452_length_1008_cov_41.030803	333	413	9	4	80	0.0500000
NODE_6452_length_1008_cov_41.030803	333	413	10	20	80	0.2500000
NODE_6452_length_1008_cov_41.030803	333	413	11	18	80	0.2250000
NODE_6452_length_1008_cov_41.030803	333	413	13	14	80	0.1750000
NODE_6452_length_1008_cov_41.030803	333	413	14	6	80	0.0750000
NODE_6452_length_1008_cov_41.030803	333	413	15	10	80	0.1250000
NODE_6452_length_1008_cov_41.030803	333	413	16	8	80	0.1000000
NODE_6452_length_1008_cov_41.030803	409	489	7	2	80	0.0250000
NODE_6452_length_1008_cov_41.030803	409	489	8	8	80	0.1000000
NODE_6452_length_1008_cov_41.030803	409	489	9	1	80	0.0125000
NODE_6452_length_1008_cov_41.030803	409	489	10	2	80	0.0250000
NODE_6452_length_1008_cov_41.030803	409	489	11	8	80	0.1000000
NODE_6452_length_1008_cov_41.030803	409	489	12	32	80	0.4000000
NODE_6452_length_1008_cov_41.030803	409	489	13	27	80	0.3375000
NODE_6452_length_1008_cov_41.030803	462	542	0	1	80	0.0125000
NODE_6452_length_1008_cov_41.030803	462	542	1	10	80	0.1250000
NODE_6452_length_1008_cov_41.030803	462	542	3	6	80	0.0750000
NODE_6452_length_1008_cov_41.030803	462	542	6	18	80	0.2250000
NODE_6452_length_1008_cov_41.030803	462	542	7	20	80	0.2500000
NODE_6452_length_1008_cov_41.030803	462	542	8	8	80	0.1000000
NODE_6452_length_1008_cov_41.030803	462	542	9	1	80	0.0125000
NODE_6452_length_1008_cov_41.030803	462	542	10	2	80	0.0250000
NODE_6452_length_1008_cov_41.030803	462	542	11	8	80	0.1000000
NODE_6452_length_1008_cov_41.030803	462	542	12	6	80	0.0750000
NODE_6453_length_1008_cov_39.377338	311	391	3	11	80	0.1375000
NODE_6453_length_1008_cov_39.377338	311	391	4	4	80	0.0500000
NODE_6453_length_1008_cov_39.377338	311	391	5	37	80	0.4625000
NODE_6453_length_1008_cov_39.377338	311	391	6	28	80	0.3500000
NODE_6453_length_1008_cov_39.377338	364	444	2	2	80	0.0250000
NODE_6453_length_1008_cov_39.377338	364	444	3	26	80	0.3250000
NODE_6453_length_1008_cov_39.377338	364	444	4	4	80	0.0500000
NODE_6453_length_1008_cov_39.377338	364	444	5	48	80	0.6000000
NODE_6453_length_1008_cov_39.377338	440	520	2	10	80	0.1250000
NODE_6453_length_1008_cov_39.377338	440	520	4	1	80	0.0125000
NODE_6453_length_1008_cov_39.377338	440	520	5	15	80	0.1875000
NODE_6453_length_1008_cov_39.377338	440	520	6	14	80	0.1750000
NODE_6453_length_1008_cov_39.377338	440	520	8	18	80	0.2250000
NODE_6453_length_1008_cov_39.377338	440	520	9	5	80	0.0625000
NODE_6453_length_1008_cov_39.377338	440	520	10	3	80	0.0375000
NODE_6453_length_1008_cov_39.377338	440	520	11	14	80	0.1750000
NODE_6453_length_1008_cov_39.377338	493	573	8	5	80	0.0625000
NODE_6453_length_1008_cov_39.377338	493	573	9	5	80	0.0625000
NODE_6453_length_1008_cov_39.377338	493	573	10	3	80	0.0375000
NODE_6453_length_1008_cov_39.377338	493	573	11	24	80	0.3000000
NODE_6453_length_1008_cov_39.377338	493	573	12	1	80	0.0125000
NODE_6453_length_1008_cov_39.377338	493	573	13	10	80	0.1250000
NODE_6453_length_1008_cov_39.377338	493	573	15	22	80	0.2750000
NODE_6453_length_1008_cov_39.377338	493	573	17	10	80	0.1250000
NODE_6454_length_1008_cov_27.836084	405	485	7	12	80	0.1500000
NODE_6454_length_1008_cov_27.836084	405	485	9	9	80	0.1125000
NODE_6454_length_1008_cov_27.836084	405	485	10	11	80	0.1375000
NODE_6454_length_1008_cov_27.836084	405	485	12	15	80	0.1875000
NODE_6454_length_1008_cov_27.836084	405	485	13	10	80	0.1250000
NODE_6454_length_1008_cov_27.836084	405	485	14	23	80	0.2875000
NODE_6454_length_1008_cov_27.836084	458	538	8	14	80	0.1750000
NODE_6454_length_1008_cov_27.836084	458	538	9	24	80	0.3000000
NODE_6454_length_1008_cov_27.836084	458	538	11	5	80	0.0625000
NODE_6454_length_1008_cov_27.836084	458	538	13	15	80	0.1875000
NODE_6454_length_1008_cov_27.836084	458	538	14	22	80	0.2750000
NODE_6454_length_1008_cov_27.836084	534	614	0	7	80	0.0875000
NODE_6454_length_1008_cov_27.836084	534	614	1	5	80	0.0625000
NODE_6454_length_1008_cov_27.836084	534	614	2	15	80	0.1875000
NODE_6454_length_1008_cov_27.836084	534	614	4	11	80	0.1375000
NODE_6454_length_1008_cov_27.836084	534	614	5	9	80	0.1125000
NODE_6454_length_1008_cov_27.836084	534	614	6	2	80	0.0250000
NODE_6454_length_1008_cov_27.836084	534	614	7	14	80	0.1750000
NODE_6454_length_1008_cov_27.836084	534	614	8	17	80	0.2125000
NODE_6454_length_1008_cov_27.836084	587	667	0	60	80	0.7500000
NODE_6454_length_1008_cov_27.836084	587	667	1	5	80	0.0625000
NODE_6454_length_1008_cov_27.836084	587	667	2	15	80	0.1875000
NODE_6455_length_1008_cov_24.741474	485	565	6	13	80	0.1625000
NODE_6455_length_1008_cov_24.741474	485	565	7	15	80	0.1875000
NODE_6455_length_1008_cov_24.741474	485	565	8	39	80	0.4875000
NODE_6455_length_1008_cov_24.741474	485	565	10	13	80	0.1625000
NODE_6455_length_1008_cov_24.741474	538	618	4	18	80	0.2250000
NODE_6455_length_1008_cov_24.741474	538	618	5	15	80	0.1875000
NODE_6455_length_1008_cov_24.741474	538	618	6	33	80	0.4125000
NODE_6455_length_1008_cov_24.741474	538	618	7	14	80	0.1750000
NODE_6456_length_1008_cov_20.278328	401	481	2	25	80	0.3125000
NODE_6456_length_1008_cov_20.278328	401	481	4	55	80	0.6875000
NODE_6456_length_1008_cov_20.278328	454	534	2	26	80	0.3250000
NODE_6456_length_1008_cov_20.278328	454	534	4	54	80	0.6750000
NODE_6457_length_1008_cov_6.071507	460	540	0	48	80	0.6000000
NODE_6457_length_1008_cov_6.071507	460	540	1	32	80	0.4000000
NODE_6457_length_1008_cov_6.071507	513	593	1	80	80	1.0000000
NODE_6466_length_1008_cov_1.798680	0	64	0	64	64	1.0000000
NODE_6466_length_1008_cov_1.798680	37	104	0	67	67	1.0000000
NODE_6473_length_1007_cov_27.011013	294	371	6	3	77	0.0389610
NODE_6473_length_1007_cov_27.011013	294	371	10	2	77	0.0259740
NODE_6473_length_1007_cov_27.011013	294	371	12	55	77	0.7142857
NODE_6473_length_1007_cov_27.011013	294	371	13	2	77	0.0259740
NODE_6473_length_1007_cov_27.011013	294	371	14	15	77	0.1948052
NODE_6473_length_1007_cov_27.011013	347	424	11	33	77	0.4285714
NODE_6473_length_1007_cov_27.011013	347	424	12	7	77	0.0909091
NODE_6473_length_1007_cov_27.011013	347	424	13	22	77	0.2857143
NODE_6473_length_1007_cov_27.011013	347	424	14	15	77	0.1948052
NODE_6474_length_1007_cov_24.668502	369	449	1	15	80	0.1875000
NODE_6474_length_1007_cov_24.668502	369	449	2	65	80	0.8125000
NODE_6474_length_1007_cov_24.668502	422	502	2	40	80	0.5000000
NODE_6474_length_1007_cov_24.668502	422	502	3	4	80	0.0500000
NODE_6474_length_1007_cov_24.668502	422	502	4	36	80	0.4500000
NODE_6474_length_1007_cov_24.668502	498	578	4	53	80	0.6625000
NODE_6474_length_1007_cov_24.668502	498	578	5	27	80	0.3375000
NODE_6474_length_1007_cov_24.668502	551	631	2	7	80	0.0875000
NODE_6474_length_1007_cov_24.668502	551	631	3	12	80	0.1500000
NODE_6474_length_1007_cov_24.668502	551	631	4	45	80	0.5625000
NODE_6474_length_1007_cov_24.668502	551	631	5	16	80	0.2000000
NODE_6475_length_1007_cov_21.729075	454	534	3	11	80	0.1375000
NODE_6475_length_1007_cov_21.729075	454	534	4	67	80	0.8375000
NODE_6475_length_1007_cov_21.729075	454	534	5	2	80	0.0250000
NODE_6475_length_1007_cov_21.729075	507	587	1	49	80	0.6125000
NODE_6475_length_1007_cov_21.729075	507	587	3	3	80	0.0375000
NODE_6475_length_1007_cov_21.729075	507	587	4	28	80	0.3500000
NODE_6475_length_1007_cov_21.729075	583	663	0	46	80	0.5750000
NODE_6475_length_1007_cov_21.729075	583	663	1	34	80	0.4250000
NODE_6475_length_1007_cov_21.729075	636	716	0	80	80	1.0000000
NODE_6476_length_1007_cov_14.515419	400	480	1	19	80	0.2375000
NODE_6476_length_1007_cov_14.515419	400	480	2	4	80	0.0500000
NODE_6476_length_1007_cov_14.515419	400	480	3	57	80	0.7125000
NODE_6476_length_1007_cov_14.515419	453	533	3	80	80	1.0000000
NODE_6477_length_1007_cov_13.685022	376	456	3	49	80	0.6125000
NODE_6477_length_1007_cov_13.685022	376	456	5	31	80	0.3875000
NODE_6477_length_1007_cov_13.685022	429	509	3	30	80	0.3750000
NODE_6477_length_1007_cov_13.685022	429	509	5	50	80	0.6250000
NODE_6478_length_1007_cov_9.189427	438	518	7	53	80	0.6625000
NODE_6478_length_1007_cov_9.189427	438	518	8	27	80	0.3375000
NODE_6478_length_1007_cov_9.189427	491	571	0	9	80	0.1125000
NODE_6478_length_1007_cov_9.189427	491	571	2	12	80	0.1500000
NODE_6478_length_1007_cov_9.189427	491	571	3	7	80	0.0875000
NODE_6478_length_1007_cov_9.189427	491	571	5	9	80	0.1125000
NODE_6478_length_1007_cov_9.189427	491	571	6	4	80	0.0500000
NODE_6478_length_1007_cov_9.189427	491	571	7	39	80	0.4875000
NODE_6491_length_1006_cov_59.773980	379	459	22	9	80	0.1125000
NODE_6491_length_1006_cov_59.773980	379	459	23	16	80	0.2000000
NODE_6491_length_1006_cov_59.773980	379	459	24	17	80	0.2125000
NODE_6491_length_1006_cov_59.773980	379	459	25	18	80	0.2250000
NODE_6491_length_1006_cov_59.773980	379	459	26	20	80	0.2500000
NODE_6491_length_1006_cov_59.773980	432	512	20	4	80	0.0500000
NODE_6491_length_1006_cov_59.773980	432	512	21	9	80	0.1125000
NODE_6491_length_1006_cov_59.773980	432	512	22	27	80	0.3375000
NODE_6491_length_1006_cov_59.773980	432	512	23	22	80	0.2750000
NODE_6491_length_1006_cov_59.773980	432	512	24	11	80	0.1375000
NODE_6491_length_1006_cov_59.773980	432	512	25	3	80	0.0375000
NODE_6491_length_1006_cov_59.773980	432	512	28	4	80	0.0500000
NODE_6491_length_1006_cov_59.773980	508	588	14	39	80	0.4875000
NODE_6491_length_1006_cov_59.773980	508	588	15	11	80	0.1375000
NODE_6491_length_1006_cov_59.773980	508	588	16	11	80	0.1375000
NODE_6491_length_1006_cov_59.773980	508	588	17	4	80	0.0500000
NODE_6491_length_1006_cov_59.773980	508	588	20	3	80	0.0375000
NODE_6491_length_1006_cov_59.773980	508	588	21	12	80	0.1500000
NODE_6491_length_1006_cov_59.773980	561	641	4	11	80	0.1375000
NODE_6491_length_1006_cov_59.773980	561	641	6	15	80	0.1875000
NODE_6491_length_1006_cov_59.773980	561	641	11	13	80	0.1625000
NODE_6491_length_1006_cov_59.773980	561	641	12	13	80	0.1625000
NODE_6491_length_1006_cov_59.773980	561	641	14	23	80	0.2875000
NODE_6491_length_1006_cov_59.773980	561	641	15	5	80	0.0625000
NODE_6492_length_1006_cov_34.762955	482	562	6	33	80	0.4125000
NODE_6492_length_1006_cov_34.762955	482	562	7	7	80	0.0875000
NODE_6492_length_1006_cov_34.762955	482	562	8	7	80	0.0875000
NODE_6492_length_1006_cov_34.762955	482	562	9	33	80	0.4125000
NODE_6492_length_1006_cov_34.762955	535	615	4	11	80	0.1375000
NODE_6492_length_1006_cov_34.762955	535	615	6	13	80	0.1625000
NODE_6492_length_1006_cov_34.762955	535	615	8	10	80	0.1250000
NODE_6492_length_1006_cov_34.762955	535	615	9	46	80	0.5750000
NODE_6493_length_1006_cov_21.776185	516	596	9	11	80	0.1375000
NODE_6493_length_1006_cov_21.776185	516	596	10	7	80	0.0875000
NODE_6493_length_1006_cov_21.776185	516	596	11	3	80	0.0375000
NODE_6493_length_1006_cov_21.776185	516	596	12	29	80	0.3625000
NODE_6493_length_1006_cov_21.776185	516	596	13	30	80	0.3750000
NODE_6493_length_1006_cov_21.776185	569	649	7	1	80	0.0125000
NODE_6493_length_1006_cov_21.776185	569	649	8	4	80	0.0500000
NODE_6493_length_1006_cov_21.776185	569	649	12	17	80	0.2125000
NODE_6493_length_1006_cov_21.776185	569	649	13	51	80	0.6375000
NODE_6493_length_1006_cov_21.776185	569	649	14	7	80	0.0875000
NODE_6494_length_1006_cov_19.690187	371	451	0	7	80	0.0875000
NODE_6494_length_1006_cov_19.690187	371	451	2	73	80	0.9125000
NODE_6494_length_1006_cov_19.690187	424	504	0	4	80	0.0500000
NODE_6494_length_1006_cov_19.690187	424	504	2	76	80	0.9500000
NODE_6495_length_1006_cov_19.299890	495	575	4	22	80	0.2750000
NODE_6495_length_1006_cov_19.299890	495	575	5	9	80	0.1125000
NODE_6495_length_1006_cov_19.299890	495	575	6	49	80	0.6125000
NODE_6495_length_1006_cov_19.299890	548	628	2	17	80	0.2125000
NODE_6495_length_1006_cov_19.299890	548	628	3	3	80	0.0375000
NODE_6495_length_1006_cov_19.299890	548	628	4	46	80	0.5750000
NODE_6495_length_1006_cov_19.299890	548	628	6	14	80	0.1750000
NODE_6496_length_1006_cov_13.187431	245	325	9	19	80	0.2375000
NODE_6496_length_1006_cov_13.187431	245	325	10	1	80	0.0125000
NODE_6496_length_1006_cov_13.187431	245	325	11	4	80	0.0500000
NODE_6496_length_1006_cov_13.187431	245	325	12	22	80	0.2750000
NODE_6496_length_1006_cov_13.187431	245	325	13	7	80	0.0875000
NODE_6496_length_1006_cov_13.187431	245	325	14	4	80	0.0500000
NODE_6496_length_1006_cov_13.187431	245	325	15	2	80	0.0250000
NODE_6496_length_1006_cov_13.187431	245	325	16	21	80	0.2625000
NODE_6496_length_1006_cov_13.187431	298	378	8	26	80	0.3250000
NODE_6496_length_1006_cov_13.187431	298	378	14	13	80	0.1625000
NODE_6496_length_1006_cov_13.187431	298	378	15	18	80	0.2250000
NODE_6496_length_1006_cov_13.187431	298	378	16	23	80	0.2875000
NODE_6497_length_1006_cov_12.862183	383	463	3	80	80	1.0000000
NODE_6497_length_1006_cov_12.862183	436	516	0	19	80	0.2375000
NODE_6497_length_1006_cov_12.862183	436	516	1	6	80	0.0750000
NODE_6497_length_1006_cov_12.862183	436	516	3	46	80	0.5750000
NODE_6497_length_1006_cov_12.862183	436	516	5	9	80	0.1125000
NODE_6498_length_1006_cov_10.986770	762	842	8	7	80	0.0875000
NODE_6498_length_1006_cov_10.986770	762	842	9	9	80	0.1125000
NODE_6498_length_1006_cov_10.986770	762	842	14	3	80	0.0375000
NODE_6498_length_1006_cov_10.986770	762	842	15	13	80	0.1625000
NODE_6498_length_1006_cov_10.986770	762	842	17	1	80	0.0125000
NODE_6498_length_1006_cov_10.986770	762	842	19	16	80	0.2000000
NODE_6498_length_1006_cov_10.986770	762	842	20	31	80	0.3875000
NODE_6498_length_1006_cov_10.986770	815	895	13	23	80	0.2875000
NODE_6498_length_1006_cov_10.986770	815	895	14	10	80	0.1250000
NODE_6498_length_1006_cov_10.986770	815	895	15	17	80	0.2125000
NODE_6498_length_1006_cov_10.986770	815	895	20	30	80	0.3750000
NODE_6499_length_1006_cov_8.633958	314	394	11	1	80	0.0125000
NODE_6499_length_1006_cov_8.633958	314	394	12	10	80	0.1250000
NODE_6499_length_1006_cov_8.633958	314	394	14	35	80	0.4375000
NODE_6499_length_1006_cov_8.633958	314	394	15	34	80	0.4250000
NODE_6499_length_1006_cov_8.633958	367	447	3	4	80	0.0500000
NODE_6499_length_1006_cov_8.633958	367	447	4	4	80	0.0500000
NODE_6499_length_1006_cov_8.633958	367	447	5	2	80	0.0250000
NODE_6499_length_1006_cov_8.633958	367	447	7	7	80	0.0875000
NODE_6499_length_1006_cov_8.633958	367	447	8	11	80	0.1375000
NODE_6499_length_1006_cov_8.633958	367	447	10	18	80	0.2250000
NODE_6499_length_1006_cov_8.633958	367	447	11	8	80	0.1000000
NODE_6499_length_1006_cov_8.633958	367	447	12	10	80	0.1250000
NODE_6499_length_1006_cov_8.633958	367	447	14	16	80	0.2000000
NODE_6515_length_1005_cov_80.271523	509	589	32	5	80	0.0625000
NODE_6515_length_1005_cov_80.271523	509	589	33	4	80	0.0500000
NODE_6515_length_1005_cov_80.271523	509	589	34	17	80	0.2125000
NODE_6515_length_1005_cov_80.271523	509	589	35	1	80	0.0125000
NODE_6515_length_1005_cov_80.271523	509	589	36	26	80	0.3250000
NODE_6515_length_1005_cov_80.271523	509	589	37	23	80	0.2875000
NODE_6515_length_1005_cov_80.271523	509	589	38	1	80	0.0125000
NODE_6515_length_1005_cov_80.271523	509	589	39	3	80	0.0375000
NODE_6515_length_1005_cov_80.271523	562	642	22	9	80	0.1125000
NODE_6515_length_1005_cov_80.271523	562	642	23	10	80	0.1250000
NODE_6515_length_1005_cov_80.271523	562	642	24	1	80	0.0125000
NODE_6515_length_1005_cov_80.271523	562	642	26	3	80	0.0375000
NODE_6515_length_1005_cov_80.271523	562	642	28	6	80	0.0750000
NODE_6515_length_1005_cov_80.271523	562	642	30	19	80	0.2375000
NODE_6515_length_1005_cov_80.271523	562	642	33	4	80	0.0500000
NODE_6515_length_1005_cov_80.271523	562	642	36	12	80	0.1500000
NODE_6515_length_1005_cov_80.271523	562	642	37	12	80	0.1500000
NODE_6515_length_1005_cov_80.271523	562	642	38	1	80	0.0125000
NODE_6515_length_1005_cov_80.271523	562	642	39	3	80	0.0375000
NODE_6516_length_1005_cov_45.008830	357	437	4	7	80	0.0875000
NODE_6516_length_1005_cov_45.008830	357	437	5	5	80	0.0625000
NODE_6516_length_1005_cov_45.008830	357	437	6	15	80	0.1875000
NODE_6516_length_1005_cov_45.008830	357	437	7	31	80	0.3875000
NODE_6516_length_1005_cov_45.008830	357	437	8	8	80	0.1000000
NODE_6516_length_1005_cov_45.008830	357	437	9	3	80	0.0375000
NODE_6516_length_1005_cov_45.008830	357	437	12	7	80	0.0875000
NODE_6516_length_1005_cov_45.008830	357	437	14	1	80	0.0125000
NODE_6516_length_1005_cov_45.008830	357	437	15	3	80	0.0375000
NODE_6516_length_1005_cov_45.008830	410	490	7	5	80	0.0625000
NODE_6516_length_1005_cov_45.008830	410	490	8	8	80	0.1000000
NODE_6516_length_1005_cov_45.008830	410	490	9	3	80	0.0375000
NODE_6516_length_1005_cov_45.008830	410	490	12	7	80	0.0875000
NODE_6516_length_1005_cov_45.008830	410	490	14	1	80	0.0125000
NODE_6516_length_1005_cov_45.008830	410	490	15	45	80	0.5625000
NODE_6516_length_1005_cov_45.008830	410	490	16	11	80	0.1375000
NODE_6517_length_1005_cov_36.636865	567	647	4	7	80	0.0875000
NODE_6517_length_1005_cov_36.636865	567	647	5	1	80	0.0125000
NODE_6517_length_1005_cov_36.636865	567	647	6	15	80	0.1875000
NODE_6517_length_1005_cov_36.636865	567	647	7	57	80	0.7125000
NODE_6517_length_1005_cov_36.636865	620	700	2	43	80	0.5375000
NODE_6517_length_1005_cov_36.636865	620	700	4	17	80	0.2125000
NODE_6517_length_1005_cov_36.636865	620	700	5	1	80	0.0125000
NODE_6517_length_1005_cov_36.636865	620	700	6	5	80	0.0625000
NODE_6517_length_1005_cov_36.636865	620	700	7	14	80	0.1750000
NODE_6518_length_1005_cov_21.222958	389	409	6	13	20	0.6500000
NODE_6518_length_1005_cov_21.222958	389	409	7	7	20	0.3500000
NODE_6518_length_1005_cov_21.222958	451	519	13	4	68	0.0588235
NODE_6518_length_1005_cov_21.222958	451	519	14	4	68	0.0588235
NODE_6518_length_1005_cov_21.222958	451	519	15	9	68	0.1323529
NODE_6518_length_1005_cov_21.222958	451	519	16	18	68	0.2647059
NODE_6518_length_1005_cov_21.222958	451	519	17	10	68	0.1470588
NODE_6518_length_1005_cov_21.222958	451	519	20	2	68	0.0294118
NODE_6518_length_1005_cov_21.222958	451	519	21	17	68	0.2500000
NODE_6518_length_1005_cov_21.222958	451	519	22	4	68	0.0588235
NODE_6518_length_1005_cov_21.222958	515	595	16	10	80	0.1250000
NODE_6518_length_1005_cov_21.222958	515	595	18	18	80	0.2250000
NODE_6518_length_1005_cov_21.222958	515	595	19	2	80	0.0250000
NODE_6518_length_1005_cov_21.222958	515	595	22	30	80	0.3750000
NODE_6518_length_1005_cov_21.222958	515	595	23	12	80	0.1500000
NODE_6518_length_1005_cov_21.222958	515	595	24	8	80	0.1000000
NODE_6518_length_1005_cov_21.222958	568	648	5	1	80	0.0125000
NODE_6518_length_1005_cov_21.222958	568	648	7	1	80	0.0125000
NODE_6518_length_1005_cov_21.222958	568	648	8	10	80	0.1250000
NODE_6518_length_1005_cov_21.222958	568	648	12	31	80	0.3875000
NODE_6518_length_1005_cov_21.222958	568	648	13	5	80	0.0625000
NODE_6518_length_1005_cov_21.222958	568	648	15	4	80	0.0500000
NODE_6518_length_1005_cov_21.222958	568	648	16	11	80	0.1375000
NODE_6518_length_1005_cov_21.222958	568	648	18	17	80	0.2125000
NODE_6520_length_1005_cov_14.278146	480	560	4	7	80	0.0875000
NODE_6520_length_1005_cov_14.278146	480	560	5	9	80	0.1125000
NODE_6520_length_1005_cov_14.278146	480	560	6	64	80	0.8000000
NODE_6520_length_1005_cov_14.278146	533	613	3	33	80	0.4125000
NODE_6520_length_1005_cov_14.278146	533	613	4	27	80	0.3375000
NODE_6520_length_1005_cov_14.278146	533	613	6	20	80	0.2500000
NODE_6521_length_1005_cov_13.215232	511	591	2	4	80	0.0500000
NODE_6521_length_1005_cov_13.215232	511	591	4	5	80	0.0625000
NODE_6521_length_1005_cov_13.215232	511	591	5	19	80	0.2375000
NODE_6521_length_1005_cov_13.215232	511	591	7	27	80	0.3375000
NODE_6521_length_1005_cov_13.215232	511	591	8	25	80	0.3125000
NODE_6521_length_1005_cov_13.215232	564	644	7	6	80	0.0750000
NODE_6521_length_1005_cov_13.215232	564	644	8	28	80	0.3500000
NODE_6521_length_1005_cov_13.215232	564	644	9	23	80	0.2875000
NODE_6521_length_1005_cov_13.215232	564	644	10	8	80	0.1000000
NODE_6521_length_1005_cov_13.215232	564	644	12	15	80	0.1875000
NODE_6523_length_1005_cov_5.579470	534	614	0	13	80	0.1625000
NODE_6523_length_1005_cov_5.579470	534	614	1	67	80	0.8375000
NODE_6523_length_1005_cov_5.579470	587	667	0	21	80	0.2625000
NODE_6523_length_1005_cov_5.579470	587	667	1	59	80	0.7375000
NODE_6536_length_1004_cov_45.470718	343	423	13	1	80	0.0125000
NODE_6536_length_1004_cov_45.470718	343	423	14	19	80	0.2375000
NODE_6536_length_1004_cov_45.470718	343	423	15	12	80	0.1500000
NODE_6536_length_1004_cov_45.470718	343	423	16	22	80	0.2750000
NODE_6536_length_1004_cov_45.470718	343	423	17	14	80	0.1750000
NODE_6536_length_1004_cov_45.470718	343	423	18	4	80	0.0500000
NODE_6536_length_1004_cov_45.470718	343	423	19	8	80	0.1000000
NODE_6536_length_1004_cov_45.470718	396	476	10	1	80	0.0125000
NODE_6536_length_1004_cov_45.470718	396	476	11	4	80	0.0500000
NODE_6536_length_1004_cov_45.470718	396	476	12	1	80	0.0125000
NODE_6536_length_1004_cov_45.470718	396	476	13	1	80	0.0125000
NODE_6536_length_1004_cov_45.470718	396	476	15	8	80	0.1000000
NODE_6536_length_1004_cov_45.470718	396	476	16	2	80	0.0250000
NODE_6536_length_1004_cov_45.470718	396	476	17	34	80	0.4250000
NODE_6536_length_1004_cov_45.470718	396	476	18	4	80	0.0500000
NODE_6536_length_1004_cov_45.470718	396	476	19	8	80	0.1000000
NODE_6536_length_1004_cov_45.470718	396	476	22	13	80	0.1625000
NODE_6536_length_1004_cov_45.470718	396	476	23	4	80	0.0500000
NODE_6536_length_1004_cov_45.470718	472	552	21	4	80	0.0500000
NODE_6536_length_1004_cov_45.470718	472	552	22	15	80	0.1875000
NODE_6536_length_1004_cov_45.470718	472	552	23	45	80	0.5625000
NODE_6536_length_1004_cov_45.470718	472	552	24	16	80	0.2000000
NODE_6536_length_1004_cov_45.470718	525	605	16	4	80	0.0500000
NODE_6536_length_1004_cov_45.470718	525	605	20	2	80	0.0250000
NODE_6536_length_1004_cov_45.470718	525	605	21	11	80	0.1375000
NODE_6536_length_1004_cov_45.470718	525	605	22	7	80	0.0875000
NODE_6536_length_1004_cov_45.470718	525	605	23	47	80	0.5875000
NODE_6536_length_1004_cov_45.470718	525	605	24	9	80	0.1125000
NODE_6537_length_1004_cov_34.565746	419	499	13	12	80	0.1500000
NODE_6537_length_1004_cov_34.565746	419	499	15	3	80	0.0375000
NODE_6537_length_1004_cov_34.565746	419	499	16	9	80	0.1125000
NODE_6537_length_1004_cov_34.565746	419	499	17	51	80	0.6375000
NODE_6537_length_1004_cov_34.565746	419	499	19	5	80	0.0625000
NODE_6537_length_1004_cov_34.565746	472	552	11	21	80	0.2625000
NODE_6537_length_1004_cov_34.565746	472	552	12	21	80	0.2625000
NODE_6537_length_1004_cov_34.565746	472	552	13	3	80	0.0375000
NODE_6537_length_1004_cov_34.565746	472	552	16	17	80	0.2125000
NODE_6537_length_1004_cov_34.565746	472	552	17	16	80	0.2000000
NODE_6537_length_1004_cov_34.565746	472	552	19	2	80	0.0250000
NODE_6538_length_1004_cov_28.710497	385	465	8	11	80	0.1375000
NODE_6538_length_1004_cov_28.710497	385	465	9	48	80	0.6000000
NODE_6538_length_1004_cov_28.710497	385	465	10	21	80	0.2625000
NODE_6538_length_1004_cov_28.710497	438	518	8	3	80	0.0375000
NODE_6538_length_1004_cov_28.710497	438	518	9	46	80	0.5750000
NODE_6538_length_1004_cov_28.710497	438	518	10	23	80	0.2875000
NODE_6538_length_1004_cov_28.710497	438	518	11	8	80	0.1000000
NODE_6538_length_1004_cov_28.710497	514	594	5	35	80	0.4375000
NODE_6538_length_1004_cov_28.710497	514	594	6	33	80	0.4125000
NODE_6538_length_1004_cov_28.710497	514	594	7	8	80	0.1000000
NODE_6538_length_1004_cov_28.710497	514	594	8	3	80	0.0375000
NODE_6538_length_1004_cov_28.710497	514	594	9	1	80	0.0125000
NODE_6538_length_1004_cov_28.710497	567	647	3	6	80	0.0750000
NODE_6538_length_1004_cov_28.710497	567	647	4	5	80	0.0625000
NODE_6538_length_1004_cov_28.710497	567	647	5	42	80	0.5250000
NODE_6538_length_1004_cov_28.710497	567	647	6	27	80	0.3375000
NODE_6539_length_1004_cov_12.745856	432	512	7	1	80	0.0125000
NODE_6539_length_1004_cov_12.745856	432	512	8	4	80	0.0500000
NODE_6539_length_1004_cov_12.745856	432	512	9	6	80	0.0750000
NODE_6539_length_1004_cov_12.745856	432	512	11	16	80	0.2000000
NODE_6539_length_1004_cov_12.745856	432	512	13	11	80	0.1375000
NODE_6539_length_1004_cov_12.745856	432	512	14	12	80	0.1500000
NODE_6539_length_1004_cov_12.745856	432	512	15	20	80	0.2500000
NODE_6539_length_1004_cov_12.745856	432	512	16	10	80	0.1250000
NODE_6539_length_1004_cov_12.745856	485	565	14	4	80	0.0500000
NODE_6539_length_1004_cov_12.745856	485	565	15	13	80	0.1625000
NODE_6539_length_1004_cov_12.745856	485	565	16	49	80	0.6125000
NODE_6539_length_1004_cov_12.745856	485	565	17	6	80	0.0750000
NODE_6539_length_1004_cov_12.745856	485	565	18	6	80	0.0750000
NODE_6539_length_1004_cov_12.745856	485	565	19	2	80	0.0250000
NODE_6550_length_1003_cov_47.014381	383	463	3	28	80	0.3500000
NODE_6550_length_1003_cov_47.014381	383	463	9	10	80	0.1250000
NODE_6550_length_1003_cov_47.014381	383	463	10	30	80	0.3750000
NODE_6550_length_1003_cov_47.014381	383	463	11	4	80	0.0500000
NODE_6550_length_1003_cov_47.014381	383	463	12	8	80	0.1000000
NODE_6550_length_1003_cov_47.014381	436	516	9	3	80	0.0375000
NODE_6550_length_1003_cov_47.014381	436	516	10	27	80	0.3375000
NODE_6550_length_1003_cov_47.014381	436	516	11	50	80	0.6250000
NODE_6550_length_1003_cov_47.014381	512	592	6	3	80	0.0375000
NODE_6550_length_1003_cov_47.014381	512	592	8	14	80	0.1750000
NODE_6550_length_1003_cov_47.014381	512	592	9	16	80	0.2000000
NODE_6550_length_1003_cov_47.014381	512	592	10	25	80	0.3125000
NODE_6550_length_1003_cov_47.014381	512	592	11	16	80	0.2000000
NODE_6550_length_1003_cov_47.014381	512	592	12	6	80	0.0750000
NODE_6550_length_1003_cov_47.014381	565	645	6	1	80	0.0125000
NODE_6550_length_1003_cov_47.014381	565	645	9	42	80	0.5250000
NODE_6550_length_1003_cov_47.014381	565	645	10	30	80	0.3750000
NODE_6550_length_1003_cov_47.014381	565	645	11	7	80	0.0875000
NODE_6551_length_1003_cov_35.329646	372	452	15	7	80	0.0875000
NODE_6551_length_1003_cov_35.329646	372	452	16	6	80	0.0750000
NODE_6551_length_1003_cov_35.329646	372	452	17	4	80	0.0500000
NODE_6551_length_1003_cov_35.329646	372	452	20	3	80	0.0375000
NODE_6551_length_1003_cov_35.329646	372	452	24	44	80	0.5500000
NODE_6551_length_1003_cov_35.329646	372	452	25	4	80	0.0500000
NODE_6551_length_1003_cov_35.329646	372	452	26	12	80	0.1500000
NODE_6551_length_1003_cov_35.329646	425	505	24	15	80	0.1875000
NODE_6551_length_1003_cov_35.329646	425	505	25	1	80	0.0125000
NODE_6551_length_1003_cov_35.329646	425	505	26	19	80	0.2375000
NODE_6551_length_1003_cov_35.329646	425	505	28	14	80	0.1750000
NODE_6551_length_1003_cov_35.329646	425	505	29	7	80	0.0875000
NODE_6551_length_1003_cov_35.329646	425	505	30	5	80	0.0625000
NODE_6551_length_1003_cov_35.329646	425	505	32	19	80	0.2375000
NODE_6552_length_1003_cov_32.721239	357	437	13	46	80	0.5750000
NODE_6552_length_1003_cov_32.721239	357	437	14	23	80	0.2875000
NODE_6552_length_1003_cov_32.721239	357	437	15	11	80	0.1375000
NODE_6552_length_1003_cov_32.721239	410	490	12	10	80	0.1250000
NODE_6552_length_1003_cov_32.721239	410	490	13	22	80	0.2750000
NODE_6552_length_1003_cov_32.721239	410	490	14	9	80	0.1125000
NODE_6552_length_1003_cov_32.721239	410	490	15	15	80	0.1875000
NODE_6552_length_1003_cov_32.721239	410	490	16	7	80	0.0875000
NODE_6552_length_1003_cov_32.721239	410	490	17	2	80	0.0250000
NODE_6552_length_1003_cov_32.721239	410	490	18	10	80	0.1250000
NODE_6552_length_1003_cov_32.721239	410	490	19	5	80	0.0625000
NODE_6553_length_1003_cov_23.758850	467	547	0	80	80	1.0000000
NODE_6553_length_1003_cov_23.758850	520	600	0	80	80	1.0000000
NODE_6554_length_1003_cov_19.939159	240	320	16	4	80	0.0500000
NODE_6554_length_1003_cov_19.939159	240	320	17	10	80	0.1250000
NODE_6554_length_1003_cov_19.939159	240	320	18	14	80	0.1750000
NODE_6554_length_1003_cov_19.939159	240	320	20	52	80	0.6500000
NODE_6554_length_1003_cov_19.939159	293	373	9	18	80	0.2250000
NODE_6554_length_1003_cov_19.939159	293	373	10	2	80	0.0250000
NODE_6554_length_1003_cov_19.939159	293	373	12	5	80	0.0625000
NODE_6554_length_1003_cov_19.939159	293	373	14	15	80	0.1875000
NODE_6554_length_1003_cov_19.939159	293	373	15	3	80	0.0375000
NODE_6554_length_1003_cov_19.939159	293	373	16	4	80	0.0500000
NODE_6554_length_1003_cov_19.939159	293	373	17	19	80	0.2375000
NODE_6554_length_1003_cov_19.939159	293	373	20	14	80	0.1750000
NODE_6555_length_1003_cov_16.618363	524	604	0	63	80	0.7875000
NODE_6555_length_1003_cov_16.618363	524	604	1	1	80	0.0125000
NODE_6555_length_1003_cov_16.618363	524	604	2	16	80	0.2000000
NODE_6555_length_1003_cov_16.618363	577	657	0	10	80	0.1250000
NODE_6555_length_1003_cov_16.618363	577	657	1	1	80	0.0125000
NODE_6555_length_1003_cov_16.618363	577	657	2	26	80	0.3250000
NODE_6555_length_1003_cov_16.618363	577	657	4	8	80	0.1000000
NODE_6555_length_1003_cov_16.618363	577	657	6	3	80	0.0375000
NODE_6555_length_1003_cov_16.618363	577	657	8	2	80	0.0250000
NODE_6555_length_1003_cov_16.618363	577	657	10	30	80	0.3750000
NODE_6555_length_1003_cov_16.618363	653	733	10	46	80	0.5750000
NODE_6555_length_1003_cov_16.618363	653	733	12	28	80	0.3500000
NODE_6555_length_1003_cov_16.618363	653	733	14	6	80	0.0750000
NODE_6555_length_1003_cov_16.618363	706	786	6	9	80	0.1125000
NODE_6555_length_1003_cov_16.618363	706	786	8	2	80	0.0250000
NODE_6555_length_1003_cov_16.618363	706	786	10	10	80	0.1250000
NODE_6555_length_1003_cov_16.618363	706	786	11	2	80	0.0250000
NODE_6555_length_1003_cov_16.618363	706	786	12	51	80	0.6375000
NODE_6555_length_1003_cov_16.618363	706	786	14	6	80	0.0750000
NODE_6556_length_1003_cov_13.863938	537	617	11	17	80	0.2125000
NODE_6556_length_1003_cov_13.863938	537	617	16	7	80	0.0875000
NODE_6556_length_1003_cov_13.863938	537	617	17	24	80	0.3000000
NODE_6556_length_1003_cov_13.863938	537	617	18	32	80	0.4000000
NODE_6556_length_1003_cov_13.863938	590	670	0	7	80	0.0875000
NODE_6556_length_1003_cov_13.863938	590	670	3	6	80	0.0750000
NODE_6556_length_1003_cov_13.863938	590	670	8	31	80	0.3875000
NODE_6556_length_1003_cov_13.863938	590	670	10	6	80	0.0750000
NODE_6556_length_1003_cov_13.863938	590	670	11	20	80	0.2500000
NODE_6556_length_1003_cov_13.863938	590	670	16	7	80	0.0875000
NODE_6556_length_1003_cov_13.863938	590	670	17	3	80	0.0375000
NODE_6557_length_1003_cov_12.363938	529	609	6	9	80	0.1125000
NODE_6557_length_1003_cov_12.363938	529	609	7	9	80	0.1125000
NODE_6557_length_1003_cov_12.363938	529	609	9	14	80	0.1750000
NODE_6557_length_1003_cov_12.363938	529	609	10	20	80	0.2500000
NODE_6557_length_1003_cov_12.363938	529	609	11	28	80	0.3500000
NODE_6557_length_1003_cov_12.363938	582	662	9	10	80	0.1250000
NODE_6557_length_1003_cov_12.363938	582	662	10	49	80	0.6125000
NODE_6557_length_1003_cov_12.363938	582	662	11	21	80	0.2625000
NODE_6567_length_1002_cov_65.513843	387	467	24	4	80	0.0500000
NODE_6567_length_1002_cov_65.513843	387	467	25	5	80	0.0625000
NODE_6567_length_1002_cov_65.513843	387	467	27	7	80	0.0875000
NODE_6567_length_1002_cov_65.513843	387	467	28	3	80	0.0375000
NODE_6567_length_1002_cov_65.513843	387	467	30	7	80	0.0875000
NODE_6567_length_1002_cov_65.513843	387	467	31	28	80	0.3500000
NODE_6567_length_1002_cov_65.513843	387	467	32	12	80	0.1500000
NODE_6567_length_1002_cov_65.513843	387	467	33	2	80	0.0250000
NODE_6567_length_1002_cov_65.513843	387	467	34	2	80	0.0250000
NODE_6567_length_1002_cov_65.513843	387	467	35	4	80	0.0500000
NODE_6567_length_1002_cov_65.513843	387	467	36	1	80	0.0125000
NODE_6567_length_1002_cov_65.513843	387	467	37	5	80	0.0625000
NODE_6567_length_1002_cov_65.513843	440	520	31	1	80	0.0125000
NODE_6567_length_1002_cov_65.513843	440	520	32	21	80	0.2625000
NODE_6567_length_1002_cov_65.513843	440	520	33	10	80	0.1250000
NODE_6567_length_1002_cov_65.513843	440	520	34	9	80	0.1125000
NODE_6567_length_1002_cov_65.513843	440	520	35	7	80	0.0875000
NODE_6567_length_1002_cov_65.513843	440	520	36	2	80	0.0250000
NODE_6567_length_1002_cov_65.513843	440	520	37	11	80	0.1375000
NODE_6567_length_1002_cov_65.513843	440	520	38	9	80	0.1125000
NODE_6567_length_1002_cov_65.513843	440	520	39	7	80	0.0875000
NODE_6567_length_1002_cov_65.513843	440	520	40	1	80	0.0125000
NODE_6567_length_1002_cov_65.513843	440	520	41	2	80	0.0250000
NODE_6567_length_1002_cov_65.513843	516	596	28	7	80	0.0875000
NODE_6567_length_1002_cov_65.513843	516	596	29	26	80	0.3250000
NODE_6567_length_1002_cov_65.513843	516	596	30	7	80	0.0875000
NODE_6567_length_1002_cov_65.513843	516	596	31	10	80	0.1250000
NODE_6567_length_1002_cov_65.513843	516	596	32	5	80	0.0625000
NODE_6567_length_1002_cov_65.513843	516	596	33	10	80	0.1250000
NODE_6567_length_1002_cov_65.513843	516	596	37	1	80	0.0125000
NODE_6567_length_1002_cov_65.513843	516	596	38	14	80	0.1750000
NODE_6567_length_1002_cov_65.513843	569	649	15	10	80	0.1250000
NODE_6567_length_1002_cov_65.513843	569	649	16	1	80	0.0125000
NODE_6567_length_1002_cov_65.513843	569	649	20	2	80	0.0250000
NODE_6567_length_1002_cov_65.513843	569	649	21	6	80	0.0750000
NODE_6567_length_1002_cov_65.513843	569	649	22	1	80	0.0125000
NODE_6567_length_1002_cov_65.513843	569	649	23	16	80	0.2000000
NODE_6567_length_1002_cov_65.513843	569	649	25	4	80	0.0500000
NODE_6567_length_1002_cov_65.513843	569	649	26	5	80	0.0625000
NODE_6567_length_1002_cov_65.513843	569	649	27	1	80	0.0125000
NODE_6567_length_1002_cov_65.513843	569	649	29	20	80	0.2500000
NODE_6567_length_1002_cov_65.513843	569	649	30	3	80	0.0375000
NODE_6567_length_1002_cov_65.513843	569	649	31	11	80	0.1375000
NODE_6568_length_1002_cov_41.995570	408	488	16	7	80	0.0875000
NODE_6568_length_1002_cov_41.995570	408	488	17	14	80	0.1750000
NODE_6568_length_1002_cov_41.995570	408	488	18	8	80	0.1000000
NODE_6568_length_1002_cov_41.995570	408	488	19	51	80	0.6375000
NODE_6568_length_1002_cov_41.995570	461	541	9	15	80	0.1875000
NODE_6568_length_1002_cov_41.995570	461	541	11	10	80	0.1250000
NODE_6568_length_1002_cov_41.995570	461	541	13	15	80	0.1875000
NODE_6568_length_1002_cov_41.995570	461	541	14	5	80	0.0625000
NODE_6568_length_1002_cov_41.995570	461	541	15	3	80	0.0375000
NODE_6568_length_1002_cov_41.995570	461	541	16	2	80	0.0250000
NODE_6568_length_1002_cov_41.995570	461	541	17	18	80	0.2250000
NODE_6568_length_1002_cov_41.995570	461	541	18	7	80	0.0875000
NODE_6568_length_1002_cov_41.995570	461	541	19	5	80	0.0625000
NODE_6569_length_1002_cov_19.966777	401	481	11	14	80	0.1750000
NODE_6569_length_1002_cov_19.966777	401	481	12	1	80	0.0125000
NODE_6569_length_1002_cov_19.966777	401	481	13	17	80	0.2125000
NODE_6569_length_1002_cov_19.966777	401	481	14	48	80	0.6000000
NODE_6569_length_1002_cov_19.966777	454	534	6	10	80	0.1250000
NODE_6569_length_1002_cov_19.966777	454	534	7	4	80	0.0500000
NODE_6569_length_1002_cov_19.966777	454	534	8	13	80	0.1625000
NODE_6569_length_1002_cov_19.966777	454	534	9	14	80	0.1750000
NODE_6569_length_1002_cov_19.966777	454	534	10	4	80	0.0500000
NODE_6569_length_1002_cov_19.966777	454	534	11	6	80	0.0750000
NODE_6569_length_1002_cov_19.966777	454	534	12	1	80	0.0125000
NODE_6569_length_1002_cov_19.966777	454	534	14	28	80	0.3500000
NODE_6570_length_1002_cov_19.539313	334	414	3	9	80	0.1125000
NODE_6570_length_1002_cov_19.539313	334	414	4	71	80	0.8875000
NODE_6570_length_1002_cov_19.539313	335	414	3	9	79	0.1139240
NODE_6570_length_1002_cov_19.539313	335	414	4	70	79	0.8860760
NODE_6570_length_1002_cov_19.539313	387	467	2	6	80	0.0750000
NODE_6570_length_1002_cov_19.539313	387	467	3	49	80	0.6125000
NODE_6570_length_1002_cov_19.539313	387	467	4	25	80	0.3125000
NODE_6570_length_1002_cov_19.539313	387	467	2	6	80	0.0750000
NODE_6570_length_1002_cov_19.539313	387	467	3	49	80	0.6125000
NODE_6570_length_1002_cov_19.539313	387	467	4	25	80	0.3125000
NODE_6570_length_1002_cov_19.539313	396	467	2	6	71	0.0845070
NODE_6570_length_1002_cov_19.539313	396	467	3	49	71	0.6901408
NODE_6570_length_1002_cov_19.539313	396	467	4	16	71	0.2253521
NODE_6570_length_1002_cov_19.539313	463	543	2	6	80	0.0750000
NODE_6570_length_1002_cov_19.539313	463	543	3	9	80	0.1125000
NODE_6570_length_1002_cov_19.539313	463	543	4	21	80	0.2625000
NODE_6570_length_1002_cov_19.539313	463	543	6	1	80	0.0125000
NODE_6570_length_1002_cov_19.539313	463	543	7	43	80	0.5375000
NODE_6570_length_1002_cov_19.539313	516	596	7	65	80	0.8125000
NODE_6570_length_1002_cov_19.539313	516	596	8	1	80	0.0125000
NODE_6570_length_1002_cov_19.539313	516	596	9	14	80	0.1750000
NODE_6571_length_1002_cov_17.780731	631	711	3	26	80	0.3250000
NODE_6571_length_1002_cov_17.780731	631	711	5	9	80	0.1125000
NODE_6571_length_1002_cov_17.780731	631	711	7	26	80	0.3250000
NODE_6571_length_1002_cov_17.780731	631	711	8	19	80	0.2375000
NODE_6571_length_1002_cov_17.780731	684	764	7	21	80	0.2625000
NODE_6571_length_1002_cov_17.780731	684	764	8	27	80	0.3375000
NODE_6571_length_1002_cov_17.780731	684	764	9	8	80	0.1000000
NODE_6571_length_1002_cov_17.780731	684	764	10	24	80	0.3000000
NODE_6572_length_1002_cov_17.590255	0	58	0	58	58	1.0000000
NODE_6572_length_1002_cov_17.590255	31	77	0	46	46	1.0000000
NODE_6573_length_1002_cov_17.105205	522	602	1	80	80	1.0000000
NODE_6573_length_1002_cov_17.105205	575	655	0	12	80	0.1500000
NODE_6573_length_1002_cov_17.105205	575	655	1	68	80	0.8500000
NODE_6574_length_1002_cov_11.954596	480	560	10	24	80	0.3000000
NODE_6574_length_1002_cov_11.954596	480	560	11	30	80	0.3750000
NODE_6574_length_1002_cov_11.954596	480	560	12	26	80	0.3250000
NODE_6574_length_1002_cov_11.954596	533	613	6	11	80	0.1375000
NODE_6574_length_1002_cov_11.954596	533	613	7	15	80	0.1875000
NODE_6574_length_1002_cov_11.954596	533	613	8	5	80	0.0625000
NODE_6574_length_1002_cov_11.954596	533	613	9	14	80	0.1750000
NODE_6574_length_1002_cov_11.954596	533	613	11	16	80	0.2000000
NODE_6574_length_1002_cov_11.954596	533	613	12	19	80	0.2375000
NODE_6575_length_1002_cov_11.823920	471	551	0	80	80	1.0000000
NODE_6575_length_1002_cov_11.823920	524	614	0	90	90	1.0000000
NODE_6577_length_1002_cov_6.596899	422	502	2	18	80	0.2250000
NODE_6577_length_1002_cov_6.596899	422	502	3	1	80	0.0125000
NODE_6577_length_1002_cov_6.596899	422	502	4	61	80	0.7625000
NODE_6577_length_1002_cov_6.596899	475	555	2	25	80	0.3125000
NODE_6577_length_1002_cov_6.596899	475	555	3	1	80	0.0125000
NODE_6577_length_1002_cov_6.596899	475	555	4	54	80	0.6750000
NODE_6588_length_1002_cov_2.102990	29	110	0	81	81	1.0000000
NODE_6596_length_1001_cov_41.914634	549	629	1	18	80	0.2250000
NODE_6596_length_1001_cov_41.914634	549	629	2	1	80	0.0125000
NODE_6596_length_1001_cov_41.914634	549	629	3	30	80	0.3750000
NODE_6596_length_1001_cov_41.914634	549	629	4	31	80	0.3875000
NODE_6596_length_1001_cov_41.914634	602	682	4	80	80	1.0000000
NODE_6597_length_1001_cov_30.378049	306	386	2	69	80	0.8625000
NODE_6597_length_1001_cov_30.378049	306	386	3	11	80	0.1375000
NODE_6597_length_1001_cov_30.378049	359	439	2	72	80	0.9000000
NODE_6597_length_1001_cov_30.378049	359	439	3	8	80	0.1000000
NODE_6597_length_1001_cov_30.378049	369	439	2	62	70	0.8857143
NODE_6597_length_1001_cov_30.378049	369	439	3	8	70	0.1142857
NODE_6597_length_1001_cov_30.378049	435	515	1	18	80	0.2250000
NODE_6597_length_1001_cov_30.378049	435	515	2	4	80	0.0500000
NODE_6597_length_1001_cov_30.378049	435	515	3	25	80	0.3125000
NODE_6597_length_1001_cov_30.378049	435	515	4	2	80	0.0250000
NODE_6597_length_1001_cov_30.378049	435	515	5	23	80	0.2875000
NODE_6597_length_1001_cov_30.378049	435	515	7	8	80	0.1000000
NODE_6597_length_1001_cov_30.378049	488	568	5	19	80	0.2375000
NODE_6597_length_1001_cov_30.378049	488	568	7	24	80	0.3000000
NODE_6597_length_1001_cov_30.378049	488	568	9	37	80	0.4625000
NODE_6598_length_1001_cov_22.517738	536	616	5	65	80	0.8125000
NODE_6598_length_1001_cov_22.517738	536	616	8	15	80	0.1875000
NODE_6598_length_1001_cov_22.517738	589	670	3	7	81	0.0864198
NODE_6598_length_1001_cov_22.517738	589	670	4	17	81	0.2098765
NODE_6598_length_1001_cov_22.517738	589	670	5	57	81	0.7037037
NODE_6599_length_1001_cov_17.996674	414	456	0	32	42	0.7619048
NODE_6599_length_1001_cov_17.996674	414	456	1	10	42	0.2380952
NODE_6599_length_1001_cov_17.996674	429	509	0	17	80	0.2125000
NODE_6599_length_1001_cov_17.996674	429	509	1	28	80	0.3500000
NODE_6599_length_1001_cov_17.996674	429	509	2	35	80	0.4375000
NODE_6599_length_1001_cov_17.996674	505	585	2	10	80	0.1250000
NODE_6599_length_1001_cov_17.996674	505	585	3	8	80	0.1000000
NODE_6599_length_1001_cov_17.996674	505	585	5	26	80	0.3250000
NODE_6599_length_1001_cov_17.996674	505	585	6	36	80	0.4500000
NODE_6599_length_1001_cov_17.996674	558	638	4	14	80	0.1750000
NODE_6599_length_1001_cov_17.996674	558	638	5	28	80	0.3500000
NODE_6599_length_1001_cov_17.996674	558	638	6	38	80	0.4750000
NODE_6600_length_1001_cov_16.798226	422	502	6	8	80	0.1000000
NODE_6600_length_1001_cov_16.798226	422	502	7	14	80	0.1750000
NODE_6600_length_1001_cov_16.798226	422	502	8	41	80	0.5125000
NODE_6600_length_1001_cov_16.798226	422	502	9	17	80	0.2125000
NODE_6600_length_1001_cov_16.798226	475	555	4	16	80	0.2000000
NODE_6600_length_1001_cov_16.798226	475	555	5	17	80	0.2125000
NODE_6600_length_1001_cov_16.798226	475	555	6	14	80	0.1750000
NODE_6600_length_1001_cov_16.798226	475	555	7	6	80	0.0750000
NODE_6600_length_1001_cov_16.798226	475	555	8	7	80	0.0875000
NODE_6600_length_1001_cov_16.798226	475	555	9	20	80	0.2500000
NODE_6600_length_1001_cov_16.798226	551	631	2	21	80	0.2625000
NODE_6600_length_1001_cov_16.798226	551	631	3	10	80	0.1250000
NODE_6600_length_1001_cov_16.798226	551	631	4	49	80	0.6125000
NODE_6600_length_1001_cov_16.798226	604	684	0	47	80	0.5875000
NODE_6600_length_1001_cov_16.798226	604	684	2	27	80	0.3375000
NODE_6600_length_1001_cov_16.798226	604	684	4	6	80	0.0750000
NODE_6601_length_1001_cov_12.778271	348	428	0	55	80	0.6875000
NODE_6601_length_1001_cov_12.778271	348	428	2	25	80	0.3125000
NODE_6601_length_1001_cov_12.778271	401	481	0	2	80	0.0250000
NODE_6601_length_1001_cov_12.778271	401	481	2	78	80	0.9750000
NODE_6602_length_1001_cov_12.305987	255	335	0	80	80	1.0000000
NODE_6602_length_1001_cov_12.305987	308	388	0	80	80	1.0000000
NODE_6603_length_1001_cov_11.955654	485	569	2	48	84	0.5714286
NODE_6603_length_1001_cov_11.955654	485	569	3	34	84	0.4047619
NODE_6603_length_1001_cov_11.955654	485	569	4	2	84	0.0238095
NODE_6603_length_1001_cov_11.955654	542	622	3	58	80	0.7250000
NODE_6603_length_1001_cov_11.955654	542	622	4	22	80	0.2750000
NODE_6604_length_1001_cov_10.156319	587	667	0	15	80	0.1875000
NODE_6604_length_1001_cov_10.156319	587	667	1	35	80	0.4375000
NODE_6604_length_1001_cov_10.156319	587	667	3	30	80	0.3750000
NODE_6604_length_1001_cov_10.156319	640	720	3	44	80	0.5500000
NODE_6604_length_1001_cov_10.156319	640	720	5	6	80	0.0750000
NODE_6604_length_1001_cov_10.156319	640	720	6	30	80	0.3750000
NODE_6605_length_1001_cov_9.754989	377	457	5	4	80	0.0500000
NODE_6605_length_1001_cov_9.754989	377	457	6	18	80	0.2250000
NODE_6605_length_1001_cov_9.754989	377	457	7	57	80	0.7125000
NODE_6605_length_1001_cov_9.754989	377	457	8	1	80	0.0125000
NODE_6605_length_1001_cov_9.754989	430	510	5	4	80	0.0500000
NODE_6605_length_1001_cov_9.754989	430	510	6	34	80	0.4250000
NODE_6605_length_1001_cov_9.754989	430	510	7	28	80	0.3500000
NODE_6605_length_1001_cov_9.754989	430	510	8	14	80	0.1750000
NODE_6607_length_1001_cov_4.616408	408	488	0	80	80	1.0000000
NODE_6607_length_1001_cov_4.616408	461	541	0	80	80	1.0000000
NODE_6616_length_1000_cov_55.578246	393	473	3	5	80	0.0625000
NODE_6616_length_1000_cov_55.578246	393	473	5	1	80	0.0125000
NODE_6616_length_1000_cov_55.578246	393	473	6	23	80	0.2875000
NODE_6616_length_1000_cov_55.578246	393	473	9	4	80	0.0500000
NODE_6616_length_1000_cov_55.578246	393	473	10	19	80	0.2375000
NODE_6616_length_1000_cov_55.578246	393	473	11	11	80	0.1375000
NODE_6616_length_1000_cov_55.578246	393	473	12	17	80	0.2125000
NODE_6616_length_1000_cov_55.578246	446	526	9	4	80	0.0500000
NODE_6616_length_1000_cov_55.578246	446	526	10	40	80	0.5000000
NODE_6616_length_1000_cov_55.578246	446	526	11	18	80	0.2250000
NODE_6616_length_1000_cov_55.578246	446	526	12	17	80	0.2125000
NODE_6616_length_1000_cov_55.578246	446	526	15	1	80	0.0125000
NODE_6616_length_1000_cov_55.578246	522	598	11	3	76	0.0394737
NODE_6616_length_1000_cov_55.578246	522	598	12	7	76	0.0921053
NODE_6616_length_1000_cov_55.578246	522	598	13	17	76	0.2236842
NODE_6616_length_1000_cov_55.578246	522	598	14	1	76	0.0131579
NODE_6616_length_1000_cov_55.578246	522	598	15	4	76	0.0526316
NODE_6616_length_1000_cov_55.578246	522	598	16	15	76	0.1973684
NODE_6616_length_1000_cov_55.578246	522	598	17	17	76	0.2236842
NODE_6616_length_1000_cov_55.578246	522	598	18	12	76	0.1578947
NODE_6616_length_1000_cov_55.578246	575	649	11	9	74	0.1216216
NODE_6616_length_1000_cov_55.578246	575	649	12	28	74	0.3783784
NODE_6616_length_1000_cov_55.578246	575	649	13	20	74	0.2702703
NODE_6616_length_1000_cov_55.578246	575	649	14	9	74	0.1216216
NODE_6616_length_1000_cov_55.578246	575	649	15	8	74	0.1081081
NODE_6617_length_1000_cov_51.534961	432	512	1	75	80	0.9375000
NODE_6617_length_1000_cov_51.534961	432	512	4	5	80	0.0625000
NODE_6617_length_1000_cov_51.534961	485	565	1	22	80	0.2750000
NODE_6617_length_1000_cov_51.534961	485	565	3	18	80	0.2250000
NODE_6617_length_1000_cov_51.534961	485	565	4	40	80	0.5000000
NODE_6617_length_1000_cov_51.534961	561	641	3	26	80	0.3250000
NODE_6617_length_1000_cov_51.534961	561	641	4	54	80	0.6750000
NODE_6617_length_1000_cov_51.534961	614	694	0	37	80	0.4625000
NODE_6617_length_1000_cov_51.534961	614	694	4	43	80	0.5375000
NODE_6618_length_1000_cov_39.011099	186	266	20	8	80	0.1000000
NODE_6618_length_1000_cov_39.011099	186	266	21	5	80	0.0625000
NODE_6618_length_1000_cov_39.011099	186	266	23	25	80	0.3125000
NODE_6618_length_1000_cov_39.011099	186	266	24	3	80	0.0375000
NODE_6618_length_1000_cov_39.011099	186	266	25	4	80	0.0500000
NODE_6618_length_1000_cov_39.011099	186	266	26	12	80	0.1500000
NODE_6618_length_1000_cov_39.011099	186	266	28	14	80	0.1750000
NODE_6618_length_1000_cov_39.011099	186	266	29	9	80	0.1125000
NODE_6618_length_1000_cov_39.011099	239	319	16	2	80	0.0250000
NODE_6618_length_1000_cov_39.011099	239	319	18	2	80	0.0250000
NODE_6618_length_1000_cov_39.011099	239	319	20	7	80	0.0875000
NODE_6618_length_1000_cov_39.011099	239	319	22	20	80	0.2500000
NODE_6618_length_1000_cov_39.011099	239	319	25	24	80	0.3000000
NODE_6618_length_1000_cov_39.011099	239	319	26	4	80	0.0500000
NODE_6618_length_1000_cov_39.011099	239	319	28	12	80	0.1500000
NODE_6618_length_1000_cov_39.011099	239	319	29	9	80	0.1125000
NODE_6619_length_1000_cov_19.897891	451	531	5	13	80	0.1625000
NODE_6619_length_1000_cov_19.897891	451	531	6	30	80	0.3750000
NODE_6619_length_1000_cov_19.897891	451	531	7	3	80	0.0375000
NODE_6619_length_1000_cov_19.897891	451	531	8	17	80	0.2125000
NODE_6619_length_1000_cov_19.897891	451	531	9	17	80	0.2125000
NODE_6619_length_1000_cov_19.897891	504	584	8	10	80	0.1250000
NODE_6619_length_1000_cov_19.897891	504	584	9	21	80	0.2625000
NODE_6619_length_1000_cov_19.897891	504	584	11	48	80	0.6000000
NODE_6619_length_1000_cov_19.897891	504	584	12	1	80	0.0125000
NODE_6619_length_1000_cov_19.897891	580	660	5	3	80	0.0375000
NODE_6619_length_1000_cov_19.897891	580	660	6	10	80	0.1250000
NODE_6619_length_1000_cov_19.897891	580	660	7	18	80	0.2250000
NODE_6619_length_1000_cov_19.897891	580	660	8	31	80	0.3875000
NODE_6619_length_1000_cov_19.897891	580	660	10	12	80	0.1500000
NODE_6619_length_1000_cov_19.897891	580	660	11	6	80	0.0750000
NODE_6619_length_1000_cov_19.897891	633	713	1	28	80	0.3500000
NODE_6619_length_1000_cov_19.897891	633	713	4	8	80	0.1000000
NODE_6619_length_1000_cov_19.897891	633	713	5	20	80	0.2500000
NODE_6619_length_1000_cov_19.897891	633	713	6	10	80	0.1250000
NODE_6619_length_1000_cov_19.897891	633	713	7	3	80	0.0375000
NODE_6619_length_1000_cov_19.897891	633	713	8	11	80	0.1375000
NODE_6620_length_1000_cov_13.349612	324	404	0	80	80	1.0000000
NODE_6620_length_1000_cov_13.349612	377	457	0	80	80	1.0000000
NODE_6621_length_1000_cov_11.463929	382	462	0	24	80	0.3000000
NODE_6621_length_1000_cov_11.463929	382	462	1	33	80	0.4125000
NODE_6621_length_1000_cov_11.463929	382	462	3	23	80	0.2875000
NODE_6621_length_1000_cov_11.463929	435	515	1	4	80	0.0500000
NODE_6621_length_1000_cov_11.463929	435	515	3	76	80	0.9500000
NODE_6622_length_1000_cov_9.675916	625	705	5	6	80	0.0750000
NODE_6622_length_1000_cov_9.675916	625	705	6	20	80	0.2500000
NODE_6622_length_1000_cov_9.675916	625	705	7	4	80	0.0500000
NODE_6622_length_1000_cov_9.675916	625	705	8	5	80	0.0625000
NODE_6622_length_1000_cov_9.675916	625	705	9	6	80	0.0750000
NODE_6622_length_1000_cov_9.675916	625	705	10	39	80	0.4875000
NODE_6622_length_1000_cov_9.675916	678	758	5	22	80	0.2750000
NODE_6622_length_1000_cov_9.675916	678	758	6	12	80	0.1500000
NODE_6622_length_1000_cov_9.675916	678	758	7	13	80	0.1625000
NODE_6622_length_1000_cov_9.675916	678	758	8	21	80	0.2625000
NODE_6622_length_1000_cov_9.675916	678	758	9	12	80	0.1500000
NODE_6623_length_1000_cov_7.051054	358	438	6	7	80	0.0875000
NODE_6623_length_1000_cov_7.051054	358	438	8	73	80	0.9125000
NODE_6623_length_1000_cov_7.051054	411	491	0	1	80	0.0125000
NODE_6623_length_1000_cov_7.051054	411	491	2	12	80	0.1500000
NODE_6623_length_1000_cov_7.051054	411	491	4	38	80	0.4750000
NODE_6623_length_1000_cov_7.051054	411	491	6	9	80	0.1125000
NODE_6623_length_1000_cov_7.051054	411	491	8	20	80	0.2500000
NODE_6626_length_1000_cov_3.652608	203	265	0	62	62	1.0000000
NODE_6639_length_999_cov_47.442222	604	684	20	10	80	0.1250000
NODE_6639_length_999_cov_47.442222	604	684	22	7	80	0.0875000
NODE_6639_length_999_cov_47.442222	604	684	24	1	80	0.0125000
NODE_6639_length_999_cov_47.442222	604	684	25	4	80	0.0500000
NODE_6639_length_999_cov_47.442222	604	684	26	11	80	0.1375000
NODE_6639_length_999_cov_47.442222	604	684	27	21	80	0.2625000
NODE_6639_length_999_cov_47.442222	604	684	31	4	80	0.0500000
NODE_6639_length_999_cov_47.442222	604	684	32	22	80	0.2750000
NODE_6639_length_999_cov_47.442222	657	723	11	3	66	0.0454545
NODE_6639_length_999_cov_47.442222	657	723	15	1	66	0.0151515
NODE_6639_length_999_cov_47.442222	657	723	17	11	66	0.1666667
NODE_6639_length_999_cov_47.442222	657	723	19	11	66	0.1666667
NODE_6639_length_999_cov_47.442222	657	723	20	23	66	0.3484848
NODE_6639_length_999_cov_47.442222	657	723	22	7	66	0.1060606
NODE_6639_length_999_cov_47.442222	657	723	24	1	66	0.0151515
NODE_6639_length_999_cov_47.442222	657	723	25	2	66	0.0303030
NODE_6639_length_999_cov_47.442222	657	723	26	2	66	0.0303030
NODE_6639_length_999_cov_47.442222	657	723	27	5	66	0.0757576
NODE_6640_length_999_cov_33.055556	458	540	1	33	82	0.4024390
NODE_6640_length_999_cov_33.055556	458	540	3	41	82	0.5000000
NODE_6640_length_999_cov_33.055556	458	540	4	8	82	0.0975610
NODE_6640_length_999_cov_33.055556	513	593	3	66	80	0.8250000
NODE_6640_length_999_cov_33.055556	513	593	4	14	80	0.1750000
NODE_6641_length_999_cov_22.755556	493	573	11	15	80	0.1875000
NODE_6641_length_999_cov_22.755556	493	573	15	65	80	0.8125000
NODE_6641_length_999_cov_22.755556	546	626	11	1	80	0.0125000
NODE_6641_length_999_cov_22.755556	546	626	12	34	80	0.4250000
NODE_6641_length_999_cov_22.755556	546	626	13	2	80	0.0250000
NODE_6641_length_999_cov_22.755556	546	626	14	1	80	0.0125000
NODE_6641_length_999_cov_22.755556	546	626	15	42	80	0.5250000
NODE_6642_length_999_cov_21.842222	359	439	10	77	80	0.9625000
NODE_6642_length_999_cov_21.842222	359	439	11	3	80	0.0375000
NODE_6642_length_999_cov_21.842222	412	492	9	10	80	0.1250000
NODE_6642_length_999_cov_21.842222	412	492	10	39	80	0.4875000
NODE_6642_length_999_cov_21.842222	412	492	11	14	80	0.1750000
NODE_6642_length_999_cov_21.842222	412	492	12	1	80	0.0125000
NODE_6642_length_999_cov_21.842222	412	492	13	16	80	0.2000000
NODE_6643_length_999_cov_20.006667	361	441	3	43	80	0.5375000
NODE_6643_length_999_cov_20.006667	361	441	4	6	80	0.0750000
NODE_6643_length_999_cov_20.006667	361	441	5	31	80	0.3875000
NODE_6643_length_999_cov_20.006667	414	494	3	21	80	0.2625000
NODE_6643_length_999_cov_20.006667	414	494	4	25	80	0.3125000
NODE_6643_length_999_cov_20.006667	414	494	6	34	80	0.4250000
NODE_6643_length_999_cov_20.006667	490	570	3	59	80	0.7375000
NODE_6643_length_999_cov_20.006667	490	570	4	18	80	0.2250000
NODE_6643_length_999_cov_20.006667	490	570	5	3	80	0.0375000
NODE_6643_length_999_cov_20.006667	543	623	2	30	80	0.3750000
NODE_6643_length_999_cov_20.006667	543	623	3	13	80	0.1625000
NODE_6643_length_999_cov_20.006667	543	623	4	19	80	0.2375000
NODE_6643_length_999_cov_20.006667	543	623	5	18	80	0.2250000
NODE_6645_length_999_cov_16.794444	438	518	0	5	80	0.0625000
NODE_6645_length_999_cov_16.794444	438	518	2	75	80	0.9375000
NODE_6645_length_999_cov_16.794444	491	571	0	58	80	0.7250000
NODE_6645_length_999_cov_16.794444	491	571	2	22	80	0.2750000
NODE_6646_length_999_cov_15.146667	464	544	7	10	80	0.1250000
NODE_6646_length_999_cov_15.146667	464	544	8	14	80	0.1750000
NODE_6646_length_999_cov_15.146667	464	544	9	4	80	0.0500000
NODE_6646_length_999_cov_15.146667	464	544	10	32	80	0.4000000
NODE_6646_length_999_cov_15.146667	464	544	11	20	80	0.2500000
NODE_6646_length_999_cov_15.146667	517	597	5	6	80	0.0750000
NODE_6646_length_999_cov_15.146667	517	597	7	57	80	0.7125000
NODE_6646_length_999_cov_15.146667	517	597	9	4	80	0.0500000
NODE_6646_length_999_cov_15.146667	517	597	10	13	80	0.1625000
NODE_6648_length_999_cov_8.771111	361	441	0	80	80	1.0000000
NODE_6648_length_999_cov_8.771111	414	492	0	78	78	1.0000000
NODE_6649_length_999_cov_5.171111	417	497	0	80	80	1.0000000
NODE_6649_length_999_cov_5.171111	470	550	0	80	80	1.0000000
NODE_6650_length_999_cov_2.854444	35	101	0	64	66	0.9696970
NODE_6650_length_999_cov_2.854444	35	101	1	2	66	0.0303030
NODE_6657_length_998_cov_30.697442	404	484	2	45	80	0.5625000
NODE_6657_length_998_cov_30.697442	404	484	3	35	80	0.4375000
NODE_6657_length_998_cov_30.697442	457	537	2	26	80	0.3250000
NODE_6657_length_998_cov_30.697442	457	537	3	38	80	0.4750000
NODE_6657_length_998_cov_30.697442	457	537	4	16	80	0.2000000
NODE_6657_length_998_cov_30.697442	533	613	3	12	80	0.1500000
NODE_6657_length_998_cov_30.697442	533	613	4	33	80	0.4125000
NODE_6657_length_998_cov_30.697442	533	613	5	1	80	0.0125000
NODE_6657_length_998_cov_30.697442	533	613	6	34	80	0.4250000
NODE_6657_length_998_cov_30.697442	586	666	3	27	80	0.3375000
NODE_6657_length_998_cov_30.697442	586	666	4	40	80	0.5000000
NODE_6657_length_998_cov_30.697442	586	666	6	13	80	0.1625000
NODE_6658_length_998_cov_23.703003	235	315	10	28	80	0.3500000
NODE_6658_length_998_cov_23.703003	235	315	11	18	80	0.2250000
NODE_6658_length_998_cov_23.703003	235	315	12	10	80	0.1250000
NODE_6658_length_998_cov_23.703003	235	315	13	1	80	0.0125000
NODE_6658_length_998_cov_23.703003	235	315	14	23	80	0.2875000
NODE_6658_length_998_cov_23.703003	288	368	11	29	80	0.3625000
NODE_6658_length_998_cov_23.703003	288	368	12	27	80	0.3375000
NODE_6658_length_998_cov_23.703003	288	368	13	1	80	0.0125000
NODE_6658_length_998_cov_23.703003	288	368	14	23	80	0.2875000
NODE_6659_length_998_cov_22.692992	531	611	3	1	80	0.0125000
NODE_6659_length_998_cov_22.692992	531	611	4	12	80	0.1500000
NODE_6659_length_998_cov_22.692992	531	611	6	1	80	0.0125000
NODE_6659_length_998_cov_22.692992	531	611	7	24	80	0.3000000
NODE_6659_length_998_cov_22.692992	531	611	8	32	80	0.4000000
NODE_6659_length_998_cov_22.692992	531	611	9	10	80	0.1250000
NODE_6659_length_998_cov_22.692992	584	664	5	7	80	0.0875000
NODE_6659_length_998_cov_22.692992	584	664	6	14	80	0.1750000
NODE_6659_length_998_cov_22.692992	584	664	7	39	80	0.4875000
NODE_6659_length_998_cov_22.692992	584	664	8	10	80	0.1250000
NODE_6659_length_998_cov_22.692992	584	664	9	10	80	0.1250000
NODE_6660_length_998_cov_11.152392	514	594	5	17	80	0.2125000
NODE_6660_length_998_cov_11.152392	514	594	6	14	80	0.1750000
NODE_6660_length_998_cov_11.152392	514	594	8	14	80	0.1750000
NODE_6660_length_998_cov_11.152392	514	594	10	4	80	0.0500000
NODE_6660_length_998_cov_11.152392	514	594	13	20	80	0.2500000
NODE_6660_length_998_cov_11.152392	514	594	14	11	80	0.1375000
NODE_6660_length_998_cov_11.152392	567	640	13	41	73	0.5616438
NODE_6660_length_998_cov_11.152392	567	640	14	14	73	0.1917808
NODE_6660_length_998_cov_11.152392	567	640	16	18	73	0.2465753
NODE_6660_length_998_cov_11.152392	636	716	3	8	80	0.1000000
NODE_6660_length_998_cov_11.152392	636	716	6	4	80	0.0500000
NODE_6660_length_998_cov_11.152392	636	716	8	14	80	0.1750000
NODE_6660_length_998_cov_11.152392	636	716	10	14	80	0.1750000
NODE_6660_length_998_cov_11.152392	636	716	11	22	80	0.2750000
NODE_6660_length_998_cov_11.152392	636	716	13	18	80	0.2250000
NODE_6660_length_998_cov_11.152392	689	769	0	34	80	0.4250000
NODE_6660_length_998_cov_11.152392	689	769	2	7	80	0.0875000
NODE_6660_length_998_cov_11.152392	689	769	3	20	80	0.2500000
NODE_6660_length_998_cov_11.152392	689	769	6	4	80	0.0500000
NODE_6660_length_998_cov_11.152392	689	769	8	14	80	0.1750000
NODE_6660_length_998_cov_11.152392	689	769	10	1	80	0.0125000
NODE_6661_length_998_cov_10.061179	422	502	5	4	80	0.0500000
NODE_6661_length_998_cov_10.061179	422	502	6	6	80	0.0750000
NODE_6661_length_998_cov_10.061179	422	502	7	70	80	0.8750000
NODE_6661_length_998_cov_10.061179	475	555	4	7	80	0.0875000
NODE_6661_length_998_cov_10.061179	475	555	5	50	80	0.6250000
NODE_6661_length_998_cov_10.061179	475	555	6	1	80	0.0125000
NODE_6661_length_998_cov_10.061179	475	555	7	22	80	0.2750000
NODE_6662_length_998_cov_7.126808	353	430	10	7	77	0.0909091
NODE_6662_length_998_cov_7.126808	353	430	12	29	77	0.3766234
NODE_6662_length_998_cov_7.126808	353	430	13	41	77	0.5324675
NODE_6662_length_998_cov_7.126808	403	483	10	6	80	0.0750000
NODE_6662_length_998_cov_7.126808	403	483	11	18	80	0.2250000
NODE_6662_length_998_cov_7.126808	403	483	13	29	80	0.3625000
NODE_6662_length_998_cov_7.126808	403	483	15	27	80	0.3375000
NODE_6669_length_997_cov_48.518931	445	525	21	2	80	0.0250000
NODE_6669_length_997_cov_48.518931	445	525	22	1	80	0.0125000
NODE_6669_length_997_cov_48.518931	445	525	23	10	80	0.1250000
NODE_6669_length_997_cov_48.518931	445	525	24	10	80	0.1250000
NODE_6669_length_997_cov_48.518931	445	525	26	12	80	0.1500000
NODE_6669_length_997_cov_48.518931	445	525	27	37	80	0.4625000
NODE_6669_length_997_cov_48.518931	445	525	29	6	80	0.0750000
NODE_6669_length_997_cov_48.518931	445	525	31	2	80	0.0250000
NODE_6669_length_997_cov_48.518931	498	578	27	33	80	0.4125000
NODE_6669_length_997_cov_48.518931	498	578	28	7	80	0.0875000
NODE_6669_length_997_cov_48.518931	498	578	29	26	80	0.3250000
NODE_6669_length_997_cov_48.518931	498	578	30	3	80	0.0375000
NODE_6669_length_997_cov_48.518931	498	578	31	11	80	0.1375000
NODE_6670_length_997_cov_36.721604	400	480	6	35	80	0.4375000
NODE_6670_length_997_cov_36.721604	400	480	8	11	80	0.1375000
NODE_6670_length_997_cov_36.721604	400	480	10	14	80	0.1750000
NODE_6670_length_997_cov_36.721604	400	480	11	20	80	0.2500000
NODE_6670_length_997_cov_36.721604	453	533	6	4	80	0.0500000
NODE_6670_length_997_cov_36.721604	453	533	8	53	80	0.6625000
NODE_6670_length_997_cov_36.721604	453	533	10	4	80	0.0500000
NODE_6670_length_997_cov_36.721604	453	533	11	19	80	0.2375000
NODE_6671_length_997_cov_22.646993	328	408	1	16	80	0.2000000
NODE_6671_length_997_cov_22.646993	328	408	2	43	80	0.5375000
NODE_6671_length_997_cov_22.646993	328	408	3	4	80	0.0500000
NODE_6671_length_997_cov_22.646993	328	408	4	17	80	0.2125000
NODE_6671_length_997_cov_22.646993	381	461	2	6	80	0.0750000
NODE_6671_length_997_cov_22.646993	381	461	3	4	80	0.0500000
NODE_6671_length_997_cov_22.646993	381	461	4	70	80	0.8750000
NODE_6672_length_997_cov_19.709354	420	500	1	80	80	1.0000000
NODE_6672_length_997_cov_19.709354	473	553	0	39	80	0.4875000
NODE_6672_length_997_cov_19.709354	473	553	1	41	80	0.5125000
NODE_6672_length_997_cov_19.709354	549	629	0	80	80	1.0000000
NODE_6672_length_997_cov_19.709354	602	682	0	80	80	1.0000000
NODE_6673_length_997_cov_17.947661	465	545	6	16	80	0.2000000
NODE_6673_length_997_cov_17.947661	465	545	7	26	80	0.3250000
NODE_6673_length_997_cov_17.947661	465	545	9	20	80	0.2500000
NODE_6673_length_997_cov_17.947661	465	545	10	4	80	0.0500000
NODE_6673_length_997_cov_17.947661	465	545	11	14	80	0.1750000
NODE_6673_length_997_cov_17.947661	518	598	6	2	80	0.0250000
NODE_6673_length_997_cov_17.947661	518	598	7	78	80	0.9750000
NODE_6673_length_997_cov_17.947661	594	674	2	8	80	0.1000000
NODE_6673_length_997_cov_17.947661	594	674	3	18	80	0.2250000
NODE_6673_length_997_cov_17.947661	594	674	4	11	80	0.1375000
NODE_6673_length_997_cov_17.947661	594	674	5	36	80	0.4500000
NODE_6673_length_997_cov_17.947661	594	674	6	4	80	0.0500000
NODE_6673_length_997_cov_17.947661	594	674	7	3	80	0.0375000
NODE_6673_length_997_cov_17.947661	647	727	3	51	80	0.6375000
NODE_6673_length_997_cov_17.947661	647	727	4	7	80	0.0875000
NODE_6673_length_997_cov_17.947661	647	727	5	22	80	0.2750000
NODE_6674_length_997_cov_14.718263	388	468	2	33	80	0.4125000
NODE_6674_length_997_cov_14.718263	388	468	4	47	80	0.5875000
NODE_6674_length_997_cov_14.718263	441	521	2	19	80	0.2375000
NODE_6674_length_997_cov_14.718263	441	521	4	61	80	0.7625000
NODE_6675_length_997_cov_7.114699	307	387	0	80	80	1.0000000
NODE_6675_length_997_cov_7.114699	360	440	0	80	80	1.0000000
NODE_6694_length_996_cov_59.568562	387	467	11	17	80	0.2125000
NODE_6694_length_996_cov_59.568562	387	467	14	8	80	0.1000000
NODE_6694_length_996_cov_59.568562	387	467	16	46	80	0.5750000
NODE_6694_length_996_cov_59.568562	387	467	17	6	80	0.0750000
NODE_6694_length_996_cov_59.568562	387	467	19	3	80	0.0375000
NODE_6694_length_996_cov_59.568562	440	520	12	3	80	0.0375000
NODE_6694_length_996_cov_59.568562	440	520	15	13	80	0.1625000
NODE_6694_length_996_cov_59.568562	440	520	16	18	80	0.2250000
NODE_6694_length_996_cov_59.568562	440	520	17	6	80	0.0750000
NODE_6694_length_996_cov_59.568562	440	520	18	2	80	0.0250000
NODE_6694_length_996_cov_59.568562	440	520	19	10	80	0.1250000
NODE_6694_length_996_cov_59.568562	440	520	21	4	80	0.0500000
NODE_6694_length_996_cov_59.568562	440	520	22	24	80	0.3000000
NODE_6695_length_996_cov_32.462653	503	583	9	14	80	0.1750000
NODE_6695_length_996_cov_32.462653	503	583	11	7	80	0.0875000
NODE_6695_length_996_cov_32.462653	503	583	12	7	80	0.0875000
NODE_6695_length_996_cov_32.462653	503	583	13	11	80	0.1375000
NODE_6695_length_996_cov_32.462653	503	583	14	1	80	0.0125000
NODE_6695_length_996_cov_32.462653	503	583	15	4	80	0.0500000
NODE_6695_length_996_cov_32.462653	503	583	16	2	80	0.0250000
NODE_6695_length_996_cov_32.462653	503	583	18	11	80	0.1375000
NODE_6695_length_996_cov_32.462653	503	583	19	16	80	0.2000000
NODE_6695_length_996_cov_32.462653	503	583	21	4	80	0.0500000
NODE_6695_length_996_cov_32.462653	503	583	22	2	80	0.0250000
NODE_6695_length_996_cov_32.462653	503	583	24	1	80	0.0125000
NODE_6695_length_996_cov_32.462653	556	636	18	4	80	0.0500000
NODE_6695_length_996_cov_32.462653	556	636	19	16	80	0.2000000
NODE_6695_length_996_cov_32.462653	556	636	21	4	80	0.0500000
NODE_6695_length_996_cov_32.462653	556	636	22	2	80	0.0250000
NODE_6695_length_996_cov_32.462653	556	636	24	9	80	0.1125000
NODE_6695_length_996_cov_32.462653	556	636	25	1	80	0.0125000
NODE_6695_length_996_cov_32.462653	556	636	26	1	80	0.0125000
NODE_6695_length_996_cov_32.462653	556	636	28	19	80	0.2375000
NODE_6695_length_996_cov_32.462653	556	636	29	23	80	0.2875000
NODE_6695_length_996_cov_32.462653	556	636	30	1	80	0.0125000
NODE_6696_length_996_cov_23.312152	571	651	1	51	80	0.6375000
NODE_6696_length_996_cov_23.312152	571	651	2	29	80	0.3625000
NODE_6696_length_996_cov_23.312152	624	704	2	68	80	0.8500000
NODE_6696_length_996_cov_23.312152	624	704	3	12	80	0.1500000
NODE_6697_length_996_cov_20.979933	533	613	12	11	80	0.1375000
NODE_6697_length_996_cov_20.979933	533	613	13	27	80	0.3375000
NODE_6697_length_996_cov_20.979933	533	613	14	27	80	0.3375000
NODE_6697_length_996_cov_20.979933	533	613	15	15	80	0.1875000
NODE_6697_length_996_cov_20.979933	586	666	5	15	80	0.1875000
NODE_6697_length_996_cov_20.979933	586	666	7	13	80	0.1625000
NODE_6697_length_996_cov_20.979933	586	666	8	11	80	0.1375000
NODE_6697_length_996_cov_20.979933	586	666	10	3	80	0.0375000
NODE_6697_length_996_cov_20.979933	586	666	12	1	80	0.0125000
NODE_6697_length_996_cov_20.979933	586	666	13	13	80	0.1625000
NODE_6697_length_996_cov_20.979933	586	666	14	3	80	0.0375000
NODE_6697_length_996_cov_20.979933	586	666	15	21	80	0.2625000
NODE_6698_length_996_cov_17.865106	535	615	0	80	80	1.0000000
NODE_6698_length_996_cov_17.865106	588	668	0	80	80	1.0000000
NODE_6699_length_996_cov_10.297659	499	579	7	36	80	0.4500000
NODE_6699_length_996_cov_10.297659	499	579	9	5	80	0.0625000
NODE_6699_length_996_cov_10.297659	499	579	10	39	80	0.4875000
NODE_6699_length_996_cov_10.297659	552	630	4	25	78	0.3205128
NODE_6699_length_996_cov_10.297659	552	630	7	40	78	0.5128205
NODE_6699_length_996_cov_10.297659	552	630	10	13	78	0.1666667
NODE_6702_length_996_cov_3.205128	499	555	8	13	56	0.2321429
NODE_6702_length_996_cov_3.205128	499	555	9	37	56	0.6607143
NODE_6702_length_996_cov_3.205128	499	555	10	6	56	0.1071429
NODE_6707_length_995_cov_26.131696	543	623	3	6	80	0.0750000
NODE_6707_length_995_cov_26.131696	543	623	4	11	80	0.1375000
NODE_6707_length_995_cov_26.131696	543	623	5	8	80	0.1000000
NODE_6707_length_995_cov_26.131696	543	623	7	55	80	0.6875000
NODE_6707_length_995_cov_26.131696	596	676	0	16	80	0.2000000
NODE_6707_length_995_cov_26.131696	596	676	1	28	80	0.3500000
NODE_6707_length_995_cov_26.131696	596	676	2	1	80	0.0125000
NODE_6707_length_995_cov_26.131696	596	676	3	14	80	0.1750000
NODE_6707_length_995_cov_26.131696	596	676	4	11	80	0.1375000
NODE_6707_length_995_cov_26.131696	596	676	5	8	80	0.1000000
NODE_6707_length_995_cov_26.131696	596	676	7	2	80	0.0250000
NODE_6708_length_995_cov_20.262277	457	537	4	3	80	0.0375000
NODE_6708_length_995_cov_20.262277	457	537	5	16	80	0.2000000
NODE_6708_length_995_cov_20.262277	457	537	6	4	80	0.0500000
NODE_6708_length_995_cov_20.262277	457	537	7	18	80	0.2250000
NODE_6708_length_995_cov_20.262277	457	537	8	26	80	0.3250000
NODE_6708_length_995_cov_20.262277	457	537	9	5	80	0.0625000
NODE_6708_length_995_cov_20.262277	457	537	10	8	80	0.1000000
NODE_6708_length_995_cov_20.262277	510	590	7	63	80	0.7875000
NODE_6708_length_995_cov_20.262277	510	590	8	17	80	0.2125000
NODE_6709_length_995_cov_19.382812	457	537	0	17	80	0.2125000
NODE_6709_length_995_cov_19.382812	457	537	2	4	80	0.0500000
NODE_6709_length_995_cov_19.382812	457	537	3	47	80	0.5875000
NODE_6709_length_995_cov_19.382812	457	537	4	3	80	0.0375000
NODE_6709_length_995_cov_19.382812	457	537	6	9	80	0.1125000
NODE_6709_length_995_cov_19.382812	510	590	3	15	80	0.1875000
NODE_6709_length_995_cov_19.382812	510	590	4	3	80	0.0375000
NODE_6709_length_995_cov_19.382812	510	590	6	62	80	0.7750000
NODE_6710_length_995_cov_19.034598	453	533	0	40	80	0.5000000
NODE_6710_length_995_cov_19.034598	453	533	1	40	80	0.5000000
NODE_6710_length_995_cov_19.034598	506	586	0	80	80	1.0000000
NODE_6711_length_995_cov_9.734375	222	323	0	54	101	0.5346535
NODE_6711_length_995_cov_9.734375	222	323	2	47	101	0.4653465
NODE_6711_length_995_cov_9.734375	296	376	0	80	80	1.0000000
NODE_6723_length_994_cov_74.678212	362	442	17	18	80	0.2250000
NODE_6723_length_994_cov_74.678212	362	442	18	62	80	0.7750000
NODE_6723_length_994_cov_74.678212	415	495	3	5	80	0.0625000
NODE_6723_length_994_cov_74.678212	415	495	17	4	80	0.0500000
NODE_6723_length_994_cov_74.678212	415	495	18	58	80	0.7250000
NODE_6723_length_994_cov_74.678212	415	495	19	13	80	0.1625000
NODE_6723_length_994_cov_74.678212	491	571	2	6	80	0.0750000
NODE_6723_length_994_cov_74.678212	491	571	3	39	80	0.4875000
NODE_6723_length_994_cov_74.678212	491	571	5	25	80	0.3125000
NODE_6723_length_994_cov_74.678212	491	571	6	10	80	0.1250000
NODE_6723_length_994_cov_74.678212	544	624	5	33	80	0.4125000
NODE_6723_length_994_cov_74.678212	544	624	6	10	80	0.1250000
NODE_6723_length_994_cov_74.678212	544	624	8	3	80	0.0375000
NODE_6723_length_994_cov_74.678212	544	624	16	2	80	0.0250000
NODE_6723_length_994_cov_74.678212	544	624	17	5	80	0.0625000
NODE_6723_length_994_cov_74.678212	544	624	18	6	80	0.0750000
NODE_6723_length_994_cov_74.678212	544	624	19	2	80	0.0250000
NODE_6723_length_994_cov_74.678212	544	624	20	4	80	0.0500000
NODE_6723_length_994_cov_74.678212	544	624	23	1	80	0.0125000
NODE_6723_length_994_cov_74.678212	544	624	24	14	80	0.1750000
NODE_6724_length_994_cov_26.045810	442	522	10	9	80	0.1125000
NODE_6724_length_994_cov_26.045810	442	522	11	6	80	0.0750000
NODE_6724_length_994_cov_26.045810	442	522	13	8	80	0.1000000
NODE_6724_length_994_cov_26.045810	442	522	14	4	80	0.0500000
NODE_6724_length_994_cov_26.045810	442	522	15	13	80	0.1625000
NODE_6724_length_994_cov_26.045810	442	522	16	5	80	0.0625000
NODE_6724_length_994_cov_26.045810	442	522	18	35	80	0.4375000
NODE_6724_length_994_cov_26.045810	495	575	6	16	80	0.2000000
NODE_6724_length_994_cov_26.045810	495	575	10	18	80	0.2250000
NODE_6724_length_994_cov_26.045810	495	575	11	34	80	0.4250000
NODE_6724_length_994_cov_26.045810	495	575	13	8	80	0.1000000
NODE_6724_length_994_cov_26.045810	495	575	16	4	80	0.0500000
NODE_6725_length_994_cov_25.240223	504	584	6	22	80	0.2750000
NODE_6725_length_994_cov_25.240223	504	584	7	12	80	0.1500000
NODE_6725_length_994_cov_25.240223	504	584	9	4	80	0.0500000
NODE_6725_length_994_cov_25.240223	504	584	10	42	80	0.5250000
NODE_6725_length_994_cov_25.240223	557	637	7	7	80	0.0875000
NODE_6725_length_994_cov_25.240223	557	637	8	19	80	0.2375000
NODE_6725_length_994_cov_25.240223	557	637	9	23	80	0.2875000
NODE_6725_length_994_cov_25.240223	557	637	10	31	80	0.3875000
NODE_6726_length_994_cov_24.615642	422	502	2	51	80	0.6375000
NODE_6726_length_994_cov_24.615642	422	502	5	29	80	0.3625000
NODE_6726_length_994_cov_24.615642	475	555	4	13	80	0.1625000
NODE_6726_length_994_cov_24.615642	475	555	5	51	80	0.6375000
NODE_6726_length_994_cov_24.615642	475	555	7	16	80	0.2000000
NODE_6726_length_994_cov_24.615642	551	631	7	15	80	0.1875000
NODE_6726_length_994_cov_24.615642	551	631	8	61	80	0.7625000
NODE_6726_length_994_cov_24.615642	551	631	9	1	80	0.0125000
NODE_6726_length_994_cov_24.615642	551	631	11	3	80	0.0375000
NODE_6726_length_994_cov_24.615642	604	684	7	25	80	0.3125000
NODE_6726_length_994_cov_24.615642	604	684	8	51	80	0.6375000
NODE_6726_length_994_cov_24.615642	604	684	9	1	80	0.0125000
NODE_6726_length_994_cov_24.615642	604	684	11	3	80	0.0375000
NODE_6727_length_994_cov_22.593296	323	403	2	44	80	0.5500000
NODE_6727_length_994_cov_22.593296	323	403	3	1	80	0.0125000
NODE_6727_length_994_cov_22.593296	323	403	5	21	80	0.2625000
NODE_6727_length_994_cov_22.593296	323	403	6	13	80	0.1625000
NODE_6727_length_994_cov_22.593296	323	403	7	1	80	0.0125000
NODE_6727_length_994_cov_22.593296	376	456	5	13	80	0.1625000
NODE_6727_length_994_cov_22.593296	376	456	6	13	80	0.1625000
NODE_6727_length_994_cov_22.593296	376	456	7	8	80	0.1000000
NODE_6727_length_994_cov_22.593296	376	456	8	16	80	0.2000000
NODE_6727_length_994_cov_22.593296	376	456	9	30	80	0.3750000
NODE_6727_length_994_cov_22.593296	452	532	7	10	80	0.1250000
NODE_6727_length_994_cov_22.593296	452	532	8	5	80	0.0625000
NODE_6727_length_994_cov_22.593296	452	532	9	3	80	0.0375000
NODE_6727_length_994_cov_22.593296	452	532	10	8	80	0.1000000
NODE_6727_length_994_cov_22.593296	452	532	11	3	80	0.0375000
NODE_6727_length_994_cov_22.593296	452	532	12	42	80	0.5250000
NODE_6727_length_994_cov_22.593296	452	532	13	3	80	0.0375000
NODE_6727_length_994_cov_22.593296	452	532	14	1	80	0.0125000
NODE_6727_length_994_cov_22.593296	452	532	15	5	80	0.0625000
NODE_6727_length_994_cov_22.593296	505	585	10	6	80	0.0750000
NODE_6727_length_994_cov_22.593296	505	585	11	10	80	0.1250000
NODE_6727_length_994_cov_22.593296	505	585	12	27	80	0.3375000
NODE_6727_length_994_cov_22.593296	505	585	13	11	80	0.1375000
NODE_6727_length_994_cov_22.593296	505	585	14	14	80	0.1750000
NODE_6727_length_994_cov_22.593296	505	585	15	12	80	0.1500000
NODE_6728_length_994_cov_6.985475	0	58	0	58	58	1.0000000
NODE_6728_length_994_cov_6.985475	15	95	0	80	80	1.0000000
NODE_6728_length_994_cov_6.985475	68	148	0	80	80	1.0000000
NODE_6740_length_993_cov_56.321029	266	346	4	13	80	0.1625000
NODE_6740_length_993_cov_56.321029	266	346	5	28	80	0.3500000
NODE_6740_length_993_cov_56.321029	266	346	6	1	80	0.0125000
NODE_6740_length_993_cov_56.321029	266	346	7	36	80	0.4500000
NODE_6740_length_993_cov_56.321029	266	346	8	2	80	0.0250000
NODE_6740_length_993_cov_56.321029	319	399	5	19	80	0.2375000
NODE_6740_length_993_cov_56.321029	319	399	6	7	80	0.0875000
NODE_6740_length_993_cov_56.321029	319	399	7	52	80	0.6500000
NODE_6740_length_993_cov_56.321029	319	399	8	2	80	0.0250000
NODE_6740_length_993_cov_56.321029	400	470	5	23	70	0.3285714
NODE_6740_length_993_cov_56.321029	400	470	6	30	70	0.4285714
NODE_6740_length_993_cov_56.321029	400	470	7	17	70	0.2428571
NODE_6740_length_993_cov_56.321029	443	523	4	40	80	0.5000000
NODE_6740_length_993_cov_56.321029	443	523	5	24	80	0.3000000
NODE_6740_length_993_cov_56.321029	443	523	6	1	80	0.0125000
NODE_6740_length_993_cov_56.321029	443	523	7	15	80	0.1875000
NODE_6741_length_993_cov_44.695749	385	465	7	20	80	0.2500000
NODE_6741_length_993_cov_44.695749	385	465	10	60	80	0.7500000
NODE_6741_length_993_cov_44.695749	438	518	4	45	80	0.5625000
NODE_6741_length_993_cov_44.695749	438	518	7	28	80	0.3500000
NODE_6741_length_993_cov_44.695749	438	518	10	7	80	0.0875000
NODE_6742_length_993_cov_40.574944	417	497	5	80	80	1.0000000
NODE_6742_length_993_cov_40.574944	470	550	5	28	80	0.3500000
NODE_6742_length_993_cov_40.574944	470	550	6	44	80	0.5500000
NODE_6742_length_993_cov_40.574944	470	550	8	8	80	0.1000000
NODE_6742_length_993_cov_40.574944	546	628	2	12	82	0.1463415
NODE_6742_length_993_cov_40.574944	546	628	4	62	82	0.7560976
NODE_6742_length_993_cov_40.574944	546	628	8	5	82	0.0609756
NODE_6742_length_993_cov_40.574944	546	628	9	3	82	0.0365854
NODE_6742_length_993_cov_40.574944	601	681	1	20	80	0.2500000
NODE_6742_length_993_cov_40.574944	601	681	2	32	80	0.4000000
NODE_6742_length_993_cov_40.574944	601	681	4	15	80	0.1875000
NODE_6742_length_993_cov_40.574944	601	681	6	13	80	0.1625000
NODE_6743_length_993_cov_39.817673	3	83	0	80	80	1.0000000
NODE_6744_length_993_cov_30.128635	477	557	18	5	80	0.0625000
NODE_6744_length_993_cov_30.128635	477	557	21	12	80	0.1500000
NODE_6744_length_993_cov_30.128635	477	557	22	9	80	0.1125000
NODE_6744_length_993_cov_30.128635	477	557	23	6	80	0.0750000
NODE_6744_length_993_cov_30.128635	477	557	24	6	80	0.0750000
NODE_6744_length_993_cov_30.128635	477	557	26	3	80	0.0375000
NODE_6744_length_993_cov_30.128635	477	557	27	1	80	0.0125000
NODE_6744_length_993_cov_30.128635	477	557	28	10	80	0.1250000
NODE_6744_length_993_cov_30.128635	477	557	29	12	80	0.1500000
NODE_6744_length_993_cov_30.128635	477	557	30	6	80	0.0750000
NODE_6744_length_993_cov_30.128635	477	557	35	10	80	0.1250000
NODE_6744_length_993_cov_30.128635	530	610	28	1	80	0.0125000
NODE_6744_length_993_cov_30.128635	530	610	29	10	80	0.1250000
NODE_6744_length_993_cov_30.128635	530	610	30	21	80	0.2625000
NODE_6744_length_993_cov_30.128635	530	610	31	5	80	0.0625000
NODE_6744_length_993_cov_30.128635	530	610	32	12	80	0.1500000
NODE_6744_length_993_cov_30.128635	530	610	33	6	80	0.0750000
NODE_6744_length_993_cov_30.128635	530	610	35	24	80	0.3000000
NODE_6744_length_993_cov_30.128635	530	610	36	1	80	0.0125000
NODE_6745_length_993_cov_17.435123	573	653	1	57	80	0.7125000
NODE_6745_length_993_cov_17.435123	573	653	2	23	80	0.2875000
NODE_6745_length_993_cov_17.435123	626	706	1	4	80	0.0500000
NODE_6745_length_993_cov_17.435123	626	706	2	76	80	0.9500000
NODE_6746_length_993_cov_13.074944	483	563	10	21	80	0.2625000
NODE_6746_length_993_cov_13.074944	483	563	12	9	80	0.1125000
NODE_6746_length_993_cov_13.074944	483	563	13	10	80	0.1250000
NODE_6746_length_993_cov_13.074944	483	563	14	2	80	0.0250000
NODE_6746_length_993_cov_13.074944	483	563	15	14	80	0.1750000
NODE_6746_length_993_cov_13.074944	483	563	16	5	80	0.0625000
NODE_6746_length_993_cov_13.074944	483	563	17	19	80	0.2375000
NODE_6746_length_993_cov_13.074944	536	616	12	62	80	0.7750000
NODE_6746_length_993_cov_13.074944	536	616	15	1	80	0.0125000
NODE_6746_length_993_cov_13.074944	536	616	17	17	80	0.2125000
NODE_6747_length_993_cov_10.190157	500	580	1	46	80	0.5750000
NODE_6747_length_993_cov_10.190157	500	580	2	34	80	0.4250000
NODE_6747_length_993_cov_10.190157	553	633	2	80	80	1.0000000
NODE_6756_length_993_cov_0.909396	16	73	0	57	57	1.0000000
NODE_6757_length_992_cov_36.119821	354	434	24	22	80	0.2750000
NODE_6757_length_992_cov_36.119821	354	434	25	9	80	0.1125000
NODE_6757_length_992_cov_36.119821	354	434	26	3	80	0.0375000
NODE_6757_length_992_cov_36.119821	354	434	27	32	80	0.4000000
NODE_6757_length_992_cov_36.119821	354	434	29	14	80	0.1750000
NODE_6757_length_992_cov_36.119821	407	487	11	1	80	0.0125000
NODE_6757_length_992_cov_36.119821	407	487	19	1	80	0.0125000
NODE_6757_length_992_cov_36.119821	407	487	23	9	80	0.1125000
NODE_6757_length_992_cov_36.119821	407	487	24	53	80	0.6625000
NODE_6757_length_992_cov_36.119821	407	487	25	11	80	0.1375000
NODE_6757_length_992_cov_36.119821	407	487	29	5	80	0.0625000
NODE_6757_length_992_cov_36.119821	483	563	6	7	80	0.0875000
NODE_6757_length_992_cov_36.119821	483	563	7	17	80	0.2125000
NODE_6757_length_992_cov_36.119821	483	563	9	25	80	0.3125000
NODE_6757_length_992_cov_36.119821	483	563	10	8	80	0.1000000
NODE_6757_length_992_cov_36.119821	483	563	11	16	80	0.2000000
NODE_6757_length_992_cov_36.119821	483	563	12	4	80	0.0500000
NODE_6757_length_992_cov_36.119821	483	563	19	1	80	0.0125000
NODE_6757_length_992_cov_36.119821	483	563	24	2	80	0.0250000
NODE_6757_length_992_cov_36.119821	536	616	4	13	80	0.1625000
NODE_6757_length_992_cov_36.119821	536	616	5	13	80	0.1625000
NODE_6757_length_992_cov_36.119821	536	616	6	11	80	0.1375000
NODE_6757_length_992_cov_36.119821	536	616	7	40	80	0.5000000
NODE_6757_length_992_cov_36.119821	536	616	9	3	80	0.0375000
NODE_6758_length_992_cov_34.802912	443	523	0	80	80	1.0000000
NODE_6758_length_992_cov_34.802912	496	576	0	80	80	1.0000000
NODE_6759_length_992_cov_33.047032	381	461	6	2	80	0.0250000
NODE_6759_length_992_cov_33.047032	381	461	7	42	80	0.5250000
NODE_6759_length_992_cov_33.047032	381	461	8	5	80	0.0625000
NODE_6759_length_992_cov_33.047032	381	461	9	31	80	0.3875000
NODE_6759_length_992_cov_33.047032	434	514	3	40	80	0.5000000
NODE_6759_length_992_cov_33.047032	434	514	4	2	80	0.0250000
NODE_6759_length_992_cov_33.047032	434	514	7	13	80	0.1625000
NODE_6759_length_992_cov_33.047032	434	514	9	25	80	0.3125000
NODE_6759_length_992_cov_33.047032	510	590	3	18	80	0.2250000
NODE_6759_length_992_cov_33.047032	510	590	4	12	80	0.1500000
NODE_6759_length_992_cov_33.047032	510	590	5	37	80	0.4625000
NODE_6759_length_992_cov_33.047032	510	590	6	13	80	0.1625000
NODE_6759_length_992_cov_33.047032	563	643	4	65	80	0.8125000
NODE_6759_length_992_cov_33.047032	563	643	5	7	80	0.0875000
NODE_6759_length_992_cov_33.047032	563	643	6	8	80	0.1000000
NODE_6760_length_992_cov_23.543113	435	515	8	40	80	0.5000000
NODE_6760_length_992_cov_23.543113	435	515	10	40	80	0.5000000
NODE_6760_length_992_cov_23.543113	488	568	8	28	80	0.3500000
NODE_6760_length_992_cov_23.543113	488	568	9	26	80	0.3250000
NODE_6760_length_992_cov_23.543113	488	568	10	26	80	0.3250000
NODE_6761_length_992_cov_22.608063	440	520	1	10	80	0.1250000
NODE_6761_length_992_cov_22.608063	440	520	2	8	80	0.1000000
NODE_6761_length_992_cov_22.608063	440	520	5	62	80	0.7750000
NODE_6761_length_992_cov_22.608063	493	573	0	48	80	0.6000000
NODE_6761_length_992_cov_22.608063	493	573	1	15	80	0.1875000
NODE_6761_length_992_cov_22.608063	493	573	2	8	80	0.1000000
NODE_6761_length_992_cov_22.608063	493	573	5	9	80	0.1125000
NODE_6762_length_992_cov_21.427772	216	296	9	20	80	0.2500000
NODE_6762_length_992_cov_21.427772	216	296	10	5	80	0.0625000
NODE_6762_length_992_cov_21.427772	216	296	11	4	80	0.0500000
NODE_6762_length_992_cov_21.427772	216	296	13	1	80	0.0125000
NODE_6762_length_992_cov_21.427772	216	296	14	6	80	0.0750000
NODE_6762_length_992_cov_21.427772	216	296	15	2	80	0.0250000
NODE_6762_length_992_cov_21.427772	216	296	17	3	80	0.0375000
NODE_6762_length_992_cov_21.427772	216	296	19	3	80	0.0375000
NODE_6762_length_992_cov_21.427772	216	296	22	2	80	0.0250000
NODE_6762_length_992_cov_21.427772	216	296	23	5	80	0.0625000
NODE_6762_length_992_cov_21.427772	216	296	25	12	80	0.1500000
NODE_6762_length_992_cov_21.427772	216	296	26	4	80	0.0500000
NODE_6762_length_992_cov_21.427772	216	296	28	5	80	0.0625000
NODE_6762_length_992_cov_21.427772	216	296	29	8	80	0.1000000
NODE_6762_length_992_cov_21.427772	269	349	25	10	80	0.1250000
NODE_6762_length_992_cov_21.427772	269	349	26	4	80	0.0500000
NODE_6762_length_992_cov_21.427772	269	349	27	5	80	0.0625000
NODE_6762_length_992_cov_21.427772	269	349	28	6	80	0.0750000
NODE_6762_length_992_cov_21.427772	269	349	29	19	80	0.2375000
NODE_6762_length_992_cov_21.427772	269	349	30	36	80	0.4500000
NODE_6763_length_992_cov_20.010078	312	392	5	1	80	0.0125000
NODE_6763_length_992_cov_20.010078	312	392	7	34	80	0.4250000
NODE_6763_length_992_cov_20.010078	312	392	9	38	80	0.4750000
NODE_6763_length_992_cov_20.010078	312	392	12	7	80	0.0875000
NODE_6763_length_992_cov_20.010078	365	445	0	33	80	0.4125000
NODE_6763_length_992_cov_20.010078	365	445	2	10	80	0.1250000
NODE_6763_length_992_cov_20.010078	365	445	5	11	80	0.1375000
NODE_6763_length_992_cov_20.010078	365	445	7	26	80	0.3250000
NODE_6764_length_992_cov_16.524076	465	545	3	12	80	0.1500000
NODE_6764_length_992_cov_16.524076	465	545	4	19	80	0.2375000
NODE_6764_length_992_cov_16.524076	465	545	5	10	80	0.1250000
NODE_6764_length_992_cov_16.524076	465	545	6	39	80	0.4875000
NODE_6764_length_992_cov_16.524076	518	598	3	37	80	0.4625000
NODE_6764_length_992_cov_16.524076	518	598	4	27	80	0.3375000
NODE_6764_length_992_cov_16.524076	518	598	6	16	80	0.2000000
NODE_6765_length_992_cov_16.266517	396	476	11	19	80	0.2375000
NODE_6765_length_992_cov_16.266517	396	476	12	16	80	0.2000000
NODE_6765_length_992_cov_16.266517	396	476	15	34	80	0.4250000
NODE_6765_length_992_cov_16.266517	396	476	16	11	80	0.1375000
NODE_6765_length_992_cov_16.266517	449	529	4	15	80	0.1875000
NODE_6765_length_992_cov_16.266517	449	529	7	5	80	0.0625000
NODE_6765_length_992_cov_16.266517	449	529	9	19	80	0.2375000
NODE_6765_length_992_cov_16.266517	449	529	10	14	80	0.1750000
NODE_6765_length_992_cov_16.266517	449	529	11	19	80	0.2375000
NODE_6765_length_992_cov_16.266517	449	529	12	8	80	0.1000000
NODE_6766_length_992_cov_16.146697	272	352	0	67	80	0.8375000
NODE_6766_length_992_cov_16.146697	272	352	1	13	80	0.1625000
NODE_6766_length_992_cov_16.146697	325	405	0	14	80	0.1750000
NODE_6766_length_992_cov_16.146697	325	405	1	66	80	0.8250000
NODE_6767_length_992_cov_15.212766	354	434	3	55	80	0.6875000
NODE_6767_length_992_cov_15.212766	354	434	5	2	80	0.0250000
NODE_6767_length_992_cov_15.212766	354	434	6	9	80	0.1125000
NODE_6767_length_992_cov_15.212766	354	434	7	14	80	0.1750000
NODE_6767_length_992_cov_15.212766	407	487	3	2	80	0.0250000
NODE_6767_length_992_cov_15.212766	407	487	5	2	80	0.0250000
NODE_6767_length_992_cov_15.212766	407	487	6	9	80	0.1125000
NODE_6767_length_992_cov_15.212766	407	487	7	36	80	0.4500000
NODE_6767_length_992_cov_15.212766	407	487	8	21	80	0.2625000
NODE_6767_length_992_cov_15.212766	407	487	9	6	80	0.0750000
NODE_6767_length_992_cov_15.212766	407	487	11	4	80	0.0500000
NODE_6767_length_992_cov_15.212766	483	563	10	2	80	0.0250000
NODE_6767_length_992_cov_15.212766	483	563	11	41	80	0.5125000
NODE_6767_length_992_cov_15.212766	483	563	12	1	80	0.0125000
NODE_6767_length_992_cov_15.212766	483	563	13	36	80	0.4500000
NODE_6767_length_992_cov_15.212766	536	616	7	13	80	0.1625000
NODE_6767_length_992_cov_15.212766	536	616	8	7	80	0.0875000
NODE_6767_length_992_cov_15.212766	536	616	9	26	80	0.3250000
NODE_6767_length_992_cov_15.212766	536	616	10	9	80	0.1125000
NODE_6767_length_992_cov_15.212766	536	616	11	2	80	0.0250000
NODE_6767_length_992_cov_15.212766	536	616	12	1	80	0.0125000
NODE_6767_length_992_cov_15.212766	536	616	13	22	80	0.2750000
NODE_6781_length_991_cov_48.582960	451	531	3	34	80	0.4250000
NODE_6781_length_991_cov_48.582960	451	531	4	14	80	0.1750000
NODE_6781_length_991_cov_48.582960	451	531	9	16	80	0.2000000
NODE_6781_length_991_cov_48.582960	451	531	10	3	80	0.0375000
NODE_6781_length_991_cov_48.582960	451	531	16	13	80	0.1625000
NODE_6781_length_991_cov_48.582960	504	584	9	11	80	0.1375000
NODE_6781_length_991_cov_48.582960	504	584	10	3	80	0.0375000
NODE_6781_length_991_cov_48.582960	504	584	16	15	80	0.1875000
NODE_6781_length_991_cov_48.582960	504	584	17	7	80	0.0875000
NODE_6781_length_991_cov_48.582960	504	584	18	1	80	0.0125000
NODE_6781_length_991_cov_48.582960	504	584	19	10	80	0.1250000
NODE_6781_length_991_cov_48.582960	504	584	20	5	80	0.0625000
NODE_6781_length_991_cov_48.582960	504	584	21	7	80	0.0875000
NODE_6781_length_991_cov_48.582960	504	584	22	21	80	0.2625000
NODE_6782_length_991_cov_25.891256	340	420	1	30	80	0.3750000
NODE_6782_length_991_cov_25.891256	340	420	2	50	80	0.6250000
NODE_6782_length_991_cov_25.891256	393	473	0	45	80	0.5625000
NODE_6782_length_991_cov_25.891256	393	473	1	35	80	0.4375000
NODE_6782_length_991_cov_25.891256	469	549	0	29	80	0.3625000
NODE_6782_length_991_cov_25.891256	469	549	2	28	80	0.3500000
NODE_6782_length_991_cov_25.891256	469	549	4	23	80	0.2875000
NODE_6782_length_991_cov_25.891256	522	602	2	4	80	0.0500000
NODE_6782_length_991_cov_25.891256	522	602	4	76	80	0.9500000
NODE_6783_length_991_cov_25.392377	377	457	5	17	80	0.2125000
NODE_6783_length_991_cov_25.392377	377	457	7	7	80	0.0875000
NODE_6783_length_991_cov_25.392377	377	457	8	56	80	0.7000000
NODE_6783_length_991_cov_25.392377	430	510	6	7	80	0.0875000
NODE_6783_length_991_cov_25.392377	430	510	7	29	80	0.3625000
NODE_6783_length_991_cov_25.392377	430	510	8	43	80	0.5375000
NODE_6783_length_991_cov_25.392377	430	510	9	1	80	0.0125000
NODE_6783_length_991_cov_25.392377	506	586	4	20	80	0.2500000
NODE_6783_length_991_cov_25.392377	506	586	5	14	80	0.1750000
NODE_6783_length_991_cov_25.392377	506	586	6	36	80	0.4500000
NODE_6783_length_991_cov_25.392377	506	586	8	10	80	0.1250000
NODE_6783_length_991_cov_25.392377	559	639	5	27	80	0.3375000
NODE_6783_length_991_cov_25.392377	559	639	6	53	80	0.6625000
NODE_6784_length_991_cov_22.210762	421	501	4	14	80	0.1750000
NODE_6784_length_991_cov_22.210762	421	501	5	17	80	0.2125000
NODE_6784_length_991_cov_22.210762	421	501	6	27	80	0.3375000
NODE_6784_length_991_cov_22.210762	421	501	10	22	80	0.2750000
NODE_6784_length_991_cov_22.210762	474	554	5	1	80	0.0125000
NODE_6784_length_991_cov_22.210762	474	554	6	4	80	0.0500000
NODE_6784_length_991_cov_22.210762	474	554	10	31	80	0.3875000
NODE_6784_length_991_cov_22.210762	474	554	11	9	80	0.1125000
NODE_6784_length_991_cov_22.210762	474	554	12	9	80	0.1125000
NODE_6784_length_991_cov_22.210762	474	554	13	25	80	0.3125000
NODE_6784_length_991_cov_22.210762	474	554	14	1	80	0.0125000
NODE_6785_length_991_cov_18.008969	366	446	0	80	80	1.0000000
NODE_6785_length_991_cov_18.008969	419	499	0	33	80	0.4125000
NODE_6785_length_991_cov_18.008969	419	499	1	47	80	0.5875000
NODE_6785_length_991_cov_18.008969	495	575	1	30	80	0.3750000
NODE_6785_length_991_cov_18.008969	495	575	2	50	80	0.6250000
NODE_6785_length_991_cov_18.008969	548	629	1	26	81	0.3209876
NODE_6785_length_991_cov_18.008969	548	629	2	55	81	0.6790124
NODE_6786_length_991_cov_14.727578	426	506	2	12	80	0.1500000
NODE_6786_length_991_cov_14.727578	426	506	3	50	80	0.6250000
NODE_6786_length_991_cov_14.727578	426	506	4	18	80	0.2250000
NODE_6786_length_991_cov_14.727578	479	559	1	39	80	0.4875000
NODE_6786_length_991_cov_14.727578	479	559	2	26	80	0.3250000
NODE_6786_length_991_cov_14.727578	479	559	3	15	80	0.1875000
NODE_6787_length_991_cov_13.081839	240	320	2	1	80	0.0125000
NODE_6787_length_991_cov_13.081839	240	320	4	23	80	0.2875000
NODE_6787_length_991_cov_13.081839	240	320	6	33	80	0.4125000
NODE_6787_length_991_cov_13.081839	240	320	7	20	80	0.2500000
NODE_6787_length_991_cov_13.081839	240	320	8	3	80	0.0375000
NODE_6787_length_991_cov_13.081839	293	373	6	4	80	0.0500000
NODE_6787_length_991_cov_13.081839	293	373	7	20	80	0.2500000
NODE_6787_length_991_cov_13.081839	293	373	8	17	80	0.2125000
NODE_6787_length_991_cov_13.081839	293	373	10	39	80	0.4875000
NODE_6788_length_991_cov_12.693946	425	505	8	9	80	0.1125000
NODE_6788_length_991_cov_12.693946	425	505	9	6	80	0.0750000
NODE_6788_length_991_cov_12.693946	425	505	11	13	80	0.1625000
NODE_6788_length_991_cov_12.693946	425	505	12	8	80	0.1000000
NODE_6788_length_991_cov_12.693946	425	505	14	18	80	0.2250000
NODE_6788_length_991_cov_12.693946	425	505	16	26	80	0.3250000
NODE_6788_length_991_cov_12.693946	478	558	10	5	80	0.0625000
NODE_6788_length_991_cov_12.693946	478	558	11	44	80	0.5500000
NODE_6788_length_991_cov_12.693946	478	558	12	25	80	0.3125000
NODE_6788_length_991_cov_12.693946	478	558	16	6	80	0.0750000
NODE_6789_length_991_cov_9.647982	436	516	0	17	80	0.2125000
NODE_6789_length_991_cov_9.647982	436	516	2	63	80	0.7875000
NODE_6789_length_991_cov_9.647982	489	569	2	80	80	1.0000000
NODE_6790_length_991_cov_5.176009	538	618	0	6	80	0.0750000
NODE_6790_length_991_cov_5.176009	538	618	1	39	80	0.4875000
NODE_6790_length_991_cov_5.176009	538	618	2	15	80	0.1875000
NODE_6790_length_991_cov_5.176009	538	618	4	20	80	0.2500000
NODE_6790_length_991_cov_5.176009	591	671	0	59	80	0.7375000
NODE_6790_length_991_cov_5.176009	591	671	1	21	80	0.2625000
NODE_6801_length_990_cov_39.386083	402	482	4	18	80	0.2250000
NODE_6801_length_990_cov_39.386083	402	482	6	7	80	0.0875000
NODE_6801_length_990_cov_39.386083	402	482	7	23	80	0.2875000
NODE_6801_length_990_cov_39.386083	402	482	8	32	80	0.4000000
NODE_6801_length_990_cov_39.386083	455	535	5	14	80	0.1750000
NODE_6801_length_990_cov_39.386083	455	535	7	33	80	0.4125000
NODE_6801_length_990_cov_39.386083	455	535	8	33	80	0.4125000
NODE_6802_length_990_cov_35.993266	321	401	3	14	80	0.1750000
NODE_6802_length_990_cov_35.993266	321	401	4	6	80	0.0750000
NODE_6802_length_990_cov_35.993266	321	401	5	29	80	0.3625000
NODE_6802_length_990_cov_35.993266	321	401	6	25	80	0.3125000
NODE_6802_length_990_cov_35.993266	321	401	7	6	80	0.0750000
NODE_6802_length_990_cov_35.993266	374	454	6	21	80	0.2625000
NODE_6802_length_990_cov_35.993266	374	454	7	10	80	0.1250000
NODE_6802_length_990_cov_35.993266	374	454	9	5	80	0.0625000
NODE_6802_length_990_cov_35.993266	374	454	10	8	80	0.1000000
NODE_6802_length_990_cov_35.993266	374	454	11	10	80	0.1250000
NODE_6802_length_990_cov_35.993266	374	454	12	1	80	0.0125000
NODE_6802_length_990_cov_35.993266	374	454	13	14	80	0.1750000
NODE_6802_length_990_cov_35.993266	374	454	15	11	80	0.1375000
NODE_6802_length_990_cov_35.993266	450	530	13	1	80	0.0125000
NODE_6802_length_990_cov_35.993266	450	530	15	11	80	0.1375000
NODE_6802_length_990_cov_35.993266	450	530	16	15	80	0.1875000
NODE_6802_length_990_cov_35.993266	450	530	17	15	80	0.1875000
NODE_6802_length_990_cov_35.993266	450	530	18	23	80	0.2875000
NODE_6802_length_990_cov_35.993266	450	530	19	15	80	0.1875000
NODE_6802_length_990_cov_35.993266	503	583	11	4	80	0.0500000
NODE_6802_length_990_cov_35.993266	503	583	12	1	80	0.0125000
NODE_6802_length_990_cov_35.993266	503	583	13	10	80	0.1250000
NODE_6802_length_990_cov_35.993266	503	583	14	8	80	0.1000000
NODE_6802_length_990_cov_35.993266	503	583	15	9	80	0.1125000
NODE_6802_length_990_cov_35.993266	503	583	17	6	80	0.0750000
NODE_6802_length_990_cov_35.993266	503	583	18	27	80	0.3375000
NODE_6802_length_990_cov_35.993266	503	583	19	15	80	0.1875000
NODE_6803_length_990_cov_24.445567	588	668	3	15	80	0.1875000
NODE_6803_length_990_cov_24.445567	588	668	4	65	80	0.8125000
NODE_6803_length_990_cov_24.445567	641	721	3	31	80	0.3875000
NODE_6803_length_990_cov_24.445567	641	721	4	49	80	0.6125000
NODE_6805_length_990_cov_22.378227	430	510	0	80	80	1.0000000
NODE_6805_length_990_cov_22.378227	483	563	0	80	80	1.0000000
NODE_6806_length_990_cov_20.150393	408	488	1	24	80	0.3000000
NODE_6806_length_990_cov_20.150393	408	488	2	30	80	0.3750000
NODE_6806_length_990_cov_20.150393	408	488	3	26	80	0.3250000
NODE_6806_length_990_cov_20.150393	461	541	2	25	80	0.3125000
NODE_6806_length_990_cov_20.150393	461	541	3	55	80	0.6875000
NODE_6807_length_990_cov_18.154882	434	514	7	7	80	0.0875000
NODE_6807_length_990_cov_18.154882	434	514	9	1	80	0.0125000
NODE_6807_length_990_cov_18.154882	434	514	10	22	80	0.2750000
NODE_6807_length_990_cov_18.154882	434	514	11	18	80	0.2250000
NODE_6807_length_990_cov_18.154882	434	514	12	32	80	0.4000000
NODE_6807_length_990_cov_18.154882	487	567	6	4	80	0.0500000
NODE_6807_length_990_cov_18.154882	487	567	7	46	80	0.5750000
NODE_6807_length_990_cov_18.154882	487	567	8	10	80	0.1250000
NODE_6807_length_990_cov_18.154882	487	567	9	1	80	0.0125000
NODE_6807_length_990_cov_18.154882	487	567	10	1	80	0.0125000
NODE_6807_length_990_cov_18.154882	487	567	11	18	80	0.2250000
NODE_6808_length_990_cov_17.250281	329	409	3	80	80	1.0000000
NODE_6808_length_990_cov_17.250281	382	462	1	20	80	0.2500000
NODE_6808_length_990_cov_17.250281	382	462	3	53	80	0.6625000
NODE_6808_length_990_cov_17.250281	382	462	4	7	80	0.0875000
NODE_6808_length_990_cov_17.250281	458	538	1	19	80	0.2375000
NODE_6808_length_990_cov_17.250281	458	538	2	10	80	0.1250000
NODE_6808_length_990_cov_17.250281	458	538	3	15	80	0.1875000
NODE_6808_length_990_cov_17.250281	458	538	4	28	80	0.3500000
NODE_6808_length_990_cov_17.250281	458	538	5	8	80	0.1000000
NODE_6808_length_990_cov_17.250281	511	591	4	19	80	0.2375000
NODE_6808_length_990_cov_17.250281	511	591	5	24	80	0.3000000
NODE_6808_length_990_cov_17.250281	511	591	7	16	80	0.2000000
NODE_6808_length_990_cov_17.250281	511	591	8	21	80	0.2625000
NODE_6809_length_990_cov_14.977553	448	528	2	52	80	0.6500000
NODE_6809_length_990_cov_14.977553	448	528	3	28	80	0.3500000
NODE_6809_length_990_cov_14.977553	501	581	2	41	80	0.5125000
NODE_6809_length_990_cov_14.977553	501	581	3	39	80	0.4875000
NODE_6810_length_990_cov_13.846240	482	562	2	48	80	0.6000000
NODE_6810_length_990_cov_13.846240	482	562	4	32	80	0.4000000
NODE_6810_length_990_cov_13.846240	535	615	0	14	80	0.1750000
NODE_6810_length_990_cov_13.846240	535	615	2	66	80	0.8250000
NODE_6821_length_990_cov_0.978676	79	151	0	72	72	1.0000000
NODE_6821_length_990_cov_0.978676	82	152	0	70	70	1.0000000
NODE_6823_length_989_cov_45.902247	47	127	0	80	80	1.0000000
NODE_6823_length_989_cov_45.902247	330	410	4	4	80	0.0500000
NODE_6823_length_989_cov_45.902247	330	410	7	13	80	0.1625000
NODE_6823_length_989_cov_45.902247	330	410	9	1	80	0.0125000
NODE_6823_length_989_cov_45.902247	330	410	10	41	80	0.5125000
NODE_6823_length_989_cov_45.902247	330	410	11	10	80	0.1250000
NODE_6823_length_989_cov_45.902247	330	410	12	7	80	0.0875000
NODE_6823_length_989_cov_45.902247	330	410	14	4	80	0.0500000
NODE_6823_length_989_cov_45.902247	383	463	1	6	80	0.0750000
NODE_6823_length_989_cov_45.902247	383	463	2	33	80	0.4125000
NODE_6823_length_989_cov_45.902247	383	463	4	18	80	0.2250000
NODE_6823_length_989_cov_45.902247	383	463	7	13	80	0.1625000
NODE_6823_length_989_cov_45.902247	383	463	9	1	80	0.0125000
NODE_6823_length_989_cov_45.902247	383	463	10	9	80	0.1125000
NODE_6824_length_989_cov_35.430337	412	492	2	80	80	1.0000000
NODE_6824_length_989_cov_35.430337	465	545	0	6	80	0.0750000
NODE_6824_length_989_cov_35.430337	465	545	1	23	80	0.2875000
NODE_6824_length_989_cov_35.430337	465	545	2	51	80	0.6375000
NODE_6825_length_989_cov_30.124719	477	557	4	2	80	0.0250000
NODE_6825_length_989_cov_30.124719	477	557	6	54	80	0.6750000
NODE_6825_length_989_cov_30.124719	477	557	7	1	80	0.0125000
NODE_6825_length_989_cov_30.124719	477	557	8	22	80	0.2750000
NODE_6825_length_989_cov_30.124719	477	557	9	1	80	0.0125000
NODE_6825_length_989_cov_30.124719	530	610	4	8	80	0.1000000
NODE_6825_length_989_cov_30.124719	530	610	6	51	80	0.6375000
NODE_6825_length_989_cov_30.124719	530	610	8	7	80	0.0875000
NODE_6825_length_989_cov_30.124719	530	610	10	14	80	0.1750000
NODE_6826_length_989_cov_29.347191	447	527	0	80	80	1.0000000
NODE_6826_length_989_cov_29.347191	500	580	0	80	80	1.0000000
NODE_6826_length_989_cov_29.347191	576	656	0	80	80	1.0000000
NODE_6826_length_989_cov_29.347191	629	709	0	80	80	1.0000000
NODE_6827_length_989_cov_27.886517	245	325	1	5	80	0.0625000
NODE_6827_length_989_cov_27.886517	245	325	2	43	80	0.5375000
NODE_6827_length_989_cov_27.886517	245	325	3	25	80	0.3125000
NODE_6827_length_989_cov_27.886517	245	325	4	7	80	0.0875000
NODE_6827_length_989_cov_27.886517	298	378	3	20	80	0.2500000
NODE_6827_length_989_cov_27.886517	298	378	4	54	80	0.6750000
NODE_6827_length_989_cov_27.886517	298	378	5	6	80	0.0750000
NODE_6827_length_989_cov_27.886517	374	454	4	21	80	0.2625000
NODE_6827_length_989_cov_27.886517	374	454	5	11	80	0.1375000
NODE_6827_length_989_cov_27.886517	374	454	6	40	80	0.5000000
NODE_6827_length_989_cov_27.886517	374	454	7	8	80	0.1000000
NODE_6827_length_989_cov_27.886517	427	507	3	10	80	0.1250000
NODE_6827_length_989_cov_27.886517	427	507	4	29	80	0.3625000
NODE_6827_length_989_cov_27.886517	427	507	5	25	80	0.3125000
NODE_6827_length_989_cov_27.886517	427	507	6	16	80	0.2000000
NODE_6828_length_989_cov_27.515730	393	473	5	66	80	0.8250000
NODE_6828_length_989_cov_27.515730	393	473	6	14	80	0.1750000
NODE_6828_length_989_cov_27.515730	446	526	0	31	80	0.3875000
NODE_6828_length_989_cov_27.515730	446	526	3	2	80	0.0250000
NODE_6828_length_989_cov_27.515730	446	526	5	47	80	0.5875000
NODE_6828_length_989_cov_27.515730	522	602	0	74	80	0.9250000
NODE_6828_length_989_cov_27.515730	522	602	1	6	80	0.0750000
NODE_6828_length_989_cov_27.515730	575	655	0	21	80	0.2625000
NODE_6828_length_989_cov_27.515730	575	655	1	46	80	0.5750000
NODE_6828_length_989_cov_27.515730	575	655	2	13	80	0.1625000
NODE_6829_length_989_cov_23.844944	312	392	5	34	80	0.4250000
NODE_6829_length_989_cov_23.844944	312	392	6	46	80	0.5750000
NODE_6829_length_989_cov_23.844944	365	445	6	52	80	0.6500000
NODE_6829_length_989_cov_23.844944	365	445	7	28	80	0.3500000
NODE_6830_length_989_cov_23.131461	475	555	1	48	80	0.6000000
NODE_6830_length_989_cov_23.131461	475	555	2	32	80	0.4000000
NODE_6830_length_989_cov_23.131461	528	608	2	80	80	1.0000000
NODE_6831_length_989_cov_20.189888	500	580	3	13	80	0.1625000
NODE_6831_length_989_cov_20.189888	500	580	5	38	80	0.4750000
NODE_6831_length_989_cov_20.189888	500	580	6	29	80	0.3625000
NODE_6831_length_989_cov_20.189888	553	633	3	11	80	0.1375000
NODE_6831_length_989_cov_20.189888	553	633	4	22	80	0.2750000
NODE_6831_length_989_cov_20.189888	553	633	6	47	80	0.5875000
NODE_6832_length_989_cov_18.429213	190	270	16	6	80	0.0750000
NODE_6832_length_989_cov_18.429213	190	270	17	23	80	0.2875000
NODE_6832_length_989_cov_18.429213	190	270	18	51	80	0.6375000
NODE_6832_length_989_cov_18.429213	258	323	13	6	65	0.0923077
NODE_6832_length_989_cov_18.429213	258	323	14	16	65	0.2461538
NODE_6832_length_989_cov_18.429213	258	323	15	11	65	0.1692308
NODE_6832_length_989_cov_18.429213	258	323	16	26	65	0.4000000
NODE_6832_length_989_cov_18.429213	258	323	18	6	65	0.0923077
NODE_6832_length_989_cov_18.429213	319	399	5	52	80	0.6500000
NODE_6832_length_989_cov_18.429213	319	399	7	9	80	0.1125000
NODE_6832_length_989_cov_18.429213	319	399	12	2	80	0.0250000
NODE_6832_length_989_cov_18.429213	319	399	13	14	80	0.1750000
NODE_6832_length_989_cov_18.429213	319	399	14	3	80	0.0375000
NODE_6832_length_989_cov_18.429213	372	412	5	27	40	0.6750000
NODE_6832_length_989_cov_18.429213	372	412	6	13	40	0.3250000
NODE_6833_length_989_cov_10.307865	433	513	3	80	80	1.0000000
NODE_6833_length_989_cov_10.307865	486	570	0	4	84	0.0476190
NODE_6833_length_989_cov_10.307865	486	570	2	21	84	0.2500000
NODE_6833_length_989_cov_10.307865	486	570	3	59	84	0.7023810
NODE_6833_length_989_cov_10.307865	566	642	0	31	76	0.4078947
NODE_6833_length_989_cov_10.307865	566	642	2	15	76	0.1973684
NODE_6833_length_989_cov_10.307865	566	642	4	4	76	0.0526316
NODE_6833_length_989_cov_10.307865	566	642	7	26	76	0.3421053
NODE_6833_length_989_cov_10.307865	615	695	4	1	80	0.0125000
NODE_6833_length_989_cov_10.307865	615	695	7	46	80	0.5750000
NODE_6833_length_989_cov_10.307865	615	695	9	33	80	0.4125000
NODE_6834_length_989_cov_8.941573	528	608	8	23	80	0.2875000
NODE_6834_length_989_cov_8.941573	528	608	10	1	80	0.0125000
NODE_6834_length_989_cov_8.941573	528	608	11	23	80	0.2875000
NODE_6834_length_989_cov_8.941573	528	608	12	33	80	0.4125000
NODE_6834_length_989_cov_8.941573	581	661	4	9	80	0.1125000
NODE_6834_length_989_cov_8.941573	581	661	8	58	80	0.7250000
NODE_6834_length_989_cov_8.941573	581	661	9	9	80	0.1125000
NODE_6834_length_989_cov_8.941573	581	661	11	4	80	0.0500000
NODE_6835_length_989_cov_5.132584	459	524	0	65	65	1.0000000
NODE_6838_length_989_cov_2.540449	703	783	6	80	80	1.0000000
NODE_6845_length_988_cov_52.168729	361	441	5	6	80	0.0750000
NODE_6845_length_988_cov_52.168729	361	441	6	2	80	0.0250000
NODE_6845_length_988_cov_52.168729	361	441	12	1	80	0.0125000
NODE_6845_length_988_cov_52.168729	361	441	13	6	80	0.0750000
NODE_6845_length_988_cov_52.168729	361	441	14	1	80	0.0125000
NODE_6845_length_988_cov_52.168729	361	441	15	13	80	0.1625000
NODE_6845_length_988_cov_52.168729	361	441	16	3	80	0.0375000
NODE_6845_length_988_cov_52.168729	361	441	17	48	80	0.6000000
NODE_6845_length_988_cov_52.168729	414	494	4	11	80	0.1375000
NODE_6845_length_988_cov_52.168729	414	494	5	20	80	0.2500000
NODE_6845_length_988_cov_52.168729	414	494	6	2	80	0.0250000
NODE_6845_length_988_cov_52.168729	414	494	7	1	80	0.0125000
NODE_6845_length_988_cov_52.168729	414	494	8	2	80	0.0250000
NODE_6845_length_988_cov_52.168729	414	494	9	14	80	0.1750000
NODE_6845_length_988_cov_52.168729	414	494	12	1	80	0.0125000
NODE_6845_length_988_cov_52.168729	414	494	13	6	80	0.0750000
NODE_6845_length_988_cov_52.168729	414	494	14	1	80	0.0125000
NODE_6845_length_988_cov_52.168729	414	494	15	11	80	0.1375000
NODE_6845_length_988_cov_52.168729	414	494	17	11	80	0.1375000
NODE_6845_length_988_cov_52.168729	490	570	17	52	80	0.6500000
NODE_6845_length_988_cov_52.168729	490	570	18	28	80	0.3500000
NODE_6845_length_988_cov_52.168729	543	623	2	9	80	0.1125000
NODE_6845_length_988_cov_52.168729	543	623	15	4	80	0.0500000
NODE_6845_length_988_cov_52.168729	543	623	18	38	80	0.4750000
NODE_6845_length_988_cov_52.168729	543	623	19	29	80	0.3625000
NODE_6846_length_988_cov_36.733408	390	470	11	14	80	0.1750000
NODE_6846_length_988_cov_36.733408	390	470	17	16	80	0.2000000
NODE_6846_length_988_cov_36.733408	390	470	19	21	80	0.2625000
NODE_6846_length_988_cov_36.733408	390	470	21	4	80	0.0500000
NODE_6846_length_988_cov_36.733408	390	470	22	14	80	0.1750000
NODE_6846_length_988_cov_36.733408	390	470	24	11	80	0.1375000
NODE_6846_length_988_cov_36.733408	443	523	15	1	80	0.0125000
NODE_6846_length_988_cov_36.733408	443	523	16	1	80	0.0125000
NODE_6846_length_988_cov_36.733408	443	523	17	8	80	0.1000000
NODE_6846_length_988_cov_36.733408	443	523	19	6	80	0.0750000
NODE_6846_length_988_cov_36.733408	443	523	20	21	80	0.2625000
NODE_6846_length_988_cov_36.733408	443	523	21	2	80	0.0250000
NODE_6846_length_988_cov_36.733408	443	523	22	14	80	0.1750000
NODE_6846_length_988_cov_36.733408	443	523	24	27	80	0.3375000
NODE_6847_length_988_cov_36.221597	478	558	6	14	80	0.1750000
NODE_6847_length_988_cov_36.221597	478	558	7	11	80	0.1375000
NODE_6847_length_988_cov_36.221597	478	558	8	2	80	0.0250000
NODE_6847_length_988_cov_36.221597	478	558	9	7	80	0.0875000
NODE_6847_length_988_cov_36.221597	478	558	10	4	80	0.0500000
NODE_6847_length_988_cov_36.221597	478	558	11	39	80	0.4875000
NODE_6847_length_988_cov_36.221597	478	558	12	3	80	0.0375000
NODE_6847_length_988_cov_36.221597	531	611	11	43	80	0.5375000
NODE_6847_length_988_cov_36.221597	531	611	12	14	80	0.1750000
NODE_6847_length_988_cov_36.221597	531	611	13	18	80	0.2250000
NODE_6847_length_988_cov_36.221597	531	611	14	1	80	0.0125000
NODE_6847_length_988_cov_36.221597	531	611	15	4	80	0.0500000
NODE_6848_length_988_cov_25.895388	389	469	2	11	80	0.1375000
NODE_6848_length_988_cov_25.895388	389	469	3	59	80	0.7375000
NODE_6848_length_988_cov_25.895388	389	469	6	1	80	0.0125000
NODE_6848_length_988_cov_25.895388	389	469	7	9	80	0.1125000
NODE_6848_length_988_cov_25.895388	442	522	3	17	80	0.2125000
NODE_6848_length_988_cov_25.895388	442	522	6	1	80	0.0125000
NODE_6848_length_988_cov_25.895388	442	522	7	29	80	0.3625000
NODE_6848_length_988_cov_25.895388	442	522	8	6	80	0.0750000
NODE_6848_length_988_cov_25.895388	442	522	9	27	80	0.3375000
NODE_6848_length_988_cov_25.895388	518	598	7	40	80	0.5000000
NODE_6848_length_988_cov_25.895388	518	598	8	3	80	0.0375000
NODE_6848_length_988_cov_25.895388	518	598	11	2	80	0.0250000
NODE_6848_length_988_cov_25.895388	518	598	12	35	80	0.4375000
NODE_6848_length_988_cov_25.895388	571	651	6	28	80	0.3500000
NODE_6848_length_988_cov_25.895388	571	651	7	1	80	0.0125000
NODE_6848_length_988_cov_25.895388	571	651	8	13	80	0.1625000
NODE_6848_length_988_cov_25.895388	571	651	11	1	80	0.0125000
NODE_6848_length_988_cov_25.895388	571	651	12	37	80	0.4625000
NODE_6849_length_988_cov_20.250844	423	503	5	15	80	0.1875000
NODE_6849_length_988_cov_20.250844	423	503	6	50	80	0.6250000
NODE_6849_length_988_cov_20.250844	423	503	7	15	80	0.1875000
NODE_6849_length_988_cov_20.250844	476	556	4	4	80	0.0500000
NODE_6849_length_988_cov_20.250844	476	556	5	1	80	0.0125000
NODE_6849_length_988_cov_20.250844	476	556	6	75	80	0.9375000
NODE_6850_length_988_cov_15.812148	474	554	4	68	80	0.8500000
NODE_6850_length_988_cov_15.812148	474	554	6	3	80	0.0375000
NODE_6850_length_988_cov_15.812148	474	554	8	9	80	0.1125000
NODE_6850_length_988_cov_15.812148	527	607	4	25	80	0.3125000
NODE_6850_length_988_cov_15.812148	527	607	6	5	80	0.0625000
NODE_6850_length_988_cov_15.812148	527	607	8	50	80	0.6250000
NODE_6851_length_988_cov_15.082115	435	517	2	9	82	0.1097561
NODE_6851_length_988_cov_15.082115	435	517	3	17	82	0.2073171
NODE_6851_length_988_cov_15.082115	435	517	4	35	82	0.4268293
NODE_6851_length_988_cov_15.082115	435	517	5	2	82	0.0243902
NODE_6851_length_988_cov_15.082115	435	517	6	19	82	0.2317073
NODE_6851_length_988_cov_15.082115	490	570	4	7	80	0.0875000
NODE_6851_length_988_cov_15.082115	490	570	5	1	80	0.0125000
NODE_6851_length_988_cov_15.082115	490	570	6	72	80	0.9000000
NODE_6852_length_988_cov_14.697413	467	547	4	12	80	0.1500000
NODE_6852_length_988_cov_14.697413	467	547	6	9	80	0.1125000
NODE_6852_length_988_cov_14.697413	467	547	8	52	80	0.6500000
NODE_6852_length_988_cov_14.697413	467	547	10	7	80	0.0875000
NODE_6852_length_988_cov_14.697413	520	600	7	37	80	0.4625000
NODE_6852_length_988_cov_14.697413	520	600	8	29	80	0.3625000
NODE_6852_length_988_cov_14.697413	520	600	10	7	80	0.0875000
NODE_6852_length_988_cov_14.697413	520	600	11	7	80	0.0875000
NODE_6853_length_988_cov_7.730034	562	642	0	7	80	0.0875000
NODE_6853_length_988_cov_7.730034	562	642	2	73	80	0.9125000
NODE_6853_length_988_cov_7.730034	615	695	0	60	80	0.7500000
NODE_6853_length_988_cov_7.730034	615	695	2	20	80	0.2500000
NODE_6862_length_987_cov_42.784910	383	476	15	22	93	0.2365591
NODE_6862_length_987_cov_42.784910	383	476	16	10	93	0.1075269
NODE_6862_length_987_cov_42.784910	383	476	19	21	93	0.2258064
NODE_6862_length_987_cov_42.784910	383	476	20	5	93	0.0537634
NODE_6862_length_987_cov_42.784910	383	476	21	12	93	0.1290323
NODE_6862_length_987_cov_42.784910	383	476	23	16	93	0.1720430
NODE_6862_length_987_cov_42.784910	383	476	25	1	93	0.0107527
NODE_6862_length_987_cov_42.784910	383	476	26	3	93	0.0322581
NODE_6862_length_987_cov_42.784910	383	476	30	2	93	0.0215054
NODE_6862_length_987_cov_42.784910	383	476	31	1	93	0.0107527
NODE_6862_length_987_cov_42.784910	449	529	16	5	80	0.0625000
NODE_6862_length_987_cov_42.784910	449	529	19	6	80	0.0750000
NODE_6862_length_987_cov_42.784910	449	529	21	9	80	0.1125000
NODE_6862_length_987_cov_42.784910	449	529	25	1	80	0.0125000
NODE_6862_length_987_cov_42.784910	449	529	26	3	80	0.0375000
NODE_6862_length_987_cov_42.784910	449	529	28	3	80	0.0375000
NODE_6862_length_987_cov_42.784910	449	529	30	2	80	0.0250000
NODE_6862_length_987_cov_42.784910	449	529	31	4	80	0.0500000
NODE_6862_length_987_cov_42.784910	449	529	35	20	80	0.2500000
NODE_6862_length_987_cov_42.784910	449	529	36	27	80	0.3375000
NODE_6863_length_987_cov_39.716216	290	370	5	2	80	0.0250000
NODE_6863_length_987_cov_39.716216	290	370	10	12	80	0.1500000
NODE_6863_length_987_cov_39.716216	290	370	11	15	80	0.1875000
NODE_6863_length_987_cov_39.716216	290	370	13	2	80	0.0250000
NODE_6863_length_987_cov_39.716216	290	370	15	17	80	0.2125000
NODE_6863_length_987_cov_39.716216	290	370	18	3	80	0.0375000
NODE_6863_length_987_cov_39.716216	290	370	20	16	80	0.2000000
NODE_6863_length_987_cov_39.716216	290	370	23	4	80	0.0500000
NODE_6863_length_987_cov_39.716216	290	370	24	9	80	0.1125000
NODE_6863_length_987_cov_39.716216	343	423	20	14	80	0.1750000
NODE_6863_length_987_cov_39.716216	343	423	22	7	80	0.0875000
NODE_6863_length_987_cov_39.716216	343	423	23	8	80	0.1000000
NODE_6863_length_987_cov_39.716216	343	423	24	29	80	0.3625000
NODE_6863_length_987_cov_39.716216	343	423	25	22	80	0.2750000
NODE_6863_length_987_cov_39.716216	419	499	12	1	80	0.0125000
NODE_6863_length_987_cov_39.716216	419	499	13	7	80	0.0875000
NODE_6863_length_987_cov_39.716216	419	499	14	16	80	0.2000000
NODE_6863_length_987_cov_39.716216	419	499	16	4	80	0.0500000
NODE_6863_length_987_cov_39.716216	419	499	17	2	80	0.0250000
NODE_6863_length_987_cov_39.716216	419	499	18	1	80	0.0125000
NODE_6863_length_987_cov_39.716216	419	499	19	14	80	0.1750000
NODE_6863_length_987_cov_39.716216	419	499	20	12	80	0.1500000
NODE_6863_length_987_cov_39.716216	419	499	25	23	80	0.2875000
NODE_6863_length_987_cov_39.716216	472	552	7	12	80	0.1500000
NODE_6863_length_987_cov_39.716216	472	552	8	3	80	0.0375000
NODE_6863_length_987_cov_39.716216	472	552	10	12	80	0.1500000
NODE_6863_length_987_cov_39.716216	472	552	11	18	80	0.2250000
NODE_6863_length_987_cov_39.716216	472	552	12	1	80	0.0125000
NODE_6863_length_987_cov_39.716216	472	552	13	15	80	0.1875000
NODE_6863_length_987_cov_39.716216	472	552	14	15	80	0.1875000
NODE_6863_length_987_cov_39.716216	472	552	16	2	80	0.0250000
NODE_6863_length_987_cov_39.716216	472	552	17	2	80	0.0250000
NODE_6864_length_987_cov_28.171171	406	486	3	2	80	0.0250000
NODE_6864_length_987_cov_28.171171	406	486	4	20	80	0.2500000
NODE_6864_length_987_cov_28.171171	406	486	5	34	80	0.4250000
NODE_6864_length_987_cov_28.171171	406	486	6	23	80	0.2875000
NODE_6864_length_987_cov_28.171171	406	486	7	1	80	0.0125000
NODE_6864_length_987_cov_28.171171	459	539	5	3	80	0.0375000
NODE_6864_length_987_cov_28.171171	459	539	6	27	80	0.3375000
NODE_6864_length_987_cov_28.171171	459	539	7	25	80	0.3125000
NODE_6864_length_987_cov_28.171171	459	539	8	10	80	0.1250000
NODE_6864_length_987_cov_28.171171	459	539	9	4	80	0.0500000
NODE_6864_length_987_cov_28.171171	459	539	12	1	80	0.0125000
NODE_6864_length_987_cov_28.171171	459	539	13	10	80	0.1250000
NODE_6864_length_987_cov_28.171171	535	615	13	27	80	0.3375000
NODE_6864_length_987_cov_28.171171	535	615	14	13	80	0.1625000
NODE_6864_length_987_cov_28.171171	535	615	15	1	80	0.0125000
NODE_6864_length_987_cov_28.171171	535	615	16	3	80	0.0375000
NODE_6864_length_987_cov_28.171171	535	615	17	12	80	0.1500000
NODE_6864_length_987_cov_28.171171	535	615	18	19	80	0.2375000
NODE_6864_length_987_cov_28.171171	535	615	19	5	80	0.0625000
NODE_6864_length_987_cov_28.171171	588	668	17	3	80	0.0375000
NODE_6864_length_987_cov_28.171171	588	668	18	37	80	0.4625000
NODE_6864_length_987_cov_28.171171	588	668	19	21	80	0.2625000
NODE_6864_length_987_cov_28.171171	588	668	20	19	80	0.2375000
NODE_6865_length_987_cov_23.627252	331	411	9	37	80	0.4625000
NODE_6865_length_987_cov_23.627252	331	411	10	13	80	0.1625000
NODE_6865_length_987_cov_23.627252	331	411	11	30	80	0.3750000
NODE_6865_length_987_cov_23.627252	384	464	5	5	80	0.0625000
NODE_6865_length_987_cov_23.627252	384	464	6	18	80	0.2250000
NODE_6865_length_987_cov_23.627252	384	464	7	9	80	0.1125000
NODE_6865_length_987_cov_23.627252	384	464	8	5	80	0.0625000
NODE_6865_length_987_cov_23.627252	384	464	9	10	80	0.1250000
NODE_6865_length_987_cov_23.627252	384	464	10	20	80	0.2500000
NODE_6865_length_987_cov_23.627252	384	464	11	13	80	0.1625000
NODE_6866_length_987_cov_18.797297	437	517	6	8	80	0.1000000
NODE_6866_length_987_cov_18.797297	437	517	7	40	80	0.5000000
NODE_6866_length_987_cov_18.797297	437	517	8	32	80	0.4000000
NODE_6866_length_987_cov_18.797297	490	570	2	2	80	0.0250000
NODE_6866_length_987_cov_18.797297	490	570	3	17	80	0.2125000
NODE_6866_length_987_cov_18.797297	490	570	4	9	80	0.1125000
NODE_6866_length_987_cov_18.797297	490	570	5	18	80	0.2250000
NODE_6866_length_987_cov_18.797297	490	570	6	11	80	0.1375000
NODE_6866_length_987_cov_18.797297	490	570	7	2	80	0.0250000
NODE_6866_length_987_cov_18.797297	490	570	8	21	80	0.2625000
NODE_6867_length_987_cov_15.628378	369	449	7	20	80	0.2500000
NODE_6867_length_987_cov_15.628378	369	449	8	29	80	0.3625000
NODE_6867_length_987_cov_15.628378	369	449	9	20	80	0.2500000
NODE_6867_length_987_cov_15.628378	369	449	11	11	80	0.1375000
NODE_6867_length_987_cov_15.628378	422	502	6	1	80	0.0125000
NODE_6867_length_987_cov_15.628378	422	502	7	45	80	0.5625000
NODE_6867_length_987_cov_15.628378	422	502	8	16	80	0.2000000
NODE_6867_length_987_cov_15.628378	422	502	9	18	80	0.2250000
NODE_6868_length_987_cov_15.439189	438	518	7	8	80	0.1000000
NODE_6868_length_987_cov_15.439189	438	518	8	18	80	0.2250000
NODE_6868_length_987_cov_15.439189	438	518	10	3	80	0.0375000
NODE_6868_length_987_cov_15.439189	438	518	11	10	80	0.1250000
NODE_6868_length_987_cov_15.439189	438	518	12	2	80	0.0250000
NODE_6868_length_987_cov_15.439189	438	518	13	30	80	0.3750000
NODE_6868_length_987_cov_15.439189	438	518	14	9	80	0.1125000
NODE_6868_length_987_cov_15.439189	491	571	13	21	80	0.2625000
NODE_6868_length_987_cov_15.439189	491	571	14	10	80	0.1250000
NODE_6868_length_987_cov_15.439189	491	571	15	22	80	0.2750000
NODE_6868_length_987_cov_15.439189	491	571	16	19	80	0.2375000
NODE_6868_length_987_cov_15.439189	491	571	17	1	80	0.0125000
NODE_6868_length_987_cov_15.439189	491	571	18	2	80	0.0250000
NODE_6868_length_987_cov_15.439189	491	571	19	5	80	0.0625000
NODE_6869_length_987_cov_14.343468	506	586	0	80	80	1.0000000
NODE_6869_length_987_cov_14.343468	559	639	0	80	80	1.0000000
NODE_6870_length_987_cov_13.515766	475	555	7	5	80	0.0625000
NODE_6870_length_987_cov_13.515766	475	555	8	27	80	0.3375000
NODE_6870_length_987_cov_13.515766	475	555	9	24	80	0.3000000
NODE_6870_length_987_cov_13.515766	475	555	11	2	80	0.0250000
NODE_6870_length_987_cov_13.515766	475	555	14	14	80	0.1750000
NODE_6870_length_987_cov_13.515766	475	555	15	3	80	0.0375000
NODE_6870_length_987_cov_13.515766	475	555	16	5	80	0.0625000
NODE_6870_length_987_cov_13.515766	528	608	9	3	80	0.0375000
NODE_6870_length_987_cov_13.515766	528	608	11	2	80	0.0250000
NODE_6870_length_987_cov_13.515766	528	608	14	26	80	0.3250000
NODE_6870_length_987_cov_13.515766	528	608	15	8	80	0.1000000
NODE_6870_length_987_cov_13.515766	528	608	16	13	80	0.1625000
NODE_6870_length_987_cov_13.515766	528	608	18	3	80	0.0375000
NODE_6870_length_987_cov_13.515766	528	608	19	25	80	0.3125000
NODE_6871_length_987_cov_9.521396	408	482	8	4	74	0.0540541
NODE_6871_length_987_cov_9.521396	408	482	9	64	74	0.8648649
NODE_6871_length_987_cov_9.521396	408	482	10	5	74	0.0675676
NODE_6871_length_987_cov_9.521396	408	482	11	1	74	0.0135135
NODE_6871_length_987_cov_9.521396	455	535	1	26	80	0.3250000
NODE_6871_length_987_cov_9.521396	455	535	2	11	80	0.1375000
NODE_6871_length_987_cov_9.521396	455	535	4	4	80	0.0500000
NODE_6871_length_987_cov_9.521396	455	535	5	2	80	0.0250000
NODE_6871_length_987_cov_9.521396	455	535	6	4	80	0.0500000
NODE_6871_length_987_cov_9.521396	455	535	7	5	80	0.0625000
NODE_6871_length_987_cov_9.521396	455	535	8	5	80	0.0625000
NODE_6871_length_987_cov_9.521396	455	535	9	23	80	0.2875000
NODE_6872_length_987_cov_9.054054	440	520	0	39	80	0.4875000
NODE_6872_length_987_cov_9.054054	440	520	4	41	80	0.5125000
NODE_6872_length_987_cov_9.054054	493	573	4	80	80	1.0000000
NODE_6875_length_987_cov_5.378378	509	589	0	80	80	1.0000000
NODE_6875_length_987_cov_5.378378	562	642	0	80	80	1.0000000
NODE_6889_length_986_cov_36.937993	327	407	4	20	80	0.2500000
NODE_6889_length_986_cov_36.937993	327	407	8	40	80	0.5000000
NODE_6889_length_986_cov_36.937993	327	407	9	13	80	0.1625000
NODE_6889_length_986_cov_36.937993	327	407	10	7	80	0.0875000
NODE_6889_length_986_cov_36.937993	380	460	8	13	80	0.1625000
NODE_6889_length_986_cov_36.937993	380	460	9	24	80	0.3000000
NODE_6889_length_986_cov_36.937993	380	460	10	27	80	0.3375000
NODE_6889_length_986_cov_36.937993	380	460	11	16	80	0.2000000
NODE_6889_length_986_cov_36.937993	456	536	10	8	80	0.1000000
NODE_6889_length_986_cov_36.937993	456	536	14	1	80	0.0125000
NODE_6889_length_986_cov_36.937993	456	536	15	3	80	0.0375000
NODE_6889_length_986_cov_36.937993	456	536	16	23	80	0.2875000
NODE_6889_length_986_cov_36.937993	456	536	17	23	80	0.2875000
NODE_6889_length_986_cov_36.937993	456	536	18	15	80	0.1875000
NODE_6889_length_986_cov_36.937993	456	536	19	2	80	0.0250000
NODE_6889_length_986_cov_36.937993	456	536	20	5	80	0.0625000
NODE_6889_length_986_cov_36.937993	509	589	15	1	80	0.0125000
NODE_6889_length_986_cov_36.937993	509	589	16	24	80	0.3000000
NODE_6889_length_986_cov_36.937993	509	589	17	15	80	0.1875000
NODE_6889_length_986_cov_36.937993	509	589	18	38	80	0.4750000
NODE_6889_length_986_cov_36.937993	509	589	19	2	80	0.0250000
NODE_6890_length_986_cov_35.130778	325	405	7	27	80	0.3375000
NODE_6890_length_986_cov_35.130778	325	405	9	26	80	0.3250000
NODE_6890_length_986_cov_35.130778	325	405	10	16	80	0.2000000
NODE_6890_length_986_cov_35.130778	325	405	11	7	80	0.0875000
NODE_6890_length_986_cov_35.130778	325	405	12	4	80	0.0500000
NODE_6890_length_986_cov_35.130778	378	458	10	16	80	0.2000000
NODE_6890_length_986_cov_35.130778	378	458	11	8	80	0.1000000
NODE_6890_length_986_cov_35.130778	378	458	12	16	80	0.2000000
NODE_6890_length_986_cov_35.130778	378	458	13	2	80	0.0250000
NODE_6890_length_986_cov_35.130778	378	458	14	30	80	0.3750000
NODE_6890_length_986_cov_35.130778	378	458	16	8	80	0.1000000
NODE_6890_length_986_cov_35.130778	454	534	9	22	80	0.2750000
NODE_6890_length_986_cov_35.130778	454	534	10	9	80	0.1125000
NODE_6890_length_986_cov_35.130778	454	534	11	8	80	0.1000000
NODE_6890_length_986_cov_35.130778	454	534	12	16	80	0.2000000
NODE_6890_length_986_cov_35.130778	454	534	13	8	80	0.1000000
NODE_6890_length_986_cov_35.130778	454	534	14	17	80	0.2125000
NODE_6890_length_986_cov_35.130778	507	587	8	21	80	0.2625000
NODE_6890_length_986_cov_35.130778	507	587	10	2	80	0.0250000
NODE_6890_length_986_cov_35.130778	507	587	11	13	80	0.1625000
NODE_6890_length_986_cov_35.130778	507	587	12	8	80	0.1000000
NODE_6890_length_986_cov_35.130778	507	587	13	6	80	0.0750000
NODE_6890_length_986_cov_35.130778	507	587	14	28	80	0.3500000
NODE_6890_length_986_cov_35.130778	507	587	15	2	80	0.0250000
NODE_6891_length_986_cov_24.037204	602	682	2	40	80	0.5000000
NODE_6891_length_986_cov_24.037204	602	682	3	40	80	0.5000000
NODE_6891_length_986_cov_24.037204	655	735	2	28	80	0.3500000
NODE_6891_length_986_cov_24.037204	655	735	3	2	80	0.0250000
NODE_6891_length_986_cov_24.037204	655	735	4	6	80	0.0750000
NODE_6891_length_986_cov_24.037204	655	735	5	5	80	0.0625000
NODE_6891_length_986_cov_24.037204	655	735	6	34	80	0.4250000
NODE_6891_length_986_cov_24.037204	655	735	7	5	80	0.0625000
NODE_6891_length_986_cov_24.037204	731	811	7	29	80	0.3625000
NODE_6891_length_986_cov_24.037204	731	811	8	4	80	0.0500000
NODE_6891_length_986_cov_24.037204	731	811	13	1	80	0.0125000
NODE_6891_length_986_cov_24.037204	731	811	15	37	80	0.4625000
NODE_6891_length_986_cov_24.037204	731	811	16	7	80	0.0875000
NODE_6891_length_986_cov_24.037204	731	811	18	2	80	0.0250000
NODE_6891_length_986_cov_24.037204	784	864	12	17	80	0.2125000
NODE_6891_length_986_cov_24.037204	784	864	13	6	80	0.0750000
NODE_6891_length_986_cov_24.037204	784	864	15	18	80	0.2250000
NODE_6891_length_986_cov_24.037204	784	864	16	13	80	0.1625000
NODE_6891_length_986_cov_24.037204	784	864	17	2	80	0.0250000
NODE_6891_length_986_cov_24.037204	784	864	18	24	80	0.3000000
NODE_6892_length_986_cov_20.591883	395	475	3	3	80	0.0375000
NODE_6892_length_986_cov_20.591883	395	475	4	45	80	0.5625000
NODE_6892_length_986_cov_20.591883	395	475	5	32	80	0.4000000
NODE_6892_length_986_cov_20.591883	448	528	1	43	80	0.5375000
NODE_6892_length_986_cov_20.591883	448	528	3	13	80	0.1625000
NODE_6892_length_986_cov_20.591883	448	528	4	22	80	0.2750000
NODE_6892_length_986_cov_20.591883	448	528	5	2	80	0.0250000
NODE_6893_length_986_cov_16.815107	389	469	5	15	80	0.1875000
NODE_6893_length_986_cov_16.815107	389	469	6	65	80	0.8125000
NODE_6893_length_986_cov_16.815107	442	522	3	3	80	0.0375000
NODE_6893_length_986_cov_16.815107	442	522	4	2	80	0.0250000
NODE_6893_length_986_cov_16.815107	442	522	5	4	80	0.0500000
NODE_6893_length_986_cov_16.815107	442	522	6	71	80	0.8875000
NODE_6894_length_986_cov_11.021421	474	554	8	8	80	0.1000000
NODE_6894_length_986_cov_11.021421	474	554	9	1	80	0.0125000
NODE_6894_length_986_cov_11.021421	474	554	13	27	80	0.3375000
NODE_6894_length_986_cov_11.021421	474	554	15	2	80	0.0250000
NODE_6894_length_986_cov_11.021421	474	554	16	7	80	0.0875000
NODE_6894_length_986_cov_11.021421	474	554	17	35	80	0.4375000
NODE_6894_length_986_cov_11.021421	527	607	11	48	80	0.6000000
NODE_6894_length_986_cov_11.021421	527	607	13	1	80	0.0125000
NODE_6894_length_986_cov_11.021421	527	607	15	2	80	0.0250000
NODE_6894_length_986_cov_11.021421	527	607	16	11	80	0.1375000
NODE_6894_length_986_cov_11.021421	527	607	17	18	80	0.2250000
NODE_6905_length_985_cov_41.707675	443	523	1	4	80	0.0500000
NODE_6905_length_985_cov_41.707675	443	523	3	1	80	0.0125000
NODE_6905_length_985_cov_41.707675	443	523	4	8	80	0.1000000
NODE_6905_length_985_cov_41.707675	443	523	5	5	80	0.0625000
NODE_6905_length_985_cov_41.707675	443	523	6	25	80	0.3125000
NODE_6905_length_985_cov_41.707675	443	523	8	9	80	0.1125000
NODE_6905_length_985_cov_41.707675	443	523	9	4	80	0.0500000
NODE_6905_length_985_cov_41.707675	443	523	10	8	80	0.1000000
NODE_6905_length_985_cov_41.707675	443	523	11	16	80	0.2000000
NODE_6905_length_985_cov_41.707675	496	576	9	3	80	0.0375000
NODE_6905_length_985_cov_41.707675	496	576	10	41	80	0.5125000
NODE_6905_length_985_cov_41.707675	496	576	11	36	80	0.4500000
NODE_6911_length_984_cov_64.531073	412	481	2	18	69	0.2608696
NODE_6911_length_984_cov_64.531073	412	481	3	21	69	0.3043478
NODE_6911_length_984_cov_64.531073	412	481	4	30	69	0.4347826
NODE_6911_length_984_cov_64.531073	454	534	2	7	80	0.0875000
NODE_6911_length_984_cov_64.531073	454	534	4	73	80	0.9125000
NODE_6911_length_984_cov_64.531073	475	555	2	28	80	0.3500000
NODE_6911_length_984_cov_64.531073	475	555	4	52	80	0.6500000
NODE_6911_length_984_cov_64.531073	528	608	0	28	80	0.3500000
NODE_6911_length_984_cov_64.531073	528	608	2	52	80	0.6500000
NODE_6911_length_984_cov_64.531073	549	629	0	49	80	0.6125000
NODE_6911_length_984_cov_64.531073	549	629	2	31	80	0.3875000
NODE_6912_length_984_cov_28.832768	430	510	6	20	80	0.2500000
NODE_6912_length_984_cov_28.832768	430	510	7	15	80	0.1875000
NODE_6912_length_984_cov_28.832768	430	510	8	11	80	0.1375000
NODE_6912_length_984_cov_28.832768	430	510	9	8	80	0.1000000
NODE_6912_length_984_cov_28.832768	430	510	10	10	80	0.1250000
NODE_6912_length_984_cov_28.832768	430	510	12	16	80	0.2000000
NODE_6912_length_984_cov_28.832768	483	563	3	23	80	0.2875000
NODE_6912_length_984_cov_28.832768	483	563	4	19	80	0.2375000
NODE_6912_length_984_cov_28.832768	483	563	5	8	80	0.1000000
NODE_6912_length_984_cov_28.832768	483	563	6	23	80	0.2875000
NODE_6912_length_984_cov_28.832768	483	563	8	7	80	0.0875000
NODE_6913_length_984_cov_27.247458	203	283	12	6	80	0.0750000
NODE_6913_length_984_cov_27.247458	203	283	13	9	80	0.1125000
NODE_6913_length_984_cov_27.247458	203	283	14	53	80	0.6625000
NODE_6913_length_984_cov_27.247458	203	283	15	5	80	0.0625000
NODE_6913_length_984_cov_27.247458	203	283	16	1	80	0.0125000
NODE_6913_length_984_cov_27.247458	203	283	17	5	80	0.0625000
NODE_6913_length_984_cov_27.247458	203	283	18	1	80	0.0125000
NODE_6913_length_984_cov_27.247458	256	336	12	6	80	0.0750000
NODE_6913_length_984_cov_27.247458	256	336	13	9	80	0.1125000
NODE_6913_length_984_cov_27.247458	256	336	14	10	80	0.1250000
NODE_6913_length_984_cov_27.247458	256	336	15	2	80	0.0250000
NODE_6913_length_984_cov_27.247458	256	336	16	2	80	0.0250000
NODE_6913_length_984_cov_27.247458	256	336	17	20	80	0.2500000
NODE_6913_length_984_cov_27.247458	256	336	18	13	80	0.1625000
NODE_6913_length_984_cov_27.247458	256	336	19	7	80	0.0875000
NODE_6913_length_984_cov_27.247458	256	336	20	9	80	0.1125000
NODE_6913_length_984_cov_27.247458	256	336	21	1	80	0.0125000
NODE_6913_length_984_cov_27.247458	256	336	23	1	80	0.0125000
NODE_6913_length_984_cov_27.247458	332	412	16	9	80	0.1125000
NODE_6913_length_984_cov_27.247458	332	412	18	60	80	0.7500000
NODE_6913_length_984_cov_27.247458	332	412	19	11	80	0.1375000
NODE_6913_length_984_cov_27.247458	385	465	16	10	80	0.1250000
NODE_6913_length_984_cov_27.247458	385	465	17	4	80	0.0500000
NODE_6913_length_984_cov_27.247458	385	465	18	40	80	0.5000000
NODE_6913_length_984_cov_27.247458	385	465	19	10	80	0.1250000
NODE_6913_length_984_cov_27.247458	385	465	20	7	80	0.0875000
NODE_6913_length_984_cov_27.247458	385	465	21	9	80	0.1125000
NODE_6914_length_984_cov_25.944633	483	563	11	23	80	0.2875000
NODE_6914_length_984_cov_25.944633	483	563	12	30	80	0.3750000
NODE_6914_length_984_cov_25.944633	483	563	13	23	80	0.2875000
NODE_6914_length_984_cov_25.944633	483	563	14	4	80	0.0500000
NODE_6914_length_984_cov_25.944633	536	616	7	19	80	0.2375000
NODE_6914_length_984_cov_25.944633	536	616	8	2	80	0.0250000
NODE_6914_length_984_cov_25.944633	536	616	9	12	80	0.1500000
NODE_6914_length_984_cov_25.944633	536	616	12	25	80	0.3125000
NODE_6914_length_984_cov_25.944633	536	616	13	18	80	0.2250000
NODE_6914_length_984_cov_25.944633	536	616	14	4	80	0.0500000
NODE_6915_length_984_cov_16.611299	351	431	7	14	80	0.1750000
NODE_6915_length_984_cov_16.611299	351	431	8	14	80	0.1750000
NODE_6915_length_984_cov_16.611299	351	431	9	3	80	0.0375000
NODE_6915_length_984_cov_16.611299	351	431	10	19	80	0.2375000
NODE_6915_length_984_cov_16.611299	351	431	11	15	80	0.1875000
NODE_6915_length_984_cov_16.611299	351	431	12	15	80	0.1875000
NODE_6915_length_984_cov_16.611299	404	484	8	37	80	0.4625000
NODE_6915_length_984_cov_16.611299	404	484	9	15	80	0.1875000
NODE_6915_length_984_cov_16.611299	404	484	10	9	80	0.1125000
NODE_6915_length_984_cov_16.611299	404	484	11	4	80	0.0500000
NODE_6915_length_984_cov_16.611299	404	484	12	15	80	0.1875000
NODE_6917_length_984_cov_6.414689	415	495	4	59	80	0.7375000
NODE_6917_length_984_cov_6.414689	415	495	5	6	80	0.0750000
NODE_6917_length_984_cov_6.414689	415	495	6	15	80	0.1875000
NODE_6917_length_984_cov_6.414689	468	548	3	44	80	0.5500000
NODE_6917_length_984_cov_6.414689	468	548	4	12	80	0.1500000
NODE_6917_length_984_cov_6.414689	468	548	5	9	80	0.1125000
NODE_6917_length_984_cov_6.414689	468	548	6	15	80	0.1875000
NODE_6918_length_984_cov_4.720904	494	574	4	46	80	0.5750000
NODE_6918_length_984_cov_4.720904	494	574	5	34	80	0.4250000
NODE_6918_length_984_cov_4.720904	547	627	2	14	80	0.1750000
NODE_6918_length_984_cov_4.720904	547	627	3	17	80	0.2125000
NODE_6918_length_984_cov_4.720904	547	627	4	12	80	0.1500000
NODE_6918_length_984_cov_4.720904	547	627	5	37	80	0.4625000
NODE_6927_length_984_cov_1.333333	922	971	0	49	49	1.0000000
NODE_6931_length_983_cov_34.566742	466	546	0	14	80	0.1750000
NODE_6931_length_983_cov_34.566742	466	546	1	7	80	0.0875000
NODE_6931_length_983_cov_34.566742	466	546	2	59	80	0.7375000
NODE_6931_length_983_cov_34.566742	519	599	0	67	80	0.8375000
NODE_6931_length_983_cov_34.566742	519	599	1	7	80	0.0875000
NODE_6931_length_983_cov_34.566742	519	599	2	6	80	0.0750000
NODE_6932_length_983_cov_26.011312	449	529	2	9	80	0.1125000
NODE_6932_length_983_cov_26.011312	449	529	3	15	80	0.1875000
NODE_6932_length_983_cov_26.011312	449	529	4	13	80	0.1625000
NODE_6932_length_983_cov_26.011312	449	529	5	43	80	0.5375000
NODE_6932_length_983_cov_26.011312	502	582	5	45	80	0.5625000
NODE_6932_length_983_cov_26.011312	502	582	6	35	80	0.4375000
NODE_6932_length_983_cov_26.011312	578	658	2	22	80	0.2750000
NODE_6932_length_983_cov_26.011312	578	658	3	32	80	0.4000000
NODE_6932_length_983_cov_26.011312	578	658	4	14	80	0.1750000
NODE_6932_length_983_cov_26.011312	578	658	6	12	80	0.1500000
NODE_6932_length_983_cov_26.011312	631	711	1	20	80	0.2500000
NODE_6932_length_983_cov_26.011312	631	711	2	55	80	0.6875000
NODE_6932_length_983_cov_26.011312	631	711	3	5	80	0.0625000
NODE_6933_length_983_cov_24.694570	539	619	18	5	80	0.0625000
NODE_6933_length_983_cov_24.694570	539	619	19	20	80	0.2500000
NODE_6933_length_983_cov_24.694570	539	619	20	11	80	0.1375000
NODE_6933_length_983_cov_24.694570	539	619	21	30	80	0.3750000
NODE_6933_length_983_cov_24.694570	539	619	22	3	80	0.0375000
NODE_6933_length_983_cov_24.694570	539	619	23	11	80	0.1375000
NODE_6933_length_983_cov_24.694570	592	672	15	22	80	0.2750000
NODE_6933_length_983_cov_24.694570	592	672	16	4	80	0.0500000
NODE_6933_length_983_cov_24.694570	592	672	17	11	80	0.1375000
NODE_6933_length_983_cov_24.694570	592	672	18	2	80	0.0250000
NODE_6933_length_983_cov_24.694570	592	672	21	23	80	0.2875000
NODE_6933_length_983_cov_24.694570	592	672	22	3	80	0.0375000
NODE_6933_length_983_cov_24.694570	592	672	23	14	80	0.1750000
NODE_6933_length_983_cov_24.694570	592	672	25	1	80	0.0125000
NODE_6934_length_983_cov_22.214932	395	475	4	1	80	0.0125000
NODE_6934_length_983_cov_22.214932	395	475	5	9	80	0.1125000
NODE_6934_length_983_cov_22.214932	395	475	6	15	80	0.1875000
NODE_6934_length_983_cov_22.214932	395	475	8	29	80	0.3625000
NODE_6934_length_983_cov_22.214932	395	475	11	10	80	0.1250000
NODE_6934_length_983_cov_22.214932	395	475	12	16	80	0.2000000
NODE_6934_length_983_cov_22.214932	448	528	8	1	80	0.0125000
NODE_6934_length_983_cov_22.214932	448	528	10	30	80	0.3750000
NODE_6934_length_983_cov_22.214932	448	528	11	10	80	0.1250000
NODE_6934_length_983_cov_22.214932	448	528	12	19	80	0.2375000
NODE_6934_length_983_cov_22.214932	448	528	13	20	80	0.2500000
NODE_6935_length_983_cov_19.132353	377	457	5	23	80	0.2875000
NODE_6935_length_983_cov_19.132353	377	457	6	5	80	0.0625000
NODE_6935_length_983_cov_19.132353	377	457	7	51	80	0.6375000
NODE_6935_length_983_cov_19.132353	377	457	9	1	80	0.0125000
NODE_6935_length_983_cov_19.132353	430	510	6	9	80	0.1125000
NODE_6935_length_983_cov_19.132353	430	510	7	44	80	0.5500000
NODE_6935_length_983_cov_19.132353	430	510	9	27	80	0.3375000
NODE_6936_length_983_cov_16.875566	419	499	1	56	80	0.7000000
NODE_6936_length_983_cov_16.875566	419	499	2	24	80	0.3000000
NODE_6936_length_983_cov_16.875566	472	552	0	50	80	0.6250000
NODE_6936_length_983_cov_16.875566	472	552	1	30	80	0.3750000
NODE_6936_length_983_cov_16.875566	548	628	0	14	80	0.1750000
NODE_6936_length_983_cov_16.875566	548	628	1	20	80	0.2500000
NODE_6936_length_983_cov_16.875566	548	628	5	13	80	0.1625000
NODE_6936_length_983_cov_16.875566	548	628	6	33	80	0.4125000
NODE_6936_length_983_cov_16.875566	601	681	5	21	80	0.2625000
NODE_6936_length_983_cov_16.875566	601	681	6	26	80	0.3250000
NODE_6936_length_983_cov_16.875566	601	681	10	33	80	0.4125000
NODE_6937_length_983_cov_7.240950	487	567	2	40	80	0.5000000
NODE_6937_length_983_cov_7.240950	487	567	4	40	80	0.5000000
NODE_6937_length_983_cov_7.240950	540	620	0	40	80	0.5000000
NODE_6937_length_983_cov_7.240950	540	620	1	1	80	0.0125000
NODE_6937_length_983_cov_7.240950	540	620	2	39	80	0.4875000
NODE_6949_length_982_cov_30.750849	357	437	21	28	80	0.3500000
NODE_6949_length_982_cov_30.750849	357	437	23	4	80	0.0500000
NODE_6949_length_982_cov_30.750849	357	437	24	6	80	0.0750000
NODE_6949_length_982_cov_30.750849	357	437	28	4	80	0.0500000
NODE_6949_length_982_cov_30.750849	357	437	29	28	80	0.3500000
NODE_6949_length_982_cov_30.750849	357	437	30	1	80	0.0125000
NODE_6949_length_982_cov_30.750849	357	437	31	5	80	0.0625000
NODE_6949_length_982_cov_30.750849	357	437	32	4	80	0.0500000
NODE_6949_length_982_cov_30.750849	410	490	16	2	80	0.0250000
NODE_6949_length_982_cov_30.750849	410	490	19	2	80	0.0250000
NODE_6949_length_982_cov_30.750849	410	490	20	14	80	0.1750000
NODE_6949_length_982_cov_30.750849	410	490	21	5	80	0.0625000
NODE_6949_length_982_cov_30.750849	410	490	22	3	80	0.0375000
NODE_6949_length_982_cov_30.750849	410	490	23	11	80	0.1375000
NODE_6949_length_982_cov_30.750849	410	490	25	1	80	0.0125000
NODE_6949_length_982_cov_30.750849	410	490	29	17	80	0.2125000
NODE_6949_length_982_cov_30.750849	410	490	30	1	80	0.0125000
NODE_6949_length_982_cov_30.750849	410	490	31	9	80	0.1125000
NODE_6949_length_982_cov_30.750849	410	490	32	15	80	0.1875000
NODE_6950_length_982_cov_29.901472	516	596	6	29	80	0.3625000
NODE_6950_length_982_cov_29.901472	516	596	7	20	80	0.2500000
NODE_6950_length_982_cov_29.901472	516	596	8	8	80	0.1000000
NODE_6950_length_982_cov_29.901472	516	596	9	23	80	0.2875000
NODE_6950_length_982_cov_29.901472	569	649	5	16	80	0.2000000
NODE_6950_length_982_cov_29.901472	569	649	6	24	80	0.3000000
NODE_6950_length_982_cov_29.901472	569	649	7	33	80	0.4125000
NODE_6950_length_982_cov_29.901472	569	649	8	7	80	0.0875000
NODE_6951_length_982_cov_18.251416	356	436	1	62	80	0.7750000
NODE_6951_length_982_cov_18.251416	356	436	2	18	80	0.2250000
NODE_6951_length_982_cov_18.251416	409	489	1	66	80	0.8250000
NODE_6951_length_982_cov_18.251416	409	489	2	14	80	0.1750000
NODE_6951_length_982_cov_18.251416	485	565	1	76	80	0.9500000
NODE_6951_length_982_cov_18.251416	485	565	2	4	80	0.0500000
NODE_6951_length_982_cov_18.251416	538	618	1	76	80	0.9500000
NODE_6951_length_982_cov_18.251416	538	618	2	4	80	0.0500000
NODE_6952_length_982_cov_13.840317	608	688	11	9	80	0.1125000
NODE_6952_length_982_cov_13.840317	608	688	12	18	80	0.2250000
NODE_6952_length_982_cov_13.840317	608	688	13	6	80	0.0750000
NODE_6952_length_982_cov_13.840317	608	688	14	31	80	0.3875000
NODE_6952_length_982_cov_13.840317	608	688	16	16	80	0.2000000
NODE_6952_length_982_cov_13.840317	661	741	7	21	80	0.2625000
NODE_6952_length_982_cov_13.840317	661	741	10	10	80	0.1250000
NODE_6952_length_982_cov_13.840317	661	741	12	36	80	0.4500000
NODE_6952_length_982_cov_13.840317	661	741	14	13	80	0.1625000
NODE_6953_length_982_cov_13.227633	317	397	4	8	80	0.1000000
NODE_6953_length_982_cov_13.227633	317	397	6	20	80	0.2500000
NODE_6953_length_982_cov_13.227633	317	397	7	16	80	0.2000000
NODE_6953_length_982_cov_13.227633	317	397	8	5	80	0.0625000
NODE_6953_length_982_cov_13.227633	317	397	9	1	80	0.0125000
NODE_6953_length_982_cov_13.227633	317	397	10	30	80	0.3750000
NODE_6953_length_982_cov_13.227633	370	450	6	64	80	0.8000000
NODE_6953_length_982_cov_13.227633	370	450	7	13	80	0.1625000
NODE_6953_length_982_cov_13.227633	370	450	9	1	80	0.0125000
NODE_6953_length_982_cov_13.227633	370	450	10	2	80	0.0250000
NODE_6954_length_982_cov_10.918460	209	289	1	13	80	0.1625000
NODE_6954_length_982_cov_10.918460	209	289	2	67	80	0.8375000
NODE_6954_length_982_cov_10.918460	262	342	2	80	80	1.0000000
NODE_6956_length_982_cov_7.210646	216	296	1	21	80	0.2625000
NODE_6956_length_982_cov_7.210646	216	296	2	30	80	0.3750000
NODE_6956_length_982_cov_7.210646	216	296	7	29	80	0.3625000
NODE_6956_length_982_cov_7.210646	269	349	6	52	80	0.6500000
NODE_6956_length_982_cov_7.210646	269	349	7	28	80	0.3500000
NODE_6973_length_981_cov_55.260771	410	490	11	11	80	0.1375000
NODE_6973_length_981_cov_55.260771	410	490	12	11	80	0.1375000
NODE_6973_length_981_cov_55.260771	410	490	14	7	80	0.0875000
NODE_6973_length_981_cov_55.260771	410	490	15	3	80	0.0375000
NODE_6973_length_981_cov_55.260771	410	490	16	19	80	0.2375000
NODE_6973_length_981_cov_55.260771	410	490	17	27	80	0.3375000
NODE_6973_length_981_cov_55.260771	410	490	18	2	80	0.0250000
NODE_6973_length_981_cov_55.260771	463	543	14	23	80	0.2875000
NODE_6973_length_981_cov_55.260771	463	543	15	7	80	0.0875000
NODE_6973_length_981_cov_55.260771	463	543	16	40	80	0.5000000
NODE_6973_length_981_cov_55.260771	463	543	17	10	80	0.1250000
NODE_6973_length_981_cov_55.260771	539	619	10	16	80	0.2000000
NODE_6973_length_981_cov_55.260771	539	619	11	9	80	0.1125000
NODE_6973_length_981_cov_55.260771	539	619	12	5	80	0.0625000
NODE_6973_length_981_cov_55.260771	539	619	13	7	80	0.0875000
NODE_6973_length_981_cov_55.260771	539	619	14	21	80	0.2625000
NODE_6973_length_981_cov_55.260771	539	619	15	9	80	0.1125000
NODE_6973_length_981_cov_55.260771	539	619	16	13	80	0.1625000
NODE_6973_length_981_cov_55.260771	592	672	7	1	80	0.0125000
NODE_6973_length_981_cov_55.260771	592	672	9	29	80	0.3625000
NODE_6973_length_981_cov_55.260771	592	672	10	22	80	0.2750000
NODE_6973_length_981_cov_55.260771	592	672	11	24	80	0.3000000
NODE_6973_length_981_cov_55.260771	592	672	12	4	80	0.0500000
NODE_6974_length_981_cov_33.287982	362	441	5	1	79	0.0126582
NODE_6974_length_981_cov_33.287982	362	441	6	17	79	0.2151899
NODE_6974_length_981_cov_33.287982	362	441	8	10	79	0.1265823
NODE_6974_length_981_cov_33.287982	362	441	9	6	79	0.0759494
NODE_6974_length_981_cov_33.287982	362	441	10	45	79	0.5696203
NODE_6974_length_981_cov_33.287982	414	495	5	1	81	0.0123457
NODE_6974_length_981_cov_33.287982	414	495	6	37	81	0.4567901
NODE_6974_length_981_cov_33.287982	414	495	7	3	81	0.0370370
NODE_6974_length_981_cov_33.287982	414	495	8	15	81	0.1851852
NODE_6974_length_981_cov_33.287982	414	495	9	6	81	0.0740741
NODE_6974_length_981_cov_33.287982	414	495	10	3	81	0.0370370
NODE_6974_length_981_cov_33.287982	414	495	11	16	81	0.1975309
NODE_6974_length_981_cov_33.287982	491	571	8	20	80	0.2500000
NODE_6974_length_981_cov_33.287982	491	571	9	44	80	0.5500000
NODE_6974_length_981_cov_33.287982	491	571	10	16	80	0.2000000
NODE_6974_length_981_cov_33.287982	544	624	2	9	80	0.1125000
NODE_6974_length_981_cov_33.287982	544	624	3	1	80	0.0125000
NODE_6974_length_981_cov_33.287982	544	624	6	3	80	0.0375000
NODE_6974_length_981_cov_33.287982	544	624	7	37	80	0.4625000
NODE_6974_length_981_cov_33.287982	544	624	8	17	80	0.2125000
NODE_6974_length_981_cov_33.287982	544	624	10	13	80	0.1625000
NODE_6975_length_981_cov_33.121315	269	349	3	11	80	0.1375000
NODE_6975_length_981_cov_33.121315	269	349	4	12	80	0.1500000
NODE_6975_length_981_cov_33.121315	269	349	5	27	80	0.3375000
NODE_6975_length_981_cov_33.121315	269	349	6	30	80	0.3750000
NODE_6975_length_981_cov_33.121315	322	402	3	1	80	0.0125000
NODE_6975_length_981_cov_33.121315	322	402	4	19	80	0.2375000
NODE_6975_length_981_cov_33.121315	322	402	5	9	80	0.1125000
NODE_6975_length_981_cov_33.121315	322	402	6	13	80	0.1625000
NODE_6975_length_981_cov_33.121315	322	402	7	21	80	0.2625000
NODE_6975_length_981_cov_33.121315	322	402	8	17	80	0.2125000
NODE_6975_length_981_cov_33.121315	398	478	6	36	80	0.4500000
NODE_6975_length_981_cov_33.121315	398	478	7	1	80	0.0125000
NODE_6975_length_981_cov_33.121315	398	478	8	43	80	0.5375000
NODE_6975_length_981_cov_33.121315	451	531	2	17	80	0.2125000
NODE_6975_length_981_cov_33.121315	451	531	4	8	80	0.1000000
NODE_6975_length_981_cov_33.121315	451	531	5	12	80	0.1500000
NODE_6975_length_981_cov_33.121315	451	531	6	42	80	0.5250000
NODE_6975_length_981_cov_33.121315	451	531	7	1	80	0.0125000
NODE_6976_length_981_cov_26.732426	397	477	2	14	80	0.1750000
NODE_6976_length_981_cov_26.732426	397	477	5	41	80	0.5125000
NODE_6976_length_981_cov_26.732426	397	477	6	25	80	0.3125000
NODE_6976_length_981_cov_26.732426	450	530	5	9	80	0.1125000
NODE_6976_length_981_cov_26.732426	450	530	6	71	80	0.8875000
NODE_6977_length_981_cov_24.304989	390	470	7	7	80	0.0875000
NODE_6977_length_981_cov_24.304989	390	470	8	44	80	0.5500000
NODE_6977_length_981_cov_24.304989	390	470	9	15	80	0.1875000
NODE_6977_length_981_cov_24.304989	390	470	10	9	80	0.1125000
NODE_6977_length_981_cov_24.304989	390	470	11	5	80	0.0625000
NODE_6977_length_981_cov_24.304989	443	523	7	21	80	0.2625000
NODE_6977_length_981_cov_24.304989	443	523	8	6	80	0.0750000
NODE_6977_length_981_cov_24.304989	443	523	9	11	80	0.1375000
NODE_6977_length_981_cov_24.304989	443	523	10	32	80	0.4000000
NODE_6977_length_981_cov_24.304989	443	523	11	10	80	0.1250000
NODE_6978_length_981_cov_10.485261	363	443	2	80	80	1.0000000
NODE_6978_length_981_cov_10.485261	416	496	0	2	80	0.0250000
NODE_6978_length_981_cov_10.485261	416	496	2	78	80	0.9750000
NODE_6980_length_981_cov_5.328798	821	885	0	64	64	1.0000000
NODE_6980_length_981_cov_5.328798	847	884	0	37	37	1.0000000
NODE_6998_length_980_cov_40.710556	329	409	3	62	80	0.7750000
NODE_6998_length_980_cov_40.710556	329	409	4	18	80	0.2250000
NODE_6998_length_980_cov_40.710556	382	462	0	38	80	0.4750000
NODE_6998_length_980_cov_40.710556	382	462	2	12	80	0.1500000
NODE_6998_length_980_cov_40.710556	382	462	3	30	80	0.3750000
NODE_6998_length_980_cov_40.710556	458	538	0	80	80	1.0000000
NODE_6998_length_980_cov_40.710556	511	591	0	80	80	1.0000000
NODE_6999_length_980_cov_37.634506	666	746	8	9	80	0.1125000
NODE_6999_length_980_cov_37.634506	666	746	9	4	80	0.0500000
NODE_6999_length_980_cov_37.634506	666	746	10	2	80	0.0250000
NODE_6999_length_980_cov_37.634506	666	746	11	17	80	0.2125000
NODE_6999_length_980_cov_37.634506	666	746	13	12	80	0.1500000
NODE_6999_length_980_cov_37.634506	666	746	15	30	80	0.3750000
NODE_6999_length_980_cov_37.634506	666	746	16	6	80	0.0750000
NODE_6999_length_980_cov_37.634506	719	799	11	10	80	0.1250000
NODE_6999_length_980_cov_37.634506	719	799	12	7	80	0.0875000
NODE_6999_length_980_cov_37.634506	719	799	13	13	80	0.1625000
NODE_6999_length_980_cov_37.634506	719	799	14	11	80	0.1375000
NODE_6999_length_980_cov_37.634506	719	799	15	33	80	0.4125000
NODE_6999_length_980_cov_37.634506	719	799	16	6	80	0.0750000
NODE_7000_length_980_cov_36.261067	331	411	5	30	80	0.3750000
NODE_7000_length_980_cov_36.261067	331	411	6	9	80	0.1125000
NODE_7000_length_980_cov_36.261067	331	411	7	10	80	0.1250000
NODE_7000_length_980_cov_36.261067	331	411	8	10	80	0.1250000
NODE_7000_length_980_cov_36.261067	331	411	9	7	80	0.0875000
NODE_7000_length_980_cov_36.261067	331	411	10	8	80	0.1000000
NODE_7000_length_980_cov_36.261067	331	411	11	6	80	0.0750000
NODE_7000_length_980_cov_36.261067	384	453	7	8	69	0.1159420
NODE_7000_length_980_cov_36.261067	384	453	9	5	69	0.0724638
NODE_7000_length_980_cov_36.261067	384	453	10	8	69	0.1159420
NODE_7000_length_980_cov_36.261067	384	453	11	7	69	0.1014493
NODE_7000_length_980_cov_36.261067	384	453	12	20	69	0.2898551
NODE_7000_length_980_cov_36.261067	384	453	13	3	69	0.0434783
NODE_7000_length_980_cov_36.261067	384	453	14	4	69	0.0579710
NODE_7000_length_980_cov_36.261067	384	453	15	14	69	0.2028985
NODE_7000_length_980_cov_36.261067	465	545	16	4	80	0.0500000
NODE_7000_length_980_cov_36.261067	465	545	17	21	80	0.2625000
NODE_7000_length_980_cov_36.261067	465	545	18	9	80	0.1125000
NODE_7000_length_980_cov_36.261067	465	545	19	25	80	0.3125000
NODE_7000_length_980_cov_36.261067	465	545	20	10	80	0.1250000
NODE_7000_length_980_cov_36.261067	465	545	21	11	80	0.1375000
NODE_7000_length_980_cov_36.261067	518	598	10	4	80	0.0500000
NODE_7000_length_980_cov_36.261067	518	598	11	4	80	0.0500000
NODE_7000_length_980_cov_36.261067	518	598	12	3	80	0.0375000
NODE_7000_length_980_cov_36.261067	518	598	13	21	80	0.2625000
NODE_7000_length_980_cov_36.261067	518	598	14	2	80	0.0250000
NODE_7000_length_980_cov_36.261067	518	598	16	5	80	0.0625000
NODE_7000_length_980_cov_36.261067	518	598	17	2	80	0.0250000
NODE_7000_length_980_cov_36.261067	518	598	18	14	80	0.1750000
NODE_7000_length_980_cov_36.261067	518	598	19	18	80	0.2250000
NODE_7000_length_980_cov_36.261067	518	598	20	7	80	0.0875000
NODE_7001_length_980_cov_28.514188	430	510	9	6	80	0.0750000
NODE_7001_length_980_cov_28.514188	430	510	10	4	80	0.0500000
NODE_7001_length_980_cov_28.514188	430	510	11	31	80	0.3875000
NODE_7001_length_980_cov_28.514188	430	510	12	39	80	0.4875000
NODE_7001_length_980_cov_28.514188	483	563	3	12	80	0.1500000
NODE_7001_length_980_cov_28.514188	483	563	5	16	80	0.2000000
NODE_7001_length_980_cov_28.514188	483	563	7	18	80	0.2250000
NODE_7001_length_980_cov_28.514188	483	563	9	7	80	0.0875000
NODE_7001_length_980_cov_28.514188	483	563	11	27	80	0.3375000
NODE_7002_length_980_cov_25.205448	497	577	17	1	80	0.0125000
NODE_7002_length_980_cov_25.205448	497	577	19	3	80	0.0375000
NODE_7002_length_980_cov_25.205448	497	577	20	4	80	0.0500000
NODE_7002_length_980_cov_25.205448	497	577	21	13	80	0.1625000
NODE_7002_length_980_cov_25.205448	497	577	22	10	80	0.1250000
NODE_7002_length_980_cov_25.205448	497	577	23	2	80	0.0250000
NODE_7002_length_980_cov_25.205448	497	577	24	3	80	0.0375000
NODE_7002_length_980_cov_25.205448	497	577	25	20	80	0.2500000
NODE_7002_length_980_cov_25.205448	497	577	26	7	80	0.0875000
NODE_7002_length_980_cov_25.205448	497	577	27	17	80	0.2125000
NODE_7002_length_980_cov_25.205448	550	630	21	12	80	0.1500000
NODE_7002_length_980_cov_25.205448	550	630	22	10	80	0.1250000
NODE_7002_length_980_cov_25.205448	550	630	23	17	80	0.2125000
NODE_7002_length_980_cov_25.205448	550	630	24	16	80	0.2000000
NODE_7002_length_980_cov_25.205448	550	630	25	13	80	0.1625000
NODE_7002_length_980_cov_25.205448	550	630	26	7	80	0.0875000
NODE_7002_length_980_cov_25.205448	550	630	27	5	80	0.0625000
NODE_7003_length_980_cov_24.321226	417	497	8	20	80	0.2500000
NODE_7003_length_980_cov_24.321226	417	497	9	17	80	0.2125000
NODE_7003_length_980_cov_24.321226	417	497	11	11	80	0.1375000
NODE_7003_length_980_cov_24.321226	417	497	12	13	80	0.1625000
NODE_7003_length_980_cov_24.321226	417	497	13	8	80	0.1000000
NODE_7003_length_980_cov_24.321226	417	497	14	11	80	0.1375000
NODE_7003_length_980_cov_24.321226	470	550	11	2	80	0.0250000
NODE_7003_length_980_cov_24.321226	470	550	12	7	80	0.0875000
NODE_7003_length_980_cov_24.321226	470	550	13	47	80	0.5875000
NODE_7003_length_980_cov_24.321226	470	550	14	24	80	0.3000000
NODE_7004_length_980_cov_20.460840	388	468	7	35	80	0.4375000
NODE_7004_length_980_cov_20.460840	388	468	9	29	80	0.3625000
NODE_7004_length_980_cov_20.460840	388	468	10	9	80	0.1125000
NODE_7004_length_980_cov_20.460840	388	468	11	7	80	0.0875000
NODE_7004_length_980_cov_20.460840	441	521	4	14	80	0.1750000
NODE_7004_length_980_cov_20.460840	441	521	5	9	80	0.1125000
NODE_7004_length_980_cov_20.460840	441	521	7	57	80	0.7125000
NODE_7005_length_980_cov_19.969353	486	566	0	3	80	0.0375000
NODE_7005_length_980_cov_19.969353	486	566	2	77	80	0.9625000
NODE_7005_length_980_cov_19.969353	539	619	2	80	80	1.0000000
NODE_7006_length_980_cov_13.736663	350	430	0	80	80	1.0000000
NODE_7006_length_980_cov_13.736663	403	483	0	80	80	1.0000000
NODE_7006_length_980_cov_13.736663	479	559	0	43	80	0.5375000
NODE_7006_length_980_cov_13.736663	479	559	2	17	80	0.2125000
NODE_7006_length_980_cov_13.736663	479	559	3	8	80	0.1000000
NODE_7006_length_980_cov_13.736663	479	559	4	12	80	0.1500000
NODE_7006_length_980_cov_13.736663	532	612	2	7	80	0.0875000
NODE_7006_length_980_cov_13.736663	532	612	3	8	80	0.1000000
NODE_7006_length_980_cov_13.736663	532	612	4	65	80	0.8125000
NODE_7008_length_980_cov_10.842225	517	597	6	27	80	0.3375000
NODE_7008_length_980_cov_10.842225	517	597	7	53	80	0.6625000
NODE_7008_length_980_cov_10.842225	570	650	7	40	80	0.5000000
NODE_7008_length_980_cov_10.842225	570	650	9	40	80	0.5000000
NODE_7009_length_980_cov_10.087401	341	424	9	21	83	0.2530121
NODE_7009_length_980_cov_10.087401	341	424	10	22	83	0.2650602
NODE_7009_length_980_cov_10.087401	341	424	11	9	83	0.1084337
NODE_7009_length_980_cov_10.087401	341	424	12	24	83	0.2891566
NODE_7009_length_980_cov_10.087401	341	424	13	7	83	0.0843373
NODE_7009_length_980_cov_10.087401	397	477	4	36	80	0.4500000
NODE_7009_length_980_cov_10.087401	397	477	9	13	80	0.1625000
NODE_7009_length_980_cov_10.087401	397	477	10	12	80	0.1500000
NODE_7009_length_980_cov_10.087401	397	477	11	9	80	0.1125000
NODE_7009_length_980_cov_10.087401	397	477	12	10	80	0.1250000
NODE_7010_length_980_cov_9.643587	267	347	0	80	80	1.0000000
NODE_7010_length_980_cov_9.643587	320	400	0	80	80	1.0000000
NODE_7010_length_980_cov_9.643587	396	476	0	80	80	1.0000000
NODE_7010_length_980_cov_9.643587	449	529	0	80	80	1.0000000
NODE_7026_length_979_cov_22.576136	442	522	5	10	80	0.1250000
NODE_7026_length_979_cov_22.576136	442	522	8	2	80	0.0250000
NODE_7026_length_979_cov_22.576136	442	522	9	36	80	0.4500000
NODE_7026_length_979_cov_22.576136	442	522	10	5	80	0.0625000
NODE_7026_length_979_cov_22.576136	442	522	11	27	80	0.3375000
NODE_7026_length_979_cov_22.576136	495	575	9	57	80	0.7125000
NODE_7026_length_979_cov_22.576136	495	575	11	16	80	0.2000000
NODE_7026_length_979_cov_22.576136	495	575	12	7	80	0.0875000
NODE_7027_length_979_cov_19.739773	445	524	3	19	79	0.2405063
NODE_7027_length_979_cov_19.739773	445	524	4	19	79	0.2405063
NODE_7027_length_979_cov_19.739773	445	524	5	5	79	0.0632911
NODE_7027_length_979_cov_19.739773	445	524	6	33	79	0.4177215
NODE_7027_length_979_cov_19.739773	445	524	8	3	79	0.0379747
NODE_7027_length_979_cov_19.739773	497	577	6	51	80	0.6375000
NODE_7027_length_979_cov_19.739773	497	577	8	29	80	0.3625000
NODE_7028_length_979_cov_19.480682	436	516	1	30	80	0.3750000
NODE_7028_length_979_cov_19.480682	436	516	5	18	80	0.2250000
NODE_7028_length_979_cov_19.480682	436	516	9	1	80	0.0125000
NODE_7028_length_979_cov_19.480682	436	516	10	21	80	0.2625000
NODE_7028_length_979_cov_19.480682	436	516	11	10	80	0.1250000
NODE_7028_length_979_cov_19.480682	489	569	10	17	80	0.2125000
NODE_7028_length_979_cov_19.480682	489	569	11	46	80	0.5750000
NODE_7028_length_979_cov_19.480682	489	569	12	13	80	0.1625000
NODE_7028_length_979_cov_19.480682	489	569	13	4	80	0.0500000
NODE_7028_length_979_cov_19.480682	565	645	8	10	80	0.1250000
NODE_7028_length_979_cov_19.480682	565	645	9	1	80	0.0125000
NODE_7028_length_979_cov_19.480682	565	645	13	22	80	0.2750000
NODE_7028_length_979_cov_19.480682	565	645	16	14	80	0.1750000
NODE_7028_length_979_cov_19.480682	565	645	17	33	80	0.4125000
NODE_7028_length_979_cov_19.480682	618	698	7	6	80	0.0750000
NODE_7028_length_979_cov_19.480682	618	698	8	21	80	0.2625000
NODE_7028_length_979_cov_19.480682	618	698	9	1	80	0.0125000
NODE_7028_length_979_cov_19.480682	618	698	11	29	80	0.3625000
NODE_7028_length_979_cov_19.480682	618	698	12	2	80	0.0250000
NODE_7028_length_979_cov_19.480682	618	698	13	16	80	0.2000000
NODE_7028_length_979_cov_19.480682	618	698	14	2	80	0.0250000
NODE_7028_length_979_cov_19.480682	618	698	15	3	80	0.0375000
NODE_7029_length_979_cov_18.901136	470	550	4	12	80	0.1500000
NODE_7029_length_979_cov_18.901136	470	550	5	46	80	0.5750000
NODE_7029_length_979_cov_18.901136	470	550	6	22	80	0.2750000
NODE_7029_length_979_cov_18.901136	523	603	2	10	80	0.1250000
NODE_7029_length_979_cov_18.901136	523	603	3	27	80	0.3375000
NODE_7029_length_979_cov_18.901136	523	603	4	28	80	0.3500000
NODE_7029_length_979_cov_18.901136	523	603	5	1	80	0.0125000
NODE_7029_length_979_cov_18.901136	523	603	6	14	80	0.1750000
NODE_7031_length_979_cov_3.519318	101	168	0	67	67	1.0000000
NODE_7040_length_978_cov_23.195677	424	504	3	15	80	0.1875000
NODE_7040_length_978_cov_23.195677	424	504	4	9	80	0.1125000
NODE_7040_length_978_cov_23.195677	424	504	5	49	80	0.6125000
NODE_7040_length_978_cov_23.195677	424	504	6	7	80	0.0875000
NODE_7040_length_978_cov_23.195677	477	557	4	10	80	0.1250000
NODE_7040_length_978_cov_23.195677	477	557	5	57	80	0.7125000
NODE_7040_length_978_cov_23.195677	477	557	6	13	80	0.1625000
NODE_7041_length_978_cov_18.866894	440	520	5	16	80	0.2000000
NODE_7041_length_978_cov_18.866894	440	520	6	51	80	0.6375000
NODE_7041_length_978_cov_18.866894	440	520	8	13	80	0.1625000
NODE_7041_length_978_cov_18.866894	493	573	5	4	80	0.0500000
NODE_7041_length_978_cov_18.866894	493	573	6	16	80	0.2000000
NODE_7041_length_978_cov_18.866894	493	573	7	44	80	0.5500000
NODE_7041_length_978_cov_18.866894	493	573	8	16	80	0.2000000
NODE_7042_length_978_cov_15.614334	341	421	0	80	80	1.0000000
NODE_7042_length_978_cov_15.614334	394	474	0	80	80	1.0000000
NODE_7042_length_978_cov_15.614334	470	550	0	80	80	1.0000000
NODE_7042_length_978_cov_15.614334	523	603	0	80	80	1.0000000
NODE_7043_length_978_cov_15.253697	327	407	2	13	80	0.1625000
NODE_7043_length_978_cov_15.253697	327	407	4	28	80	0.3500000
NODE_7043_length_978_cov_15.253697	327	407	6	39	80	0.4875000
NODE_7043_length_978_cov_15.253697	380	460	6	80	80	1.0000000
NODE_7043_length_978_cov_15.253697	456	536	0	18	80	0.2250000
NODE_7043_length_978_cov_15.253697	456	536	2	28	80	0.3500000
NODE_7043_length_978_cov_15.253697	456	536	4	25	80	0.3125000
NODE_7043_length_978_cov_15.253697	456	536	6	9	80	0.1125000
NODE_7043_length_978_cov_15.253697	509	589	0	71	80	0.8875000
NODE_7043_length_978_cov_15.253697	509	589	2	9	80	0.1125000
NODE_7044_length_978_cov_14.730375	407	487	5	6	80	0.0750000
NODE_7044_length_978_cov_14.730375	407	487	6	19	80	0.2375000
NODE_7044_length_978_cov_14.730375	407	487	7	16	80	0.2000000
NODE_7044_length_978_cov_14.730375	407	487	8	9	80	0.1125000
NODE_7044_length_978_cov_14.730375	407	487	9	29	80	0.3625000
NODE_7044_length_978_cov_14.730375	407	487	10	1	80	0.0125000
NODE_7044_length_978_cov_14.730375	460	540	6	12	80	0.1500000
NODE_7044_length_978_cov_14.730375	460	540	7	3	80	0.0375000
NODE_7044_length_978_cov_14.730375	460	540	8	12	80	0.1500000
NODE_7044_length_978_cov_14.730375	460	540	9	52	80	0.6500000
NODE_7044_length_978_cov_14.730375	460	540	10	1	80	0.0125000
NODE_7045_length_978_cov_7.257110	571	651	0	80	80	1.0000000
NODE_7045_length_978_cov_7.257110	624	704	0	80	80	1.0000000
NODE_7062_length_977_cov_47.484055	427	507	7	31	80	0.3875000
NODE_7062_length_977_cov_47.484055	427	507	8	26	80	0.3250000
NODE_7062_length_977_cov_47.484055	427	507	9	23	80	0.2875000
NODE_7062_length_977_cov_47.484055	480	560	5	6	80	0.0750000
NODE_7062_length_977_cov_47.484055	480	560	6	38	80	0.4750000
NODE_7062_length_977_cov_47.484055	480	560	7	1	80	0.0125000
NODE_7062_length_977_cov_47.484055	480	560	8	35	80	0.4375000
NODE_7063_length_977_cov_47.116173	428	508	7	6	80	0.0750000
NODE_7063_length_977_cov_47.116173	428	508	8	1	80	0.0125000
NODE_7063_length_977_cov_47.116173	428	508	9	25	80	0.3125000
NODE_7063_length_977_cov_47.116173	428	508	10	18	80	0.2250000
NODE_7063_length_977_cov_47.116173	428	508	12	30	80	0.3750000
NODE_7063_length_977_cov_47.116173	481	561	3	13	80	0.1625000
NODE_7063_length_977_cov_47.116173	481	561	4	16	80	0.2000000
NODE_7063_length_977_cov_47.116173	481	561	6	11	80	0.1375000
NODE_7063_length_977_cov_47.116173	481	561	7	19	80	0.2375000
NODE_7063_length_977_cov_47.116173	481	561	8	1	80	0.0125000
NODE_7063_length_977_cov_47.116173	481	561	9	20	80	0.2500000
NODE_7063_length_977_cov_47.116173	557	637	0	67	80	0.8375000
NODE_7063_length_977_cov_47.116173	557	637	1	7	80	0.0875000
NODE_7063_length_977_cov_47.116173	557	637	3	6	80	0.0750000
NODE_7063_length_977_cov_47.116173	610	690	0	80	80	1.0000000
NODE_7064_length_977_cov_32.542141	486	566	5	30	80	0.3750000
NODE_7064_length_977_cov_32.542141	486	566	6	26	80	0.3250000
NODE_7064_length_977_cov_32.542141	486	566	8	24	80	0.3000000
NODE_7064_length_977_cov_32.542141	539	619	2	16	80	0.2000000
NODE_7064_length_977_cov_32.542141	539	619	5	64	80	0.8000000
NODE_7065_length_977_cov_30.676538	361	441	9	10	80	0.1250000
NODE_7065_length_977_cov_30.676538	361	441	11	10	80	0.1250000
NODE_7065_length_977_cov_30.676538	361	441	12	1	80	0.0125000
NODE_7065_length_977_cov_30.676538	361	441	13	5	80	0.0625000
NODE_7065_length_977_cov_30.676538	361	441	14	27	80	0.3375000
NODE_7065_length_977_cov_30.676538	361	441	15	4	80	0.0500000
NODE_7065_length_977_cov_30.676538	361	441	17	23	80	0.2875000
NODE_7065_length_977_cov_30.676538	414	494	9	1	80	0.0125000
NODE_7065_length_977_cov_30.676538	414	494	11	6	80	0.0750000
NODE_7065_length_977_cov_30.676538	414	494	12	1	80	0.0125000
NODE_7065_length_977_cov_30.676538	414	494	14	11	80	0.1375000
NODE_7065_length_977_cov_30.676538	414	494	15	23	80	0.2875000
NODE_7065_length_977_cov_30.676538	414	494	16	2	80	0.0250000
NODE_7065_length_977_cov_30.676538	414	494	17	36	80	0.4500000
NODE_7066_length_977_cov_28.348519	455	535	8	5	80	0.0625000
NODE_7066_length_977_cov_28.348519	455	535	10	29	80	0.3625000
NODE_7066_length_977_cov_28.348519	455	535	14	29	80	0.3625000
NODE_7066_length_977_cov_28.348519	455	535	15	17	80	0.2125000
NODE_7066_length_977_cov_28.348519	508	588	7	2	80	0.0250000
NODE_7066_length_977_cov_28.348519	508	588	8	32	80	0.4000000
NODE_7066_length_977_cov_28.348519	508	588	9	24	80	0.3000000
NODE_7066_length_977_cov_28.348519	508	588	10	20	80	0.2500000
NODE_7066_length_977_cov_28.348519	508	588	14	2	80	0.0250000
NODE_7067_length_977_cov_26.571754	343	423	2	80	80	1.0000000
NODE_7067_length_977_cov_26.571754	396	476	0	42	80	0.5250000
NODE_7067_length_977_cov_26.571754	396	476	1	8	80	0.1000000
NODE_7067_length_977_cov_26.571754	396	476	2	30	80	0.3750000
NODE_7067_length_977_cov_26.571754	472	552	0	80	80	1.0000000
NODE_7067_length_977_cov_26.571754	525	600	0	75	75	1.0000000
NODE_7068_length_977_cov_24.898633	470	550	2	2	80	0.0250000
NODE_7068_length_977_cov_24.898633	470	550	4	1	80	0.0125000
NODE_7068_length_977_cov_24.898633	470	550	5	1	80	0.0125000
NODE_7068_length_977_cov_24.898633	470	550	6	18	80	0.2250000
NODE_7068_length_977_cov_24.898633	470	550	9	10	80	0.1250000
NODE_7068_length_977_cov_24.898633	470	550	10	40	80	0.5000000
NODE_7068_length_977_cov_24.898633	470	550	11	2	80	0.0250000
NODE_7068_length_977_cov_24.898633	470	550	13	6	80	0.0750000
NODE_7068_length_977_cov_24.898633	523	603	10	19	80	0.2375000
NODE_7068_length_977_cov_24.898633	523	603	11	2	80	0.0250000
NODE_7068_length_977_cov_24.898633	523	603	12	24	80	0.3000000
NODE_7068_length_977_cov_24.898633	523	603	13	35	80	0.4375000
NODE_7069_length_977_cov_22.986333	313	393	1	2	80	0.0250000
NODE_7069_length_977_cov_22.986333	313	393	2	26	80	0.3250000
NODE_7069_length_977_cov_22.986333	313	393	3	29	80	0.3625000
NODE_7069_length_977_cov_22.986333	313	393	4	23	80	0.2875000
NODE_7069_length_977_cov_22.986333	366	446	3	4	80	0.0500000
NODE_7069_length_977_cov_22.986333	366	446	4	38	80	0.4750000
NODE_7069_length_977_cov_22.986333	366	446	5	25	80	0.3125000
NODE_7069_length_977_cov_22.986333	366	446	6	13	80	0.1625000
NODE_7069_length_977_cov_22.986333	442	522	6	11	80	0.1375000
NODE_7069_length_977_cov_22.986333	442	522	7	50	80	0.6250000
NODE_7069_length_977_cov_22.986333	442	522	8	14	80	0.1750000
NODE_7069_length_977_cov_22.986333	442	522	9	5	80	0.0625000
NODE_7069_length_977_cov_22.986333	495	575	4	5	80	0.0625000
NODE_7069_length_977_cov_22.986333	495	575	5	13	80	0.1625000
NODE_7069_length_977_cov_22.986333	495	575	6	37	80	0.4625000
NODE_7069_length_977_cov_22.986333	495	575	7	25	80	0.3125000
NODE_7070_length_977_cov_10.753986	290	370	9	4	80	0.0500000
NODE_7070_length_977_cov_10.753986	290	370	10	1	80	0.0125000
NODE_7070_length_977_cov_10.753986	290	370	11	31	80	0.3875000
NODE_7070_length_977_cov_10.753986	290	370	12	11	80	0.1375000
NODE_7070_length_977_cov_10.753986	290	370	13	33	80	0.4125000
NODE_7070_length_977_cov_10.753986	343	423	11	37	80	0.4625000
NODE_7070_length_977_cov_10.753986	343	423	13	6	80	0.0750000
NODE_7070_length_977_cov_10.753986	343	423	14	9	80	0.1125000
NODE_7070_length_977_cov_10.753986	343	423	15	5	80	0.0625000
NODE_7070_length_977_cov_10.753986	343	423	16	23	80	0.2875000
NODE_7071_length_977_cov_9.924829	401	456	0	55	55	1.0000000
NODE_7073_length_977_cov_6.391800	483	563	0	56	80	0.7000000
NODE_7073_length_977_cov_6.391800	483	563	1	23	80	0.2875000
NODE_7073_length_977_cov_6.391800	483	563	2	1	80	0.0125000
NODE_7073_length_977_cov_6.391800	536	616	0	3	80	0.0375000
NODE_7073_length_977_cov_6.391800	536	616	1	23	80	0.2875000
NODE_7073_length_977_cov_6.391800	536	616	2	54	80	0.6750000
NODE_7075_length_977_cov_2.907745	191	241	1	50	50	1.0000000
NODE_7085_length_976_cov_38.192702	326	406	0	63	80	0.7875000
NODE_7085_length_976_cov_38.192702	326	406	1	12	80	0.1500000
NODE_7085_length_976_cov_38.192702	326	406	3	3	80	0.0375000
NODE_7085_length_976_cov_38.192702	326	406	4	2	80	0.0250000
NODE_7085_length_976_cov_38.192702	379	459	0	10	80	0.1250000
NODE_7085_length_976_cov_38.192702	379	459	1	12	80	0.1500000
NODE_7085_length_976_cov_38.192702	379	459	3	3	80	0.0375000
NODE_7085_length_976_cov_38.192702	379	459	4	20	80	0.2500000
NODE_7085_length_976_cov_38.192702	379	459	5	11	80	0.1375000
NODE_7085_length_976_cov_38.192702	379	459	6	6	80	0.0750000
NODE_7085_length_976_cov_38.192702	379	459	7	7	80	0.0875000
NODE_7085_length_976_cov_38.192702	379	459	9	11	80	0.1375000
NODE_7085_length_976_cov_38.192702	455	535	9	4	80	0.0500000
NODE_7085_length_976_cov_38.192702	455	535	10	14	80	0.1750000
NODE_7085_length_976_cov_38.192702	455	535	11	2	80	0.0250000
NODE_7085_length_976_cov_38.192702	455	535	12	17	80	0.2125000
NODE_7085_length_976_cov_38.192702	455	535	13	6	80	0.0750000
NODE_7085_length_976_cov_38.192702	455	535	14	9	80	0.1125000
NODE_7085_length_976_cov_38.192702	455	535	15	16	80	0.2000000
NODE_7085_length_976_cov_38.192702	455	535	16	12	80	0.1500000
NODE_7085_length_976_cov_38.192702	455	536	9	4	81	0.0493827
NODE_7085_length_976_cov_38.192702	455	536	10	14	81	0.1728395
NODE_7085_length_976_cov_38.192702	455	536	11	2	81	0.0246914
NODE_7085_length_976_cov_38.192702	455	536	12	17	81	0.2098765
NODE_7085_length_976_cov_38.192702	455	536	13	6	81	0.0740741
NODE_7085_length_976_cov_38.192702	455	536	14	9	81	0.1111111
NODE_7085_length_976_cov_38.192702	455	536	15	16	81	0.1975309
NODE_7085_length_976_cov_38.192702	455	536	16	13	81	0.1604938
NODE_7085_length_976_cov_38.192702	455	519	9	4	64	0.0625000
NODE_7085_length_976_cov_38.192702	455	519	10	14	64	0.2187500
NODE_7085_length_976_cov_38.192702	455	519	11	2	64	0.0312500
NODE_7085_length_976_cov_38.192702	455	519	12	17	64	0.2656250
NODE_7085_length_976_cov_38.192702	455	519	13	6	64	0.0937500
NODE_7085_length_976_cov_38.192702	455	519	14	9	64	0.1406250
NODE_7085_length_976_cov_38.192702	455	519	15	12	64	0.1875000
NODE_7085_length_976_cov_38.192702	508	588	12	3	80	0.0375000
NODE_7085_length_976_cov_38.192702	508	588	13	13	80	0.1625000
NODE_7085_length_976_cov_38.192702	508	588	14	6	80	0.0750000
NODE_7085_length_976_cov_38.192702	508	588	15	31	80	0.3875000
NODE_7085_length_976_cov_38.192702	508	588	16	27	80	0.3375000
NODE_7086_length_976_cov_26.275941	499	579	4	3	80	0.0375000
NODE_7086_length_976_cov_26.275941	499	579	5	1	80	0.0125000
NODE_7086_length_976_cov_26.275941	499	579	6	64	80	0.8000000
NODE_7086_length_976_cov_26.275941	499	579	7	12	80	0.1500000
NODE_7086_length_976_cov_26.275941	552	632	5	47	80	0.5875000
NODE_7086_length_976_cov_26.275941	552	632	6	16	80	0.2000000
NODE_7086_length_976_cov_26.275941	552	632	7	17	80	0.2125000
NODE_7087_length_976_cov_25.559863	376	456	7	8	80	0.1000000
NODE_7087_length_976_cov_25.559863	376	456	9	49	80	0.6125000
NODE_7087_length_976_cov_25.559863	376	456	10	14	80	0.1750000
NODE_7087_length_976_cov_25.559863	376	456	11	1	80	0.0125000
NODE_7087_length_976_cov_25.559863	376	456	12	8	80	0.1000000
NODE_7087_length_976_cov_25.559863	429	509	9	22	80	0.2750000
NODE_7087_length_976_cov_25.559863	429	509	10	42	80	0.5250000
NODE_7087_length_976_cov_25.559863	429	509	11	5	80	0.0625000
NODE_7087_length_976_cov_25.559863	429	509	12	11	80	0.1375000
NODE_7088_length_976_cov_17.961231	572	652	6	1	80	0.0125000
NODE_7088_length_976_cov_17.961231	572	652	7	30	80	0.3750000
NODE_7088_length_976_cov_17.961231	572	652	8	7	80	0.0875000
NODE_7088_length_976_cov_17.961231	572	652	9	42	80	0.5250000
NODE_7088_length_976_cov_17.961231	625	705	5	3	80	0.0375000
NODE_7088_length_976_cov_17.961231	625	705	7	8	80	0.1000000
NODE_7088_length_976_cov_17.961231	625	705	8	49	80	0.6125000
NODE_7088_length_976_cov_17.961231	625	705	9	20	80	0.2500000
NODE_7089_length_976_cov_5.567845	789	851	0	16	62	0.2580645
NODE_7089_length_976_cov_5.567845	789	851	1	46	62	0.7419355
NODE_7089_length_976_cov_5.567845	842	904	1	62	62	1.0000000
NODE_7101_length_975_cov_192.211187	722	802	5	19	80	0.2375000
NODE_7101_length_975_cov_192.211187	722	802	6	4	80	0.0500000
NODE_7101_length_975_cov_192.211187	722	802	7	8	80	0.1000000
NODE_7101_length_975_cov_192.211187	722	802	8	18	80	0.2250000
NODE_7101_length_975_cov_192.211187	722	802	10	5	80	0.0625000
NODE_7101_length_975_cov_192.211187	722	802	11	19	80	0.2375000
NODE_7101_length_975_cov_192.211187	722	802	12	5	80	0.0625000
NODE_7101_length_975_cov_192.211187	722	802	15	2	80	0.0250000
NODE_7102_length_975_cov_41.446347	414	494	11	14	80	0.1750000
NODE_7102_length_975_cov_41.446347	414	494	13	2	80	0.0250000
NODE_7102_length_975_cov_41.446347	414	494	14	6	80	0.0750000
NODE_7102_length_975_cov_41.446347	414	494	15	4	80	0.0500000
NODE_7102_length_975_cov_41.446347	414	494	16	5	80	0.0625000
NODE_7102_length_975_cov_41.446347	414	494	18	11	80	0.1375000
NODE_7102_length_975_cov_41.446347	414	494	19	29	80	0.3625000
NODE_7102_length_975_cov_41.446347	414	494	20	9	80	0.1125000
NODE_7102_length_975_cov_41.446347	467	547	18	15	80	0.1875000
NODE_7102_length_975_cov_41.446347	467	547	19	41	80	0.5125000
NODE_7102_length_975_cov_41.446347	467	547	20	16	80	0.2000000
NODE_7102_length_975_cov_41.446347	467	547	22	8	80	0.1000000
NODE_7103_length_975_cov_37.618721	375	455	5	6	80	0.0750000
NODE_7103_length_975_cov_37.618721	375	455	6	11	80	0.1375000
NODE_7103_length_975_cov_37.618721	375	455	7	13	80	0.1625000
NODE_7103_length_975_cov_37.618721	375	455	8	9	80	0.1125000
NODE_7103_length_975_cov_37.618721	375	455	9	33	80	0.4125000
NODE_7103_length_975_cov_37.618721	375	455	10	8	80	0.1000000
NODE_7103_length_975_cov_37.618721	428	508	2	4	80	0.0500000
NODE_7103_length_975_cov_37.618721	428	508	3	28	80	0.3500000
NODE_7103_length_975_cov_37.618721	428	508	5	27	80	0.3375000
NODE_7103_length_975_cov_37.618721	428	508	6	11	80	0.1375000
NODE_7103_length_975_cov_37.618721	428	508	7	10	80	0.1250000
NODE_7104_length_975_cov_34.265982	424	504	4	5	80	0.0625000
NODE_7104_length_975_cov_34.265982	424	504	5	11	80	0.1375000
NODE_7104_length_975_cov_34.265982	424	504	6	10	80	0.1250000
NODE_7104_length_975_cov_34.265982	424	504	7	15	80	0.1875000
NODE_7104_length_975_cov_34.265982	424	504	8	1	80	0.0125000
NODE_7104_length_975_cov_34.265982	424	504	9	38	80	0.4750000
NODE_7104_length_975_cov_34.265982	477	557	9	53	80	0.6625000
NODE_7104_length_975_cov_34.265982	477	557	10	11	80	0.1375000
NODE_7104_length_975_cov_34.265982	477	557	11	16	80	0.2000000
NODE_7105_length_975_cov_31.888128	461	541	0	80	80	1.0000000
NODE_7105_length_975_cov_31.888128	514	594	0	80	80	1.0000000
NODE_7106_length_975_cov_22.093607	392	472	22	16	80	0.2000000
NODE_7106_length_975_cov_22.093607	392	472	24	10	80	0.1250000
NODE_7106_length_975_cov_22.093607	392	472	25	16	80	0.2000000
NODE_7106_length_975_cov_22.093607	392	472	27	14	80	0.1750000
NODE_7106_length_975_cov_22.093607	392	472	28	1	80	0.0125000
NODE_7106_length_975_cov_22.093607	392	472	31	7	80	0.0875000
NODE_7106_length_975_cov_22.093607	392	472	33	3	80	0.0375000
NODE_7106_length_975_cov_22.093607	392	472	38	13	80	0.1625000
NODE_7106_length_975_cov_22.093607	445	525	18	1	80	0.0125000
NODE_7106_length_975_cov_22.093607	445	525	27	3	80	0.0375000
NODE_7106_length_975_cov_22.093607	445	525	28	1	80	0.0125000
NODE_7106_length_975_cov_22.093607	445	525	31	7	80	0.0875000
NODE_7106_length_975_cov_22.093607	445	525	32	6	80	0.0750000
NODE_7106_length_975_cov_22.093607	445	525	33	5	80	0.0625000
NODE_7106_length_975_cov_22.093607	445	525	34	13	80	0.1625000
NODE_7106_length_975_cov_22.093607	445	525	37	17	80	0.2125000
NODE_7106_length_975_cov_22.093607	445	525	38	27	80	0.3375000
NODE_7107_length_975_cov_15.091324	403	483	12	1	80	0.0125000
NODE_7107_length_975_cov_15.091324	403	483	13	14	80	0.1750000
NODE_7107_length_975_cov_15.091324	403	483	15	11	80	0.1375000
NODE_7107_length_975_cov_15.091324	403	483	17	7	80	0.0875000
NODE_7107_length_975_cov_15.091324	403	483	18	6	80	0.0750000
NODE_7107_length_975_cov_15.091324	403	483	19	1	80	0.0125000
NODE_7107_length_975_cov_15.091324	403	483	20	23	80	0.2875000
NODE_7107_length_975_cov_15.091324	403	483	21	17	80	0.2125000
NODE_7107_length_975_cov_15.091324	456	536	18	13	80	0.1625000
NODE_7107_length_975_cov_15.091324	456	536	19	4	80	0.0500000
NODE_7107_length_975_cov_15.091324	456	536	20	36	80	0.4500000
NODE_7107_length_975_cov_15.091324	456	536	21	22	80	0.2750000
NODE_7107_length_975_cov_15.091324	456	536	23	5	80	0.0625000
NODE_7108_length_975_cov_15.046804	63	143	9	9	80	0.1125000
NODE_7108_length_975_cov_15.046804	63	143	10	1	80	0.0125000
NODE_7108_length_975_cov_15.046804	63	143	11	20	80	0.2500000
NODE_7108_length_975_cov_15.046804	63	143	14	11	80	0.1375000
NODE_7108_length_975_cov_15.046804	63	143	18	6	80	0.0750000
NODE_7108_length_975_cov_15.046804	63	143	21	4	80	0.0500000
NODE_7108_length_975_cov_15.046804	63	143	22	26	80	0.3250000
NODE_7108_length_975_cov_15.046804	63	143	25	2	80	0.0250000
NODE_7108_length_975_cov_15.046804	63	143	27	1	80	0.0125000
NODE_7108_length_975_cov_15.046804	116	196	19	18	80	0.2250000
NODE_7108_length_975_cov_15.046804	116	196	20	8	80	0.1000000
NODE_7108_length_975_cov_15.046804	116	196	22	24	80	0.3000000
NODE_7108_length_975_cov_15.046804	116	196	24	8	80	0.1000000
NODE_7108_length_975_cov_15.046804	116	196	25	21	80	0.2625000
NODE_7108_length_975_cov_15.046804	116	196	27	1	80	0.0125000
NODE_7109_length_975_cov_12.043379	535	615	16	13	80	0.1625000
NODE_7109_length_975_cov_12.043379	535	615	17	21	80	0.2625000
NODE_7109_length_975_cov_12.043379	535	615	18	39	80	0.4875000
NODE_7109_length_975_cov_12.043379	535	615	19	7	80	0.0875000
NODE_7109_length_975_cov_12.043379	588	668	5	10	80	0.1250000
NODE_7109_length_975_cov_12.043379	588	668	6	2	80	0.0250000
NODE_7109_length_975_cov_12.043379	588	668	17	39	80	0.4875000
NODE_7109_length_975_cov_12.043379	588	668	18	23	80	0.2875000
NODE_7109_length_975_cov_12.043379	588	668	19	6	80	0.0750000
NODE_7110_length_975_cov_11.772831	276	354	1	11	78	0.1410256
NODE_7110_length_975_cov_11.772831	276	354	2	67	78	0.8589743
NODE_7110_length_975_cov_11.772831	327	407	1	25	80	0.3125000
NODE_7110_length_975_cov_11.772831	327	407	2	55	80	0.6875000
NODE_7111_length_975_cov_10.599315	405	485	0	80	80	1.0000000
NODE_7111_length_975_cov_10.599315	458	538	0	80	80	1.0000000
NODE_7112_length_975_cov_8.089041	430	510	1	9	80	0.1125000
NODE_7112_length_975_cov_8.089041	430	510	2	71	80	0.8875000
NODE_7112_length_975_cov_8.089041	483	563	2	80	80	1.0000000
NODE_7114_length_975_cov_3.728311	254	334	0	9	80	0.1125000
NODE_7114_length_975_cov_3.728311	254	334	1	71	80	0.8875000
NODE_7114_length_975_cov_3.728311	307	387	1	71	80	0.8875000
NODE_7114_length_975_cov_3.728311	307	387	2	9	80	0.1125000
NODE_7125_length_974_cov_293.334857	564	642	86	1	78	0.0128205
NODE_7125_length_974_cov_293.334857	564	642	88	1	78	0.0128205
NODE_7125_length_974_cov_293.334857	564	642	90	11	78	0.1410256
NODE_7125_length_974_cov_293.334857	564	642	92	1	78	0.0128205
NODE_7125_length_974_cov_293.334857	564	642	93	6	78	0.0769231
NODE_7125_length_974_cov_293.334857	564	642	94	4	78	0.0512821
NODE_7125_length_974_cov_293.334857	564	642	95	8	78	0.1025641
NODE_7125_length_974_cov_293.334857	564	642	102	1	78	0.0128205
NODE_7125_length_974_cov_293.334857	564	642	104	2	78	0.0256410
NODE_7125_length_974_cov_293.334857	564	642	105	2	78	0.0256410
NODE_7125_length_974_cov_293.334857	564	642	106	1	78	0.0128205
NODE_7125_length_974_cov_293.334857	564	642	107	1	78	0.0128205
NODE_7125_length_974_cov_293.334857	564	642	108	3	78	0.0384615
NODE_7125_length_974_cov_293.334857	564	642	109	1	78	0.0128205
NODE_7125_length_974_cov_293.334857	564	642	110	4	78	0.0512821
NODE_7125_length_974_cov_293.334857	564	642	111	4	78	0.0512821
NODE_7125_length_974_cov_293.334857	564	642	112	3	78	0.0384615
NODE_7125_length_974_cov_293.334857	564	642	113	1	78	0.0128205
NODE_7125_length_974_cov_293.334857	564	642	115	7	78	0.0897436
NODE_7125_length_974_cov_293.334857	564	642	117	2	78	0.0256410
NODE_7125_length_974_cov_293.334857	564	642	119	1	78	0.0128205
NODE_7125_length_974_cov_293.334857	564	642	120	2	78	0.0256410
NODE_7125_length_974_cov_293.334857	564	642	121	2	78	0.0256410
NODE_7125_length_974_cov_293.334857	564	642	122	2	78	0.0256410
NODE_7125_length_974_cov_293.334857	564	642	123	1	78	0.0128205
NODE_7125_length_974_cov_293.334857	564	642	124	4	78	0.0512821
NODE_7125_length_974_cov_293.334857	564	642	127	2	78	0.0256410
NODE_7125_length_974_cov_293.334857	564	642	86	1	78	0.0128205
NODE_7125_length_974_cov_293.334857	564	642	88	1	78	0.0128205
NODE_7125_length_974_cov_293.334857	564	642	90	11	78	0.1410256
NODE_7125_length_974_cov_293.334857	564	642	92	1	78	0.0128205
NODE_7125_length_974_cov_293.334857	564	642	93	6	78	0.0769231
NODE_7125_length_974_cov_293.334857	564	642	94	4	78	0.0512821
NODE_7125_length_974_cov_293.334857	564	642	95	8	78	0.1025641
NODE_7125_length_974_cov_293.334857	564	642	102	1	78	0.0128205
NODE_7125_length_974_cov_293.334857	564	642	104	2	78	0.0256410
NODE_7125_length_974_cov_293.334857	564	642	105	2	78	0.0256410
NODE_7125_length_974_cov_293.334857	564	642	106	1	78	0.0128205
NODE_7125_length_974_cov_293.334857	564	642	107	1	78	0.0128205
NODE_7125_length_974_cov_293.334857	564	642	108	3	78	0.0384615
NODE_7125_length_974_cov_293.334857	564	642	109	1	78	0.0128205
NODE_7125_length_974_cov_293.334857	564	642	110	4	78	0.0512821
NODE_7125_length_974_cov_293.334857	564	642	111	4	78	0.0512821
NODE_7125_length_974_cov_293.334857	564	642	112	3	78	0.0384615
NODE_7125_length_974_cov_293.334857	564	642	113	1	78	0.0128205
NODE_7125_length_974_cov_293.334857	564	642	115	7	78	0.0897436
NODE_7125_length_974_cov_293.334857	564	642	117	2	78	0.0256410
NODE_7125_length_974_cov_293.334857	564	642	119	1	78	0.0128205
NODE_7125_length_974_cov_293.334857	564	642	120	2	78	0.0256410
NODE_7125_length_974_cov_293.334857	564	642	121	2	78	0.0256410
NODE_7125_length_974_cov_293.334857	564	642	122	2	78	0.0256410
NODE_7125_length_974_cov_293.334857	564	642	123	1	78	0.0128205
NODE_7125_length_974_cov_293.334857	564	642	124	4	78	0.0512821
NODE_7125_length_974_cov_293.334857	564	642	127	2	78	0.0256410
NODE_7125_length_974_cov_293.334857	564	633	90	7	69	0.1014493
NODE_7125_length_974_cov_293.334857	564	633	93	5	69	0.0724638
NODE_7125_length_974_cov_293.334857	564	633	94	3	69	0.0434783
NODE_7125_length_974_cov_293.334857	564	633	95	8	69	0.1159420
NODE_7125_length_974_cov_293.334857	564	633	102	1	69	0.0144928
NODE_7125_length_974_cov_293.334857	564	633	104	2	69	0.0289855
NODE_7125_length_974_cov_293.334857	564	633	105	2	69	0.0289855
NODE_7125_length_974_cov_293.334857	564	633	106	1	69	0.0144928
NODE_7125_length_974_cov_293.334857	564	633	107	1	69	0.0144928
NODE_7125_length_974_cov_293.334857	564	633	108	3	69	0.0434783
NODE_7125_length_974_cov_293.334857	564	633	109	1	69	0.0144928
NODE_7125_length_974_cov_293.334857	564	633	110	4	69	0.0579710
NODE_7125_length_974_cov_293.334857	564	633	111	4	69	0.0579710
NODE_7125_length_974_cov_293.334857	564	633	112	3	69	0.0434783
NODE_7125_length_974_cov_293.334857	564	633	113	1	69	0.0144928
NODE_7125_length_974_cov_293.334857	564	633	115	7	69	0.1014493
NODE_7125_length_974_cov_293.334857	564	633	117	2	69	0.0289855
NODE_7125_length_974_cov_293.334857	564	633	119	1	69	0.0144928
NODE_7125_length_974_cov_293.334857	564	633	120	2	69	0.0289855
NODE_7125_length_974_cov_293.334857	564	633	121	2	69	0.0289855
NODE_7125_length_974_cov_293.334857	564	633	122	2	69	0.0289855
NODE_7125_length_974_cov_293.334857	564	633	123	1	69	0.0144928
NODE_7125_length_974_cov_293.334857	564	633	124	4	69	0.0579710
NODE_7125_length_974_cov_293.334857	564	633	127	2	69	0.0289855
NODE_7126_length_974_cov_49.884571	459	539	9	20	80	0.2500000
NODE_7126_length_974_cov_49.884571	459	539	12	7	80	0.0875000
NODE_7126_length_974_cov_49.884571	459	539	13	9	80	0.1125000
NODE_7126_length_974_cov_49.884571	459	539	14	14	80	0.1750000
NODE_7126_length_974_cov_49.884571	459	539	15	11	80	0.1375000
NODE_7126_length_974_cov_49.884571	459	539	17	1	80	0.0125000
NODE_7126_length_974_cov_49.884571	459	539	19	5	80	0.0625000
NODE_7126_length_974_cov_49.884571	459	539	20	7	80	0.0875000
NODE_7126_length_974_cov_49.884571	459	539	21	6	80	0.0750000
NODE_7126_length_974_cov_49.884571	512	592	14	6	80	0.0750000
NODE_7126_length_974_cov_49.884571	512	592	15	9	80	0.1125000
NODE_7126_length_974_cov_49.884571	512	592	16	12	80	0.1500000
NODE_7126_length_974_cov_49.884571	512	592	17	24	80	0.3000000
NODE_7126_length_974_cov_49.884571	512	592	19	16	80	0.2000000
NODE_7126_length_974_cov_49.884571	512	592	20	7	80	0.0875000
NODE_7126_length_974_cov_49.884571	512	592	21	6	80	0.0750000
NODE_7127_length_974_cov_38.384000	430	508	12	9	78	0.1153846
NODE_7127_length_974_cov_38.384000	430	508	13	33	78	0.4230769
NODE_7127_length_974_cov_38.384000	430	508	16	18	78	0.2307692
NODE_7127_length_974_cov_38.384000	430	508	17	5	78	0.0641026
NODE_7127_length_974_cov_38.384000	430	508	18	2	78	0.0256410
NODE_7127_length_974_cov_38.384000	430	508	20	11	78	0.1410256
NODE_7127_length_974_cov_38.384000	483	561	11	36	78	0.4615385
NODE_7127_length_974_cov_38.384000	483	561	12	21	78	0.2692308
NODE_7127_length_974_cov_38.384000	483	561	13	4	78	0.0512821
NODE_7127_length_974_cov_38.384000	483	561	16	4	78	0.0512821
NODE_7127_length_974_cov_38.384000	483	561	17	2	78	0.0256410
NODE_7127_length_974_cov_38.384000	483	561	20	11	78	0.1410256
NODE_7128_length_974_cov_26.008000	391	471	1	40	80	0.5000000
NODE_7128_length_974_cov_26.008000	391	471	4	3	80	0.0375000
NODE_7128_length_974_cov_26.008000	391	471	7	11	80	0.1375000
NODE_7128_length_974_cov_26.008000	391	471	10	2	80	0.0250000
NODE_7128_length_974_cov_26.008000	391	471	11	12	80	0.1500000
NODE_7128_length_974_cov_26.008000	391	471	13	12	80	0.1500000
NODE_7128_length_974_cov_26.008000	444	524	7	1	80	0.0125000
NODE_7128_length_974_cov_26.008000	444	524	10	2	80	0.0250000
NODE_7128_length_974_cov_26.008000	444	524	11	12	80	0.1500000
NODE_7128_length_974_cov_26.008000	444	524	12	10	80	0.1250000
NODE_7128_length_974_cov_26.008000	444	524	13	43	80	0.5375000
NODE_7128_length_974_cov_26.008000	444	524	15	3	80	0.0375000
NODE_7128_length_974_cov_26.008000	444	524	19	9	80	0.1125000
NODE_7128_length_974_cov_26.008000	520	600	16	5	80	0.0625000
NODE_7128_length_974_cov_26.008000	520	600	19	12	80	0.1500000
NODE_7128_length_974_cov_26.008000	520	600	20	11	80	0.1375000
NODE_7128_length_974_cov_26.008000	520	600	21	13	80	0.1625000
NODE_7128_length_974_cov_26.008000	520	600	23	2	80	0.0250000
NODE_7128_length_974_cov_26.008000	520	600	24	37	80	0.4625000
NODE_7128_length_974_cov_26.008000	573	653	13	16	80	0.2000000
NODE_7128_length_974_cov_26.008000	573	653	14	28	80	0.3500000
NODE_7128_length_974_cov_26.008000	573	653	16	14	80	0.1750000
NODE_7128_length_974_cov_26.008000	573	653	20	11	80	0.1375000
NODE_7128_length_974_cov_26.008000	573	653	21	1	80	0.0125000
NODE_7128_length_974_cov_26.008000	573	653	23	2	80	0.0250000
NODE_7128_length_974_cov_26.008000	573	653	24	8	80	0.1000000
NODE_7129_length_974_cov_21.160000	460	540	3	17	80	0.2125000
NODE_7129_length_974_cov_21.160000	460	540	4	13	80	0.1625000
NODE_7129_length_974_cov_21.160000	460	540	5	3	80	0.0375000
NODE_7129_length_974_cov_21.160000	460	540	7	5	80	0.0625000
NODE_7129_length_974_cov_21.160000	460	540	8	25	80	0.3125000
NODE_7129_length_974_cov_21.160000	460	540	9	17	80	0.2125000
NODE_7129_length_974_cov_21.160000	513	593	0	47	80	0.5875000
NODE_7129_length_974_cov_21.160000	513	593	2	3	80	0.0375000
NODE_7129_length_974_cov_21.160000	513	593	3	20	80	0.2500000
NODE_7129_length_974_cov_21.160000	513	593	4	10	80	0.1250000
NODE_7131_length_974_cov_11.384000	290	370	1	9	80	0.1125000
NODE_7131_length_974_cov_11.384000	290	370	2	50	80	0.6250000
NODE_7131_length_974_cov_11.384000	290	370	3	21	80	0.2625000
NODE_7131_length_974_cov_11.384000	343	423	1	6	80	0.0750000
NODE_7131_length_974_cov_11.384000	343	423	2	18	80	0.2250000
NODE_7131_length_974_cov_11.384000	343	423	3	56	80	0.7000000
NODE_7132_length_974_cov_11.216000	543	623	2	26	80	0.3250000
NODE_7132_length_974_cov_11.216000	543	623	3	54	80	0.6750000
NODE_7132_length_974_cov_11.216000	596	668	1	7	72	0.0972222
NODE_7132_length_974_cov_11.216000	596	668	2	62	72	0.8611111
NODE_7132_length_974_cov_11.216000	596	668	3	3	72	0.0416667
NODE_7133_length_974_cov_9.601143	436	516	1	10	80	0.1250000
NODE_7133_length_974_cov_9.601143	436	516	3	37	80	0.4625000
NODE_7133_length_974_cov_9.601143	436	516	4	2	80	0.0250000
NODE_7133_length_974_cov_9.601143	436	516	6	14	80	0.1750000
NODE_7133_length_974_cov_9.601143	436	516	9	17	80	0.2125000
NODE_7133_length_974_cov_9.601143	489	569	6	10	80	0.1250000
NODE_7133_length_974_cov_9.601143	489	569	8	17	80	0.2125000
NODE_7133_length_974_cov_9.601143	489	569	9	53	80	0.6625000
NODE_7134_length_974_cov_7.436571	382	462	2	1	80	0.0125000
NODE_7134_length_974_cov_7.436571	382	462	3	41	80	0.5125000
NODE_7134_length_974_cov_7.436571	382	462	4	37	80	0.4625000
NODE_7134_length_974_cov_7.436571	382	462	5	1	80	0.0125000
NODE_7134_length_974_cov_7.436571	436	515	2	23	79	0.2911392
NODE_7134_length_974_cov_7.436571	436	515	3	23	79	0.2911392
NODE_7134_length_974_cov_7.436571	436	515	4	29	79	0.3670886
NODE_7134_length_974_cov_7.436571	436	515	5	4	79	0.0506329
NODE_7147_length_973_cov_46.012586	349	429	7	9	80	0.1125000
NODE_7147_length_973_cov_46.012586	349	429	8	8	80	0.1000000
NODE_7147_length_973_cov_46.012586	349	429	9	10	80	0.1250000
NODE_7147_length_973_cov_46.012586	349	429	10	40	80	0.5000000
NODE_7147_length_973_cov_46.012586	349	429	11	13	80	0.1625000
NODE_7147_length_973_cov_46.012586	402	482	9	1	80	0.0125000
NODE_7147_length_973_cov_46.012586	402	482	10	31	80	0.3875000
NODE_7147_length_973_cov_46.012586	402	482	11	20	80	0.2500000
NODE_7147_length_973_cov_46.012586	402	482	12	2	80	0.0250000
NODE_7147_length_973_cov_46.012586	402	482	13	18	80	0.2250000
NODE_7147_length_973_cov_46.012586	402	482	15	8	80	0.1000000
NODE_7147_length_973_cov_46.012586	478	558	12	13	80	0.1625000
NODE_7147_length_973_cov_46.012586	478	558	13	22	80	0.2750000
NODE_7147_length_973_cov_46.012586	478	558	14	19	80	0.2375000
NODE_7147_length_973_cov_46.012586	478	558	15	14	80	0.1750000
NODE_7147_length_973_cov_46.012586	478	558	16	12	80	0.1500000
NODE_7147_length_973_cov_46.012586	531	611	10	5	80	0.0625000
NODE_7147_length_973_cov_46.012586	531	611	11	2	80	0.0250000
NODE_7147_length_973_cov_46.012586	531	611	12	20	80	0.2500000
NODE_7147_length_973_cov_46.012586	531	611	13	35	80	0.4375000
NODE_7147_length_973_cov_46.012586	531	611	14	18	80	0.2250000
NODE_7148_length_973_cov_40.305492	364	444	19	2	80	0.0250000
NODE_7148_length_973_cov_40.305492	364	444	20	7	80	0.0875000
NODE_7148_length_973_cov_40.305492	364	444	22	3	80	0.0375000
NODE_7148_length_973_cov_40.305492	364	444	25	2	80	0.0250000
NODE_7148_length_973_cov_40.305492	364	444	26	2	80	0.0250000
NODE_7148_length_973_cov_40.305492	364	444	30	14	80	0.1750000
NODE_7148_length_973_cov_40.305492	364	444	32	8	80	0.1000000
NODE_7148_length_973_cov_40.305492	364	444	33	24	80	0.3000000
NODE_7148_length_973_cov_40.305492	364	444	34	7	80	0.0875000
NODE_7148_length_973_cov_40.305492	364	444	35	9	80	0.1125000
NODE_7148_length_973_cov_40.305492	364	444	38	1	80	0.0125000
NODE_7148_length_973_cov_40.305492	364	444	39	1	80	0.0125000
NODE_7148_length_973_cov_40.305492	417	497	31	2	80	0.0250000
NODE_7148_length_973_cov_40.305492	417	497	32	17	80	0.2125000
NODE_7148_length_973_cov_40.305492	417	497	33	28	80	0.3500000
NODE_7148_length_973_cov_40.305492	417	497	34	14	80	0.1750000
NODE_7148_length_973_cov_40.305492	417	497	35	9	80	0.1125000
NODE_7148_length_973_cov_40.305492	417	497	37	6	80	0.0750000
NODE_7148_length_973_cov_40.305492	417	497	38	2	80	0.0250000
NODE_7148_length_973_cov_40.305492	417	497	39	2	80	0.0250000
NODE_7149_length_973_cov_24.105263	460	540	10	5	80	0.0625000
NODE_7149_length_973_cov_24.105263	460	540	12	1	80	0.0125000
NODE_7149_length_973_cov_24.105263	460	540	13	1	80	0.0125000
NODE_7149_length_973_cov_24.105263	460	540	14	4	80	0.0500000
NODE_7149_length_973_cov_24.105263	460	540	15	3	80	0.0375000
NODE_7149_length_973_cov_24.105263	460	540	16	35	80	0.4375000
NODE_7149_length_973_cov_24.105263	460	540	17	13	80	0.1625000
NODE_7149_length_973_cov_24.105263	460	540	18	4	80	0.0500000
NODE_7149_length_973_cov_24.105263	460	540	19	1	80	0.0125000
NODE_7149_length_973_cov_24.105263	460	540	20	3	80	0.0375000
NODE_7149_length_973_cov_24.105263	460	540	21	3	80	0.0375000
NODE_7149_length_973_cov_24.105263	460	540	22	6	80	0.0750000
NODE_7149_length_973_cov_24.105263	460	540	23	1	80	0.0125000
NODE_7149_length_973_cov_24.105263	513	593	16	4	80	0.0500000
NODE_7149_length_973_cov_24.105263	513	593	17	5	80	0.0625000
NODE_7149_length_973_cov_24.105263	513	593	18	4	80	0.0500000
NODE_7149_length_973_cov_24.105263	513	593	19	1	80	0.0125000
NODE_7149_length_973_cov_24.105263	513	593	20	3	80	0.0375000
NODE_7149_length_973_cov_24.105263	513	593	21	4	80	0.0500000
NODE_7149_length_973_cov_24.105263	513	593	22	11	80	0.1375000
NODE_7149_length_973_cov_24.105263	513	593	23	15	80	0.1875000
NODE_7149_length_973_cov_24.105263	513	593	24	3	80	0.0375000
NODE_7149_length_973_cov_24.105263	513	593	25	12	80	0.1500000
NODE_7149_length_973_cov_24.105263	513	593	26	12	80	0.1500000
NODE_7149_length_973_cov_24.105263	513	593	27	6	80	0.0750000
NODE_7150_length_973_cov_22.106407	342	422	0	80	80	1.0000000
NODE_7150_length_973_cov_22.106407	395	475	0	80	80	1.0000000
NODE_7150_length_973_cov_22.106407	471	550	0	13	79	0.1645570
NODE_7150_length_973_cov_22.106407	471	550	1	66	79	0.8354430
NODE_7150_length_973_cov_22.106407	526	604	1	68	78	0.8717949
NODE_7150_length_973_cov_22.106407	526	604	2	10	78	0.1282051
NODE_7151_length_973_cov_10.994279	430	510	8	18	80	0.2250000
NODE_7151_length_973_cov_10.994279	430	510	11	7	80	0.0875000
NODE_7151_length_973_cov_10.994279	430	510	13	10	80	0.1250000
NODE_7151_length_973_cov_10.994279	430	510	14	31	80	0.3875000
NODE_7151_length_973_cov_10.994279	430	510	15	14	80	0.1750000
NODE_7151_length_973_cov_10.994279	483	563	8	56	80	0.7000000
NODE_7151_length_973_cov_10.994279	483	563	9	1	80	0.0125000
NODE_7151_length_973_cov_10.994279	483	563	10	14	80	0.1750000
NODE_7151_length_973_cov_10.994279	483	563	11	7	80	0.0875000
NODE_7151_length_973_cov_10.994279	483	563	13	1	80	0.0125000
NODE_7151_length_973_cov_10.994279	483	563	15	1	80	0.0125000
NODE_7151_length_973_cov_10.994279	559	635	7	32	76	0.4210526
NODE_7151_length_973_cov_10.994279	559	635	8	33	76	0.4342105
NODE_7151_length_973_cov_10.994279	559	635	9	11	76	0.1447368
NODE_7151_length_973_cov_10.994279	608	688	5	21	80	0.2625000
NODE_7151_length_973_cov_10.994279	608	688	7	56	80	0.7000000
NODE_7151_length_973_cov_10.994279	608	688	9	3	80	0.0375000
NODE_7153_length_973_cov_2.973684	734	814	0	80	80	1.0000000
NODE_7153_length_973_cov_2.973684	820	890	0	2	70	0.0285714
NODE_7153_length_973_cov_2.973684	820	890	2	2	70	0.0285714
NODE_7153_length_973_cov_2.973684	820	890	4	66	70	0.9428571
NODE_7153_length_973_cov_2.973684	863	944	4	81	81	1.0000000
NODE_7166_length_972_cov_32.547537	299	379	13	22	80	0.2750000
NODE_7166_length_972_cov_32.547537	299	379	16	37	80	0.4625000
NODE_7166_length_972_cov_32.547537	299	379	19	21	80	0.2625000
NODE_7166_length_972_cov_32.547537	352	432	13	4	80	0.0500000
NODE_7166_length_972_cov_32.547537	352	432	14	3	80	0.0375000
NODE_7166_length_972_cov_32.547537	352	432	15	1	80	0.0125000
NODE_7166_length_972_cov_32.547537	352	432	16	27	80	0.3375000
NODE_7166_length_972_cov_32.547537	352	432	17	9	80	0.1125000
NODE_7166_length_972_cov_32.547537	352	432	18	10	80	0.1250000
NODE_7166_length_972_cov_32.547537	352	432	19	26	80	0.3250000
NODE_7166_length_972_cov_32.547537	428	508	7	1	80	0.0125000
NODE_7166_length_972_cov_32.547537	428	508	8	16	80	0.2000000
NODE_7166_length_972_cov_32.547537	428	508	11	33	80	0.4125000
NODE_7166_length_972_cov_32.547537	428	508	13	8	80	0.1000000
NODE_7166_length_972_cov_32.547537	428	508	14	11	80	0.1375000
NODE_7166_length_972_cov_32.547537	428	508	16	11	80	0.1375000
NODE_7166_length_972_cov_32.547537	481	561	5	2	80	0.0250000
NODE_7166_length_972_cov_32.547537	481	561	6	38	80	0.4750000
NODE_7166_length_972_cov_32.547537	481	561	7	14	80	0.1750000
NODE_7166_length_972_cov_32.547537	481	561	8	16	80	0.2000000
NODE_7166_length_972_cov_32.547537	481	561	11	10	80	0.1250000
NODE_7167_length_972_cov_31.010309	474	554	11	25	80	0.3125000
NODE_7167_length_972_cov_31.010309	474	554	12	31	80	0.3875000
NODE_7167_length_972_cov_31.010309	474	554	13	24	80	0.3000000
NODE_7167_length_972_cov_31.010309	527	607	7	32	80	0.4000000
NODE_7167_length_972_cov_31.010309	527	607	8	11	80	0.1375000
NODE_7167_length_972_cov_31.010309	527	607	9	9	80	0.1125000
NODE_7167_length_972_cov_31.010309	527	607	11	9	80	0.1125000
NODE_7167_length_972_cov_31.010309	527	607	13	19	80	0.2375000
NODE_7168_length_972_cov_29.810997	481	561	11	5	80	0.0625000
NODE_7168_length_972_cov_29.810997	481	561	16	32	80	0.4000000
NODE_7168_length_972_cov_29.810997	481	561	17	35	80	0.4375000
NODE_7168_length_972_cov_29.810997	481	561	18	8	80	0.1000000
NODE_7168_length_972_cov_29.810997	534	614	8	4	80	0.0500000
NODE_7168_length_972_cov_29.810997	534	614	12	1	80	0.0125000
NODE_7168_length_972_cov_29.810997	534	614	13	6	80	0.0750000
NODE_7168_length_972_cov_29.810997	534	614	14	20	80	0.2500000
NODE_7168_length_972_cov_29.810997	534	614	16	27	80	0.3375000
NODE_7168_length_972_cov_29.810997	534	614	17	16	80	0.2000000
NODE_7168_length_972_cov_29.810997	534	614	18	6	80	0.0750000
NODE_7169_length_972_cov_23.438717	442	522	7	26	80	0.3250000
NODE_7169_length_972_cov_23.438717	442	522	8	1	80	0.0125000
NODE_7169_length_972_cov_23.438717	442	522	9	3	80	0.0375000
NODE_7169_length_972_cov_23.438717	442	522	11	10	80	0.1250000
NODE_7169_length_972_cov_23.438717	442	522	14	24	80	0.3000000
NODE_7169_length_972_cov_23.438717	442	522	15	4	80	0.0500000
NODE_7169_length_972_cov_23.438717	442	522	16	12	80	0.1500000
NODE_7169_length_972_cov_23.438717	495	575	13	2	80	0.0250000
NODE_7169_length_972_cov_23.438717	495	575	14	12	80	0.1500000
NODE_7169_length_972_cov_23.438717	495	575	15	41	80	0.5125000
NODE_7169_length_972_cov_23.438717	495	575	16	15	80	0.1875000
NODE_7169_length_972_cov_23.438717	495	575	19	10	80	0.1250000
NODE_7170_length_972_cov_18.886598	453	533	6	30	80	0.3750000
NODE_7170_length_972_cov_18.886598	453	533	7	17	80	0.2125000
NODE_7170_length_972_cov_18.886598	453	533	8	33	80	0.4125000
NODE_7170_length_972_cov_18.886598	506	585	2	5	79	0.0632911
NODE_7170_length_972_cov_18.886598	506	585	4	23	79	0.2911392
NODE_7170_length_972_cov_18.886598	506	585	5	10	79	0.1265823
NODE_7170_length_972_cov_18.886598	506	585	6	21	79	0.2658228
NODE_7170_length_972_cov_18.886598	506	585	8	20	79	0.2531646
NODE_7171_length_972_cov_15.100802	329	409	0	7	80	0.0875000
NODE_7171_length_972_cov_15.100802	329	409	1	18	80	0.2250000
NODE_7171_length_972_cov_15.100802	329	409	3	45	80	0.5625000
NODE_7171_length_972_cov_15.100802	329	409	4	10	80	0.1250000
NODE_7171_length_972_cov_15.100802	382	462	3	17	80	0.2125000
NODE_7171_length_972_cov_15.100802	382	462	4	36	80	0.4500000
NODE_7171_length_972_cov_15.100802	382	462	5	22	80	0.2750000
NODE_7171_length_972_cov_15.100802	382	462	7	5	80	0.0625000
NODE_7172_length_972_cov_12.674685	444	524	14	28	80	0.3500000
NODE_7172_length_972_cov_12.674685	444	524	15	40	80	0.5000000
NODE_7172_length_972_cov_12.674685	444	524	16	12	80	0.1500000
NODE_7172_length_972_cov_12.674685	497	577	9	5	80	0.0625000
NODE_7172_length_972_cov_12.674685	497	577	10	8	80	0.1000000
NODE_7172_length_972_cov_12.674685	497	577	13	31	80	0.3875000
NODE_7172_length_972_cov_12.674685	497	577	14	1	80	0.0125000
NODE_7172_length_972_cov_12.674685	497	577	15	24	80	0.3000000
NODE_7172_length_972_cov_12.674685	497	577	16	11	80	0.1375000
NODE_7173_length_972_cov_11.235968	504	584	0	50	80	0.6250000
NODE_7173_length_972_cov_11.235968	504	584	1	4	80	0.0500000
NODE_7173_length_972_cov_11.235968	504	584	2	17	80	0.2125000
NODE_7173_length_972_cov_11.235968	504	584	3	9	80	0.1125000
NODE_7173_length_972_cov_11.235968	557	637	1	1	80	0.0125000
NODE_7173_length_972_cov_11.235968	557	637	2	17	80	0.2125000
NODE_7173_length_972_cov_11.235968	557	637	3	34	80	0.4250000
NODE_7173_length_972_cov_11.235968	557	637	4	28	80	0.3500000
NODE_7174_length_972_cov_10.983963	402	482	4	80	80	1.0000000
NODE_7174_length_972_cov_10.983963	455	535	0	11	80	0.1375000
NODE_7174_length_972_cov_10.983963	455	535	4	69	80	0.8625000
NODE_7175_length_972_cov_8.887743	302	382	0	4	80	0.0500000
NODE_7175_length_972_cov_8.887743	302	382	1	39	80	0.4875000
NODE_7175_length_972_cov_8.887743	302	382	2	37	80	0.4625000
NODE_7175_length_972_cov_8.887743	355	430	0	52	75	0.6933333
NODE_7175_length_972_cov_8.887743	355	430	1	23	75	0.3066667
NODE_7176_length_972_cov_8.265750	488	568	4	14	80	0.1750000
NODE_7176_length_972_cov_8.265750	488	568	6	21	80	0.2625000
NODE_7176_length_972_cov_8.265750	488	568	8	2	80	0.0250000
NODE_7176_length_972_cov_8.265750	488	568	9	10	80	0.1250000
NODE_7176_length_972_cov_8.265750	488	568	10	33	80	0.4125000
NODE_7176_length_972_cov_8.265750	541	621	9	36	80	0.4500000
NODE_7176_length_972_cov_8.265750	541	621	10	44	80	0.5500000
NODE_7182_length_972_cov_2.714777	165	241	0	76	76	1.0000000
NODE_7195_length_971_cov_52.575688	398	478	10	9	80	0.1125000
NODE_7195_length_971_cov_52.575688	398	478	11	14	80	0.1750000
NODE_7195_length_971_cov_52.575688	398	478	14	36	80	0.4500000
NODE_7195_length_971_cov_52.575688	398	478	16	2	80	0.0250000
NODE_7195_length_971_cov_52.575688	398	478	18	19	80	0.2375000
NODE_7195_length_971_cov_52.575688	451	531	14	6	80	0.0750000
NODE_7195_length_971_cov_52.575688	451	531	16	2	80	0.0250000
NODE_7195_length_971_cov_52.575688	451	531	17	34	80	0.4250000
NODE_7195_length_971_cov_52.575688	451	531	18	38	80	0.4750000
NODE_7195_length_971_cov_52.575688	527	607	9	18	80	0.2250000
NODE_7195_length_971_cov_52.575688	527	607	10	3	80	0.0375000
NODE_7195_length_971_cov_52.575688	527	607	11	21	80	0.2625000
NODE_7195_length_971_cov_52.575688	527	607	12	23	80	0.2875000
NODE_7195_length_971_cov_52.575688	527	607	13	8	80	0.1000000
NODE_7195_length_971_cov_52.575688	527	607	16	1	80	0.0125000
NODE_7195_length_971_cov_52.575688	527	607	18	6	80	0.0750000
NODE_7195_length_971_cov_52.575688	580	660	8	29	80	0.3625000
NODE_7195_length_971_cov_52.575688	580	660	9	31	80	0.3875000
NODE_7195_length_971_cov_52.575688	580	660	10	2	80	0.0250000
NODE_7195_length_971_cov_52.575688	580	660	11	18	80	0.2250000
NODE_7196_length_971_cov_44.464450	280	360	2	68	80	0.8500000
NODE_7196_length_971_cov_44.464450	280	360	4	9	80	0.1125000
NODE_7196_length_971_cov_44.464450	280	360	6	3	80	0.0375000
NODE_7196_length_971_cov_44.464450	333	413	2	15	80	0.1875000
NODE_7196_length_971_cov_44.464450	333	413	4	35	80	0.4375000
NODE_7196_length_971_cov_44.464450	333	413	5	2	80	0.0250000
NODE_7196_length_971_cov_44.464450	333	413	6	3	80	0.0375000
NODE_7196_length_971_cov_44.464450	333	413	7	25	80	0.3125000
NODE_7196_length_971_cov_44.464450	409	489	6	8	80	0.1000000
NODE_7196_length_971_cov_44.464450	409	489	7	51	80	0.6375000
NODE_7196_length_971_cov_44.464450	409	489	8	21	80	0.2625000
NODE_7196_length_971_cov_44.464450	462	542	3	6	80	0.0750000
NODE_7196_length_971_cov_44.464450	462	542	4	14	80	0.1750000
NODE_7196_length_971_cov_44.464450	462	542	5	23	80	0.2875000
NODE_7196_length_971_cov_44.464450	462	542	6	9	80	0.1125000
NODE_7196_length_971_cov_44.464450	462	542	7	11	80	0.1375000
NODE_7196_length_971_cov_44.464450	462	542	8	17	80	0.2125000
NODE_7197_length_971_cov_32.721330	509	589	14	8	80	0.1000000
NODE_7197_length_971_cov_32.721330	509	589	15	8	80	0.1000000
NODE_7197_length_971_cov_32.721330	509	589	16	10	80	0.1250000
NODE_7197_length_971_cov_32.721330	509	589	17	24	80	0.3000000
NODE_7197_length_971_cov_32.721330	509	589	18	1	80	0.0125000
NODE_7197_length_971_cov_32.721330	509	589	19	29	80	0.3625000
NODE_7197_length_971_cov_32.721330	562	642	5	15	80	0.1875000
NODE_7197_length_971_cov_32.721330	562	642	12	1	80	0.0125000
NODE_7197_length_971_cov_32.721330	562	642	13	19	80	0.2375000
NODE_7197_length_971_cov_32.721330	562	642	15	11	80	0.1375000
NODE_7197_length_971_cov_32.721330	562	642	17	10	80	0.1250000
NODE_7197_length_971_cov_32.721330	562	642	18	1	80	0.0125000
NODE_7197_length_971_cov_32.721330	562	642	19	23	80	0.2875000
NODE_7198_length_971_cov_30.264908	474	554	7	7	80	0.0875000
NODE_7198_length_971_cov_30.264908	474	554	8	16	80	0.2000000
NODE_7198_length_971_cov_30.264908	474	554	10	3	80	0.0375000
NODE_7198_length_971_cov_30.264908	474	554	14	26	80	0.3250000
NODE_7198_length_971_cov_30.264908	474	554	15	28	80	0.3500000
NODE_7198_length_971_cov_30.264908	527	607	11	17	80	0.2125000
NODE_7198_length_971_cov_30.264908	527	607	12	3	80	0.0375000
NODE_7198_length_971_cov_30.264908	527	607	13	13	80	0.1625000
NODE_7198_length_971_cov_30.264908	527	607	14	21	80	0.2625000
NODE_7198_length_971_cov_30.264908	527	607	15	26	80	0.3250000
NODE_7199_length_971_cov_26.631881	434	514	4	73	80	0.9125000
NODE_7199_length_971_cov_26.631881	434	514	8	7	80	0.0875000
NODE_7199_length_971_cov_26.631881	487	567	0	22	80	0.2750000
NODE_7199_length_971_cov_26.631881	487	567	4	58	80	0.7250000
NODE_7200_length_971_cov_25.635321	404	484	2	17	80	0.2125000
NODE_7200_length_971_cov_25.635321	404	484	3	10	80	0.1250000
NODE_7200_length_971_cov_25.635321	404	484	4	53	80	0.6625000
NODE_7200_length_971_cov_25.635321	457	537	2	27	80	0.3375000
NODE_7200_length_971_cov_25.635321	457	537	4	53	80	0.6625000
NODE_7201_length_971_cov_23.334862	363	443	10	27	80	0.3375000
NODE_7201_length_971_cov_23.334862	363	443	11	33	80	0.4125000
NODE_7201_length_971_cov_23.334862	363	443	12	20	80	0.2500000
NODE_7201_length_971_cov_23.334862	416	497	7	2	81	0.0246914
NODE_7201_length_971_cov_23.334862	416	497	8	10	81	0.1234568
NODE_7201_length_971_cov_23.334862	416	497	9	13	81	0.1604938
NODE_7201_length_971_cov_23.334862	416	497	10	22	81	0.2716049
NODE_7201_length_971_cov_23.334862	416	497	11	34	81	0.4197531
NODE_7202_length_971_cov_18.254587	468	548	2	29	80	0.3625000
NODE_7202_length_971_cov_18.254587	468	548	3	28	80	0.3500000
NODE_7202_length_971_cov_18.254587	468	548	4	23	80	0.2875000
NODE_7202_length_971_cov_18.254587	521	601	3	12	80	0.1500000
NODE_7202_length_971_cov_18.254587	521	601	4	68	80	0.8500000
NODE_7203_length_971_cov_18.229358	392	472	5	10	80	0.1250000
NODE_7203_length_971_cov_18.229358	392	472	10	2	80	0.0250000
NODE_7203_length_971_cov_18.229358	392	472	13	9	80	0.1125000
NODE_7203_length_971_cov_18.229358	392	472	14	59	80	0.7375000
NODE_7203_length_971_cov_18.229358	445	525	10	7	80	0.0875000
NODE_7203_length_971_cov_18.229358	445	525	13	10	80	0.1250000
NODE_7203_length_971_cov_18.229358	445	525	14	63	80	0.7875000
NODE_7204_length_971_cov_16.591743	481	561	5	26	80	0.3250000
NODE_7204_length_971_cov_16.591743	481	561	6	28	80	0.3500000
NODE_7204_length_971_cov_16.591743	481	561	7	2	80	0.0250000
NODE_7204_length_971_cov_16.591743	481	561	8	18	80	0.2250000
NODE_7204_length_971_cov_16.591743	481	561	9	6	80	0.0750000
NODE_7204_length_971_cov_16.591743	534	614	5	20	80	0.2500000
NODE_7204_length_971_cov_16.591743	534	614	6	3	80	0.0375000
NODE_7204_length_971_cov_16.591743	534	614	7	2	80	0.0250000
NODE_7204_length_971_cov_16.591743	534	614	8	49	80	0.6125000
NODE_7204_length_971_cov_16.591743	534	614	9	6	80	0.0750000
NODE_7205_length_971_cov_15.563073	463	543	3	32	80	0.4000000
NODE_7205_length_971_cov_15.563073	463	543	4	1	80	0.0125000
NODE_7205_length_971_cov_15.563073	463	543	5	47	80	0.5875000
NODE_7205_length_971_cov_15.563073	516	596	3	6	80	0.0750000
NODE_7205_length_971_cov_15.563073	516	596	4	1	80	0.0125000
NODE_7205_length_971_cov_15.563073	516	596	5	61	80	0.7625000
NODE_7205_length_971_cov_15.563073	516	596	6	10	80	0.1250000
NODE_7205_length_971_cov_15.563073	516	596	8	2	80	0.0250000
NODE_7206_length_971_cov_12.141055	415	495	3	30	80	0.3750000
NODE_7206_length_971_cov_12.141055	415	495	5	1	80	0.0125000
NODE_7206_length_971_cov_12.141055	415	495	6	19	80	0.2375000
NODE_7206_length_971_cov_12.141055	415	495	7	7	80	0.0875000
NODE_7206_length_971_cov_12.141055	415	495	8	23	80	0.2875000
NODE_7206_length_971_cov_12.141055	468	548	6	14	80	0.1750000
NODE_7206_length_971_cov_12.141055	468	548	7	7	80	0.0875000
NODE_7206_length_971_cov_12.141055	468	548	8	59	80	0.7375000
NODE_7222_length_970_cov_34.928817	438	518	17	6	80	0.0750000
NODE_7222_length_970_cov_34.928817	438	518	18	2	80	0.0250000
NODE_7222_length_970_cov_34.928817	438	518	19	18	80	0.2250000
NODE_7222_length_970_cov_34.928817	438	518	20	24	80	0.3000000
NODE_7222_length_970_cov_34.928817	438	518	21	21	80	0.2625000
NODE_7222_length_970_cov_34.928817	438	518	22	9	80	0.1125000
NODE_7222_length_970_cov_34.928817	491	571	9	14	80	0.1750000
NODE_7222_length_970_cov_34.928817	491	571	11	2	80	0.0250000
NODE_7222_length_970_cov_34.928817	491	571	15	4	80	0.0500000
NODE_7222_length_970_cov_34.928817	491	571	16	5	80	0.0625000
NODE_7222_length_970_cov_34.928817	491	571	18	14	80	0.1750000
NODE_7222_length_970_cov_34.928817	491	571	19	10	80	0.1250000
NODE_7222_length_970_cov_34.928817	491	571	20	7	80	0.0875000
NODE_7222_length_970_cov_34.928817	491	571	21	21	80	0.2625000
NODE_7222_length_970_cov_34.928817	491	571	22	3	80	0.0375000
NODE_7223_length_970_cov_34.445465	540	620	9	4	80	0.0500000
NODE_7223_length_970_cov_34.445465	540	620	10	2	80	0.0250000
NODE_7223_length_970_cov_34.445465	540	620	11	24	80	0.3000000
NODE_7223_length_970_cov_34.445465	540	620	12	35	80	0.4375000
NODE_7223_length_970_cov_34.445465	540	620	13	15	80	0.1875000
NODE_7223_length_970_cov_34.445465	593	673	6	10	80	0.1250000
NODE_7223_length_970_cov_34.445465	593	673	7	35	80	0.4375000
NODE_7223_length_970_cov_34.445465	593	673	8	7	80	0.0875000
NODE_7223_length_970_cov_34.445465	593	673	9	5	80	0.0625000
NODE_7223_length_970_cov_34.445465	593	673	11	3	80	0.0375000
NODE_7223_length_970_cov_34.445465	593	673	12	8	80	0.1000000
NODE_7223_length_970_cov_34.445465	593	673	13	12	80	0.1500000
NODE_7224_length_970_cov_34.257176	352	432	13	9	80	0.1125000
NODE_7224_length_970_cov_34.257176	352	432	17	2	80	0.0250000
NODE_7224_length_970_cov_34.257176	352	432	20	38	80	0.4750000
NODE_7224_length_970_cov_34.257176	352	432	21	29	80	0.3625000
NODE_7224_length_970_cov_34.257176	352	432	22	2	80	0.0250000
NODE_7224_length_970_cov_34.257176	405	485	13	20	80	0.2500000
NODE_7224_length_970_cov_34.257176	405	485	14	2	80	0.0250000
NODE_7224_length_970_cov_34.257176	405	485	17	7	80	0.0875000
NODE_7224_length_970_cov_34.257176	405	485	19	1	80	0.0125000
NODE_7224_length_970_cov_34.257176	405	485	20	12	80	0.1500000
NODE_7224_length_970_cov_34.257176	405	485	21	36	80	0.4500000
NODE_7224_length_970_cov_34.257176	405	485	22	2	80	0.0250000
NODE_7225_length_970_cov_26.904707	297	372	2	1	75	0.0133333
NODE_7225_length_970_cov_26.904707	297	372	4	42	75	0.5600000
NODE_7225_length_970_cov_26.904707	297	372	5	1	75	0.0133333
NODE_7225_length_970_cov_26.904707	297	372	6	31	75	0.4133333
NODE_7225_length_970_cov_26.904707	303	376	4	37	73	0.5068493
NODE_7225_length_970_cov_26.904707	303	376	5	1	73	0.0136986
NODE_7225_length_970_cov_26.904707	303	376	6	32	73	0.4383562
NODE_7225_length_970_cov_26.904707	303	376	7	3	73	0.0410959
NODE_7225_length_970_cov_26.904707	311	377	4	29	66	0.4393939
NODE_7225_length_970_cov_26.904707	311	377	5	1	66	0.0151515
NODE_7225_length_970_cov_26.904707	311	377	6	32	66	0.4848485
NODE_7225_length_970_cov_26.904707	311	377	7	4	66	0.0606061
NODE_7225_length_970_cov_26.904707	350	429	4	31	79	0.3924051
NODE_7225_length_970_cov_26.904707	350	429	6	24	79	0.3037975
NODE_7225_length_970_cov_26.904707	350	429	7	23	79	0.2911392
NODE_7225_length_970_cov_26.904707	350	429	8	1	79	0.0126582
NODE_7225_length_970_cov_26.904707	350	429	4	31	79	0.3924051
NODE_7225_length_970_cov_26.904707	350	429	6	24	79	0.3037975
NODE_7225_length_970_cov_26.904707	350	429	7	23	79	0.2911392
NODE_7225_length_970_cov_26.904707	350	429	8	1	79	0.0126582
NODE_7225_length_970_cov_26.904707	350	429	4	31	79	0.3924051
NODE_7225_length_970_cov_26.904707	350	429	6	24	79	0.3037975
NODE_7225_length_970_cov_26.904707	350	429	7	23	79	0.2911392
NODE_7225_length_970_cov_26.904707	350	429	8	1	79	0.0126582
NODE_7226_length_970_cov_26.040184	266	346	8	5	80	0.0625000
NODE_7226_length_970_cov_26.040184	266	346	9	3	80	0.0375000
NODE_7226_length_970_cov_26.040184	266	346	10	22	80	0.2750000
NODE_7226_length_970_cov_26.040184	266	346	12	6	80	0.0750000
NODE_7226_length_970_cov_26.040184	266	346	13	23	80	0.2875000
NODE_7226_length_970_cov_26.040184	266	346	15	12	80	0.1500000
NODE_7226_length_970_cov_26.040184	266	346	16	9	80	0.1125000
NODE_7226_length_970_cov_26.040184	319	399	11	3	80	0.0375000
NODE_7226_length_970_cov_26.040184	319	399	12	6	80	0.0750000
NODE_7226_length_970_cov_26.040184	319	399	13	11	80	0.1375000
NODE_7226_length_970_cov_26.040184	319	399	14	33	80	0.4125000
NODE_7226_length_970_cov_26.040184	319	399	15	15	80	0.1875000
NODE_7226_length_970_cov_26.040184	319	399	16	11	80	0.1375000
NODE_7226_length_970_cov_26.040184	319	399	19	1	80	0.0125000
NODE_7226_length_970_cov_26.040184	395	475	14	1	80	0.0125000
NODE_7226_length_970_cov_26.040184	395	475	16	2	80	0.0250000
NODE_7226_length_970_cov_26.040184	395	475	17	15	80	0.1875000
NODE_7226_length_970_cov_26.040184	395	475	18	10	80	0.1250000
NODE_7226_length_970_cov_26.040184	395	475	19	18	80	0.2250000
NODE_7226_length_970_cov_26.040184	395	475	20	21	80	0.2625000
NODE_7226_length_970_cov_26.040184	395	475	21	1	80	0.0125000
NODE_7226_length_970_cov_26.040184	395	475	22	2	80	0.0250000
NODE_7226_length_970_cov_26.040184	395	475	23	10	80	0.1250000
NODE_7226_length_970_cov_26.040184	448	528	17	29	80	0.3625000
NODE_7226_length_970_cov_26.040184	448	528	18	24	80	0.3000000
NODE_7226_length_970_cov_26.040184	448	528	19	12	80	0.1500000
NODE_7226_length_970_cov_26.040184	448	528	20	15	80	0.1875000
NODE_7227_length_970_cov_19.291619	415	495	1	4	80	0.0500000
NODE_7227_length_970_cov_19.291619	415	495	2	15	80	0.1875000
NODE_7227_length_970_cov_19.291619	415	495	3	61	80	0.7625000
NODE_7227_length_970_cov_19.291619	468	548	2	10	80	0.1250000
NODE_7227_length_970_cov_19.291619	468	548	3	70	80	0.8750000
NODE_7228_length_970_cov_17.731343	557	637	2	80	80	1.0000000
NODE_7228_length_970_cov_17.731343	610	690	1	48	80	0.6000000
NODE_7228_length_970_cov_17.731343	610	690	2	32	80	0.4000000
NODE_7229_length_970_cov_15.135476	407	487	2	2	80	0.0250000
NODE_7229_length_970_cov_15.135476	407	487	4	29	80	0.3625000
NODE_7229_length_970_cov_15.135476	407	487	6	49	80	0.6125000
NODE_7229_length_970_cov_15.135476	460	540	4	14	80	0.1750000
NODE_7229_length_970_cov_15.135476	460	540	6	66	80	0.8250000
NODE_7230_length_970_cov_12.675086	534	614	3	35	80	0.4375000
NODE_7230_length_970_cov_12.675086	534	614	4	45	80	0.5625000
NODE_7230_length_970_cov_12.675086	587	667	1	7	80	0.0875000
NODE_7230_length_970_cov_12.675086	587	667	3	22	80	0.2750000
NODE_7230_length_970_cov_12.675086	587	667	4	51	80	0.6375000
NODE_7231_length_970_cov_8.095293	487	567	2	9	80	0.1125000
NODE_7231_length_970_cov_8.095293	487	567	3	55	80	0.6875000
NODE_7231_length_970_cov_8.095293	487	567	4	16	80	0.2000000
NODE_7231_length_970_cov_8.095293	540	620	2	55	80	0.6875000
NODE_7231_length_970_cov_8.095293	540	620	3	16	80	0.2000000
NODE_7231_length_970_cov_8.095293	540	620	4	9	80	0.1125000
NODE_7233_length_970_cov_7.127440	336	416	4	1	80	0.0125000
NODE_7233_length_970_cov_7.127440	336	416	5	37	80	0.4625000
NODE_7233_length_970_cov_7.127440	336	416	7	19	80	0.2375000
NODE_7233_length_970_cov_7.127440	336	416	8	23	80	0.2875000
NODE_7233_length_970_cov_7.127440	389	469	4	11	80	0.1375000
NODE_7233_length_970_cov_7.127440	389	469	6	23	80	0.2875000
NODE_7233_length_970_cov_7.127440	389	469	7	4	80	0.0500000
NODE_7233_length_970_cov_7.127440	389	469	8	42	80	0.5250000
NODE_7234_length_970_cov_5.824340	0	56	0	56	56	1.0000000
NODE_7246_length_969_cov_47.172414	419	499	22	4	80	0.0500000
NODE_7246_length_969_cov_47.172414	419	499	24	8	80	0.1000000
NODE_7246_length_969_cov_47.172414	419	499	25	66	80	0.8250000
NODE_7246_length_969_cov_47.172414	419	499	26	2	80	0.0250000
NODE_7246_length_969_cov_47.172414	472	552	15	6	80	0.0750000
NODE_7246_length_969_cov_47.172414	472	552	22	21	80	0.2625000
NODE_7246_length_969_cov_47.172414	472	552	23	16	80	0.2000000
NODE_7246_length_969_cov_47.172414	472	552	24	22	80	0.2750000
NODE_7246_length_969_cov_47.172414	472	552	25	13	80	0.1625000
NODE_7246_length_969_cov_47.172414	472	552	26	2	80	0.0250000
NODE_7247_length_969_cov_28.234483	327	407	2	2	80	0.0250000
NODE_7247_length_969_cov_28.234483	327	407	4	78	80	0.9750000
NODE_7247_length_969_cov_28.234483	380	460	2	25	80	0.3125000
NODE_7247_length_969_cov_28.234483	380	460	4	55	80	0.6875000
NODE_7248_length_969_cov_27.131034	392	472	1	34	80	0.4250000
NODE_7248_length_969_cov_27.131034	392	472	2	46	80	0.5750000
NODE_7248_length_969_cov_27.131034	445	525	0	43	80	0.5375000
NODE_7248_length_969_cov_27.131034	445	525	1	37	80	0.4625000
NODE_7249_length_969_cov_26.345977	466	542	10	5	76	0.0657895
NODE_7249_length_969_cov_26.345977	466	542	11	3	76	0.0394737
NODE_7249_length_969_cov_26.345977	466	542	12	1	76	0.0131579
NODE_7249_length_969_cov_26.345977	466	542	14	1	76	0.0131579
NODE_7249_length_969_cov_26.345977	466	542	15	41	76	0.5394737
NODE_7249_length_969_cov_26.345977	466	542	16	25	76	0.3289474
NODE_7249_length_969_cov_26.345977	515	595	8	6	80	0.0750000
NODE_7249_length_969_cov_26.345977	515	595	11	28	80	0.3500000
NODE_7249_length_969_cov_26.345977	515	595	13	18	80	0.2250000
NODE_7249_length_969_cov_26.345977	515	595	15	24	80	0.3000000
NODE_7249_length_969_cov_26.345977	515	595	16	4	80	0.0500000
NODE_7250_length_969_cov_18.954023	274	354	1	17	80	0.2125000
NODE_7250_length_969_cov_18.954023	274	354	2	12	80	0.1500000
NODE_7250_length_969_cov_18.954023	274	354	3	51	80	0.6375000
NODE_7250_length_969_cov_18.954023	327	407	3	77	80	0.9625000
NODE_7250_length_969_cov_18.954023	327	407	4	3	80	0.0375000
NODE_7251_length_969_cov_17.952874	410	490	3	37	80	0.4625000
NODE_7251_length_969_cov_17.952874	410	490	5	28	80	0.3500000
NODE_7251_length_969_cov_17.952874	410	490	6	15	80	0.1875000
NODE_7251_length_969_cov_17.952874	463	543	5	20	80	0.2500000
NODE_7251_length_969_cov_17.952874	463	543	6	47	80	0.5875000
NODE_7251_length_969_cov_17.952874	463	543	7	9	80	0.1125000
NODE_7251_length_969_cov_17.952874	463	543	11	4	80	0.0500000
NODE_7251_length_969_cov_17.952874	693	773	5	22	80	0.2750000
NODE_7251_length_969_cov_17.952874	693	773	7	1	80	0.0125000
NODE_7251_length_969_cov_17.952874	693	773	8	35	80	0.4375000
NODE_7251_length_969_cov_17.952874	693	773	11	1	80	0.0125000
NODE_7251_length_969_cov_17.952874	693	773	12	21	80	0.2625000
NODE_7251_length_969_cov_17.952874	746	826	8	18	80	0.2250000
NODE_7251_length_969_cov_17.952874	746	826	9	14	80	0.1750000
NODE_7251_length_969_cov_17.952874	746	826	10	2	80	0.0250000
NODE_7251_length_969_cov_17.952874	746	826	11	1	80	0.0125000
NODE_7251_length_969_cov_17.952874	746	826	12	45	80	0.5625000
NODE_7252_length_969_cov_15.942529	446	526	1	19	80	0.2375000
NODE_7252_length_969_cov_15.942529	446	526	2	61	80	0.7625000
NODE_7252_length_969_cov_15.942529	499	579	1	72	80	0.9000000
NODE_7252_length_969_cov_15.942529	499	579	2	8	80	0.1000000
NODE_7253_length_969_cov_9.926437	573	653	4	18	80	0.2250000
NODE_7253_length_969_cov_9.926437	573	653	5	45	80	0.5625000
NODE_7253_length_969_cov_9.926437	573	653	6	11	80	0.1375000
NODE_7253_length_969_cov_9.926437	573	653	9	6	80	0.0750000
NODE_7253_length_969_cov_9.926437	626	706	1	6	80	0.0750000
NODE_7253_length_969_cov_9.926437	626	706	2	8	80	0.1000000
NODE_7253_length_969_cov_9.926437	626	706	3	3	80	0.0375000
NODE_7253_length_969_cov_9.926437	626	706	4	54	80	0.6750000
NODE_7253_length_969_cov_9.926437	626	706	5	9	80	0.1125000
NODE_7265_length_968_cov_59.162255	376	456	15	6	80	0.0750000
NODE_7265_length_968_cov_59.162255	376	456	16	70	80	0.8750000
NODE_7265_length_968_cov_59.162255	376	456	17	1	80	0.0125000
NODE_7265_length_968_cov_59.162255	376	456	18	3	80	0.0375000
NODE_7265_length_968_cov_59.162255	429	509	8	12	80	0.1500000
NODE_7265_length_968_cov_59.162255	429	509	9	4	80	0.0500000
NODE_7265_length_968_cov_59.162255	429	509	10	12	80	0.1500000
NODE_7265_length_968_cov_59.162255	429	509	11	15	80	0.1875000
NODE_7265_length_968_cov_59.162255	429	509	16	33	80	0.4125000
NODE_7265_length_968_cov_59.162255	429	509	17	1	80	0.0125000
NODE_7265_length_968_cov_59.162255	429	509	18	3	80	0.0375000
NODE_7265_length_968_cov_59.162255	505	585	3	33	80	0.4125000
NODE_7265_length_968_cov_59.162255	505	585	4	22	80	0.2750000
NODE_7265_length_968_cov_59.162255	505	585	5	7	80	0.0875000
NODE_7265_length_968_cov_59.162255	505	585	6	3	80	0.0375000
NODE_7265_length_968_cov_59.162255	505	585	8	15	80	0.1875000
NODE_7265_length_968_cov_59.162255	558	638	1	5	80	0.0625000
NODE_7265_length_968_cov_59.162255	558	638	2	44	80	0.5500000
NODE_7265_length_968_cov_59.162255	558	638	3	15	80	0.1875000
NODE_7265_length_968_cov_59.162255	558	638	4	16	80	0.2000000
NODE_7266_length_968_cov_40.005754	514	594	13	9	80	0.1125000
NODE_7266_length_968_cov_40.005754	514	594	14	1	80	0.0125000
NODE_7266_length_968_cov_40.005754	514	594	15	7	80	0.0875000
NODE_7266_length_968_cov_40.005754	514	594	16	1	80	0.0125000
NODE_7266_length_968_cov_40.005754	514	594	17	10	80	0.1250000
NODE_7266_length_968_cov_40.005754	514	594	19	34	80	0.4250000
NODE_7266_length_968_cov_40.005754	514	594	20	7	80	0.0875000
NODE_7266_length_968_cov_40.005754	514	594	21	3	80	0.0375000
NODE_7266_length_968_cov_40.005754	514	594	22	8	80	0.1000000
NODE_7266_length_968_cov_40.005754	567	647	13	2	80	0.0250000
NODE_7266_length_968_cov_40.005754	567	647	14	14	80	0.1750000
NODE_7266_length_968_cov_40.005754	567	647	17	10	80	0.1250000
NODE_7266_length_968_cov_40.005754	567	647	18	3	80	0.0375000
NODE_7266_length_968_cov_40.005754	567	647	19	33	80	0.4125000
NODE_7266_length_968_cov_40.005754	567	647	20	7	80	0.0875000
NODE_7266_length_968_cov_40.005754	567	647	21	3	80	0.0375000
NODE_7266_length_968_cov_40.005754	567	647	22	8	80	0.1000000
NODE_7267_length_968_cov_36.521289	450	530	13	2	80	0.0250000
NODE_7267_length_968_cov_36.521289	450	530	15	24	80	0.3000000
NODE_7267_length_968_cov_36.521289	450	530	16	25	80	0.3125000
NODE_7267_length_968_cov_36.521289	450	530	17	24	80	0.3000000
NODE_7267_length_968_cov_36.521289	450	530	18	5	80	0.0625000
NODE_7267_length_968_cov_36.521289	503	583	11	4	80	0.0500000
NODE_7267_length_968_cov_36.521289	503	583	12	34	80	0.4250000
NODE_7267_length_968_cov_36.521289	503	583	13	8	80	0.1000000
NODE_7267_length_968_cov_36.521289	503	583	14	5	80	0.0625000
NODE_7267_length_968_cov_36.521289	503	583	15	5	80	0.0625000
NODE_7267_length_968_cov_36.521289	503	583	16	8	80	0.1000000
NODE_7267_length_968_cov_36.521289	503	583	17	16	80	0.2000000
NODE_7268_length_968_cov_34.799770	474	554	14	1	80	0.0125000
NODE_7268_length_968_cov_34.799770	474	554	15	30	80	0.3750000
NODE_7268_length_968_cov_34.799770	474	554	16	17	80	0.2125000
NODE_7268_length_968_cov_34.799770	474	554	17	4	80	0.0500000
NODE_7268_length_968_cov_34.799770	474	554	18	21	80	0.2625000
NODE_7268_length_968_cov_34.799770	474	554	19	7	80	0.0875000
NODE_7268_length_968_cov_34.799770	527	607	8	12	80	0.1500000
NODE_7268_length_968_cov_34.799770	527	607	9	8	80	0.1000000
NODE_7268_length_968_cov_34.799770	527	607	10	4	80	0.0500000
NODE_7268_length_968_cov_34.799770	527	607	11	2	80	0.0250000
NODE_7268_length_968_cov_34.799770	527	607	15	3	80	0.0375000
NODE_7268_length_968_cov_34.799770	527	607	16	4	80	0.0500000
NODE_7268_length_968_cov_34.799770	527	607	17	16	80	0.2000000
NODE_7268_length_968_cov_34.799770	527	607	18	24	80	0.3000000
NODE_7268_length_968_cov_34.799770	527	607	19	7	80	0.0875000
NODE_7269_length_968_cov_26.929804	293	372	0	79	79	1.0000000
NODE_7269_length_968_cov_26.929804	345	425	0	56	80	0.7000000
NODE_7269_length_968_cov_26.929804	345	425	2	24	80	0.3000000
NODE_7269_length_968_cov_26.929804	421	501	2	12	80	0.1500000
NODE_7269_length_968_cov_26.929804	421	501	3	10	80	0.1250000
NODE_7269_length_968_cov_26.929804	421	501	4	39	80	0.4875000
NODE_7269_length_968_cov_26.929804	421	501	5	6	80	0.0750000
NODE_7269_length_968_cov_26.929804	421	501	6	13	80	0.1625000
NODE_7269_length_968_cov_26.929804	474	554	4	8	80	0.1000000
NODE_7269_length_968_cov_26.929804	474	554	5	6	80	0.0750000
NODE_7269_length_968_cov_26.929804	474	554	6	16	80	0.2000000
NODE_7269_length_968_cov_26.929804	474	554	7	1	80	0.0125000
NODE_7269_length_968_cov_26.929804	474	554	8	49	80	0.6125000
NODE_7270_length_968_cov_24.468354	434	514	10	2	80	0.0250000
NODE_7270_length_968_cov_24.468354	434	514	12	16	80	0.2000000
NODE_7270_length_968_cov_24.468354	434	514	13	45	80	0.5625000
NODE_7270_length_968_cov_24.468354	434	514	14	17	80	0.2125000
NODE_7270_length_968_cov_24.468354	487	567	8	6	80	0.0750000
NODE_7270_length_968_cov_24.468354	487	567	11	13	80	0.1625000
NODE_7270_length_968_cov_24.468354	487	567	12	3	80	0.0375000
NODE_7270_length_968_cov_24.468354	487	567	13	24	80	0.3000000
NODE_7270_length_968_cov_24.468354	487	567	14	34	80	0.4250000
NODE_7271_length_968_cov_23.204833	344	424	6	36	80	0.4500000
NODE_7271_length_968_cov_23.204833	344	424	7	44	80	0.5500000
NODE_7271_length_968_cov_23.204833	397	477	3	1	80	0.0125000
NODE_7271_length_968_cov_23.204833	397	477	4	17	80	0.2125000
NODE_7271_length_968_cov_23.204833	397	477	5	13	80	0.1625000
NODE_7271_length_968_cov_23.204833	397	477	6	44	80	0.5500000
NODE_7271_length_968_cov_23.204833	397	477	7	5	80	0.0625000
NODE_7271_length_968_cov_23.204833	473	553	4	16	80	0.2000000
NODE_7271_length_968_cov_23.204833	473	553	5	64	80	0.8000000
NODE_7271_length_968_cov_23.204833	526	606	4	62	80	0.7750000
NODE_7271_length_968_cov_23.204833	526	606	5	18	80	0.2250000
NODE_7272_length_968_cov_22.321059	417	497	9	4	80	0.0500000
NODE_7272_length_968_cov_22.321059	417	497	11	1	80	0.0125000
NODE_7272_length_968_cov_22.321059	417	497	12	2	80	0.0250000
NODE_7272_length_968_cov_22.321059	417	497	14	1	80	0.0125000
NODE_7272_length_968_cov_22.321059	417	497	15	2	80	0.0250000
NODE_7272_length_968_cov_22.321059	417	497	16	45	80	0.5625000
NODE_7272_length_968_cov_22.321059	417	497	17	9	80	0.1125000
NODE_7272_length_968_cov_22.321059	417	497	18	16	80	0.2000000
NODE_7272_length_968_cov_22.321059	470	550	15	1	80	0.0125000
NODE_7272_length_968_cov_22.321059	470	550	16	2	80	0.0250000
NODE_7272_length_968_cov_22.321059	470	550	17	21	80	0.2625000
NODE_7272_length_968_cov_22.321059	470	550	18	40	80	0.5000000
NODE_7272_length_968_cov_22.321059	470	550	19	16	80	0.2000000
NODE_7273_length_968_cov_20.897583	313	393	9	7	80	0.0875000
NODE_7273_length_968_cov_20.897583	313	393	10	2	80	0.0250000
NODE_7273_length_968_cov_20.897583	313	393	11	30	80	0.3750000
NODE_7273_length_968_cov_20.897583	313	393	12	33	80	0.4125000
NODE_7273_length_968_cov_20.897583	313	393	13	2	80	0.0250000
NODE_7273_length_968_cov_20.897583	313	393	14	6	80	0.0750000
NODE_7273_length_968_cov_20.897583	366	446	9	9	80	0.1125000
NODE_7273_length_968_cov_20.897583	366	446	10	3	80	0.0375000
NODE_7273_length_968_cov_20.897583	366	446	11	37	80	0.4625000
NODE_7273_length_968_cov_20.897583	366	446	12	2	80	0.0250000
NODE_7273_length_968_cov_20.897583	366	446	13	13	80	0.1625000
NODE_7273_length_968_cov_20.897583	366	446	14	16	80	0.2000000
NODE_7274_length_968_cov_19.296893	401	481	5	32	80	0.4000000
NODE_7274_length_968_cov_19.296893	401	481	6	7	80	0.0875000
NODE_7274_length_968_cov_19.296893	401	481	7	24	80	0.3000000
NODE_7274_length_968_cov_19.296893	401	481	8	10	80	0.1250000
NODE_7274_length_968_cov_19.296893	401	481	9	7	80	0.0875000
NODE_7274_length_968_cov_19.296893	454	534	7	10	80	0.1250000
NODE_7274_length_968_cov_19.296893	454	534	8	10	80	0.1250000
NODE_7274_length_968_cov_19.296893	454	534	9	47	80	0.5875000
NODE_7274_length_968_cov_19.296893	454	534	10	9	80	0.1125000
NODE_7274_length_968_cov_19.296893	454	534	11	4	80	0.0500000
NODE_7275_length_968_cov_18.100115	573	653	2	15	80	0.1875000
NODE_7275_length_968_cov_18.100115	573	653	3	65	80	0.8125000
NODE_7275_length_968_cov_18.100115	626	706	1	2	80	0.0250000
NODE_7275_length_968_cov_18.100115	626	706	2	31	80	0.3875000
NODE_7275_length_968_cov_18.100115	626	706	3	47	80	0.5875000
NODE_7276_length_968_cov_15.576525	472	552	3	4	80	0.0500000
NODE_7276_length_968_cov_15.576525	472	552	4	16	80	0.2000000
NODE_7276_length_968_cov_15.576525	472	552	5	27	80	0.3375000
NODE_7276_length_968_cov_15.576525	472	552	6	25	80	0.3125000
NODE_7276_length_968_cov_15.576525	472	552	7	8	80	0.1000000
NODE_7276_length_968_cov_15.576525	525	605	2	50	80	0.6250000
NODE_7276_length_968_cov_15.576525	525	605	3	7	80	0.0875000
NODE_7276_length_968_cov_15.576525	525	605	4	16	80	0.2000000
NODE_7276_length_968_cov_15.576525	525	605	5	7	80	0.0875000
NODE_7277_length_968_cov_15.024166	329	409	0	2	80	0.0250000
NODE_7277_length_968_cov_15.024166	329	409	1	9	80	0.1125000
NODE_7277_length_968_cov_15.024166	329	409	3	69	80	0.8625000
NODE_7277_length_968_cov_15.024166	382	462	2	2	80	0.0250000
NODE_7277_length_968_cov_15.024166	382	462	3	48	80	0.6000000
NODE_7277_length_968_cov_15.024166	382	462	4	30	80	0.3750000
NODE_7277_length_968_cov_15.024166	458	538	3	77	80	0.9625000
NODE_7277_length_968_cov_15.024166	458	538	4	3	80	0.0375000
NODE_7277_length_968_cov_15.024166	511	591	2	27	80	0.3375000
NODE_7277_length_968_cov_15.024166	511	591	3	53	80	0.6625000
NODE_7278_length_968_cov_13.911392	674	754	5	20	80	0.2500000
NODE_7278_length_968_cov_13.911392	674	754	6	60	80	0.7500000
NODE_7278_length_968_cov_13.911392	727	807	1	17	80	0.2125000
NODE_7278_length_968_cov_13.911392	727	807	2	19	80	0.2375000
NODE_7278_length_968_cov_13.911392	727	807	3	14	80	0.1750000
NODE_7278_length_968_cov_13.911392	727	807	5	23	80	0.2875000
NODE_7278_length_968_cov_13.911392	727	807	6	7	80	0.0875000
NODE_7279_length_968_cov_11.698504	598	678	1	31	80	0.3875000
NODE_7279_length_968_cov_11.698504	598	678	2	49	80	0.6125000
NODE_7279_length_968_cov_11.698504	651	731	1	26	80	0.3250000
NODE_7279_length_968_cov_11.698504	651	731	2	54	80	0.6750000
NODE_7280_length_968_cov_6.490219	538	618	0	80	80	1.0000000
NODE_7280_length_968_cov_6.490219	591	671	0	80	80	1.0000000
NODE_7294_length_967_cov_25.572581	332	412	8	42	80	0.5250000
NODE_7294_length_967_cov_25.572581	332	412	10	10	80	0.1250000
NODE_7294_length_967_cov_25.572581	332	412	12	28	80	0.3500000
NODE_7294_length_967_cov_25.572581	385	465	10	8	80	0.1000000
NODE_7294_length_967_cov_25.572581	385	465	11	5	80	0.0625000
NODE_7294_length_967_cov_25.572581	385	465	12	65	80	0.8125000
NODE_7294_length_967_cov_25.572581	385	465	13	2	80	0.0250000
NODE_7295_length_967_cov_24.919355	396	476	4	39	80	0.4875000
NODE_7295_length_967_cov_24.919355	396	476	5	3	80	0.0375000
NODE_7295_length_967_cov_24.919355	396	476	6	32	80	0.4000000
NODE_7295_length_967_cov_24.919355	396	476	7	6	80	0.0750000
NODE_7295_length_967_cov_24.919355	449	529	5	13	80	0.1625000
NODE_7295_length_967_cov_24.919355	449	529	6	67	80	0.8375000
NODE_7296_length_967_cov_19.137097	374	454	2	80	80	1.0000000
NODE_7296_length_967_cov_19.137097	427	507	2	54	80	0.6750000
NODE_7296_length_967_cov_19.137097	427	507	4	26	80	0.3250000
NODE_7296_length_967_cov_19.137097	503	583	2	62	80	0.7750000
NODE_7296_length_967_cov_19.137097	503	583	4	18	80	0.2250000
NODE_7296_length_967_cov_19.137097	556	636	0	5	80	0.0625000
NODE_7296_length_967_cov_19.137097	556	636	2	75	80	0.9375000
NODE_7297_length_967_cov_14.654378	453	533	4	4	80	0.0500000
NODE_7297_length_967_cov_14.654378	453	533	6	8	80	0.1000000
NODE_7297_length_967_cov_14.654378	453	533	8	31	80	0.3875000
NODE_7297_length_967_cov_14.654378	453	533	10	18	80	0.2250000
NODE_7297_length_967_cov_14.654378	453	533	12	15	80	0.1875000
NODE_7297_length_967_cov_14.654378	453	533	14	4	80	0.0500000
NODE_7297_length_967_cov_14.654378	506	586	9	15	80	0.1875000
NODE_7297_length_967_cov_14.654378	506	586	10	8	80	0.1000000
NODE_7297_length_967_cov_14.654378	506	586	11	35	80	0.4375000
NODE_7297_length_967_cov_14.654378	506	586	12	15	80	0.1875000
NODE_7297_length_967_cov_14.654378	506	586	13	3	80	0.0375000
NODE_7297_length_967_cov_14.654378	506	586	14	4	80	0.0500000
NODE_7298_length_967_cov_8.027650	280	360	9	62	80	0.7750000
NODE_7298_length_967_cov_8.027650	280	360	11	1	80	0.0125000
NODE_7298_length_967_cov_8.027650	280	360	12	17	80	0.2125000
NODE_7298_length_967_cov_8.027650	333	413	6	3	80	0.0375000
NODE_7298_length_967_cov_8.027650	333	413	8	41	80	0.5125000
NODE_7298_length_967_cov_8.027650	333	413	9	20	80	0.2500000
NODE_7298_length_967_cov_8.027650	333	413	11	1	80	0.0125000
NODE_7298_length_967_cov_8.027650	333	413	12	15	80	0.1875000
NODE_7310_length_966_cov_43.154556	401	474	13	2	73	0.0273973
NODE_7310_length_966_cov_43.154556	401	474	15	3	73	0.0410959
NODE_7310_length_966_cov_43.154556	401	474	18	1	73	0.0136986
NODE_7310_length_966_cov_43.154556	401	474	20	17	73	0.2328767
NODE_7310_length_966_cov_43.154556	401	474	21	48	73	0.6575342
NODE_7310_length_966_cov_43.154556	401	474	22	2	73	0.0273973
NODE_7310_length_966_cov_43.154556	447	527	8	3	80	0.0375000
NODE_7310_length_966_cov_43.154556	447	527	9	7	80	0.0875000
NODE_7310_length_966_cov_43.154556	447	527	11	7	80	0.0875000
NODE_7310_length_966_cov_43.154556	447	527	12	28	80	0.3500000
NODE_7310_length_966_cov_43.154556	447	527	13	10	80	0.1250000
NODE_7310_length_966_cov_43.154556	447	527	15	3	80	0.0375000
NODE_7310_length_966_cov_43.154556	447	527	18	1	80	0.0125000
NODE_7310_length_966_cov_43.154556	447	527	20	4	80	0.0500000
NODE_7310_length_966_cov_43.154556	447	527	21	15	80	0.1875000
NODE_7310_length_966_cov_43.154556	447	527	22	2	80	0.0250000
NODE_7311_length_966_cov_42.877739	477	557	11	32	80	0.4000000
NODE_7311_length_966_cov_42.877739	477	557	12	14	80	0.1750000
NODE_7311_length_966_cov_42.877739	477	557	13	34	80	0.4250000
NODE_7311_length_966_cov_42.877739	530	610	10	22	80	0.2750000
NODE_7311_length_966_cov_42.877739	530	610	11	1	80	0.0125000
NODE_7311_length_966_cov_42.877739	530	610	12	4	80	0.0500000
NODE_7311_length_966_cov_42.877739	530	610	13	43	80	0.5375000
NODE_7311_length_966_cov_42.877739	530	610	14	10	80	0.1250000
NODE_7312_length_966_cov_39.956171	283	363	1	6	80	0.0750000
NODE_7312_length_966_cov_39.956171	283	363	2	14	80	0.1750000
NODE_7312_length_966_cov_39.956171	283	363	3	59	80	0.7375000
NODE_7312_length_966_cov_39.956171	283	363	4	1	80	0.0125000
NODE_7312_length_966_cov_39.956171	336	416	3	26	80	0.3250000
NODE_7312_length_966_cov_39.956171	336	416	4	50	80	0.6250000
NODE_7312_length_966_cov_39.956171	336	416	5	4	80	0.0500000
NODE_7312_length_966_cov_39.956171	412	494	5	9	82	0.1097561
NODE_7312_length_966_cov_39.956171	412	494	6	3	82	0.0365854
NODE_7312_length_966_cov_39.956171	412	494	8	10	82	0.1219512
NODE_7312_length_966_cov_39.956171	412	494	9	32	82	0.3902439
NODE_7312_length_966_cov_39.956171	412	494	10	26	82	0.3170732
NODE_7312_length_966_cov_39.956171	412	494	12	2	82	0.0243902
NODE_7312_length_966_cov_39.956171	467	547	9	5	80	0.0625000
NODE_7312_length_966_cov_39.956171	467	547	10	55	80	0.6875000
NODE_7312_length_966_cov_39.956171	467	547	11	4	80	0.0500000
NODE_7312_length_966_cov_39.956171	467	547	12	16	80	0.2000000
NODE_7313_length_966_cov_36.160323	461	541	11	3	80	0.0375000
NODE_7313_length_966_cov_36.160323	461	541	12	32	80	0.4000000
NODE_7313_length_966_cov_36.160323	461	541	13	1	80	0.0125000
NODE_7313_length_966_cov_36.160323	461	541	14	13	80	0.1625000
NODE_7313_length_966_cov_36.160323	461	541	15	31	80	0.3875000
NODE_7313_length_966_cov_36.160323	461	541	11	3	80	0.0375000
NODE_7313_length_966_cov_36.160323	461	541	12	32	80	0.4000000
NODE_7313_length_966_cov_36.160323	461	541	13	1	80	0.0125000
NODE_7313_length_966_cov_36.160323	461	541	14	13	80	0.1625000
NODE_7313_length_966_cov_36.160323	461	541	15	31	80	0.3875000
NODE_7313_length_966_cov_36.160323	514	594	9	25	80	0.3125000
NODE_7313_length_966_cov_36.160323	514	594	10	5	80	0.0625000
NODE_7313_length_966_cov_36.160323	514	594	11	26	80	0.3250000
NODE_7313_length_966_cov_36.160323	514	594	12	7	80	0.0875000
NODE_7313_length_966_cov_36.160323	514	594	13	1	80	0.0125000
NODE_7313_length_966_cov_36.160323	514	594	14	1	80	0.0125000
NODE_7313_length_966_cov_36.160323	514	594	15	15	80	0.1875000
NODE_7314_length_966_cov_18.658593	408	488	2	55	80	0.6875000
NODE_7314_length_966_cov_18.658593	408	488	4	25	80	0.3125000
NODE_7314_length_966_cov_18.658593	461	541	2	72	80	0.9000000
NODE_7314_length_966_cov_18.658593	461	541	4	8	80	0.1000000
NODE_7315_length_966_cov_17.606690	341	421	4	35	80	0.4375000
NODE_7315_length_966_cov_17.606690	341	421	5	45	80	0.5625000
NODE_7315_length_966_cov_17.606690	394	474	0	34	80	0.4250000
NODE_7315_length_966_cov_17.606690	394	474	1	10	80	0.1250000
NODE_7315_length_966_cov_17.606690	394	474	4	36	80	0.4500000
NODE_7316_length_966_cov_16.064591	296	376	6	43	80	0.5375000
NODE_7316_length_966_cov_16.064591	296	376	8	37	80	0.4625000
NODE_7316_length_966_cov_16.064591	349	429	4	6	80	0.0750000
NODE_7316_length_966_cov_16.064591	349	429	6	18	80	0.2250000
NODE_7316_length_966_cov_16.064591	349	429	8	56	80	0.7000000
NODE_7317_length_966_cov_15.155709	562	642	6	7	80	0.0875000
NODE_7317_length_966_cov_15.155709	562	642	9	17	80	0.2125000
NODE_7317_length_966_cov_15.155709	562	642	10	43	80	0.5375000
NODE_7317_length_966_cov_15.155709	562	642	11	9	80	0.1125000
NODE_7317_length_966_cov_15.155709	562	642	12	4	80	0.0500000
NODE_7317_length_966_cov_15.155709	615	695	8	38	80	0.4750000
NODE_7317_length_966_cov_15.155709	615	695	10	14	80	0.1750000
NODE_7317_length_966_cov_15.155709	615	695	11	24	80	0.3000000
NODE_7317_length_966_cov_15.155709	615	695	12	4	80	0.0500000
NODE_7318_length_966_cov_7.726644	280	360	0	80	80	1.0000000
NODE_7318_length_966_cov_7.726644	334	414	0	70	80	0.8750000
NODE_7318_length_966_cov_7.726644	334	414	1	10	80	0.1250000
NODE_7335_length_965_cov_51.524249	197	277	0	16	80	0.2000000
NODE_7335_length_965_cov_51.524249	197	277	2	6	80	0.0750000
NODE_7335_length_965_cov_51.524249	197	277	4	53	80	0.6625000
NODE_7335_length_965_cov_51.524249	197	277	6	4	80	0.0500000
NODE_7335_length_965_cov_51.524249	197	277	7	1	80	0.0125000
NODE_7335_length_965_cov_51.524249	250	327	4	22	77	0.2857143
NODE_7335_length_965_cov_51.524249	250	327	6	4	77	0.0519481
NODE_7335_length_965_cov_51.524249	250	327	7	37	77	0.4805195
NODE_7335_length_965_cov_51.524249	250	327	8	14	77	0.1818182
NODE_7335_length_965_cov_51.524249	329	406	8	1	77	0.0129870
NODE_7335_length_965_cov_51.524249	329	406	9	2	77	0.0259740
NODE_7335_length_965_cov_51.524249	329	406	10	50	77	0.6493506
NODE_7335_length_965_cov_51.524249	329	406	11	9	77	0.1168831
NODE_7335_length_965_cov_51.524249	329	406	12	15	77	0.1948052
NODE_7335_length_965_cov_51.524249	379	459	9	15	80	0.1875000
NODE_7335_length_965_cov_51.524249	379	459	10	28	80	0.3500000
NODE_7335_length_965_cov_51.524249	379	459	11	9	80	0.1125000
NODE_7335_length_965_cov_51.524249	379	459	12	28	80	0.3500000
NODE_7336_length_965_cov_18.072748	515	595	4	3	80	0.0375000
NODE_7336_length_965_cov_18.072748	515	595	5	4	80	0.0500000
NODE_7336_length_965_cov_18.072748	515	595	6	73	80	0.9125000
NODE_7336_length_965_cov_18.072748	568	648	4	52	80	0.6500000
NODE_7336_length_965_cov_18.072748	568	648	5	4	80	0.0500000
NODE_7336_length_965_cov_18.072748	568	648	6	24	80	0.3000000
NODE_7337_length_965_cov_14.277136	342	422	2	25	80	0.3125000
NODE_7337_length_965_cov_14.277136	342	422	3	30	80	0.3750000
NODE_7337_length_965_cov_14.277136	342	422	4	25	80	0.3125000
NODE_7337_length_965_cov_14.277136	395	470	3	3	75	0.0400000
NODE_7337_length_965_cov_14.277136	395	470	4	30	75	0.4000000
NODE_7337_length_965_cov_14.277136	395	470	5	37	75	0.4933333
NODE_7337_length_965_cov_14.277136	395	470	6	5	75	0.0666667
NODE_7338_length_965_cov_7.808314	567	647	4	37	80	0.4625000
NODE_7338_length_965_cov_7.808314	567	647	6	43	80	0.5375000
NODE_7338_length_965_cov_7.808314	620	700	4	4	80	0.0500000
NODE_7338_length_965_cov_7.808314	620	700	5	38	80	0.4750000
NODE_7338_length_965_cov_7.808314	620	700	6	38	80	0.4750000
NODE_7344_length_964_cov_60.153757	197	277	12	14	80	0.1750000
NODE_7344_length_964_cov_60.153757	197	277	14	12	80	0.1500000
NODE_7344_length_964_cov_60.153757	197	277	15	10	80	0.1250000
NODE_7344_length_964_cov_60.153757	197	277	16	19	80	0.2375000
NODE_7344_length_964_cov_60.153757	197	277	18	10	80	0.1250000
NODE_7344_length_964_cov_60.153757	197	277	19	2	80	0.0250000
NODE_7344_length_964_cov_60.153757	197	277	20	5	80	0.0625000
NODE_7344_length_964_cov_60.153757	197	277	21	1	80	0.0125000
NODE_7344_length_964_cov_60.153757	197	277	25	6	80	0.0750000
NODE_7344_length_964_cov_60.153757	197	277	26	1	80	0.0125000
NODE_7344_length_964_cov_60.153757	250	314	12	51	64	0.7968750
NODE_7344_length_964_cov_60.153757	250	314	14	12	64	0.1875000
NODE_7344_length_964_cov_60.153757	250	314	15	1	64	0.0156250
NODE_7344_length_964_cov_60.153757	672	752	20	14	80	0.1750000
NODE_7344_length_964_cov_60.153757	672	752	21	10	80	0.1250000
NODE_7344_length_964_cov_60.153757	672	752	22	10	80	0.1250000
NODE_7344_length_964_cov_60.153757	672	752	23	9	80	0.1125000
NODE_7344_length_964_cov_60.153757	672	752	24	22	80	0.2750000
NODE_7344_length_964_cov_60.153757	672	752	26	9	80	0.1125000
NODE_7344_length_964_cov_60.153757	672	752	28	5	80	0.0625000
NODE_7344_length_964_cov_60.153757	672	752	30	1	80	0.0125000
NODE_7344_length_964_cov_60.153757	725	805	15	8	80	0.1000000
NODE_7344_length_964_cov_60.153757	725	805	16	29	80	0.3625000
NODE_7344_length_964_cov_60.153757	725	805	17	13	80	0.1625000
NODE_7344_length_964_cov_60.153757	725	805	22	10	80	0.1250000
NODE_7344_length_964_cov_60.153757	725	805	23	4	80	0.0500000
NODE_7344_length_964_cov_60.153757	725	805	24	16	80	0.2000000
NODE_7345_length_964_cov_45.564162	314	394	7	25	80	0.3125000
NODE_7345_length_964_cov_45.564162	314	394	8	3	80	0.0375000
NODE_7345_length_964_cov_45.564162	314	394	9	14	80	0.1750000
NODE_7345_length_964_cov_45.564162	314	394	10	37	80	0.4625000
NODE_7345_length_964_cov_45.564162	314	394	11	1	80	0.0125000
NODE_7345_length_964_cov_45.564162	367	447	5	17	80	0.2125000
NODE_7345_length_964_cov_45.564162	367	447	6	5	80	0.0625000
NODE_7345_length_964_cov_45.564162	367	447	7	43	80	0.5375000
NODE_7345_length_964_cov_45.564162	367	447	8	4	80	0.0500000
NODE_7345_length_964_cov_45.564162	367	447	9	11	80	0.1375000
NODE_7345_length_964_cov_45.564162	443	523	5	2	80	0.0250000
NODE_7345_length_964_cov_45.564162	443	523	8	4	80	0.0500000
NODE_7345_length_964_cov_45.564162	443	523	10	4	80	0.0500000
NODE_7345_length_964_cov_45.564162	443	523	11	20	80	0.2500000
NODE_7345_length_964_cov_45.564162	443	523	12	7	80	0.0875000
NODE_7345_length_964_cov_45.564162	443	523	13	35	80	0.4375000
NODE_7345_length_964_cov_45.564162	443	523	14	8	80	0.1000000
NODE_7345_length_964_cov_45.564162	496	566	11	15	70	0.2142857
NODE_7345_length_964_cov_45.564162	496	566	12	7	70	0.1000000
NODE_7345_length_964_cov_45.564162	496	566	13	48	70	0.6857143
NODE_7346_length_964_cov_33.487861	363	443	28	3	80	0.0375000
NODE_7346_length_964_cov_33.487861	363	443	29	10	80	0.1250000
NODE_7346_length_964_cov_33.487861	363	443	30	15	80	0.1875000
NODE_7346_length_964_cov_33.487861	363	443	31	25	80	0.3125000
NODE_7346_length_964_cov_33.487861	363	443	32	6	80	0.0750000
NODE_7346_length_964_cov_33.487861	363	443	34	11	80	0.1375000
NODE_7346_length_964_cov_33.487861	363	443	35	1	80	0.0125000
NODE_7346_length_964_cov_33.487861	363	443	36	4	80	0.0500000
NODE_7346_length_964_cov_33.487861	363	443	37	4	80	0.0500000
NODE_7346_length_964_cov_33.487861	363	443	38	1	80	0.0125000
NODE_7346_length_964_cov_33.487861	416	496	17	2	80	0.0250000
NODE_7346_length_964_cov_33.487861	416	496	18	1	80	0.0125000
NODE_7346_length_964_cov_33.487861	416	496	19	1	80	0.0125000
NODE_7346_length_964_cov_33.487861	416	496	22	1	80	0.0125000
NODE_7346_length_964_cov_33.487861	416	496	23	1	80	0.0125000
NODE_7346_length_964_cov_33.487861	416	496	24	22	80	0.2750000
NODE_7346_length_964_cov_33.487861	416	496	25	16	80	0.2000000
NODE_7346_length_964_cov_33.487861	416	496	28	7	80	0.0875000
NODE_7346_length_964_cov_33.487861	416	496	29	15	80	0.1875000
NODE_7346_length_964_cov_33.487861	416	496	30	12	80	0.1500000
NODE_7346_length_964_cov_33.487861	416	496	31	2	80	0.0250000
NODE_7347_length_964_cov_33.077457	408	488	0	80	80	1.0000000
NODE_7347_length_964_cov_33.077457	461	541	0	80	80	1.0000000
NODE_7347_length_964_cov_33.077457	537	617	0	47	80	0.5875000
NODE_7347_length_964_cov_33.077457	537	617	1	33	80	0.4125000
NODE_7347_length_964_cov_33.077457	590	670	1	33	80	0.4125000
NODE_7347_length_964_cov_33.077457	590	670	2	47	80	0.5875000
NODE_7348_length_964_cov_29.250867	419	499	6	11	80	0.1375000
NODE_7348_length_964_cov_29.250867	419	499	7	5	80	0.0625000
NODE_7348_length_964_cov_29.250867	419	499	12	2	80	0.0250000
NODE_7348_length_964_cov_29.250867	419	499	13	2	80	0.0250000
NODE_7348_length_964_cov_29.250867	419	499	14	3	80	0.0375000
NODE_7348_length_964_cov_29.250867	419	499	15	1	80	0.0125000
NODE_7348_length_964_cov_29.250867	419	499	16	9	80	0.1125000
NODE_7348_length_964_cov_29.250867	419	499	17	42	80	0.5250000
NODE_7348_length_964_cov_29.250867	419	499	18	5	80	0.0625000
NODE_7348_length_964_cov_29.250867	472	552	15	4	80	0.0500000
NODE_7348_length_964_cov_29.250867	472	552	16	13	80	0.1625000
NODE_7348_length_964_cov_29.250867	472	552	17	52	80	0.6500000
NODE_7348_length_964_cov_29.250867	472	552	18	11	80	0.1375000
NODE_7349_length_964_cov_20.191908	228	301	1	42	73	0.5753425
NODE_7349_length_964_cov_20.191908	228	301	2	31	73	0.4246575
NODE_7349_length_964_cov_20.191908	349	429	1	7	80	0.0875000
NODE_7349_length_964_cov_20.191908	349	429	2	71	80	0.8875000
NODE_7349_length_964_cov_20.191908	349	429	3	2	80	0.0250000
NODE_7349_length_964_cov_20.191908	402	482	1	7	80	0.0875000
NODE_7349_length_964_cov_20.191908	402	482	2	18	80	0.2250000
NODE_7349_length_964_cov_20.191908	402	482	3	30	80	0.3750000
NODE_7349_length_964_cov_20.191908	402	482	5	25	80	0.3125000
NODE_7350_length_964_cov_18.510983	486	566	9	3	80	0.0375000
NODE_7350_length_964_cov_18.510983	486	566	10	22	80	0.2750000
NODE_7350_length_964_cov_18.510983	486	566	11	46	80	0.5750000
NODE_7350_length_964_cov_18.510983	486	566	12	2	80	0.0250000
NODE_7350_length_964_cov_18.510983	486	566	14	1	80	0.0125000
NODE_7350_length_964_cov_18.510983	486	566	17	6	80	0.0750000
NODE_7350_length_964_cov_18.510983	539	619	9	3	80	0.0375000
NODE_7350_length_964_cov_18.510983	539	619	11	36	80	0.4500000
NODE_7350_length_964_cov_18.510983	539	619	14	1	80	0.0125000
NODE_7350_length_964_cov_18.510983	539	619	15	1	80	0.0125000
NODE_7350_length_964_cov_18.510983	539	619	16	26	80	0.3250000
NODE_7350_length_964_cov_18.510983	539	619	17	13	80	0.1625000
NODE_7351_length_964_cov_16.613873	464	544	6	33	80	0.4125000
NODE_7351_length_964_cov_16.613873	464	544	8	20	80	0.2500000
NODE_7351_length_964_cov_16.613873	464	544	9	27	80	0.3375000
NODE_7351_length_964_cov_16.613873	517	597	5	24	80	0.3000000
NODE_7351_length_964_cov_16.613873	517	597	6	14	80	0.1750000
NODE_7351_length_964_cov_16.613873	517	597	8	35	80	0.4375000
NODE_7351_length_964_cov_16.613873	517	597	9	7	80	0.0875000
NODE_7352_length_964_cov_15.717919	411	491	6	47	80	0.5875000
NODE_7352_length_964_cov_15.717919	411	491	7	14	80	0.1750000
NODE_7352_length_964_cov_15.717919	411	491	8	19	80	0.2375000
NODE_7352_length_964_cov_15.717919	464	544	5	11	80	0.1375000
NODE_7352_length_964_cov_15.717919	464	544	6	4	80	0.0500000
NODE_7352_length_964_cov_15.717919	464	544	7	42	80	0.5250000
NODE_7352_length_964_cov_15.717919	464	544	8	23	80	0.2875000
NODE_7352_length_964_cov_15.717919	540	620	4	26	80	0.3250000
NODE_7352_length_964_cov_15.717919	540	620	5	45	80	0.5625000
NODE_7352_length_964_cov_15.717919	540	620	6	9	80	0.1125000
NODE_7352_length_964_cov_15.717919	593	668	4	1	75	0.0133333
NODE_7352_length_964_cov_15.717919	593	668	5	43	75	0.5733333
NODE_7352_length_964_cov_15.717919	593	668	6	20	75	0.2666667
NODE_7352_length_964_cov_15.717919	593	668	7	10	75	0.1333333
NODE_7352_length_964_cov_15.717919	593	668	8	1	75	0.0133333
NODE_7353_length_964_cov_14.591908	521	601	1	9	80	0.1125000
NODE_7353_length_964_cov_14.591908	521	601	2	8	80	0.1000000
NODE_7353_length_964_cov_14.591908	521	601	3	36	80	0.4500000
NODE_7353_length_964_cov_14.591908	521	601	4	27	80	0.3375000
NODE_7353_length_964_cov_14.591908	574	654	3	10	80	0.1250000
NODE_7353_length_964_cov_14.591908	574	654	4	70	80	0.8750000
NODE_7354_length_964_cov_11.589595	475	555	0	80	80	1.0000000
NODE_7354_length_964_cov_11.589595	528	608	0	80	80	1.0000000
NODE_7355_length_964_cov_7.639306	420	500	4	22	80	0.2750000
NODE_7355_length_964_cov_7.639306	420	500	5	28	80	0.3500000
NODE_7355_length_964_cov_7.639306	420	500	7	30	80	0.3750000
NODE_7355_length_964_cov_7.639306	473	553	1	8	80	0.1000000
NODE_7355_length_964_cov_7.639306	473	553	2	14	80	0.1750000
NODE_7355_length_964_cov_7.639306	473	553	5	58	80	0.7250000
NODE_7356_length_964_cov_7.596532	534	614	0	80	80	1.0000000
NODE_7356_length_964_cov_7.596532	587	667	0	80	80	1.0000000
NODE_7357_length_964_cov_6.568786	368	448	6	3	80	0.0375000
NODE_7357_length_964_cov_6.568786	368	448	7	2	80	0.0250000
NODE_7357_length_964_cov_6.568786	368	448	9	40	80	0.5000000
NODE_7357_length_964_cov_6.568786	368	448	15	35	80	0.4375000
NODE_7357_length_964_cov_6.568786	421	501	9	9	80	0.1125000
NODE_7357_length_964_cov_6.568786	421	501	12	12	80	0.1500000
NODE_7357_length_964_cov_6.568786	421	501	13	1	80	0.0125000
NODE_7357_length_964_cov_6.568786	421	501	14	3	80	0.0375000
NODE_7357_length_964_cov_6.568786	421	501	15	55	80	0.6875000
NODE_7359_length_964_cov_6.027746	890	940	0	50	50	1.0000000
NODE_7361_length_964_cov_4.665896	706	772	0	66	66	1.0000000
NODE_7376_length_963_cov_66.251157	456	536	8	19	80	0.2375000
NODE_7376_length_963_cov_66.251157	456	536	9	12	80	0.1500000
NODE_7376_length_963_cov_66.251157	456	536	10	10	80	0.1250000
NODE_7376_length_963_cov_66.251157	456	536	11	31	80	0.3875000
NODE_7376_length_963_cov_66.251157	456	536	12	6	80	0.0750000
NODE_7376_length_963_cov_66.251157	456	536	13	2	80	0.0250000
NODE_7376_length_963_cov_66.251157	509	589	10	14	80	0.1750000
NODE_7376_length_963_cov_66.251157	509	589	11	39	80	0.4875000
NODE_7376_length_963_cov_66.251157	509	589	12	14	80	0.1750000
NODE_7376_length_963_cov_66.251157	509	589	14	2	80	0.0250000
NODE_7376_length_963_cov_66.251157	509	589	15	11	80	0.1375000
NODE_7376_length_963_cov_66.251157	585	665	12	26	80	0.3250000
NODE_7376_length_963_cov_66.251157	585	665	13	10	80	0.1250000
NODE_7376_length_963_cov_66.251157	585	665	14	8	80	0.1000000
NODE_7376_length_963_cov_66.251157	585	665	15	22	80	0.2750000
NODE_7376_length_963_cov_66.251157	585	665	16	12	80	0.1500000
NODE_7376_length_963_cov_66.251157	585	665	17	2	80	0.0250000
NODE_7376_length_963_cov_66.251157	638	718	10	4	80	0.0500000
NODE_7376_length_963_cov_66.251157	638	718	11	24	80	0.3000000
NODE_7376_length_963_cov_66.251157	638	718	12	51	80	0.6375000
NODE_7376_length_963_cov_66.251157	638	718	13	1	80	0.0125000
NODE_7377_length_963_cov_35.638889	381	461	18	7	80	0.0875000
NODE_7377_length_963_cov_35.638889	381	461	20	8	80	0.1000000
NODE_7377_length_963_cov_35.638889	381	461	21	7	80	0.0875000
NODE_7377_length_963_cov_35.638889	381	461	24	10	80	0.1250000
NODE_7377_length_963_cov_35.638889	381	461	26	5	80	0.0625000
NODE_7377_length_963_cov_35.638889	381	461	27	41	80	0.5125000
NODE_7377_length_963_cov_35.638889	381	461	28	2	80	0.0250000
NODE_7377_length_963_cov_35.638889	434	514	26	1	80	0.0125000
NODE_7377_length_963_cov_35.638889	434	514	27	58	80	0.7250000
NODE_7377_length_963_cov_35.638889	434	514	28	20	80	0.2500000
NODE_7377_length_963_cov_35.638889	434	514	30	1	80	0.0125000
NODE_7377_length_963_cov_35.638889	510	590	5	18	80	0.2250000
NODE_7377_length_963_cov_35.638889	510	590	9	2	80	0.0250000
NODE_7377_length_963_cov_35.638889	510	590	11	7	80	0.0875000
NODE_7377_length_963_cov_35.638889	510	590	14	10	80	0.1250000
NODE_7377_length_963_cov_35.638889	510	590	18	15	80	0.1875000
NODE_7377_length_963_cov_35.638889	510	590	21	17	80	0.2125000
NODE_7377_length_963_cov_35.638889	510	590	22	5	80	0.0625000
NODE_7377_length_963_cov_35.638889	510	590	27	6	80	0.0750000
NODE_7377_length_963_cov_35.638889	563	643	5	19	80	0.2375000
NODE_7377_length_963_cov_35.638889	563	643	6	17	80	0.2125000
NODE_7377_length_963_cov_35.638889	563	643	8	35	80	0.4375000
NODE_7377_length_963_cov_35.638889	563	643	9	2	80	0.0250000
NODE_7377_length_963_cov_35.638889	563	643	11	7	80	0.0875000
NODE_7378_length_963_cov_33.642361	347	427	2	11	80	0.1375000
NODE_7378_length_963_cov_33.642361	347	427	3	16	80	0.2000000
NODE_7378_length_963_cov_33.642361	347	427	4	25	80	0.3125000
NODE_7378_length_963_cov_33.642361	347	427	5	28	80	0.3500000
NODE_7378_length_963_cov_33.642361	400	480	5	29	80	0.3625000
NODE_7378_length_963_cov_33.642361	400	480	6	18	80	0.2250000
NODE_7378_length_963_cov_33.642361	400	480	7	33	80	0.4125000
NODE_7379_length_963_cov_18.626157	392	472	3	28	80	0.3500000
NODE_7379_length_963_cov_18.626157	392	472	4	31	80	0.3875000
NODE_7379_length_963_cov_18.626157	392	472	7	21	80	0.2625000
NODE_7379_length_963_cov_18.626157	445	525	4	6	80	0.0750000
NODE_7379_length_963_cov_18.626157	445	525	6	11	80	0.1375000
NODE_7379_length_963_cov_18.626157	445	525	7	56	80	0.7000000
NODE_7379_length_963_cov_18.626157	445	525	9	7	80	0.0875000
NODE_7380_length_963_cov_17.750000	402	482	5	14	80	0.1750000
NODE_7380_length_963_cov_17.750000	402	482	6	7	80	0.0875000
NODE_7380_length_963_cov_17.750000	402	482	8	21	80	0.2625000
NODE_7380_length_963_cov_17.750000	402	482	10	38	80	0.4750000
NODE_7380_length_963_cov_17.750000	455	535	6	23	80	0.2875000
NODE_7380_length_963_cov_17.750000	455	535	7	1	80	0.0125000
NODE_7380_length_963_cov_17.750000	455	535	8	27	80	0.3375000
NODE_7380_length_963_cov_17.750000	455	535	10	29	80	0.3625000
NODE_7381_length_963_cov_17.023148	542	622	5	26	80	0.3250000
NODE_7381_length_963_cov_17.023148	542	622	6	43	80	0.5375000
NODE_7381_length_963_cov_17.023148	542	622	7	11	80	0.1375000
NODE_7381_length_963_cov_17.023148	595	675	3	10	80	0.1250000
NODE_7381_length_963_cov_17.023148	595	675	4	23	80	0.2875000
NODE_7381_length_963_cov_17.023148	595	675	5	26	80	0.3250000
NODE_7381_length_963_cov_17.023148	595	675	6	21	80	0.2625000
NODE_7382_length_963_cov_16.642361	481	561	4	4	80	0.0500000
NODE_7382_length_963_cov_16.642361	481	561	5	63	80	0.7875000
NODE_7382_length_963_cov_16.642361	481	561	8	13	80	0.1625000
NODE_7382_length_963_cov_16.642361	534	614	2	11	80	0.1375000
NODE_7382_length_963_cov_16.642361	534	614	5	54	80	0.6750000
NODE_7382_length_963_cov_16.642361	534	614	6	15	80	0.1875000
NODE_7382_length_963_cov_16.642361	572	629	2	26	57	0.4561403
NODE_7382_length_963_cov_16.642361	572	629	5	16	57	0.2807018
NODE_7382_length_963_cov_16.642361	572	629	6	15	57	0.2631579
NODE_7383_length_963_cov_14.961806	283	363	4	56	80	0.7000000
NODE_7383_length_963_cov_14.961806	283	363	5	7	80	0.0875000
NODE_7383_length_963_cov_14.961806	283	363	6	17	80	0.2125000
NODE_7383_length_963_cov_14.961806	336	416	4	61	80	0.7625000
NODE_7383_length_963_cov_14.961806	336	416	5	19	80	0.2375000
NODE_7384_length_963_cov_13.341435	558	638	4	44	80	0.5500000
NODE_7384_length_963_cov_13.341435	558	638	5	36	80	0.4500000
NODE_7384_length_963_cov_13.341435	611	691	2	3	80	0.0375000
NODE_7384_length_963_cov_13.341435	611	691	3	31	80	0.3875000
NODE_7384_length_963_cov_13.341435	611	691	4	17	80	0.2125000
NODE_7384_length_963_cov_13.341435	611	691	5	29	80	0.3625000
NODE_7386_length_963_cov_9.520833	459	539	0	6	80	0.0750000
NODE_7386_length_963_cov_9.520833	459	539	2	19	80	0.2375000
NODE_7386_length_963_cov_9.520833	459	539	3	3	80	0.0375000
NODE_7386_length_963_cov_9.520833	459	539	4	52	80	0.6500000
NODE_7386_length_963_cov_9.520833	512	592	4	38	80	0.4750000
NODE_7386_length_963_cov_9.520833	512	592	6	42	80	0.5250000
NODE_7386_length_963_cov_9.520833	588	662	2	27	74	0.3648649
NODE_7386_length_963_cov_9.520833	588	662	3	3	74	0.0405405
NODE_7386_length_963_cov_9.520833	588	662	4	19	74	0.2567568
NODE_7386_length_963_cov_9.520833	588	662	6	25	74	0.3378378
NODE_7386_length_963_cov_9.520833	641	724	0	24	83	0.2891566
NODE_7386_length_963_cov_9.520833	641	724	2	59	83	0.7108434
NODE_7388_length_963_cov_7.510417	781	842	8	4	61	0.0655738
NODE_7388_length_963_cov_7.510417	781	842	10	11	61	0.1803279
NODE_7388_length_963_cov_7.510417	781	842	11	2	61	0.0327869
NODE_7388_length_963_cov_7.510417	781	842	12	1	61	0.0163934
NODE_7388_length_963_cov_7.510417	781	842	13	10	61	0.1639344
NODE_7388_length_963_cov_7.510417	781	842	14	2	61	0.0327869
NODE_7388_length_963_cov_7.510417	781	842	17	7	61	0.1147541
NODE_7388_length_963_cov_7.510417	781	842	18	4	61	0.0655738
NODE_7388_length_963_cov_7.510417	781	842	19	20	61	0.3278688
NODE_7388_length_963_cov_7.510417	815	894	17	3	79	0.0379747
NODE_7388_length_963_cov_7.510417	815	894	18	4	79	0.0506329
NODE_7388_length_963_cov_7.510417	815	894	19	51	79	0.6455696
NODE_7388_length_963_cov_7.510417	815	894	20	15	79	0.1898734
NODE_7388_length_963_cov_7.510417	815	894	21	6	79	0.0759494
NODE_7392_length_963_cov_3.755787	378	458	7	16	80	0.2000000
NODE_7392_length_963_cov_3.755787	378	458	8	14	80	0.1750000
NODE_7392_length_963_cov_3.755787	378	458	10	12	80	0.1500000
NODE_7392_length_963_cov_3.755787	378	458	13	38	80	0.4750000
NODE_7392_length_963_cov_3.755787	431	511	4	10	80	0.1250000
NODE_7392_length_963_cov_3.755787	431	511	5	16	80	0.2000000
NODE_7392_length_963_cov_3.755787	431	511	7	43	80	0.5375000
NODE_7392_length_963_cov_3.755787	431	511	8	11	80	0.1375000
NODE_7397_length_963_cov_1.931713	426	485	0	59	59	1.0000000
NODE_7404_length_962_cov_37.169177	356	436	4	23	80	0.2875000
NODE_7404_length_962_cov_37.169177	356	436	6	8	80	0.1000000
NODE_7404_length_962_cov_37.169177	356	436	7	6	80	0.0750000
NODE_7404_length_962_cov_37.169177	356	436	8	43	80	0.5375000
NODE_7404_length_962_cov_37.169177	409	489	5	9	80	0.1125000
NODE_7404_length_962_cov_37.169177	409	489	7	7	80	0.0875000
NODE_7404_length_962_cov_37.169177	409	489	8	32	80	0.4000000
NODE_7404_length_962_cov_37.169177	409	489	9	32	80	0.4000000
NODE_7405_length_962_cov_28.852839	474	554	3	65	80	0.8125000
NODE_7405_length_962_cov_28.852839	474	554	4	15	80	0.1875000
NODE_7405_length_962_cov_28.852839	527	607	2	3	80	0.0375000
NODE_7405_length_962_cov_28.852839	527	607	3	54	80	0.6750000
NODE_7405_length_962_cov_28.852839	527	607	4	23	80	0.2875000
NODE_7405_length_962_cov_28.852839	603	683	2	33	80	0.4125000
NODE_7405_length_962_cov_28.852839	603	683	3	21	80	0.2625000
NODE_7405_length_962_cov_28.852839	603	683	4	26	80	0.3250000
NODE_7405_length_962_cov_28.852839	656	736	3	7	80	0.0875000
NODE_7405_length_962_cov_28.852839	656	736	4	71	80	0.8875000
NODE_7405_length_962_cov_28.852839	656	736	5	2	80	0.0250000
NODE_7406_length_962_cov_27.859791	441	521	2	11	80	0.1375000
NODE_7406_length_962_cov_27.859791	441	521	3	27	80	0.3375000
NODE_7406_length_962_cov_27.859791	441	521	4	9	80	0.1125000
NODE_7406_length_962_cov_27.859791	441	521	6	33	80	0.4125000
NODE_7406_length_962_cov_27.859791	494	574	4	6	80	0.0750000
NODE_7406_length_962_cov_27.859791	494	574	6	74	80	0.9250000
NODE_7407_length_962_cov_21.019699	318	398	2	34	80	0.4250000
NODE_7407_length_962_cov_21.019699	318	398	3	46	80	0.5750000
NODE_7407_length_962_cov_21.019699	371	451	2	11	80	0.1375000
NODE_7407_length_962_cov_21.019699	371	451	3	28	80	0.3500000
NODE_7407_length_962_cov_21.019699	371	451	4	41	80	0.5125000
NODE_7408_length_962_cov_16.792584	350	430	2	80	80	1.0000000
NODE_7408_length_962_cov_16.792584	403	483	0	20	80	0.2500000
NODE_7408_length_962_cov_16.792584	403	483	2	60	80	0.7500000
NODE_7409_length_962_cov_14.650058	477	557	6	39	80	0.4875000
NODE_7409_length_962_cov_14.650058	477	557	7	6	80	0.0750000
NODE_7409_length_962_cov_14.650058	477	557	8	35	80	0.4375000
NODE_7409_length_962_cov_14.650058	530	610	3	8	80	0.1000000
NODE_7409_length_962_cov_14.650058	530	610	5	11	80	0.1375000
NODE_7409_length_962_cov_14.650058	530	610	7	27	80	0.3375000
NODE_7409_length_962_cov_14.650058	530	610	8	29	80	0.3625000
NODE_7409_length_962_cov_14.650058	530	610	9	5	80	0.0625000
NODE_7410_length_962_cov_7.993048	308	345	2	37	37	1.0000000
NODE_7411_length_962_cov_7.835458	447	527	0	80	80	1.0000000
NODE_7411_length_962_cov_7.835458	500	580	0	80	80	1.0000000
NODE_7412_length_962_cov_6.855156	490	570	3	75	80	0.9375000
NODE_7412_length_962_cov_6.855156	490	570	4	1	80	0.0125000
NODE_7412_length_962_cov_6.855156	490	570	5	4	80	0.0500000
NODE_7412_length_962_cov_6.855156	543	623	3	22	80	0.2750000
NODE_7412_length_962_cov_6.855156	543	623	4	45	80	0.5625000
NODE_7412_length_962_cov_6.855156	543	623	5	11	80	0.1375000
NODE_7412_length_962_cov_6.855156	543	623	6	1	80	0.0125000
NODE_7412_length_962_cov_6.855156	543	623	7	1	80	0.0125000
NODE_7417_length_962_cov_1.840093	88	151	0	63	63	1.0000000
NODE_7422_length_961_cov_61.019722	453	533	0	49	80	0.6125000
NODE_7422_length_961_cov_61.019722	453	533	1	2	80	0.0250000
NODE_7422_length_961_cov_61.019722	453	533	4	1	80	0.0125000
NODE_7422_length_961_cov_61.019722	453	533	5	1	80	0.0125000
NODE_7422_length_961_cov_61.019722	453	533	7	6	80	0.0750000
NODE_7422_length_961_cov_61.019722	453	533	8	17	80	0.2125000
NODE_7422_length_961_cov_61.019722	453	533	9	4	80	0.0500000
NODE_7422_length_961_cov_61.019722	506	586	7	6	80	0.0750000
NODE_7422_length_961_cov_61.019722	506	586	8	17	80	0.2125000
NODE_7422_length_961_cov_61.019722	506	586	9	5	80	0.0625000
NODE_7422_length_961_cov_61.019722	506	586	10	21	80	0.2625000
NODE_7422_length_961_cov_61.019722	506	586	11	31	80	0.3875000
NODE_7422_length_961_cov_61.019722	614	672	0	10	58	0.1724138
NODE_7422_length_961_cov_61.019722	614	672	3	7	58	0.1206897
NODE_7422_length_961_cov_61.019722	614	672	4	3	58	0.0517241
NODE_7422_length_961_cov_61.019722	614	672	5	7	58	0.1206897
NODE_7422_length_961_cov_61.019722	614	672	8	1	58	0.0172414
NODE_7422_length_961_cov_61.019722	614	672	9	4	58	0.0689655
NODE_7422_length_961_cov_61.019722	614	672	10	26	58	0.4482759
NODE_7423_length_961_cov_51.005800	334	414	52	2	80	0.0250000
NODE_7423_length_961_cov_51.005800	334	414	53	5	80	0.0625000
NODE_7423_length_961_cov_51.005800	334	414	54	1	80	0.0125000
NODE_7423_length_961_cov_51.005800	334	414	55	2	80	0.0250000
NODE_7423_length_961_cov_51.005800	334	414	56	6	80	0.0750000
NODE_7423_length_961_cov_51.005800	334	414	57	1	80	0.0125000
NODE_7423_length_961_cov_51.005800	334	414	59	5	80	0.0625000
NODE_7423_length_961_cov_51.005800	334	414	60	7	80	0.0875000
NODE_7423_length_961_cov_51.005800	334	414	61	1	80	0.0125000
NODE_7423_length_961_cov_51.005800	334	414	62	7	80	0.0875000
NODE_7423_length_961_cov_51.005800	334	414	63	2	80	0.0250000
NODE_7423_length_961_cov_51.005800	334	414	64	6	80	0.0750000
NODE_7423_length_961_cov_51.005800	334	414	65	6	80	0.0750000
NODE_7423_length_961_cov_51.005800	334	414	66	5	80	0.0625000
NODE_7423_length_961_cov_51.005800	334	414	67	2	80	0.0250000
NODE_7423_length_961_cov_51.005800	334	414	68	13	80	0.1625000
NODE_7423_length_961_cov_51.005800	334	414	69	1	80	0.0125000
NODE_7423_length_961_cov_51.005800	334	414	70	1	80	0.0125000
NODE_7423_length_961_cov_51.005800	334	414	71	5	80	0.0625000
NODE_7423_length_961_cov_51.005800	334	414	72	2	80	0.0250000
NODE_7423_length_961_cov_51.005800	387	467	36	1	80	0.0125000
NODE_7423_length_961_cov_51.005800	387	467	38	3	80	0.0375000
NODE_7423_length_961_cov_51.005800	387	467	39	8	80	0.1000000
NODE_7423_length_961_cov_51.005800	387	467	40	3	80	0.0375000
NODE_7423_length_961_cov_51.005800	387	467	41	1	80	0.0125000
NODE_7423_length_961_cov_51.005800	387	467	42	9	80	0.1125000
NODE_7423_length_961_cov_51.005800	387	467	43	3	80	0.0375000
NODE_7423_length_961_cov_51.005800	387	467	44	1	80	0.0125000
NODE_7423_length_961_cov_51.005800	387	467	47	11	80	0.1375000
NODE_7423_length_961_cov_51.005800	387	467	52	1	80	0.0125000
NODE_7423_length_961_cov_51.005800	387	467	54	2	80	0.0250000
NODE_7423_length_961_cov_51.005800	387	467	55	6	80	0.0750000
NODE_7423_length_961_cov_51.005800	387	467	56	3	80	0.0375000
NODE_7423_length_961_cov_51.005800	387	467	57	1	80	0.0125000
NODE_7423_length_961_cov_51.005800	387	467	59	3	80	0.0375000
NODE_7423_length_961_cov_51.005800	387	467	61	1	80	0.0125000
NODE_7423_length_961_cov_51.005800	387	467	62	5	80	0.0625000
NODE_7423_length_961_cov_51.005800	387	467	66	1	80	0.0125000
NODE_7423_length_961_cov_51.005800	387	467	67	2	80	0.0250000
NODE_7423_length_961_cov_51.005800	387	467	68	6	80	0.0750000
NODE_7423_length_961_cov_51.005800	387	467	69	1	80	0.0125000
NODE_7423_length_961_cov_51.005800	387	467	70	1	80	0.0125000
NODE_7423_length_961_cov_51.005800	387	467	71	5	80	0.0625000
NODE_7423_length_961_cov_51.005800	387	467	72	2	80	0.0250000
NODE_7424_length_961_cov_45.923434	391	471	29	2	80	0.0250000
NODE_7424_length_961_cov_45.923434	391	471	30	3	80	0.0375000
NODE_7424_length_961_cov_45.923434	391	471	32	2	80	0.0250000
NODE_7424_length_961_cov_45.923434	391	471	36	6	80	0.0750000
NODE_7424_length_961_cov_45.923434	391	471	37	7	80	0.0875000
NODE_7424_length_961_cov_45.923434	391	471	38	11	80	0.1375000
NODE_7424_length_961_cov_45.923434	391	471	39	32	80	0.4000000
NODE_7424_length_961_cov_45.923434	391	471	40	9	80	0.1125000
NODE_7424_length_961_cov_45.923434	391	471	41	7	80	0.0875000
NODE_7424_length_961_cov_45.923434	391	471	42	1	80	0.0125000
NODE_7424_length_961_cov_45.923434	444	524	21	4	80	0.0500000
NODE_7424_length_961_cov_45.923434	444	524	22	5	80	0.0625000
NODE_7424_length_961_cov_45.923434	444	524	23	4	80	0.0500000
NODE_7424_length_961_cov_45.923434	444	524	24	8	80	0.1000000
NODE_7424_length_961_cov_45.923434	444	524	25	1	80	0.0125000
NODE_7424_length_961_cov_45.923434	444	524	26	4	80	0.0500000
NODE_7424_length_961_cov_45.923434	444	524	27	2	80	0.0250000
NODE_7424_length_961_cov_45.923434	444	524	29	1	80	0.0125000
NODE_7424_length_961_cov_45.923434	444	524	30	1	80	0.0125000
NODE_7424_length_961_cov_45.923434	444	524	32	2	80	0.0250000
NODE_7424_length_961_cov_45.923434	444	524	33	5	80	0.0625000
NODE_7424_length_961_cov_45.923434	444	524	36	15	80	0.1875000
NODE_7424_length_961_cov_45.923434	444	524	37	3	80	0.0375000
NODE_7424_length_961_cov_45.923434	444	524	39	8	80	0.1000000
NODE_7424_length_961_cov_45.923434	444	524	40	9	80	0.1125000
NODE_7424_length_961_cov_45.923434	444	524	41	7	80	0.0875000
NODE_7424_length_961_cov_45.923434	444	524	42	1	80	0.0125000
NODE_7426_length_961_cov_21.410673	313	393	4	6	80	0.0750000
NODE_7426_length_961_cov_21.410673	313	393	6	9	80	0.1125000
NODE_7426_length_961_cov_21.410673	313	393	7	15	80	0.1875000
NODE_7426_length_961_cov_21.410673	313	393	9	21	80	0.2625000
NODE_7426_length_961_cov_21.410673	313	393	10	28	80	0.3500000
NODE_7426_length_961_cov_21.410673	313	393	12	1	80	0.0125000
NODE_7426_length_961_cov_21.410673	366	446	9	16	80	0.2000000
NODE_7426_length_961_cov_21.410673	366	446	10	20	80	0.2500000
NODE_7426_length_961_cov_21.410673	366	446	12	34	80	0.4250000
NODE_7426_length_961_cov_21.410673	366	446	13	10	80	0.1250000
NODE_7427_length_961_cov_18.592807	403	483	0	37	80	0.4625000
NODE_7427_length_961_cov_18.592807	403	483	8	19	80	0.2375000
NODE_7427_length_961_cov_18.592807	403	483	10	24	80	0.3000000
NODE_7427_length_961_cov_18.592807	456	536	8	3	80	0.0375000
NODE_7427_length_961_cov_18.592807	456	536	10	55	80	0.6875000
NODE_7427_length_961_cov_18.592807	456	536	12	22	80	0.2750000
NODE_7428_length_961_cov_17.701856	433	513	3	1	80	0.0125000
NODE_7428_length_961_cov_17.701856	433	513	4	36	80	0.4500000
NODE_7428_length_961_cov_17.701856	433	513	5	1	80	0.0125000
NODE_7428_length_961_cov_17.701856	433	513	6	19	80	0.2375000
NODE_7428_length_961_cov_17.701856	433	513	7	23	80	0.2875000
NODE_7428_length_961_cov_17.701856	486	566	4	30	80	0.3750000
NODE_7428_length_961_cov_17.701856	486	566	5	50	80	0.6250000
NODE_7429_length_961_cov_17.020882	505	585	4	37	80	0.4625000
NODE_7429_length_961_cov_17.020882	505	585	5	19	80	0.2375000
NODE_7429_length_961_cov_17.020882	505	585	6	24	80	0.3000000
NODE_7429_length_961_cov_17.020882	558	638	3	24	80	0.3000000
NODE_7429_length_961_cov_17.020882	558	638	4	39	80	0.4875000
NODE_7429_length_961_cov_17.020882	558	638	5	17	80	0.2125000
NODE_7430_length_961_cov_16.235499	328	408	2	2	80	0.0250000
NODE_7430_length_961_cov_16.235499	328	408	4	44	80	0.5500000
NODE_7430_length_961_cov_16.235499	328	408	7	34	80	0.4250000
NODE_7430_length_961_cov_16.235499	381	461	3	24	80	0.3000000
NODE_7430_length_961_cov_16.235499	381	461	4	56	80	0.7000000
NODE_7432_length_961_cov_12.968677	347	427	0	80	80	1.0000000
NODE_7432_length_961_cov_12.968677	400	480	0	80	80	1.0000000
NODE_7433_length_961_cov_9.875870	439	519	3	2	80	0.0250000
NODE_7433_length_961_cov_9.875870	439	519	4	78	80	0.9750000
NODE_7433_length_961_cov_9.875870	492	572	3	16	80	0.2000000
NODE_7433_length_961_cov_9.875870	492	572	4	37	80	0.4625000
NODE_7433_length_961_cov_9.875870	492	572	5	27	80	0.3375000
NODE_7434_length_961_cov_6.172854	624	704	9	8	80	0.1000000
NODE_7434_length_961_cov_6.172854	624	704	10	38	80	0.4750000
NODE_7434_length_961_cov_6.172854	624	704	12	32	80	0.4000000
NODE_7434_length_961_cov_6.172854	624	704	13	2	80	0.0250000
NODE_7434_length_961_cov_6.172854	677	757	3	25	80	0.3125000
NODE_7434_length_961_cov_6.172854	677	757	8	27	80	0.3375000
NODE_7434_length_961_cov_6.172854	677	757	9	9	80	0.1125000
NODE_7434_length_961_cov_6.172854	677	757	12	19	80	0.2375000
NODE_7435_length_961_cov_4.553364	451	531	0	80	80	1.0000000
NODE_7435_length_961_cov_4.553364	504	584	0	80	80	1.0000000
NODE_7440_length_960_cov_35.649245	65	145	3	13	80	0.1625000
NODE_7440_length_960_cov_35.649245	65	145	4	8	80	0.1000000
NODE_7440_length_960_cov_35.649245	65	145	5	59	80	0.7375000
NODE_7440_length_960_cov_35.649245	118	198	3	18	80	0.2250000
NODE_7440_length_960_cov_35.649245	118	198	4	8	80	0.1000000
NODE_7440_length_960_cov_35.649245	118	198	5	54	80	0.6750000
NODE_7440_length_960_cov_35.649245	446	526	3	13	80	0.1625000
NODE_7440_length_960_cov_35.649245	446	526	4	7	80	0.0875000
NODE_7440_length_960_cov_35.649245	446	526	5	5	80	0.0625000
NODE_7440_length_960_cov_35.649245	446	526	6	10	80	0.1250000
NODE_7440_length_960_cov_35.649245	446	526	7	40	80	0.5000000
NODE_7440_length_960_cov_35.649245	446	526	9	5	80	0.0625000
NODE_7440_length_960_cov_35.649245	499	579	7	23	80	0.2875000
NODE_7440_length_960_cov_35.649245	499	579	8	34	80	0.4250000
NODE_7440_length_960_cov_35.649245	499	579	9	23	80	0.2875000
NODE_7441_length_960_cov_34.886179	386	466	11	7	80	0.0875000
NODE_7441_length_960_cov_34.886179	386	466	12	8	80	0.1000000
NODE_7441_length_960_cov_34.886179	386	466	14	1	80	0.0125000
NODE_7441_length_960_cov_34.886179	386	466	15	12	80	0.1500000
NODE_7441_length_960_cov_34.886179	386	466	16	50	80	0.6250000
NODE_7441_length_960_cov_34.886179	386	466	17	2	80	0.0250000
NODE_7441_length_960_cov_34.886179	439	519	15	17	80	0.2125000
NODE_7441_length_960_cov_34.886179	439	519	16	33	80	0.4125000
NODE_7441_length_960_cov_34.886179	439	519	17	14	80	0.1750000
NODE_7441_length_960_cov_34.886179	439	519	18	16	80	0.2000000
NODE_7443_length_960_cov_25.133566	413	493	6	11	80	0.1375000
NODE_7443_length_960_cov_25.133566	413	493	7	48	80	0.6000000
NODE_7443_length_960_cov_25.133566	413	493	8	21	80	0.2625000
NODE_7443_length_960_cov_25.133566	466	546	3	30	80	0.3750000
NODE_7443_length_960_cov_25.133566	466	546	4	8	80	0.1000000
NODE_7443_length_960_cov_25.133566	466	546	5	3	80	0.0375000
NODE_7443_length_960_cov_25.133566	466	546	6	23	80	0.2875000
NODE_7443_length_960_cov_25.133566	466	546	7	16	80	0.2000000
NODE_7444_length_960_cov_19.336818	385	465	4	1	80	0.0125000
NODE_7444_length_960_cov_19.336818	385	465	5	24	80	0.3000000
NODE_7444_length_960_cov_19.336818	385	465	7	1	80	0.0125000
NODE_7444_length_960_cov_19.336818	385	465	8	16	80	0.2000000
NODE_7444_length_960_cov_19.336818	385	465	9	8	80	0.1000000
NODE_7444_length_960_cov_19.336818	385	465	10	17	80	0.2125000
NODE_7444_length_960_cov_19.336818	385	465	11	8	80	0.1000000
NODE_7444_length_960_cov_19.336818	385	465	12	5	80	0.0625000
NODE_7444_length_960_cov_19.336818	438	518	10	14	80	0.1750000
NODE_7444_length_960_cov_19.336818	438	518	11	14	80	0.1750000
NODE_7444_length_960_cov_19.336818	438	518	12	5	80	0.0625000
NODE_7444_length_960_cov_19.336818	438	518	13	47	80	0.5875000
NODE_7445_length_960_cov_13.221835	460	539	3	13	79	0.1645570
NODE_7445_length_960_cov_13.221835	460	539	9	5	79	0.0632911
NODE_7445_length_960_cov_13.221835	460	539	10	7	79	0.0886076
NODE_7445_length_960_cov_13.221835	460	539	12	15	79	0.1898734
NODE_7445_length_960_cov_13.221835	460	539	13	8	79	0.1012658
NODE_7445_length_960_cov_13.221835	460	539	15	18	79	0.2278481
NODE_7445_length_960_cov_13.221835	460	539	16	9	79	0.1139240
NODE_7445_length_960_cov_13.221835	460	539	17	4	79	0.0506329
NODE_7445_length_960_cov_13.221835	512	592	15	29	80	0.3625000
NODE_7445_length_960_cov_13.221835	512	592	16	47	80	0.5875000
NODE_7445_length_960_cov_13.221835	512	592	17	4	80	0.0500000
NODE_7446_length_960_cov_12.804878	347	427	1	39	80	0.4875000
NODE_7446_length_960_cov_12.804878	347	427	3	23	80	0.2875000
NODE_7446_length_960_cov_12.804878	347	427	4	18	80	0.2250000
NODE_7446_length_960_cov_12.804878	400	480	3	55	80	0.6875000
NODE_7446_length_960_cov_12.804878	400	480	4	25	80	0.3125000
NODE_7462_length_959_cov_39.394186	326	406	3	10	80	0.1250000
NODE_7462_length_959_cov_39.394186	326	406	4	9	80	0.1125000
NODE_7462_length_959_cov_39.394186	326	406	5	1	80	0.0125000
NODE_7462_length_959_cov_39.394186	326	406	6	18	80	0.2250000
NODE_7462_length_959_cov_39.394186	326	406	7	42	80	0.5250000
NODE_7462_length_959_cov_39.394186	379	459	6	7	80	0.0875000
NODE_7462_length_959_cov_39.394186	379	459	7	68	80	0.8500000
NODE_7462_length_959_cov_39.394186	379	459	8	5	80	0.0625000
NODE_7463_length_959_cov_28.895349	327	407	2	14	80	0.1750000
NODE_7463_length_959_cov_28.895349	327	407	3	50	80	0.6250000
NODE_7463_length_959_cov_28.895349	327	407	4	16	80	0.2000000
NODE_7463_length_959_cov_28.895349	380	460	3	11	80	0.1375000
NODE_7463_length_959_cov_28.895349	380	460	4	67	80	0.8375000
NODE_7463_length_959_cov_28.895349	380	460	5	2	80	0.0250000
NODE_7464_length_959_cov_26.634884	563	643	7	17	80	0.2125000
NODE_7464_length_959_cov_26.634884	563	643	8	19	80	0.2375000
NODE_7464_length_959_cov_26.634884	563	643	11	21	80	0.2625000
NODE_7464_length_959_cov_26.634884	563	643	14	23	80	0.2875000
NODE_7464_length_959_cov_26.634884	616	696	10	3	80	0.0375000
NODE_7464_length_959_cov_26.634884	616	696	11	16	80	0.2000000
NODE_7464_length_959_cov_26.634884	616	696	13	8	80	0.1000000
NODE_7464_length_959_cov_26.634884	616	696	14	34	80	0.4250000
NODE_7464_length_959_cov_26.634884	616	696	16	19	80	0.2375000
NODE_7464_length_959_cov_26.634884	692	772	4	2	80	0.0250000
NODE_7464_length_959_cov_26.634884	692	772	6	1	80	0.0125000
NODE_7464_length_959_cov_26.634884	692	772	7	20	80	0.2500000
NODE_7464_length_959_cov_26.634884	692	772	10	8	80	0.1000000
NODE_7464_length_959_cov_26.634884	692	772	11	49	80	0.6125000
NODE_7464_length_959_cov_26.634884	745	825	1	23	80	0.2875000
NODE_7464_length_959_cov_26.634884	745	825	3	1	80	0.0125000
NODE_7464_length_959_cov_26.634884	745	825	4	31	80	0.3875000
NODE_7464_length_959_cov_26.634884	745	825	6	1	80	0.0125000
NODE_7464_length_959_cov_26.634884	745	825	7	20	80	0.2500000
NODE_7464_length_959_cov_26.634884	745	825	11	4	80	0.0500000
NODE_7465_length_959_cov_18.862791	320	400	0	22	80	0.2750000
NODE_7465_length_959_cov_18.862791	320	400	1	45	80	0.5625000
NODE_7465_length_959_cov_18.862791	320	400	2	13	80	0.1625000
NODE_7465_length_959_cov_18.862791	373	453	1	14	80	0.1750000
NODE_7465_length_959_cov_18.862791	373	453	2	66	80	0.8250000
NODE_7466_length_959_cov_17.910465	358	438	3	25	80	0.3125000
NODE_7466_length_959_cov_17.910465	358	438	4	41	80	0.5125000
NODE_7466_length_959_cov_17.910465	358	438	5	14	80	0.1750000
NODE_7466_length_959_cov_17.910465	411	491	2	37	80	0.4625000
NODE_7466_length_959_cov_17.910465	411	491	3	11	80	0.1375000
NODE_7466_length_959_cov_17.910465	411	491	4	18	80	0.2250000
NODE_7466_length_959_cov_17.910465	411	491	5	14	80	0.1750000
NODE_7467_length_959_cov_15.337209	267	347	2	80	80	1.0000000
NODE_7467_length_959_cov_15.337209	320	400	0	7	80	0.0875000
NODE_7467_length_959_cov_15.337209	320	400	1	32	80	0.4000000
NODE_7467_length_959_cov_15.337209	320	400	2	41	80	0.5125000
NODE_7468_length_959_cov_9.005814	529	609	9	8	80	0.1000000
NODE_7468_length_959_cov_9.005814	529	609	11	3	80	0.0375000
NODE_7468_length_959_cov_9.005814	529	609	12	1	80	0.0125000
NODE_7468_length_959_cov_9.005814	529	609	13	9	80	0.1125000
NODE_7468_length_959_cov_9.005814	529	609	14	29	80	0.3625000
NODE_7468_length_959_cov_9.005814	529	609	15	27	80	0.3375000
NODE_7468_length_959_cov_9.005814	529	609	16	3	80	0.0375000
NODE_7468_length_959_cov_9.005814	582	662	6	8	80	0.1000000
NODE_7468_length_959_cov_9.005814	582	662	9	16	80	0.2000000
NODE_7468_length_959_cov_9.005814	582	662	11	24	80	0.3000000
NODE_7468_length_959_cov_9.005814	582	662	13	3	80	0.0375000
NODE_7468_length_959_cov_9.005814	582	662	14	26	80	0.3250000
NODE_7468_length_959_cov_9.005814	582	662	16	3	80	0.0375000
NODE_7469_length_959_cov_8.163953	392	472	3	13	80	0.1625000
NODE_7469_length_959_cov_8.163953	392	472	4	29	80	0.3625000
NODE_7469_length_959_cov_8.163953	392	472	5	38	80	0.4750000
NODE_7469_length_959_cov_8.163953	445	525	3	66	80	0.8250000
NODE_7469_length_959_cov_8.163953	445	525	4	14	80	0.1750000
NODE_7470_length_959_cov_7.097674	401	481	0	8	80	0.1000000
NODE_7470_length_959_cov_7.097674	401	481	2	72	80	0.9000000
NODE_7470_length_959_cov_7.097674	454	534	2	46	80	0.5750000
NODE_7470_length_959_cov_7.097674	454	534	4	34	80	0.4250000
NODE_7472_length_959_cov_4.603488	596	676	0	80	80	1.0000000
NODE_7472_length_959_cov_4.603488	649	729	0	80	80	1.0000000
NODE_7486_length_958_cov_57.015134	328	408	5	16	80	0.2000000
NODE_7486_length_958_cov_57.015134	328	408	7	1	80	0.0125000
NODE_7486_length_958_cov_57.015134	328	408	9	11	80	0.1375000
NODE_7486_length_958_cov_57.015134	328	408	11	2	80	0.0250000
NODE_7486_length_958_cov_57.015134	328	408	13	16	80	0.2000000
NODE_7486_length_958_cov_57.015134	328	408	15	5	80	0.0625000
NODE_7486_length_958_cov_57.015134	328	408	18	2	80	0.0250000
NODE_7486_length_958_cov_57.015134	328	408	20	1	80	0.0125000
NODE_7486_length_958_cov_57.015134	328	408	21	5	80	0.0625000
NODE_7486_length_958_cov_57.015134	328	408	23	5	80	0.0625000
NODE_7486_length_958_cov_57.015134	328	408	24	12	80	0.1500000
NODE_7486_length_958_cov_57.015134	328	408	25	4	80	0.0500000
NODE_7486_length_958_cov_57.015134	381	461	20	1	80	0.0125000
NODE_7486_length_958_cov_57.015134	381	461	21	5	80	0.0625000
NODE_7486_length_958_cov_57.015134	381	461	23	5	80	0.0625000
NODE_7486_length_958_cov_57.015134	381	461	24	12	80	0.1500000
NODE_7486_length_958_cov_57.015134	381	461	25	12	80	0.1500000
NODE_7486_length_958_cov_57.015134	381	461	26	4	80	0.0500000
NODE_7486_length_958_cov_57.015134	381	461	29	1	80	0.0125000
NODE_7486_length_958_cov_57.015134	381	461	30	3	80	0.0375000
NODE_7486_length_958_cov_57.015134	381	461	34	1	80	0.0125000
NODE_7486_length_958_cov_57.015134	381	461	35	1	80	0.0125000
NODE_7486_length_958_cov_57.015134	381	461	36	4	80	0.0500000
NODE_7486_length_958_cov_57.015134	381	461	38	5	80	0.0625000
NODE_7486_length_958_cov_57.015134	381	461	39	2	80	0.0250000
NODE_7486_length_958_cov_57.015134	381	461	42	3	80	0.0375000
NODE_7486_length_958_cov_57.015134	381	461	43	15	80	0.1875000
NODE_7486_length_958_cov_57.015134	381	461	44	3	80	0.0375000
NODE_7486_length_958_cov_57.015134	381	461	45	3	80	0.0375000
NODE_7486_length_958_cov_57.015134	457	537	44	1	80	0.0125000
NODE_7486_length_958_cov_57.015134	457	537	45	11	80	0.1375000
NODE_7486_length_958_cov_57.015134	457	537	46	1	80	0.0125000
NODE_7486_length_958_cov_57.015134	457	537	47	14	80	0.1750000
NODE_7486_length_958_cov_57.015134	457	537	48	3	80	0.0375000
NODE_7486_length_958_cov_57.015134	457	537	51	1	80	0.0125000
NODE_7486_length_958_cov_57.015134	457	537	54	4	80	0.0500000
NODE_7486_length_958_cov_57.015134	457	537	55	2	80	0.0250000
NODE_7486_length_958_cov_57.015134	457	537	56	4	80	0.0500000
NODE_7486_length_958_cov_57.015134	457	537	57	3	80	0.0375000
NODE_7486_length_958_cov_57.015134	457	537	58	12	80	0.1500000
NODE_7486_length_958_cov_57.015134	457	537	59	4	80	0.0500000
NODE_7486_length_958_cov_57.015134	457	537	60	6	80	0.0750000
NODE_7486_length_958_cov_57.015134	457	537	61	1	80	0.0125000
NODE_7486_length_958_cov_57.015134	457	537	62	12	80	0.1500000
NODE_7486_length_958_cov_57.015134	457	537	63	1	80	0.0125000
NODE_7486_length_958_cov_57.015134	510	590	34	3	80	0.0375000
NODE_7486_length_958_cov_57.015134	510	590	35	1	80	0.0125000
NODE_7486_length_958_cov_57.015134	510	590	38	5	80	0.0625000
NODE_7486_length_958_cov_57.015134	510	590	40	5	80	0.0625000
NODE_7486_length_958_cov_57.015134	510	590	41	1	80	0.0125000
NODE_7486_length_958_cov_57.015134	510	590	43	1	80	0.0125000
NODE_7486_length_958_cov_57.015134	510	590	45	1	80	0.0125000
NODE_7486_length_958_cov_57.015134	510	590	46	3	80	0.0375000
NODE_7486_length_958_cov_57.015134	510	590	47	1	80	0.0125000
NODE_7486_length_958_cov_57.015134	510	590	48	8	80	0.1000000
NODE_7486_length_958_cov_57.015134	510	590	49	8	80	0.1000000
NODE_7486_length_958_cov_57.015134	510	590	51	11	80	0.1375000
NODE_7486_length_958_cov_57.015134	510	590	52	4	80	0.0500000
NODE_7486_length_958_cov_57.015134	510	590	54	5	80	0.0625000
NODE_7486_length_958_cov_57.015134	510	590	55	2	80	0.0250000
NODE_7486_length_958_cov_57.015134	510	590	57	1	80	0.0125000
NODE_7486_length_958_cov_57.015134	510	590	58	2	80	0.0250000
NODE_7486_length_958_cov_57.015134	510	590	59	1	80	0.0125000
NODE_7486_length_958_cov_57.015134	510	590	60	3	80	0.0375000
NODE_7486_length_958_cov_57.015134	510	590	61	1	80	0.0125000
NODE_7486_length_958_cov_57.015134	510	590	62	12	80	0.1500000
NODE_7486_length_958_cov_57.015134	510	590	63	1	80	0.0125000
NODE_7487_length_958_cov_42.265425	418	498	10	29	80	0.3625000
NODE_7487_length_958_cov_42.265425	418	498	11	2	80	0.0250000
NODE_7487_length_958_cov_42.265425	418	498	12	7	80	0.0875000
NODE_7487_length_958_cov_42.265425	418	498	13	30	80	0.3750000
NODE_7487_length_958_cov_42.265425	418	498	16	12	80	0.1500000
NODE_7487_length_958_cov_42.265425	471	551	4	5	80	0.0625000
NODE_7487_length_958_cov_42.265425	471	551	6	17	80	0.2125000
NODE_7487_length_958_cov_42.265425	471	551	7	5	80	0.0625000
NODE_7487_length_958_cov_42.265425	471	551	10	53	80	0.6625000
NODE_7488_length_958_cov_28.618161	336	416	3	44	80	0.5500000
NODE_7488_length_958_cov_28.618161	336	416	4	24	80	0.3000000
NODE_7488_length_958_cov_28.618161	336	416	5	4	80	0.0500000
NODE_7488_length_958_cov_28.618161	336	416	6	5	80	0.0625000
NODE_7488_length_958_cov_28.618161	336	416	7	3	80	0.0375000
NODE_7488_length_958_cov_28.618161	389	469	4	17	80	0.2125000
NODE_7488_length_958_cov_28.618161	389	469	5	4	80	0.0500000
NODE_7488_length_958_cov_28.618161	389	469	6	5	80	0.0625000
NODE_7488_length_958_cov_28.618161	389	469	7	31	80	0.3875000
NODE_7488_length_958_cov_28.618161	389	469	9	7	80	0.0875000
NODE_7488_length_958_cov_28.618161	389	469	12	3	80	0.0375000
NODE_7488_length_958_cov_28.618161	389	469	15	1	80	0.0125000
NODE_7488_length_958_cov_28.618161	389	469	16	3	80	0.0375000
NODE_7488_length_958_cov_28.618161	389	469	23	9	80	0.1125000
NODE_7488_length_958_cov_28.618161	465	545	21	6	80	0.0750000
NODE_7488_length_958_cov_28.618161	465	545	22	1	80	0.0125000
NODE_7488_length_958_cov_28.618161	465	545	23	17	80	0.2125000
NODE_7488_length_958_cov_28.618161	465	545	24	15	80	0.1875000
NODE_7488_length_958_cov_28.618161	465	545	25	41	80	0.5125000
NODE_7488_length_958_cov_28.618161	518	598	20	10	80	0.1250000
NODE_7488_length_958_cov_28.618161	518	598	21	1	80	0.0125000
NODE_7488_length_958_cov_28.618161	518	598	22	31	80	0.3875000
NODE_7488_length_958_cov_28.618161	518	598	23	1	80	0.0125000
NODE_7488_length_958_cov_28.618161	518	598	24	24	80	0.3000000
NODE_7488_length_958_cov_28.618161	518	598	25	13	80	0.1625000
NODE_7489_length_958_cov_16.452852	446	526	3	7	80	0.0875000
NODE_7489_length_958_cov_16.452852	446	526	4	73	80	0.9125000
NODE_7489_length_958_cov_16.452852	499	579	1	7	80	0.0875000
NODE_7489_length_958_cov_16.452852	499	579	2	2	80	0.0250000
NODE_7489_length_958_cov_16.452852	499	579	3	25	80	0.3125000
NODE_7489_length_958_cov_16.452852	499	579	4	46	80	0.5750000
NODE_7490_length_958_cov_16.008149	446	526	9	7	80	0.0875000
NODE_7490_length_958_cov_16.008149	446	526	10	6	80	0.0750000
NODE_7490_length_958_cov_16.008149	446	526	11	40	80	0.5000000
NODE_7490_length_958_cov_16.008149	446	526	12	12	80	0.1500000
NODE_7490_length_958_cov_16.008149	446	526	13	6	80	0.0750000
NODE_7490_length_958_cov_16.008149	446	526	15	1	80	0.0125000
NODE_7490_length_958_cov_16.008149	446	526	17	3	80	0.0375000
NODE_7490_length_958_cov_16.008149	446	526	18	5	80	0.0625000
NODE_7490_length_958_cov_16.008149	499	579	9	7	80	0.0875000
NODE_7490_length_958_cov_16.008149	499	579	10	2	80	0.0250000
NODE_7490_length_958_cov_16.008149	499	579	11	4	80	0.0500000
NODE_7490_length_958_cov_16.008149	499	579	12	5	80	0.0625000
NODE_7490_length_958_cov_16.008149	499	579	14	8	80	0.1000000
NODE_7490_length_958_cov_16.008149	499	579	15	5	80	0.0625000
NODE_7490_length_958_cov_16.008149	499	579	16	21	80	0.2625000
NODE_7490_length_958_cov_16.008149	499	579	17	23	80	0.2875000
NODE_7490_length_958_cov_16.008149	499	579	18	5	80	0.0625000
NODE_7491_length_958_cov_14.154831	516	596	4	13	80	0.1625000
NODE_7491_length_958_cov_14.154831	516	596	7	16	80	0.2000000
NODE_7491_length_958_cov_14.154831	516	596	8	10	80	0.1250000
NODE_7491_length_958_cov_14.154831	516	596	9	41	80	0.5125000
NODE_7491_length_958_cov_14.154831	569	649	0	35	80	0.4375000
NODE_7491_length_958_cov_14.154831	569	649	2	1	80	0.0125000
NODE_7491_length_958_cov_14.154831	569	649	3	13	80	0.1625000
NODE_7491_length_958_cov_14.154831	569	649	4	17	80	0.2125000
NODE_7491_length_958_cov_14.154831	569	649	7	14	80	0.1750000
NODE_7492_length_958_cov_12.381839	454	534	5	49	80	0.6125000
NODE_7492_length_958_cov_12.381839	454	534	8	31	80	0.3875000
NODE_7492_length_958_cov_12.381839	507	587	0	8	80	0.1000000
NODE_7492_length_958_cov_12.381839	507	587	1	4	80	0.0500000
NODE_7492_length_958_cov_12.381839	507	587	4	39	80	0.4875000
NODE_7492_length_958_cov_12.381839	507	587	5	29	80	0.3625000
NODE_7493_length_958_cov_11.782305	479	559	0	4	80	0.0500000
NODE_7493_length_958_cov_11.782305	479	559	1	76	80	0.9500000
NODE_7493_length_958_cov_11.782305	532	612	0	57	80	0.7125000
NODE_7493_length_958_cov_11.782305	532	612	1	23	80	0.2875000
NODE_7501_length_957_cov_40.837995	746	826	12	35	80	0.4375000
NODE_7501_length_957_cov_40.837995	746	826	13	2	80	0.0250000
NODE_7501_length_957_cov_40.837995	746	826	14	22	80	0.2750000
NODE_7501_length_957_cov_40.837995	746	826	15	3	80	0.0375000
NODE_7501_length_957_cov_40.837995	746	826	16	18	80	0.2250000
NODE_7501_length_957_cov_40.837995	799	879	3	9	80	0.1125000
NODE_7501_length_957_cov_40.837995	799	879	5	7	80	0.0875000
NODE_7501_length_957_cov_40.837995	799	879	6	5	80	0.0625000
NODE_7501_length_957_cov_40.837995	799	879	8	6	80	0.0750000
NODE_7501_length_957_cov_40.837995	799	879	9	21	80	0.2625000
NODE_7501_length_957_cov_40.837995	799	879	11	3	80	0.0375000
NODE_7501_length_957_cov_40.837995	799	879	12	29	80	0.3625000
NODE_7502_length_957_cov_25.976690	631	711	8	55	80	0.6875000
NODE_7502_length_957_cov_25.976690	631	711	10	17	80	0.2125000
NODE_7502_length_957_cov_25.976690	631	711	11	8	80	0.1000000
NODE_7502_length_957_cov_25.976690	684	764	8	2	80	0.0250000
NODE_7502_length_957_cov_25.976690	684	764	10	17	80	0.2125000
NODE_7502_length_957_cov_25.976690	684	764	11	15	80	0.1875000
NODE_7502_length_957_cov_25.976690	684	764	12	20	80	0.2500000
NODE_7502_length_957_cov_25.976690	684	764	14	4	80	0.0500000
NODE_7502_length_957_cov_25.976690	684	764	16	15	80	0.1875000
NODE_7502_length_957_cov_25.976690	684	764	17	6	80	0.0750000
NODE_7502_length_957_cov_25.976690	684	764	18	1	80	0.0125000
NODE_7503_length_957_cov_25.855478	57	131	1	74	74	1.0000000
NODE_7503_length_957_cov_25.855478	414	494	0	38	80	0.4750000
NODE_7503_length_957_cov_25.855478	414	494	1	42	80	0.5250000
NODE_7503_length_957_cov_25.855478	467	547	0	33	80	0.4125000
NODE_7503_length_957_cov_25.855478	467	547	1	47	80	0.5875000
NODE_7504_length_957_cov_24.625874	445	525	9	26	80	0.3250000
NODE_7504_length_957_cov_24.625874	445	525	10	28	80	0.3500000
NODE_7504_length_957_cov_24.625874	445	525	11	3	80	0.0375000
NODE_7504_length_957_cov_24.625874	445	525	13	23	80	0.2875000
NODE_7504_length_957_cov_24.625874	498	578	7	1	80	0.0125000
NODE_7504_length_957_cov_24.625874	498	578	8	11	80	0.1375000
NODE_7504_length_957_cov_24.625874	498	578	9	41	80	0.5125000
NODE_7504_length_957_cov_24.625874	498	578	10	27	80	0.3375000
NODE_7505_length_957_cov_19.955711	286	366	2	73	80	0.9125000
NODE_7505_length_957_cov_19.955711	286	366	3	7	80	0.0875000
NODE_7505_length_957_cov_19.955711	339	419	2	62	80	0.7750000
NODE_7505_length_957_cov_19.955711	339	419	3	18	80	0.2250000
NODE_7506_length_957_cov_18.861305	414	494	5	8	80	0.1000000
NODE_7506_length_957_cov_18.861305	414	494	6	3	80	0.0375000
NODE_7506_length_957_cov_18.861305	414	494	7	46	80	0.5750000
NODE_7506_length_957_cov_18.861305	414	494	8	23	80	0.2875000
NODE_7506_length_957_cov_18.861305	467	547	4	8	80	0.1000000
NODE_7506_length_957_cov_18.861305	467	547	5	18	80	0.2250000
NODE_7506_length_957_cov_18.861305	467	547	6	1	80	0.0125000
NODE_7506_length_957_cov_18.861305	467	547	7	18	80	0.2250000
NODE_7506_length_957_cov_18.861305	467	547	8	35	80	0.4375000
NODE_7507_length_957_cov_17.356643	361	441	2	17	80	0.2125000
NODE_7507_length_957_cov_17.356643	361	441	3	13	80	0.1625000
NODE_7507_length_957_cov_17.356643	361	441	5	50	80	0.6250000
NODE_7507_length_957_cov_17.356643	414	494	5	80	80	1.0000000
NODE_7508_length_957_cov_13.569930	162	242	1	24	80	0.3000000
NODE_7508_length_957_cov_13.569930	162	242	2	56	80	0.7000000
NODE_7508_length_957_cov_13.569930	215	299	1	81	84	0.9642857
NODE_7508_length_957_cov_13.569930	215	299	2	3	84	0.0357143
NODE_7509_length_957_cov_12.334499	314	394	3	22	80	0.2750000
NODE_7509_length_957_cov_12.334499	314	394	4	58	80	0.7250000
NODE_7509_length_957_cov_12.334499	367	447	2	4	80	0.0500000
NODE_7509_length_957_cov_12.334499	367	447	3	48	80	0.6000000
NODE_7509_length_957_cov_12.334499	367	447	4	28	80	0.3500000
NODE_7510_length_957_cov_12.017483	173	253	9	5	80	0.0625000
NODE_7510_length_957_cov_12.017483	173	253	10	1	80	0.0125000
NODE_7510_length_957_cov_12.017483	173	253	11	15	80	0.1875000
NODE_7510_length_957_cov_12.017483	173	253	12	23	80	0.2875000
NODE_7510_length_957_cov_12.017483	173	253	13	36	80	0.4500000
NODE_7510_length_957_cov_12.017483	226	306	5	5	80	0.0625000
NODE_7510_length_957_cov_12.017483	226	306	6	17	80	0.2125000
NODE_7510_length_957_cov_12.017483	226	306	7	14	80	0.1750000
NODE_7510_length_957_cov_12.017483	226	306	9	5	80	0.0625000
NODE_7510_length_957_cov_12.017483	226	306	11	7	80	0.0875000
NODE_7510_length_957_cov_12.017483	226	306	12	25	80	0.3125000
NODE_7510_length_957_cov_12.017483	226	306	13	7	80	0.0875000
NODE_7511_length_957_cov_10.026807	446	526	0	6	80	0.0750000
NODE_7511_length_957_cov_10.026807	446	526	1	8	80	0.1000000
NODE_7511_length_957_cov_10.026807	446	526	2	44	80	0.5500000
NODE_7511_length_957_cov_10.026807	446	526	3	22	80	0.2750000
NODE_7511_length_957_cov_10.026807	499	579	2	5	80	0.0625000
NODE_7511_length_957_cov_10.026807	499	579	3	75	80	0.9375000
NODE_7529_length_956_cov_48.047841	479	559	15	2	80	0.0250000
NODE_7529_length_956_cov_48.047841	479	559	16	8	80	0.1000000
NODE_7529_length_956_cov_48.047841	479	559	17	18	80	0.2250000
NODE_7529_length_956_cov_48.047841	479	559	18	12	80	0.1500000
NODE_7529_length_956_cov_48.047841	479	559	19	13	80	0.1625000
NODE_7529_length_956_cov_48.047841	479	559	20	27	80	0.3375000
NODE_7529_length_956_cov_48.047841	532	612	2	4	80	0.0500000
NODE_7529_length_956_cov_48.047841	532	612	3	6	80	0.0750000
NODE_7529_length_956_cov_48.047841	532	612	5	26	80	0.3250000
NODE_7529_length_956_cov_48.047841	532	612	6	1	80	0.0125000
NODE_7529_length_956_cov_48.047841	532	612	7	1	80	0.0125000
NODE_7529_length_956_cov_48.047841	532	612	9	2	80	0.0250000
NODE_7529_length_956_cov_48.047841	532	612	10	13	80	0.1625000
NODE_7529_length_956_cov_48.047841	532	612	15	2	80	0.0250000
NODE_7529_length_956_cov_48.047841	532	612	16	8	80	0.1000000
NODE_7529_length_956_cov_48.047841	532	612	19	13	80	0.1625000
NODE_7529_length_956_cov_48.047841	532	612	20	4	80	0.0500000
NODE_7529_length_956_cov_48.047841	608	688	1	48	80	0.6000000
NODE_7529_length_956_cov_48.047841	608	688	2	32	80	0.4000000
NODE_7529_length_956_cov_48.047841	661	741	1	42	80	0.5250000
NODE_7529_length_956_cov_48.047841	661	741	4	1	80	0.0125000
NODE_7529_length_956_cov_48.047841	661	741	5	32	80	0.4000000
NODE_7529_length_956_cov_48.047841	661	741	6	5	80	0.0625000
NODE_7530_length_956_cov_34.539090	298	378	0	7	80	0.0875000
NODE_7530_length_956_cov_34.539090	298	378	2	41	80	0.5125000
NODE_7530_length_956_cov_34.539090	298	378	4	32	80	0.4000000
NODE_7530_length_956_cov_34.539090	351	431	4	80	80	1.0000000
NODE_7530_length_956_cov_34.539090	427	507	3	11	80	0.1375000
NODE_7530_length_956_cov_34.539090	427	507	4	21	80	0.2625000
NODE_7530_length_956_cov_34.539090	427	507	5	41	80	0.5125000
NODE_7530_length_956_cov_34.539090	427	507	7	7	80	0.0875000
NODE_7530_length_956_cov_34.539090	480	560	3	21	80	0.2625000
NODE_7530_length_956_cov_34.539090	480	560	5	16	80	0.2000000
NODE_7530_length_956_cov_34.539090	480	560	6	43	80	0.5375000
NODE_7531_length_956_cov_24.355893	398	478	0	80	80	1.0000000
NODE_7531_length_956_cov_24.355893	451	531	0	80	80	1.0000000
NODE_7532_length_956_cov_21.940490	373	453	3	3	80	0.0375000
NODE_7532_length_956_cov_21.940490	373	453	4	4	80	0.0500000
NODE_7532_length_956_cov_21.940490	373	453	5	19	80	0.2375000
NODE_7532_length_956_cov_21.940490	373	453	6	11	80	0.1375000
NODE_7532_length_956_cov_21.940490	373	453	7	43	80	0.5375000
NODE_7532_length_956_cov_21.940490	426	506	3	7	80	0.0875000
NODE_7532_length_956_cov_21.940490	426	506	4	38	80	0.4750000
NODE_7532_length_956_cov_21.940490	426	506	5	34	80	0.4250000
NODE_7532_length_956_cov_21.940490	426	506	6	1	80	0.0125000
NODE_7532_length_956_cov_21.940490	502	582	3	54	80	0.6750000
NODE_7532_length_956_cov_21.940490	502	582	4	18	80	0.2250000
NODE_7532_length_956_cov_21.940490	502	582	5	8	80	0.1000000
NODE_7532_length_956_cov_21.940490	555	635	1	13	80	0.1625000
NODE_7532_length_956_cov_21.940490	555	635	2	15	80	0.1875000
NODE_7532_length_956_cov_21.940490	555	635	3	52	80	0.6500000
NODE_7533_length_956_cov_19.435239	274	354	4	38	80	0.4750000
NODE_7533_length_956_cov_19.435239	274	354	5	42	80	0.5250000
NODE_7533_length_956_cov_19.435239	274	301	4	27	27	1.0000000
NODE_7534_length_956_cov_17.819137	378	458	5	3	80	0.0375000
NODE_7534_length_956_cov_17.819137	378	458	6	28	80	0.3500000
NODE_7534_length_956_cov_17.819137	378	458	7	23	80	0.2875000
NODE_7534_length_956_cov_17.819137	378	458	8	15	80	0.1875000
NODE_7534_length_956_cov_17.819137	378	458	9	11	80	0.1375000
NODE_7534_length_956_cov_17.819137	431	511	7	1	80	0.0125000
NODE_7534_length_956_cov_17.819137	431	511	8	15	80	0.1875000
NODE_7534_length_956_cov_17.819137	431	511	9	47	80	0.5875000
NODE_7534_length_956_cov_17.819137	431	511	10	7	80	0.0875000
NODE_7534_length_956_cov_17.819137	431	511	11	10	80	0.1250000
NODE_7535_length_956_cov_16.098016	551	631	10	9	80	0.1125000
NODE_7535_length_956_cov_16.098016	551	631	11	8	80	0.1000000
NODE_7535_length_956_cov_16.098016	551	631	12	46	80	0.5750000
NODE_7535_length_956_cov_16.098016	551	631	14	17	80	0.2125000
NODE_7535_length_956_cov_16.098016	604	684	8	8	80	0.1000000
NODE_7535_length_956_cov_16.098016	604	684	9	2	80	0.0250000
NODE_7535_length_956_cov_16.098016	604	684	10	14	80	0.1750000
NODE_7535_length_956_cov_16.098016	604	684	11	24	80	0.3000000
NODE_7535_length_956_cov_16.098016	604	684	12	15	80	0.1875000
NODE_7535_length_956_cov_16.098016	604	684	14	17	80	0.2125000
NODE_7536_length_956_cov_15.229872	490	570	0	12	80	0.1500000
NODE_7536_length_956_cov_15.229872	490	570	2	68	80	0.8500000
NODE_7536_length_956_cov_15.229872	543	623	2	80	80	1.0000000
NODE_7537_length_956_cov_7.533256	439	519	0	80	80	1.0000000
NODE_7537_length_956_cov_7.533256	497	572	0	75	75	1.0000000
NODE_7545_length_955_cov_30.821262	438	518	4	5	80	0.0625000
NODE_7545_length_955_cov_30.821262	438	518	5	13	80	0.1625000
NODE_7545_length_955_cov_30.821262	438	518	6	41	80	0.5125000
NODE_7545_length_955_cov_30.821262	438	518	7	6	80	0.0750000
NODE_7545_length_955_cov_30.821262	438	518	8	15	80	0.1875000
NODE_7545_length_955_cov_30.821262	491	571	6	41	80	0.5125000
NODE_7545_length_955_cov_30.821262	491	571	7	24	80	0.3000000
NODE_7545_length_955_cov_30.821262	491	571	8	15	80	0.1875000
NODE_7546_length_955_cov_30.574766	380	460	1	18	80	0.2250000
NODE_7546_length_955_cov_30.574766	380	460	2	8	80	0.1000000
NODE_7546_length_955_cov_30.574766	380	460	3	54	80	0.6750000
NODE_7546_length_955_cov_30.574766	433	513	2	3	80	0.0375000
NODE_7546_length_955_cov_30.574766	433	513	3	37	80	0.4625000
NODE_7546_length_955_cov_30.574766	433	513	4	6	80	0.0750000
NODE_7546_length_955_cov_30.574766	433	513	5	1	80	0.0125000
NODE_7546_length_955_cov_30.574766	433	513	6	3	80	0.0375000
NODE_7546_length_955_cov_30.574766	433	513	7	30	80	0.3750000
NODE_7546_length_955_cov_30.574766	509	589	7	13	80	0.1625000
NODE_7546_length_955_cov_30.574766	509	589	8	37	80	0.4625000
NODE_7546_length_955_cov_30.574766	509	589	9	3	80	0.0375000
NODE_7546_length_955_cov_30.574766	509	589	10	27	80	0.3375000
NODE_7546_length_955_cov_30.574766	562	642	7	9	80	0.1125000
NODE_7546_length_955_cov_30.574766	562	642	8	4	80	0.0500000
NODE_7546_length_955_cov_30.574766	562	642	9	3	80	0.0375000
NODE_7546_length_955_cov_30.574766	562	642	10	37	80	0.4625000
NODE_7546_length_955_cov_30.574766	562	642	11	27	80	0.3375000
NODE_7547_length_955_cov_27.734813	373	453	11	1	80	0.0125000
NODE_7547_length_955_cov_27.734813	373	453	18	14	80	0.1750000
NODE_7547_length_955_cov_27.734813	373	453	20	5	80	0.0625000
NODE_7547_length_955_cov_27.734813	373	453	21	2	80	0.0250000
NODE_7547_length_955_cov_27.734813	373	453	22	6	80	0.0750000
NODE_7547_length_955_cov_27.734813	373	453	23	2	80	0.0250000
NODE_7547_length_955_cov_27.734813	373	453	24	20	80	0.2500000
NODE_7547_length_955_cov_27.734813	373	453	25	6	80	0.0750000
NODE_7547_length_955_cov_27.734813	373	453	26	4	80	0.0500000
NODE_7547_length_955_cov_27.734813	373	453	29	20	80	0.2500000
NODE_7547_length_955_cov_27.734813	426	506	25	3	80	0.0375000
NODE_7547_length_955_cov_27.734813	426	506	26	4	80	0.0500000
NODE_7547_length_955_cov_27.734813	426	506	28	5	80	0.0625000
NODE_7547_length_955_cov_27.734813	426	506	29	42	80	0.5250000
NODE_7547_length_955_cov_27.734813	426	506	30	2	80	0.0250000
NODE_7547_length_955_cov_27.734813	426	506	31	6	80	0.0750000
NODE_7547_length_955_cov_27.734813	426	506	32	9	80	0.1125000
NODE_7547_length_955_cov_27.734813	426	506	33	9	80	0.1125000
NODE_7548_length_955_cov_24.475467	439	519	11	3	80	0.0375000
NODE_7548_length_955_cov_24.475467	439	519	13	12	80	0.1500000
NODE_7548_length_955_cov_24.475467	439	519	14	2	80	0.0250000
NODE_7548_length_955_cov_24.475467	439	519	15	20	80	0.2500000
NODE_7548_length_955_cov_24.475467	439	519	17	1	80	0.0125000
NODE_7548_length_955_cov_24.475467	439	519	18	14	80	0.1750000
NODE_7548_length_955_cov_24.475467	439	519	19	14	80	0.1750000
NODE_7548_length_955_cov_24.475467	439	519	20	12	80	0.1500000
NODE_7548_length_955_cov_24.475467	439	519	21	2	80	0.0250000
NODE_7548_length_955_cov_24.475467	492	572	15	11	80	0.1375000
NODE_7548_length_955_cov_24.475467	492	572	17	7	80	0.0875000
NODE_7548_length_955_cov_24.475467	492	572	18	6	80	0.0750000
NODE_7548_length_955_cov_24.475467	492	572	19	15	80	0.1875000
NODE_7548_length_955_cov_24.475467	492	572	20	30	80	0.3750000
NODE_7548_length_955_cov_24.475467	492	572	21	2	80	0.0250000
NODE_7548_length_955_cov_24.475467	492	572	22	9	80	0.1125000
NODE_7549_length_955_cov_22.146028	351	431	5	4	80	0.0500000
NODE_7549_length_955_cov_22.146028	351	431	6	59	80	0.7375000
NODE_7549_length_955_cov_22.146028	351	431	7	17	80	0.2125000
NODE_7549_length_955_cov_22.146028	404	484	5	3	80	0.0375000
NODE_7549_length_955_cov_22.146028	404	484	6	72	80	0.9000000
NODE_7549_length_955_cov_22.146028	404	484	7	2	80	0.0250000
NODE_7549_length_955_cov_22.146028	404	484	8	3	80	0.0375000
NODE_7550_length_955_cov_16.212617	441	521	4	47	80	0.5875000
NODE_7550_length_955_cov_16.212617	441	521	5	2	80	0.0250000
NODE_7550_length_955_cov_16.212617	441	521	6	31	80	0.3875000
NODE_7550_length_955_cov_16.212617	494	574	4	56	80	0.7000000
NODE_7550_length_955_cov_16.212617	494	574	5	7	80	0.0875000
NODE_7550_length_955_cov_16.212617	494	574	6	17	80	0.2125000
NODE_7551_length_955_cov_13.334112	269	349	0	80	80	1.0000000
NODE_7551_length_955_cov_13.334112	322	402	0	80	80	1.0000000
NODE_7552_length_955_cov_12.544393	363	443	7	20	80	0.2500000
NODE_7552_length_955_cov_12.544393	363	443	11	40	80	0.5000000
NODE_7552_length_955_cov_12.544393	363	443	12	20	80	0.2500000
NODE_7552_length_955_cov_12.544393	416	496	5	32	80	0.4000000
NODE_7552_length_955_cov_12.544393	416	496	6	11	80	0.1375000
NODE_7552_length_955_cov_12.544393	416	496	7	1	80	0.0125000
NODE_7552_length_955_cov_12.544393	416	496	11	36	80	0.4500000
NODE_7553_length_955_cov_8.204439	358	438	2	49	80	0.6125000
NODE_7553_length_955_cov_8.204439	358	438	4	11	80	0.1375000
NODE_7553_length_955_cov_8.204439	358	438	6	20	80	0.2500000
NODE_7553_length_955_cov_8.204439	411	491	0	43	80	0.5375000
NODE_7553_length_955_cov_8.204439	411	491	2	37	80	0.4625000
NODE_7563_length_954_cov_35.691228	381	461	5	80	80	1.0000000
NODE_7563_length_954_cov_35.691228	434	514	3	9	80	0.1125000
NODE_7563_length_954_cov_35.691228	434	514	4	38	80	0.4750000
NODE_7563_length_954_cov_35.691228	434	514	5	33	80	0.4125000
NODE_7564_length_954_cov_30.769591	408	488	12	6	80	0.0750000
NODE_7564_length_954_cov_30.769591	408	488	14	16	80	0.2000000
NODE_7564_length_954_cov_30.769591	408	488	15	2	80	0.0250000
NODE_7564_length_954_cov_30.769591	408	488	16	31	80	0.3875000
NODE_7564_length_954_cov_30.769591	408	488	17	19	80	0.2375000
NODE_7564_length_954_cov_30.769591	408	488	18	3	80	0.0375000
NODE_7564_length_954_cov_30.769591	408	488	19	3	80	0.0375000
NODE_7564_length_954_cov_30.769591	461	541	11	3	80	0.0375000
NODE_7564_length_954_cov_30.769591	461	541	12	17	80	0.2125000
NODE_7564_length_954_cov_30.769591	461	541	13	6	80	0.0750000
NODE_7564_length_954_cov_30.769591	461	541	14	34	80	0.4250000
NODE_7564_length_954_cov_30.769591	461	541	16	13	80	0.1625000
NODE_7564_length_954_cov_30.769591	461	541	17	7	80	0.0875000
NODE_7565_length_954_cov_27.247953	418	498	3	8	80	0.1000000
NODE_7565_length_954_cov_27.247953	418	498	6	1	80	0.0125000
NODE_7565_length_954_cov_27.247953	418	498	9	2	80	0.0250000
NODE_7565_length_954_cov_27.247953	418	498	10	28	80	0.3500000
NODE_7565_length_954_cov_27.247953	418	498	11	41	80	0.5125000
NODE_7565_length_954_cov_27.247953	471	551	10	12	80	0.1500000
NODE_7565_length_954_cov_27.247953	471	551	11	18	80	0.2250000
NODE_7565_length_954_cov_27.247953	471	551	14	8	80	0.1000000
NODE_7565_length_954_cov_27.247953	471	551	16	1	80	0.0125000
NODE_7565_length_954_cov_27.247953	471	551	17	26	80	0.3250000
NODE_7565_length_954_cov_27.247953	471	551	18	15	80	0.1875000
NODE_7566_length_954_cov_22.796491	270	350	17	16	80	0.2000000
NODE_7566_length_954_cov_22.796491	270	350	18	3	80	0.0375000
NODE_7566_length_954_cov_22.796491	270	350	19	61	80	0.7625000
NODE_7566_length_954_cov_22.796491	323	403	1	5	80	0.0625000
NODE_7566_length_954_cov_22.796491	323	403	6	1	80	0.0125000
NODE_7566_length_954_cov_22.796491	323	403	7	8	80	0.1000000
NODE_7566_length_954_cov_22.796491	323	403	9	8	80	0.1000000
NODE_7566_length_954_cov_22.796491	323	403	16	7	80	0.0875000
NODE_7566_length_954_cov_22.796491	323	403	17	36	80	0.4500000
NODE_7566_length_954_cov_22.796491	323	403	18	7	80	0.0875000
NODE_7566_length_954_cov_22.796491	323	403	19	8	80	0.1000000
NODE_7567_length_954_cov_15.645614	337	417	2	27	80	0.3375000
NODE_7567_length_954_cov_15.645614	337	417	3	34	80	0.4250000
NODE_7567_length_954_cov_15.645614	337	417	4	19	80	0.2375000
NODE_7567_length_954_cov_15.645614	390	470	3	8	80	0.1000000
NODE_7567_length_954_cov_15.645614	390	470	4	66	80	0.8250000
NODE_7567_length_954_cov_15.645614	390	470	6	6	80	0.0750000
NODE_7568_length_954_cov_13.538012	346	426	7	22	80	0.2750000
NODE_7568_length_954_cov_13.538012	346	426	9	16	80	0.2000000
NODE_7568_length_954_cov_13.538012	346	426	10	23	80	0.2875000
NODE_7568_length_954_cov_13.538012	346	426	13	19	80	0.2375000
NODE_7568_length_954_cov_13.538012	399	479	9	8	80	0.1000000
NODE_7568_length_954_cov_13.538012	399	479	11	5	80	0.0625000
NODE_7568_length_954_cov_13.538012	399	479	12	9	80	0.1125000
NODE_7568_length_954_cov_13.538012	399	479	13	23	80	0.2875000
NODE_7568_length_954_cov_13.538012	399	479	14	35	80	0.4375000
NODE_7569_length_954_cov_12.162573	155	217	0	53	62	0.8548387
NODE_7569_length_954_cov_12.162573	155	217	1	9	62	0.1451613
NODE_7570_length_954_cov_10.714620	239	319	2	80	80	1.0000000
NODE_7570_length_954_cov_10.714620	292	372	0	26	80	0.3250000
NODE_7570_length_954_cov_10.714620	292	372	2	54	80	0.6750000
NODE_7571_length_954_cov_5.670175	431	511	0	2	80	0.0250000
NODE_7571_length_954_cov_5.670175	431	511	4	73	80	0.9125000
NODE_7571_length_954_cov_5.670175	431	511	7	1	80	0.0125000
NODE_7571_length_954_cov_5.670175	431	511	8	4	80	0.0500000
NODE_7571_length_954_cov_5.670175	484	564	0	55	80	0.6875000
NODE_7571_length_954_cov_5.670175	484	564	4	25	80	0.3125000
NODE_7582_length_953_cov_35.789227	425	505	19	11	80	0.1375000
NODE_7582_length_953_cov_35.789227	425	505	20	17	80	0.2125000
NODE_7582_length_953_cov_35.789227	425	505	21	28	80	0.3500000
NODE_7582_length_953_cov_35.789227	425	505	22	1	80	0.0125000
NODE_7582_length_953_cov_35.789227	425	505	23	7	80	0.0875000
NODE_7582_length_953_cov_35.789227	425	505	24	13	80	0.1625000
NODE_7582_length_953_cov_35.789227	425	505	26	1	80	0.0125000
NODE_7582_length_953_cov_35.789227	425	505	27	2	80	0.0250000
NODE_7582_length_953_cov_35.789227	478	558	18	1	80	0.0125000
NODE_7582_length_953_cov_35.789227	478	558	19	23	80	0.2875000
NODE_7582_length_953_cov_35.789227	478	558	21	1	80	0.0125000
NODE_7582_length_953_cov_35.789227	478	558	22	9	80	0.1125000
NODE_7582_length_953_cov_35.789227	478	558	23	7	80	0.0875000
NODE_7582_length_953_cov_35.789227	478	558	24	18	80	0.2250000
NODE_7582_length_953_cov_35.789227	478	558	25	21	80	0.2625000
NODE_7583_length_953_cov_33.940281	430	510	4	5	80	0.0625000
NODE_7583_length_953_cov_33.940281	430	510	6	7	80	0.0875000
NODE_7583_length_953_cov_33.940281	430	510	8	37	80	0.4625000
NODE_7583_length_953_cov_33.940281	430	510	9	24	80	0.3000000
NODE_7583_length_953_cov_33.940281	430	510	10	7	80	0.0875000
NODE_7583_length_953_cov_33.940281	483	563	6	19	80	0.2375000
NODE_7583_length_953_cov_33.940281	483	563	8	33	80	0.4125000
NODE_7583_length_953_cov_33.940281	483	563	9	25	80	0.3125000
NODE_7583_length_953_cov_33.940281	483	563	10	3	80	0.0375000
NODE_7584_length_953_cov_26.844262	333	413	1	64	80	0.8000000
NODE_7584_length_953_cov_26.844262	333	413	2	9	80	0.1125000
NODE_7584_length_953_cov_26.844262	333	413	3	7	80	0.0875000
NODE_7584_length_953_cov_26.844262	386	466	1	11	80	0.1375000
NODE_7584_length_953_cov_26.844262	386	466	2	9	80	0.1125000
NODE_7584_length_953_cov_26.844262	386	466	3	28	80	0.3500000
NODE_7584_length_953_cov_26.844262	386	466	4	32	80	0.4000000
NODE_7584_length_953_cov_26.844262	462	542	3	11	80	0.1375000
NODE_7584_length_953_cov_26.844262	462	542	6	3	80	0.0375000
NODE_7584_length_953_cov_26.844262	462	542	7	13	80	0.1625000
NODE_7584_length_953_cov_26.844262	462	542	9	10	80	0.1250000
NODE_7584_length_953_cov_26.844262	462	542	10	18	80	0.2250000
NODE_7584_length_953_cov_26.844262	462	542	11	25	80	0.3125000
NODE_7584_length_953_cov_26.844262	515	595	9	35	80	0.4375000
NODE_7584_length_953_cov_26.844262	515	595	10	15	80	0.1875000
NODE_7584_length_953_cov_26.844262	515	595	11	30	80	0.3750000
NODE_7585_length_953_cov_20.770492	301	381	10	6	80	0.0750000
NODE_7585_length_953_cov_20.770492	301	381	12	11	80	0.1375000
NODE_7585_length_953_cov_20.770492	301	381	13	7	80	0.0875000
NODE_7585_length_953_cov_20.770492	301	381	15	10	80	0.1250000
NODE_7585_length_953_cov_20.770492	301	381	16	9	80	0.1125000
NODE_7585_length_953_cov_20.770492	301	381	18	10	80	0.1250000
NODE_7585_length_953_cov_20.770492	301	381	19	12	80	0.1500000
NODE_7585_length_953_cov_20.770492	301	381	20	1	80	0.0125000
NODE_7585_length_953_cov_20.770492	301	381	21	14	80	0.1750000
NODE_7585_length_953_cov_20.770492	354	434	16	4	80	0.0500000
NODE_7585_length_953_cov_20.770492	354	434	19	12	80	0.1500000
NODE_7585_length_953_cov_20.770492	354	434	20	16	80	0.2000000
NODE_7585_length_953_cov_20.770492	354	434	21	15	80	0.1875000
NODE_7585_length_953_cov_20.770492	354	434	22	1	80	0.0125000
NODE_7585_length_953_cov_20.770492	354	434	23	22	80	0.2750000
NODE_7585_length_953_cov_20.770492	354	434	24	6	80	0.0750000
NODE_7585_length_953_cov_20.770492	354	434	25	4	80	0.0500000
NODE_7586_length_953_cov_17.514052	421	501	1	80	80	1.0000000
NODE_7586_length_953_cov_17.514052	474	554	0	51	80	0.6375000
NODE_7586_length_953_cov_17.514052	474	554	1	29	80	0.3625000
NODE_7586_length_953_cov_17.514052	550	630	0	19	80	0.2375000
NODE_7586_length_953_cov_17.514052	550	630	2	3	80	0.0375000
NODE_7586_length_953_cov_17.514052	550	630	3	8	80	0.1000000
NODE_7586_length_953_cov_17.514052	550	630	4	36	80	0.4500000
NODE_7586_length_953_cov_17.514052	550	630	6	14	80	0.1750000
NODE_7586_length_953_cov_17.514052	603	683	4	13	80	0.1625000
NODE_7586_length_953_cov_17.514052	603	683	6	17	80	0.2125000
NODE_7586_length_953_cov_17.514052	603	683	8	50	80	0.6250000
NODE_7587_length_953_cov_11.579625	332	412	9	16	80	0.2000000
NODE_7587_length_953_cov_11.579625	332	412	10	64	80	0.8000000
NODE_7587_length_953_cov_11.579625	385	465	4	7	80	0.0875000
NODE_7587_length_953_cov_11.579625	385	465	8	3	80	0.0375000
NODE_7587_length_953_cov_11.579625	385	465	9	2	80	0.0250000
NODE_7587_length_953_cov_11.579625	385	465	10	68	80	0.8500000
NODE_7588_length_953_cov_7.281030	276	356	0	74	80	0.9250000
NODE_7588_length_953_cov_7.281030	276	356	1	6	80	0.0750000
NODE_7588_length_953_cov_7.281030	329	409	0	21	80	0.2625000
NODE_7588_length_953_cov_7.281030	329	409	1	59	80	0.7375000
NODE_7599_length_952_cov_44.880422	447	527	14	23	80	0.2875000
NODE_7599_length_952_cov_44.880422	447	527	16	7	80	0.0875000
NODE_7599_length_952_cov_44.880422	447	527	17	32	80	0.4000000
NODE_7599_length_952_cov_44.880422	447	527	19	8	80	0.1000000
NODE_7599_length_952_cov_44.880422	447	527	20	10	80	0.1250000
NODE_7599_length_952_cov_44.880422	500	580	13	26	80	0.3250000
NODE_7599_length_952_cov_44.880422	500	580	16	5	80	0.0625000
NODE_7599_length_952_cov_44.880422	500	580	17	7	80	0.0875000
NODE_7599_length_952_cov_44.880422	500	580	18	2	80	0.0250000
NODE_7599_length_952_cov_44.880422	500	580	19	21	80	0.2625000
NODE_7599_length_952_cov_44.880422	500	580	20	19	80	0.2375000
NODE_7599_length_952_cov_44.880422	871	951	0	80	80	1.0000000
NODE_7600_length_952_cov_42.485346	402	482	17	15	80	0.1875000
NODE_7600_length_952_cov_42.485346	402	482	19	3	80	0.0375000
NODE_7600_length_952_cov_42.485346	402	482	20	11	80	0.1375000
NODE_7600_length_952_cov_42.485346	402	482	21	20	80	0.2500000
NODE_7600_length_952_cov_42.485346	402	482	23	17	80	0.2125000
NODE_7600_length_952_cov_42.485346	402	482	25	14	80	0.1750000
NODE_7600_length_952_cov_42.485346	455	535	17	1	80	0.0125000
NODE_7600_length_952_cov_42.485346	455	535	20	13	80	0.1625000
NODE_7600_length_952_cov_42.485346	455	535	23	13	80	0.1625000
NODE_7600_length_952_cov_42.485346	455	535	24	13	80	0.1625000
NODE_7600_length_952_cov_42.485346	455	535	25	19	80	0.2375000
NODE_7600_length_952_cov_42.485346	455	535	27	14	80	0.1750000
NODE_7600_length_952_cov_42.485346	455	535	28	4	80	0.0500000
NODE_7600_length_952_cov_42.485346	455	535	30	3	80	0.0375000
NODE_7601_length_952_cov_40.065651	422	502	8	9	80	0.1125000
NODE_7601_length_952_cov_40.065651	422	502	9	2	80	0.0250000
NODE_7601_length_952_cov_40.065651	422	502	12	31	80	0.3875000
NODE_7601_length_952_cov_40.065651	422	502	13	38	80	0.4750000
NODE_7601_length_952_cov_40.065651	475	555	6	9	80	0.1125000
NODE_7601_length_952_cov_40.065651	475	555	10	22	80	0.2750000
NODE_7601_length_952_cov_40.065651	475	555	11	10	80	0.1250000
NODE_7601_length_952_cov_40.065651	475	555	12	1	80	0.0125000
NODE_7601_length_952_cov_40.065651	475	555	13	36	80	0.4500000
NODE_7601_length_952_cov_40.065651	475	555	14	2	80	0.0250000
NODE_7602_length_952_cov_34.813599	308	388	3	27	80	0.3375000
NODE_7602_length_952_cov_34.813599	308	388	4	8	80	0.1000000
NODE_7602_length_952_cov_34.813599	308	388	5	45	80	0.5625000
NODE_7602_length_952_cov_34.813599	361	441	4	14	80	0.1750000
NODE_7602_length_952_cov_34.813599	361	441	5	66	80	0.8250000
NODE_7603_length_952_cov_28.055100	661	741	5	16	80	0.2000000
NODE_7603_length_952_cov_28.055100	661	741	7	52	80	0.6500000
NODE_7603_length_952_cov_28.055100	661	741	8	12	80	0.1500000
NODE_7603_length_952_cov_28.055100	714	794	3	31	80	0.3875000
NODE_7603_length_952_cov_28.055100	714	794	5	6	80	0.0750000
NODE_7603_length_952_cov_28.055100	714	794	7	12	80	0.1500000
NODE_7603_length_952_cov_28.055100	714	794	8	31	80	0.3875000
NODE_7604_length_952_cov_23.739742	435	515	8	2	80	0.0250000
NODE_7604_length_952_cov_23.739742	435	515	10	35	80	0.4375000
NODE_7604_length_952_cov_23.739742	435	515	11	43	80	0.5375000
NODE_7604_length_952_cov_23.739742	488	568	9	15	80	0.1875000
NODE_7604_length_952_cov_23.739742	488	568	10	10	80	0.1250000
NODE_7604_length_952_cov_23.739742	488	568	11	55	80	0.6875000
NODE_7606_length_952_cov_11.478312	245	324	4	14	79	0.1772152
NODE_7606_length_952_cov_11.478312	245	324	5	17	79	0.2151899
NODE_7606_length_952_cov_11.478312	245	324	6	1	79	0.0126582
NODE_7606_length_952_cov_11.478312	245	324	8	4	79	0.0506329
NODE_7606_length_952_cov_11.478312	245	324	11	3	79	0.0379747
NODE_7606_length_952_cov_11.478312	245	324	15	2	79	0.0253165
NODE_7606_length_952_cov_11.478312	245	324	16	33	79	0.4177215
NODE_7606_length_952_cov_11.478312	245	324	19	2	79	0.0253165
NODE_7606_length_952_cov_11.478312	245	324	21	3	79	0.0379747
NODE_7606_length_952_cov_11.478312	297	377	16	22	80	0.2750000
NODE_7606_length_952_cov_11.478312	297	377	18	10	80	0.1250000
NODE_7606_length_952_cov_11.478312	297	377	19	17	80	0.2125000
NODE_7606_length_952_cov_11.478312	297	377	20	28	80	0.3500000
NODE_7606_length_952_cov_11.478312	297	377	21	3	80	0.0375000
NODE_7607_length_952_cov_11.284877	272	352	0	80	80	1.0000000
NODE_7607_length_952_cov_11.284877	325	405	0	80	80	1.0000000
NODE_7608_length_952_cov_10.807737	458	538	1	13	80	0.1625000
NODE_7608_length_952_cov_10.807737	458	538	2	67	80	0.8375000
NODE_7608_length_952_cov_10.807737	511	591	2	34	80	0.4250000
NODE_7608_length_952_cov_10.807737	511	591	3	17	80	0.2125000
NODE_7608_length_952_cov_10.807737	511	591	4	29	80	0.3625000
NODE_7609_length_952_cov_8.770223	375	455	0	3	80	0.0375000
NODE_7609_length_952_cov_8.770223	375	455	2	7	80	0.0875000
NODE_7609_length_952_cov_8.770223	375	455	4	70	80	0.8750000
NODE_7609_length_952_cov_8.770223	428	508	0	56	80	0.7000000
NODE_7609_length_952_cov_8.770223	428	508	2	7	80	0.0875000
NODE_7609_length_952_cov_8.770223	428	508	4	17	80	0.2125000
NODE_7623_length_951_cov_54.397887	354	434	19	24	80	0.3000000
NODE_7623_length_951_cov_54.397887	354	434	20	17	80	0.2125000
NODE_7623_length_951_cov_54.397887	354	434	21	25	80	0.3125000
NODE_7623_length_951_cov_54.397887	354	434	22	1	80	0.0125000
NODE_7623_length_951_cov_54.397887	354	434	23	13	80	0.1625000
NODE_7623_length_951_cov_54.397887	407	487	12	14	80	0.1750000
NODE_7623_length_951_cov_54.397887	407	487	14	5	80	0.0625000
NODE_7623_length_951_cov_54.397887	407	487	17	20	80	0.2500000
NODE_7623_length_951_cov_54.397887	407	487	18	6	80	0.0750000
NODE_7623_length_951_cov_54.397887	407	487	19	31	80	0.3875000
NODE_7623_length_951_cov_54.397887	407	487	20	1	80	0.0125000
NODE_7623_length_951_cov_54.397887	407	487	21	3	80	0.0375000
NODE_7623_length_951_cov_54.397887	483	563	12	4	80	0.0500000
NODE_7623_length_951_cov_54.397887	483	563	13	27	80	0.3375000
NODE_7623_length_951_cov_54.397887	483	563	14	29	80	0.3625000
NODE_7623_length_951_cov_54.397887	483	563	17	11	80	0.1375000
NODE_7623_length_951_cov_54.397887	483	563	18	3	80	0.0375000
NODE_7623_length_951_cov_54.397887	483	563	20	6	80	0.0750000
NODE_7623_length_951_cov_54.397887	544	616	8	8	72	0.1111111
NODE_7623_length_951_cov_54.397887	544	616	11	43	72	0.5972222
NODE_7623_length_951_cov_54.397887	544	616	13	21	72	0.2916667
NODE_7624_length_951_cov_47.881455	355	435	11	6	80	0.0750000
NODE_7624_length_951_cov_47.881455	355	435	12	16	80	0.2000000
NODE_7624_length_951_cov_47.881455	355	435	13	35	80	0.4375000
NODE_7624_length_951_cov_47.881455	355	435	14	12	80	0.1500000
NODE_7624_length_951_cov_47.881455	355	435	17	3	80	0.0375000
NODE_7624_length_951_cov_47.881455	355	435	18	8	80	0.1000000
NODE_7624_length_951_cov_47.881455	408	488	11	5	80	0.0625000
NODE_7624_length_951_cov_47.881455	408	488	12	27	80	0.3375000
NODE_7624_length_951_cov_47.881455	408	488	13	13	80	0.1625000
NODE_7624_length_951_cov_47.881455	408	488	15	2	80	0.0250000
NODE_7624_length_951_cov_47.881455	408	488	17	3	80	0.0375000
NODE_7624_length_951_cov_47.881455	408	488	18	11	80	0.1375000
NODE_7624_length_951_cov_47.881455	408	488	19	6	80	0.0750000
NODE_7624_length_951_cov_47.881455	408	488	20	13	80	0.1625000
NODE_7624_length_951_cov_47.881455	484	564	11	19	80	0.2375000
NODE_7624_length_951_cov_47.881455	484	564	13	40	80	0.5000000
NODE_7624_length_951_cov_47.881455	484	564	14	21	80	0.2625000
NODE_7624_length_951_cov_47.881455	537	617	5	29	80	0.3625000
NODE_7624_length_951_cov_47.881455	537	617	7	11	80	0.1375000
NODE_7624_length_951_cov_47.881455	537	617	8	3	80	0.0375000
NODE_7624_length_951_cov_47.881455	537	617	12	3	80	0.0375000
NODE_7624_length_951_cov_47.881455	537	617	13	16	80	0.2000000
NODE_7624_length_951_cov_47.881455	537	617	14	18	80	0.2250000
NODE_7625_length_951_cov_24.322770	479	559	6	4	80	0.0500000
NODE_7625_length_951_cov_24.322770	479	559	9	7	80	0.0875000
NODE_7625_length_951_cov_24.322770	479	559	11	3	80	0.0375000
NODE_7625_length_951_cov_24.322770	479	559	13	4	80	0.0500000
NODE_7625_length_951_cov_24.322770	479	559	16	27	80	0.3375000
NODE_7625_length_951_cov_24.322770	479	559	18	35	80	0.4375000
NODE_7625_length_951_cov_24.322770	532	612	5	27	80	0.3375000
NODE_7625_length_951_cov_24.322770	532	612	6	30	80	0.3750000
NODE_7625_length_951_cov_24.322770	532	612	9	7	80	0.0875000
NODE_7625_length_951_cov_24.322770	532	612	11	3	80	0.0375000
NODE_7625_length_951_cov_24.322770	532	612	13	4	80	0.0500000
NODE_7625_length_951_cov_24.322770	532	612	16	9	80	0.1125000
NODE_7626_length_951_cov_23.001174	470	550	9	18	80	0.2250000
NODE_7626_length_951_cov_23.001174	470	550	10	10	80	0.1250000
NODE_7626_length_951_cov_23.001174	470	550	11	4	80	0.0500000
NODE_7626_length_951_cov_23.001174	470	550	12	48	80	0.6000000
NODE_7626_length_951_cov_23.001174	523	603	3	15	80	0.1875000
NODE_7626_length_951_cov_23.001174	523	603	4	9	80	0.1125000
NODE_7626_length_951_cov_23.001174	523	603	6	10	80	0.1250000
NODE_7626_length_951_cov_23.001174	523	603	7	5	80	0.0625000
NODE_7626_length_951_cov_23.001174	523	603	8	6	80	0.0750000
NODE_7626_length_951_cov_23.001174	523	603	9	25	80	0.3125000
NODE_7626_length_951_cov_23.001174	523	603	10	10	80	0.1250000
NODE_7627_length_951_cov_22.059859	562	642	4	16	80	0.2000000
NODE_7627_length_951_cov_22.059859	562	642	6	64	80	0.8000000
NODE_7627_length_951_cov_22.059859	615	695	2	2	80	0.0250000
NODE_7627_length_951_cov_22.059859	615	695	3	41	80	0.5125000
NODE_7627_length_951_cov_22.059859	615	695	4	26	80	0.3250000
NODE_7627_length_951_cov_22.059859	615	695	6	11	80	0.1375000
NODE_7628_length_951_cov_19.413146	456	536	4	9	80	0.1125000
NODE_7628_length_951_cov_19.413146	456	536	6	14	80	0.1750000
NODE_7628_length_951_cov_19.413146	456	536	8	13	80	0.1625000
NODE_7628_length_951_cov_19.413146	456	536	9	15	80	0.1875000
NODE_7628_length_951_cov_19.413146	456	536	10	29	80	0.3625000
NODE_7628_length_951_cov_19.413146	509	589	6	6	80	0.0750000
NODE_7628_length_951_cov_19.413146	509	589	7	26	80	0.3250000
NODE_7628_length_951_cov_19.413146	509	589	9	15	80	0.1875000
NODE_7628_length_951_cov_19.413146	509	589	10	33	80	0.4125000
NODE_7628_length_951_cov_19.413146	830	877	0	47	47	1.0000000
NODE_7629_length_951_cov_18.970657	384	464	3	74	80	0.9250000
NODE_7629_length_951_cov_18.970657	384	464	5	6	80	0.0750000
NODE_7629_length_951_cov_18.970657	437	517	3	21	80	0.2625000
NODE_7629_length_951_cov_18.970657	437	517	4	10	80	0.1250000
NODE_7629_length_951_cov_18.970657	437	517	5	49	80	0.6125000
NODE_7629_length_951_cov_18.970657	513	593	2	60	80	0.7500000
NODE_7629_length_951_cov_18.970657	513	593	3	2	80	0.0250000
NODE_7629_length_951_cov_18.970657	513	593	4	18	80	0.2250000
NODE_7629_length_951_cov_18.970657	566	646	0	30	80	0.3750000
NODE_7629_length_951_cov_18.970657	566	646	2	50	80	0.6250000
NODE_7630_length_951_cov_17.164319	409	490	5	7	81	0.0864198
NODE_7630_length_951_cov_17.164319	409	490	6	2	81	0.0246914
NODE_7630_length_951_cov_17.164319	409	490	7	4	81	0.0493827
NODE_7630_length_951_cov_17.164319	409	490	8	42	81	0.5185185
NODE_7630_length_951_cov_17.164319	409	490	9	14	81	0.1728395
NODE_7630_length_951_cov_17.164319	409	490	10	12	81	0.1481481
NODE_7630_length_951_cov_17.164319	463	543	2	29	80	0.3625000
NODE_7630_length_951_cov_17.164319	463	543	3	15	80	0.1875000
NODE_7630_length_951_cov_17.164319	463	543	5	16	80	0.2000000
NODE_7630_length_951_cov_17.164319	463	543	6	2	80	0.0250000
NODE_7630_length_951_cov_17.164319	463	543	7	4	80	0.0500000
NODE_7630_length_951_cov_17.164319	463	543	8	14	80	0.1750000
NODE_7631_length_951_cov_17.009390	393	473	0	34	80	0.4250000
NODE_7631_length_951_cov_17.009390	393	473	3	46	80	0.5750000
NODE_7631_length_951_cov_17.009390	446	526	3	80	80	1.0000000
NODE_7632_length_951_cov_15.551643	520	600	3	3	80	0.0375000
NODE_7632_length_951_cov_15.551643	520	600	4	37	80	0.4625000
NODE_7632_length_951_cov_15.551643	520	600	5	40	80	0.5000000
NODE_7632_length_951_cov_15.551643	573	653	1	12	80	0.1500000
NODE_7632_length_951_cov_15.551643	573	653	3	44	80	0.5500000
NODE_7632_length_951_cov_15.551643	573	653	5	24	80	0.3000000
NODE_7633_length_951_cov_13.562207	364	444	5	34	80	0.4250000
NODE_7633_length_951_cov_13.562207	364	444	6	46	80	0.5750000
NODE_7633_length_951_cov_13.562207	417	497	2	11	80	0.1375000
NODE_7633_length_951_cov_13.562207	417	497	3	1	80	0.0125000
NODE_7633_length_951_cov_13.562207	417	497	4	26	80	0.3250000
NODE_7633_length_951_cov_13.562207	417	497	5	21	80	0.2625000
NODE_7633_length_951_cov_13.562207	417	497	6	21	80	0.2625000
NODE_7634_length_951_cov_13.086854	450	530	5	80	80	1.0000000
NODE_7634_length_951_cov_13.086854	503	583	0	26	80	0.3250000
NODE_7634_length_951_cov_13.086854	503	583	1	1	80	0.0125000
NODE_7634_length_951_cov_13.086854	503	583	3	7	80	0.0875000
NODE_7634_length_951_cov_13.086854	503	583	4	14	80	0.1750000
NODE_7634_length_951_cov_13.086854	503	583	5	32	80	0.4000000
NODE_7635_length_951_cov_6.812207	350	430	0	23	80	0.2875000
NODE_7635_length_951_cov_6.812207	350	430	2	27	80	0.3375000
NODE_7635_length_951_cov_6.812207	350	430	3	2	80	0.0250000
NODE_7635_length_951_cov_6.812207	350	430	5	28	80	0.3500000
NODE_7635_length_951_cov_6.812207	403	483	5	80	80	1.0000000
NODE_7636_length_951_cov_5.076291	80	160	2	80	80	1.0000000
NODE_7636_length_951_cov_5.076291	133	213	1	25	80	0.3125000
NODE_7636_length_951_cov_5.076291	133	213	2	55	80	0.6875000
NODE_7649_length_950_cov_62.151586	731	794	7	17	63	0.2698413
NODE_7649_length_950_cov_62.151586	731	794	8	8	63	0.1269841
NODE_7649_length_950_cov_62.151586	731	794	12	7	63	0.1111111
NODE_7649_length_950_cov_62.151586	731	794	14	3	63	0.0476190
NODE_7649_length_950_cov_62.151586	731	794	15	28	63	0.4444444
NODE_7650_length_950_cov_56.088132	354	434	19	14	80	0.1750000
NODE_7650_length_950_cov_56.088132	354	434	20	7	80	0.0875000
NODE_7650_length_950_cov_56.088132	354	434	21	16	80	0.2000000
NODE_7650_length_950_cov_56.088132	354	434	22	13	80	0.1625000
NODE_7650_length_950_cov_56.088132	354	434	24	3	80	0.0375000
NODE_7650_length_950_cov_56.088132	354	434	25	2	80	0.0250000
NODE_7650_length_950_cov_56.088132	354	434	26	6	80	0.0750000
NODE_7650_length_950_cov_56.088132	354	434	27	4	80	0.0500000
NODE_7650_length_950_cov_56.088132	354	434	29	3	80	0.0375000
NODE_7650_length_950_cov_56.088132	354	434	30	12	80	0.1500000
NODE_7650_length_950_cov_56.088132	407	487	24	22	80	0.2750000
NODE_7650_length_950_cov_56.088132	407	487	25	2	80	0.0250000
NODE_7650_length_950_cov_56.088132	407	487	26	18	80	0.2250000
NODE_7650_length_950_cov_56.088132	407	487	27	12	80	0.1500000
NODE_7650_length_950_cov_56.088132	407	487	28	4	80	0.0500000
NODE_7650_length_950_cov_56.088132	407	487	29	8	80	0.1000000
NODE_7650_length_950_cov_56.088132	407	487	30	14	80	0.1750000
NODE_7650_length_950_cov_56.088132	483	563	24	8	80	0.1000000
NODE_7650_length_950_cov_56.088132	483	563	25	3	80	0.0375000
NODE_7650_length_950_cov_56.088132	483	563	26	8	80	0.1000000
NODE_7650_length_950_cov_56.088132	483	563	27	4	80	0.0500000
NODE_7650_length_950_cov_56.088132	483	563	29	7	80	0.0875000
NODE_7650_length_950_cov_56.088132	483	563	31	1	80	0.0125000
NODE_7650_length_950_cov_56.088132	483	563	32	23	80	0.2875000
NODE_7650_length_950_cov_56.088132	483	563	33	11	80	0.1375000
NODE_7650_length_950_cov_56.088132	483	563	34	7	80	0.0875000
NODE_7650_length_950_cov_56.088132	483	563	35	8	80	0.1000000
NODE_7650_length_950_cov_56.088132	536	616	15	3	80	0.0375000
NODE_7650_length_950_cov_56.088132	536	616	16	4	80	0.0500000
NODE_7650_length_950_cov_56.088132	536	616	19	6	80	0.0750000
NODE_7650_length_950_cov_56.088132	536	616	20	9	80	0.1125000
NODE_7650_length_950_cov_56.088132	536	616	21	16	80	0.2000000
NODE_7650_length_950_cov_56.088132	536	616	22	9	80	0.1125000
NODE_7650_length_950_cov_56.088132	536	616	24	3	80	0.0375000
NODE_7650_length_950_cov_56.088132	536	616	25	6	80	0.0750000
NODE_7650_length_950_cov_56.088132	536	616	26	2	80	0.0250000
NODE_7650_length_950_cov_56.088132	536	616	27	3	80	0.0375000
NODE_7650_length_950_cov_56.088132	536	616	29	2	80	0.0250000
NODE_7650_length_950_cov_56.088132	536	616	32	13	80	0.1625000
NODE_7650_length_950_cov_56.088132	536	616	33	1	80	0.0125000
NODE_7650_length_950_cov_56.088132	536	616	34	3	80	0.0375000
NODE_7651_length_950_cov_29.780259	501	581	4	72	80	0.9000000
NODE_7651_length_950_cov_29.780259	501	581	6	8	80	0.1000000
NODE_7651_length_950_cov_29.780259	554	634	2	21	80	0.2625000
NODE_7651_length_950_cov_29.780259	554	634	4	59	80	0.7375000
NODE_7652_length_950_cov_27.278496	388	468	0	80	80	1.0000000
NODE_7652_length_950_cov_27.278496	441	519	0	78	78	1.0000000
NODE_7653_length_950_cov_26.766157	322	402	5	9	80	0.1125000
NODE_7653_length_950_cov_26.766157	322	402	6	2	80	0.0250000
NODE_7653_length_950_cov_26.766157	322	402	7	24	80	0.3000000
NODE_7653_length_950_cov_26.766157	322	402	9	5	80	0.0625000
NODE_7653_length_950_cov_26.766157	322	402	11	14	80	0.1750000
NODE_7653_length_950_cov_26.766157	322	402	13	26	80	0.3250000
NODE_7653_length_950_cov_26.766157	375	455	11	28	80	0.3500000
NODE_7653_length_950_cov_26.766157	375	455	13	52	80	0.6500000
NODE_7653_length_950_cov_26.766157	451	531	2	5	80	0.0625000
NODE_7653_length_950_cov_26.766157	451	531	4	14	80	0.1750000
NODE_7653_length_950_cov_26.766157	451	531	6	5	80	0.0625000
NODE_7653_length_950_cov_26.766157	451	531	8	15	80	0.1875000
NODE_7653_length_950_cov_26.766157	451	531	10	32	80	0.4000000
NODE_7653_length_950_cov_26.766157	451	531	11	9	80	0.1125000
NODE_7653_length_950_cov_26.766157	504	584	2	58	80	0.7250000
NODE_7653_length_950_cov_26.766157	504	584	4	14	80	0.1750000
NODE_7653_length_950_cov_26.766157	504	584	6	5	80	0.0625000
NODE_7653_length_950_cov_26.766157	504	584	8	3	80	0.0375000
NODE_7654_length_950_cov_19.638073	421	501	28	4	80	0.0500000
NODE_7654_length_950_cov_19.638073	421	501	29	18	80	0.2250000
NODE_7654_length_950_cov_19.638073	421	501	30	27	80	0.3375000
NODE_7654_length_950_cov_19.638073	421	501	31	8	80	0.1000000
NODE_7654_length_950_cov_19.638073	421	501	32	23	80	0.2875000
NODE_7654_length_950_cov_19.638073	474	554	28	23	80	0.2875000
NODE_7654_length_950_cov_19.638073	474	554	29	4	80	0.0500000
NODE_7654_length_950_cov_19.638073	474	554	30	4	80	0.0500000
NODE_7654_length_950_cov_19.638073	474	554	31	6	80	0.0750000
NODE_7654_length_950_cov_19.638073	474	554	32	43	80	0.5375000
NODE_7654_length_950_cov_19.638073	550	630	7	2	80	0.0250000
NODE_7654_length_950_cov_19.638073	550	630	8	19	80	0.2375000
NODE_7654_length_950_cov_19.638073	550	630	9	5	80	0.0625000
NODE_7654_length_950_cov_19.638073	550	630	10	29	80	0.3625000
NODE_7654_length_950_cov_19.638073	550	630	11	9	80	0.1125000
NODE_7654_length_950_cov_19.638073	550	630	22	3	80	0.0375000
NODE_7654_length_950_cov_19.638073	550	630	23	7	80	0.0875000
NODE_7654_length_950_cov_19.638073	550	630	28	6	80	0.0750000
NODE_7654_length_950_cov_19.638073	603	683	6	11	80	0.1375000
NODE_7654_length_950_cov_19.638073	603	683	7	44	80	0.5500000
NODE_7654_length_950_cov_19.638073	603	683	8	19	80	0.2375000
NODE_7654_length_950_cov_19.638073	603	683	10	6	80	0.0750000
NODE_7655_length_950_cov_14.686251	376	456	0	80	80	1.0000000
NODE_7655_length_950_cov_14.686251	429	509	0	80	80	1.0000000
NODE_7656_length_950_cov_14.215041	339	419	0	80	80	1.0000000
NODE_7656_length_950_cov_14.215041	392	472	0	80	80	1.0000000
NODE_7657_length_950_cov_6.397180	370	450	5	2	80	0.0250000
NODE_7657_length_950_cov_6.397180	370	450	7	8	80	0.1000000
NODE_7657_length_950_cov_6.397180	370	450	8	43	80	0.5375000
NODE_7657_length_950_cov_6.397180	370	450	10	24	80	0.3000000
NODE_7657_length_950_cov_6.397180	370	450	11	3	80	0.0375000
NODE_7657_length_950_cov_6.397180	423	504	8	9	81	0.1111111
NODE_7657_length_950_cov_6.397180	423	504	10	24	81	0.2962963
NODE_7657_length_950_cov_6.397180	423	504	11	48	81	0.5925926
NODE_7659_length_950_cov_4.430082	594	674	0	80	80	1.0000000
NODE_7659_length_950_cov_4.430082	647	727	0	80	80	1.0000000
NODE_7672_length_949_cov_25.550588	371	451	4	46	80	0.5750000
NODE_7672_length_949_cov_25.550588	371	451	5	33	80	0.4125000
NODE_7672_length_949_cov_25.550588	371	451	8	1	80	0.0125000
NODE_7672_length_949_cov_25.550588	500	580	13	36	80	0.4500000
NODE_7672_length_949_cov_25.550588	500	580	14	20	80	0.2500000
NODE_7672_length_949_cov_25.550588	500	580	15	9	80	0.1125000
NODE_7672_length_949_cov_25.550588	500	580	16	7	80	0.0875000
NODE_7672_length_949_cov_25.550588	500	580	17	8	80	0.1000000
NODE_7672_length_949_cov_25.550588	553	633	4	2	80	0.0250000
NODE_7672_length_949_cov_25.550588	553	633	5	1	80	0.0125000
NODE_7672_length_949_cov_25.550588	553	633	6	1	80	0.0125000
NODE_7672_length_949_cov_25.550588	553	633	9	1	80	0.0125000
NODE_7672_length_949_cov_25.550588	553	633	10	17	80	0.2125000
NODE_7672_length_949_cov_25.550588	553	633	11	11	80	0.1375000
NODE_7672_length_949_cov_25.550588	553	633	13	23	80	0.2875000
NODE_7672_length_949_cov_25.550588	553	633	14	11	80	0.1375000
NODE_7672_length_949_cov_25.550588	553	633	15	13	80	0.1625000
NODE_7673_length_949_cov_20.949412	252	332	10	21	80	0.2625000
NODE_7673_length_949_cov_20.949412	252	332	11	22	80	0.2750000
NODE_7673_length_949_cov_20.949412	252	332	13	1	80	0.0125000
NODE_7673_length_949_cov_20.949412	252	332	14	3	80	0.0375000
NODE_7673_length_949_cov_20.949412	252	332	16	23	80	0.2875000
NODE_7673_length_949_cov_20.949412	252	332	17	6	80	0.0750000
NODE_7673_length_949_cov_20.949412	252	332	18	4	80	0.0500000
NODE_7673_length_949_cov_20.949412	305	385	16	17	80	0.2125000
NODE_7673_length_949_cov_20.949412	305	385	17	19	80	0.2375000
NODE_7673_length_949_cov_20.949412	305	385	18	20	80	0.2500000
NODE_7673_length_949_cov_20.949412	305	385	21	19	80	0.2375000
NODE_7673_length_949_cov_20.949412	305	385	23	4	80	0.0500000
NODE_7673_length_949_cov_20.949412	305	385	24	1	80	0.0125000
NODE_7674_length_949_cov_20.601176	364	444	3	5	80	0.0625000
NODE_7674_length_949_cov_20.601176	364	444	5	75	80	0.9375000
NODE_7674_length_949_cov_20.601176	417	497	1	15	80	0.1875000
NODE_7674_length_949_cov_20.601176	417	497	3	43	80	0.5375000
NODE_7674_length_949_cov_20.601176	417	497	5	22	80	0.2750000
NODE_7674_length_949_cov_20.601176	493	573	0	25	80	0.3125000
NODE_7674_length_949_cov_20.601176	493	573	1	10	80	0.1250000
NODE_7674_length_949_cov_20.601176	493	573	2	14	80	0.1750000
NODE_7674_length_949_cov_20.601176	493	573	3	31	80	0.3875000
NODE_7674_length_949_cov_20.601176	546	626	3	80	80	1.0000000
NODE_7675_length_949_cov_20.575294	481	561	3	26	80	0.3250000
NODE_7675_length_949_cov_20.575294	481	561	4	46	80	0.5750000
NODE_7675_length_949_cov_20.575294	481	561	5	8	80	0.1000000
NODE_7675_length_949_cov_20.575294	534	614	2	24	80	0.3000000
NODE_7675_length_949_cov_20.575294	534	614	3	50	80	0.6250000
NODE_7675_length_949_cov_20.575294	534	614	4	6	80	0.0750000
NODE_7676_length_949_cov_19.483529	340	420	4	27	80	0.3375000
NODE_7676_length_949_cov_19.483529	340	420	5	7	80	0.0875000
NODE_7676_length_949_cov_19.483529	340	420	6	1	80	0.0125000
NODE_7676_length_949_cov_19.483529	340	420	9	40	80	0.5000000
NODE_7676_length_949_cov_19.483529	340	420	10	5	80	0.0625000
NODE_7676_length_949_cov_19.483529	393	473	6	16	80	0.2000000
NODE_7676_length_949_cov_19.483529	393	473	7	28	80	0.3500000
NODE_7676_length_949_cov_19.483529	393	473	8	1	80	0.0125000
NODE_7676_length_949_cov_19.483529	393	473	9	22	80	0.2750000
NODE_7676_length_949_cov_19.483529	393	473	10	13	80	0.1625000
NODE_7676_length_949_cov_19.483529	469	549	7	24	80	0.3000000
NODE_7676_length_949_cov_19.483529	469	549	8	10	80	0.1250000
NODE_7676_length_949_cov_19.483529	469	549	9	2	80	0.0250000
NODE_7676_length_949_cov_19.483529	469	549	10	38	80	0.4750000
NODE_7676_length_949_cov_19.483529	469	549	11	6	80	0.0750000
NODE_7676_length_949_cov_19.483529	522	602	7	58	80	0.7250000
NODE_7676_length_949_cov_19.483529	522	602	8	19	80	0.2375000
NODE_7676_length_949_cov_19.483529	522	602	10	2	80	0.0250000
NODE_7676_length_949_cov_19.483529	522	602	11	1	80	0.0125000
NODE_7677_length_949_cov_19.407059	433	513	0	80	80	1.0000000
NODE_7677_length_949_cov_19.407059	486	566	0	80	80	1.0000000
NODE_7677_length_949_cov_19.407059	562	642	0	80	80	1.0000000
NODE_7677_length_949_cov_19.407059	615	695	0	80	80	1.0000000
NODE_7678_length_949_cov_10.903529	561	641	1	13	80	0.1625000
NODE_7678_length_949_cov_10.903529	561	641	2	67	80	0.8375000
NODE_7678_length_949_cov_10.903529	614	694	0	35	80	0.4375000
NODE_7678_length_949_cov_10.903529	614	694	1	31	80	0.3875000
NODE_7678_length_949_cov_10.903529	614	694	2	14	80	0.1750000
NODE_7679_length_949_cov_7.245882	0	71	0	71	71	1.0000000
NODE_7679_length_949_cov_7.245882	0	71	0	71	71	1.0000000
NODE_7679_length_949_cov_7.245882	44	124	0	80	80	1.0000000
NODE_7680_length_949_cov_6.998824	494	574	1	7	80	0.0875000
NODE_7680_length_949_cov_6.998824	494	574	2	73	80	0.9125000
NODE_7680_length_949_cov_6.998824	547	627	0	33	80	0.4125000
NODE_7680_length_949_cov_6.998824	547	627	1	27	80	0.3375000
NODE_7680_length_949_cov_6.998824	547	627	2	20	80	0.2500000
NODE_7702_length_948_cov_37.201413	510	590	12	11	80	0.1375000
NODE_7702_length_948_cov_37.201413	510	590	14	11	80	0.1375000
NODE_7702_length_948_cov_37.201413	510	590	16	7	80	0.0875000
NODE_7702_length_948_cov_37.201413	510	590	23	19	80	0.2375000
NODE_7702_length_948_cov_37.201413	510	590	26	25	80	0.3125000
NODE_7702_length_948_cov_37.201413	510	590	29	7	80	0.0875000
NODE_7702_length_948_cov_37.201413	563	643	23	4	80	0.0500000
NODE_7702_length_948_cov_37.201413	563	643	25	20	80	0.2500000
NODE_7702_length_948_cov_37.201413	563	643	26	26	80	0.3250000
NODE_7702_length_948_cov_37.201413	563	643	27	8	80	0.1000000
NODE_7702_length_948_cov_37.201413	563	643	28	1	80	0.0125000
NODE_7702_length_948_cov_37.201413	563	643	29	21	80	0.2625000
NODE_7703_length_948_cov_20.082450	58	99	0	41	41	1.0000000
NODE_7703_length_948_cov_20.082450	113	193	8	1	80	0.0125000
NODE_7703_length_948_cov_20.082450	113	193	9	4	80	0.0500000
NODE_7703_length_948_cov_20.082450	113	193	10	2	80	0.0250000
NODE_7703_length_948_cov_20.082450	113	193	11	2	80	0.0250000
NODE_7703_length_948_cov_20.082450	113	193	12	8	80	0.1000000
NODE_7703_length_948_cov_20.082450	113	193	14	4	80	0.0500000
NODE_7703_length_948_cov_20.082450	113	193	15	2	80	0.0250000
NODE_7703_length_948_cov_20.082450	113	193	16	4	80	0.0500000
NODE_7703_length_948_cov_20.082450	113	193	17	7	80	0.0875000
NODE_7703_length_948_cov_20.082450	113	193	21	4	80	0.0500000
NODE_7703_length_948_cov_20.082450	113	193	23	2	80	0.0250000
NODE_7703_length_948_cov_20.082450	113	193	24	21	80	0.2625000
NODE_7703_length_948_cov_20.082450	113	193	25	10	80	0.1250000
NODE_7703_length_948_cov_20.082450	113	193	26	7	80	0.0875000
NODE_7703_length_948_cov_20.082450	113	193	27	2	80	0.0250000
NODE_7703_length_948_cov_20.082450	166	246	23	1	80	0.0125000
NODE_7703_length_948_cov_20.082450	166	246	24	8	80	0.1000000
NODE_7703_length_948_cov_20.082450	166	246	25	11	80	0.1375000
NODE_7703_length_948_cov_20.082450	166	246	26	39	80	0.4875000
NODE_7703_length_948_cov_20.082450	166	246	27	21	80	0.2625000
NODE_7704_length_948_cov_16.785630	308	388	3	2	80	0.0250000
NODE_7704_length_948_cov_16.785630	308	388	4	71	80	0.8875000
NODE_7704_length_948_cov_16.785630	308	388	5	7	80	0.0875000
NODE_7704_length_948_cov_16.785630	361	441	2	9	80	0.1125000
NODE_7704_length_948_cov_16.785630	361	441	3	36	80	0.4500000
NODE_7704_length_948_cov_16.785630	361	441	4	20	80	0.2500000
NODE_7704_length_948_cov_16.785630	361	441	5	15	80	0.1875000
NODE_7704_length_948_cov_16.785630	437	517	2	60	80	0.7500000
NODE_7704_length_948_cov_16.785630	437	517	3	20	80	0.2500000
NODE_7704_length_948_cov_16.785630	490	570	1	39	80	0.4875000
NODE_7704_length_948_cov_16.785630	490	570	2	30	80	0.3750000
NODE_7704_length_948_cov_16.785630	490	570	3	11	80	0.1375000
NODE_7705_length_948_cov_12.740872	400	480	1	28	80	0.3500000
NODE_7705_length_948_cov_12.740872	400	480	2	52	80	0.6500000
NODE_7705_length_948_cov_12.740872	453	533	1	8	80	0.1000000
NODE_7705_length_948_cov_12.740872	453	533	2	72	80	0.9000000
NODE_7706_length_948_cov_10.220259	465	545	3	7	80	0.0875000
NODE_7706_length_948_cov_10.220259	465	545	4	5	80	0.0625000
NODE_7706_length_948_cov_10.220259	465	545	5	10	80	0.1250000
NODE_7706_length_948_cov_10.220259	465	545	6	6	80	0.0750000
NODE_7706_length_948_cov_10.220259	465	545	7	1	80	0.0125000
NODE_7706_length_948_cov_10.220259	465	545	8	51	80	0.6375000
NODE_7706_length_948_cov_10.220259	518	598	7	20	80	0.2500000
NODE_7706_length_948_cov_10.220259	518	598	8	60	80	0.7500000
NODE_7707_length_948_cov_8.504122	456	536	5	78	80	0.9750000
NODE_7707_length_948_cov_8.504122	456	536	7	2	80	0.0250000
NODE_7707_length_948_cov_8.504122	509	589	5	48	80	0.6000000
NODE_7707_length_948_cov_8.504122	509	589	6	17	80	0.2125000
NODE_7707_length_948_cov_8.504122	509	589	7	15	80	0.1875000
NODE_7709_length_948_cov_5.425206	641	721	2	27	80	0.3375000
NODE_7709_length_948_cov_5.425206	641	721	3	53	80	0.6625000
NODE_7709_length_948_cov_5.425206	694	774	2	51	80	0.6375000
NODE_7709_length_948_cov_5.425206	694	774	3	29	80	0.3625000
NODE_7711_length_948_cov_3.586572	696	776	0	80	80	1.0000000
NODE_7715_length_948_cov_2.786808	259	324	0	65	65	1.0000000
NODE_7715_length_948_cov_2.786808	297	377	0	80	80	1.0000000
NODE_7721_length_947_cov_91.466981	393	473	16	2	80	0.0250000
NODE_7721_length_947_cov_91.466981	393	473	17	16	80	0.2000000
NODE_7721_length_947_cov_91.466981	393	473	18	20	80	0.2500000
NODE_7721_length_947_cov_91.466981	393	473	19	2	80	0.0250000
NODE_7721_length_947_cov_91.466981	393	473	20	3	80	0.0375000
NODE_7721_length_947_cov_91.466981	393	473	21	7	80	0.0875000
NODE_7721_length_947_cov_91.466981	393	473	22	12	80	0.1500000
NODE_7721_length_947_cov_91.466981	393	473	23	1	80	0.0125000
NODE_7721_length_947_cov_91.466981	393	473	26	12	80	0.1500000
NODE_7721_length_947_cov_91.466981	393	473	27	5	80	0.0625000
NODE_7721_length_947_cov_91.466981	446	526	19	7	80	0.0875000
NODE_7721_length_947_cov_91.466981	446	526	20	8	80	0.1000000
NODE_7721_length_947_cov_91.466981	446	526	21	22	80	0.2750000
NODE_7721_length_947_cov_91.466981	446	526	22	16	80	0.2000000
NODE_7721_length_947_cov_91.466981	446	526	23	1	80	0.0125000
NODE_7721_length_947_cov_91.466981	446	526	25	1	80	0.0125000
NODE_7721_length_947_cov_91.466981	446	526	26	18	80	0.2250000
NODE_7721_length_947_cov_91.466981	446	526	27	7	80	0.0875000
NODE_7722_length_947_cov_61.139151	402	482	26	14	80	0.1750000
NODE_7722_length_947_cov_61.139151	402	482	30	2	80	0.0250000
NODE_7722_length_947_cov_61.139151	402	482	31	7	80	0.0875000
NODE_7722_length_947_cov_61.139151	402	482	32	21	80	0.2625000
NODE_7722_length_947_cov_61.139151	402	482	33	7	80	0.0875000
NODE_7722_length_947_cov_61.139151	402	482	34	1	80	0.0125000
NODE_7722_length_947_cov_61.139151	402	482	35	28	80	0.3500000
NODE_7722_length_947_cov_61.139151	455	535	15	9	80	0.1125000
NODE_7722_length_947_cov_61.139151	455	535	16	7	80	0.0875000
NODE_7722_length_947_cov_61.139151	455	535	21	13	80	0.1625000
NODE_7722_length_947_cov_61.139151	455	535	22	4	80	0.0500000
NODE_7722_length_947_cov_61.139151	455	535	25	4	80	0.0500000
NODE_7722_length_947_cov_61.139151	455	535	26	6	80	0.0750000
NODE_7722_length_947_cov_61.139151	455	535	29	3	80	0.0375000
NODE_7722_length_947_cov_61.139151	455	535	30	4	80	0.0500000
NODE_7722_length_947_cov_61.139151	455	535	31	12	80	0.1500000
NODE_7722_length_947_cov_61.139151	455	535	32	13	80	0.1625000
NODE_7722_length_947_cov_61.139151	455	535	33	5	80	0.0625000
NODE_7723_length_947_cov_50.009434	488	568	1	33	80	0.4125000
NODE_7723_length_947_cov_50.009434	488	568	4	2	80	0.0250000
NODE_7723_length_947_cov_50.009434	488	568	5	23	80	0.2875000
NODE_7723_length_947_cov_50.009434	488	568	6	22	80	0.2750000
NODE_7723_length_947_cov_50.009434	541	621	5	5	80	0.0625000
NODE_7723_length_947_cov_50.009434	541	621	6	67	80	0.8375000
NODE_7723_length_947_cov_50.009434	541	621	7	8	80	0.1000000
NODE_7724_length_947_cov_36.271226	511	591	9	31	80	0.3875000
NODE_7724_length_947_cov_36.271226	511	591	10	4	80	0.0500000
NODE_7724_length_947_cov_36.271226	511	591	11	7	80	0.0875000
NODE_7724_length_947_cov_36.271226	511	591	12	38	80	0.4750000
NODE_7724_length_947_cov_36.271226	564	644	5	2	80	0.0250000
NODE_7724_length_947_cov_36.271226	564	644	7	31	80	0.3875000
NODE_7724_length_947_cov_36.271226	564	644	8	2	80	0.0250000
NODE_7724_length_947_cov_36.271226	564	644	9	45	80	0.5625000
NODE_7725_length_947_cov_23.384434	425	505	2	10	80	0.1250000
NODE_7725_length_947_cov_23.384434	425	505	4	17	80	0.2125000
NODE_7725_length_947_cov_23.384434	425	505	5	17	80	0.2125000
NODE_7725_length_947_cov_23.384434	425	505	6	36	80	0.4500000
NODE_7725_length_947_cov_23.384434	478	558	0	18	80	0.2250000
NODE_7725_length_947_cov_23.384434	478	558	2	45	80	0.5625000
NODE_7725_length_947_cov_23.384434	478	558	4	17	80	0.2125000
NODE_7726_length_947_cov_19.103774	316	396	9	47	80	0.5875000
NODE_7726_length_947_cov_19.103774	316	396	11	33	80	0.4125000
NODE_7726_length_947_cov_19.103774	369	449	2	1	80	0.0125000
NODE_7726_length_947_cov_19.103774	369	449	5	3	80	0.0375000
NODE_7726_length_947_cov_19.103774	369	449	7	6	80	0.0750000
NODE_7726_length_947_cov_19.103774	369	449	8	14	80	0.1750000
NODE_7726_length_947_cov_19.103774	369	449	9	56	80	0.7000000
NODE_7727_length_947_cov_18.853774	516	596	0	80	80	1.0000000
NODE_7727_length_947_cov_18.853774	569	649	0	80	80	1.0000000
NODE_7728_length_947_cov_18.077830	315	395	6	9	80	0.1125000
NODE_7728_length_947_cov_18.077830	315	395	7	1	80	0.0125000
NODE_7728_length_947_cov_18.077830	315	395	8	7	80	0.0875000
NODE_7728_length_947_cov_18.077830	315	395	11	50	80	0.6250000
NODE_7728_length_947_cov_18.077830	315	395	12	13	80	0.1625000
NODE_7728_length_947_cov_18.077830	368	448	6	1	80	0.0125000
NODE_7728_length_947_cov_18.077830	368	448	7	4	80	0.0500000
NODE_7728_length_947_cov_18.077830	368	448	9	7	80	0.0875000
NODE_7728_length_947_cov_18.077830	368	448	11	55	80	0.6875000
NODE_7728_length_947_cov_18.077830	368	448	12	13	80	0.1625000
NODE_7729_length_947_cov_17.713443	403	483	0	80	80	1.0000000
NODE_7729_length_947_cov_17.713443	456	536	0	80	80	1.0000000
NODE_7730_length_947_cov_14.492925	358	438	0	7	80	0.0875000
NODE_7730_length_947_cov_14.492925	358	438	1	53	80	0.6625000
NODE_7730_length_947_cov_14.492925	358	438	2	20	80	0.2500000
NODE_7730_length_947_cov_14.492925	411	491	1	35	80	0.4375000
NODE_7730_length_947_cov_14.492925	411	491	2	20	80	0.2500000
NODE_7730_length_947_cov_14.492925	411	491	3	10	80	0.1250000
NODE_7730_length_947_cov_14.492925	411	491	5	15	80	0.1875000
NODE_7730_length_947_cov_14.492925	487	567	4	15	80	0.1875000
NODE_7730_length_947_cov_14.492925	487	567	5	65	80	0.8125000
NODE_7730_length_947_cov_14.492925	540	620	2	4	80	0.0500000
NODE_7730_length_947_cov_14.492925	540	620	3	20	80	0.2500000
NODE_7730_length_947_cov_14.492925	540	620	4	44	80	0.5500000
NODE_7730_length_947_cov_14.492925	540	620	5	12	80	0.1500000
NODE_7731_length_947_cov_10.573113	550	630	4	4	80	0.0500000
NODE_7731_length_947_cov_10.573113	550	630	5	18	80	0.2250000
NODE_7731_length_947_cov_10.573113	550	630	6	58	80	0.7250000
NODE_7731_length_947_cov_10.573113	603	683	2	5	80	0.0625000
NODE_7731_length_947_cov_10.573113	603	683	3	32	80	0.4000000
NODE_7731_length_947_cov_10.573113	603	683	5	34	80	0.4250000
NODE_7731_length_947_cov_10.573113	603	683	6	9	80	0.1125000
NODE_7732_length_947_cov_7.762972	550	630	0	80	80	1.0000000
NODE_7732_length_947_cov_7.762972	607	683	0	76	76	1.0000000
NODE_7747_length_946_cov_39.726092	378	458	3	10	80	0.1250000
NODE_7747_length_946_cov_39.726092	378	458	4	17	80	0.2125000
NODE_7747_length_946_cov_39.726092	378	458	5	30	80	0.3750000
NODE_7747_length_946_cov_39.726092	378	458	6	23	80	0.2875000
NODE_7747_length_946_cov_39.726092	431	511	4	13	80	0.1625000
NODE_7747_length_946_cov_39.726092	431	511	5	5	80	0.0625000
NODE_7747_length_946_cov_39.726092	431	511	6	17	80	0.2125000
NODE_7747_length_946_cov_39.726092	431	511	7	7	80	0.0875000
NODE_7747_length_946_cov_39.726092	431	511	8	1	80	0.0125000
NODE_7747_length_946_cov_39.726092	431	511	9	1	80	0.0125000
NODE_7747_length_946_cov_39.726092	431	511	11	14	80	0.1750000
NODE_7747_length_946_cov_39.726092	431	511	12	22	80	0.2750000
NODE_7747_length_946_cov_39.726092	507	587	11	7	80	0.0875000
NODE_7747_length_946_cov_39.726092	507	587	12	18	80	0.2250000
NODE_7747_length_946_cov_39.726092	507	587	13	7	80	0.0875000
NODE_7747_length_946_cov_39.726092	507	587	14	30	80	0.3750000
NODE_7747_length_946_cov_39.726092	507	587	17	18	80	0.2250000
NODE_7747_length_946_cov_39.726092	560	640	8	1	80	0.0125000
NODE_7747_length_946_cov_39.726092	560	640	9	14	80	0.1750000
NODE_7747_length_946_cov_39.726092	560	640	11	1	80	0.0125000
NODE_7747_length_946_cov_39.726092	560	640	13	3	80	0.0375000
NODE_7747_length_946_cov_39.726092	560	640	14	14	80	0.1750000
NODE_7747_length_946_cov_39.726092	560	640	15	14	80	0.1750000
NODE_7747_length_946_cov_39.726092	560	640	17	33	80	0.4125000
NODE_7748_length_946_cov_32.728453	404	484	1	44	80	0.5500000
NODE_7748_length_946_cov_32.728453	404	484	2	36	80	0.4500000
NODE_7748_length_946_cov_32.728453	457	537	1	45	80	0.5625000
NODE_7748_length_946_cov_32.728453	457	537	2	35	80	0.4375000
NODE_7749_length_946_cov_27.548996	280	360	11	10	80	0.1250000
NODE_7749_length_946_cov_27.548996	280	360	12	6	80	0.0750000
NODE_7749_length_946_cov_27.548996	280	360	14	2	80	0.0250000
NODE_7749_length_946_cov_27.548996	280	360	15	2	80	0.0250000
NODE_7749_length_946_cov_27.548996	280	360	16	15	80	0.1875000
NODE_7749_length_946_cov_27.548996	280	360	18	41	80	0.5125000
NODE_7749_length_946_cov_27.548996	280	360	20	4	80	0.0500000
NODE_7749_length_946_cov_27.548996	333	413	11	20	80	0.2500000
NODE_7749_length_946_cov_27.548996	333	413	14	1	80	0.0125000
NODE_7749_length_946_cov_27.548996	333	413	15	4	80	0.0500000
NODE_7749_length_946_cov_27.548996	333	413	16	2	80	0.0250000
NODE_7749_length_946_cov_27.548996	333	413	17	21	80	0.2625000
NODE_7749_length_946_cov_27.548996	333	413	18	28	80	0.3500000
NODE_7749_length_946_cov_27.548996	333	413	20	4	80	0.0500000
NODE_7750_length_946_cov_24.622196	352	432	37	8	80	0.1000000
NODE_7750_length_946_cov_24.622196	352	432	38	30	80	0.3750000
NODE_7750_length_946_cov_24.622196	352	432	51	13	80	0.1625000
NODE_7750_length_946_cov_24.622196	352	432	52	10	80	0.1250000
NODE_7750_length_946_cov_24.622196	352	432	53	19	80	0.2375000
NODE_7750_length_946_cov_24.622196	405	486	26	1	81	0.0123457
NODE_7750_length_946_cov_24.622196	405	486	27	4	81	0.0493827
NODE_7750_length_946_cov_24.622196	405	486	29	4	81	0.0493827
NODE_7750_length_946_cov_24.622196	405	486	31	9	81	0.1111111
NODE_7750_length_946_cov_24.622196	405	486	48	1	81	0.0123457
NODE_7750_length_946_cov_24.622196	405	486	50	14	81	0.1728395
NODE_7750_length_946_cov_24.622196	405	486	51	34	81	0.4197531
NODE_7750_length_946_cov_24.622196	405	486	53	14	81	0.1728395
NODE_7751_length_946_cov_18.082645	492	572	6	6	80	0.0750000
NODE_7751_length_946_cov_18.082645	492	572	7	3	80	0.0375000
NODE_7751_length_946_cov_18.082645	492	572	8	5	80	0.0625000
NODE_7751_length_946_cov_18.082645	492	572	9	18	80	0.2250000
NODE_7751_length_946_cov_18.082645	492	572	10	13	80	0.1625000
NODE_7751_length_946_cov_18.082645	492	572	11	35	80	0.4375000
NODE_7751_length_946_cov_18.082645	545	625	10	4	80	0.0500000
NODE_7751_length_946_cov_18.082645	545	625	11	44	80	0.5500000
NODE_7751_length_946_cov_18.082645	545	625	12	14	80	0.1750000
NODE_7751_length_946_cov_18.082645	545	625	13	18	80	0.2250000
NODE_7752_length_946_cov_18.031877	433	513	0	14	80	0.1750000
NODE_7752_length_946_cov_18.031877	433	513	2	66	80	0.8250000
NODE_7752_length_946_cov_18.031877	486	566	2	68	80	0.8500000
NODE_7752_length_946_cov_18.031877	486	566	4	12	80	0.1500000
NODE_7753_length_946_cov_15.188902	472	552	0	1	80	0.0125000
NODE_7753_length_946_cov_15.188902	472	552	1	52	80	0.6500000
NODE_7753_length_946_cov_15.188902	472	552	2	27	80	0.3375000
NODE_7753_length_946_cov_15.188902	525	605	0	54	80	0.6750000
NODE_7753_length_946_cov_15.188902	525	605	1	26	80	0.3250000
NODE_7754_length_946_cov_11.201889	408	488	0	80	80	1.0000000
NODE_7754_length_946_cov_11.201889	461	541	0	80	80	1.0000000
NODE_7768_length_945_cov_42.997636	361	441	3	27	80	0.3375000
NODE_7768_length_945_cov_42.997636	361	441	4	53	80	0.6625000
NODE_7768_length_945_cov_42.997636	414	494	2	37	80	0.4625000
NODE_7768_length_945_cov_42.997636	414	494	3	43	80	0.5375000
NODE_7769_length_945_cov_31.223404	357	437	23	12	80	0.1500000
NODE_7769_length_945_cov_31.223404	357	437	25	3	80	0.0375000
NODE_7769_length_945_cov_31.223404	357	437	27	8	80	0.1000000
NODE_7769_length_945_cov_31.223404	357	437	28	8	80	0.1000000
NODE_7769_length_945_cov_31.223404	357	437	29	16	80	0.2000000
NODE_7769_length_945_cov_31.223404	357	437	31	21	80	0.2625000
NODE_7769_length_945_cov_31.223404	357	437	33	11	80	0.1375000
NODE_7769_length_945_cov_31.223404	357	437	36	1	80	0.0125000
NODE_7769_length_945_cov_31.223404	410	490	26	12	80	0.1500000
NODE_7769_length_945_cov_31.223404	410	490	31	21	80	0.2625000
NODE_7769_length_945_cov_31.223404	410	490	32	1	80	0.0125000
NODE_7769_length_945_cov_31.223404	410	490	33	11	80	0.1375000
NODE_7769_length_945_cov_31.223404	410	490	34	7	80	0.0875000
NODE_7769_length_945_cov_31.223404	410	490	35	8	80	0.1000000
NODE_7769_length_945_cov_31.223404	410	490	36	5	80	0.0625000
NODE_7769_length_945_cov_31.223404	410	490	38	10	80	0.1250000
NODE_7769_length_945_cov_31.223404	410	490	39	5	80	0.0625000
NODE_7770_length_945_cov_26.348700	331	411	10	2	80	0.0250000
NODE_7770_length_945_cov_26.348700	331	411	11	12	80	0.1500000
NODE_7770_length_945_cov_26.348700	331	411	12	21	80	0.2625000
NODE_7770_length_945_cov_26.348700	331	411	13	28	80	0.3500000
NODE_7770_length_945_cov_26.348700	331	411	14	17	80	0.2125000
NODE_7770_length_945_cov_26.348700	384	464	10	2	80	0.0250000
NODE_7770_length_945_cov_26.348700	384	464	11	1	80	0.0125000
NODE_7770_length_945_cov_26.348700	384	464	12	45	80	0.5625000
NODE_7770_length_945_cov_26.348700	384	464	13	22	80	0.2750000
NODE_7770_length_945_cov_26.348700	384	464	14	10	80	0.1250000
NODE_7771_length_945_cov_20.349882	435	515	11	8	80	0.1000000
NODE_7771_length_945_cov_20.349882	435	515	13	22	80	0.2750000
NODE_7771_length_945_cov_20.349882	435	515	14	26	80	0.3250000
NODE_7771_length_945_cov_20.349882	435	515	15	13	80	0.1625000
NODE_7771_length_945_cov_20.349882	435	515	16	5	80	0.0625000
NODE_7771_length_945_cov_20.349882	435	515	17	6	80	0.0750000
NODE_7771_length_945_cov_20.349882	488	568	12	14	80	0.1750000
NODE_7771_length_945_cov_20.349882	488	568	13	2	80	0.0250000
NODE_7771_length_945_cov_20.349882	488	568	14	8	80	0.1000000
NODE_7771_length_945_cov_20.349882	488	568	15	30	80	0.3750000
NODE_7771_length_945_cov_20.349882	488	568	16	20	80	0.2500000
NODE_7771_length_945_cov_20.349882	488	568	17	6	80	0.0750000
NODE_7772_length_945_cov_14.771868	386	466	14	42	80	0.5250000
NODE_7772_length_945_cov_14.771868	386	466	21	2	80	0.0250000
NODE_7772_length_945_cov_14.771868	386	466	22	24	80	0.3000000
NODE_7772_length_945_cov_14.771868	386	466	23	12	80	0.1500000
NODE_7772_length_945_cov_14.771868	439	519	18	5	80	0.0625000
NODE_7772_length_945_cov_14.771868	439	519	20	23	80	0.2875000
NODE_7772_length_945_cov_14.771868	439	519	21	9	80	0.1125000
NODE_7772_length_945_cov_14.771868	439	519	22	24	80	0.3000000
NODE_7772_length_945_cov_14.771868	439	519	23	1	80	0.0125000
NODE_7772_length_945_cov_14.771868	439	519	25	6	80	0.0750000
NODE_7772_length_945_cov_14.771868	439	519	26	4	80	0.0500000
NODE_7772_length_945_cov_14.771868	439	519	28	8	80	0.1000000
NODE_7773_length_945_cov_10.158392	599	679	2	19	80	0.2375000
NODE_7773_length_945_cov_10.158392	599	679	3	22	80	0.2750000
NODE_7773_length_945_cov_10.158392	599	679	4	39	80	0.4875000
NODE_7773_length_945_cov_10.158392	652	732	3	48	80	0.6000000
NODE_7773_length_945_cov_10.158392	652	732	4	20	80	0.2500000
NODE_7773_length_945_cov_10.158392	652	732	5	12	80	0.1500000
NODE_7775_length_945_cov_5.403073	357	437	0	80	80	1.0000000
NODE_7775_length_945_cov_5.403073	410	490	0	41	80	0.5125000
NODE_7775_length_945_cov_5.403073	410	490	1	12	80	0.1500000
NODE_7775_length_945_cov_5.403073	410	490	2	27	80	0.3375000
NODE_7785_length_944_cov_42.401183	358	438	4	7	80	0.0875000
NODE_7785_length_944_cov_42.401183	358	438	5	5	80	0.0625000
NODE_7785_length_944_cov_42.401183	358	438	6	5	80	0.0625000
NODE_7785_length_944_cov_42.401183	358	438	7	1	80	0.0125000
NODE_7785_length_944_cov_42.401183	358	438	10	6	80	0.0750000
NODE_7785_length_944_cov_42.401183	358	438	11	10	80	0.1250000
NODE_7785_length_944_cov_42.401183	358	438	12	5	80	0.0625000
NODE_7785_length_944_cov_42.401183	358	438	13	2	80	0.0250000
NODE_7785_length_944_cov_42.401183	358	438	14	2	80	0.0250000
NODE_7785_length_944_cov_42.401183	358	438	15	13	80	0.1625000
NODE_7785_length_944_cov_42.401183	358	438	16	5	80	0.0625000
NODE_7785_length_944_cov_42.401183	358	438	17	6	80	0.0750000
NODE_7785_length_944_cov_42.401183	358	438	19	13	80	0.1625000
NODE_7785_length_944_cov_42.401183	411	498	15	3	87	0.0344828
NODE_7785_length_944_cov_42.401183	411	498	16	5	87	0.0574713
NODE_7785_length_944_cov_42.401183	411	498	17	6	87	0.0689655
NODE_7785_length_944_cov_42.401183	411	498	19	22	87	0.2528736
NODE_7785_length_944_cov_42.401183	411	498	20	9	87	0.1034483
NODE_7785_length_944_cov_42.401183	411	498	21	7	87	0.0804598
NODE_7785_length_944_cov_42.401183	411	498	22	15	87	0.1724138
NODE_7785_length_944_cov_42.401183	411	498	24	19	87	0.2183908
NODE_7785_length_944_cov_42.401183	411	498	25	1	87	0.0114943
NODE_7786_length_944_cov_32.712426	377	457	6	7	80	0.0875000
NODE_7786_length_944_cov_32.712426	377	457	8	6	80	0.0750000
NODE_7786_length_944_cov_32.712426	377	457	9	52	80	0.6500000
NODE_7786_length_944_cov_32.712426	377	457	10	4	80	0.0500000
NODE_7786_length_944_cov_32.712426	377	457	11	3	80	0.0375000
NODE_7786_length_944_cov_32.712426	377	457	12	8	80	0.1000000
NODE_7786_length_944_cov_32.712426	430	510	4	27	80	0.3375000
NODE_7786_length_944_cov_32.712426	430	510	6	33	80	0.4125000
NODE_7786_length_944_cov_32.712426	430	510	9	16	80	0.2000000
NODE_7786_length_944_cov_32.712426	430	510	10	4	80	0.0500000
NODE_7787_length_944_cov_27.839053	417	497	5	5	80	0.0625000
NODE_7787_length_944_cov_27.839053	417	497	6	30	80	0.3750000
NODE_7787_length_944_cov_27.839053	417	497	9	9	80	0.1125000
NODE_7787_length_944_cov_27.839053	417	497	10	7	80	0.0875000
NODE_7787_length_944_cov_27.839053	417	497	11	10	80	0.1250000
NODE_7787_length_944_cov_27.839053	417	497	13	19	80	0.2375000
NODE_7787_length_944_cov_27.839053	470	550	8	9	80	0.1125000
NODE_7787_length_944_cov_27.839053	470	550	10	36	80	0.4500000
NODE_7787_length_944_cov_27.839053	470	550	11	9	80	0.1125000
NODE_7787_length_944_cov_27.839053	470	550	12	1	80	0.0125000
NODE_7787_length_944_cov_27.839053	470	550	13	25	80	0.3125000
NODE_7788_length_944_cov_24.702959	413	493	2	8	80	0.1000000
NODE_7788_length_944_cov_24.702959	413	493	4	25	80	0.3125000
NODE_7788_length_944_cov_24.702959	413	493	5	1	80	0.0125000
NODE_7788_length_944_cov_24.702959	413	493	7	30	80	0.3750000
NODE_7788_length_944_cov_24.702959	413	493	8	4	80	0.0500000
NODE_7788_length_944_cov_24.702959	413	493	9	12	80	0.1500000
NODE_7788_length_944_cov_24.702959	466	546	7	11	80	0.1375000
NODE_7788_length_944_cov_24.702959	466	546	8	50	80	0.6250000
NODE_7788_length_944_cov_24.702959	466	546	9	19	80	0.2375000
NODE_7789_length_944_cov_11.951479	347	427	6	24	80	0.3000000
NODE_7789_length_944_cov_11.951479	347	427	7	14	80	0.1750000
NODE_7789_length_944_cov_11.951479	347	427	8	8	80	0.1000000
NODE_7789_length_944_cov_11.951479	347	427	9	10	80	0.1250000
NODE_7789_length_944_cov_11.951479	347	427	10	23	80	0.2875000
NODE_7789_length_944_cov_11.951479	347	427	13	1	80	0.0125000
NODE_7789_length_944_cov_11.951479	400	480	9	3	80	0.0375000
NODE_7789_length_944_cov_11.951479	400	480	10	35	80	0.4375000
NODE_7789_length_944_cov_11.951479	400	480	11	29	80	0.3625000
NODE_7789_length_944_cov_11.951479	400	480	13	8	80	0.1000000
NODE_7789_length_944_cov_11.951479	400	480	14	5	80	0.0625000
NODE_7789_length_944_cov_11.951479	476	556	9	4	80	0.0500000
NODE_7789_length_944_cov_11.951479	476	556	10	43	80	0.5375000
NODE_7789_length_944_cov_11.951479	476	556	11	9	80	0.1125000
NODE_7789_length_944_cov_11.951479	476	556	12	7	80	0.0875000
NODE_7789_length_944_cov_11.951479	476	556	13	15	80	0.1875000
NODE_7789_length_944_cov_11.951479	476	556	14	2	80	0.0250000
NODE_7789_length_944_cov_11.951479	529	609	8	25	80	0.3125000
NODE_7789_length_944_cov_11.951479	529	609	9	6	80	0.0750000
NODE_7789_length_944_cov_11.951479	529	609	10	2	80	0.0250000
NODE_7789_length_944_cov_11.951479	529	609	11	8	80	0.1000000
NODE_7789_length_944_cov_11.951479	529	609	12	8	80	0.1000000
NODE_7789_length_944_cov_11.951479	529	609	13	29	80	0.3625000
NODE_7789_length_944_cov_11.951479	529	609	14	2	80	0.0250000
NODE_7790_length_944_cov_6.745562	366	446	0	54	80	0.6750000
NODE_7790_length_944_cov_6.745562	366	446	2	26	80	0.3250000
NODE_7790_length_944_cov_6.745562	419	499	0	1	80	0.0125000
NODE_7790_length_944_cov_6.745562	419	499	2	79	80	0.9875000
NODE_7792_length_944_cov_4.420118	236	316	2	80	80	1.0000000
NODE_7792_length_944_cov_4.420118	289	369	0	29	80	0.3625000
NODE_7792_length_944_cov_4.420118	289	369	2	51	80	0.6375000
NODE_7800_length_943_cov_40.111374	536	614	23	17	78	0.2179487
NODE_7800_length_943_cov_40.111374	536	614	29	9	78	0.1153846
NODE_7800_length_943_cov_40.111374	536	614	30	1	78	0.0128205
NODE_7800_length_943_cov_40.111374	536	614	32	11	78	0.1410256
NODE_7800_length_943_cov_40.111374	536	614	33	16	78	0.2051282
NODE_7800_length_943_cov_40.111374	536	614	35	1	78	0.0128205
NODE_7800_length_943_cov_40.111374	536	614	36	1	78	0.0128205
NODE_7800_length_943_cov_40.111374	536	614	37	4	78	0.0512821
NODE_7800_length_943_cov_40.111374	536	614	38	13	78	0.1666667
NODE_7800_length_943_cov_40.111374	536	614	39	5	78	0.0641026
NODE_7800_length_943_cov_40.111374	587	667	19	8	80	0.1000000
NODE_7800_length_943_cov_40.111374	587	667	20	3	80	0.0375000
NODE_7800_length_943_cov_40.111374	587	667	21	8	80	0.1000000
NODE_7800_length_943_cov_40.111374	587	667	22	2	80	0.0250000
NODE_7800_length_943_cov_40.111374	587	667	23	27	80	0.3375000
NODE_7800_length_943_cov_40.111374	587	667	24	3	80	0.0375000
NODE_7800_length_943_cov_40.111374	587	667	26	1	80	0.0125000
NODE_7800_length_943_cov_40.111374	587	667	28	18	80	0.2250000
NODE_7800_length_943_cov_40.111374	587	667	30	1	80	0.0125000
NODE_7800_length_943_cov_40.111374	587	667	32	9	80	0.1125000
NODE_7801_length_943_cov_29.446682	338	418	0	54	80	0.6750000
NODE_7801_length_943_cov_29.446682	338	418	1	3	80	0.0375000
NODE_7801_length_943_cov_29.446682	338	418	3	23	80	0.2875000
NODE_7801_length_943_cov_29.446682	391	471	0	1	80	0.0125000
NODE_7801_length_943_cov_29.446682	391	471	1	3	80	0.0375000
NODE_7801_length_943_cov_29.446682	391	471	3	76	80	0.9500000
NODE_7802_length_943_cov_28.289100	393	473	7	9	80	0.1125000
NODE_7802_length_943_cov_28.289100	393	473	8	51	80	0.6375000
NODE_7802_length_943_cov_28.289100	393	473	9	6	80	0.0750000
NODE_7802_length_943_cov_28.289100	393	473	10	14	80	0.1750000
NODE_7802_length_943_cov_28.289100	446	526	3	3	80	0.0375000
NODE_7802_length_943_cov_28.289100	446	526	6	39	80	0.4875000
NODE_7802_length_943_cov_28.289100	446	526	8	38	80	0.4750000
NODE_7803_length_943_cov_27.225118	343	423	0	4	80	0.0500000
NODE_7803_length_943_cov_27.225118	343	423	2	22	80	0.2750000
NODE_7803_length_943_cov_27.225118	343	423	6	18	80	0.2250000
NODE_7803_length_943_cov_27.225118	343	423	7	5	80	0.0625000
NODE_7803_length_943_cov_27.225118	343	423	10	3	80	0.0375000
NODE_7803_length_943_cov_27.225118	343	423	12	24	80	0.3000000
NODE_7803_length_943_cov_27.225118	343	423	14	1	80	0.0125000
NODE_7803_length_943_cov_27.225118	343	423	16	3	80	0.0375000
NODE_7803_length_943_cov_27.225118	396	476	12	23	80	0.2875000
NODE_7803_length_943_cov_27.225118	396	476	14	1	80	0.0125000
NODE_7803_length_943_cov_27.225118	396	476	16	50	80	0.6250000
NODE_7803_length_943_cov_27.225118	396	476	17	1	80	0.0125000
NODE_7803_length_943_cov_27.225118	396	476	18	5	80	0.0625000
NODE_7804_length_943_cov_26.536730	275	303	7	28	28	1.0000000
NODE_7804_length_943_cov_26.536730	299	379	7	41	80	0.5125000
NODE_7804_length_943_cov_26.536730	299	379	13	20	80	0.2500000
NODE_7804_length_943_cov_26.536730	299	379	14	1	80	0.0125000
NODE_7804_length_943_cov_26.536730	299	379	15	18	80	0.2250000
NODE_7804_length_943_cov_26.536730	352	432	9	3	80	0.0375000
NODE_7804_length_943_cov_26.536730	352	432	10	17	80	0.2125000
NODE_7804_length_943_cov_26.536730	352	432	11	29	80	0.3625000
NODE_7804_length_943_cov_26.536730	352	432	13	23	80	0.2875000
NODE_7804_length_943_cov_26.536730	352	432	15	8	80	0.1000000
NODE_7805_length_943_cov_24.992891	374	454	2	10	80	0.1250000
NODE_7805_length_943_cov_24.992891	374	454	3	45	80	0.5625000
NODE_7805_length_943_cov_24.992891	374	454	4	25	80	0.3125000
NODE_7805_length_943_cov_24.992891	427	507	2	31	80	0.3875000
NODE_7805_length_943_cov_24.992891	427	507	3	32	80	0.4000000
NODE_7805_length_943_cov_24.992891	427	507	4	17	80	0.2125000
NODE_7805_length_943_cov_24.992891	503	583	2	43	80	0.5375000
NODE_7805_length_943_cov_24.992891	503	583	3	29	80	0.3625000
NODE_7805_length_943_cov_24.992891	503	583	4	8	80	0.1000000
NODE_7805_length_943_cov_24.992891	556	636	3	51	80	0.6375000
NODE_7805_length_943_cov_24.992891	556	636	4	29	80	0.3625000
NODE_7806_length_943_cov_24.758294	403	483	9	26	80	0.3250000
NODE_7806_length_943_cov_24.758294	403	483	10	8	80	0.1000000
NODE_7806_length_943_cov_24.758294	403	483	11	46	80	0.5750000
NODE_7806_length_943_cov_24.758294	456	536	7	32	80	0.4000000
NODE_7806_length_943_cov_24.758294	456	536	9	8	80	0.1000000
NODE_7806_length_943_cov_24.758294	456	536	10	8	80	0.1000000
NODE_7806_length_943_cov_24.758294	456	536	11	32	80	0.4000000
NODE_7807_length_943_cov_22.316351	432	512	18	51	80	0.6375000
NODE_7807_length_943_cov_22.316351	432	512	20	9	80	0.1125000
NODE_7807_length_943_cov_22.316351	432	512	21	20	80	0.2500000
NODE_7807_length_943_cov_22.316351	485	565	8	1	80	0.0125000
NODE_7807_length_943_cov_22.316351	485	565	20	19	80	0.2375000
NODE_7807_length_943_cov_22.316351	485	565	21	18	80	0.2250000
NODE_7807_length_943_cov_22.316351	485	565	22	1	80	0.0125000
NODE_7807_length_943_cov_22.316351	485	565	23	41	80	0.5125000
NODE_7808_length_943_cov_22.149289	393	473	16	8	80	0.1000000
NODE_7808_length_943_cov_22.149289	393	473	17	12	80	0.1500000
NODE_7808_length_943_cov_22.149289	393	473	18	6	80	0.0750000
NODE_7808_length_943_cov_22.149289	393	473	19	38	80	0.4750000
NODE_7808_length_943_cov_22.149289	393	473	20	8	80	0.1000000
NODE_7808_length_943_cov_22.149289	393	473	21	8	80	0.1000000
NODE_7808_length_943_cov_22.149289	446	526	8	2	80	0.0250000
NODE_7808_length_943_cov_22.149289	446	526	9	2	80	0.0250000
NODE_7808_length_943_cov_22.149289	446	526	10	13	80	0.1625000
NODE_7808_length_943_cov_22.149289	446	526	13	13	80	0.1625000
NODE_7808_length_943_cov_22.149289	446	526	14	2	80	0.0250000
NODE_7808_length_943_cov_22.149289	446	526	16	25	80	0.3125000
NODE_7808_length_943_cov_22.149289	446	526	17	4	80	0.0500000
NODE_7808_length_943_cov_22.149289	446	526	18	6	80	0.0750000
NODE_7808_length_943_cov_22.149289	446	526	19	13	80	0.1625000
NODE_7809_length_943_cov_20.055687	412	492	0	5	80	0.0625000
NODE_7809_length_943_cov_20.055687	412	492	2	75	80	0.9375000
NODE_7809_length_943_cov_20.055687	465	545	0	58	80	0.7250000
NODE_7809_length_943_cov_20.055687	465	545	2	22	80	0.2750000
NODE_7810_length_943_cov_16.022512	338	418	1	73	80	0.9125000
NODE_7810_length_943_cov_16.022512	338	418	2	7	80	0.0875000
NODE_7810_length_943_cov_16.022512	391	471	1	51	80	0.6375000
NODE_7810_length_943_cov_16.022512	391	471	2	29	80	0.3625000
NODE_7811_length_943_cov_10.939573	474	554	9	13	80	0.1625000
NODE_7811_length_943_cov_10.939573	474	554	10	14	80	0.1750000
NODE_7811_length_943_cov_10.939573	474	554	11	53	80	0.6625000
NODE_7811_length_943_cov_10.939573	527	607	5	21	80	0.2625000
NODE_7811_length_943_cov_10.939573	527	607	6	5	80	0.0625000
NODE_7811_length_943_cov_10.939573	527	607	7	7	80	0.0875000
NODE_7811_length_943_cov_10.939573	527	607	8	4	80	0.0500000
NODE_7811_length_943_cov_10.939573	527	607	9	14	80	0.1750000
NODE_7811_length_943_cov_10.939573	527	607	10	29	80	0.3625000
NODE_7812_length_943_cov_9.483412	422	502	10	4	80	0.0500000
NODE_7812_length_943_cov_9.483412	422	502	11	5	80	0.0625000
NODE_7812_length_943_cov_9.483412	422	502	12	33	80	0.4125000
NODE_7812_length_943_cov_9.483412	422	502	14	4	80	0.0500000
NODE_7812_length_943_cov_9.483412	422	502	17	34	80	0.4250000
NODE_7812_length_943_cov_9.483412	475	555	8	11	80	0.1375000
NODE_7812_length_943_cov_9.483412	475	555	10	23	80	0.2875000
NODE_7812_length_943_cov_9.483412	475	555	12	1	80	0.0125000
NODE_7812_length_943_cov_9.483412	475	555	13	15	80	0.1875000
NODE_7812_length_943_cov_9.483412	475	555	17	30	80	0.3750000
NODE_7830_length_942_cov_58.088968	384	464	19	1	80	0.0125000
NODE_7830_length_942_cov_58.088968	384	464	20	12	80	0.1500000
NODE_7830_length_942_cov_58.088968	384	464	21	26	80	0.3250000
NODE_7830_length_942_cov_58.088968	384	464	22	7	80	0.0875000
NODE_7830_length_942_cov_58.088968	384	464	23	32	80	0.4000000
NODE_7830_length_942_cov_58.088968	384	464	24	2	80	0.0250000
NODE_7830_length_942_cov_58.088968	437	517	20	10	80	0.1250000
NODE_7830_length_942_cov_58.088968	437	517	21	5	80	0.0625000
NODE_7830_length_942_cov_58.088968	437	517	22	18	80	0.2250000
NODE_7830_length_942_cov_58.088968	437	517	23	20	80	0.2500000
NODE_7830_length_942_cov_58.088968	437	517	24	5	80	0.0625000
NODE_7830_length_942_cov_58.088968	437	517	25	6	80	0.0750000
NODE_7830_length_942_cov_58.088968	437	517	26	16	80	0.2000000
NODE_7832_length_942_cov_27.466192	360	440	0	80	80	1.0000000
NODE_7832_length_942_cov_27.466192	413	493	0	80	80	1.0000000
NODE_7833_length_942_cov_26.914591	346	426	5	15	80	0.1875000
NODE_7833_length_942_cov_26.914591	346	426	6	58	80	0.7250000
NODE_7833_length_942_cov_26.914591	346	426	8	7	80	0.0875000
NODE_7833_length_942_cov_26.914591	399	479	4	42	80	0.5250000
NODE_7833_length_942_cov_26.914591	399	479	5	3	80	0.0375000
NODE_7833_length_942_cov_26.914591	399	479	6	28	80	0.3500000
NODE_7833_length_942_cov_26.914591	399	479	8	7	80	0.0875000
NODE_7834_length_942_cov_17.911032	390	470	4	4	80	0.0500000
NODE_7834_length_942_cov_17.911032	390	470	5	9	80	0.1125000
NODE_7834_length_942_cov_17.911032	390	470	6	17	80	0.2125000
NODE_7834_length_942_cov_17.911032	390	470	7	39	80	0.4875000
NODE_7834_length_942_cov_17.911032	390	470	8	11	80	0.1375000
NODE_7834_length_942_cov_17.911032	443	523	4	18	80	0.2250000
NODE_7834_length_942_cov_17.911032	443	523	6	51	80	0.6375000
NODE_7834_length_942_cov_17.911032	443	523	8	11	80	0.1375000
NODE_7835_length_942_cov_14.695136	442	522	1	80	80	1.0000000
NODE_7835_length_942_cov_14.695136	495	575	0	1	80	0.0125000
NODE_7835_length_942_cov_14.695136	495	575	1	79	80	0.9875000
NODE_7836_length_942_cov_14.097272	547	627	2	80	80	1.0000000
NODE_7836_length_942_cov_14.097272	600	680	0	28	80	0.3500000
NODE_7836_length_942_cov_14.097272	600	680	1	18	80	0.2250000
NODE_7836_length_942_cov_14.097272	600	680	2	34	80	0.4250000
NODE_7837_length_942_cov_13.174377	322	402	2	24	80	0.3000000
NODE_7837_length_942_cov_13.174377	322	402	4	56	80	0.7000000
NODE_7837_length_942_cov_13.174377	375	455	2	23	80	0.2875000
NODE_7837_length_942_cov_13.174377	375	455	4	57	80	0.7125000
NODE_7858_length_941_cov_36.592637	259	339	4	16	80	0.2000000
NODE_7858_length_941_cov_36.592637	259	339	5	37	80	0.4625000
NODE_7858_length_941_cov_36.592637	259	339	6	11	80	0.1375000
NODE_7858_length_941_cov_36.592637	259	339	7	16	80	0.2000000
NODE_7858_length_941_cov_36.592637	312	392	6	13	80	0.1625000
NODE_7858_length_941_cov_36.592637	312	392	7	24	80	0.3000000
NODE_7858_length_941_cov_36.592637	312	392	8	1	80	0.0125000
NODE_7858_length_941_cov_36.592637	312	392	9	16	80	0.2000000
NODE_7858_length_941_cov_36.592637	312	392	10	22	80	0.2750000
NODE_7858_length_941_cov_36.592637	312	392	11	4	80	0.0500000
NODE_7858_length_941_cov_36.592637	388	468	9	34	80	0.4250000
NODE_7858_length_941_cov_36.592637	388	468	10	46	80	0.5750000
NODE_7858_length_941_cov_36.592637	441	521	3	3	80	0.0375000
NODE_7858_length_941_cov_36.592637	441	521	4	13	80	0.1625000
NODE_7858_length_941_cov_36.592637	441	521	5	4	80	0.0500000
NODE_7858_length_941_cov_36.592637	441	521	6	1	80	0.0125000
NODE_7858_length_941_cov_36.592637	441	521	7	1	80	0.0125000
NODE_7858_length_941_cov_36.592637	441	521	8	3	80	0.0375000
NODE_7858_length_941_cov_36.592637	441	521	9	46	80	0.5750000
NODE_7858_length_941_cov_36.592637	441	521	10	9	80	0.1125000
NODE_7859_length_941_cov_35.375297	352	432	4	2	80	0.0250000
NODE_7859_length_941_cov_35.375297	352	432	5	14	80	0.1750000
NODE_7859_length_941_cov_35.375297	352	432	6	4	80	0.0500000
NODE_7859_length_941_cov_35.375297	352	432	7	20	80	0.2500000
NODE_7859_length_941_cov_35.375297	352	432	8	8	80	0.1000000
NODE_7859_length_941_cov_35.375297	352	432	9	32	80	0.4000000
NODE_7859_length_941_cov_35.375297	405	485	8	58	80	0.7250000
NODE_7859_length_941_cov_35.375297	405	485	9	22	80	0.2750000
NODE_7859_length_941_cov_35.375297	481	561	2	17	80	0.2125000
NODE_7859_length_941_cov_35.375297	481	561	3	2	80	0.0250000
NODE_7859_length_941_cov_35.375297	481	561	4	20	80	0.2500000
NODE_7859_length_941_cov_35.375297	481	561	5	12	80	0.1500000
NODE_7859_length_941_cov_35.375297	481	561	6	24	80	0.3000000
NODE_7859_length_941_cov_35.375297	481	561	8	5	80	0.0625000
NODE_7859_length_941_cov_35.375297	534	614	2	51	80	0.6375000
NODE_7859_length_941_cov_35.375297	534	614	3	21	80	0.2625000
NODE_7859_length_941_cov_35.375297	534	614	4	8	80	0.1000000
NODE_7860_length_941_cov_32.222090	407	487	6	21	80	0.2625000
NODE_7860_length_941_cov_32.222090	407	487	8	59	80	0.7375000
NODE_7860_length_941_cov_32.222090	460	540	0	5	80	0.0625000
NODE_7860_length_941_cov_32.222090	460	540	6	69	80	0.8625000
NODE_7860_length_941_cov_32.222090	460	540	8	6	80	0.0750000
NODE_7861_length_941_cov_28.442993	391	471	8	27	80	0.3375000
NODE_7861_length_941_cov_28.442993	391	471	10	18	80	0.2250000
NODE_7861_length_941_cov_28.442993	391	471	11	31	80	0.3875000
NODE_7861_length_941_cov_28.442993	391	471	12	4	80	0.0500000
NODE_7861_length_941_cov_28.442993	444	524	5	24	80	0.3000000
NODE_7861_length_941_cov_28.442993	444	524	7	9	80	0.1125000
NODE_7861_length_941_cov_28.442993	444	524	8	20	80	0.2500000
NODE_7861_length_941_cov_28.442993	444	524	10	18	80	0.2250000
NODE_7861_length_941_cov_28.442993	444	524	11	9	80	0.1125000
NODE_7862_length_941_cov_20.788599	341	421	17	27	80	0.3375000
NODE_7862_length_941_cov_20.788599	341	421	19	20	80	0.2500000
NODE_7862_length_941_cov_20.788599	341	421	20	17	80	0.2125000
NODE_7862_length_941_cov_20.788599	341	421	21	9	80	0.1125000
NODE_7862_length_941_cov_20.788599	341	421	23	1	80	0.0125000
NODE_7862_length_941_cov_20.788599	341	421	24	5	80	0.0625000
NODE_7862_length_941_cov_20.788599	341	421	25	1	80	0.0125000
NODE_7862_length_941_cov_20.788599	394	474	19	22	80	0.2750000
NODE_7862_length_941_cov_20.788599	394	474	20	12	80	0.1500000
NODE_7862_length_941_cov_20.788599	394	474	21	13	80	0.1625000
NODE_7862_length_941_cov_20.788599	394	474	22	2	80	0.0250000
NODE_7862_length_941_cov_20.788599	394	474	23	5	80	0.0625000
NODE_7862_length_941_cov_20.788599	394	474	24	16	80	0.2000000
NODE_7862_length_941_cov_20.788599	394	474	25	10	80	0.1250000
NODE_7863_length_941_cov_18.000000	364	444	6	9	80	0.1125000
NODE_7863_length_941_cov_18.000000	364	444	7	9	80	0.1125000
NODE_7863_length_941_cov_18.000000	364	444	8	27	80	0.3375000
NODE_7863_length_941_cov_18.000000	364	444	10	35	80	0.4375000
NODE_7863_length_941_cov_18.000000	417	497	4	1	80	0.0125000
NODE_7863_length_941_cov_18.000000	417	497	5	9	80	0.1125000
NODE_7863_length_941_cov_18.000000	417	497	6	8	80	0.1000000
NODE_7863_length_941_cov_18.000000	417	497	7	28	80	0.3500000
NODE_7863_length_941_cov_18.000000	417	497	8	24	80	0.3000000
NODE_7863_length_941_cov_18.000000	417	497	10	10	80	0.1250000
NODE_7864_length_941_cov_11.020190	325	405	0	80	80	1.0000000
NODE_7864_length_941_cov_11.020190	378	458	0	80	80	1.0000000
NODE_7865_length_941_cov_6.020190	260	287	2	27	27	1.0000000
NODE_7865_length_941_cov_6.020190	260	340	2	61	80	0.7625000
NODE_7865_length_941_cov_6.020190	260	340	3	19	80	0.2375000
NODE_7867_length_941_cov_3.745843	867	941	0	74	74	1.0000000
NODE_7877_length_940_cov_43.954816	243	323	6	1	80	0.0125000
NODE_7877_length_940_cov_43.954816	243	323	7	16	80	0.2000000
NODE_7877_length_940_cov_43.954816	243	323	8	17	80	0.2125000
NODE_7877_length_940_cov_43.954816	243	323	10	7	80	0.0875000
NODE_7877_length_940_cov_43.954816	243	323	11	5	80	0.0625000
NODE_7877_length_940_cov_43.954816	243	323	12	13	80	0.1625000
NODE_7877_length_940_cov_43.954816	243	323	13	19	80	0.2375000
NODE_7877_length_940_cov_43.954816	243	323	15	2	80	0.0250000
NODE_7877_length_940_cov_43.954816	296	376	12	6	80	0.0750000
NODE_7877_length_940_cov_43.954816	296	376	13	19	80	0.2375000
NODE_7877_length_940_cov_43.954816	296	376	14	10	80	0.1250000
NODE_7877_length_940_cov_43.954816	296	376	15	6	80	0.0750000
NODE_7877_length_940_cov_43.954816	296	376	16	28	80	0.3500000
NODE_7877_length_940_cov_43.954816	296	376	17	11	80	0.1375000
NODE_7877_length_940_cov_43.954816	372	452	14	33	80	0.4125000
NODE_7877_length_940_cov_43.954816	372	452	15	13	80	0.1625000
NODE_7877_length_940_cov_43.954816	372	452	16	5	80	0.0625000
NODE_7877_length_940_cov_43.954816	372	452	17	22	80	0.2750000
NODE_7877_length_940_cov_43.954816	372	452	18	6	80	0.0750000
NODE_7877_length_940_cov_43.954816	372	452	19	1	80	0.0125000
NODE_7877_length_940_cov_43.954816	425	505	12	29	80	0.3625000
NODE_7877_length_940_cov_43.954816	425	505	16	6	80	0.0750000
NODE_7877_length_940_cov_43.954816	425	505	17	21	80	0.2625000
NODE_7877_length_940_cov_43.954816	425	505	18	23	80	0.2875000
NODE_7877_length_940_cov_43.954816	425	505	19	1	80	0.0125000
NODE_7878_length_940_cov_27.763377	423	503	2	16	80	0.2000000
NODE_7878_length_940_cov_27.763377	423	503	3	1	80	0.0125000
NODE_7878_length_940_cov_27.763377	423	503	7	63	80	0.7875000
NODE_7878_length_940_cov_27.763377	476	556	5	29	80	0.3625000
NODE_7878_length_940_cov_27.763377	476	556	6	8	80	0.1000000
NODE_7878_length_940_cov_27.763377	476	556	7	43	80	0.5375000
NODE_7897_length_939_cov_58.982143	363	443	24	2	80	0.0250000
NODE_7897_length_939_cov_58.982143	363	443	25	6	80	0.0750000
NODE_7897_length_939_cov_58.982143	363	443	26	9	80	0.1125000
NODE_7897_length_939_cov_58.982143	363	443	27	1	80	0.0125000
NODE_7897_length_939_cov_58.982143	363	443	31	1	80	0.0125000
NODE_7897_length_939_cov_58.982143	363	443	32	3	80	0.0375000
NODE_7897_length_939_cov_58.982143	363	443	33	1	80	0.0125000
NODE_7897_length_939_cov_58.982143	363	443	34	3	80	0.0375000
NODE_7897_length_939_cov_58.982143	363	443	35	2	80	0.0250000
NODE_7897_length_939_cov_58.982143	363	443	36	6	80	0.0750000
NODE_7897_length_939_cov_58.982143	363	443	37	5	80	0.0625000
NODE_7897_length_939_cov_58.982143	363	443	38	9	80	0.1125000
NODE_7897_length_939_cov_58.982143	363	443	39	12	80	0.1500000
NODE_7897_length_939_cov_58.982143	363	443	44	4	80	0.0500000
NODE_7897_length_939_cov_58.982143	363	443	46	1	80	0.0125000
NODE_7897_length_939_cov_58.982143	363	443	48	1	80	0.0125000
NODE_7897_length_939_cov_58.982143	363	443	50	12	80	0.1500000
NODE_7897_length_939_cov_58.982143	363	443	51	2	80	0.0250000
NODE_7897_length_939_cov_58.982143	416	496	38	2	80	0.0250000
NODE_7897_length_939_cov_58.982143	416	496	39	5	80	0.0625000
NODE_7897_length_939_cov_58.982143	416	496	40	1	80	0.0125000
NODE_7897_length_939_cov_58.982143	416	496	44	5	80	0.0625000
NODE_7897_length_939_cov_58.982143	416	496	45	4	80	0.0500000
NODE_7897_length_939_cov_58.982143	416	496	46	4	80	0.0500000
NODE_7897_length_939_cov_58.982143	416	496	47	13	80	0.1625000
NODE_7897_length_939_cov_58.982143	416	496	48	6	80	0.0750000
NODE_7897_length_939_cov_58.982143	416	496	49	22	80	0.2750000
NODE_7897_length_939_cov_58.982143	416	496	50	16	80	0.2000000
NODE_7897_length_939_cov_58.982143	416	496	51	2	80	0.0250000
NODE_7898_length_939_cov_32.469048	327	407	4	18	80	0.2250000
NODE_7898_length_939_cov_32.469048	327	407	6	2	80	0.0250000
NODE_7898_length_939_cov_32.469048	327	407	7	2	80	0.0250000
NODE_7898_length_939_cov_32.469048	327	407	8	4	80	0.0500000
NODE_7898_length_939_cov_32.469048	327	407	13	1	80	0.0125000
NODE_7898_length_939_cov_32.469048	327	407	14	53	80	0.6625000
NODE_7898_length_939_cov_32.469048	380	460	14	31	80	0.3875000
NODE_7898_length_939_cov_32.469048	380	460	16	3	80	0.0375000
NODE_7898_length_939_cov_32.469048	380	460	27	3	80	0.0375000
NODE_7898_length_939_cov_32.469048	380	460	28	4	80	0.0500000
NODE_7898_length_939_cov_32.469048	380	460	29	2	80	0.0250000
NODE_7898_length_939_cov_32.469048	380	460	30	20	80	0.2500000
NODE_7898_length_939_cov_32.469048	380	460	31	3	80	0.0375000
NODE_7898_length_939_cov_32.469048	380	460	32	14	80	0.1750000
NODE_7899_length_939_cov_31.895238	265	345	0	80	80	1.0000000
NODE_7899_length_939_cov_31.895238	318	398	0	80	80	1.0000000
NODE_7900_length_939_cov_25.354762	439	519	6	25	80	0.3125000
NODE_7900_length_939_cov_25.354762	439	519	9	4	80	0.0500000
NODE_7900_length_939_cov_25.354762	439	519	11	7	80	0.0875000
NODE_7900_length_939_cov_25.354762	439	519	12	1	80	0.0125000
NODE_7900_length_939_cov_25.354762	439	519	13	43	80	0.5375000
NODE_7900_length_939_cov_25.354762	492	572	9	1	80	0.0125000
NODE_7900_length_939_cov_25.354762	492	572	11	7	80	0.0875000
NODE_7900_length_939_cov_25.354762	492	572	13	72	80	0.9000000
NODE_7901_length_939_cov_24.892857	370	450	7	20	80	0.2500000
NODE_7901_length_939_cov_24.892857	370	450	8	47	80	0.5875000
NODE_7901_length_939_cov_24.892857	370	450	9	13	80	0.1625000
NODE_7901_length_939_cov_24.892857	423	503	7	2	80	0.0250000
NODE_7901_length_939_cov_24.892857	423	503	8	14	80	0.1750000
NODE_7901_length_939_cov_24.892857	423	503	9	43	80	0.5375000
NODE_7901_length_939_cov_24.892857	423	503	10	21	80	0.2625000
NODE_7902_length_939_cov_24.246429	422	502	1	7	80	0.0875000
NODE_7902_length_939_cov_24.246429	422	502	2	20	80	0.2500000
NODE_7902_length_939_cov_24.246429	422	502	3	24	80	0.3000000
NODE_7902_length_939_cov_24.246429	422	502	4	10	80	0.1250000
NODE_7902_length_939_cov_24.246429	422	502	5	19	80	0.2375000
NODE_7902_length_939_cov_24.246429	475	555	4	38	80	0.4750000
NODE_7902_length_939_cov_24.246429	475	555	5	42	80	0.5250000
NODE_7902_length_939_cov_24.246429	551	631	2	8	80	0.1000000
NODE_7902_length_939_cov_24.246429	551	631	3	24	80	0.3000000
NODE_7902_length_939_cov_24.246429	551	631	4	45	80	0.5625000
NODE_7902_length_939_cov_24.246429	551	631	5	3	80	0.0375000
NODE_7902_length_939_cov_24.246429	604	684	1	51	80	0.6375000
NODE_7902_length_939_cov_24.246429	604	684	2	10	80	0.1250000
NODE_7902_length_939_cov_24.246429	604	684	3	19	80	0.2375000
NODE_7903_length_939_cov_21.141667	368	448	4	6	80	0.0750000
NODE_7903_length_939_cov_21.141667	368	448	6	16	80	0.2000000
NODE_7903_length_939_cov_21.141667	368	448	7	11	80	0.1375000
NODE_7903_length_939_cov_21.141667	368	448	8	47	80	0.5875000
NODE_7903_length_939_cov_21.141667	421	501	6	20	80	0.2500000
NODE_7903_length_939_cov_21.141667	421	501	7	21	80	0.2625000
NODE_7903_length_939_cov_21.141667	421	501	8	39	80	0.4875000
NODE_7904_length_939_cov_16.425000	327	407	0	80	80	1.0000000
NODE_7904_length_939_cov_16.425000	380	460	0	80	80	1.0000000
NODE_7905_length_939_cov_13.828571	469	548	0	29	79	0.3670886
NODE_7905_length_939_cov_13.828571	469	548	1	12	79	0.1518987
NODE_7905_length_939_cov_13.828571	469	548	2	8	79	0.1012658
NODE_7905_length_939_cov_13.828571	469	548	3	30	79	0.3797468
NODE_7905_length_939_cov_13.828571	522	603	3	73	81	0.9012346
NODE_7905_length_939_cov_13.828571	522	603	4	8	81	0.0987654
NODE_7906_length_939_cov_13.521429	402	482	7	42	80	0.5250000
NODE_7906_length_939_cov_13.521429	402	482	8	32	80	0.4000000
NODE_7906_length_939_cov_13.521429	402	482	9	6	80	0.0750000
NODE_7906_length_939_cov_13.521429	455	535	3	15	80	0.1875000
NODE_7906_length_939_cov_13.521429	455	535	4	7	80	0.0875000
NODE_7906_length_939_cov_13.521429	455	535	6	12	80	0.1500000
NODE_7906_length_939_cov_13.521429	455	535	7	26	80	0.3250000
NODE_7906_length_939_cov_13.521429	455	535	8	20	80	0.2500000
NODE_7907_length_939_cov_12.955952	398	478	2	6	80	0.0750000
NODE_7907_length_939_cov_12.955952	398	478	3	72	80	0.9000000
NODE_7907_length_939_cov_12.955952	398	478	4	2	80	0.0250000
NODE_7907_length_939_cov_12.955952	451	531	3	25	80	0.3125000
NODE_7907_length_939_cov_12.955952	451	531	4	55	80	0.6875000
NODE_7908_length_939_cov_6.564286	523	545	0	22	22	1.0000000
NODE_7922_length_938_cov_44.458880	362	442	11	10	80	0.1250000
NODE_7922_length_938_cov_44.458880	362	442	12	2	80	0.0250000
NODE_7922_length_938_cov_44.458880	362	442	13	14	80	0.1750000
NODE_7922_length_938_cov_44.458880	362	442	14	22	80	0.2750000
NODE_7922_length_938_cov_44.458880	362	442	15	32	80	0.4000000
NODE_7922_length_938_cov_44.458880	415	495	13	6	80	0.0750000
NODE_7922_length_938_cov_44.458880	415	495	14	27	80	0.3375000
NODE_7922_length_938_cov_44.458880	415	495	15	23	80	0.2875000
NODE_7922_length_938_cov_44.458880	415	495	16	20	80	0.2500000
NODE_7922_length_938_cov_44.458880	415	495	17	3	80	0.0375000
NODE_7922_length_938_cov_44.458880	415	495	18	1	80	0.0125000
NODE_7923_length_938_cov_44.435042	748	815	5	9	67	0.1343284
NODE_7923_length_938_cov_44.435042	748	815	7	14	67	0.2089552
NODE_7923_length_938_cov_44.435042	748	815	8	44	67	0.6567164
NODE_7924_length_938_cov_32.177592	466	546	6	22	80	0.2750000
NODE_7924_length_938_cov_32.177592	466	546	7	2	80	0.0250000
NODE_7924_length_938_cov_32.177592	466	546	8	15	80	0.1875000
NODE_7924_length_938_cov_32.177592	466	546	9	29	80	0.3625000
NODE_7924_length_938_cov_32.177592	466	546	10	12	80	0.1500000
NODE_7924_length_938_cov_32.177592	519	599	3	37	80	0.4625000
NODE_7924_length_938_cov_32.177592	519	599	4	8	80	0.1000000
NODE_7924_length_938_cov_32.177592	519	599	6	30	80	0.3750000
NODE_7924_length_938_cov_32.177592	519	599	7	2	80	0.0250000
NODE_7924_length_938_cov_32.177592	519	599	8	3	80	0.0375000
NODE_7925_length_938_cov_21.139452	474	554	9	8	80	0.1000000
NODE_7925_length_938_cov_21.139452	474	554	10	7	80	0.0875000
NODE_7925_length_938_cov_21.139452	474	554	11	59	80	0.7375000
NODE_7925_length_938_cov_21.139452	474	554	12	6	80	0.0750000
NODE_7925_length_938_cov_21.139452	527	607	8	32	80	0.4000000
NODE_7925_length_938_cov_21.139452	527	607	9	12	80	0.1500000
NODE_7925_length_938_cov_21.139452	527	607	11	14	80	0.1750000
NODE_7925_length_938_cov_21.139452	527	607	12	6	80	0.0750000
NODE_7925_length_938_cov_21.139452	527	607	13	16	80	0.2000000
NODE_7927_length_938_cov_8.791418	300	380	0	16	80	0.2000000
NODE_7927_length_938_cov_8.791418	300	380	3	4	80	0.0500000
NODE_7927_length_938_cov_8.791418	300	380	4	16	80	0.2000000
NODE_7927_length_938_cov_8.791418	300	380	5	44	80	0.5500000
NODE_7927_length_938_cov_8.791418	353	433	5	69	80	0.8625000
NODE_7927_length_938_cov_8.791418	353	433	8	11	80	0.1375000
NODE_7932_length_938_cov_2.693683	59	139	2	80	80	1.0000000
NODE_7932_length_938_cov_2.693683	112	192	0	27	80	0.3375000
NODE_7932_length_938_cov_2.693683	112	192	1	9	80	0.1125000
NODE_7932_length_938_cov_2.693683	112	192	2	44	80	0.5500000
NODE_7946_length_937_cov_31.890215	407	487	9	14	80	0.1750000
NODE_7946_length_937_cov_31.890215	407	487	10	2	80	0.0250000
NODE_7946_length_937_cov_31.890215	407	487	11	44	80	0.5500000
NODE_7946_length_937_cov_31.890215	407	487	12	20	80	0.2500000
NODE_7946_length_937_cov_31.890215	460	536	8	11	76	0.1447368
NODE_7946_length_937_cov_31.890215	460	536	9	3	76	0.0394737
NODE_7946_length_937_cov_31.890215	460	536	10	3	76	0.0394737
NODE_7946_length_937_cov_31.890215	460	536	11	26	76	0.3421053
NODE_7946_length_937_cov_31.890215	460	536	12	1	76	0.0131579
NODE_7946_length_937_cov_31.890215	460	536	21	11	76	0.1447368
NODE_7946_length_937_cov_31.890215	460	536	22	18	76	0.2368421
NODE_7946_length_937_cov_31.890215	460	536	23	3	76	0.0394737
NODE_7947_length_937_cov_31.198091	425	505	13	28	80	0.3500000
NODE_7947_length_937_cov_31.198091	425	505	15	52	80	0.6500000
NODE_7947_length_937_cov_31.198091	478	558	6	3	80	0.0375000
NODE_7947_length_937_cov_31.198091	478	558	8	20	80	0.2500000
NODE_7947_length_937_cov_31.198091	478	558	10	23	80	0.2875000
NODE_7947_length_937_cov_31.198091	478	558	15	34	80	0.4250000
NODE_7948_length_937_cov_29.742243	296	376	1	16	80	0.2000000
NODE_7948_length_937_cov_29.742243	296	376	6	44	80	0.5500000
NODE_7948_length_937_cov_29.742243	296	376	11	20	80	0.2500000
NODE_7948_length_937_cov_29.742243	349	429	0	2	80	0.0250000
NODE_7948_length_937_cov_29.742243	349	429	1	61	80	0.7625000
NODE_7948_length_937_cov_29.742243	349	429	2	6	80	0.0750000
NODE_7948_length_937_cov_29.742243	349	429	6	11	80	0.1375000
NODE_7948_length_937_cov_29.742243	425	505	2	13	80	0.1625000
NODE_7948_length_937_cov_29.742243	425	505	3	67	80	0.8375000
NODE_7948_length_937_cov_29.742243	478	558	3	31	80	0.3875000
NODE_7948_length_937_cov_29.742243	478	558	4	1	80	0.0125000
NODE_7948_length_937_cov_29.742243	478	558	5	2	80	0.0250000
NODE_7948_length_937_cov_29.742243	478	558	8	46	80	0.5750000
NODE_7950_length_937_cov_26.153938	487	567	1	21	80	0.2625000
NODE_7950_length_937_cov_26.153938	487	567	3	35	80	0.4375000
NODE_7950_length_937_cov_26.153938	487	567	4	24	80	0.3000000
NODE_7950_length_937_cov_26.153938	540	620	3	3	80	0.0375000
NODE_7950_length_937_cov_26.153938	540	620	4	38	80	0.4750000
NODE_7950_length_937_cov_26.153938	540	620	5	21	80	0.2625000
NODE_7950_length_937_cov_26.153938	540	620	6	18	80	0.2250000
NODE_7951_length_937_cov_20.898568	515	595	11	28	80	0.3500000
NODE_7951_length_937_cov_20.898568	515	595	12	33	80	0.4125000
NODE_7951_length_937_cov_20.898568	515	595	13	19	80	0.2375000
NODE_7951_length_937_cov_20.898568	568	648	8	10	80	0.1250000
NODE_7951_length_937_cov_20.898568	568	648	10	33	80	0.4125000
NODE_7951_length_937_cov_20.898568	568	648	11	13	80	0.1625000
NODE_7951_length_937_cov_20.898568	568	648	12	5	80	0.0625000
NODE_7951_length_937_cov_20.898568	568	648	13	19	80	0.2375000
NODE_7952_length_937_cov_20.502387	181	261	0	80	80	1.0000000
NODE_7952_length_937_cov_20.502387	234	314	0	80	80	1.0000000
NODE_7952_length_937_cov_20.502387	310	390	0	8	80	0.1000000
NODE_7952_length_937_cov_20.502387	310	390	2	28	80	0.3500000
NODE_7952_length_937_cov_20.502387	310	390	3	44	80	0.5500000
NODE_7952_length_937_cov_20.502387	363	443	1	15	80	0.1875000
NODE_7952_length_937_cov_20.502387	363	443	2	10	80	0.1250000
NODE_7952_length_937_cov_20.502387	363	443	3	55	80	0.6875000
NODE_7953_length_937_cov_15.219570	526	606	0	78	80	0.9750000
NODE_7953_length_937_cov_15.219570	526	606	1	2	80	0.0250000
NODE_7953_length_937_cov_15.219570	579	659	0	80	80	1.0000000
NODE_7954_length_937_cov_9.633652	521	601	0	80	80	1.0000000
NODE_7954_length_937_cov_9.633652	574	654	0	80	80	1.0000000
NODE_7956_length_937_cov_6.630072	305	385	4	29	80	0.3625000
NODE_7956_length_937_cov_6.630072	305	385	6	51	80	0.6375000
NODE_7956_length_937_cov_6.630072	358	438	3	8	80	0.1000000
NODE_7956_length_937_cov_6.630072	358	438	4	67	80	0.8375000
NODE_7956_length_937_cov_6.630072	358	438	6	5	80	0.0625000
NODE_7957_length_937_cov_4.649165	470	550	2	9	80	0.1125000
NODE_7957_length_937_cov_4.649165	470	550	3	55	80	0.6875000
NODE_7957_length_937_cov_4.649165	470	550	4	1	80	0.0125000
NODE_7957_length_937_cov_4.649165	470	550	5	15	80	0.1875000
NODE_7957_length_937_cov_4.649165	523	603	3	26	80	0.3250000
NODE_7957_length_937_cov_4.649165	523	603	4	23	80	0.2875000
NODE_7957_length_937_cov_4.649165	523	603	5	31	80	0.3875000
NODE_7969_length_936_cov_57.105137	267	347	0	19	80	0.2375000
NODE_7969_length_936_cov_57.105137	267	347	1	40	80	0.5000000
NODE_7969_length_936_cov_57.105137	267	347	2	14	80	0.1750000
NODE_7969_length_936_cov_57.105137	267	347	4	7	80	0.0875000
NODE_7969_length_936_cov_57.105137	320	400	1	6	80	0.0750000
NODE_7969_length_936_cov_57.105137	320	400	2	14	80	0.1750000
NODE_7969_length_936_cov_57.105137	320	400	4	11	80	0.1375000
NODE_7969_length_936_cov_57.105137	320	400	5	3	80	0.0375000
NODE_7969_length_936_cov_57.105137	320	400	6	13	80	0.1625000
NODE_7969_length_936_cov_57.105137	320	400	7	5	80	0.0625000
NODE_7969_length_936_cov_57.105137	320	400	8	16	80	0.2000000
NODE_7969_length_936_cov_57.105137	320	400	9	12	80	0.1500000
NODE_7969_length_936_cov_57.105137	396	476	9	40	80	0.5000000
NODE_7969_length_936_cov_57.105137	396	476	10	40	80	0.5000000
NODE_7969_length_936_cov_57.105137	449	529	4	7	80	0.0875000
NODE_7969_length_936_cov_57.105137	449	529	5	5	80	0.0625000
NODE_7969_length_936_cov_57.105137	449	529	6	13	80	0.1625000
NODE_7969_length_936_cov_57.105137	449	529	7	16	80	0.2000000
NODE_7969_length_936_cov_57.105137	449	529	8	9	80	0.1125000
NODE_7969_length_936_cov_57.105137	449	529	9	4	80	0.0500000
NODE_7969_length_936_cov_57.105137	449	529	10	26	80	0.3250000
NODE_7970_length_936_cov_39.983274	433	513	9	5	80	0.0625000
NODE_7970_length_936_cov_39.983274	433	513	10	7	80	0.0875000
NODE_7970_length_936_cov_39.983274	433	513	11	15	80	0.1875000
NODE_7970_length_936_cov_39.983274	433	513	12	50	80	0.6250000
NODE_7970_length_936_cov_39.983274	433	513	14	3	80	0.0375000
NODE_7970_length_936_cov_39.983274	486	566	3	22	80	0.2750000
NODE_7970_length_936_cov_39.983274	486	566	4	20	80	0.2500000
NODE_7970_length_936_cov_39.983274	486	566	6	8	80	0.1000000
NODE_7970_length_936_cov_39.983274	486	566	8	2	80	0.0250000
NODE_7970_length_936_cov_39.983274	486	566	9	6	80	0.0750000
NODE_7970_length_936_cov_39.983274	486	566	11	6	80	0.0750000
NODE_7970_length_936_cov_39.983274	486	566	12	16	80	0.2000000
NODE_7971_length_936_cov_22.486260	534	614	1	80	80	1.0000000
NODE_7971_length_936_cov_22.486260	587	667	0	7	80	0.0875000
NODE_7971_length_936_cov_22.486260	587	667	1	73	80	0.9125000
NODE_7972_length_936_cov_19.639188	409	489	4	80	80	1.0000000
NODE_7972_length_936_cov_19.639188	462	542	1	5	80	0.0625000
NODE_7972_length_936_cov_19.639188	462	542	3	9	80	0.1125000
NODE_7972_length_936_cov_19.639188	462	542	4	66	80	0.8250000
NODE_7973_length_936_cov_15.083632	322	402	9	67	80	0.8375000
NODE_7973_length_936_cov_15.083632	322	402	11	13	80	0.1625000
NODE_7973_length_936_cov_15.083632	375	455	9	14	80	0.1750000
NODE_7973_length_936_cov_15.083632	375	455	11	35	80	0.4375000
NODE_7973_length_936_cov_15.083632	375	455	12	4	80	0.0500000
NODE_7973_length_936_cov_15.083632	375	455	13	1	80	0.0125000
NODE_7973_length_936_cov_15.083632	375	455	14	26	80	0.3250000
NODE_7974_length_936_cov_13.962963	356	424	0	68	68	1.0000000
NODE_7975_length_936_cov_12.502987	447	527	7	4	80	0.0500000
NODE_7975_length_936_cov_12.502987	447	527	8	19	80	0.2375000
NODE_7975_length_936_cov_12.502987	447	527	9	34	80	0.4250000
NODE_7975_length_936_cov_12.502987	447	527	10	23	80	0.2875000
NODE_7975_length_936_cov_12.502987	500	580	4	7	80	0.0875000
NODE_7975_length_936_cov_12.502987	500	580	5	2	80	0.0250000
NODE_7975_length_936_cov_12.502987	500	580	6	15	80	0.1875000
NODE_7975_length_936_cov_12.502987	500	580	7	27	80	0.3375000
NODE_7975_length_936_cov_12.502987	500	580	8	9	80	0.1125000
NODE_7975_length_936_cov_12.502987	500	580	9	17	80	0.2125000
NODE_7975_length_936_cov_12.502987	500	580	10	3	80	0.0375000
NODE_7976_length_936_cov_12.279570	340	420	3	80	80	1.0000000
NODE_7976_length_936_cov_12.279570	393	473	1	7	80	0.0875000
NODE_7976_length_936_cov_12.279570	393	473	2	26	80	0.3250000
NODE_7976_length_936_cov_12.279570	393	473	3	42	80	0.5250000
NODE_7976_length_936_cov_12.279570	393	473	4	5	80	0.0625000
NODE_7977_length_936_cov_7.906810	587	667	0	80	80	1.0000000
NODE_7977_length_936_cov_7.906810	640	720	0	80	80	1.0000000
NODE_7978_length_936_cov_6.845878	322	402	3	25	80	0.3125000
NODE_7978_length_936_cov_6.845878	322	402	4	48	80	0.6000000
NODE_7978_length_936_cov_6.845878	322	402	5	7	80	0.0875000
NODE_7978_length_936_cov_6.845878	375	455	3	48	80	0.6000000
NODE_7978_length_936_cov_6.845878	375	455	4	30	80	0.3750000
NODE_7978_length_936_cov_6.845878	375	455	5	2	80	0.0250000
NODE_7979_length_936_cov_6.434886	556	635	5	15	79	0.1898734
NODE_7979_length_936_cov_6.434886	556	635	6	2	79	0.0253165
NODE_7979_length_936_cov_6.434886	556	635	10	6	79	0.0759494
NODE_7979_length_936_cov_6.434886	556	635	11	46	79	0.5822785
NODE_7979_length_936_cov_6.434886	556	635	16	10	79	0.1265823
NODE_7979_length_936_cov_6.434886	608	688	11	17	80	0.2125000
NODE_7979_length_936_cov_6.434886	608	688	12	1	80	0.0125000
NODE_7979_length_936_cov_6.434886	608	688	14	23	80	0.2875000
NODE_7979_length_936_cov_6.434886	608	688	15	1	80	0.0125000
NODE_7979_length_936_cov_6.434886	608	688	16	13	80	0.1625000
NODE_7979_length_936_cov_6.434886	608	688	17	25	80	0.3125000
NODE_7993_length_935_cov_38.209330	57	137	4	80	80	1.0000000
NODE_7994_length_935_cov_27.306220	439	519	17	9	80	0.1125000
NODE_7994_length_935_cov_27.306220	439	519	18	1	80	0.0125000
NODE_7994_length_935_cov_27.306220	439	519	19	14	80	0.1750000
NODE_7994_length_935_cov_27.306220	439	519	21	21	80	0.2625000
NODE_7994_length_935_cov_27.306220	439	519	22	6	80	0.0750000
NODE_7994_length_935_cov_27.306220	439	519	23	15	80	0.1875000
NODE_7994_length_935_cov_27.306220	439	519	24	1	80	0.0125000
NODE_7994_length_935_cov_27.306220	439	519	25	1	80	0.0125000
NODE_7994_length_935_cov_27.306220	439	519	26	12	80	0.1500000
NODE_7994_length_935_cov_27.306220	492	572	19	7	80	0.0875000
NODE_7994_length_935_cov_27.306220	492	572	21	8	80	0.1000000
NODE_7994_length_935_cov_27.306220	492	572	22	16	80	0.2000000
NODE_7994_length_935_cov_27.306220	492	572	23	8	80	0.1000000
NODE_7994_length_935_cov_27.306220	492	572	24	5	80	0.0625000
NODE_7994_length_935_cov_27.306220	492	572	25	9	80	0.1125000
NODE_7994_length_935_cov_27.306220	492	572	26	27	80	0.3375000
NODE_7995_length_935_cov_26.562201	321	401	4	7	80	0.0875000
NODE_7995_length_935_cov_26.562201	321	401	5	38	80	0.4750000
NODE_7995_length_935_cov_26.562201	321	401	6	28	80	0.3500000
NODE_7995_length_935_cov_26.562201	321	401	7	7	80	0.0875000
NODE_7995_length_935_cov_26.562201	374	454	6	51	80	0.6375000
NODE_7995_length_935_cov_26.562201	374	454	7	19	80	0.2375000
NODE_7995_length_935_cov_26.562201	374	454	8	7	80	0.0875000
NODE_7995_length_935_cov_26.562201	374	454	9	3	80	0.0375000
NODE_7995_length_935_cov_26.562201	450	530	7	14	80	0.1750000
NODE_7995_length_935_cov_26.562201	450	530	8	17	80	0.2125000
NODE_7995_length_935_cov_26.562201	450	530	9	49	80	0.6125000
NODE_7995_length_935_cov_26.562201	503	583	4	1	80	0.0125000
NODE_7995_length_935_cov_26.562201	503	583	5	7	80	0.0875000
NODE_7995_length_935_cov_26.562201	503	583	7	59	80	0.7375000
NODE_7995_length_935_cov_26.562201	503	583	9	13	80	0.1625000
NODE_7996_length_935_cov_25.098086	356	436	1	1	80	0.0125000
NODE_7996_length_935_cov_25.098086	356	436	2	4	80	0.0500000
NODE_7996_length_935_cov_25.098086	356	436	3	44	80	0.5500000
NODE_7996_length_935_cov_25.098086	356	436	4	29	80	0.3625000
NODE_7996_length_935_cov_25.098086	356	436	6	2	80	0.0250000
NODE_7996_length_935_cov_25.098086	409	489	4	25	80	0.3125000
NODE_7996_length_935_cov_25.098086	409	489	5	15	80	0.1875000
NODE_7996_length_935_cov_25.098086	409	489	6	40	80	0.5000000
NODE_7997_length_935_cov_24.316986	467	547	0	80	80	1.0000000
NODE_7997_length_935_cov_24.316986	520	600	0	80	80	1.0000000
NODE_7998_length_935_cov_19.221292	397	477	15	11	80	0.1375000
NODE_7998_length_935_cov_19.221292	397	477	16	10	80	0.1250000
NODE_7998_length_935_cov_19.221292	397	477	17	8	80	0.1000000
NODE_7998_length_935_cov_19.221292	397	477	18	9	80	0.1125000
NODE_7998_length_935_cov_19.221292	397	477	19	13	80	0.1625000
NODE_7998_length_935_cov_19.221292	397	477	20	1	80	0.0125000
NODE_7998_length_935_cov_19.221292	397	477	22	1	80	0.0125000
NODE_7998_length_935_cov_19.221292	397	477	26	1	80	0.0125000
NODE_7998_length_935_cov_19.221292	397	477	27	2	80	0.0250000
NODE_7998_length_935_cov_19.221292	397	477	28	6	80	0.0750000
NODE_7998_length_935_cov_19.221292	397	477	30	18	80	0.2250000
NODE_7998_length_935_cov_19.221292	450	530	17	8	80	0.1000000
NODE_7998_length_935_cov_19.221292	450	530	18	46	80	0.5750000
NODE_7998_length_935_cov_19.221292	450	530	19	8	80	0.1000000
NODE_7998_length_935_cov_19.221292	450	530	20	1	80	0.0125000
NODE_7998_length_935_cov_19.221292	450	530	22	1	80	0.0125000
NODE_7998_length_935_cov_19.221292	450	530	26	1	80	0.0125000
NODE_7998_length_935_cov_19.221292	450	530	27	2	80	0.0250000
NODE_7998_length_935_cov_19.221292	450	530	28	5	80	0.0625000
NODE_7998_length_935_cov_19.221292	450	530	30	8	80	0.1000000
NODE_7999_length_935_cov_15.016746	404	484	0	80	80	1.0000000
NODE_7999_length_935_cov_15.016746	457	537	0	80	80	1.0000000
NODE_8000_length_935_cov_13.138756	341	421	0	80	80	1.0000000
NODE_8000_length_935_cov_13.138756	394	474	0	80	80	1.0000000
NODE_8002_length_935_cov_6.485646	512	592	0	23	80	0.2875000
NODE_8002_length_935_cov_6.485646	512	592	2	57	80	0.7125000
NODE_8002_length_935_cov_6.485646	565	645	0	76	80	0.9500000
NODE_8002_length_935_cov_6.485646	565	645	2	4	80	0.0500000
NODE_8003_length_935_cov_6.467703	250	330	3	44	80	0.5500000
NODE_8003_length_935_cov_6.467703	250	330	4	36	80	0.4500000
NODE_8003_length_935_cov_6.467703	303	383	1	9	80	0.1125000
NODE_8003_length_935_cov_6.467703	303	383	2	31	80	0.3875000
NODE_8003_length_935_cov_6.467703	303	383	3	29	80	0.3625000
NODE_8003_length_935_cov_6.467703	303	383	4	11	80	0.1375000
NODE_8004_length_935_cov_6.144737	478	558	0	3	80	0.0375000
NODE_8004_length_935_cov_6.144737	478	558	1	59	80	0.7375000
NODE_8004_length_935_cov_6.144737	478	558	2	18	80	0.2250000
NODE_8004_length_935_cov_6.144737	531	611	1	9	80	0.1125000
NODE_8004_length_935_cov_6.144737	531	611	2	71	80	0.8875000
NODE_8005_length_935_cov_3.905502	39	119	0	80	80	1.0000000
NODE_8005_length_935_cov_3.905502	92	166	0	74	74	1.0000000
NODE_8028_length_934_cov_22.898204	403	483	9	5	80	0.0625000
NODE_8028_length_934_cov_22.898204	403	483	10	46	80	0.5750000
NODE_8028_length_934_cov_22.898204	403	483	11	13	80	0.1625000
NODE_8028_length_934_cov_22.898204	403	483	13	16	80	0.2000000
NODE_8028_length_934_cov_22.898204	456	536	10	14	80	0.1750000
NODE_8028_length_934_cov_22.898204	456	536	11	21	80	0.2625000
NODE_8028_length_934_cov_22.898204	456	536	12	2	80	0.0250000
NODE_8028_length_934_cov_22.898204	456	536	13	22	80	0.2750000
NODE_8028_length_934_cov_22.898204	456	536	14	1	80	0.0125000
NODE_8028_length_934_cov_22.898204	456	536	15	20	80	0.2500000
NODE_8029_length_934_cov_17.746108	246	326	6	23	80	0.2875000
NODE_8029_length_934_cov_17.746108	246	326	7	57	80	0.7125000
NODE_8029_length_934_cov_17.746108	299	379	6	52	80	0.6500000
NODE_8029_length_934_cov_17.746108	299	379	7	21	80	0.2625000
NODE_8029_length_934_cov_17.746108	299	379	8	7	80	0.0875000
NODE_8030_length_934_cov_16.049102	367	447	0	80	80	1.0000000
NODE_8030_length_934_cov_16.049102	420	500	0	80	80	1.0000000
NODE_8031_length_934_cov_13.738922	379	459	0	80	80	1.0000000
NODE_8031_length_934_cov_13.738922	432	459	0	27	27	1.0000000
NODE_8031_length_934_cov_13.738922	470	512	0	42	42	1.0000000
NODE_8032_length_934_cov_9.091018	407	487	6	40	80	0.5000000
NODE_8032_length_934_cov_9.091018	407	487	7	33	80	0.4125000
NODE_8032_length_934_cov_9.091018	407	487	8	7	80	0.0875000
NODE_8032_length_934_cov_9.091018	460	540	4	20	80	0.2500000
NODE_8032_length_934_cov_9.091018	460	540	6	24	80	0.3000000
NODE_8032_length_934_cov_9.091018	460	540	7	36	80	0.4500000
NODE_8034_length_934_cov_5.349701	583	663	0	80	80	1.0000000
NODE_8050_length_933_cov_36.557554	462	542	4	4	80	0.0500000
NODE_8050_length_933_cov_36.557554	462	542	5	20	80	0.2500000
NODE_8050_length_933_cov_36.557554	462	542	6	56	80	0.7000000
NODE_8050_length_933_cov_36.557554	515	595	1	2	80	0.0250000
NODE_8050_length_933_cov_36.557554	515	595	2	5	80	0.0625000
NODE_8050_length_933_cov_36.557554	515	595	3	25	80	0.3125000
NODE_8050_length_933_cov_36.557554	515	595	4	25	80	0.3125000
NODE_8050_length_933_cov_36.557554	515	595	5	20	80	0.2500000
NODE_8050_length_933_cov_36.557554	515	595	6	3	80	0.0375000
NODE_8051_length_933_cov_27.645084	476	556	6	5	80	0.0625000
NODE_8051_length_933_cov_27.645084	476	556	8	64	80	0.8000000
NODE_8051_length_933_cov_27.645084	476	556	10	11	80	0.1375000
NODE_8051_length_933_cov_27.645084	529	609	2	5	80	0.0625000
NODE_8051_length_933_cov_27.645084	529	609	4	6	80	0.0750000
NODE_8051_length_933_cov_27.645084	529	609	6	8	80	0.1000000
NODE_8051_length_933_cov_27.645084	529	609	8	61	80	0.7625000
NODE_8052_length_933_cov_26.749400	611	691	0	32	80	0.4000000
NODE_8052_length_933_cov_26.749400	611	691	2	41	80	0.5125000
NODE_8052_length_933_cov_26.749400	611	691	4	7	80	0.0875000
NODE_8052_length_933_cov_26.749400	664	744	2	20	80	0.2500000
NODE_8052_length_933_cov_26.749400	664	744	4	60	80	0.7500000
NODE_8053_length_933_cov_26.308153	430	510	0	80	80	1.0000000
NODE_8053_length_933_cov_26.308153	483	563	0	80	80	1.0000000
NODE_8054_length_933_cov_19.966427	444	530	0	86	86	1.0000000
NODE_8054_length_933_cov_19.966427	497	583	0	86	86	1.0000000
NODE_8055_length_933_cov_16.870504	284	364	6	4	80	0.0500000
NODE_8055_length_933_cov_16.870504	284	364	8	35	80	0.4375000
NODE_8055_length_933_cov_16.870504	284	364	9	10	80	0.1250000
NODE_8055_length_933_cov_16.870504	284	364	15	31	80	0.3875000
NODE_8055_length_933_cov_16.870504	337	415	7	4	78	0.0512821
NODE_8055_length_933_cov_16.870504	337	415	9	8	78	0.1025641
NODE_8055_length_933_cov_16.870504	337	415	10	18	78	0.2307692
NODE_8055_length_933_cov_16.870504	337	415	11	1	78	0.0128205
NODE_8055_length_933_cov_16.870504	337	415	15	47	78	0.6025641
NODE_8056_length_933_cov_16.699041	366	446	4	20	80	0.2500000
NODE_8056_length_933_cov_16.699041	366	446	8	8	80	0.1000000
NODE_8056_length_933_cov_16.699041	366	446	10	29	80	0.3625000
NODE_8056_length_933_cov_16.699041	366	446	11	16	80	0.2000000
NODE_8056_length_933_cov_16.699041	366	446	12	7	80	0.0875000
NODE_8056_length_933_cov_16.699041	419	499	8	1	80	0.0125000
NODE_8056_length_933_cov_16.699041	419	499	9	1	80	0.0125000
NODE_8056_length_933_cov_16.699041	419	499	10	42	80	0.5250000
NODE_8056_length_933_cov_16.699041	419	499	11	29	80	0.3625000
NODE_8056_length_933_cov_16.699041	419	499	12	7	80	0.0875000
NODE_8057_length_933_cov_11.171463	197	277	11	2	80	0.0250000
NODE_8057_length_933_cov_11.171463	197	277	14	12	80	0.1500000
NODE_8057_length_933_cov_11.171463	197	277	16	30	80	0.3750000
NODE_8057_length_933_cov_11.171463	197	277	17	18	80	0.2250000
NODE_8057_length_933_cov_11.171463	197	277	20	18	80	0.2250000
NODE_8057_length_933_cov_11.171463	250	330	17	9	80	0.1125000
NODE_8057_length_933_cov_11.171463	250	330	20	71	80	0.8875000
NODE_8073_length_932_cov_26.656663	397	477	15	4	80	0.0500000
NODE_8073_length_932_cov_26.656663	397	477	16	9	80	0.1125000
NODE_8073_length_932_cov_26.656663	397	477	17	9	80	0.1125000
NODE_8073_length_932_cov_26.656663	397	477	18	26	80	0.3250000
NODE_8073_length_932_cov_26.656663	397	477	19	5	80	0.0625000
NODE_8073_length_932_cov_26.656663	397	477	20	23	80	0.2875000
NODE_8073_length_932_cov_26.656663	397	477	21	4	80	0.0500000
NODE_8073_length_932_cov_26.656663	450	530	8	5	80	0.0625000
NODE_8073_length_932_cov_26.656663	450	530	9	14	80	0.1750000
NODE_8073_length_932_cov_26.656663	450	530	11	1	80	0.0125000
NODE_8073_length_932_cov_26.656663	450	530	14	3	80	0.0375000
NODE_8073_length_932_cov_26.656663	450	530	15	34	80	0.4250000
NODE_8073_length_932_cov_26.656663	450	530	16	9	80	0.1125000
NODE_8073_length_932_cov_26.656663	450	530	17	9	80	0.1125000
NODE_8073_length_932_cov_26.656663	450	530	18	1	80	0.0125000
NODE_8073_length_932_cov_26.656663	450	530	20	1	80	0.0125000
NODE_8073_length_932_cov_26.656663	450	530	21	3	80	0.0375000
NODE_8074_length_932_cov_16.581032	407	485	4	17	78	0.2179487
NODE_8074_length_932_cov_16.581032	407	485	5	9	78	0.1153846
NODE_8074_length_932_cov_16.581032	407	485	6	21	78	0.2692308
NODE_8074_length_932_cov_16.581032	407	485	7	19	78	0.2435897
NODE_8074_length_932_cov_16.581032	407	485	8	5	78	0.0641026
NODE_8074_length_932_cov_16.581032	407	485	9	7	78	0.0897436
NODE_8074_length_932_cov_16.581032	460	538	6	11	78	0.1410256
NODE_8074_length_932_cov_16.581032	460	538	7	2	78	0.0256410
NODE_8074_length_932_cov_16.581032	460	538	8	58	78	0.7435898
NODE_8074_length_932_cov_16.581032	460	538	9	7	78	0.0897436
NODE_8075_length_932_cov_13.462185	413	493	4	2	80	0.0250000
NODE_8075_length_932_cov_13.462185	413	493	5	1	80	0.0125000
NODE_8075_length_932_cov_13.462185	413	493	7	28	80	0.3500000
NODE_8075_length_932_cov_13.462185	413	493	8	49	80	0.6125000
NODE_8075_length_932_cov_13.462185	466	546	1	10	80	0.1250000
NODE_8075_length_932_cov_13.462185	466	546	3	1	80	0.0125000
NODE_8075_length_932_cov_13.462185	466	546	4	44	80	0.5500000
NODE_8075_length_932_cov_13.462185	466	546	5	1	80	0.0125000
NODE_8075_length_932_cov_13.462185	466	546	7	24	80	0.3000000
NODE_8076_length_932_cov_13.442977	386	466	3	18	80	0.2250000
NODE_8076_length_932_cov_13.442977	386	466	4	10	80	0.1250000
NODE_8076_length_932_cov_13.442977	386	466	5	52	80	0.6500000
NODE_8076_length_932_cov_13.442977	439	519	4	21	80	0.2625000
NODE_8076_length_932_cov_13.442977	439	519	5	22	80	0.2750000
NODE_8076_length_932_cov_13.442977	439	519	6	37	80	0.4625000
NODE_8077_length_932_cov_11.947179	344	424	0	80	80	1.0000000
NODE_8077_length_932_cov_11.947179	397	477	0	80	80	1.0000000
NODE_8079_length_932_cov_10.849940	409	489	0	3	80	0.0375000
NODE_8079_length_932_cov_10.849940	409	489	1	77	80	0.9625000
NODE_8079_length_932_cov_10.849940	462	542	0	17	80	0.2125000
NODE_8079_length_932_cov_10.849940	462	542	1	63	80	0.7875000
NODE_8080_length_932_cov_10.174070	342	422	2	9	80	0.1125000
NODE_8080_length_932_cov_10.174070	342	422	4	11	80	0.1375000
NODE_8080_length_932_cov_10.174070	342	422	6	60	80	0.7500000
NODE_8080_length_932_cov_10.174070	395	475	4	19	80	0.2375000
NODE_8080_length_932_cov_10.174070	395	475	6	61	80	0.7625000
NODE_8082_length_932_cov_9.200480	184	264	1	41	80	0.5125000
NODE_8082_length_932_cov_9.200480	184	264	2	38	80	0.4750000
NODE_8082_length_932_cov_9.200480	184	264	3	1	80	0.0125000
NODE_8082_length_932_cov_9.200480	237	317	1	21	80	0.2625000
NODE_8082_length_932_cov_9.200480	237	317	2	9	80	0.1125000
NODE_8082_length_932_cov_9.200480	237	317	3	50	80	0.6250000
NODE_8090_length_932_cov_2.689076	598	676	0	78	78	1.0000000
NODE_8090_length_932_cov_2.689076	798	845	0	47	47	1.0000000
NODE_8103_length_931_cov_51.451923	320	400	8	17	80	0.2125000
NODE_8103_length_931_cov_51.451923	320	400	10	14	80	0.1750000
NODE_8103_length_931_cov_51.451923	320	400	12	9	80	0.1125000
NODE_8103_length_931_cov_51.451923	320	400	13	20	80	0.2500000
NODE_8103_length_931_cov_51.451923	320	400	14	20	80	0.2500000
NODE_8103_length_931_cov_51.451923	373	453	6	12	80	0.1500000
NODE_8103_length_931_cov_51.451923	373	453	7	13	80	0.1625000
NODE_8103_length_931_cov_51.451923	373	453	8	18	80	0.2250000
NODE_8103_length_931_cov_51.451923	373	453	9	2	80	0.0250000
NODE_8103_length_931_cov_51.451923	373	453	11	7	80	0.0875000
NODE_8103_length_931_cov_51.451923	373	453	12	9	80	0.1125000
NODE_8103_length_931_cov_51.451923	373	453	13	19	80	0.2375000
NODE_8104_length_931_cov_46.621394	527	607	35	37	80	0.4625000
NODE_8104_length_931_cov_46.621394	527	607	36	1	80	0.0125000
NODE_8104_length_931_cov_46.621394	527	607	37	2	80	0.0250000
NODE_8104_length_931_cov_46.621394	527	607	40	2	80	0.0250000
NODE_8104_length_931_cov_46.621394	527	607	41	2	80	0.0250000
NODE_8104_length_931_cov_46.621394	527	607	42	8	80	0.1000000
NODE_8104_length_931_cov_46.621394	527	607	43	14	80	0.1750000
NODE_8104_length_931_cov_46.621394	527	607	44	11	80	0.1375000
NODE_8104_length_931_cov_46.621394	527	607	45	2	80	0.0250000
NODE_8104_length_931_cov_46.621394	527	607	46	1	80	0.0125000
NODE_8104_length_931_cov_46.621394	580	660	35	14	80	0.1750000
NODE_8104_length_931_cov_46.621394	580	660	36	1	80	0.0125000
NODE_8104_length_931_cov_46.621394	580	660	40	1	80	0.0125000
NODE_8104_length_931_cov_46.621394	580	660	41	2	80	0.0250000
NODE_8104_length_931_cov_46.621394	580	660	42	14	80	0.1750000
NODE_8104_length_931_cov_46.621394	580	660	43	9	80	0.1125000
NODE_8104_length_931_cov_46.621394	580	660	45	4	80	0.0500000
NODE_8104_length_931_cov_46.621394	580	660	46	11	80	0.1375000
NODE_8104_length_931_cov_46.621394	580	660	47	1	80	0.0125000
NODE_8104_length_931_cov_46.621394	580	660	50	5	80	0.0625000
NODE_8104_length_931_cov_46.621394	580	660	52	3	80	0.0375000
NODE_8104_length_931_cov_46.621394	580	660	53	1	80	0.0125000
NODE_8104_length_931_cov_46.621394	580	660	54	7	80	0.0875000
NODE_8104_length_931_cov_46.621394	580	660	55	2	80	0.0250000
NODE_8104_length_931_cov_46.621394	580	660	57	1	80	0.0125000
NODE_8104_length_931_cov_46.621394	580	660	59	4	80	0.0500000
NODE_8105_length_931_cov_36.334135	347	427	2	10	80	0.1250000
NODE_8105_length_931_cov_36.334135	347	427	3	20	80	0.2500000
NODE_8105_length_931_cov_36.334135	347	427	4	25	80	0.3125000
NODE_8105_length_931_cov_36.334135	347	427	5	25	80	0.3125000
NODE_8105_length_931_cov_36.334135	400	480	3	2	80	0.0250000
NODE_8105_length_931_cov_36.334135	400	480	4	4	80	0.0500000
NODE_8105_length_931_cov_36.334135	400	480	5	74	80	0.9250000
NODE_8106_length_931_cov_32.495192	482	562	3	2	80	0.0250000
NODE_8106_length_931_cov_32.495192	482	562	4	78	80	0.9750000
NODE_8106_length_931_cov_32.495192	535	617	0	9	82	0.1097561
NODE_8106_length_931_cov_32.495192	535	617	2	37	82	0.4512195
NODE_8106_length_931_cov_32.495192	535	617	3	11	82	0.1341463
NODE_8106_length_931_cov_32.495192	535	617	4	25	82	0.3048781
NODE_8107_length_931_cov_22.100962	375	455	9	13	80	0.1625000
NODE_8107_length_931_cov_22.100962	375	455	10	16	80	0.2000000
NODE_8107_length_931_cov_22.100962	375	455	11	27	80	0.3375000
NODE_8107_length_931_cov_22.100962	375	455	12	24	80	0.3000000
NODE_8107_length_931_cov_22.100962	428	508	4	13	80	0.1625000
NODE_8107_length_931_cov_22.100962	428	508	6	36	80	0.4500000
NODE_8107_length_931_cov_22.100962	428	508	8	1	80	0.0125000
NODE_8107_length_931_cov_22.100962	428	508	9	16	80	0.2000000
NODE_8107_length_931_cov_22.100962	428	508	11	4	80	0.0500000
NODE_8107_length_931_cov_22.100962	428	508	12	10	80	0.1250000
NODE_8108_length_931_cov_21.781250	347	427	12	37	80	0.4625000
NODE_8108_length_931_cov_21.781250	347	427	13	9	80	0.1125000
NODE_8108_length_931_cov_21.781250	347	427	14	1	80	0.0125000
NODE_8108_length_931_cov_21.781250	347	427	16	2	80	0.0250000
NODE_8108_length_931_cov_21.781250	347	427	17	6	80	0.0750000
NODE_8108_length_931_cov_21.781250	347	427	18	12	80	0.1500000
NODE_8108_length_931_cov_21.781250	347	427	19	1	80	0.0125000
NODE_8108_length_931_cov_21.781250	347	427	20	12	80	0.1500000
NODE_8108_length_931_cov_21.781250	400	480	12	41	80	0.5125000
NODE_8108_length_931_cov_21.781250	400	480	13	27	80	0.3375000
NODE_8108_length_931_cov_21.781250	400	480	14	4	80	0.0500000
NODE_8108_length_931_cov_21.781250	400	480	19	1	80	0.0125000
NODE_8108_length_931_cov_21.781250	400	480	20	7	80	0.0875000
NODE_8109_length_931_cov_19.084135	411	491	10	8	80	0.1000000
NODE_8109_length_931_cov_19.084135	411	491	11	2	80	0.0250000
NODE_8109_length_931_cov_19.084135	411	491	12	4	80	0.0500000
NODE_8109_length_931_cov_19.084135	411	491	14	11	80	0.1375000
NODE_8109_length_931_cov_19.084135	411	491	15	27	80	0.3375000
NODE_8109_length_931_cov_19.084135	411	491	16	18	80	0.2250000
NODE_8109_length_931_cov_19.084135	411	491	17	10	80	0.1250000
NODE_8109_length_931_cov_19.084135	464	544	5	11	80	0.1375000
NODE_8109_length_931_cov_19.084135	464	544	7	28	80	0.3500000
NODE_8109_length_931_cov_19.084135	464	544	8	7	80	0.0875000
NODE_8109_length_931_cov_19.084135	464	544	10	15	80	0.1875000
NODE_8109_length_931_cov_19.084135	464	544	11	2	80	0.0250000
NODE_8109_length_931_cov_19.084135	464	544	12	4	80	0.0500000
NODE_8109_length_931_cov_19.084135	464	544	14	11	80	0.1375000
NODE_8109_length_931_cov_19.084135	464	544	16	2	80	0.0250000
NODE_8110_length_931_cov_14.879808	444	524	2	1	80	0.0125000
NODE_8110_length_931_cov_14.879808	444	524	3	1	80	0.0125000
NODE_8110_length_931_cov_14.879808	444	524	4	29	80	0.3625000
NODE_8110_length_931_cov_14.879808	444	524	6	2	80	0.0250000
NODE_8110_length_931_cov_14.879808	444	524	7	36	80	0.4500000
NODE_8110_length_931_cov_14.879808	444	524	9	11	80	0.1375000
NODE_8110_length_931_cov_14.879808	497	577	7	32	80	0.4000000
NODE_8110_length_931_cov_14.879808	497	577	8	2	80	0.0250000
NODE_8110_length_931_cov_14.879808	497	577	9	46	80	0.5750000
NODE_8111_length_931_cov_13.087740	759	800	0	41	41	1.0000000
NODE_8112_length_931_cov_10.534856	399	479	1	20	80	0.2500000
NODE_8112_length_931_cov_10.534856	399	479	2	56	80	0.7000000
NODE_8112_length_931_cov_10.534856	399	479	3	4	80	0.0500000
NODE_8112_length_931_cov_10.534856	452	532	1	20	80	0.2500000
NODE_8112_length_931_cov_10.534856	452	532	2	8	80	0.1000000
NODE_8112_length_931_cov_10.534856	452	532	3	52	80	0.6500000
NODE_8113_length_931_cov_9.865385	236	316	1	5	80	0.0625000
NODE_8113_length_931_cov_9.865385	236	316	5	11	80	0.1375000
NODE_8113_length_931_cov_9.865385	236	316	7	4	80	0.0500000
NODE_8113_length_931_cov_9.865385	236	316	8	29	80	0.3625000
NODE_8113_length_931_cov_9.865385	236	316	9	20	80	0.2500000
NODE_8113_length_931_cov_9.865385	236	316	11	11	80	0.1375000
NODE_8113_length_931_cov_9.865385	289	369	9	16	80	0.2000000
NODE_8113_length_931_cov_9.865385	289	369	11	22	80	0.2750000
NODE_8113_length_931_cov_9.865385	289	369	12	42	80	0.5250000
NODE_8115_length_931_cov_6.201923	479	559	0	75	80	0.9375000
NODE_8115_length_931_cov_6.201923	479	559	1	5	80	0.0625000
NODE_8115_length_931_cov_6.201923	532	612	0	22	80	0.2750000
NODE_8115_length_931_cov_6.201923	532	612	1	28	80	0.3500000
NODE_8115_length_931_cov_6.201923	532	612	2	30	80	0.3750000
NODE_8124_length_931_cov_1.780048	832	902	0	70	70	1.0000000
NODE_8126_length_931_cov_1.433894	220	284	0	64	64	1.0000000
NODE_8131_length_930_cov_49.052948	252	332	7	17	80	0.2125000
NODE_8131_length_930_cov_49.052948	252	332	9	12	80	0.1500000
NODE_8131_length_930_cov_49.052948	252	332	10	6	80	0.0750000
NODE_8131_length_930_cov_49.052948	252	332	12	15	80	0.1875000
NODE_8131_length_930_cov_49.052948	252	332	13	13	80	0.1625000
NODE_8131_length_930_cov_49.052948	252	332	14	17	80	0.2125000
NODE_8131_length_930_cov_49.052948	305	385	13	10	80	0.1250000
NODE_8131_length_930_cov_49.052948	305	385	14	22	80	0.2750000
NODE_8131_length_930_cov_49.052948	305	385	16	8	80	0.1000000
NODE_8131_length_930_cov_49.052948	305	385	17	1	80	0.0125000
NODE_8131_length_930_cov_49.052948	305	385	19	2	80	0.0250000
NODE_8131_length_930_cov_49.052948	305	385	20	12	80	0.1500000
NODE_8131_length_930_cov_49.052948	305	385	21	9	80	0.1125000
NODE_8131_length_930_cov_49.052948	305	385	22	1	80	0.0125000
NODE_8131_length_930_cov_49.052948	305	385	25	15	80	0.1875000
NODE_8131_length_930_cov_49.052948	381	462	22	3	81	0.0370370
NODE_8131_length_930_cov_49.052948	381	462	23	9	81	0.1111111
NODE_8131_length_930_cov_49.052948	381	462	24	7	81	0.0864198
NODE_8131_length_930_cov_49.052948	381	462	25	27	81	0.3333333
NODE_8131_length_930_cov_49.052948	381	462	26	22	81	0.2716049
NODE_8131_length_930_cov_49.052948	381	462	27	13	81	0.1604938
NODE_8131_length_930_cov_49.052948	435	515	15	1	80	0.0125000
NODE_8131_length_930_cov_49.052948	435	515	16	11	80	0.1375000
NODE_8131_length_930_cov_49.052948	435	515	17	5	80	0.0625000
NODE_8131_length_930_cov_49.052948	435	515	18	1	80	0.0125000
NODE_8131_length_930_cov_49.052948	435	515	20	2	80	0.0250000
NODE_8131_length_930_cov_49.052948	435	515	21	15	80	0.1875000
NODE_8131_length_930_cov_49.052948	435	515	22	19	80	0.2375000
NODE_8131_length_930_cov_49.052948	435	515	23	11	80	0.1375000
NODE_8131_length_930_cov_49.052948	435	515	25	13	80	0.1625000
NODE_8131_length_930_cov_49.052948	435	515	27	2	80	0.0250000
NODE_8132_length_930_cov_31.510229	400	482	11	3	82	0.0365854
NODE_8132_length_930_cov_31.510229	400	482	12	2	82	0.0243902
NODE_8132_length_930_cov_31.510229	400	482	13	5	82	0.0609756
NODE_8132_length_930_cov_31.510229	400	482	14	17	82	0.2073171
NODE_8132_length_930_cov_31.510229	400	482	15	1	82	0.0121951
NODE_8132_length_930_cov_31.510229	400	482	16	8	82	0.0975610
NODE_8132_length_930_cov_31.510229	400	482	17	5	82	0.0609756
NODE_8132_length_930_cov_31.510229	400	482	18	11	82	0.1341463
NODE_8132_length_930_cov_31.510229	400	482	19	26	82	0.3170732
NODE_8132_length_930_cov_31.510229	400	482	21	4	82	0.0487805
NODE_8132_length_930_cov_31.510229	453	535	8	1	82	0.0121951
NODE_8132_length_930_cov_31.510229	453	535	9	10	82	0.1219512
NODE_8132_length_930_cov_31.510229	453	535	10	10	82	0.1219512
NODE_8132_length_930_cov_31.510229	453	535	11	23	82	0.2804878
NODE_8132_length_930_cov_31.510229	453	535	12	9	82	0.1097561
NODE_8132_length_930_cov_31.510229	453	535	13	10	82	0.1219512
NODE_8132_length_930_cov_31.510229	453	535	14	17	82	0.2073171
NODE_8132_length_930_cov_31.510229	453	535	15	1	82	0.0121951
NODE_8132_length_930_cov_31.510229	453	535	16	1	82	0.0121951
NODE_8133_length_930_cov_29.139591	329	409	1	3	80	0.0375000
NODE_8133_length_930_cov_29.139591	329	409	4	77	80	0.9625000
NODE_8133_length_930_cov_29.139591	382	462	4	67	80	0.8375000
NODE_8133_length_930_cov_29.139591	382	462	7	13	80	0.1625000
NODE_8134_length_930_cov_24.787004	518	598	0	80	80	1.0000000
NODE_8134_length_930_cov_24.787004	571	651	0	80	80	1.0000000
NODE_8135_length_930_cov_24.608905	300	380	0	15	80	0.1875000
NODE_8135_length_930_cov_24.608905	300	380	2	16	80	0.2000000
NODE_8135_length_930_cov_24.608905	300	380	4	49	80	0.6125000
NODE_8135_length_930_cov_24.608905	353	433	0	68	80	0.8500000
NODE_8135_length_930_cov_24.608905	353	433	2	12	80	0.1500000
NODE_8136_length_930_cov_16.494585	482	562	4	33	80	0.4125000
NODE_8136_length_930_cov_16.494585	482	562	5	32	80	0.4000000
NODE_8136_length_930_cov_16.494585	482	562	6	15	80	0.1875000
NODE_8136_length_930_cov_16.494585	535	615	3	20	80	0.2500000
NODE_8136_length_930_cov_16.494585	535	615	4	54	80	0.6750000
NODE_8136_length_930_cov_16.494585	535	615	5	6	80	0.0750000
NODE_8137_length_930_cov_13.296029	249	329	0	44	80	0.5500000
NODE_8137_length_930_cov_13.296029	249	329	1	8	80	0.1000000
NODE_8137_length_930_cov_13.296029	249	329	2	6	80	0.0750000
NODE_8137_length_930_cov_13.296029	249	329	3	22	80	0.2750000
NODE_8137_length_930_cov_13.296029	302	382	2	5	80	0.0625000
NODE_8137_length_930_cov_13.296029	302	382	3	32	80	0.4000000
NODE_8137_length_930_cov_13.296029	302	382	4	43	80	0.5375000
NODE_8137_length_930_cov_13.296029	378	458	1	1	80	0.0125000
NODE_8137_length_930_cov_13.296029	378	458	2	6	80	0.0750000
NODE_8137_length_930_cov_13.296029	378	458	3	8	80	0.1000000
NODE_8137_length_930_cov_13.296029	378	458	4	65	80	0.8125000
NODE_8137_length_930_cov_13.296029	431	511	0	22	80	0.2750000
NODE_8137_length_930_cov_13.296029	431	511	1	32	80	0.4000000
NODE_8137_length_930_cov_13.296029	431	511	2	6	80	0.0750000
NODE_8137_length_930_cov_13.296029	431	511	3	8	80	0.1000000
NODE_8137_length_930_cov_13.296029	431	511	4	12	80	0.1500000
NODE_8138_length_930_cov_11.758123	463	543	8	2	80	0.0250000
NODE_8138_length_930_cov_11.758123	463	543	10	6	80	0.0750000
NODE_8138_length_930_cov_11.758123	463	543	12	72	80	0.9000000
NODE_8138_length_930_cov_11.758123	516	596	8	55	80	0.6875000
NODE_8138_length_930_cov_11.758123	516	596	10	2	80	0.0250000
NODE_8138_length_930_cov_11.758123	516	596	12	23	80	0.2875000
NODE_8139_length_930_cov_7.576414	531	611	1	49	80	0.6125000
NODE_8139_length_930_cov_7.576414	531	611	2	31	80	0.3875000
NODE_8139_length_930_cov_7.576414	584	664	2	80	80	1.0000000
NODE_8156_length_930_cov_0.821901	676	736	0	60	60	1.0000000
NODE_8157_length_929_cov_54.485542	313	393	10	4	80	0.0500000
NODE_8157_length_929_cov_54.485542	313	393	11	16	80	0.2000000
NODE_8157_length_929_cov_54.485542	313	393	12	12	80	0.1500000
NODE_8157_length_929_cov_54.485542	313	393	13	9	80	0.1125000
NODE_8157_length_929_cov_54.485542	313	393	14	10	80	0.1250000
NODE_8157_length_929_cov_54.485542	313	393	15	29	80	0.3625000
NODE_8157_length_929_cov_54.485542	366	446	6	6	80	0.0750000
NODE_8157_length_929_cov_54.485542	366	446	10	23	80	0.2875000
NODE_8157_length_929_cov_54.485542	366	446	11	33	80	0.4125000
NODE_8157_length_929_cov_54.485542	366	446	12	18	80	0.2250000
NODE_8157_length_929_cov_54.485542	442	522	4	8	80	0.1000000
NODE_8157_length_929_cov_54.485542	442	522	5	21	80	0.2625000
NODE_8157_length_929_cov_54.485542	442	522	6	40	80	0.5000000
NODE_8157_length_929_cov_54.485542	442	522	7	10	80	0.1250000
NODE_8157_length_929_cov_54.485542	442	522	8	1	80	0.0125000
NODE_8157_length_929_cov_54.485542	495	575	6	40	80	0.5000000
NODE_8157_length_929_cov_54.485542	495	575	7	39	80	0.4875000
NODE_8157_length_929_cov_54.485542	495	575	8	1	80	0.0125000
NODE_8158_length_929_cov_49.865060	429	509	0	31	80	0.3875000
NODE_8158_length_929_cov_49.865060	429	509	2	26	80	0.3250000
NODE_8158_length_929_cov_49.865060	429	509	3	23	80	0.2875000
NODE_8158_length_929_cov_49.865060	482	562	2	14	80	0.1750000
NODE_8158_length_929_cov_49.865060	482	562	3	46	80	0.5750000
NODE_8158_length_929_cov_49.865060	482	562	4	20	80	0.2500000
NODE_8159_length_929_cov_34.634940	358	438	7	11	80	0.1375000
NODE_8159_length_929_cov_34.634940	358	438	9	69	80	0.8625000
NODE_8159_length_929_cov_34.634940	411	491	1	15	80	0.1875000
NODE_8159_length_929_cov_34.634940	411	491	6	18	80	0.2250000
NODE_8159_length_929_cov_34.634940	411	491	7	31	80	0.3875000
NODE_8159_length_929_cov_34.634940	411	491	9	16	80	0.2000000
NODE_8161_length_929_cov_20.815663	365	445	10	6	80	0.0750000
NODE_8161_length_929_cov_20.815663	365	445	11	9	80	0.1125000
NODE_8161_length_929_cov_20.815663	365	445	12	57	80	0.7125000
NODE_8161_length_929_cov_20.815663	365	445	13	8	80	0.1000000
NODE_8161_length_929_cov_20.815663	418	498	8	28	80	0.3500000
NODE_8161_length_929_cov_20.815663	418	498	9	1	80	0.0125000
NODE_8161_length_929_cov_20.815663	418	498	10	19	80	0.2375000
NODE_8161_length_929_cov_20.815663	418	498	11	2	80	0.0250000
NODE_8161_length_929_cov_20.815663	418	498	12	30	80	0.3750000
NODE_8162_length_929_cov_17.798795	376	456	0	30	80	0.3750000
NODE_8162_length_929_cov_17.798795	376	456	1	1	80	0.0125000
NODE_8162_length_929_cov_17.798795	376	456	2	49	80	0.6125000
NODE_8162_length_929_cov_17.798795	429	509	2	80	80	1.0000000
NODE_8163_length_929_cov_16.622892	331	408	2	57	77	0.7402598
NODE_8163_length_929_cov_16.622892	331	408	3	20	77	0.2597403
NODE_8163_length_929_cov_16.622892	381	461	2	7	80	0.0875000
NODE_8163_length_929_cov_16.622892	381	461	3	65	80	0.8125000
NODE_8163_length_929_cov_16.622892	381	461	5	8	80	0.1000000
NODE_8163_length_929_cov_16.622892	457	537	5	4	80	0.0500000
NODE_8163_length_929_cov_16.622892	457	537	6	15	80	0.1875000
NODE_8163_length_929_cov_16.622892	457	537	8	9	80	0.1125000
NODE_8163_length_929_cov_16.622892	457	537	9	27	80	0.3375000
NODE_8163_length_929_cov_16.622892	457	537	10	2	80	0.0250000
NODE_8163_length_929_cov_16.622892	457	537	11	23	80	0.2875000
NODE_8163_length_929_cov_16.622892	510	590	7	7	80	0.0875000
NODE_8163_length_929_cov_16.622892	510	590	9	6	80	0.0750000
NODE_8163_length_929_cov_16.622892	510	590	10	22	80	0.2750000
NODE_8163_length_929_cov_16.622892	510	590	11	45	80	0.5625000
NODE_8164_length_929_cov_15.242169	302	382	0	1	80	0.0125000
NODE_8164_length_929_cov_15.242169	302	382	2	79	80	0.9875000
NODE_8164_length_929_cov_15.242169	355	435	0	1	80	0.0125000
NODE_8164_length_929_cov_15.242169	355	435	2	79	80	0.9875000
NODE_8164_length_929_cov_15.242169	431	511	2	45	80	0.5625000
NODE_8164_length_929_cov_15.242169	431	511	3	22	80	0.2750000
NODE_8164_length_929_cov_15.242169	431	511	4	13	80	0.1625000
NODE_8164_length_929_cov_15.242169	484	564	2	10	80	0.1250000
NODE_8164_length_929_cov_15.242169	484	564	3	14	80	0.1750000
NODE_8164_length_929_cov_15.242169	484	564	4	56	80	0.7000000
NODE_8165_length_929_cov_13.197590	259	339	0	25	80	0.3125000
NODE_8165_length_929_cov_13.197590	259	339	1	20	80	0.2500000
NODE_8165_length_929_cov_13.197590	259	339	2	35	80	0.4375000
NODE_8165_length_929_cov_13.197590	312	392	2	80	80	1.0000000
NODE_8167_length_929_cov_7.766265	385	465	0	80	80	1.0000000
NODE_8167_length_929_cov_7.766265	438	518	0	80	80	1.0000000
NODE_8168_length_929_cov_5.750602	382	462	6	14	80	0.1750000
NODE_8168_length_929_cov_5.750602	382	462	7	59	80	0.7375000
NODE_8168_length_929_cov_5.750602	382	462	8	7	80	0.0875000
NODE_8168_length_929_cov_5.750602	435	515	3	18	80	0.2250000
NODE_8168_length_929_cov_5.750602	435	515	6	25	80	0.3125000
NODE_8168_length_929_cov_5.750602	435	515	7	15	80	0.1875000
NODE_8168_length_929_cov_5.750602	435	515	8	22	80	0.2750000
NODE_8181_length_928_cov_35.226779	273	353	2	80	80	1.0000000
NODE_8181_length_928_cov_35.226779	326	406	0	16	80	0.2000000
NODE_8181_length_928_cov_35.226779	326	406	2	64	80	0.8000000
NODE_8181_length_928_cov_35.226779	402	482	0	80	80	1.0000000
NODE_8181_length_928_cov_35.226779	455	535	0	80	80	1.0000000
NODE_8182_length_928_cov_25.218335	299	379	5	51	80	0.6375000
NODE_8182_length_928_cov_25.218335	299	379	7	12	80	0.1500000
NODE_8182_length_928_cov_25.218335	299	379	9	17	80	0.2125000
NODE_8182_length_928_cov_25.218335	352	432	7	10	80	0.1250000
NODE_8182_length_928_cov_25.218335	352	432	8	16	80	0.2000000
NODE_8182_length_928_cov_25.218335	352	432	9	27	80	0.3375000
NODE_8182_length_928_cov_25.218335	352	432	11	27	80	0.3375000
NODE_8183_length_928_cov_22.815440	342	422	7	5	80	0.0625000
NODE_8183_length_928_cov_22.815440	342	422	8	23	80	0.2875000
NODE_8183_length_928_cov_22.815440	342	422	11	32	80	0.4000000
NODE_8183_length_928_cov_22.815440	342	422	12	20	80	0.2500000
NODE_8183_length_928_cov_22.815440	395	475	10	12	80	0.1500000
NODE_8183_length_928_cov_22.815440	395	475	11	29	80	0.3625000
NODE_8183_length_928_cov_22.815440	395	475	12	39	80	0.4875000
NODE_8183_length_928_cov_22.815440	471	551	12	13	80	0.1625000
NODE_8183_length_928_cov_22.815440	471	551	13	2	80	0.0250000
NODE_8183_length_928_cov_22.815440	471	551	15	14	80	0.1750000
NODE_8183_length_928_cov_22.815440	471	551	16	33	80	0.4125000
NODE_8183_length_928_cov_22.815440	471	551	17	5	80	0.0625000
NODE_8183_length_928_cov_22.815440	471	551	18	12	80	0.1500000
NODE_8183_length_928_cov_22.815440	471	551	19	1	80	0.0125000
NODE_8183_length_928_cov_22.815440	524	604	12	3	80	0.0375000
NODE_8183_length_928_cov_22.815440	524	604	13	2	80	0.0250000
NODE_8183_length_928_cov_22.815440	524	604	14	15	80	0.1875000
NODE_8183_length_928_cov_22.815440	524	604	15	33	80	0.4125000
NODE_8183_length_928_cov_22.815440	524	604	16	27	80	0.3375000
NODE_8184_length_928_cov_20.718938	365	445	18	4	80	0.0500000
NODE_8184_length_928_cov_20.718938	365	445	19	7	80	0.0875000
NODE_8184_length_928_cov_20.718938	365	445	20	9	80	0.1125000
NODE_8184_length_928_cov_20.718938	365	445	21	25	80	0.3125000
NODE_8184_length_928_cov_20.718938	365	445	22	17	80	0.2125000
NODE_8184_length_928_cov_20.718938	365	445	24	4	80	0.0500000
NODE_8184_length_928_cov_20.718938	365	445	25	14	80	0.1750000
NODE_8184_length_928_cov_20.718938	418	498	14	8	80	0.1000000
NODE_8184_length_928_cov_20.718938	418	498	17	1	80	0.0125000
NODE_8184_length_928_cov_20.718938	418	498	20	2	80	0.0250000
NODE_8184_length_928_cov_20.718938	418	498	21	19	80	0.2375000
NODE_8184_length_928_cov_20.718938	418	498	22	8	80	0.1000000
NODE_8184_length_928_cov_20.718938	418	498	23	9	80	0.1125000
NODE_8184_length_928_cov_20.718938	418	498	24	10	80	0.1250000
NODE_8184_length_928_cov_20.718938	418	498	25	23	80	0.2875000
NODE_8185_length_928_cov_19.418577	420	500	2	11	80	0.1375000
NODE_8185_length_928_cov_19.418577	420	500	3	55	80	0.6875000
NODE_8185_length_928_cov_19.418577	420	500	4	5	80	0.0625000
NODE_8185_length_928_cov_19.418577	420	500	5	5	80	0.0625000
NODE_8185_length_928_cov_19.418577	420	500	6	4	80	0.0500000
NODE_8185_length_928_cov_19.418577	473	553	3	13	80	0.1625000
NODE_8185_length_928_cov_19.418577	473	553	4	5	80	0.0625000
NODE_8185_length_928_cov_19.418577	473	553	5	5	80	0.0625000
NODE_8185_length_928_cov_19.418577	473	553	6	57	80	0.7125000
NODE_8185_length_928_cov_19.418577	549	591	4	10	42	0.2380952
NODE_8185_length_928_cov_19.418577	549	591	5	12	42	0.2857143
NODE_8185_length_928_cov_19.418577	549	591	6	20	42	0.4761905
NODE_8186_length_928_cov_13.354644	323	403	13	21	80	0.2625000
NODE_8186_length_928_cov_13.354644	323	403	15	36	80	0.4500000
NODE_8186_length_928_cov_13.354644	323	403	16	2	80	0.0250000
NODE_8186_length_928_cov_13.354644	323	403	17	13	80	0.1625000
NODE_8186_length_928_cov_13.354644	323	403	18	8	80	0.1000000
NODE_8186_length_928_cov_13.354644	376	456	13	2	80	0.0250000
NODE_8186_length_928_cov_13.354644	376	456	14	23	80	0.2875000
NODE_8186_length_928_cov_13.354644	376	456	15	31	80	0.3875000
NODE_8186_length_928_cov_13.354644	376	456	16	4	80	0.0500000
NODE_8186_length_928_cov_13.354644	376	456	17	12	80	0.1500000
NODE_8186_length_928_cov_13.354644	376	456	18	8	80	0.1000000
NODE_8187_length_928_cov_13.096502	361	441	2	6	80	0.0750000
NODE_8187_length_928_cov_13.096502	361	441	4	74	80	0.9250000
NODE_8187_length_928_cov_13.096502	414	494	2	33	80	0.4125000
NODE_8187_length_928_cov_13.096502	414	494	4	47	80	0.5875000
NODE_8189_length_928_cov_10.399276	447	527	2	9	80	0.1125000
NODE_8189_length_928_cov_10.399276	447	527	4	10	80	0.1250000
NODE_8189_length_928_cov_10.399276	447	527	5	61	80	0.7625000
NODE_8189_length_928_cov_10.399276	500	580	4	52	80	0.6500000
NODE_8189_length_928_cov_10.399276	500	580	5	28	80	0.3500000
NODE_8207_length_927_cov_19.516908	398	478	6	6	80	0.0750000
NODE_8207_length_927_cov_19.516908	398	478	7	48	80	0.6000000
NODE_8207_length_927_cov_19.516908	398	478	8	26	80	0.3250000
NODE_8207_length_927_cov_19.516908	451	531	4	29	80	0.3625000
NODE_8207_length_927_cov_19.516908	451	531	5	2	80	0.0250000
NODE_8207_length_927_cov_19.516908	451	531	6	27	80	0.3375000
NODE_8207_length_927_cov_19.516908	451	531	7	2	80	0.0250000
NODE_8207_length_927_cov_19.516908	451	531	8	20	80	0.2500000
NODE_8208_length_927_cov_11.190821	358	438	6	10	80	0.1250000
NODE_8208_length_927_cov_11.190821	358	438	7	70	80	0.8750000
NODE_8208_length_927_cov_11.190821	411	491	0	1	80	0.0125000
NODE_8208_length_927_cov_11.190821	411	491	3	25	80	0.3125000
NODE_8208_length_927_cov_11.190821	411	491	4	11	80	0.1375000
NODE_8208_length_927_cov_11.190821	411	491	5	14	80	0.1750000
NODE_8208_length_927_cov_11.190821	411	491	6	12	80	0.1500000
NODE_8208_length_927_cov_11.190821	411	491	7	17	80	0.2125000
NODE_8209_length_927_cov_8.123188	239	319	1	48	80	0.6000000
NODE_8209_length_927_cov_8.123188	239	319	2	32	80	0.4000000
NODE_8209_length_927_cov_8.123188	292	372	2	80	80	1.0000000
NODE_8210_length_927_cov_4.585749	515	595	0	16	80	0.2000000
NODE_8210_length_927_cov_4.585749	515	595	1	59	80	0.7375000
NODE_8210_length_927_cov_4.585749	515	595	2	5	80	0.0625000
NODE_8210_length_927_cov_4.585749	568	648	0	69	80	0.8625000
NODE_8210_length_927_cov_4.585749	568	648	1	11	80	0.1375000
NODE_8222_length_927_cov_1.250000	626	706	10	7	80	0.0875000
NODE_8222_length_927_cov_1.250000	626	706	11	21	80	0.2625000
NODE_8222_length_927_cov_1.250000	626	706	16	2	80	0.0250000
NODE_8222_length_927_cov_1.250000	626	706	19	17	80	0.2125000
NODE_8222_length_927_cov_1.250000	626	706	20	15	80	0.1875000
NODE_8222_length_927_cov_1.250000	626	706	21	18	80	0.2250000
NODE_8222_length_927_cov_1.250000	679	759	16	27	80	0.3375000
NODE_8222_length_927_cov_1.250000	679	759	19	7	80	0.0875000
NODE_8222_length_927_cov_1.250000	679	759	21	24	80	0.3000000
NODE_8222_length_927_cov_1.250000	679	759	22	2	80	0.0250000
NODE_8222_length_927_cov_1.250000	679	759	23	2	80	0.0250000
NODE_8222_length_927_cov_1.250000	679	759	24	14	80	0.1750000
NODE_8222_length_927_cov_1.250000	679	759	25	4	80	0.0500000
NODE_8227_length_926_cov_78.382104	433	513	22	41	80	0.5125000
NODE_8227_length_926_cov_78.382104	433	513	23	4	80	0.0500000
NODE_8227_length_926_cov_78.382104	433	513	25	15	80	0.1875000
NODE_8227_length_926_cov_78.382104	433	513	26	20	80	0.2500000
NODE_8227_length_926_cov_78.382104	486	566	17	6	80	0.0750000
NODE_8227_length_926_cov_78.382104	486	566	18	4	80	0.0500000
NODE_8227_length_926_cov_78.382104	486	566	19	4	80	0.0500000
NODE_8227_length_926_cov_78.382104	486	566	20	4	80	0.0500000
NODE_8227_length_926_cov_78.382104	486	566	22	21	80	0.2625000
NODE_8227_length_926_cov_78.382104	486	566	24	7	80	0.0875000
NODE_8227_length_926_cov_78.382104	486	566	25	25	80	0.3125000
NODE_8227_length_926_cov_78.382104	486	566	26	9	80	0.1125000
NODE_8228_length_926_cov_44.385732	383	463	10	3	80	0.0375000
NODE_8228_length_926_cov_44.385732	383	463	12	4	80	0.0500000
NODE_8228_length_926_cov_44.385732	383	463	13	4	80	0.0500000
NODE_8228_length_926_cov_44.385732	383	463	14	11	80	0.1375000
NODE_8228_length_926_cov_44.385732	383	463	15	21	80	0.2625000
NODE_8228_length_926_cov_44.385732	383	463	16	8	80	0.1000000
NODE_8228_length_926_cov_44.385732	383	463	17	29	80	0.3625000
NODE_8228_length_926_cov_44.385732	436	516	10	10	80	0.1250000
NODE_8228_length_926_cov_44.385732	436	516	11	13	80	0.1625000
NODE_8228_length_926_cov_44.385732	436	516	13	13	80	0.1625000
NODE_8228_length_926_cov_44.385732	436	516	14	17	80	0.2125000
NODE_8228_length_926_cov_44.385732	436	516	15	20	80	0.2500000
NODE_8228_length_926_cov_44.385732	436	516	16	7	80	0.0875000
NODE_8229_length_926_cov_43.446191	362	442	4	15	80	0.1875000
NODE_8229_length_926_cov_43.446191	362	442	5	3	80	0.0375000
NODE_8229_length_926_cov_43.446191	362	442	7	49	80	0.6125000
NODE_8229_length_926_cov_43.446191	362	442	8	1	80	0.0125000
NODE_8229_length_926_cov_43.446191	362	442	9	12	80	0.1500000
NODE_8229_length_926_cov_43.446191	415	495	7	19	80	0.2375000
NODE_8229_length_926_cov_43.446191	415	495	8	1	80	0.0125000
NODE_8229_length_926_cov_43.446191	415	495	9	19	80	0.2375000
NODE_8229_length_926_cov_43.446191	415	495	10	7	80	0.0875000
NODE_8229_length_926_cov_43.446191	415	495	12	28	80	0.3500000
NODE_8229_length_926_cov_43.446191	415	495	17	2	80	0.0250000
NODE_8229_length_926_cov_43.446191	415	495	18	4	80	0.0500000
NODE_8229_length_926_cov_43.446191	491	571	13	25	80	0.3125000
NODE_8229_length_926_cov_43.446191	491	571	14	15	80	0.1875000
NODE_8229_length_926_cov_43.446191	491	571	15	4	80	0.0500000
NODE_8229_length_926_cov_43.446191	491	571	16	19	80	0.2375000
NODE_8229_length_926_cov_43.446191	491	571	17	9	80	0.1125000
NODE_8229_length_926_cov_43.446191	491	571	18	8	80	0.1000000
NODE_8229_length_926_cov_43.446191	544	624	9	13	80	0.1625000
NODE_8229_length_926_cov_43.446191	544	624	11	7	80	0.0875000
NODE_8229_length_926_cov_43.446191	544	624	12	7	80	0.0875000
NODE_8229_length_926_cov_43.446191	544	624	13	29	80	0.3625000
NODE_8229_length_926_cov_43.446191	544	624	14	21	80	0.2625000
NODE_8229_length_926_cov_43.446191	544	624	15	3	80	0.0375000
NODE_8230_length_926_cov_40.163241	42	61	0	9	19	0.4736842
NODE_8230_length_926_cov_40.163241	42	61	2	10	19	0.5263158
NODE_8230_length_926_cov_40.163241	279	359	5	14	80	0.1750000
NODE_8230_length_926_cov_40.163241	279	359	6	66	80	0.8250000
NODE_8230_length_926_cov_40.163241	332	412	5	11	80	0.1375000
NODE_8230_length_926_cov_40.163241	332	412	6	44	80	0.5500000
NODE_8230_length_926_cov_40.163241	332	412	7	2	80	0.0250000
NODE_8230_length_926_cov_40.163241	332	412	10	19	80	0.2375000
NODE_8230_length_926_cov_40.163241	332	412	11	4	80	0.0500000
NODE_8230_length_926_cov_40.163241	408	488	8	72	80	0.9000000
NODE_8230_length_926_cov_40.163241	408	488	9	1	80	0.0125000
NODE_8230_length_926_cov_40.163241	408	488	10	7	80	0.0875000
NODE_8230_length_926_cov_40.163241	461	541	2	2	80	0.0250000
NODE_8230_length_926_cov_40.163241	461	541	6	2	80	0.0250000
NODE_8230_length_926_cov_40.163241	461	541	7	44	80	0.5500000
NODE_8230_length_926_cov_40.163241	461	541	8	32	80	0.4000000
NODE_8231_length_926_cov_29.923821	372	452	3	12	80	0.1500000
NODE_8231_length_926_cov_29.923821	372	452	4	4	80	0.0500000
NODE_8231_length_926_cov_29.923821	372	452	5	2	80	0.0250000
NODE_8231_length_926_cov_29.923821	372	452	7	1	80	0.0125000
NODE_8231_length_926_cov_29.923821	372	452	8	6	80	0.0750000
NODE_8231_length_926_cov_29.923821	372	452	9	15	80	0.1875000
NODE_8231_length_926_cov_29.923821	372	452	10	4	80	0.0500000
NODE_8231_length_926_cov_29.923821	372	452	11	1	80	0.0125000
NODE_8231_length_926_cov_29.923821	372	452	12	35	80	0.4375000
NODE_8231_length_926_cov_29.923821	425	505	9	38	80	0.4750000
NODE_8231_length_926_cov_29.923821	425	505	10	19	80	0.2375000
NODE_8231_length_926_cov_29.923821	425	505	12	23	80	0.2875000
NODE_8232_length_926_cov_24.657799	350	430	3	48	80	0.6000000
NODE_8232_length_926_cov_24.657799	350	430	5	32	80	0.4000000
NODE_8232_length_926_cov_24.657799	403	483	3	16	80	0.2000000
NODE_8232_length_926_cov_24.657799	403	483	5	64	80	0.8000000
NODE_8233_length_926_cov_17.438936	360	440	2	30	80	0.3750000
NODE_8233_length_926_cov_17.438936	360	440	3	25	80	0.3125000
NODE_8233_length_926_cov_17.438936	360	440	4	8	80	0.1000000
NODE_8233_length_926_cov_17.438936	360	440	6	10	80	0.1250000
NODE_8233_length_926_cov_17.438936	360	440	7	6	80	0.0750000
NODE_8233_length_926_cov_17.438936	360	440	8	1	80	0.0125000
NODE_8233_length_926_cov_17.438936	413	493	3	2	80	0.0250000
NODE_8233_length_926_cov_17.438936	413	493	4	8	80	0.1000000
NODE_8233_length_926_cov_17.438936	413	493	6	10	80	0.1250000
NODE_8233_length_926_cov_17.438936	413	493	7	6	80	0.0750000
NODE_8233_length_926_cov_17.438936	413	493	8	40	80	0.5000000
NODE_8233_length_926_cov_17.438936	413	493	9	11	80	0.1375000
NODE_8233_length_926_cov_17.438936	413	493	10	3	80	0.0375000
NODE_8234_length_926_cov_12.413543	418	491	8	3	73	0.0410959
NODE_8234_length_926_cov_12.413543	418	491	9	59	73	0.8082192
NODE_8234_length_926_cov_12.413543	418	491	10	11	73	0.1506849
NODE_8234_length_926_cov_12.413543	464	544	3	4	80	0.0500000
NODE_8234_length_926_cov_12.413543	464	544	5	1	80	0.0125000
NODE_8234_length_926_cov_12.413543	464	544	7	41	80	0.5125000
NODE_8234_length_926_cov_12.413543	464	544	8	3	80	0.0375000
NODE_8234_length_926_cov_12.413543	464	544	9	20	80	0.2500000
NODE_8234_length_926_cov_12.413543	464	544	10	11	80	0.1375000
NODE_8235_length_926_cov_5.771463	453	533	2	34	80	0.4250000
NODE_8235_length_926_cov_5.771463	453	533	3	9	80	0.1125000
NODE_8235_length_926_cov_5.771463	453	533	4	37	80	0.4625000
NODE_8235_length_926_cov_5.771463	505	586	2	37	81	0.4567901
NODE_8235_length_926_cov_5.771463	505	586	3	9	81	0.1111111
NODE_8235_length_926_cov_5.771463	505	586	4	35	81	0.4320988
NODE_8236_length_926_cov_5.209190	435	515	0	80	80	1.0000000
NODE_8236_length_926_cov_5.209190	488	568	0	80	80	1.0000000
NODE_8247_length_925_cov_40.767554	514	594	6	16	80	0.2000000
NODE_8247_length_925_cov_40.767554	514	594	7	32	80	0.4000000
NODE_8247_length_925_cov_40.767554	514	594	8	30	80	0.3750000
NODE_8247_length_925_cov_40.767554	514	594	10	2	80	0.0250000
NODE_8247_length_925_cov_40.767554	567	647	6	20	80	0.2500000
NODE_8247_length_925_cov_40.767554	567	647	7	18	80	0.2250000
NODE_8247_length_925_cov_40.767554	567	647	8	32	80	0.4000000
NODE_8247_length_925_cov_40.767554	567	647	9	8	80	0.1000000
NODE_8247_length_925_cov_40.767554	567	647	10	2	80	0.0250000
NODE_8248_length_925_cov_30.226392	262	342	1	54	80	0.6750000
NODE_8248_length_925_cov_30.226392	262	342	2	1	80	0.0125000
NODE_8248_length_925_cov_30.226392	262	342	3	13	80	0.1625000
NODE_8248_length_925_cov_30.226392	262	342	4	12	80	0.1500000
NODE_8248_length_925_cov_30.226392	315	395	1	1	80	0.0125000
NODE_8248_length_925_cov_30.226392	315	395	2	1	80	0.0125000
NODE_8248_length_925_cov_30.226392	315	395	3	13	80	0.1625000
NODE_8248_length_925_cov_30.226392	315	395	4	32	80	0.4000000
NODE_8248_length_925_cov_30.226392	315	395	6	33	80	0.4125000
NODE_8248_length_925_cov_30.226392	391	471	3	8	80	0.1000000
NODE_8248_length_925_cov_30.226392	391	471	4	1	80	0.0125000
NODE_8248_length_925_cov_30.226392	391	471	5	66	80	0.8250000
NODE_8248_length_925_cov_30.226392	391	471	6	5	80	0.0625000
NODE_8248_length_925_cov_30.226392	444	524	0	16	80	0.2000000
NODE_8248_length_925_cov_30.226392	444	524	2	28	80	0.3500000
NODE_8248_length_925_cov_30.226392	444	524	3	17	80	0.2125000
NODE_8248_length_925_cov_30.226392	444	524	4	1	80	0.0125000
NODE_8248_length_925_cov_30.226392	444	524	5	18	80	0.2250000
NODE_8249_length_925_cov_22.075061	334	414	0	36	80	0.4500000
NODE_8249_length_925_cov_22.075061	334	414	2	12	80	0.1500000
NODE_8249_length_925_cov_22.075061	334	414	3	19	80	0.2375000
NODE_8249_length_925_cov_22.075061	334	414	6	13	80	0.1625000
NODE_8249_length_925_cov_22.075061	387	467	3	14	80	0.1750000
NODE_8249_length_925_cov_22.075061	387	467	6	38	80	0.4750000
NODE_8249_length_925_cov_22.075061	387	467	7	14	80	0.1750000
NODE_8249_length_925_cov_22.075061	387	467	10	14	80	0.1750000
NODE_8250_length_925_cov_18.164649	410	490	4	52	80	0.6500000
NODE_8250_length_925_cov_18.164649	410	490	5	1	80	0.0125000
NODE_8250_length_925_cov_18.164649	410	490	7	10	80	0.1250000
NODE_8250_length_925_cov_18.164649	410	490	8	15	80	0.1875000
NODE_8250_length_925_cov_18.164649	410	490	9	2	80	0.0250000
NODE_8250_length_925_cov_18.164649	464	543	7	34	79	0.4303797
NODE_8250_length_925_cov_18.164649	464	543	8	34	79	0.4303797
NODE_8250_length_925_cov_18.164649	464	543	9	11	79	0.1392405
NODE_8251_length_925_cov_14.067797	472	548	13	4	76	0.0526316
NODE_8251_length_925_cov_14.067797	472	548	14	20	76	0.2631579
NODE_8251_length_925_cov_14.067797	472	548	15	52	76	0.6842105
NODE_8251_length_925_cov_14.067797	525	601	7	5	76	0.0657895
NODE_8251_length_925_cov_14.067797	525	601	8	4	76	0.0526316
NODE_8251_length_925_cov_14.067797	525	601	10	2	76	0.0263158
NODE_8251_length_925_cov_14.067797	525	601	12	8	76	0.1052632
NODE_8251_length_925_cov_14.067797	525	601	13	33	76	0.4342105
NODE_8251_length_925_cov_14.067797	525	601	14	3	76	0.0394737
NODE_8251_length_925_cov_14.067797	525	601	15	21	76	0.2763158
NODE_8252_length_925_cov_7.098063	418	498	2	80	80	1.0000000
NODE_8252_length_925_cov_7.098063	471	551	0	44	80	0.5500000
NODE_8252_length_925_cov_7.098063	471	551	1	8	80	0.1000000
NODE_8252_length_925_cov_7.098063	471	551	2	28	80	0.3500000
NODE_8266_length_924_cov_61.292121	397	477	12	35	80	0.4375000
NODE_8266_length_924_cov_61.292121	397	477	15	5	80	0.0625000
NODE_8266_length_924_cov_61.292121	397	477	16	1	80	0.0125000
NODE_8266_length_924_cov_61.292121	397	477	18	10	80	0.1250000
NODE_8266_length_924_cov_61.292121	397	477	19	29	80	0.3625000
NODE_8266_length_924_cov_61.292121	450	530	16	9	80	0.1125000
NODE_8266_length_924_cov_61.292121	450	530	17	37	80	0.4625000
NODE_8266_length_924_cov_61.292121	450	530	18	3	80	0.0375000
NODE_8266_length_924_cov_61.292121	450	530	19	27	80	0.3375000
NODE_8266_length_924_cov_61.292121	450	530	20	4	80	0.0500000
NODE_8267_length_924_cov_31.522424	375	455	1	9	80	0.1125000
NODE_8267_length_924_cov_31.522424	375	455	2	71	80	0.8875000
NODE_8267_length_924_cov_31.522424	428	508	0	42	80	0.5250000
NODE_8267_length_924_cov_31.522424	428	508	1	20	80	0.2500000
NODE_8267_length_924_cov_31.522424	428	508	2	18	80	0.2250000
NODE_8268_length_924_cov_30.446061	299	379	2	59	80	0.7375000
NODE_8268_length_924_cov_30.446061	299	379	3	21	80	0.2625000
NODE_8268_length_924_cov_30.446061	352	432	1	15	80	0.1875000
NODE_8268_length_924_cov_30.446061	352	432	2	44	80	0.5500000
NODE_8268_length_924_cov_30.446061	352	432	3	21	80	0.2625000
NODE_8268_length_924_cov_30.446061	428	508	0	6	80	0.0750000
NODE_8268_length_924_cov_30.446061	428	508	1	74	80	0.9250000
NODE_8268_length_924_cov_30.446061	481	561	0	59	80	0.7375000
NODE_8268_length_924_cov_30.446061	481	561	1	21	80	0.2625000
NODE_8269_length_924_cov_28.877576	542	622	3	33	80	0.4125000
NODE_8269_length_924_cov_28.877576	542	622	4	10	80	0.1250000
NODE_8269_length_924_cov_28.877576	542	622	5	37	80	0.4625000
NODE_8269_length_924_cov_28.877576	595	675	1	20	80	0.2500000
NODE_8269_length_924_cov_28.877576	595	675	3	60	80	0.7500000
NODE_8270_length_924_cov_27.261818	506	586	8	25	80	0.3125000
NODE_8270_length_924_cov_27.261818	506	586	11	1	80	0.0125000
NODE_8270_length_924_cov_27.261818	506	586	13	1	80	0.0125000
NODE_8270_length_924_cov_27.261818	506	586	14	5	80	0.0625000
NODE_8270_length_924_cov_27.261818	506	586	16	15	80	0.1875000
NODE_8270_length_924_cov_27.261818	506	586	18	2	80	0.0250000
NODE_8270_length_924_cov_27.261818	506	586	19	4	80	0.0500000
NODE_8270_length_924_cov_27.261818	506	586	20	9	80	0.1125000
NODE_8270_length_924_cov_27.261818	506	586	21	1	80	0.0125000
NODE_8270_length_924_cov_27.261818	506	586	22	17	80	0.2125000
NODE_8270_length_924_cov_27.261818	559	639	20	16	80	0.2000000
NODE_8270_length_924_cov_27.261818	559	639	21	22	80	0.2750000
NODE_8270_length_924_cov_27.261818	559	639	22	37	80	0.4625000
NODE_8270_length_924_cov_27.261818	559	639	23	5	80	0.0625000
NODE_8271_length_924_cov_25.946667	371	451	5	19	80	0.2375000
NODE_8271_length_924_cov_25.946667	371	451	7	2	80	0.0250000
NODE_8271_length_924_cov_25.946667	371	451	8	57	80	0.7125000
NODE_8271_length_924_cov_25.946667	371	451	9	2	80	0.0250000
NODE_8271_length_924_cov_25.946667	424	504	5	27	80	0.3375000
NODE_8271_length_924_cov_25.946667	424	504	7	23	80	0.2875000
NODE_8271_length_924_cov_25.946667	424	504	8	28	80	0.3500000
NODE_8271_length_924_cov_25.946667	424	504	9	2	80	0.0250000
NODE_8271_length_924_cov_25.946667	500	580	4	7	80	0.0875000
NODE_8271_length_924_cov_25.946667	500	580	5	49	80	0.6125000
NODE_8271_length_924_cov_25.946667	500	580	6	1	80	0.0125000
NODE_8271_length_924_cov_25.946667	500	580	7	14	80	0.1750000
NODE_8271_length_924_cov_25.946667	500	580	8	9	80	0.1125000
NODE_8271_length_924_cov_25.946667	553	633	1	7	80	0.0875000
NODE_8271_length_924_cov_25.946667	553	633	2	15	80	0.1875000
NODE_8271_length_924_cov_25.946667	553	633	4	38	80	0.4750000
NODE_8271_length_924_cov_25.946667	553	633	5	20	80	0.2500000
NODE_8272_length_924_cov_25.113939	305	385	3	80	80	1.0000000
NODE_8272_length_924_cov_25.113939	358	438	2	44	80	0.5500000
NODE_8272_length_924_cov_25.113939	358	438	3	36	80	0.4500000
NODE_8272_length_924_cov_25.113939	434	514	0	1	80	0.0125000
NODE_8272_length_924_cov_25.113939	434	514	1	73	80	0.9125000
NODE_8272_length_924_cov_25.113939	434	514	2	6	80	0.0750000
NODE_8272_length_924_cov_25.113939	487	567	1	46	80	0.5750000
NODE_8272_length_924_cov_25.113939	487	567	2	34	80	0.4250000
NODE_8273_length_924_cov_16.343030	481	561	0	80	80	1.0000000
NODE_8273_length_924_cov_16.343030	534	614	0	80	80	1.0000000
NODE_8274_length_924_cov_14.793939	299	379	0	4	80	0.0500000
NODE_8274_length_924_cov_14.793939	299	379	1	64	80	0.8000000
NODE_8274_length_924_cov_14.793939	299	379	2	10	80	0.1250000
NODE_8274_length_924_cov_14.793939	299	379	3	2	80	0.0250000
NODE_8274_length_924_cov_14.793939	352	432	1	15	80	0.1875000
NODE_8274_length_924_cov_14.793939	352	432	2	10	80	0.1250000
NODE_8274_length_924_cov_14.793939	352	432	3	42	80	0.5250000
NODE_8274_length_924_cov_14.793939	352	432	4	13	80	0.1625000
NODE_8275_length_924_cov_14.209697	485	562	6	10	77	0.1298701
NODE_8275_length_924_cov_14.209697	485	562	8	8	77	0.1038961
NODE_8275_length_924_cov_14.209697	485	562	14	37	77	0.4805195
NODE_8275_length_924_cov_14.209697	485	562	16	15	77	0.1948052
NODE_8275_length_924_cov_14.209697	485	562	22	7	77	0.0909091
NODE_8275_length_924_cov_14.209697	535	615	14	5	80	0.0625000
NODE_8275_length_924_cov_14.209697	535	615	16	15	80	0.1875000
NODE_8275_length_924_cov_14.209697	535	615	20	13	80	0.1625000
NODE_8275_length_924_cov_14.209697	535	615	22	47	80	0.5875000
NODE_8276_length_924_cov_13.423030	287	367	0	80	80	1.0000000
NODE_8276_length_924_cov_13.423030	340	420	0	80	80	1.0000000
NODE_8277_length_924_cov_12.008485	237	307	2	70	70	1.0000000
NODE_8279_length_924_cov_8.619394	560	640	0	28	80	0.3500000
NODE_8279_length_924_cov_8.619394	560	640	1	52	80	0.6500000
NODE_8279_length_924_cov_8.619394	613	693	1	80	80	1.0000000
NODE_8280_length_924_cov_4.640000	426	506	1	80	80	1.0000000
NODE_8280_length_924_cov_4.640000	479	559	1	62	80	0.7750000
NODE_8280_length_924_cov_4.640000	479	559	2	18	80	0.2250000
NODE_8290_length_924_cov_1.467879	352	381	0	29	29	1.0000000
NODE_8296_length_924_cov_0.648485	830	890	0	60	60	1.0000000
NODE_8296_length_924_cov_0.648485	863	924	0	61	61	1.0000000
NODE_8297_length_923_cov_43.213592	371	451	7	43	80	0.5375000
NODE_8297_length_923_cov_43.213592	371	451	8	5	80	0.0625000
NODE_8297_length_923_cov_43.213592	371	451	15	10	80	0.1250000
NODE_8297_length_923_cov_43.213592	371	451	16	22	80	0.2750000
NODE_8297_length_923_cov_43.213592	424	504	10	15	80	0.1875000
NODE_8297_length_923_cov_43.213592	424	504	14	14	80	0.1750000
NODE_8297_length_923_cov_43.213592	424	504	15	23	80	0.2875000
NODE_8297_length_923_cov_43.213592	424	504	16	28	80	0.3500000
NODE_8297_length_923_cov_43.213592	500	580	4	7	80	0.0875000
NODE_8297_length_923_cov_43.213592	500	580	5	5	80	0.0625000
NODE_8297_length_923_cov_43.213592	500	580	6	16	80	0.2000000
NODE_8297_length_923_cov_43.213592	500	580	7	26	80	0.3250000
NODE_8297_length_923_cov_43.213592	500	580	8	17	80	0.2125000
NODE_8297_length_923_cov_43.213592	500	580	10	9	80	0.1125000
NODE_8297_length_923_cov_43.213592	553	633	7	73	80	0.9125000
NODE_8297_length_923_cov_43.213592	553	633	8	7	80	0.0875000
NODE_8298_length_923_cov_34.108010	370	450	6	7	80	0.0875000
NODE_8298_length_923_cov_34.108010	370	450	8	5	80	0.0625000
NODE_8298_length_923_cov_34.108010	370	450	9	4	80	0.0500000
NODE_8298_length_923_cov_34.108010	370	450	10	33	80	0.4125000
NODE_8298_length_923_cov_34.108010	370	450	11	31	80	0.3875000
NODE_8298_length_923_cov_34.108010	423	503	8	6	80	0.0750000
NODE_8298_length_923_cov_34.108010	423	503	10	6	80	0.0750000
NODE_8298_length_923_cov_34.108010	423	503	11	38	80	0.4750000
NODE_8298_length_923_cov_34.108010	423	503	12	30	80	0.3750000
NODE_8299_length_923_cov_29.163835	392	472	0	7	80	0.0875000
NODE_8299_length_923_cov_29.163835	392	472	2	19	80	0.2375000
NODE_8299_length_923_cov_29.163835	392	472	4	54	80	0.6750000
NODE_8299_length_923_cov_29.163835	445	525	2	34	80	0.4250000
NODE_8299_length_923_cov_29.163835	445	525	4	46	80	0.5750000
NODE_8300_length_923_cov_19.139563	375	455	11	24	80	0.3000000
NODE_8300_length_923_cov_19.139563	375	455	13	26	80	0.3250000
NODE_8300_length_923_cov_19.139563	375	455	14	17	80	0.2125000
NODE_8300_length_923_cov_19.139563	375	455	15	11	80	0.1375000
NODE_8300_length_923_cov_19.139563	375	455	16	2	80	0.0250000
NODE_8300_length_923_cov_19.139563	428	508	9	20	80	0.2500000
NODE_8300_length_923_cov_19.139563	428	508	10	5	80	0.0625000
NODE_8300_length_923_cov_19.139563	428	508	11	17	80	0.2125000
NODE_8300_length_923_cov_19.139563	428	508	12	17	80	0.2125000
NODE_8300_length_923_cov_19.139563	428	508	13	18	80	0.2250000
NODE_8300_length_923_cov_19.139563	428	508	14	3	80	0.0375000
NODE_8301_length_923_cov_17.433252	512	592	4	56	80	0.7000000
NODE_8301_length_923_cov_17.433252	512	592	5	24	80	0.3000000
NODE_8301_length_923_cov_17.433252	565	645	2	13	80	0.1625000
NODE_8301_length_923_cov_17.433252	565	645	3	6	80	0.0750000
NODE_8301_length_923_cov_17.433252	565	645	4	60	80	0.7500000
NODE_8301_length_923_cov_17.433252	565	645	5	1	80	0.0125000
NODE_8302_length_923_cov_16.597087	279	359	16	20	80	0.2500000
NODE_8302_length_923_cov_16.597087	279	359	18	2	80	0.0250000
NODE_8302_length_923_cov_16.597087	279	359	19	39	80	0.4875000
NODE_8302_length_923_cov_16.597087	279	359	20	13	80	0.1625000
NODE_8302_length_923_cov_16.597087	279	359	21	6	80	0.0750000
NODE_8302_length_923_cov_16.597087	332	412	17	13	80	0.1625000
NODE_8302_length_923_cov_16.597087	332	412	18	28	80	0.3500000
NODE_8302_length_923_cov_16.597087	332	412	19	19	80	0.2375000
NODE_8302_length_923_cov_16.597087	332	412	20	13	80	0.1625000
NODE_8302_length_923_cov_16.597087	332	412	21	7	80	0.0875000
NODE_8303_length_923_cov_15.229369	446	526	1	44	80	0.5500000
NODE_8303_length_923_cov_15.229369	446	526	2	11	80	0.1375000
NODE_8303_length_923_cov_15.229369	446	526	3	4	80	0.0500000
NODE_8303_length_923_cov_15.229369	446	526	4	21	80	0.2625000
NODE_8303_length_923_cov_15.229369	499	579	2	2	80	0.0250000
NODE_8303_length_923_cov_15.229369	499	579	3	4	80	0.0500000
NODE_8303_length_923_cov_15.229369	499	579	4	47	80	0.5875000
NODE_8303_length_923_cov_15.229369	499	579	5	27	80	0.3375000
NODE_8304_length_923_cov_14.007282	304	349	7	43	45	0.9555556
NODE_8304_length_923_cov_14.007282	304	349	8	2	45	0.0444444
NODE_8304_length_923_cov_14.007282	345	427	4	12	82	0.1463415
NODE_8304_length_923_cov_14.007282	345	427	5	10	82	0.1219512
NODE_8304_length_923_cov_14.007282	345	427	7	2	82	0.0243902
NODE_8304_length_923_cov_14.007282	345	427	8	58	82	0.7073171
NODE_8304_length_923_cov_14.007282	397	480	1	30	83	0.3614458
NODE_8304_length_923_cov_14.007282	397	480	3	23	83	0.2771084
NODE_8304_length_923_cov_14.007282	397	480	4	12	83	0.1445783
NODE_8304_length_923_cov_14.007282	397	480	5	10	83	0.1204819
NODE_8304_length_923_cov_14.007282	397	480	8	8	83	0.0963855
NODE_8305_length_923_cov_6.500000	308	388	0	59	80	0.7375000
NODE_8305_length_923_cov_6.500000	308	388	1	21	80	0.2625000
NODE_8305_length_923_cov_6.500000	361	441	0	6	80	0.0750000
NODE_8305_length_923_cov_6.500000	361	441	1	74	80	0.9250000
NODE_8307_length_923_cov_6.115291	447	527	1	10	80	0.1250000
NODE_8307_length_923_cov_6.115291	447	527	5	42	80	0.5250000
NODE_8307_length_923_cov_6.115291	447	527	6	28	80	0.3500000
NODE_8307_length_923_cov_6.115291	500	580	1	63	80	0.7875000
NODE_8307_length_923_cov_6.115291	500	580	6	17	80	0.2125000
NODE_8308_length_923_cov_5.351942	363	445	1	22	82	0.2682927
NODE_8308_length_923_cov_5.351942	363	445	2	60	82	0.7317073
NODE_8308_length_923_cov_5.351942	365	445	1	20	80	0.2500000
NODE_8308_length_923_cov_5.351942	365	445	2	60	80	0.7500000
NODE_8317_length_923_cov_1.059466	63	143	0	80	80	1.0000000
NODE_8320_length_922_cov_40.331713	243	289	6	7	46	0.1521739
NODE_8320_length_922_cov_40.331713	243	289	7	14	46	0.3043478
NODE_8320_length_922_cov_40.331713	243	289	8	6	46	0.1304348
NODE_8320_length_922_cov_40.331713	243	289	9	19	46	0.4130435
NODE_8320_length_922_cov_40.331713	262	342	6	9	80	0.1125000
NODE_8320_length_922_cov_40.331713	262	342	7	3	80	0.0375000
NODE_8320_length_922_cov_40.331713	262	342	9	30	80	0.3750000
NODE_8320_length_922_cov_40.331713	262	342	10	29	80	0.3625000
NODE_8320_length_922_cov_40.331713	262	342	11	9	80	0.1125000
NODE_8320_length_922_cov_40.331713	780	860	17	23	80	0.2875000
NODE_8320_length_922_cov_40.331713	780	860	18	14	80	0.1750000
NODE_8320_length_922_cov_40.331713	780	860	20	10	80	0.1250000
NODE_8320_length_922_cov_40.331713	780	860	21	22	80	0.2750000
NODE_8320_length_922_cov_40.331713	780	860	22	11	80	0.1375000
NODE_8320_length_922_cov_40.331713	833	913	1	1	80	0.0125000
NODE_8320_length_922_cov_40.331713	833	913	2	8	80	0.1000000
NODE_8320_length_922_cov_40.331713	833	913	3	3	80	0.0375000
NODE_8320_length_922_cov_40.331713	833	913	5	5	80	0.0625000
NODE_8320_length_922_cov_40.331713	833	913	7	5	80	0.0625000
NODE_8320_length_922_cov_40.331713	833	913	9	2	80	0.0250000
NODE_8320_length_922_cov_40.331713	833	913	10	1	80	0.0125000
NODE_8320_length_922_cov_40.331713	833	913	11	2	80	0.0250000
NODE_8320_length_922_cov_40.331713	833	913	16	2	80	0.0250000
NODE_8320_length_922_cov_40.331713	833	913	17	47	80	0.5875000
NODE_8320_length_922_cov_40.331713	833	913	18	4	80	0.0500000
NODE_8321_length_922_cov_38.549210	126	177	18	2	51	0.0392157
NODE_8321_length_922_cov_38.549210	126	177	19	2	51	0.0392157
NODE_8321_length_922_cov_38.549210	126	177	23	7	51	0.1372549
NODE_8321_length_922_cov_38.549210	126	177	24	2	51	0.0392157
NODE_8321_length_922_cov_38.549210	126	177	28	1	51	0.0196078
NODE_8321_length_922_cov_38.549210	126	177	29	1	51	0.0196078
NODE_8321_length_922_cov_38.549210	126	177	31	4	51	0.0784314
NODE_8321_length_922_cov_38.549210	126	177	34	32	51	0.6274510
NODE_8321_length_922_cov_38.549210	308	383	1	31	75	0.4133333
NODE_8321_length_922_cov_38.549210	308	383	2	44	75	0.5866666
NODE_8321_length_922_cov_38.549210	356	393	1	37	37	1.0000000
NODE_8321_length_922_cov_38.549210	818	898	0	38	80	0.4750000
NODE_8321_length_922_cov_38.549210	818	898	1	1	80	0.0125000
NODE_8321_length_922_cov_38.549210	818	898	2	1	80	0.0125000
NODE_8321_length_922_cov_38.549210	818	898	5	40	80	0.5000000
NODE_8321_length_922_cov_38.549210	871	908	0	37	37	1.0000000
NODE_8322_length_922_cov_35.041312	385	465	2	35	80	0.4375000
NODE_8322_length_922_cov_35.041312	385	465	9	12	80	0.1500000
NODE_8322_length_922_cov_35.041312	385	465	10	33	80	0.4125000
NODE_8322_length_922_cov_35.041312	438	518	8	8	80	0.1000000
NODE_8322_length_922_cov_35.041312	438	518	10	72	80	0.9000000
NODE_8323_length_922_cov_30.749696	426	506	8	6	80	0.0750000
NODE_8323_length_922_cov_30.749696	426	506	9	8	80	0.1000000
NODE_8323_length_922_cov_30.749696	426	506	10	19	80	0.2375000
NODE_8323_length_922_cov_30.749696	426	506	11	25	80	0.3125000
NODE_8323_length_922_cov_30.749696	426	506	12	12	80	0.1500000
NODE_8323_length_922_cov_30.749696	426	506	14	10	80	0.1250000
NODE_8323_length_922_cov_30.749696	479	559	10	26	80	0.3250000
NODE_8323_length_922_cov_30.749696	479	559	11	4	80	0.0500000
NODE_8323_length_922_cov_30.749696	479	559	12	43	80	0.5375000
NODE_8323_length_922_cov_30.749696	479	559	13	7	80	0.0875000
NODE_8324_length_922_cov_25.558931	291	370	2	6	79	0.0759494
NODE_8324_length_922_cov_25.558931	291	370	3	20	79	0.2531646
NODE_8324_length_922_cov_25.558931	291	370	4	40	79	0.5063291
NODE_8324_length_922_cov_25.558931	291	370	5	13	79	0.1645570
NODE_8324_length_922_cov_25.558931	344	423	0	36	79	0.4556962
NODE_8324_length_922_cov_25.558931	344	423	1	9	79	0.1139240
NODE_8324_length_922_cov_25.558931	344	423	2	14	79	0.1772152
NODE_8324_length_922_cov_25.558931	344	423	3	20	79	0.2531646
NODE_8325_length_922_cov_25.527339	391	471	0	60	80	0.7500000
NODE_8325_length_922_cov_25.527339	391	471	1	20	80	0.2500000
NODE_8325_length_922_cov_25.527339	444	524	0	7	80	0.0875000
NODE_8325_length_922_cov_25.527339	444	524	1	33	80	0.4125000
NODE_8325_length_922_cov_25.527339	444	524	2	40	80	0.5000000
NODE_8326_length_922_cov_23.630620	224	304	8	5	80	0.0625000
NODE_8326_length_922_cov_23.630620	224	304	9	25	80	0.3125000
NODE_8326_length_922_cov_23.630620	224	304	10	37	80	0.4625000
NODE_8326_length_922_cov_23.630620	224	304	13	1	80	0.0125000
NODE_8326_length_922_cov_23.630620	224	304	14	12	80	0.1500000
NODE_8326_length_922_cov_23.630620	277	357	7	4	80	0.0500000
NODE_8326_length_922_cov_23.630620	277	357	8	2	80	0.0250000
NODE_8326_length_922_cov_23.630620	277	357	9	6	80	0.0750000
NODE_8326_length_922_cov_23.630620	277	357	10	14	80	0.1750000
NODE_8326_length_922_cov_23.630620	277	357	11	39	80	0.4875000
NODE_8326_length_922_cov_23.630620	277	357	12	1	80	0.0125000
NODE_8326_length_922_cov_23.630620	277	357	13	1	80	0.0125000
NODE_8326_length_922_cov_23.630620	277	357	14	13	80	0.1625000
NODE_8326_length_922_cov_23.630620	353	433	4	26	80	0.3250000
NODE_8326_length_922_cov_23.630620	353	433	5	28	80	0.3500000
NODE_8326_length_922_cov_23.630620	353	433	6	13	80	0.1625000
NODE_8326_length_922_cov_23.630620	353	433	7	13	80	0.1625000
NODE_8326_length_922_cov_23.630620	406	486	2	44	80	0.5500000
NODE_8326_length_922_cov_23.630620	406	486	3	1	80	0.0125000
NODE_8326_length_922_cov_23.630620	406	486	4	24	80	0.3000000
NODE_8326_length_922_cov_23.630620	406	486	5	6	80	0.0750000
NODE_8326_length_922_cov_23.630620	406	486	6	5	80	0.0625000
NODE_8327_length_922_cov_22.388821	465	545	2	4	80	0.0500000
NODE_8327_length_922_cov_22.388821	465	545	3	35	80	0.4375000
NODE_8327_length_922_cov_22.388821	465	545	4	38	80	0.4750000
NODE_8327_length_922_cov_22.388821	465	545	5	3	80	0.0375000
NODE_8327_length_922_cov_22.388821	518	598	3	37	80	0.4625000
NODE_8327_length_922_cov_22.388821	518	598	4	26	80	0.3250000
NODE_8327_length_922_cov_22.388821	518	598	5	17	80	0.2125000
NODE_8328_length_922_cov_20.320778	421	501	0	80	80	1.0000000
NODE_8328_length_922_cov_20.320778	474	554	0	80	80	1.0000000
NODE_8329_length_922_cov_17.645200	413	479	0	8	66	0.1212121
NODE_8329_length_922_cov_17.645200	413	479	1	25	66	0.3787879
NODE_8329_length_922_cov_17.645200	413	479	2	33	66	0.5000000
NODE_8330_length_922_cov_12.574727	454	534	7	14	80	0.1750000
NODE_8330_length_922_cov_12.574727	454	534	9	8	80	0.1000000
NODE_8330_length_922_cov_12.574727	454	534	10	34	80	0.4250000
NODE_8330_length_922_cov_12.574727	454	534	11	12	80	0.1500000
NODE_8330_length_922_cov_12.574727	454	534	12	12	80	0.1500000
NODE_8330_length_922_cov_12.574727	507	587	9	13	80	0.1625000
NODE_8330_length_922_cov_12.574727	507	587	10	25	80	0.3125000
NODE_8330_length_922_cov_12.574727	507	587	11	16	80	0.2000000
NODE_8330_length_922_cov_12.574727	507	587	12	25	80	0.3125000
NODE_8330_length_922_cov_12.574727	507	587	13	1	80	0.0125000
NODE_8331_length_922_cov_11.934386	255	335	7	1	80	0.0125000
NODE_8331_length_922_cov_11.934386	255	335	10	13	80	0.1625000
NODE_8331_length_922_cov_11.934386	255	335	11	60	80	0.7500000
NODE_8331_length_922_cov_11.934386	255	335	12	6	80	0.0750000
NODE_8331_length_922_cov_11.934386	308	388	4	3	80	0.0375000
NODE_8331_length_922_cov_11.934386	308	388	7	37	80	0.4625000
NODE_8331_length_922_cov_11.934386	308	388	8	12	80	0.1500000
NODE_8331_length_922_cov_11.934386	308	388	9	2	80	0.0250000
NODE_8331_length_922_cov_11.934386	308	388	10	6	80	0.0750000
NODE_8331_length_922_cov_11.934386	308	388	11	20	80	0.2500000
NODE_8332_length_922_cov_11.068044	423	503	0	29	80	0.3625000
NODE_8332_length_922_cov_11.068044	423	503	2	51	80	0.6375000
NODE_8332_length_922_cov_11.068044	476	557	2	81	81	1.0000000
NODE_8333_length_922_cov_7.907655	441	521	6	5	80	0.0625000
NODE_8333_length_922_cov_7.907655	441	521	7	2	80	0.0250000
NODE_8333_length_922_cov_7.907655	441	521	8	30	80	0.3750000
NODE_8333_length_922_cov_7.907655	441	521	9	29	80	0.3625000
NODE_8333_length_922_cov_7.907655	441	521	10	14	80	0.1750000
NODE_8333_length_922_cov_7.907655	494	574	7	6	80	0.0750000
NODE_8333_length_922_cov_7.907655	494	574	8	7	80	0.0875000
NODE_8333_length_922_cov_7.907655	494	574	9	53	80	0.6625000
NODE_8333_length_922_cov_7.907655	494	574	10	14	80	0.1750000
NODE_8334_length_922_cov_7.737546	463	543	2	18	80	0.2250000
NODE_8334_length_922_cov_7.737546	463	543	3	1	80	0.0125000
NODE_8334_length_922_cov_7.737546	463	543	4	61	80	0.7625000
NODE_8334_length_922_cov_7.737546	516	596	2	61	80	0.7625000
NODE_8334_length_922_cov_7.737546	516	596	3	1	80	0.0125000
NODE_8334_length_922_cov_7.737546	516	596	4	18	80	0.2250000
NODE_8335_length_922_cov_7.241798	298	378	1	14	80	0.1750000
NODE_8335_length_922_cov_7.241798	298	378	3	64	80	0.8000000
NODE_8335_length_922_cov_7.241798	298	378	4	2	80	0.0250000
NODE_8335_length_922_cov_7.241798	351	431	3	80	80	1.0000000
NODE_8347_length_921_cov_21.317518	457	537	3	16	80	0.2000000
NODE_8347_length_921_cov_21.317518	457	537	4	52	80	0.6500000
NODE_8347_length_921_cov_21.317518	457	537	6	12	80	0.1500000
NODE_8347_length_921_cov_21.317518	510	590	1	16	80	0.2000000
NODE_8347_length_921_cov_21.317518	510	590	2	26	80	0.3250000
NODE_8347_length_921_cov_21.317518	510	590	3	13	80	0.1625000
NODE_8347_length_921_cov_21.317518	510	590	4	25	80	0.3125000
NODE_8348_length_921_cov_18.462287	519	599	2	80	80	1.0000000
NODE_8348_length_921_cov_18.462287	572	652	1	18	80	0.2250000
NODE_8348_length_921_cov_18.462287	572	652	2	62	80	0.7750000
NODE_8349_length_921_cov_15.440389	373	453	6	24	80	0.3000000
NODE_8349_length_921_cov_15.440389	373	453	7	6	80	0.0750000
NODE_8349_length_921_cov_15.440389	373	453	8	50	80	0.6250000
NODE_8349_length_921_cov_15.440389	426	506	5	4	80	0.0500000
NODE_8349_length_921_cov_15.440389	426	506	6	37	80	0.4625000
NODE_8349_length_921_cov_15.440389	426	506	7	3	80	0.0375000
NODE_8349_length_921_cov_15.440389	426	506	8	36	80	0.4500000
NODE_8350_length_921_cov_13.216545	465	545	1	22	80	0.2750000
NODE_8350_length_921_cov_13.216545	465	545	2	22	80	0.2750000
NODE_8350_length_921_cov_13.216545	465	545	3	4	80	0.0500000
NODE_8350_length_921_cov_13.216545	465	545	4	32	80	0.4000000
NODE_8350_length_921_cov_13.216545	518	598	1	22	80	0.2750000
NODE_8350_length_921_cov_13.216545	518	598	2	11	80	0.1375000
NODE_8350_length_921_cov_13.216545	518	598	3	47	80	0.5875000
NODE_8351_length_921_cov_9.283455	399	439	2	40	40	1.0000000
NODE_8351_length_921_cov_9.283455	532	612	9	4	80	0.0500000
NODE_8351_length_921_cov_9.283455	532	612	10	16	80	0.2000000
NODE_8351_length_921_cov_9.283455	532	612	11	4	80	0.0500000
NODE_8351_length_921_cov_9.283455	532	612	12	2	80	0.0250000
NODE_8351_length_921_cov_9.283455	532	612	13	33	80	0.4125000
NODE_8351_length_921_cov_9.283455	532	612	14	4	80	0.0500000
NODE_8351_length_921_cov_9.283455	532	612	16	9	80	0.1125000
NODE_8351_length_921_cov_9.283455	532	612	17	8	80	0.1000000
NODE_8351_length_921_cov_9.283455	585	665	12	34	80	0.4250000
NODE_8351_length_921_cov_9.283455	585	665	13	23	80	0.2875000
NODE_8351_length_921_cov_9.283455	585	665	14	6	80	0.0750000
NODE_8351_length_921_cov_9.283455	585	665	16	9	80	0.1125000
NODE_8351_length_921_cov_9.283455	585	665	17	8	80	0.1000000
NODE_8352_length_921_cov_8.253041	289	369	0	80	80	1.0000000
NODE_8352_length_921_cov_8.253041	342	422	0	80	80	1.0000000
NODE_8364_length_920_cov_47.493301	543	623	3	4	80	0.0500000
NODE_8364_length_920_cov_47.493301	543	623	4	19	80	0.2375000
NODE_8364_length_920_cov_47.493301	543	623	6	57	80	0.7125000
NODE_8364_length_920_cov_47.493301	596	676	3	39	80	0.4875000
NODE_8364_length_920_cov_47.493301	596	676	4	28	80	0.3500000
NODE_8364_length_920_cov_47.493301	596	676	6	13	80	0.1625000
NODE_8365_length_920_cov_30.404385	543	623	0	72	80	0.9000000
NODE_8365_length_920_cov_30.404385	543	623	1	8	80	0.1000000
NODE_8365_length_920_cov_30.404385	596	676	0	25	80	0.3125000
NODE_8365_length_920_cov_30.404385	596	676	1	55	80	0.6875000
NODE_8366_length_920_cov_25.360536	413	493	13	11	80	0.1375000
NODE_8366_length_920_cov_25.360536	413	493	15	15	80	0.1875000
NODE_8366_length_920_cov_25.360536	413	493	16	5	80	0.0625000
NODE_8366_length_920_cov_25.360536	413	493	17	6	80	0.0750000
NODE_8366_length_920_cov_25.360536	413	493	18	13	80	0.1625000
NODE_8366_length_920_cov_25.360536	413	493	20	2	80	0.0250000
NODE_8366_length_920_cov_25.360536	413	493	21	3	80	0.0375000
NODE_8366_length_920_cov_25.360536	413	493	22	17	80	0.2125000
NODE_8366_length_920_cov_25.360536	413	493	23	1	80	0.0125000
NODE_8366_length_920_cov_25.360536	413	493	24	7	80	0.0875000
NODE_8366_length_920_cov_25.360536	466	546	13	11	80	0.1375000
NODE_8366_length_920_cov_25.360536	466	546	14	2	80	0.0250000
NODE_8366_length_920_cov_25.360536	466	546	15	18	80	0.2250000
NODE_8366_length_920_cov_25.360536	466	546	16	12	80	0.1500000
NODE_8366_length_920_cov_25.360536	466	546	17	4	80	0.0500000
NODE_8366_length_920_cov_25.360536	466	546	18	1	80	0.0125000
NODE_8366_length_920_cov_25.360536	466	546	19	7	80	0.0875000
NODE_8366_length_920_cov_25.360536	466	546	20	1	80	0.0125000
NODE_8366_length_920_cov_25.360536	466	546	27	6	80	0.0750000
NODE_8366_length_920_cov_25.360536	466	546	28	2	80	0.0250000
NODE_8366_length_920_cov_25.360536	466	546	29	3	80	0.0375000
NODE_8366_length_920_cov_25.360536	466	546	30	6	80	0.0750000
NODE_8366_length_920_cov_25.360536	466	546	31	4	80	0.0500000
NODE_8366_length_920_cov_25.360536	466	546	32	2	80	0.0250000
NODE_8366_length_920_cov_25.360536	466	546	33	1	80	0.0125000
NODE_8366_length_920_cov_25.360536	542	615	31	4	73	0.0547945
NODE_8366_length_920_cov_25.360536	542	615	32	2	73	0.0273973
NODE_8366_length_920_cov_25.360536	542	615	33	3	73	0.0410959
NODE_8366_length_920_cov_25.360536	542	615	35	2	73	0.0273973
NODE_8366_length_920_cov_25.360536	542	615	36	1	73	0.0136986
NODE_8366_length_920_cov_25.360536	542	615	37	1	73	0.0136986
NODE_8366_length_920_cov_25.360536	542	615	38	5	73	0.0684932
NODE_8366_length_920_cov_25.360536	542	615	39	14	73	0.1917808
NODE_8366_length_920_cov_25.360536	542	615	46	2	73	0.0273973
NODE_8366_length_920_cov_25.360536	542	615	47	6	73	0.0821918
NODE_8366_length_920_cov_25.360536	542	615	48	7	73	0.0958904
NODE_8366_length_920_cov_25.360536	542	615	50	6	73	0.0821918
NODE_8366_length_920_cov_25.360536	542	615	51	4	73	0.0547945
NODE_8366_length_920_cov_25.360536	542	615	52	3	73	0.0410959
NODE_8366_length_920_cov_25.360536	542	615	53	7	73	0.0958904
NODE_8366_length_920_cov_25.360536	542	615	54	6	73	0.0821918
NODE_8366_length_920_cov_25.360536	588	668	41	3	80	0.0375000
NODE_8366_length_920_cov_25.360536	588	668	43	2	80	0.0250000
NODE_8366_length_920_cov_25.360536	588	668	45	8	80	0.1000000
NODE_8366_length_920_cov_25.360536	588	668	48	1	80	0.0125000
NODE_8366_length_920_cov_25.360536	588	668	50	6	80	0.0750000
NODE_8366_length_920_cov_25.360536	588	668	51	4	80	0.0500000
NODE_8366_length_920_cov_25.360536	588	668	52	3	80	0.0375000
NODE_8366_length_920_cov_25.360536	588	668	53	9	80	0.1125000
NODE_8366_length_920_cov_25.360536	588	668	54	6	80	0.0750000
NODE_8366_length_920_cov_25.360536	588	668	55	8	80	0.1000000
NODE_8366_length_920_cov_25.360536	588	668	56	10	80	0.1250000
NODE_8366_length_920_cov_25.360536	588	668	57	12	80	0.1500000
NODE_8366_length_920_cov_25.360536	588	668	58	6	80	0.0750000
NODE_8366_length_920_cov_25.360536	588	668	59	2	80	0.0250000
NODE_8367_length_920_cov_24.918392	403	483	4	28	80	0.3500000
NODE_8367_length_920_cov_24.918392	403	483	5	13	80	0.1625000
NODE_8367_length_920_cov_24.918392	403	483	6	39	80	0.4875000
NODE_8367_length_920_cov_24.918392	456	536	4	10	80	0.1250000
NODE_8367_length_920_cov_24.918392	456	536	5	29	80	0.3625000
NODE_8367_length_920_cov_24.918392	456	536	6	41	80	0.5125000
NODE_8368_length_920_cov_18.517661	353	433	2	4	80	0.0500000
NODE_8368_length_920_cov_18.517661	353	433	3	69	80	0.8625000
NODE_8368_length_920_cov_18.517661	353	433	4	7	80	0.0875000
NODE_8368_length_920_cov_18.517661	406	486	2	17	80	0.2125000
NODE_8368_length_920_cov_18.517661	406	486	3	56	80	0.7000000
NODE_8368_length_920_cov_18.517661	406	486	4	7	80	0.0875000
NODE_8369_length_920_cov_17.710110	310	390	1	15	80	0.1875000
NODE_8369_length_920_cov_17.710110	310	390	2	63	80	0.7875000
NODE_8369_length_920_cov_17.710110	310	390	3	2	80	0.0250000
NODE_8369_length_920_cov_17.710110	363	443	2	80	80	1.0000000
NODE_8370_length_920_cov_15.650426	403	458	6	1	55	0.0181818
NODE_8370_length_920_cov_15.650426	403	458	7	8	55	0.1454545
NODE_8370_length_920_cov_15.650426	403	458	10	16	55	0.2909091
NODE_8370_length_920_cov_15.650426	403	458	11	30	55	0.5454546
NODE_8371_length_920_cov_12.588307	454	534	17	19	80	0.2375000
NODE_8371_length_920_cov_12.588307	454	534	18	2	80	0.0250000
NODE_8371_length_920_cov_12.588307	454	534	19	29	80	0.3625000
NODE_8371_length_920_cov_12.588307	454	534	21	5	80	0.0625000
NODE_8371_length_920_cov_12.588307	454	534	22	3	80	0.0375000
NODE_8371_length_920_cov_12.588307	454	534	23	22	80	0.2750000
NODE_8371_length_920_cov_12.588307	507	586	8	3	79	0.0379747
NODE_8371_length_920_cov_12.588307	507	586	10	18	79	0.2278481
NODE_8371_length_920_cov_12.588307	507	586	12	10	79	0.1265823
NODE_8371_length_920_cov_12.588307	507	586	13	5	79	0.0632911
NODE_8371_length_920_cov_12.588307	507	586	14	4	79	0.0506329
NODE_8371_length_920_cov_12.588307	507	586	16	5	79	0.0632911
NODE_8371_length_920_cov_12.588307	507	586	18	9	79	0.1139240
NODE_8371_length_920_cov_12.588307	507	586	19	19	79	0.2405063
NODE_8371_length_920_cov_12.588307	507	586	22	3	79	0.0379747
NODE_8371_length_920_cov_12.588307	507	586	23	3	79	0.0379747
NODE_8372_length_920_cov_10.822168	354	434	7	28	80	0.3500000
NODE_8372_length_920_cov_10.822168	354	434	8	52	80	0.6500000
NODE_8372_length_920_cov_10.822168	407	487	3	3	80	0.0375000
NODE_8372_length_920_cov_10.822168	407	487	4	3	80	0.0375000
NODE_8372_length_920_cov_10.822168	407	487	5	27	80	0.3375000
NODE_8372_length_920_cov_10.822168	407	487	6	2	80	0.0250000
NODE_8372_length_920_cov_10.822168	407	487	7	31	80	0.3875000
NODE_8372_length_920_cov_10.822168	407	487	8	14	80	0.1750000
NODE_8374_length_920_cov_8.297199	453	533	0	80	80	1.0000000
NODE_8374_length_920_cov_8.297199	506	583	0	77	77	1.0000000
NODE_8378_length_920_cov_2.992692	501	581	2	45	80	0.5625000
NODE_8378_length_920_cov_2.992692	501	581	4	35	80	0.4375000
NODE_8378_length_920_cov_2.992692	554	634	0	1	80	0.0125000
NODE_8378_length_920_cov_2.992692	554	634	2	79	80	0.9875000
NODE_8389_length_919_cov_44.813415	338	418	19	1	80	0.0125000
NODE_8389_length_919_cov_44.813415	338	418	20	1	80	0.0125000
NODE_8389_length_919_cov_44.813415	338	418	21	3	80	0.0375000
NODE_8389_length_919_cov_44.813415	338	418	23	9	80	0.1125000
NODE_8389_length_919_cov_44.813415	338	418	24	4	80	0.0500000
NODE_8389_length_919_cov_44.813415	338	418	25	13	80	0.1625000
NODE_8389_length_919_cov_44.813415	338	418	26	25	80	0.3125000
NODE_8389_length_919_cov_44.813415	338	418	27	11	80	0.1375000
NODE_8389_length_919_cov_44.813415	338	418	28	3	80	0.0375000
NODE_8389_length_919_cov_44.813415	338	418	29	10	80	0.1250000
NODE_8389_length_919_cov_44.813415	391	471	11	18	80	0.2250000
NODE_8389_length_919_cov_44.813415	391	471	12	5	80	0.0625000
NODE_8389_length_919_cov_44.813415	391	471	14	9	80	0.1125000
NODE_8389_length_919_cov_44.813415	391	471	15	4	80	0.0500000
NODE_8389_length_919_cov_44.813415	391	471	19	18	80	0.2250000
NODE_8389_length_919_cov_44.813415	391	471	20	1	80	0.0125000
NODE_8389_length_919_cov_44.813415	391	471	21	3	80	0.0375000
NODE_8389_length_919_cov_44.813415	391	471	23	9	80	0.1125000
NODE_8389_length_919_cov_44.813415	391	471	25	9	80	0.1125000
NODE_8389_length_919_cov_44.813415	391	471	26	4	80	0.0500000
NODE_8389_length_919_cov_44.813415	467	547	1	3	80	0.0375000
NODE_8389_length_919_cov_44.813415	467	547	2	14	80	0.1750000
NODE_8389_length_919_cov_44.813415	467	547	3	3	80	0.0375000
NODE_8389_length_919_cov_44.813415	467	547	4	11	80	0.1375000
NODE_8389_length_919_cov_44.813415	467	547	5	6	80	0.0750000
NODE_8389_length_919_cov_44.813415	467	547	6	18	80	0.2250000
NODE_8389_length_919_cov_44.813415	467	547	8	4	80	0.0500000
NODE_8389_length_919_cov_44.813415	467	547	9	1	80	0.0125000
NODE_8389_length_919_cov_44.813415	467	547	10	3	80	0.0375000
NODE_8389_length_919_cov_44.813415	467	547	11	17	80	0.2125000
NODE_8389_length_919_cov_44.813415	520	600	1	4	80	0.0500000
NODE_8389_length_919_cov_44.813415	520	600	2	14	80	0.1750000
NODE_8389_length_919_cov_44.813415	520	600	3	55	80	0.6875000
NODE_8389_length_919_cov_44.813415	520	600	4	7	80	0.0875000
NODE_8390_length_919_cov_37.459756	389	469	2	39	80	0.4875000
NODE_8390_length_919_cov_37.459756	389	469	7	41	80	0.5125000
NODE_8390_length_919_cov_37.459756	442	522	5	8	80	0.1000000
NODE_8390_length_919_cov_37.459756	442	522	6	30	80	0.3750000
NODE_8390_length_919_cov_37.459756	442	522	7	42	80	0.5250000
NODE_8390_length_919_cov_37.459756	518	598	2	5	80	0.0625000
NODE_8390_length_919_cov_37.459756	518	598	5	35	80	0.4375000
NODE_8390_length_919_cov_37.459756	518	598	6	23	80	0.2875000
NODE_8390_length_919_cov_37.459756	518	598	7	17	80	0.2125000
NODE_8390_length_919_cov_37.459756	571	651	2	5	80	0.0625000
NODE_8390_length_919_cov_37.459756	571	651	6	67	80	0.8375000
NODE_8390_length_919_cov_37.459756	571	651	7	7	80	0.0875000
NODE_8390_length_919_cov_37.459756	571	651	8	1	80	0.0125000
NODE_8391_length_919_cov_35.002439	474	554	6	55	80	0.6875000
NODE_8391_length_919_cov_35.002439	474	554	7	25	80	0.3125000
NODE_8391_length_919_cov_35.002439	527	607	1	15	80	0.1875000
NODE_8391_length_919_cov_35.002439	527	607	3	27	80	0.3375000
NODE_8391_length_919_cov_35.002439	527	607	4	6	80	0.0750000
NODE_8391_length_919_cov_35.002439	527	607	6	32	80	0.4000000
NODE_8392_length_919_cov_29.935366	246	326	9	12	80	0.1500000
NODE_8392_length_919_cov_29.935366	246	326	11	36	80	0.4500000
NODE_8392_length_919_cov_29.935366	246	326	12	5	80	0.0625000
NODE_8392_length_919_cov_29.935366	246	326	14	2	80	0.0250000
NODE_8392_length_919_cov_29.935366	246	326	15	19	80	0.2375000
NODE_8392_length_919_cov_29.935366	246	326	17	6	80	0.0750000
NODE_8392_length_919_cov_29.935366	299	379	14	5	80	0.0625000
NODE_8392_length_919_cov_29.935366	299	379	15	19	80	0.2375000
NODE_8392_length_919_cov_29.935366	299	379	17	31	80	0.3875000
NODE_8392_length_919_cov_29.935366	299	379	18	25	80	0.3125000
NODE_8393_length_919_cov_28.190244	470	550	6	1	80	0.0125000
NODE_8393_length_919_cov_28.190244	470	550	7	50	80	0.6250000
NODE_8393_length_919_cov_28.190244	470	550	8	29	80	0.3625000
NODE_8393_length_919_cov_28.190244	523	603	2	11	80	0.1375000
NODE_8393_length_919_cov_28.190244	523	603	4	2	80	0.0250000
NODE_8393_length_919_cov_28.190244	523	603	6	4	80	0.0500000
NODE_8393_length_919_cov_28.190244	523	603	7	14	80	0.1750000
NODE_8393_length_919_cov_28.190244	523	603	8	49	80	0.6125000
NODE_8394_length_919_cov_27.119512	454	534	9	17	80	0.2125000
NODE_8394_length_919_cov_27.119512	454	534	10	2	80	0.0250000
NODE_8394_length_919_cov_27.119512	454	534	14	27	80	0.3375000
NODE_8394_length_919_cov_27.119512	454	534	15	26	80	0.3250000
NODE_8394_length_919_cov_27.119512	454	534	17	8	80	0.1000000
NODE_8394_length_919_cov_27.119512	507	587	10	20	80	0.2500000
NODE_8394_length_919_cov_27.119512	507	587	12	12	80	0.1500000
NODE_8394_length_919_cov_27.119512	507	587	13	4	80	0.0500000
NODE_8394_length_919_cov_27.119512	507	587	14	25	80	0.3125000
NODE_8394_length_919_cov_27.119512	507	587	15	2	80	0.0250000
NODE_8394_length_919_cov_27.119512	507	587	16	8	80	0.1000000
NODE_8394_length_919_cov_27.119512	507	587	17	9	80	0.1125000
NODE_8395_length_919_cov_21.836585	545	625	0	15	80	0.1875000
NODE_8395_length_919_cov_21.836585	545	625	1	65	80	0.8125000
NODE_8395_length_919_cov_21.836585	598	677	1	79	79	1.0000000
NODE_8396_length_919_cov_17.442683	385	465	5	7	80	0.0875000
NODE_8396_length_919_cov_17.442683	385	465	6	26	80	0.3250000
NODE_8396_length_919_cov_17.442683	385	465	9	3	80	0.0375000
NODE_8396_length_919_cov_17.442683	385	465	10	10	80	0.1250000
NODE_8396_length_919_cov_17.442683	385	465	11	33	80	0.4125000
NODE_8396_length_919_cov_17.442683	385	465	12	1	80	0.0125000
NODE_8396_length_919_cov_17.442683	438	518	10	9	80	0.1125000
NODE_8396_length_919_cov_17.442683	438	518	11	26	80	0.3250000
NODE_8396_length_919_cov_17.442683	438	518	12	45	80	0.5625000
NODE_8397_length_919_cov_16.685366	309	389	3	7	80	0.0875000
NODE_8397_length_919_cov_16.685366	309	389	4	43	80	0.5375000
NODE_8397_length_919_cov_16.685366	309	389	5	26	80	0.3250000
NODE_8397_length_919_cov_16.685366	309	389	6	4	80	0.0500000
NODE_8397_length_919_cov_16.685366	362	442	4	16	80	0.2000000
NODE_8397_length_919_cov_16.685366	362	442	5	42	80	0.5250000
NODE_8397_length_919_cov_16.685366	362	442	6	22	80	0.2750000
NODE_8398_length_919_cov_14.013415	435	515	0	14	80	0.1750000
NODE_8398_length_919_cov_14.013415	435	515	1	17	80	0.2125000
NODE_8398_length_919_cov_14.013415	435	515	2	17	80	0.2125000
NODE_8398_length_919_cov_14.013415	435	515	4	32	80	0.4000000
NODE_8398_length_919_cov_14.013415	488	568	4	41	80	0.5125000
NODE_8398_length_919_cov_14.013415	488	568	5	24	80	0.3000000
NODE_8398_length_919_cov_14.013415	488	568	6	15	80	0.1875000
NODE_8399_length_919_cov_12.013415	340	420	5	21	80	0.2625000
NODE_8399_length_919_cov_12.013415	340	420	6	49	80	0.6125000
NODE_8399_length_919_cov_12.013415	340	420	7	9	80	0.1125000
NODE_8399_length_919_cov_12.013415	340	420	8	1	80	0.0125000
NODE_8399_length_919_cov_12.013415	393	473	4	2	80	0.0250000
NODE_8399_length_919_cov_12.013415	393	473	5	5	80	0.0625000
NODE_8399_length_919_cov_12.013415	393	473	6	22	80	0.2750000
NODE_8399_length_919_cov_12.013415	393	473	7	50	80	0.6250000
NODE_8399_length_919_cov_12.013415	393	473	8	1	80	0.0125000
NODE_8403_length_919_cov_3.529268	424	504	0	80	80	1.0000000
NODE_8403_length_919_cov_3.529268	477	557	0	80	80	1.0000000
NODE_8404_length_919_cov_3.200000	444	524	0	80	80	1.0000000
NODE_8404_length_919_cov_3.200000	497	577	0	80	80	1.0000000
NODE_8415_length_918_cov_41.115995	387	467	21	2	80	0.0250000
NODE_8415_length_918_cov_41.115995	387	467	23	2	80	0.0250000
NODE_8415_length_918_cov_41.115995	387	467	25	4	80	0.0500000
NODE_8415_length_918_cov_41.115995	387	467	26	4	80	0.0500000
NODE_8415_length_918_cov_41.115995	387	467	27	6	80	0.0750000
NODE_8415_length_918_cov_41.115995	387	467	29	3	80	0.0375000
NODE_8415_length_918_cov_41.115995	387	467	30	1	80	0.0125000
NODE_8415_length_918_cov_41.115995	387	467	32	3	80	0.0375000
NODE_8415_length_918_cov_41.115995	387	467	33	7	80	0.0875000
NODE_8415_length_918_cov_41.115995	387	467	34	1	80	0.0125000
NODE_8415_length_918_cov_41.115995	387	467	35	18	80	0.2250000
NODE_8415_length_918_cov_41.115995	387	467	36	7	80	0.0875000
NODE_8415_length_918_cov_41.115995	387	467	37	6	80	0.0750000
NODE_8415_length_918_cov_41.115995	387	467	39	10	80	0.1250000
NODE_8415_length_918_cov_41.115995	387	467	40	6	80	0.0750000
NODE_8415_length_918_cov_41.115995	440	520	28	1	80	0.0125000
NODE_8415_length_918_cov_41.115995	440	520	30	1	80	0.0125000
NODE_8415_length_918_cov_41.115995	440	520	33	16	80	0.2000000
NODE_8415_length_918_cov_41.115995	440	520	34	7	80	0.0875000
NODE_8415_length_918_cov_41.115995	440	520	35	14	80	0.1750000
NODE_8415_length_918_cov_41.115995	440	520	36	6	80	0.0750000
NODE_8415_length_918_cov_41.115995	440	520	37	19	80	0.2375000
NODE_8415_length_918_cov_41.115995	440	520	39	10	80	0.1250000
NODE_8415_length_918_cov_41.115995	440	520	40	6	80	0.0750000
NODE_8416_length_918_cov_37.405372	427	507	5	10	80	0.1250000
NODE_8416_length_918_cov_37.405372	427	507	7	5	80	0.0625000
NODE_8416_length_918_cov_37.405372	427	507	8	18	80	0.2250000
NODE_8416_length_918_cov_37.405372	427	507	9	6	80	0.0750000
NODE_8416_length_918_cov_37.405372	427	507	10	30	80	0.3750000
NODE_8416_length_918_cov_37.405372	427	507	13	11	80	0.1375000
NODE_8416_length_918_cov_37.405372	480	560	5	63	80	0.7875000
NODE_8416_length_918_cov_37.405372	480	560	8	17	80	0.2125000
NODE_8417_length_918_cov_31.559219	289	369	8	1	80	0.0125000
NODE_8417_length_918_cov_31.559219	289	369	9	2	80	0.0250000
NODE_8417_length_918_cov_31.559219	289	369	10	1	80	0.0125000
NODE_8417_length_918_cov_31.559219	289	369	11	10	80	0.1250000
NODE_8417_length_918_cov_31.559219	289	369	12	8	80	0.1000000
NODE_8417_length_918_cov_31.559219	289	369	13	4	80	0.0500000
NODE_8417_length_918_cov_31.559219	289	369	15	27	80	0.3375000
NODE_8417_length_918_cov_31.559219	289	369	16	8	80	0.1000000
NODE_8417_length_918_cov_31.559219	289	369	17	17	80	0.2125000
NODE_8417_length_918_cov_31.559219	289	369	18	2	80	0.0250000
NODE_8417_length_918_cov_31.559219	342	422	14	2	80	0.0250000
NODE_8417_length_918_cov_31.559219	342	422	15	2	80	0.0250000
NODE_8417_length_918_cov_31.559219	342	422	16	15	80	0.1875000
NODE_8417_length_918_cov_31.559219	342	422	17	19	80	0.2375000
NODE_8417_length_918_cov_31.559219	342	422	18	10	80	0.1250000
NODE_8417_length_918_cov_31.559219	342	422	19	21	80	0.2625000
NODE_8417_length_918_cov_31.559219	342	422	20	11	80	0.1375000
NODE_8417_length_918_cov_31.559219	418	498	7	19	80	0.2375000
NODE_8417_length_918_cov_31.559219	418	498	8	14	80	0.1750000
NODE_8417_length_918_cov_31.559219	418	498	9	4	80	0.0500000
NODE_8417_length_918_cov_31.559219	418	498	10	8	80	0.1000000
NODE_8417_length_918_cov_31.559219	418	498	11	10	80	0.1250000
NODE_8417_length_918_cov_31.559219	418	498	12	1	80	0.0125000
NODE_8417_length_918_cov_31.559219	418	498	13	2	80	0.0250000
NODE_8417_length_918_cov_31.559219	418	498	14	20	80	0.2500000
NODE_8417_length_918_cov_31.559219	418	498	15	2	80	0.0250000
NODE_8417_length_918_cov_31.559219	471	551	2	26	80	0.3250000
NODE_8417_length_918_cov_31.559219	471	551	4	8	80	0.1000000
NODE_8417_length_918_cov_31.559219	471	551	6	19	80	0.2375000
NODE_8417_length_918_cov_31.559219	471	551	7	13	80	0.1625000
NODE_8417_length_918_cov_31.559219	471	551	8	14	80	0.1750000
NODE_8418_length_918_cov_25.195360	429	509	0	80	80	1.0000000
NODE_8418_length_918_cov_25.195360	482	562	0	80	80	1.0000000
NODE_8420_length_918_cov_10.537241	361	441	2	37	80	0.4625000
NODE_8420_length_918_cov_10.537241	361	441	3	15	80	0.1875000
NODE_8420_length_918_cov_10.537241	361	441	4	28	80	0.3500000
NODE_8420_length_918_cov_10.537241	414	492	2	26	78	0.3333333
NODE_8420_length_918_cov_10.537241	414	492	3	25	78	0.3205128
NODE_8420_length_918_cov_10.537241	414	492	4	27	78	0.3461539
NODE_8421_length_918_cov_9.821734	283	363	2	21	80	0.2625000
NODE_8421_length_918_cov_9.821734	283	363	3	26	80	0.3250000
NODE_8421_length_918_cov_9.821734	283	363	4	16	80	0.2000000
NODE_8421_length_918_cov_9.821734	283	363	5	17	80	0.2125000
NODE_8421_length_918_cov_9.821734	336	416	3	9	80	0.1125000
NODE_8421_length_918_cov_9.821734	336	416	4	15	80	0.1875000
NODE_8421_length_918_cov_9.821734	336	416	5	56	80	0.7000000
NODE_8422_length_918_cov_9.714286	365	445	1	26	80	0.3250000
NODE_8422_length_918_cov_9.714286	365	445	2	22	80	0.2750000
NODE_8422_length_918_cov_9.714286	365	445	3	26	80	0.3250000
NODE_8422_length_918_cov_9.714286	365	445	4	6	80	0.0750000
NODE_8422_length_918_cov_9.714286	418	498	3	74	80	0.9250000
NODE_8422_length_918_cov_9.714286	418	498	4	6	80	0.0750000
NODE_8441_length_917_cov_38.845966	405	476	4	16	71	0.2253521
NODE_8441_length_917_cov_38.845966	405	476	6	29	71	0.4084507
NODE_8441_length_917_cov_38.845966	405	476	9	2	71	0.0281690
NODE_8441_length_917_cov_38.845966	405	476	10	14	71	0.1971831
NODE_8441_length_917_cov_38.845966	405	476	12	4	71	0.0563380
NODE_8441_length_917_cov_38.845966	405	476	13	6	71	0.0845070
NODE_8441_length_917_cov_38.845966	458	538	10	11	80	0.1375000
NODE_8441_length_917_cov_38.845966	458	538	11	28	80	0.3500000
NODE_8441_length_917_cov_38.845966	458	538	12	35	80	0.4375000
NODE_8441_length_917_cov_38.845966	458	538	13	6	80	0.0750000
NODE_8442_length_917_cov_37.775061	505	585	17	19	80	0.2375000
NODE_8442_length_917_cov_37.775061	505	585	18	5	80	0.0625000
NODE_8442_length_917_cov_37.775061	505	585	20	38	80	0.4750000
NODE_8442_length_917_cov_37.775061	505	585	21	13	80	0.1625000
NODE_8442_length_917_cov_37.775061	505	585	23	5	80	0.0625000
NODE_8442_length_917_cov_37.775061	558	638	14	1	80	0.0125000
NODE_8442_length_917_cov_37.775061	558	638	15	15	80	0.1875000
NODE_8442_length_917_cov_37.775061	558	638	16	16	80	0.2000000
NODE_8442_length_917_cov_37.775061	558	638	17	19	80	0.2375000
NODE_8442_length_917_cov_37.775061	558	638	18	20	80	0.2500000
NODE_8442_length_917_cov_37.775061	558	638	20	9	80	0.1125000
NODE_8443_length_917_cov_33.195599	335	415	2	5	80	0.0625000
NODE_8443_length_917_cov_33.195599	335	415	4	22	80	0.2750000
NODE_8443_length_917_cov_33.195599	335	415	5	50	80	0.6250000
NODE_8443_length_917_cov_33.195599	335	415	6	3	80	0.0375000
NODE_8443_length_917_cov_33.195599	388	468	2	27	80	0.3375000
NODE_8443_length_917_cov_33.195599	388	468	3	31	80	0.3875000
NODE_8443_length_917_cov_33.195599	388	468	4	18	80	0.2250000
NODE_8443_length_917_cov_33.195599	388	468	5	4	80	0.0500000
NODE_8443_length_917_cov_33.195599	464	544	1	37	80	0.4625000
NODE_8443_length_917_cov_33.195599	464	544	2	43	80	0.5375000
NODE_8443_length_917_cov_33.195599	517	597	1	12	80	0.1500000
NODE_8443_length_917_cov_33.195599	517	597	2	17	80	0.2125000
NODE_8443_length_917_cov_33.195599	517	597	5	22	80	0.2750000
NODE_8443_length_917_cov_33.195599	517	597	6	29	80	0.3625000
NODE_8444_length_917_cov_22.871638	463	543	9	6	80	0.0750000
NODE_8444_length_917_cov_22.871638	463	543	12	25	80	0.3125000
NODE_8444_length_917_cov_22.871638	463	543	15	28	80	0.3500000
NODE_8444_length_917_cov_22.871638	463	543	19	21	80	0.2625000
NODE_8444_length_917_cov_22.871638	516	593	14	2	77	0.0259740
NODE_8444_length_917_cov_22.871638	516	593	15	6	77	0.0779221
NODE_8444_length_917_cov_22.871638	516	593	17	1	77	0.0129870
NODE_8444_length_917_cov_22.871638	516	593	18	30	77	0.3896104
NODE_8444_length_917_cov_22.871638	516	593	19	29	77	0.3766234
NODE_8444_length_917_cov_22.871638	516	593	21	9	77	0.1168831
NODE_8445_length_917_cov_16.899756	321	401	3	6	80	0.0750000
NODE_8445_length_917_cov_16.899756	321	401	6	58	80	0.7250000
NODE_8445_length_917_cov_16.899756	321	401	7	16	80	0.2000000
NODE_8445_length_917_cov_16.899756	374	454	6	11	80	0.1375000
NODE_8445_length_917_cov_16.899756	374	454	7	16	80	0.2000000
NODE_8445_length_917_cov_16.899756	374	454	8	53	80	0.6625000
NODE_8446_length_917_cov_12.283619	397	477	9	7	80	0.0875000
NODE_8446_length_917_cov_12.283619	397	477	10	8	80	0.1000000
NODE_8446_length_917_cov_12.283619	397	477	11	22	80	0.2750000
NODE_8446_length_917_cov_12.283619	397	477	12	42	80	0.5250000
NODE_8446_length_917_cov_12.283619	397	477	13	1	80	0.0125000
NODE_8446_length_917_cov_12.283619	450	530	6	9	80	0.1125000
NODE_8446_length_917_cov_12.283619	450	530	7	11	80	0.1375000
NODE_8446_length_917_cov_12.283619	450	530	8	3	80	0.0375000
NODE_8446_length_917_cov_12.283619	450	530	9	37	80	0.4625000
NODE_8446_length_917_cov_12.283619	450	530	11	3	80	0.0375000
NODE_8446_length_917_cov_12.283619	450	530	12	17	80	0.2125000
NODE_8447_length_917_cov_12.172372	380	460	8	15	80	0.1875000
NODE_8447_length_917_cov_12.172372	380	460	9	18	80	0.2250000
NODE_8447_length_917_cov_12.172372	380	460	12	18	80	0.2250000
NODE_8447_length_917_cov_12.172372	380	460	15	1	80	0.0125000
NODE_8447_length_917_cov_12.172372	380	460	19	1	80	0.0125000
NODE_8447_length_917_cov_12.172372	380	460	21	16	80	0.2000000
NODE_8447_length_917_cov_12.172372	380	460	22	8	80	0.1000000
NODE_8447_length_917_cov_12.172372	380	460	24	3	80	0.0375000
NODE_8447_length_917_cov_12.172372	433	513	21	27	80	0.3375000
NODE_8447_length_917_cov_12.172372	433	513	22	8	80	0.1000000
NODE_8447_length_917_cov_12.172372	433	513	24	12	80	0.1500000
NODE_8447_length_917_cov_12.172372	433	513	26	20	80	0.2500000
NODE_8447_length_917_cov_12.172372	433	513	28	13	80	0.1625000
NODE_8447_length_917_cov_12.172372	545	597	23	15	52	0.2884615
NODE_8447_length_917_cov_12.172372	545	597	27	5	52	0.0961538
NODE_8447_length_917_cov_12.172372	545	597	28	2	52	0.0384615
NODE_8447_length_917_cov_12.172372	545	597	29	28	52	0.5384616
NODE_8447_length_917_cov_12.172372	545	597	32	2	52	0.0384615
NODE_8448_length_917_cov_8.277506	564	644	2	17	80	0.2125000
NODE_8448_length_917_cov_8.277506	564	644	3	42	80	0.5250000
NODE_8448_length_917_cov_8.277506	564	644	4	21	80	0.2625000
NODE_8448_length_917_cov_8.277506	617	697	0	46	80	0.5750000
NODE_8448_length_917_cov_8.277506	617	697	2	24	80	0.3000000
NODE_8448_length_917_cov_8.277506	617	697	3	10	80	0.1250000
NODE_8449_length_917_cov_8.145477	155	235	5	70	80	0.8750000
NODE_8449_length_917_cov_8.145477	155	235	7	10	80	0.1250000
NODE_8449_length_917_cov_8.145477	208	288	2	10	80	0.1250000
NODE_8449_length_917_cov_8.145477	208	288	5	55	80	0.6875000
NODE_8449_length_917_cov_8.145477	208	288	7	15	80	0.1875000
NODE_8451_length_917_cov_6.073350	366	446	0	40	80	0.5000000
NODE_8451_length_917_cov_6.073350	366	446	5	40	80	0.5000000
NODE_8451_length_917_cov_6.073350	419	499	5	80	80	1.0000000
NODE_8463_length_916_cov_32.867809	347	427	7	2	80	0.0250000
NODE_8463_length_916_cov_32.867809	347	427	8	8	80	0.1000000
NODE_8463_length_916_cov_32.867809	347	427	9	4	80	0.0500000
NODE_8463_length_916_cov_32.867809	347	427	10	44	80	0.5500000
NODE_8463_length_916_cov_32.867809	347	427	11	11	80	0.1375000
NODE_8463_length_916_cov_32.867809	347	427	12	10	80	0.1250000
NODE_8463_length_916_cov_32.867809	347	427	13	1	80	0.0125000
NODE_8463_length_916_cov_32.867809	400	480	3	7	80	0.0875000
NODE_8463_length_916_cov_32.867809	400	480	4	13	80	0.1625000
NODE_8463_length_916_cov_32.867809	400	480	5	23	80	0.2875000
NODE_8463_length_916_cov_32.867809	400	480	6	2	80	0.0250000
NODE_8463_length_916_cov_32.867809	400	480	7	10	80	0.1250000
NODE_8463_length_916_cov_32.867809	400	480	8	8	80	0.1000000
NODE_8463_length_916_cov_32.867809	400	480	10	17	80	0.2125000
NODE_8464_length_916_cov_27.673195	450	530	11	16	80	0.2000000
NODE_8464_length_916_cov_27.673195	450	530	12	4	80	0.0500000
NODE_8464_length_916_cov_27.673195	450	530	13	15	80	0.1875000
NODE_8464_length_916_cov_27.673195	450	530	14	11	80	0.1375000
NODE_8464_length_916_cov_27.673195	450	530	15	29	80	0.3625000
NODE_8464_length_916_cov_27.673195	450	530	16	5	80	0.0625000
NODE_8464_length_916_cov_27.673195	503	583	8	24	80	0.3000000
NODE_8464_length_916_cov_27.673195	503	583	10	9	80	0.1125000
NODE_8464_length_916_cov_27.673195	503	583	12	19	80	0.2375000
NODE_8464_length_916_cov_27.673195	503	583	13	13	80	0.1625000
NODE_8464_length_916_cov_27.673195	503	583	14	8	80	0.1000000
NODE_8464_length_916_cov_27.673195	503	583	15	7	80	0.0875000
NODE_8465_length_916_cov_27.146879	223	303	18	1	80	0.0125000
NODE_8465_length_916_cov_27.146879	223	303	19	8	80	0.1000000
NODE_8465_length_916_cov_27.146879	223	303	20	15	80	0.1875000
NODE_8465_length_916_cov_27.146879	223	303	22	1	80	0.0125000
NODE_8465_length_916_cov_27.146879	223	303	25	8	80	0.1000000
NODE_8465_length_916_cov_27.146879	223	303	26	7	80	0.0875000
NODE_8465_length_916_cov_27.146879	223	303	27	28	80	0.3500000
NODE_8465_length_916_cov_27.146879	223	303	28	12	80	0.1500000
NODE_8465_length_916_cov_27.146879	276	356	6	8	80	0.1000000
NODE_8465_length_916_cov_27.146879	276	356	8	17	80	0.2125000
NODE_8465_length_916_cov_27.146879	276	356	9	11	80	0.1375000
NODE_8465_length_916_cov_27.146879	276	356	12	4	80	0.0500000
NODE_8465_length_916_cov_27.146879	276	356	13	2	80	0.0250000
NODE_8465_length_916_cov_27.146879	276	356	17	4	80	0.0500000
NODE_8465_length_916_cov_27.146879	276	356	18	8	80	0.1000000
NODE_8465_length_916_cov_27.146879	276	356	19	8	80	0.1000000
NODE_8465_length_916_cov_27.146879	276	356	20	15	80	0.1875000
NODE_8465_length_916_cov_27.146879	276	356	22	1	80	0.0125000
NODE_8465_length_916_cov_27.146879	276	356	25	2	80	0.0250000
NODE_8466_length_916_cov_25.604651	398	478	11	2	80	0.0250000
NODE_8466_length_916_cov_25.604651	398	478	12	21	80	0.2625000
NODE_8466_length_916_cov_25.604651	398	478	13	44	80	0.5500000
NODE_8466_length_916_cov_25.604651	398	478	14	13	80	0.1625000
NODE_8466_length_916_cov_25.604651	451	531	10	6	80	0.0750000
NODE_8466_length_916_cov_25.604651	451	531	11	34	80	0.4250000
NODE_8466_length_916_cov_25.604651	451	531	12	11	80	0.1375000
NODE_8466_length_916_cov_25.604651	451	531	13	29	80	0.3625000
NODE_8467_length_916_cov_18.035496	456	536	1	21	80	0.2625000
NODE_8467_length_916_cov_18.035496	456	536	2	19	80	0.2375000
NODE_8467_length_916_cov_18.035496	456	536	4	40	80	0.5000000
NODE_8467_length_916_cov_18.035496	509	589	3	30	80	0.3750000
NODE_8467_length_916_cov_18.035496	509	589	4	50	80	0.6250000
NODE_8468_length_916_cov_12.651163	500	580	4	60	80	0.7500000
NODE_8468_length_916_cov_12.651163	500	580	5	1	80	0.0125000
NODE_8468_length_916_cov_12.651163	500	580	8	19	80	0.2375000
NODE_8468_length_916_cov_12.651163	553	633	4	26	80	0.3250000
NODE_8468_length_916_cov_12.651163	553	633	5	7	80	0.0875000
NODE_8468_length_916_cov_12.651163	553	633	8	47	80	0.5875000
NODE_8469_length_916_cov_11.337821	530	610	4	34	80	0.4250000
NODE_8469_length_916_cov_11.337821	530	610	6	3	80	0.0375000
NODE_8469_length_916_cov_11.337821	530	610	7	8	80	0.1000000
NODE_8469_length_916_cov_11.337821	530	610	8	12	80	0.1500000
NODE_8469_length_916_cov_11.337821	530	610	9	23	80	0.2875000
NODE_8469_length_916_cov_11.337821	583	663	7	37	80	0.4625000
NODE_8469_length_916_cov_11.337821	583	663	8	31	80	0.3875000
NODE_8469_length_916_cov_11.337821	583	663	9	12	80	0.1500000
NODE_8470_length_916_cov_9.640147	293	373	2	64	80	0.8000000
NODE_8470_length_916_cov_9.640147	293	373	3	16	80	0.2000000
NODE_8470_length_916_cov_9.640147	346	426	2	70	80	0.8750000
NODE_8470_length_916_cov_9.640147	346	426	4	10	80	0.1250000
NODE_8472_length_916_cov_8.042840	426	506	1	13	80	0.1625000
NODE_8472_length_916_cov_8.042840	426	506	3	23	80	0.2875000
NODE_8472_length_916_cov_8.042840	426	506	4	7	80	0.0875000
NODE_8472_length_916_cov_8.042840	426	506	5	8	80	0.1000000
NODE_8472_length_916_cov_8.042840	426	506	6	29	80	0.3625000
NODE_8472_length_916_cov_8.042840	479	559	5	17	80	0.2125000
NODE_8472_length_916_cov_8.042840	479	559	6	63	80	0.7875000
NODE_8473_length_916_cov_7.123623	785	847	0	62	62	1.0000000
NODE_8473_length_916_cov_7.123623	820	900	0	80	80	1.0000000
NODE_8481_length_915_cov_59.289216	398	478	5	6	80	0.0750000
NODE_8481_length_915_cov_59.289216	398	478	8	7	80	0.0875000
NODE_8481_length_915_cov_59.289216	398	478	9	23	80	0.2875000
NODE_8481_length_915_cov_59.289216	398	478	10	20	80	0.2500000
NODE_8481_length_915_cov_59.289216	398	478	12	1	80	0.0125000
NODE_8481_length_915_cov_59.289216	398	478	13	4	80	0.0500000
NODE_8481_length_915_cov_59.289216	398	478	14	6	80	0.0750000
NODE_8481_length_915_cov_59.289216	398	478	15	9	80	0.1125000
NODE_8481_length_915_cov_59.289216	398	478	17	4	80	0.0500000
NODE_8481_length_915_cov_59.289216	451	531	5	15	80	0.1875000
NODE_8481_length_915_cov_59.289216	451	531	6	13	80	0.1625000
NODE_8481_length_915_cov_59.289216	451	531	7	25	80	0.3125000
NODE_8481_length_915_cov_59.289216	451	531	8	13	80	0.1625000
NODE_8481_length_915_cov_59.289216	451	531	9	14	80	0.1750000
NODE_8481_length_915_cov_59.289216	527	607	5	80	80	1.0000000
NODE_8481_length_915_cov_59.289216	580	660	0	4	80	0.0500000
NODE_8481_length_915_cov_59.289216	580	660	1	27	80	0.3375000
NODE_8481_length_915_cov_59.289216	580	660	5	49	80	0.6125000
NODE_8482_length_915_cov_45.104167	153	228	8	8	75	0.1066667
NODE_8482_length_915_cov_45.104167	153	228	12	2	75	0.0266667
NODE_8482_length_915_cov_45.104167	153	228	13	17	75	0.2266667
NODE_8482_length_915_cov_45.104167	153	228	14	48	75	0.6400000
NODE_8482_length_915_cov_45.104167	206	286	10	6	80	0.0750000
NODE_8482_length_915_cov_45.104167	206	286	11	9	80	0.1125000
NODE_8482_length_915_cov_45.104167	206	286	12	11	80	0.1375000
NODE_8482_length_915_cov_45.104167	206	286	13	1	80	0.0125000
NODE_8482_length_915_cov_45.104167	206	286	14	41	80	0.5125000
NODE_8482_length_915_cov_45.104167	206	286	19	9	80	0.1125000
NODE_8482_length_915_cov_45.104167	206	286	20	3	80	0.0375000
NODE_8482_length_915_cov_45.104167	282	362	19	4	80	0.0500000
NODE_8482_length_915_cov_45.104167	282	362	20	8	80	0.1000000
NODE_8482_length_915_cov_45.104167	282	362	21	3	80	0.0375000
NODE_8482_length_915_cov_45.104167	282	362	22	1	80	0.0125000
NODE_8482_length_915_cov_45.104167	282	362	23	2	80	0.0250000
NODE_8482_length_915_cov_45.104167	282	362	25	14	80	0.1750000
NODE_8482_length_915_cov_45.104167	282	362	26	1	80	0.0125000
NODE_8482_length_915_cov_45.104167	282	362	27	4	80	0.0500000
NODE_8482_length_915_cov_45.104167	282	362	28	7	80	0.0875000
NODE_8482_length_915_cov_45.104167	282	362	29	1	80	0.0125000
NODE_8482_length_915_cov_45.104167	282	362	30	10	80	0.1250000
NODE_8482_length_915_cov_45.104167	282	362	31	2	80	0.0250000
NODE_8482_length_915_cov_45.104167	282	362	32	5	80	0.0625000
NODE_8482_length_915_cov_45.104167	282	362	33	6	80	0.0750000
NODE_8482_length_915_cov_45.104167	282	362	34	12	80	0.1500000
NODE_8482_length_915_cov_45.104167	335	415	30	4	80	0.0500000
NODE_8482_length_915_cov_45.104167	335	415	32	5	80	0.0625000
NODE_8482_length_915_cov_45.104167	335	415	33	12	80	0.1500000
NODE_8482_length_915_cov_45.104167	335	415	34	22	80	0.2750000
NODE_8482_length_915_cov_45.104167	335	415	35	19	80	0.2375000
NODE_8482_length_915_cov_45.104167	335	415	36	13	80	0.1625000
NODE_8482_length_915_cov_45.104167	335	415	37	5	80	0.0625000
NODE_8483_length_915_cov_37.599265	397	477	2	7	80	0.0875000
NODE_8483_length_915_cov_37.599265	397	477	5	1	80	0.0125000
NODE_8483_length_915_cov_37.599265	397	477	6	1	80	0.0125000
NODE_8483_length_915_cov_37.599265	397	477	12	16	80	0.2000000
NODE_8483_length_915_cov_37.599265	397	477	13	6	80	0.0750000
NODE_8483_length_915_cov_37.599265	397	477	16	45	80	0.5625000
NODE_8483_length_915_cov_37.599265	397	477	17	4	80	0.0500000
NODE_8483_length_915_cov_37.599265	450	530	16	29	80	0.3625000
NODE_8483_length_915_cov_37.599265	450	530	17	13	80	0.1625000
NODE_8483_length_915_cov_37.599265	450	530	18	6	80	0.0750000
NODE_8483_length_915_cov_37.599265	450	530	21	8	80	0.1000000
NODE_8483_length_915_cov_37.599265	450	530	22	24	80	0.3000000
NODE_8485_length_915_cov_20.458333	297	377	2	59	80	0.7375000
NODE_8485_length_915_cov_20.458333	297	377	3	21	80	0.2625000
NODE_8485_length_915_cov_20.458333	350	430	2	47	80	0.5875000
NODE_8485_length_915_cov_20.458333	350	430	3	33	80	0.4125000
NODE_8485_length_915_cov_20.458333	426	506	3	15	80	0.1875000
NODE_8485_length_915_cov_20.458333	426	506	4	4	80	0.0500000
NODE_8485_length_915_cov_20.458333	426	506	5	11	80	0.1375000
NODE_8485_length_915_cov_20.458333	426	506	6	13	80	0.1625000
NODE_8485_length_915_cov_20.458333	426	506	7	37	80	0.4625000
NODE_8485_length_915_cov_20.458333	479	559	5	2	80	0.0250000
NODE_8485_length_915_cov_20.458333	479	559	6	16	80	0.2000000
NODE_8485_length_915_cov_20.458333	479	559	7	62	80	0.7750000
NODE_8486_length_915_cov_14.397059	175	255	13	27	80	0.3375000
NODE_8486_length_915_cov_14.397059	175	255	14	5	80	0.0625000
NODE_8486_length_915_cov_14.397059	175	255	15	27	80	0.3375000
NODE_8486_length_915_cov_14.397059	175	255	19	4	80	0.0500000
NODE_8486_length_915_cov_14.397059	175	255	20	17	80	0.2125000
NODE_8486_length_915_cov_14.397059	228	308	14	24	80	0.3000000
NODE_8486_length_915_cov_14.397059	228	308	15	56	80	0.7000000
NODE_8487_length_915_cov_8.741422	295	375	8	8	80	0.1000000
NODE_8487_length_915_cov_8.741422	295	375	9	9	80	0.1125000
NODE_8487_length_915_cov_8.741422	295	375	10	31	80	0.3875000
NODE_8487_length_915_cov_8.741422	295	375	11	1	80	0.0125000
NODE_8487_length_915_cov_8.741422	295	375	13	31	80	0.3875000
NODE_8487_length_915_cov_8.741422	348	428	10	4	80	0.0500000
NODE_8487_length_915_cov_8.741422	348	428	12	19	80	0.2375000
NODE_8487_length_915_cov_8.741422	348	428	13	57	80	0.7125000
NODE_8488_length_915_cov_7.719363	823	894	0	32	71	0.4507042
NODE_8488_length_915_cov_7.719363	823	894	1	1	71	0.0140845
NODE_8488_length_915_cov_7.719363	823	894	2	38	71	0.5352113
NODE_8488_length_915_cov_7.719363	828	894	0	32	66	0.4848485
NODE_8488_length_915_cov_7.719363	828	894	1	1	66	0.0151515
NODE_8488_length_915_cov_7.719363	828	894	2	33	66	0.5000000
NODE_8488_length_915_cov_7.719363	867	915	0	48	48	1.0000000
NODE_8488_length_915_cov_7.719363	867	915	0	48	48	1.0000000
NODE_8488_length_915_cov_7.719363	867	915	0	48	48	1.0000000
NODE_8489_length_915_cov_7.648284	370	450	1	22	80	0.2750000
NODE_8489_length_915_cov_7.648284	370	450	3	12	80	0.1500000
NODE_8489_length_915_cov_7.648284	370	450	7	46	80	0.5750000
NODE_8489_length_915_cov_7.648284	423	503	5	7	80	0.0875000
NODE_8489_length_915_cov_7.648284	423	503	6	40	80	0.5000000
NODE_8489_length_915_cov_7.648284	423	503	7	33	80	0.4125000
NODE_8490_length_915_cov_6.848039	434	514	4	35	80	0.4375000
NODE_8490_length_915_cov_6.848039	434	514	5	25	80	0.3125000
NODE_8490_length_915_cov_6.848039	434	514	6	20	80	0.2500000
NODE_8490_length_915_cov_6.848039	487	567	0	4	80	0.0500000
NODE_8490_length_915_cov_6.848039	487	567	1	9	80	0.1125000
NODE_8490_length_915_cov_6.848039	487	567	3	28	80	0.3500000
NODE_8490_length_915_cov_6.848039	487	567	4	27	80	0.3375000
NODE_8490_length_915_cov_6.848039	487	567	5	12	80	0.1500000
NODE_8497_length_915_cov_2.011029	24	99	0	75	75	1.0000000
NODE_8505_length_914_cov_89.814724	0	41	4	2	41	0.0487805
NODE_8505_length_914_cov_89.814724	0	41	5	4	41	0.0975610
NODE_8505_length_914_cov_89.814724	0	41	8	1	41	0.0243902
NODE_8505_length_914_cov_89.814724	0	41	10	4	41	0.0975610
NODE_8505_length_914_cov_89.814724	0	41	11	1	41	0.0243902
NODE_8505_length_914_cov_89.814724	0	41	12	2	41	0.0487805
NODE_8505_length_914_cov_89.814724	0	41	13	1	41	0.0243902
NODE_8505_length_914_cov_89.814724	0	41	14	1	41	0.0243902
NODE_8505_length_914_cov_89.814724	0	41	15	4	41	0.0975610
NODE_8505_length_914_cov_89.814724	0	41	16	1	41	0.0243902
NODE_8505_length_914_cov_89.814724	0	41	18	2	41	0.0487805
NODE_8505_length_914_cov_89.814724	0	41	19	1	41	0.0243902
NODE_8505_length_914_cov_89.814724	0	41	22	8	41	0.1951219
NODE_8505_length_914_cov_89.814724	0	41	25	1	41	0.0243902
NODE_8505_length_914_cov_89.814724	0	41	28	8	41	0.1951219
NODE_8505_length_914_cov_89.814724	19	94	15	1	75	0.0133333
NODE_8505_length_914_cov_89.814724	19	94	16	1	75	0.0133333
NODE_8505_length_914_cov_89.814724	19	94	18	2	75	0.0266667
NODE_8505_length_914_cov_89.814724	19	94	19	1	75	0.0133333
NODE_8505_length_914_cov_89.814724	19	94	22	8	75	0.1066667
NODE_8505_length_914_cov_89.814724	19	94	25	1	75	0.0133333
NODE_8505_length_914_cov_89.814724	19	94	28	9	75	0.1200000
NODE_8505_length_914_cov_89.814724	19	94	29	11	75	0.1466667
NODE_8505_length_914_cov_89.814724	19	94	30	1	75	0.0133333
NODE_8505_length_914_cov_89.814724	19	94	31	2	75	0.0266667
NODE_8505_length_914_cov_89.814724	19	94	32	10	75	0.1333333
NODE_8505_length_914_cov_89.814724	19	94	34	3	75	0.0400000
NODE_8505_length_914_cov_89.814724	19	94	35	5	75	0.0666667
NODE_8505_length_914_cov_89.814724	19	94	39	20	75	0.2666667
NODE_8506_length_914_cov_33.755828	400	480	18	5	80	0.0625000
NODE_8506_length_914_cov_33.755828	400	480	19	19	80	0.2375000
NODE_8506_length_914_cov_33.755828	400	480	20	6	80	0.0750000
NODE_8506_length_914_cov_33.755828	400	480	22	1	80	0.0125000
NODE_8506_length_914_cov_33.755828	400	480	23	4	80	0.0500000
NODE_8506_length_914_cov_33.755828	400	480	29	12	80	0.1500000
NODE_8506_length_914_cov_33.755828	400	480	30	2	80	0.0250000
NODE_8506_length_914_cov_33.755828	400	480	31	28	80	0.3500000
NODE_8506_length_914_cov_33.755828	400	480	32	3	80	0.0375000
NODE_8506_length_914_cov_33.755828	453	533	25	11	80	0.1375000
NODE_8506_length_914_cov_33.755828	453	533	27	13	80	0.1625000
NODE_8506_length_914_cov_33.755828	453	533	28	24	80	0.3000000
NODE_8506_length_914_cov_33.755828	453	533	29	17	80	0.2125000
NODE_8506_length_914_cov_33.755828	453	533	31	15	80	0.1875000
NODE_8507_length_914_cov_31.557055	368	448	0	26	80	0.3250000
NODE_8507_length_914_cov_31.557055	368	448	1	2	80	0.0250000
NODE_8507_length_914_cov_31.557055	368	448	2	5	80	0.0625000
NODE_8507_length_914_cov_31.557055	368	448	4	47	80	0.5875000
NODE_8507_length_914_cov_31.557055	421	501	4	80	80	1.0000000
NODE_8508_length_914_cov_29.087117	331	411	11	12	80	0.1500000
NODE_8508_length_914_cov_29.087117	331	411	15	27	80	0.3375000
NODE_8508_length_914_cov_29.087117	331	411	17	41	80	0.5125000
NODE_8508_length_914_cov_29.087117	384	464	10	8	80	0.1000000
NODE_8508_length_914_cov_29.087117	384	464	12	21	80	0.2625000
NODE_8508_length_914_cov_29.087117	384	464	15	31	80	0.3875000
NODE_8508_length_914_cov_29.087117	384	464	17	20	80	0.2500000
NODE_8509_length_914_cov_28.490798	273	353	3	17	80	0.2125000
NODE_8509_length_914_cov_28.490798	273	353	5	38	80	0.4750000
NODE_8509_length_914_cov_28.490798	273	353	6	7	80	0.0875000
NODE_8509_length_914_cov_28.490798	273	353	7	18	80	0.2250000
NODE_8509_length_914_cov_28.490798	326	406	5	2	80	0.0250000
NODE_8509_length_914_cov_28.490798	326	406	6	12	80	0.1500000
NODE_8509_length_914_cov_28.490798	326	406	7	45	80	0.5625000
NODE_8509_length_914_cov_28.490798	326	406	8	20	80	0.2500000
NODE_8509_length_914_cov_28.490798	326	406	9	1	80	0.0125000
NODE_8509_length_914_cov_28.490798	402	482	4	4	80	0.0500000
NODE_8509_length_914_cov_28.490798	402	482	5	38	80	0.4750000
NODE_8509_length_914_cov_28.490798	402	482	6	33	80	0.4125000
NODE_8509_length_914_cov_28.490798	402	482	7	5	80	0.0625000
NODE_8509_length_914_cov_28.490798	455	535	3	26	80	0.3250000
NODE_8509_length_914_cov_28.490798	455	535	4	12	80	0.1500000
NODE_8509_length_914_cov_28.490798	455	535	5	42	80	0.5250000
NODE_8510_length_914_cov_25.429448	393	473	9	13	80	0.1625000
NODE_8510_length_914_cov_25.429448	393	473	10	46	80	0.5750000
NODE_8510_length_914_cov_25.429448	393	473	11	7	80	0.0875000
NODE_8510_length_914_cov_25.429448	393	473	12	14	80	0.1750000
NODE_8510_length_914_cov_25.429448	446	526	9	11	80	0.1375000
NODE_8510_length_914_cov_25.429448	446	526	10	55	80	0.6875000
NODE_8510_length_914_cov_25.429448	446	526	12	13	80	0.1625000
NODE_8510_length_914_cov_25.429448	446	526	13	1	80	0.0125000
NODE_8510_length_914_cov_25.429448	522	602	6	27	80	0.3375000
NODE_8510_length_914_cov_25.429448	522	602	7	15	80	0.1875000
NODE_8510_length_914_cov_25.429448	522	602	8	26	80	0.3250000
NODE_8510_length_914_cov_25.429448	522	602	9	12	80	0.1500000
NODE_8510_length_914_cov_25.429448	575	655	2	31	80	0.3875000
NODE_8510_length_914_cov_25.429448	575	655	3	13	80	0.1625000
NODE_8510_length_914_cov_25.429448	575	655	5	3	80	0.0375000
NODE_8510_length_914_cov_25.429448	575	655	6	33	80	0.4125000
NODE_8511_length_914_cov_19.111656	354	434	1	5	80	0.0625000
NODE_8511_length_914_cov_19.111656	354	434	2	75	80	0.9375000
NODE_8511_length_914_cov_19.111656	407	487	0	19	80	0.2375000
NODE_8511_length_914_cov_19.111656	407	487	1	39	80	0.4875000
NODE_8511_length_914_cov_19.111656	407	487	2	22	80	0.2750000
NODE_8512_length_914_cov_13.423313	603	683	3	14	80	0.1750000
NODE_8512_length_914_cov_13.423313	603	683	4	40	80	0.5000000
NODE_8512_length_914_cov_13.423313	603	683	6	26	80	0.3250000
NODE_8512_length_914_cov_13.423313	656	736	4	27	80	0.3375000
NODE_8512_length_914_cov_13.423313	656	736	5	49	80	0.6125000
NODE_8512_length_914_cov_13.423313	656	736	6	4	80	0.0500000
NODE_8513_length_914_cov_10.947239	341	411	0	14	70	0.2000000
NODE_8513_length_914_cov_10.947239	341	411	2	11	70	0.1571429
NODE_8513_length_914_cov_10.947239	341	411	5	45	70	0.6428571
NODE_8513_length_914_cov_10.947239	384	464	0	14	80	0.1750000
NODE_8513_length_914_cov_10.947239	384	464	2	64	80	0.8000000
NODE_8513_length_914_cov_10.947239	384	464	5	2	80	0.0250000
NODE_8518_length_914_cov_1.931288	833	873	0	40	40	1.0000000
NODE_8526_length_913_cov_49.665848	31	111	2	22	80	0.2750000
NODE_8526_length_913_cov_49.665848	31	111	3	24	80	0.3000000
NODE_8526_length_913_cov_49.665848	31	111	5	9	80	0.1125000
NODE_8526_length_913_cov_49.665848	31	111	6	16	80	0.2000000
NODE_8526_length_913_cov_49.665848	31	111	7	9	80	0.1125000
NODE_8526_length_913_cov_49.665848	136	155	7	14	19	0.7368421
NODE_8526_length_913_cov_49.665848	136	155	8	5	19	0.2631579
NODE_8527_length_913_cov_47.115479	367	447	8	3	80	0.0375000
NODE_8527_length_913_cov_47.115479	367	447	10	8	80	0.1000000
NODE_8527_length_913_cov_47.115479	367	447	12	5	80	0.0625000
NODE_8527_length_913_cov_47.115479	367	447	13	2	80	0.0250000
NODE_8527_length_913_cov_47.115479	367	447	14	26	80	0.3250000
NODE_8527_length_913_cov_47.115479	367	447	15	5	80	0.0625000
NODE_8527_length_913_cov_47.115479	367	447	16	8	80	0.1000000
NODE_8527_length_913_cov_47.115479	367	447	17	23	80	0.2875000
NODE_8527_length_913_cov_47.115479	420	500	11	24	80	0.3000000
NODE_8527_length_913_cov_47.115479	420	500	12	12	80	0.1500000
NODE_8527_length_913_cov_47.115479	420	500	13	7	80	0.0875000
NODE_8527_length_913_cov_47.115479	420	500	14	10	80	0.1250000
NODE_8527_length_913_cov_47.115479	420	500	15	1	80	0.0125000
NODE_8527_length_913_cov_47.115479	420	500	16	8	80	0.1000000
NODE_8527_length_913_cov_47.115479	420	500	17	18	80	0.2250000
NODE_8528_length_913_cov_36.541769	502	582	10	13	80	0.1625000
NODE_8528_length_913_cov_36.541769	502	582	13	2	80	0.0250000
NODE_8528_length_913_cov_36.541769	502	582	14	29	80	0.3625000
NODE_8528_length_913_cov_36.541769	502	582	15	9	80	0.1125000
NODE_8528_length_913_cov_36.541769	502	582	17	27	80	0.3375000
NODE_8528_length_913_cov_36.541769	555	635	9	6	80	0.0750000
NODE_8528_length_913_cov_36.541769	555	635	10	19	80	0.2375000
NODE_8528_length_913_cov_36.541769	555	635	11	17	80	0.2125000
NODE_8528_length_913_cov_36.541769	555	635	12	5	80	0.0625000
NODE_8528_length_913_cov_36.541769	555	635	13	8	80	0.1000000
NODE_8528_length_913_cov_36.541769	555	635	14	3	80	0.0375000
NODE_8528_length_913_cov_36.541769	555	635	15	7	80	0.0875000
NODE_8528_length_913_cov_36.541769	555	635	17	15	80	0.1875000
NODE_8529_length_913_cov_33.679361	433	513	11	2	80	0.0250000
NODE_8529_length_913_cov_33.679361	433	513	12	29	80	0.3625000
NODE_8529_length_913_cov_33.679361	433	513	13	6	80	0.0750000
NODE_8529_length_913_cov_33.679361	433	513	14	38	80	0.4750000
NODE_8529_length_913_cov_33.679361	433	513	15	5	80	0.0625000
NODE_8529_length_913_cov_33.679361	486	566	9	4	80	0.0500000
NODE_8529_length_913_cov_33.679361	486	566	10	14	80	0.1750000
NODE_8529_length_913_cov_33.679361	486	566	11	27	80	0.3375000
NODE_8529_length_913_cov_33.679361	486	566	13	6	80	0.0750000
NODE_8529_length_913_cov_33.679361	486	566	14	24	80	0.3000000
NODE_8529_length_913_cov_33.679361	486	566	15	5	80	0.0625000
NODE_8530_length_913_cov_29.675676	408	488	4	15	80	0.1875000
NODE_8530_length_913_cov_29.675676	408	488	6	1	80	0.0125000
NODE_8530_length_913_cov_29.675676	408	488	8	8	80	0.1000000
NODE_8530_length_913_cov_29.675676	408	488	9	23	80	0.2875000
NODE_8530_length_913_cov_29.675676	408	488	11	3	80	0.0375000
NODE_8530_length_913_cov_29.675676	408	488	14	17	80	0.2125000
NODE_8530_length_913_cov_29.675676	408	488	16	10	80	0.1250000
NODE_8530_length_913_cov_29.675676	408	488	17	2	80	0.0250000
NODE_8530_length_913_cov_29.675676	408	488	18	1	80	0.0125000
NODE_8530_length_913_cov_29.675676	461	541	14	14	80	0.1750000
NODE_8530_length_913_cov_29.675676	461	541	16	20	80	0.2500000
NODE_8530_length_913_cov_29.675676	461	541	17	5	80	0.0625000
NODE_8530_length_913_cov_29.675676	461	541	18	1	80	0.0125000
NODE_8530_length_913_cov_29.675676	461	541	19	32	80	0.4000000
NODE_8530_length_913_cov_29.675676	461	541	20	2	80	0.0250000
NODE_8530_length_913_cov_29.675676	461	541	21	5	80	0.0625000
NODE_8530_length_913_cov_29.675676	461	541	22	1	80	0.0125000
NODE_8531_length_913_cov_24.901720	342	422	18	14	80	0.1750000
NODE_8531_length_913_cov_24.901720	342	422	19	5	80	0.0625000
NODE_8531_length_913_cov_24.901720	342	422	20	6	80	0.0750000
NODE_8531_length_913_cov_24.901720	342	422	21	9	80	0.1125000
NODE_8531_length_913_cov_24.901720	342	422	22	25	80	0.3125000
NODE_8531_length_913_cov_24.901720	342	422	23	19	80	0.2375000
NODE_8531_length_913_cov_24.901720	342	422	24	1	80	0.0125000
NODE_8531_length_913_cov_24.901720	342	422	25	1	80	0.0125000
NODE_8531_length_913_cov_24.901720	395	475	10	7	80	0.0875000
NODE_8531_length_913_cov_24.901720	395	475	11	7	80	0.0875000
NODE_8531_length_913_cov_24.901720	395	475	12	4	80	0.0500000
NODE_8531_length_913_cov_24.901720	395	475	14	4	80	0.0500000
NODE_8531_length_913_cov_24.901720	395	475	16	22	80	0.2750000
NODE_8531_length_913_cov_24.901720	395	475	18	12	80	0.1500000
NODE_8531_length_913_cov_24.901720	395	475	19	5	80	0.0625000
NODE_8531_length_913_cov_24.901720	395	475	20	6	80	0.0750000
NODE_8531_length_913_cov_24.901720	395	475	21	2	80	0.0250000
NODE_8531_length_913_cov_24.901720	395	475	23	9	80	0.1125000
NODE_8531_length_913_cov_24.901720	395	475	24	1	80	0.0125000
NODE_8531_length_913_cov_24.901720	395	475	25	1	80	0.0125000
NODE_8532_length_913_cov_24.625307	396	476	20	1	80	0.0125000
NODE_8532_length_913_cov_24.625307	396	476	23	3	80	0.0375000
NODE_8532_length_913_cov_24.625307	396	476	25	6	80	0.0750000
NODE_8532_length_913_cov_24.625307	396	476	26	15	80	0.1875000
NODE_8532_length_913_cov_24.625307	396	476	27	42	80	0.5250000
NODE_8532_length_913_cov_24.625307	396	476	28	5	80	0.0625000
NODE_8532_length_913_cov_24.625307	396	476	29	8	80	0.1000000
NODE_8532_length_913_cov_24.625307	449	529	9	7	80	0.0875000
NODE_8532_length_913_cov_24.625307	449	529	10	2	80	0.0250000
NODE_8532_length_913_cov_24.625307	449	529	11	2	80	0.0250000
NODE_8532_length_913_cov_24.625307	449	529	14	10	80	0.1250000
NODE_8532_length_913_cov_24.625307	449	529	17	3	80	0.0375000
NODE_8532_length_913_cov_24.625307	449	529	18	10	80	0.1250000
NODE_8532_length_913_cov_24.625307	449	529	19	13	80	0.1625000
NODE_8532_length_913_cov_24.625307	449	529	20	7	80	0.0875000
NODE_8532_length_913_cov_24.625307	449	529	23	3	80	0.0375000
NODE_8532_length_913_cov_24.625307	449	529	25	6	80	0.0750000
NODE_8532_length_913_cov_24.625307	449	529	26	15	80	0.1875000
NODE_8532_length_913_cov_24.625307	449	529	27	2	80	0.0250000
NODE_8533_length_913_cov_15.094595	525	589	0	64	64	1.0000000
NODE_8533_length_913_cov_15.094595	562	642	0	80	80	1.0000000
NODE_8534_length_913_cov_8.633907	305	385	0	80	80	1.0000000
NODE_8534_length_913_cov_8.633907	358	429	0	71	71	1.0000000
NODE_8546_length_912_cov_25.110701	419	499	8	4	80	0.0500000
NODE_8546_length_912_cov_25.110701	419	499	9	6	80	0.0750000
NODE_8546_length_912_cov_25.110701	419	499	10	32	80	0.4000000
NODE_8546_length_912_cov_25.110701	419	499	11	32	80	0.4000000
NODE_8546_length_912_cov_25.110701	419	499	12	6	80	0.0750000
NODE_8546_length_912_cov_25.110701	472	552	7	13	80	0.1625000
NODE_8546_length_912_cov_25.110701	472	552	9	10	80	0.1250000
NODE_8546_length_912_cov_25.110701	472	552	10	40	80	0.5000000
NODE_8546_length_912_cov_25.110701	472	552	11	17	80	0.2125000
NODE_8547_length_912_cov_20.045510	306	386	2	80	80	1.0000000
NODE_8547_length_912_cov_20.045510	359	439	2	58	80	0.7250000
NODE_8547_length_912_cov_20.045510	359	439	4	22	80	0.2750000
NODE_8548_length_912_cov_19.635916	326	406	8	17	80	0.2125000
NODE_8548_length_912_cov_19.635916	326	406	10	8	80	0.1000000
NODE_8548_length_912_cov_19.635916	326	406	11	53	80	0.6625000
NODE_8548_length_912_cov_19.635916	326	406	12	2	80	0.0250000
NODE_8548_length_912_cov_19.635916	379	459	8	21	80	0.2625000
NODE_8548_length_912_cov_19.635916	379	459	9	21	80	0.2625000
NODE_8548_length_912_cov_19.635916	379	459	11	38	80	0.4750000
NODE_8549_length_912_cov_17.714637	395	475	10	12	80	0.1500000
NODE_8549_length_912_cov_17.714637	395	475	11	6	80	0.0750000
NODE_8549_length_912_cov_17.714637	395	475	13	15	80	0.1875000
NODE_8549_length_912_cov_17.714637	395	475	14	15	80	0.1875000
NODE_8549_length_912_cov_17.714637	395	475	17	26	80	0.3250000
NODE_8549_length_912_cov_17.714637	395	475	18	1	80	0.0125000
NODE_8549_length_912_cov_17.714637	395	475	19	5	80	0.0625000
NODE_8549_length_912_cov_17.714637	448	528	3	9	80	0.1125000
NODE_8549_length_912_cov_17.714637	448	528	4	22	80	0.2750000
NODE_8549_length_912_cov_17.714637	448	528	5	12	80	0.1500000
NODE_8549_length_912_cov_17.714637	448	528	10	22	80	0.2750000
NODE_8549_length_912_cov_17.714637	448	528	11	6	80	0.0750000
NODE_8549_length_912_cov_17.714637	448	528	13	9	80	0.1125000
NODE_8550_length_912_cov_15.546125	355	435	0	7	80	0.0875000
NODE_8550_length_912_cov_15.546125	355	435	2	73	80	0.9125000
NODE_8550_length_912_cov_15.546125	408	488	0	60	80	0.7500000
NODE_8550_length_912_cov_15.546125	408	488	2	20	80	0.2500000
NODE_8551_length_912_cov_15.077491	255	291	0	36	36	1.0000000
NODE_8551_length_912_cov_15.077491	264	328	0	64	64	1.0000000
NODE_8551_length_912_cov_15.077491	415	495	0	66	80	0.8250000
NODE_8551_length_912_cov_15.077491	415	495	1	14	80	0.1750000
NODE_8551_length_912_cov_15.077491	468	548	0	13	80	0.1625000
NODE_8551_length_912_cov_15.077491	468	548	1	44	80	0.5500000
NODE_8551_length_912_cov_15.077491	468	548	2	23	80	0.2875000
NODE_8552_length_912_cov_15.023370	361	441	3	12	80	0.1500000
NODE_8552_length_912_cov_15.023370	361	441	4	11	80	0.1375000
NODE_8552_length_912_cov_15.023370	361	441	6	1	80	0.0125000
NODE_8552_length_912_cov_15.023370	361	441	7	7	80	0.0875000
NODE_8552_length_912_cov_15.023370	361	441	8	7	80	0.0875000
NODE_8552_length_912_cov_15.023370	361	441	9	20	80	0.2500000
NODE_8552_length_912_cov_15.023370	361	441	10	9	80	0.1125000
NODE_8552_length_912_cov_15.023370	361	441	12	4	80	0.0500000
NODE_8552_length_912_cov_15.023370	361	441	13	5	80	0.0625000
NODE_8552_length_912_cov_15.023370	361	441	20	4	80	0.0500000
NODE_8552_length_912_cov_15.023370	414	494	9	5	80	0.0625000
NODE_8552_length_912_cov_15.023370	414	494	10	9	80	0.1125000
NODE_8552_length_912_cov_15.023370	414	494	12	4	80	0.0500000
NODE_8552_length_912_cov_15.023370	414	494	13	5	80	0.0625000
NODE_8552_length_912_cov_15.023370	414	494	20	9	80	0.1125000
NODE_8552_length_912_cov_15.023370	414	494	21	48	80	0.6000000
NODE_8553_length_912_cov_13.600246	61	141	0	80	80	1.0000000
NODE_8553_length_912_cov_13.600246	460	540	0	80	80	1.0000000
NODE_8553_length_912_cov_13.600246	513	593	0	80	80	1.0000000
NODE_8554_length_912_cov_13.113161	385	465	1	5	80	0.0625000
NODE_8554_length_912_cov_13.113161	385	465	2	24	80	0.3000000
NODE_8554_length_912_cov_13.113161	385	465	3	51	80	0.6375000
NODE_8554_length_912_cov_13.113161	438	518	3	80	80	1.0000000
NODE_8555_length_912_cov_11.110701	353	433	0	55	80	0.6875000
NODE_8555_length_912_cov_11.110701	353	433	1	25	80	0.3125000
NODE_8555_length_912_cov_11.110701	406	486	0	2	80	0.0250000
NODE_8555_length_912_cov_11.110701	406	486	1	58	80	0.7250000
NODE_8555_length_912_cov_11.110701	406	486	2	20	80	0.2500000
NODE_8555_length_912_cov_11.110701	827	907	0	80	80	1.0000000
NODE_8555_length_912_cov_11.110701	831	854	0	23	23	1.0000000
NODE_8584_length_911_cov_173.171182	580	660	36	2	80	0.0250000
NODE_8584_length_911_cov_173.171182	580	660	37	6	80	0.0750000
NODE_8584_length_911_cov_173.171182	580	660	38	1	80	0.0125000
NODE_8584_length_911_cov_173.171182	580	660	39	3	80	0.0375000
NODE_8584_length_911_cov_173.171182	580	660	40	1	80	0.0125000
NODE_8584_length_911_cov_173.171182	580	660	41	21	80	0.2625000
NODE_8584_length_911_cov_173.171182	580	660	42	12	80	0.1500000
NODE_8584_length_911_cov_173.171182	580	660	43	3	80	0.0375000
NODE_8584_length_911_cov_173.171182	580	660	44	1	80	0.0125000
NODE_8584_length_911_cov_173.171182	580	660	45	1	80	0.0125000
NODE_8584_length_911_cov_173.171182	580	660	46	8	80	0.1000000
NODE_8584_length_911_cov_173.171182	580	660	47	2	80	0.0250000
NODE_8584_length_911_cov_173.171182	580	660	48	17	80	0.2125000
NODE_8584_length_911_cov_173.171182	580	660	50	2	80	0.0250000
NODE_8584_length_911_cov_173.171182	633	713	38	1	80	0.0125000
NODE_8584_length_911_cov_173.171182	633	713	39	3	80	0.0375000
NODE_8584_length_911_cov_173.171182	633	713	40	10	80	0.1250000
NODE_8584_length_911_cov_173.171182	633	713	41	2	80	0.0250000
NODE_8584_length_911_cov_173.171182	633	713	42	8	80	0.1000000
NODE_8584_length_911_cov_173.171182	633	713	43	2	80	0.0250000
NODE_8584_length_911_cov_173.171182	633	713	45	2	80	0.0250000
NODE_8584_length_911_cov_173.171182	633	713	46	9	80	0.1125000
NODE_8584_length_911_cov_173.171182	633	713	47	4	80	0.0500000
NODE_8584_length_911_cov_173.171182	633	713	48	26	80	0.3250000
NODE_8584_length_911_cov_173.171182	633	713	49	11	80	0.1375000
NODE_8584_length_911_cov_173.171182	633	713	50	2	80	0.0250000
NODE_8585_length_911_cov_88.250000	525	605	12	47	80	0.5875000
NODE_8585_length_911_cov_88.250000	525	605	17	3	80	0.0375000
NODE_8585_length_911_cov_88.250000	525	605	21	3	80	0.0375000
NODE_8585_length_911_cov_88.250000	525	605	22	27	80	0.3375000
NODE_8585_length_911_cov_88.250000	578	658	4	3	80	0.0375000
NODE_8585_length_911_cov_88.250000	578	658	9	48	80	0.6000000
NODE_8585_length_911_cov_88.250000	578	658	12	29	80	0.3625000
NODE_8586_length_911_cov_46.854680	255	335	25	2	80	0.0250000
NODE_8586_length_911_cov_46.854680	255	335	26	16	80	0.2000000
NODE_8586_length_911_cov_46.854680	255	335	27	38	80	0.4750000
NODE_8586_length_911_cov_46.854680	255	335	28	13	80	0.1625000
NODE_8586_length_911_cov_46.854680	255	335	29	6	80	0.0750000
NODE_8586_length_911_cov_46.854680	255	335	30	5	80	0.0625000
NODE_8586_length_911_cov_46.854680	308	388	16	8	80	0.1000000
NODE_8586_length_911_cov_46.854680	308	388	17	3	80	0.0375000
NODE_8586_length_911_cov_46.854680	308	388	18	1	80	0.0125000
NODE_8586_length_911_cov_46.854680	308	388	19	1	80	0.0125000
NODE_8586_length_911_cov_46.854680	308	388	20	1	80	0.0125000
NODE_8586_length_911_cov_46.854680	308	388	21	1	80	0.0125000
NODE_8586_length_911_cov_46.854680	308	388	22	4	80	0.0500000
NODE_8586_length_911_cov_46.854680	308	388	23	8	80	0.1000000
NODE_8586_length_911_cov_46.854680	308	388	24	5	80	0.0625000
NODE_8586_length_911_cov_46.854680	308	388	25	23	80	0.2875000
NODE_8586_length_911_cov_46.854680	308	388	27	22	80	0.2750000
NODE_8586_length_911_cov_46.854680	308	388	28	3	80	0.0375000
NODE_8586_length_911_cov_46.854680	384	464	6	12	80	0.1500000
NODE_8586_length_911_cov_46.854680	384	464	7	12	80	0.1500000
NODE_8586_length_911_cov_46.854680	384	464	9	8	80	0.1000000
NODE_8586_length_911_cov_46.854680	384	464	12	13	80	0.1625000
NODE_8586_length_911_cov_46.854680	384	464	13	18	80	0.2250000
NODE_8586_length_911_cov_46.854680	384	464	14	1	80	0.0125000
NODE_8586_length_911_cov_46.854680	384	464	16	5	80	0.0625000
NODE_8586_length_911_cov_46.854680	384	464	17	11	80	0.1375000
NODE_8586_length_911_cov_46.854680	437	517	2	6	80	0.0750000
NODE_8586_length_911_cov_46.854680	437	517	4	18	80	0.2250000
NODE_8586_length_911_cov_46.854680	437	517	6	41	80	0.5125000
NODE_8586_length_911_cov_46.854680	437	517	7	12	80	0.1500000
NODE_8586_length_911_cov_46.854680	437	517	9	3	80	0.0375000
NODE_8587_length_911_cov_31.362069	301	381	8	27	80	0.3375000
NODE_8587_length_911_cov_31.362069	301	381	9	9	80	0.1125000
NODE_8587_length_911_cov_31.362069	301	381	13	14	80	0.1750000
NODE_8587_length_911_cov_31.362069	301	381	14	11	80	0.1375000
NODE_8587_length_911_cov_31.362069	301	381	15	3	80	0.0375000
NODE_8587_length_911_cov_31.362069	301	381	16	1	80	0.0125000
NODE_8587_length_911_cov_31.362069	301	381	17	15	80	0.1875000
NODE_8587_length_911_cov_31.362069	354	434	11	4	80	0.0500000
NODE_8587_length_911_cov_31.362069	354	434	12	11	80	0.1375000
NODE_8587_length_911_cov_31.362069	354	434	13	19	80	0.2375000
NODE_8587_length_911_cov_31.362069	354	434	14	25	80	0.3125000
NODE_8587_length_911_cov_31.362069	354	434	15	3	80	0.0375000
NODE_8587_length_911_cov_31.362069	354	434	16	2	80	0.0250000
NODE_8587_length_911_cov_31.362069	354	434	17	16	80	0.2000000
NODE_8588_length_911_cov_19.235222	445	525	3	5	80	0.0625000
NODE_8588_length_911_cov_19.235222	445	525	5	75	80	0.9375000
NODE_8588_length_911_cov_19.235222	498	578	0	15	80	0.1875000
NODE_8588_length_911_cov_19.235222	498	578	1	2	80	0.0250000
NODE_8588_length_911_cov_19.235222	498	578	3	41	80	0.5125000
NODE_8588_length_911_cov_19.235222	498	578	5	22	80	0.2750000
NODE_8589_length_911_cov_16.230296	233	313	0	80	80	1.0000000
NODE_8589_length_911_cov_16.230296	286	366	0	80	80	1.0000000
NODE_8590_length_911_cov_14.979064	472	552	0	80	80	1.0000000
NODE_8590_length_911_cov_14.979064	525	605	0	80	80	1.0000000
NODE_8591_length_911_cov_12.089901	357	409	3	26	52	0.5000000
NODE_8591_length_911_cov_12.089901	357	409	7	26	52	0.5000000
NODE_8591_length_911_cov_12.089901	401	462	4	41	61	0.6721311
NODE_8591_length_911_cov_12.089901	401	462	7	20	61	0.3278688
NODE_8606_length_910_cov_27.838471	347	427	13	4	80	0.0500000
NODE_8606_length_910_cov_27.838471	347	427	14	6	80	0.0750000
NODE_8606_length_910_cov_27.838471	347	427	15	17	80	0.2125000
NODE_8606_length_910_cov_27.838471	347	427	17	1	80	0.0125000
NODE_8606_length_910_cov_27.838471	347	427	18	6	80	0.0750000
NODE_8606_length_910_cov_27.838471	347	427	20	33	80	0.4125000
NODE_8606_length_910_cov_27.838471	347	427	22	13	80	0.1625000
NODE_8606_length_910_cov_27.838471	400	480	14	3	80	0.0375000
NODE_8606_length_910_cov_27.838471	400	480	16	11	80	0.1375000
NODE_8606_length_910_cov_27.838471	400	480	18	6	80	0.0750000
NODE_8606_length_910_cov_27.838471	400	480	20	14	80	0.1750000
NODE_8606_length_910_cov_27.838471	400	480	21	13	80	0.1625000
NODE_8606_length_910_cov_27.838471	400	480	22	33	80	0.4125000
NODE_8607_length_910_cov_25.895191	361	441	5	14	80	0.1750000
NODE_8607_length_910_cov_25.895191	361	441	7	39	80	0.4875000
NODE_8607_length_910_cov_25.895191	361	441	9	16	80	0.2000000
NODE_8607_length_910_cov_25.895191	361	441	10	11	80	0.1375000
NODE_8607_length_910_cov_25.895191	414	494	5	63	80	0.7875000
NODE_8607_length_910_cov_25.895191	414	494	6	4	80	0.0500000
NODE_8607_length_910_cov_25.895191	414	494	7	13	80	0.1625000
NODE_8608_length_910_cov_25.604192	294	374	4	19	80	0.2375000
NODE_8608_length_910_cov_25.604192	294	374	5	47	80	0.5875000
NODE_8608_length_910_cov_25.604192	294	374	6	11	80	0.1375000
NODE_8608_length_910_cov_25.604192	294	374	7	3	80	0.0375000
NODE_8608_length_910_cov_25.604192	347	427	4	11	80	0.1375000
NODE_8608_length_910_cov_25.604192	347	427	5	8	80	0.1000000
NODE_8608_length_910_cov_25.604192	347	427	6	19	80	0.2375000
NODE_8608_length_910_cov_25.604192	347	427	7	32	80	0.4000000
NODE_8608_length_910_cov_25.604192	347	427	8	10	80	0.1250000
NODE_8608_length_910_cov_25.604192	423	503	7	3	80	0.0375000
NODE_8608_length_910_cov_25.604192	423	503	8	2	80	0.0250000
NODE_8608_length_910_cov_25.604192	423	503	9	17	80	0.2125000
NODE_8608_length_910_cov_25.604192	423	503	10	22	80	0.2750000
NODE_8608_length_910_cov_25.604192	423	503	11	27	80	0.3375000
NODE_8608_length_910_cov_25.604192	423	503	13	9	80	0.1125000
NODE_8608_length_910_cov_25.604192	476	556	11	31	80	0.3875000
NODE_8608_length_910_cov_25.604192	476	556	12	35	80	0.4375000
NODE_8608_length_910_cov_25.604192	476	556	13	14	80	0.1750000
NODE_8609_length_910_cov_16.066584	656	736	12	6	80	0.0750000
NODE_8609_length_910_cov_16.066584	656	736	13	54	80	0.6750000
NODE_8609_length_910_cov_16.066584	656	736	14	19	80	0.2375000
NODE_8609_length_910_cov_16.066584	656	736	15	1	80	0.0125000
NODE_8609_length_910_cov_16.066584	709	789	9	1	80	0.0125000
NODE_8609_length_910_cov_16.066584	709	789	10	15	80	0.1875000
NODE_8609_length_910_cov_16.066584	709	789	11	3	80	0.0375000
NODE_8609_length_910_cov_16.066584	709	789	12	16	80	0.2000000
NODE_8609_length_910_cov_16.066584	709	789	13	45	80	0.5625000
NODE_8610_length_910_cov_14.696671	417	497	3	20	80	0.2500000
NODE_8610_length_910_cov_14.696671	417	497	4	52	80	0.6500000
NODE_8610_length_910_cov_14.696671	417	497	5	8	80	0.1000000
NODE_8610_length_910_cov_14.696671	470	550	3	25	80	0.3125000
NODE_8610_length_910_cov_14.696671	470	550	4	44	80	0.5500000
NODE_8610_length_910_cov_14.696671	470	550	5	11	80	0.1375000
NODE_8612_length_910_cov_7.114673	442	522	4	20	80	0.2500000
NODE_8612_length_910_cov_7.114673	442	522	5	11	80	0.1375000
NODE_8612_length_910_cov_7.114673	442	522	6	49	80	0.6125000
NODE_8612_length_910_cov_7.114673	495	575	2	26	80	0.3250000
NODE_8612_length_910_cov_7.114673	495	575	4	14	80	0.1750000
NODE_8612_length_910_cov_7.114673	495	575	6	40	80	0.5000000
NODE_8614_length_910_cov_2.992602	196	269	1	10	73	0.1369863
NODE_8614_length_910_cov_2.992602	196	269	3	26	73	0.3561644
NODE_8614_length_910_cov_2.992602	196	269	4	5	73	0.0684932
NODE_8614_length_910_cov_2.992602	196	269	5	3	73	0.0410959
NODE_8614_length_910_cov_2.992602	196	269	6	26	73	0.3561644
NODE_8614_length_910_cov_2.992602	196	269	8	3	73	0.0410959
NODE_8614_length_910_cov_2.992602	249	329	6	17	80	0.2125000
NODE_8614_length_910_cov_2.992602	249	329	8	5	80	0.0625000
NODE_8614_length_910_cov_2.992602	249	329	10	10	80	0.1250000
NODE_8614_length_910_cov_2.992602	249	329	11	2	80	0.0250000
NODE_8614_length_910_cov_2.992602	249	329	12	3	80	0.0375000
NODE_8614_length_910_cov_2.992602	249	329	13	43	80	0.5375000
NODE_8614_length_910_cov_2.992602	386	439	1	6	53	0.1132075
NODE_8614_length_910_cov_2.992602	386	439	3	1	53	0.0188679
NODE_8614_length_910_cov_2.992602	386	439	4	22	53	0.4150943
NODE_8614_length_910_cov_2.992602	386	439	6	8	53	0.1509434
NODE_8614_length_910_cov_2.992602	386	439	8	10	53	0.1886792
NODE_8614_length_910_cov_2.992602	386	439	9	6	53	0.1132075
NODE_8623_length_909_cov_35.291358	426	506	8	3	80	0.0375000
NODE_8623_length_909_cov_35.291358	426	506	9	1	80	0.0125000
NODE_8623_length_909_cov_35.291358	426	506	10	8	80	0.1000000
NODE_8623_length_909_cov_35.291358	426	506	11	34	80	0.4250000
NODE_8623_length_909_cov_35.291358	426	506	12	5	80	0.0625000
NODE_8623_length_909_cov_35.291358	426	506	13	3	80	0.0375000
NODE_8623_length_909_cov_35.291358	426	506	14	26	80	0.3250000
NODE_8623_length_909_cov_35.291358	479	559	11	8	80	0.1000000
NODE_8623_length_909_cov_35.291358	479	559	13	14	80	0.1750000
NODE_8623_length_909_cov_35.291358	479	559	14	53	80	0.6625000
NODE_8623_length_909_cov_35.291358	479	559	15	5	80	0.0625000
NODE_8624_length_909_cov_27.449383	311	391	1	80	80	1.0000000
NODE_8624_length_909_cov_27.449383	364	444	1	80	80	1.0000000
NODE_8625_length_909_cov_25.212346	295	375	2	36	80	0.4500000
NODE_8625_length_909_cov_25.212346	295	375	3	10	80	0.1250000
NODE_8625_length_909_cov_25.212346	295	375	4	34	80	0.4250000
NODE_8625_length_909_cov_25.212346	348	428	3	47	80	0.5875000
NODE_8625_length_909_cov_25.212346	348	428	4	32	80	0.4000000
NODE_8625_length_909_cov_25.212346	348	428	5	1	80	0.0125000
NODE_8626_length_909_cov_23.604938	403	483	0	57	80	0.7125000
NODE_8626_length_909_cov_23.604938	403	483	1	23	80	0.2875000
NODE_8626_length_909_cov_23.604938	456	536	0	4	80	0.0500000
NODE_8626_length_909_cov_23.604938	456	536	1	76	80	0.9500000
NODE_8627_length_909_cov_19.070370	441	521	0	80	80	1.0000000
NODE_8627_length_909_cov_19.070370	494	574	0	80	80	1.0000000
NODE_8628_length_909_cov_11.533333	332	412	1	28	80	0.3500000
NODE_8628_length_909_cov_11.533333	332	412	2	52	80	0.6500000
NODE_8628_length_909_cov_11.533333	385	465	2	80	80	1.0000000
NODE_8629_length_909_cov_10.229630	497	577	1	2	80	0.0250000
NODE_8629_length_909_cov_10.229630	497	577	3	76	80	0.9500000
NODE_8629_length_909_cov_10.229630	497	577	4	2	80	0.0250000
NODE_8629_length_909_cov_10.229630	550	622	1	47	72	0.6527778
NODE_8629_length_909_cov_10.229630	550	622	3	25	72	0.3472222
NODE_8631_length_909_cov_7.122222	328	408	2	25	80	0.3125000
NODE_8631_length_909_cov_7.122222	328	408	3	19	80	0.2375000
NODE_8631_length_909_cov_7.122222	328	408	4	36	80	0.4500000
NODE_8631_length_909_cov_7.122222	381	461	3	28	80	0.3500000
NODE_8631_length_909_cov_7.122222	381	461	4	52	80	0.6500000
NODE_8632_length_909_cov_4.664198	775	855	1	8	80	0.1000000
NODE_8632_length_909_cov_4.664198	775	855	3	23	80	0.2875000
NODE_8632_length_909_cov_4.664198	775	855	5	49	80	0.6125000
NODE_8632_length_909_cov_4.664198	828	885	0	16	57	0.2807018
NODE_8632_length_909_cov_4.664198	828	885	1	22	57	0.3859649
NODE_8632_length_909_cov_4.664198	828	885	3	19	57	0.3333333
NODE_8644_length_908_cov_55.546354	409	489	0	80	80	1.0000000
NODE_8644_length_908_cov_55.546354	462	542	0	80	80	1.0000000
NODE_8645_length_908_cov_18.720643	329	409	34	7	80	0.0875000
NODE_8645_length_908_cov_18.720643	329	409	35	3	80	0.0375000
NODE_8645_length_908_cov_18.720643	329	409	36	19	80	0.2375000
NODE_8645_length_908_cov_18.720643	329	409	41	9	80	0.1125000
NODE_8645_length_908_cov_18.720643	329	409	42	5	80	0.0625000
NODE_8645_length_908_cov_18.720643	329	409	43	1	80	0.0125000
NODE_8645_length_908_cov_18.720643	329	409	44	2	80	0.0250000
NODE_8645_length_908_cov_18.720643	329	409	45	2	80	0.0250000
NODE_8645_length_908_cov_18.720643	329	409	46	1	80	0.0125000
NODE_8645_length_908_cov_18.720643	329	409	47	1	80	0.0125000
NODE_8645_length_908_cov_18.720643	329	409	49	2	80	0.0250000
NODE_8645_length_908_cov_18.720643	329	409	52	1	80	0.0125000
NODE_8645_length_908_cov_18.720643	329	409	60	1	80	0.0125000
NODE_8645_length_908_cov_18.720643	329	409	61	13	80	0.1625000
NODE_8645_length_908_cov_18.720643	329	409	62	2	80	0.0250000
NODE_8645_length_908_cov_18.720643	329	409	64	9	80	0.1125000
NODE_8645_length_908_cov_18.720643	329	409	65	2	80	0.0250000
NODE_8645_length_908_cov_18.720643	382	462	42	1	80	0.0125000
NODE_8645_length_908_cov_18.720643	382	462	44	5	80	0.0625000
NODE_8645_length_908_cov_18.720643	382	462	45	2	80	0.0250000
NODE_8645_length_908_cov_18.720643	382	462	46	5	80	0.0625000
NODE_8645_length_908_cov_18.720643	382	462	49	2	80	0.0250000
NODE_8645_length_908_cov_18.720643	382	462	50	8	80	0.1000000
NODE_8645_length_908_cov_18.720643	382	462	52	1	80	0.0125000
NODE_8645_length_908_cov_18.720643	382	462	55	1	80	0.0125000
NODE_8645_length_908_cov_18.720643	382	462	56	5	80	0.0625000
NODE_8645_length_908_cov_18.720643	382	462	58	1	80	0.0125000
NODE_8645_length_908_cov_18.720643	382	462	59	15	80	0.1875000
NODE_8645_length_908_cov_18.720643	382	462	60	2	80	0.0250000
NODE_8645_length_908_cov_18.720643	382	462	61	15	80	0.1875000
NODE_8645_length_908_cov_18.720643	382	462	62	2	80	0.0250000
NODE_8645_length_908_cov_18.720643	382	462	64	10	80	0.1250000
NODE_8645_length_908_cov_18.720643	382	462	65	5	80	0.0625000
NODE_8646_length_908_cov_14.640297	430	510	3	78	80	0.9750000
NODE_8646_length_908_cov_14.640297	430	510	4	2	80	0.0250000
NODE_8646_length_908_cov_14.640297	483	562	3	79	79	1.0000000
NODE_8648_length_908_cov_10.789864	370	450	3	10	80	0.1250000
NODE_8648_length_908_cov_10.789864	370	450	5	12	80	0.1500000
NODE_8648_length_908_cov_10.789864	370	450	6	20	80	0.2500000
NODE_8648_length_908_cov_10.789864	370	450	7	7	80	0.0875000
NODE_8648_length_908_cov_10.789864	370	450	8	31	80	0.3875000
NODE_8648_length_908_cov_10.789864	423	503	1	12	80	0.1500000
NODE_8648_length_908_cov_10.789864	423	503	2	14	80	0.1750000
NODE_8648_length_908_cov_10.789864	423	503	3	37	80	0.4625000
NODE_8648_length_908_cov_10.789864	423	503	5	12	80	0.1500000
NODE_8648_length_908_cov_10.789864	423	503	6	5	80	0.0625000
NODE_8651_length_908_cov_3.737948	251	331	0	9	80	0.1125000
NODE_8651_length_908_cov_3.737948	251	331	1	36	80	0.4500000
NODE_8651_length_908_cov_3.737948	251	331	2	7	80	0.0875000
NODE_8651_length_908_cov_3.737948	251	331	3	1	80	0.0125000
NODE_8651_length_908_cov_3.737948	251	331	4	17	80	0.2125000
NODE_8651_length_908_cov_3.737948	251	331	5	5	80	0.0625000
NODE_8651_length_908_cov_3.737948	251	331	6	5	80	0.0625000
NODE_8651_length_908_cov_3.737948	304	384	4	17	80	0.2125000
NODE_8651_length_908_cov_3.737948	304	384	5	5	80	0.0625000
NODE_8651_length_908_cov_3.737948	304	384	6	58	80	0.7250000
NODE_8664_length_907_cov_22.110149	459	539	2	62	80	0.7750000
NODE_8664_length_907_cov_22.110149	459	539	3	18	80	0.2250000
NODE_8664_length_907_cov_22.110149	512	592	1	3	80	0.0375000
NODE_8664_length_907_cov_22.110149	512	592	2	46	80	0.5750000
NODE_8664_length_907_cov_22.110149	512	592	3	31	80	0.3875000
NODE_8665_length_907_cov_20.943069	410	490	1	7	80	0.0875000
NODE_8665_length_907_cov_20.943069	410	490	2	27	80	0.3375000
NODE_8665_length_907_cov_20.943069	410	490	3	14	80	0.1750000
NODE_8665_length_907_cov_20.943069	410	490	4	32	80	0.4000000
NODE_8665_length_907_cov_20.943069	463	543	4	79	80	0.9875000
NODE_8665_length_907_cov_20.943069	463	543	5	1	80	0.0125000
NODE_8666_length_907_cov_19.519802	411	488	0	77	77	1.0000000
NODE_8666_length_907_cov_19.519802	461	541	0	80	80	1.0000000
NODE_8667_length_907_cov_17.928218	329	405	2	76	76	1.0000000
NODE_8667_length_907_cov_17.928218	382	462	0	45	80	0.5625000
NODE_8667_length_907_cov_17.928218	382	462	2	35	80	0.4375000
NODE_8668_length_907_cov_13.060644	293	373	1	80	80	1.0000000
NODE_8668_length_907_cov_13.060644	346	426	1	80	80	1.0000000
NODE_8669_length_907_cov_11.155941	401	462	3	61	61	1.0000000
NODE_8669_length_907_cov_11.155941	607	687	0	69	80	0.8625000
NODE_8669_length_907_cov_11.155941	607	687	1	1	80	0.0125000
NODE_8669_length_907_cov_11.155941	607	687	2	10	80	0.1250000
NODE_8670_length_907_cov_9.237624	247	327	9	18	80	0.2250000
NODE_8670_length_907_cov_9.237624	247	327	10	58	80	0.7250000
NODE_8670_length_907_cov_9.237624	247	327	12	4	80	0.0500000
NODE_8670_length_907_cov_9.237624	300	380	3	9	80	0.1125000
NODE_8670_length_907_cov_9.237624	300	380	4	13	80	0.1625000
NODE_8670_length_907_cov_9.237624	300	380	5	3	80	0.0375000
NODE_8670_length_907_cov_9.237624	300	380	7	28	80	0.3500000
NODE_8670_length_907_cov_9.237624	300	380	9	18	80	0.2250000
NODE_8670_length_907_cov_9.237624	300	380	10	9	80	0.1125000
NODE_8671_length_907_cov_8.686881	275	365	2	2	90	0.0222222
NODE_8671_length_907_cov_8.686881	275	365	3	1	90	0.0111111
NODE_8671_length_907_cov_8.686881	275	365	4	24	90	0.2666667
NODE_8671_length_907_cov_8.686881	275	365	5	63	90	0.7000000
NODE_8671_length_907_cov_8.686881	338	418	2	6	80	0.0750000
NODE_8671_length_907_cov_8.686881	338	418	3	28	80	0.3500000
NODE_8671_length_907_cov_8.686881	338	418	4	46	80	0.5750000
NODE_8680_length_907_cov_2.949257	503	526	0	23	23	1.0000000
NODE_8686_length_906_cov_32.369269	447	527	3	32	80	0.4000000
NODE_8686_length_906_cov_32.369269	447	527	4	21	80	0.2625000
NODE_8686_length_906_cov_32.369269	447	527	5	27	80	0.3375000
NODE_8686_length_906_cov_32.369269	500	580	4	29	80	0.3625000
NODE_8686_length_906_cov_32.369269	500	580	5	51	80	0.6375000
NODE_8687_length_906_cov_23.594796	196	276	3	6	80	0.0750000
NODE_8687_length_906_cov_23.594796	196	276	4	55	80	0.6875000
NODE_8687_length_906_cov_23.594796	196	276	5	19	80	0.2375000
NODE_8687_length_906_cov_23.594796	249	329	2	21	80	0.2625000
NODE_8687_length_906_cov_23.594796	249	329	3	29	80	0.3625000
NODE_8687_length_906_cov_23.594796	249	329	4	13	80	0.1625000
NODE_8687_length_906_cov_23.594796	249	329	5	17	80	0.2125000
NODE_8688_length_906_cov_21.443618	404	484	6	5	80	0.0625000
NODE_8688_length_906_cov_21.443618	404	484	7	13	80	0.1625000
NODE_8688_length_906_cov_21.443618	404	484	8	1	80	0.0125000
NODE_8688_length_906_cov_21.443618	404	484	9	14	80	0.1750000
NODE_8688_length_906_cov_21.443618	404	484	10	9	80	0.1125000
NODE_8688_length_906_cov_21.443618	404	484	12	38	80	0.4750000
NODE_8688_length_906_cov_21.443618	457	537	12	43	80	0.5375000
NODE_8688_length_906_cov_21.443618	457	537	13	1	80	0.0125000
NODE_8688_length_906_cov_21.443618	457	537	14	7	80	0.0875000
NODE_8688_length_906_cov_21.443618	457	537	15	29	80	0.3625000
NODE_8689_length_906_cov_20.596035	593	634	2	24	41	0.5853658
NODE_8689_length_906_cov_20.596035	593	634	3	17	41	0.4146341
NODE_8690_length_906_cov_20.429988	410	490	9	25	80	0.3125000
NODE_8690_length_906_cov_20.429988	410	490	10	1	80	0.0125000
NODE_8690_length_906_cov_20.429988	410	490	11	16	80	0.2000000
NODE_8690_length_906_cov_20.429988	410	490	12	2	80	0.0250000
NODE_8690_length_906_cov_20.429988	410	490	13	1	80	0.0125000
NODE_8690_length_906_cov_20.429988	410	490	14	26	80	0.3250000
NODE_8690_length_906_cov_20.429988	410	490	15	9	80	0.1125000
NODE_8690_length_906_cov_20.429988	463	543	13	6	80	0.0750000
NODE_8690_length_906_cov_20.429988	463	543	14	39	80	0.4875000
NODE_8690_length_906_cov_20.429988	463	543	15	22	80	0.2750000
NODE_8690_length_906_cov_20.429988	463	543	16	13	80	0.1625000
NODE_8691_length_906_cov_20.395291	523	603	13	18	80	0.2250000
NODE_8691_length_906_cov_20.395291	523	603	14	34	80	0.4250000
NODE_8691_length_906_cov_20.395291	523	603	15	1	80	0.0125000
NODE_8691_length_906_cov_20.395291	523	603	16	14	80	0.1750000
NODE_8691_length_906_cov_20.395291	523	603	19	13	80	0.1625000
NODE_8691_length_906_cov_20.395291	576	656	3	13	80	0.1625000
NODE_8691_length_906_cov_20.395291	576	656	4	3	80	0.0375000
NODE_8691_length_906_cov_20.395291	576	656	5	2	80	0.0250000
NODE_8691_length_906_cov_20.395291	576	656	9	20	80	0.2500000
NODE_8691_length_906_cov_20.395291	576	656	10	2	80	0.0250000
NODE_8691_length_906_cov_20.395291	576	656	11	8	80	0.1000000
NODE_8691_length_906_cov_20.395291	576	656	13	3	80	0.0375000
NODE_8691_length_906_cov_20.395291	576	656	14	29	80	0.3625000
NODE_8692_length_906_cov_19.297398	255	335	3	21	80	0.2625000
NODE_8692_length_906_cov_19.297398	255	335	4	45	80	0.5625000
NODE_8692_length_906_cov_19.297398	255	335	5	13	80	0.1625000
NODE_8692_length_906_cov_19.297398	255	335	6	1	80	0.0125000
NODE_8692_length_906_cov_19.297398	308	388	4	22	80	0.2750000
NODE_8692_length_906_cov_19.297398	308	388	5	40	80	0.5000000
NODE_8692_length_906_cov_19.297398	308	388	6	18	80	0.2250000
NODE_8693_length_906_cov_18.505576	357	437	2	14	80	0.1750000
NODE_8693_length_906_cov_18.505576	357	437	3	4	80	0.0500000
NODE_8693_length_906_cov_18.505576	357	437	5	38	80	0.4750000
NODE_8693_length_906_cov_18.505576	357	437	6	24	80	0.3000000
NODE_8693_length_906_cov_18.505576	410	490	4	10	80	0.1250000
NODE_8693_length_906_cov_18.505576	410	490	5	7	80	0.0875000
NODE_8693_length_906_cov_18.505576	410	490	6	63	80	0.7875000
NODE_8694_length_906_cov_10.068154	191	271	0	80	80	1.0000000
NODE_8694_length_906_cov_10.068154	244	324	0	80	80	1.0000000
NODE_8695_length_906_cov_10.006196	304	384	3	21	80	0.2625000
NODE_8695_length_906_cov_10.006196	304	384	4	59	80	0.7375000
NODE_8695_length_906_cov_10.006196	357	437	4	63	80	0.7875000
NODE_8695_length_906_cov_10.006196	357	437	5	17	80	0.2125000
NODE_8696_length_906_cov_8.562577	370	454	6	11	84	0.1309524
NODE_8696_length_906_cov_8.562577	370	454	7	4	84	0.0476190
NODE_8696_length_906_cov_8.562577	370	454	8	63	84	0.7500000
NODE_8696_length_906_cov_8.562577	370	454	10	6	84	0.0714286
NODE_8696_length_906_cov_8.562577	423	507	5	36	84	0.4285714
NODE_8696_length_906_cov_8.562577	423	507	7	15	84	0.1785714
NODE_8696_length_906_cov_8.562577	423	507	8	33	84	0.3928571
NODE_8716_length_905_cov_39.203474	406	486	20	14	80	0.1750000
NODE_8716_length_905_cov_39.203474	406	486	24	21	80	0.2625000
NODE_8716_length_905_cov_39.203474	406	486	25	1	80	0.0125000
NODE_8716_length_905_cov_39.203474	406	486	26	32	80	0.4000000
NODE_8716_length_905_cov_39.203474	406	486	28	12	80	0.1500000
NODE_8716_length_905_cov_39.203474	459	539	17	13	80	0.1625000
NODE_8716_length_905_cov_39.203474	459	539	19	2	80	0.0250000
NODE_8716_length_905_cov_39.203474	459	539	20	23	80	0.2875000
NODE_8716_length_905_cov_39.203474	459	539	21	1	80	0.0125000
NODE_8716_length_905_cov_39.203474	459	539	25	11	80	0.1375000
NODE_8716_length_905_cov_39.203474	459	539	26	15	80	0.1875000
NODE_8716_length_905_cov_39.203474	459	539	27	1	80	0.0125000
NODE_8716_length_905_cov_39.203474	459	539	28	14	80	0.1750000
NODE_8717_length_905_cov_37.053350	411	491	7	3	80	0.0375000
NODE_8717_length_905_cov_37.053350	411	491	8	21	80	0.2625000
NODE_8717_length_905_cov_37.053350	411	491	9	22	80	0.2750000
NODE_8717_length_905_cov_37.053350	411	491	10	12	80	0.1500000
NODE_8717_length_905_cov_37.053350	411	491	12	22	80	0.2750000
NODE_8717_length_905_cov_37.053350	464	544	4	17	80	0.2125000
NODE_8717_length_905_cov_37.053350	464	544	7	6	80	0.0750000
NODE_8717_length_905_cov_37.053350	464	544	8	54	80	0.6750000
NODE_8717_length_905_cov_37.053350	464	544	9	3	80	0.0375000
NODE_8718_length_905_cov_27.426799	288	368	4	33	80	0.4125000
NODE_8718_length_905_cov_27.426799	288	368	5	47	80	0.5875000
NODE_8718_length_905_cov_27.426799	341	421	4	48	80	0.6000000
NODE_8718_length_905_cov_27.426799	341	421	5	31	80	0.3875000
NODE_8718_length_905_cov_27.426799	341	421	6	1	80	0.0125000
NODE_8719_length_905_cov_26.332506	375	455	0	70	80	0.8750000
NODE_8719_length_905_cov_26.332506	375	455	1	1	80	0.0125000
NODE_8719_length_905_cov_26.332506	375	455	2	9	80	0.1125000
NODE_8719_length_905_cov_26.332506	428	508	0	17	80	0.2125000
NODE_8719_length_905_cov_26.332506	428	508	1	1	80	0.0125000
NODE_8719_length_905_cov_26.332506	428	508	2	14	80	0.1750000
NODE_8719_length_905_cov_26.332506	428	508	6	3	80	0.0375000
NODE_8719_length_905_cov_26.332506	428	508	8	45	80	0.5625000
NODE_8720_length_905_cov_20.651365	377	457	4	62	80	0.7750000
NODE_8720_length_905_cov_20.651365	377	457	5	18	80	0.2250000
NODE_8720_length_905_cov_20.651365	430	510	4	36	80	0.4500000
NODE_8720_length_905_cov_20.651365	430	510	5	44	80	0.5500000
NODE_8721_length_905_cov_19.718362	365	445	7	11	80	0.1375000
NODE_8721_length_905_cov_19.718362	365	445	8	6	80	0.0750000
NODE_8721_length_905_cov_19.718362	365	445	11	63	80	0.7875000
NODE_8721_length_905_cov_19.718362	418	498	8	3	80	0.0375000
NODE_8721_length_905_cov_19.718362	418	498	9	30	80	0.3750000
NODE_8721_length_905_cov_19.718362	418	498	10	4	80	0.0500000
NODE_8721_length_905_cov_19.718362	418	498	11	43	80	0.5375000
NODE_8722_length_905_cov_13.696030	366	420	0	10	54	0.1851852
NODE_8722_length_905_cov_13.696030	366	420	1	44	54	0.8148148
NODE_8723_length_905_cov_9.978908	222	302	0	23	80	0.2875000
NODE_8723_length_905_cov_9.978908	222	302	2	57	80	0.7125000
NODE_8723_length_905_cov_9.978908	275	355	2	80	80	1.0000000
NODE_8725_length_905_cov_7.980149	321	401	0	80	80	1.0000000
NODE_8725_length_905_cov_7.980149	374	454	0	80	80	1.0000000
NODE_8727_length_905_cov_6.064516	459	539	0	5	80	0.0625000
NODE_8727_length_905_cov_6.064516	459	539	1	18	80	0.2250000
NODE_8727_length_905_cov_6.064516	459	539	3	57	80	0.7125000
NODE_8727_length_905_cov_6.064516	512	592	3	44	80	0.5500000
NODE_8727_length_905_cov_6.064516	512	592	4	36	80	0.4500000
NODE_8742_length_905_cov_1.040943	73	119	0	46	46	1.0000000
NODE_8742_length_905_cov_1.040943	126	172	0	46	46	1.0000000
NODE_8743_length_904_cov_29.532919	338	418	0	11	80	0.1375000
NODE_8743_length_904_cov_29.532919	338	418	2	31	80	0.3875000
NODE_8743_length_904_cov_29.532919	338	418	3	5	80	0.0625000
NODE_8743_length_904_cov_29.532919	338	418	4	33	80	0.4125000
NODE_8743_length_904_cov_29.532919	391	471	0	6	80	0.0750000
NODE_8743_length_904_cov_29.532919	391	471	2	16	80	0.2000000
NODE_8743_length_904_cov_29.532919	391	471	3	22	80	0.2750000
NODE_8743_length_904_cov_29.532919	391	471	4	36	80	0.4500000
NODE_8743_length_904_cov_29.532919	467	547	4	80	80	1.0000000
NODE_8743_length_904_cov_29.532919	520	600	0	15	80	0.1875000
NODE_8743_length_904_cov_29.532919	520	600	1	22	80	0.2750000
NODE_8743_length_904_cov_29.532919	520	600	2	16	80	0.2000000
NODE_8743_length_904_cov_29.532919	520	600	4	27	80	0.3375000
NODE_8744_length_904_cov_28.844720	371	451	10	10	80	0.1250000
NODE_8744_length_904_cov_28.844720	371	451	11	22	80	0.2750000
NODE_8744_length_904_cov_28.844720	371	451	12	38	80	0.4750000
NODE_8744_length_904_cov_28.844720	371	451	13	8	80	0.1000000
NODE_8744_length_904_cov_28.844720	371	451	14	2	80	0.0250000
NODE_8744_length_904_cov_28.844720	424	504	11	22	80	0.2750000
NODE_8744_length_904_cov_28.844720	424	504	12	20	80	0.2500000
NODE_8744_length_904_cov_28.844720	424	504	13	6	80	0.0750000
NODE_8744_length_904_cov_28.844720	424	504	14	32	80	0.4000000
NODE_8745_length_904_cov_26.977640	488	568	21	1	80	0.0125000
NODE_8745_length_904_cov_26.977640	488	568	22	11	80	0.1375000
NODE_8745_length_904_cov_26.977640	488	568	23	3	80	0.0375000
NODE_8745_length_904_cov_26.977640	488	568	24	14	80	0.1750000
NODE_8745_length_904_cov_26.977640	488	568	26	6	80	0.0750000
NODE_8745_length_904_cov_26.977640	488	568	27	9	80	0.1125000
NODE_8745_length_904_cov_26.977640	488	568	28	28	80	0.3500000
NODE_8745_length_904_cov_26.977640	488	568	29	8	80	0.1000000
NODE_8745_length_904_cov_26.977640	541	621	11	7	80	0.0875000
NODE_8745_length_904_cov_26.977640	541	621	14	17	80	0.2125000
NODE_8745_length_904_cov_26.977640	541	621	15	13	80	0.1625000
NODE_8745_length_904_cov_26.977640	541	621	20	5	80	0.0625000
NODE_8745_length_904_cov_26.977640	541	621	21	1	80	0.0125000
NODE_8745_length_904_cov_26.977640	541	621	22	15	80	0.1875000
NODE_8745_length_904_cov_26.977640	541	621	23	4	80	0.0500000
NODE_8745_length_904_cov_26.977640	541	621	24	18	80	0.2250000
NODE_8746_length_904_cov_24.529193	464	544	9	13	80	0.1625000
NODE_8746_length_904_cov_24.529193	464	544	10	27	80	0.3375000
NODE_8746_length_904_cov_24.529193	464	544	13	40	80	0.5000000
NODE_8746_length_904_cov_24.529193	517	597	8	1	80	0.0125000
NODE_8746_length_904_cov_24.529193	517	597	9	1	80	0.0125000
NODE_8746_length_904_cov_24.529193	517	597	11	28	80	0.3500000
NODE_8746_length_904_cov_24.529193	517	597	12	17	80	0.2125000
NODE_8746_length_904_cov_24.529193	517	597	13	33	80	0.4125000
NODE_8747_length_904_cov_24.452174	507	587	1	70	80	0.8750000
NODE_8747_length_904_cov_24.452174	507	587	2	10	80	0.1250000
NODE_8747_length_904_cov_24.452174	560	640	0	28	80	0.3500000
NODE_8747_length_904_cov_24.452174	560	640	1	52	80	0.6500000
NODE_8748_length_904_cov_19.649689	307	387	2	5	80	0.0625000
NODE_8748_length_904_cov_19.649689	307	387	4	36	80	0.4500000
NODE_8748_length_904_cov_19.649689	307	387	5	5	80	0.0625000
NODE_8748_length_904_cov_19.649689	307	387	6	31	80	0.3875000
NODE_8748_length_904_cov_19.649689	307	387	7	1	80	0.0125000
NODE_8748_length_904_cov_19.649689	307	387	8	2	80	0.0250000
NODE_8748_length_904_cov_19.649689	360	440	0	16	80	0.2000000
NODE_8748_length_904_cov_19.649689	360	440	1	17	80	0.2125000
NODE_8748_length_904_cov_19.649689	360	440	2	25	80	0.3125000
NODE_8748_length_904_cov_19.649689	360	440	4	22	80	0.2750000
NODE_8748_length_904_cov_19.649689	595	675	0	80	80	1.0000000
NODE_8748_length_904_cov_19.649689	648	728	0	80	80	1.0000000
NODE_8750_length_904_cov_16.608696	252	332	0	76	80	0.9500000
NODE_8750_length_904_cov_16.608696	252	332	1	4	80	0.0500000
NODE_8750_length_904_cov_16.608696	305	385	0	23	80	0.2875000
NODE_8750_length_904_cov_16.608696	305	385	1	56	80	0.7000000
NODE_8750_length_904_cov_16.608696	305	385	2	1	80	0.0125000
NODE_8750_length_904_cov_16.608696	381	461	1	3	80	0.0375000
NODE_8750_length_904_cov_16.608696	381	461	2	77	80	0.9625000
NODE_8750_length_904_cov_16.608696	434	514	1	36	80	0.4500000
NODE_8750_length_904_cov_16.608696	434	514	2	44	80	0.5500000
NODE_8751_length_904_cov_15.811180	431	511	9	46	80	0.5750000
NODE_8751_length_904_cov_15.811180	431	511	11	10	80	0.1250000
NODE_8751_length_904_cov_15.811180	431	511	12	2	80	0.0250000
NODE_8751_length_904_cov_15.811180	431	511	13	10	80	0.1250000
NODE_8751_length_904_cov_15.811180	431	511	14	1	80	0.0125000
NODE_8751_length_904_cov_15.811180	431	511	15	11	80	0.1375000
NODE_8751_length_904_cov_15.811180	484	564	6	27	80	0.3375000
NODE_8751_length_904_cov_15.811180	484	564	8	26	80	0.3250000
NODE_8751_length_904_cov_15.811180	484	564	11	3	80	0.0375000
NODE_8751_length_904_cov_15.811180	484	564	12	2	80	0.0250000
NODE_8751_length_904_cov_15.811180	484	564	13	10	80	0.1250000
NODE_8751_length_904_cov_15.811180	484	564	14	1	80	0.0125000
NODE_8751_length_904_cov_15.811180	484	564	15	11	80	0.1375000
NODE_8752_length_904_cov_9.249689	581	661	0	80	80	1.0000000
NODE_8752_length_904_cov_9.249689	634	714	0	80	80	1.0000000
NODE_8756_length_904_cov_4.772671	318	398	2	19	80	0.2375000
NODE_8756_length_904_cov_4.772671	318	398	3	10	80	0.1250000
NODE_8756_length_904_cov_4.772671	318	398	4	51	80	0.6375000
NODE_8756_length_904_cov_4.772671	371	451	3	41	80	0.5125000
NODE_8756_length_904_cov_4.772671	371	451	4	39	80	0.4875000
NODE_8773_length_903_cov_58.723881	386	466	13	7	80	0.0875000
NODE_8773_length_903_cov_58.723881	386	466	14	3	80	0.0375000
NODE_8773_length_903_cov_58.723881	386	466	16	31	80	0.3875000
NODE_8773_length_903_cov_58.723881	386	466	17	20	80	0.2500000
NODE_8773_length_903_cov_58.723881	386	466	18	9	80	0.1125000
NODE_8773_length_903_cov_58.723881	386	466	19	10	80	0.1250000
NODE_8773_length_903_cov_58.723881	439	519	14	6	80	0.0750000
NODE_8773_length_903_cov_58.723881	439	519	15	6	80	0.0750000
NODE_8773_length_903_cov_58.723881	439	519	16	22	80	0.2750000
NODE_8773_length_903_cov_58.723881	439	519	17	24	80	0.3000000
NODE_8773_length_903_cov_58.723881	439	519	18	21	80	0.2625000
NODE_8773_length_903_cov_58.723881	439	519	19	1	80	0.0125000
NODE_8773_length_903_cov_58.723881	515	595	5	31	80	0.3875000
NODE_8773_length_903_cov_58.723881	515	595	6	10	80	0.1250000
NODE_8773_length_903_cov_58.723881	515	595	7	6	80	0.0750000
NODE_8773_length_903_cov_58.723881	515	595	8	5	80	0.0625000
NODE_8773_length_903_cov_58.723881	515	595	9	9	80	0.1125000
NODE_8773_length_903_cov_58.723881	515	595	12	3	80	0.0375000
NODE_8773_length_903_cov_58.723881	515	595	14	8	80	0.1000000
NODE_8773_length_903_cov_58.723881	515	595	16	8	80	0.1000000
NODE_8773_length_903_cov_58.723881	568	648	2	16	80	0.2000000
NODE_8773_length_903_cov_58.723881	568	648	3	14	80	0.1750000
NODE_8773_length_903_cov_58.723881	568	648	4	16	80	0.2000000
NODE_8773_length_903_cov_58.723881	568	648	5	34	80	0.4250000
NODE_8774_length_903_cov_41.298507	397	477	16	13	80	0.1625000
NODE_8774_length_903_cov_41.298507	397	477	17	38	80	0.4750000
NODE_8774_length_903_cov_41.298507	397	477	19	4	80	0.0500000
NODE_8774_length_903_cov_41.298507	397	477	21	4	80	0.0500000
NODE_8774_length_903_cov_41.298507	397	477	22	20	80	0.2500000
NODE_8774_length_903_cov_41.298507	397	477	23	1	80	0.0125000
NODE_8774_length_903_cov_41.298507	450	530	12	14	80	0.1750000
NODE_8774_length_903_cov_41.298507	450	530	13	4	80	0.0500000
NODE_8774_length_903_cov_41.298507	450	530	15	6	80	0.0750000
NODE_8774_length_903_cov_41.298507	450	530	16	13	80	0.1625000
NODE_8774_length_903_cov_41.298507	450	530	17	18	80	0.2250000
NODE_8774_length_903_cov_41.298507	450	530	18	14	80	0.1750000
NODE_8774_length_903_cov_41.298507	450	530	19	8	80	0.1000000
NODE_8774_length_903_cov_41.298507	450	530	22	1	80	0.0125000
NODE_8774_length_903_cov_41.298507	450	530	23	2	80	0.0250000
NODE_8775_length_903_cov_28.691542	394	474	6	2	80	0.0250000
NODE_8775_length_903_cov_28.691542	394	474	8	4	80	0.0500000
NODE_8775_length_903_cov_28.691542	394	474	9	15	80	0.1875000
NODE_8775_length_903_cov_28.691542	394	474	10	2	80	0.0250000
NODE_8775_length_903_cov_28.691542	394	474	11	13	80	0.1625000
NODE_8775_length_903_cov_28.691542	394	474	12	40	80	0.5000000
NODE_8775_length_903_cov_28.691542	394	474	13	4	80	0.0500000
NODE_8775_length_903_cov_28.691542	447	527	9	7	80	0.0875000
NODE_8775_length_903_cov_28.691542	447	527	10	45	80	0.5625000
NODE_8775_length_903_cov_28.691542	447	527	11	12	80	0.1500000
NODE_8775_length_903_cov_28.691542	447	527	12	12	80	0.1500000
NODE_8775_length_903_cov_28.691542	447	527	13	4	80	0.0500000
NODE_8776_length_903_cov_26.276119	441	521	0	17	80	0.2125000
NODE_8776_length_903_cov_26.276119	441	521	1	10	80	0.1250000
NODE_8776_length_903_cov_26.276119	441	521	2	28	80	0.3500000
NODE_8776_length_903_cov_26.276119	441	521	3	25	80	0.3125000
NODE_8776_length_903_cov_26.276119	494	574	2	2	80	0.0250000
NODE_8776_length_903_cov_26.276119	494	574	3	45	80	0.5625000
NODE_8776_length_903_cov_26.276119	494	574	4	33	80	0.4125000
NODE_8778_length_903_cov_18.166667	351	431	0	80	80	1.0000000
NODE_8778_length_903_cov_18.166667	404	484	0	80	80	1.0000000
NODE_8779_length_903_cov_15.460199	440	520	0	80	80	1.0000000
NODE_8779_length_903_cov_15.460199	493	573	0	80	80	1.0000000
NODE_8780_length_903_cov_15.084577	352	432	2	80	80	1.0000000
NODE_8780_length_903_cov_15.084577	405	485	0	4	80	0.0500000
NODE_8780_length_903_cov_15.084577	405	485	1	14	80	0.1750000
NODE_8780_length_903_cov_15.084577	405	485	2	62	80	0.7750000
NODE_8781_length_903_cov_15.070896	367	447	5	10	80	0.1250000
NODE_8781_length_903_cov_15.070896	367	447	7	56	80	0.7000000
NODE_8781_length_903_cov_15.070896	367	447	9	14	80	0.1750000
NODE_8781_length_903_cov_15.070896	420	500	2	7	80	0.0875000
NODE_8781_length_903_cov_15.070896	420	500	3	3	80	0.0375000
NODE_8781_length_903_cov_15.070896	420	500	6	8	80	0.1000000
NODE_8781_length_903_cov_15.070896	420	500	7	13	80	0.1625000
NODE_8781_length_903_cov_15.070896	420	500	9	49	80	0.6125000
NODE_8782_length_903_cov_14.004975	318	399	2	41	81	0.5061728
NODE_8782_length_903_cov_14.004975	318	399	3	40	81	0.4938272
NODE_8782_length_903_cov_14.004975	372	452	2	31	80	0.3875000
NODE_8782_length_903_cov_14.004975	372	452	3	49	80	0.6125000
NODE_8783_length_903_cov_10.546020	150	230	3	70	80	0.8750000
NODE_8783_length_903_cov_10.546020	150	230	6	3	80	0.0375000
NODE_8783_length_903_cov_10.546020	150	230	7	7	80	0.0875000
NODE_8783_length_903_cov_10.546020	203	283	3	17	80	0.2125000
NODE_8783_length_903_cov_10.546020	203	283	4	4	80	0.0500000
NODE_8783_length_903_cov_10.546020	203	283	6	15	80	0.1875000
NODE_8783_length_903_cov_10.546020	203	283	7	44	80	0.5500000
NODE_8784_length_903_cov_9.288557	373	453	3	64	80	0.8000000
NODE_8784_length_903_cov_9.288557	373	453	6	16	80	0.2000000
NODE_8784_length_903_cov_9.288557	426	506	3	42	80	0.5250000
NODE_8784_length_903_cov_9.288557	426	506	6	38	80	0.4750000
NODE_8785_length_903_cov_8.052239	439	519	2	4	80	0.0500000
NODE_8785_length_903_cov_8.052239	439	519	3	7	80	0.0875000
NODE_8785_length_903_cov_8.052239	439	519	4	4	80	0.0500000
NODE_8785_length_903_cov_8.052239	439	519	5	26	80	0.3250000
NODE_8785_length_903_cov_8.052239	439	519	7	34	80	0.4250000
NODE_8785_length_903_cov_8.052239	439	519	8	5	80	0.0625000
NODE_8785_length_903_cov_8.052239	492	572	7	27	80	0.3375000
NODE_8785_length_903_cov_8.052239	492	572	8	53	80	0.6625000
NODE_8798_length_902_cov_64.459527	355	435	3	33	80	0.4125000
NODE_8798_length_902_cov_64.459527	355	435	4	26	80	0.3250000
NODE_8798_length_902_cov_64.459527	355	435	5	21	80	0.2625000
NODE_8798_length_902_cov_64.459527	408	488	2	24	80	0.3000000
NODE_8798_length_902_cov_64.459527	408	488	3	28	80	0.3500000
NODE_8798_length_902_cov_64.459527	408	488	4	28	80	0.3500000
NODE_8798_length_902_cov_64.459527	484	564	2	25	80	0.3125000
NODE_8798_length_902_cov_64.459527	484	564	4	15	80	0.1875000
NODE_8798_length_902_cov_64.459527	484	564	5	9	80	0.1125000
NODE_8798_length_902_cov_64.459527	484	564	6	31	80	0.3875000
NODE_8798_length_902_cov_64.459527	537	617	5	34	80	0.4250000
NODE_8798_length_902_cov_64.459527	537	617	6	46	80	0.5750000
NODE_8799_length_902_cov_60.823163	395	475	16	12	80	0.1500000
NODE_8799_length_902_cov_60.823163	395	475	19	2	80	0.0250000
NODE_8799_length_902_cov_60.823163	395	475	20	1	80	0.0125000
NODE_8799_length_902_cov_60.823163	395	475	21	19	80	0.2375000
NODE_8799_length_902_cov_60.823163	395	475	22	16	80	0.2000000
NODE_8799_length_902_cov_60.823163	395	475	23	30	80	0.3750000
NODE_8799_length_902_cov_60.823163	448	528	9	2	80	0.0250000
NODE_8799_length_902_cov_60.823163	448	528	13	6	80	0.0750000
NODE_8799_length_902_cov_60.823163	448	528	14	21	80	0.2625000
NODE_8799_length_902_cov_60.823163	448	528	15	20	80	0.2500000
NODE_8799_length_902_cov_60.823163	448	528	16	14	80	0.1750000
NODE_8799_length_902_cov_60.823163	448	528	18	2	80	0.0250000
NODE_8799_length_902_cov_60.823163	448	528	19	2	80	0.0250000
NODE_8799_length_902_cov_60.823163	448	528	20	1	80	0.0125000
NODE_8799_length_902_cov_60.823163	448	528	21	12	80	0.1500000
NODE_8800_length_902_cov_44.002491	383	463	10	30	80	0.3750000
NODE_8800_length_902_cov_44.002491	383	463	11	14	80	0.1750000
NODE_8800_length_902_cov_44.002491	383	463	14	13	80	0.1625000
NODE_8800_length_902_cov_44.002491	383	463	15	14	80	0.1750000
NODE_8800_length_902_cov_44.002491	383	463	17	9	80	0.1125000
NODE_8800_length_902_cov_44.002491	436	516	13	9	80	0.1125000
NODE_8800_length_902_cov_44.002491	436	516	14	39	80	0.4875000
NODE_8800_length_902_cov_44.002491	436	516	15	15	80	0.1875000
NODE_8800_length_902_cov_44.002491	436	516	16	8	80	0.1000000
NODE_8800_length_902_cov_44.002491	436	516	17	9	80	0.1125000
NODE_8801_length_902_cov_41.059776	378	458	6	2	80	0.0250000
NODE_8801_length_902_cov_41.059776	378	458	8	3	80	0.0375000
NODE_8801_length_902_cov_41.059776	378	458	9	13	80	0.1625000
NODE_8801_length_902_cov_41.059776	378	458	10	9	80	0.1125000
NODE_8801_length_902_cov_41.059776	378	458	12	8	80	0.1000000
NODE_8801_length_902_cov_41.059776	378	458	15	6	80	0.0750000
NODE_8801_length_902_cov_41.059776	378	458	16	1	80	0.0125000
NODE_8801_length_902_cov_41.059776	378	458	17	38	80	0.4750000
NODE_8801_length_902_cov_41.059776	431	511	1	29	80	0.3625000
NODE_8801_length_902_cov_41.059776	431	511	4	10	80	0.1250000
NODE_8801_length_902_cov_41.059776	431	511	5	5	80	0.0625000
NODE_8801_length_902_cov_41.059776	431	511	6	11	80	0.1375000
NODE_8801_length_902_cov_41.059776	431	511	8	3	80	0.0375000
NODE_8801_length_902_cov_41.059776	431	511	9	13	80	0.1625000
NODE_8801_length_902_cov_41.059776	431	511	10	9	80	0.1125000
NODE_8802_length_902_cov_38.952677	372	452	17	10	80	0.1250000
NODE_8802_length_902_cov_38.952677	372	452	18	10	80	0.1250000
NODE_8802_length_902_cov_38.952677	372	452	19	33	80	0.4125000
NODE_8802_length_902_cov_38.952677	372	452	20	10	80	0.1250000
NODE_8802_length_902_cov_38.952677	372	452	21	6	80	0.0750000
NODE_8802_length_902_cov_38.952677	372	452	22	10	80	0.1250000
NODE_8802_length_902_cov_38.952677	372	452	23	1	80	0.0125000
NODE_8802_length_902_cov_38.952677	425	505	19	10	80	0.1250000
NODE_8802_length_902_cov_38.952677	425	505	21	13	80	0.1625000
NODE_8802_length_902_cov_38.952677	425	505	22	16	80	0.2000000
NODE_8802_length_902_cov_38.952677	425	505	23	8	80	0.1000000
NODE_8802_length_902_cov_38.952677	425	505	24	21	80	0.2625000
NODE_8802_length_902_cov_38.952677	425	505	25	7	80	0.0875000
NODE_8802_length_902_cov_38.952677	425	505	26	1	80	0.0125000
NODE_8802_length_902_cov_38.952677	425	505	27	4	80	0.0500000
NODE_8803_length_902_cov_34.156912	373	453	13	25	80	0.3125000
NODE_8803_length_902_cov_34.156912	373	453	15	22	80	0.2750000
NODE_8803_length_902_cov_34.156912	373	453	16	5	80	0.0625000
NODE_8803_length_902_cov_34.156912	373	453	17	10	80	0.1250000
NODE_8803_length_902_cov_34.156912	373	453	18	13	80	0.1625000
NODE_8803_length_902_cov_34.156912	373	453	19	5	80	0.0625000
NODE_8803_length_902_cov_34.156912	426	506	10	21	80	0.2625000
NODE_8803_length_902_cov_34.156912	426	506	13	4	80	0.0500000
NODE_8803_length_902_cov_34.156912	426	506	15	4	80	0.0500000
NODE_8803_length_902_cov_34.156912	426	506	16	18	80	0.2250000
NODE_8803_length_902_cov_34.156912	426	506	17	16	80	0.2000000
NODE_8803_length_902_cov_34.156912	426	506	18	12	80	0.1500000
NODE_8803_length_902_cov_34.156912	426	506	19	5	80	0.0625000
NODE_8804_length_902_cov_23.007472	295	375	7	43	80	0.5375000
NODE_8804_length_902_cov_23.007472	295	375	8	24	80	0.3000000
NODE_8804_length_902_cov_23.007472	295	375	9	1	80	0.0125000
NODE_8804_length_902_cov_23.007472	295	375	10	12	80	0.1500000
NODE_8804_length_902_cov_23.007472	348	428	3	15	80	0.1875000
NODE_8804_length_902_cov_23.007472	348	428	4	12	80	0.1500000
NODE_8804_length_902_cov_23.007472	348	428	5	9	80	0.1125000
NODE_8804_length_902_cov_23.007472	348	428	8	28	80	0.3500000
NODE_8804_length_902_cov_23.007472	348	428	9	4	80	0.0500000
NODE_8804_length_902_cov_23.007472	348	428	10	12	80	0.1500000
NODE_8805_length_902_cov_19.491905	238	291	10	28	53	0.5283019
NODE_8805_length_902_cov_19.491905	238	291	11	13	53	0.2452830
NODE_8805_length_902_cov_19.491905	238	291	12	12	53	0.2264151
NODE_8805_length_902_cov_19.491905	264	344	10	2	80	0.0250000
NODE_8805_length_902_cov_19.491905	264	344	11	38	80	0.4750000
NODE_8805_length_902_cov_19.491905	264	344	12	12	80	0.1500000
NODE_8805_length_902_cov_19.491905	264	344	14	1	80	0.0125000
NODE_8805_length_902_cov_19.491905	264	344	15	27	80	0.3375000
NODE_8806_length_902_cov_10.794521	214	294	5	25	80	0.3125000
NODE_8806_length_902_cov_10.794521	214	294	6	9	80	0.1125000
NODE_8806_length_902_cov_10.794521	214	294	8	2	80	0.0250000
NODE_8806_length_902_cov_10.794521	214	294	9	13	80	0.1625000
NODE_8806_length_902_cov_10.794521	214	294	10	31	80	0.3875000
NODE_8806_length_902_cov_10.794521	267	347	7	5	80	0.0625000
NODE_8806_length_902_cov_10.794521	267	347	9	61	80	0.7625000
NODE_8806_length_902_cov_10.794521	267	347	10	14	80	0.1750000
NODE_8807_length_902_cov_9.520548	518	598	3	2	80	0.0250000
NODE_8807_length_902_cov_9.520548	518	598	5	1	80	0.0125000
NODE_8807_length_902_cov_9.520548	518	598	6	68	80	0.8500000
NODE_8807_length_902_cov_9.520548	518	598	7	9	80	0.1125000
NODE_8807_length_902_cov_9.520548	571	651	4	14	80	0.1750000
NODE_8807_length_902_cov_9.520548	571	651	5	29	80	0.3625000
NODE_8807_length_902_cov_9.520548	571	651	6	37	80	0.4625000
NODE_8808_length_902_cov_8.323786	337	417	0	19	80	0.2375000
NODE_8808_length_902_cov_8.323786	337	417	1	61	80	0.7625000
NODE_8808_length_902_cov_8.323786	390	470	1	74	80	0.9250000
NODE_8808_length_902_cov_8.323786	390	470	2	6	80	0.0750000
NODE_8811_length_902_cov_7.300125	434	514	0	80	80	1.0000000
NODE_8811_length_902_cov_7.300125	487	567	0	80	80	1.0000000
NODE_8812_length_902_cov_4.185554	505	585	0	80	80	1.0000000
NODE_8812_length_902_cov_4.185554	558	588	0	30	30	1.0000000
NODE_8812_length_902_cov_4.185554	610	662	0	52	52	1.0000000
NODE_8830_length_902_cov_0.963885	82	106	0	24	24	1.0000000
NODE_8832_length_901_cov_36.066085	412	490	10	8	78	0.1025641
NODE_8832_length_901_cov_36.066085	412	490	11	2	78	0.0256410
NODE_8832_length_901_cov_36.066085	412	490	12	15	78	0.1923077
NODE_8832_length_901_cov_36.066085	412	490	13	5	78	0.0641026
NODE_8832_length_901_cov_36.066085	412	490	14	36	78	0.4615385
NODE_8832_length_901_cov_36.066085	412	490	15	7	78	0.0897436
NODE_8832_length_901_cov_36.066085	412	490	16	5	78	0.0641026
NODE_8832_length_901_cov_36.066085	463	543	8	4	80	0.0500000
NODE_8832_length_901_cov_36.066085	463	543	9	42	80	0.5250000
NODE_8832_length_901_cov_36.066085	463	543	10	15	80	0.1875000
NODE_8832_length_901_cov_36.066085	463	543	11	2	80	0.0250000
NODE_8832_length_901_cov_36.066085	463	543	12	13	80	0.1625000
NODE_8832_length_901_cov_36.066085	463	543	13	2	80	0.0250000
NODE_8832_length_901_cov_36.066085	463	543	15	2	80	0.0250000
NODE_8833_length_901_cov_28.129676	377	457	3	19	80	0.2375000
NODE_8833_length_901_cov_28.129676	377	457	4	51	80	0.6375000
NODE_8833_length_901_cov_28.129676	377	457	5	10	80	0.1250000
NODE_8833_length_901_cov_28.129676	430	510	3	23	80	0.2875000
NODE_8833_length_901_cov_28.129676	430	510	4	57	80	0.7125000
NODE_8834_length_901_cov_26.763092	272	352	2	9	80	0.1125000
NODE_8834_length_901_cov_26.763092	272	352	3	55	80	0.6875000
NODE_8834_length_901_cov_26.763092	272	352	4	16	80	0.2000000
NODE_8834_length_901_cov_26.763092	325	405	2	34	80	0.4250000
NODE_8834_length_901_cov_26.763092	325	405	3	46	80	0.5750000
NODE_8834_length_901_cov_26.763092	401	481	2	11	80	0.1375000
NODE_8834_length_901_cov_26.763092	401	481	4	4	80	0.0500000
NODE_8834_length_901_cov_26.763092	401	481	5	23	80	0.2875000
NODE_8834_length_901_cov_26.763092	401	481	6	42	80	0.5250000
NODE_8834_length_901_cov_26.763092	454	534	4	22	80	0.2750000
NODE_8834_length_901_cov_26.763092	454	534	5	54	80	0.6750000
NODE_8834_length_901_cov_26.763092	454	534	6	4	80	0.0500000
NODE_8835_length_901_cov_25.628429	369	449	3	5	80	0.0625000
NODE_8835_length_901_cov_25.628429	369	449	6	1	80	0.0125000
NODE_8835_length_901_cov_25.628429	369	449	9	4	80	0.0500000
NODE_8835_length_901_cov_25.628429	369	449	10	60	80	0.7500000
NODE_8835_length_901_cov_25.628429	369	449	12	2	80	0.0250000
NODE_8835_length_901_cov_25.628429	369	449	13	8	80	0.1000000
NODE_8835_length_901_cov_25.628429	422	502	10	17	80	0.2125000
NODE_8835_length_901_cov_25.628429	422	502	12	8	80	0.1000000
NODE_8835_length_901_cov_25.628429	422	502	13	30	80	0.3750000
NODE_8835_length_901_cov_25.628429	422	502	14	25	80	0.3125000
NODE_8836_length_901_cov_17.857855	408	488	0	28	80	0.3500000
NODE_8836_length_901_cov_17.857855	408	488	7	52	80	0.6500000
NODE_8836_length_901_cov_17.857855	461	541	7	47	80	0.5875000
NODE_8836_length_901_cov_17.857855	461	541	8	1	80	0.0125000
NODE_8836_length_901_cov_17.857855	461	541	9	29	80	0.3625000
NODE_8836_length_901_cov_17.857855	461	541	10	3	80	0.0375000
NODE_8837_length_901_cov_16.254364	362	442	0	80	80	1.0000000
NODE_8837_length_901_cov_16.254364	415	495	0	80	80	1.0000000
NODE_8838_length_901_cov_8.346633	321	401	0	9	80	0.1125000
NODE_8838_length_901_cov_8.346633	321	401	2	30	80	0.3750000
NODE_8838_length_901_cov_8.346633	321	401	4	41	80	0.5125000
NODE_8838_length_901_cov_8.346633	374	454	4	80	80	1.0000000
NODE_8840_length_901_cov_6.044888	363	443	3	4	80	0.0500000
NODE_8840_length_901_cov_6.044888	363	443	4	26	80	0.3250000
NODE_8840_length_901_cov_6.044888	363	443	6	34	80	0.4250000
NODE_8840_length_901_cov_6.044888	363	443	8	16	80	0.2000000
NODE_8840_length_901_cov_6.044888	416	496	3	2	80	0.0250000
NODE_8840_length_901_cov_6.044888	416	496	4	55	80	0.6875000
NODE_8840_length_901_cov_6.044888	416	496	5	23	80	0.2875000
NODE_8845_length_901_cov_3.814214	194	274	2	80	80	1.0000000
NODE_8845_length_901_cov_3.814214	247	326	0	52	79	0.6582279
NODE_8845_length_901_cov_3.814214	247	326	2	27	79	0.3417721
NODE_8857_length_900_cov_30.284644	407	487	13	7	80	0.0875000
NODE_8857_length_900_cov_30.284644	407	487	14	24	80	0.3000000
NODE_8857_length_900_cov_30.284644	407	487	15	13	80	0.1625000
NODE_8857_length_900_cov_30.284644	407	487	16	11	80	0.1375000
NODE_8857_length_900_cov_30.284644	407	487	17	4	80	0.0500000
NODE_8857_length_900_cov_30.284644	407	487	18	14	80	0.1750000
NODE_8857_length_900_cov_30.284644	407	487	19	7	80	0.0875000
NODE_8857_length_900_cov_30.284644	460	540	9	5	80	0.0625000
NODE_8857_length_900_cov_30.284644	460	540	10	13	80	0.1625000
NODE_8857_length_900_cov_30.284644	460	540	12	16	80	0.2000000
NODE_8857_length_900_cov_30.284644	460	540	13	19	80	0.2375000
NODE_8857_length_900_cov_30.284644	460	540	14	10	80	0.1250000
NODE_8857_length_900_cov_30.284644	460	540	15	4	80	0.0500000
NODE_8857_length_900_cov_30.284644	460	540	16	6	80	0.0750000
NODE_8857_length_900_cov_30.284644	460	540	17	4	80	0.0500000
NODE_8857_length_900_cov_30.284644	460	540	19	3	80	0.0375000
NODE_8858_length_900_cov_29.679151	425	505	15	5	80	0.0625000
NODE_8858_length_900_cov_29.679151	425	505	16	22	80	0.2750000
NODE_8858_length_900_cov_29.679151	425	505	21	3	80	0.0375000
NODE_8858_length_900_cov_29.679151	425	505	22	18	80	0.2250000
NODE_8858_length_900_cov_29.679151	425	505	23	15	80	0.1875000
NODE_8858_length_900_cov_29.679151	425	505	24	13	80	0.1625000
NODE_8858_length_900_cov_29.679151	425	505	25	4	80	0.0500000
NODE_8858_length_900_cov_29.679151	478	558	11	2	80	0.0250000
NODE_8858_length_900_cov_29.679151	478	558	16	23	80	0.2875000
NODE_8858_length_900_cov_29.679151	478	558	18	3	80	0.0375000
NODE_8858_length_900_cov_29.679151	478	558	21	1	80	0.0125000
NODE_8858_length_900_cov_29.679151	478	558	23	39	80	0.4875000
NODE_8858_length_900_cov_29.679151	478	558	24	8	80	0.1000000
NODE_8858_length_900_cov_29.679151	478	558	25	4	80	0.0500000
NODE_8859_length_900_cov_25.963795	321	401	3	1	80	0.0125000
NODE_8859_length_900_cov_25.963795	321	401	4	1	80	0.0125000
NODE_8859_length_900_cov_25.963795	321	401	5	8	80	0.1000000
NODE_8859_length_900_cov_25.963795	321	401	6	16	80	0.2000000
NODE_8859_length_900_cov_25.963795	321	401	7	16	80	0.2000000
NODE_8859_length_900_cov_25.963795	321	401	8	38	80	0.4750000
NODE_8859_length_900_cov_25.963795	374	454	7	62	80	0.7750000
NODE_8859_length_900_cov_25.963795	374	454	8	18	80	0.2250000
NODE_8860_length_900_cov_17.681648	530	606	8	2	76	0.0263158
NODE_8860_length_900_cov_17.681648	530	606	9	25	76	0.3289474
NODE_8860_length_900_cov_17.681648	530	606	10	31	76	0.4078947
NODE_8860_length_900_cov_17.681648	530	606	11	18	76	0.2368421
NODE_8860_length_900_cov_17.681648	583	659	8	2	76	0.0263158
NODE_8860_length_900_cov_17.681648	583	659	9	43	76	0.5657895
NODE_8860_length_900_cov_17.681648	583	659	10	31	76	0.4078947
NODE_8861_length_900_cov_16.294632	316	396	2	12	80	0.1500000
NODE_8861_length_900_cov_16.294632	316	396	5	9	80	0.1125000
NODE_8861_length_900_cov_16.294632	316	396	6	59	80	0.7375000
NODE_8861_length_900_cov_16.294632	369	449	1	26	80	0.3250000
NODE_8861_length_900_cov_16.294632	369	449	2	39	80	0.4875000
NODE_8861_length_900_cov_16.294632	369	449	5	1	80	0.0125000
NODE_8861_length_900_cov_16.294632	369	449	6	14	80	0.1750000
NODE_8863_length_900_cov_5.962547	0	70	0	70	70	1.0000000
NODE_8863_length_900_cov_5.962547	43	108	0	65	65	1.0000000
NODE_8870_length_900_cov_2.521848	85	165	0	80	80	1.0000000
NODE_8870_length_900_cov_2.521848	138	218	0	80	80	1.0000000
NODE_8879_length_899_cov_45.853750	380	460	17	9	80	0.1125000
NODE_8879_length_899_cov_45.853750	380	460	20	7	80	0.0875000
NODE_8879_length_899_cov_45.853750	380	460	22	1	80	0.0125000
NODE_8879_length_899_cov_45.853750	380	460	23	1	80	0.0125000
NODE_8879_length_899_cov_45.853750	380	460	25	1	80	0.0125000
NODE_8879_length_899_cov_45.853750	380	460	26	8	80	0.1000000
NODE_8879_length_899_cov_45.853750	380	460	28	24	80	0.3000000
NODE_8879_length_899_cov_45.853750	380	460	29	11	80	0.1375000
NODE_8879_length_899_cov_45.853750	380	460	30	13	80	0.1625000
NODE_8879_length_899_cov_45.853750	380	460	31	3	80	0.0375000
NODE_8879_length_899_cov_45.853750	380	460	32	2	80	0.0250000
NODE_8879_length_899_cov_45.853750	433	516	24	15	83	0.1807229
NODE_8879_length_899_cov_45.853750	433	516	25	2	83	0.0240964
NODE_8879_length_899_cov_45.853750	433	516	26	15	83	0.1807229
NODE_8879_length_899_cov_45.853750	433	516	27	2	83	0.0240964
NODE_8879_length_899_cov_45.853750	433	516	28	35	83	0.4216867
NODE_8879_length_899_cov_45.853750	433	516	29	9	83	0.1084337
NODE_8879_length_899_cov_45.853750	433	516	30	5	83	0.0602410
NODE_8880_length_899_cov_37.758750	381	461	8	5	80	0.0625000
NODE_8880_length_899_cov_37.758750	381	461	10	52	80	0.6500000
NODE_8880_length_899_cov_37.758750	381	461	11	23	80	0.2875000
NODE_8880_length_899_cov_37.758750	434	514	5	3	80	0.0375000
NODE_8880_length_899_cov_37.758750	434	514	6	10	80	0.1250000
NODE_8880_length_899_cov_37.758750	434	514	8	18	80	0.2250000
NODE_8880_length_899_cov_37.758750	434	514	9	20	80	0.2500000
NODE_8880_length_899_cov_37.758750	434	514	10	29	80	0.3625000
NODE_8881_length_899_cov_27.362500	413	493	12	2	80	0.0250000
NODE_8881_length_899_cov_27.362500	413	493	13	5	80	0.0625000
NODE_8881_length_899_cov_27.362500	413	493	14	1	80	0.0125000
NODE_8881_length_899_cov_27.362500	413	493	15	9	80	0.1125000
NODE_8881_length_899_cov_27.362500	413	493	16	4	80	0.0500000
NODE_8881_length_899_cov_27.362500	413	493	18	8	80	0.1000000
NODE_8881_length_899_cov_27.362500	413	493	19	22	80	0.2750000
NODE_8881_length_899_cov_27.362500	413	493	20	21	80	0.2625000
NODE_8881_length_899_cov_27.362500	413	493	21	1	80	0.0125000
NODE_8881_length_899_cov_27.362500	413	493	22	7	80	0.0875000
NODE_8881_length_899_cov_27.362500	466	546	14	5	80	0.0625000
NODE_8881_length_899_cov_27.362500	466	546	15	15	80	0.1875000
NODE_8881_length_899_cov_27.362500	466	546	16	15	80	0.1875000
NODE_8881_length_899_cov_27.362500	466	546	17	10	80	0.1250000
NODE_8881_length_899_cov_27.362500	466	546	19	10	80	0.1250000
NODE_8881_length_899_cov_27.362500	466	546	20	25	80	0.3125000
NODE_8882_length_899_cov_20.563750	379	459	2	7	80	0.0875000
NODE_8882_length_899_cov_20.563750	379	459	4	9	80	0.1125000
NODE_8882_length_899_cov_20.563750	379	459	5	64	80	0.8000000
NODE_8882_length_899_cov_20.563750	432	507	5	27	75	0.3600000
NODE_8882_length_899_cov_20.563750	432	507	6	48	75	0.6400000
NODE_8884_length_899_cov_17.130000	319	399	1	2	80	0.0250000
NODE_8884_length_899_cov_17.130000	319	399	2	8	80	0.1000000
NODE_8884_length_899_cov_17.130000	319	399	3	48	80	0.6000000
NODE_8884_length_899_cov_17.130000	319	399	4	22	80	0.2750000
NODE_8884_length_899_cov_17.130000	372	452	3	5	80	0.0625000
NODE_8884_length_899_cov_17.130000	372	452	4	48	80	0.6000000
NODE_8884_length_899_cov_17.130000	372	452	5	27	80	0.3375000
NODE_8885_length_899_cov_16.317500	270	350	5	6	80	0.0750000
NODE_8885_length_899_cov_16.317500	270	350	6	16	80	0.2000000
NODE_8885_length_899_cov_16.317500	270	350	7	15	80	0.1875000
NODE_8885_length_899_cov_16.317500	270	350	8	23	80	0.2875000
NODE_8885_length_899_cov_16.317500	270	350	9	16	80	0.2000000
NODE_8885_length_899_cov_16.317500	270	350	10	4	80	0.0500000
NODE_8885_length_899_cov_16.317500	323	403	8	42	80	0.5250000
NODE_8885_length_899_cov_16.317500	323	403	9	27	80	0.3375000
NODE_8885_length_899_cov_16.317500	323	403	10	11	80	0.1375000
NODE_8886_length_899_cov_16.190000	284	364	9	22	80	0.2750000
NODE_8886_length_899_cov_16.190000	284	364	10	1	80	0.0125000
NODE_8886_length_899_cov_16.190000	284	364	11	26	80	0.3250000
NODE_8886_length_899_cov_16.190000	284	364	15	14	80	0.1750000
NODE_8886_length_899_cov_16.190000	284	364	16	11	80	0.1375000
NODE_8886_length_899_cov_16.190000	284	364	17	6	80	0.0750000
NODE_8886_length_899_cov_16.190000	337	417	8	3	80	0.0375000
NODE_8886_length_899_cov_16.190000	337	417	9	34	80	0.4250000
NODE_8886_length_899_cov_16.190000	337	417	10	39	80	0.4875000
NODE_8886_length_899_cov_16.190000	337	417	11	4	80	0.0500000
NODE_8887_length_899_cov_13.873750	317	397	0	1	80	0.0125000
NODE_8887_length_899_cov_13.873750	317	397	1	79	80	0.9875000
NODE_8887_length_899_cov_13.873750	370	450	1	80	80	1.0000000
NODE_8888_length_899_cov_12.957500	240	320	0	80	80	1.0000000
NODE_8888_length_899_cov_12.957500	293	373	0	80	80	1.0000000
NODE_8889_length_899_cov_12.516250	387	467	8	4	80	0.0500000
NODE_8889_length_899_cov_12.516250	387	467	9	5	80	0.0625000
NODE_8889_length_899_cov_12.516250	387	467	10	5	80	0.0625000
NODE_8889_length_899_cov_12.516250	387	467	11	16	80	0.2000000
NODE_8889_length_899_cov_12.516250	387	467	12	1	80	0.0125000
NODE_8889_length_899_cov_12.516250	387	467	13	36	80	0.4500000
NODE_8889_length_899_cov_12.516250	387	467	14	13	80	0.1625000
NODE_8889_length_899_cov_12.516250	440	520	9	16	80	0.2000000
NODE_8889_length_899_cov_12.516250	440	520	10	5	80	0.0625000
NODE_8889_length_899_cov_12.516250	440	520	11	46	80	0.5750000
NODE_8889_length_899_cov_12.516250	440	520	12	2	80	0.0250000
NODE_8889_length_899_cov_12.516250	440	520	14	11	80	0.1375000
NODE_8890_length_899_cov_10.846250	348	428	0	80	80	1.0000000
NODE_8890_length_899_cov_10.846250	401	485	0	84	84	1.0000000
NODE_8891_length_899_cov_9.185000	347	427	10	19	80	0.2375000
NODE_8891_length_899_cov_9.185000	347	427	12	14	80	0.1750000
NODE_8891_length_899_cov_9.185000	347	427	14	24	80	0.3000000
NODE_8891_length_899_cov_9.185000	347	427	15	3	80	0.0375000
NODE_8891_length_899_cov_9.185000	347	427	16	20	80	0.2500000
NODE_8891_length_899_cov_9.185000	400	480	4	3	80	0.0375000
NODE_8891_length_899_cov_9.185000	400	480	6	12	80	0.1500000
NODE_8891_length_899_cov_9.185000	400	480	7	1	80	0.0125000
NODE_8891_length_899_cov_9.185000	400	480	8	24	80	0.3000000
NODE_8891_length_899_cov_9.185000	400	480	10	32	80	0.4000000
NODE_8891_length_899_cov_9.185000	400	480	12	8	80	0.1000000
NODE_8892_length_899_cov_8.655000	498	578	2	80	80	1.0000000
NODE_8892_length_899_cov_8.655000	551	631	0	26	80	0.3250000
NODE_8892_length_899_cov_8.655000	551	631	1	23	80	0.2875000
NODE_8892_length_899_cov_8.655000	551	631	2	31	80	0.3875000
NODE_8893_length_899_cov_3.551250	0	54	0	54	54	1.0000000
NODE_8893_length_899_cov_3.551250	27	107	0	80	80	1.0000000
NODE_8893_length_899_cov_3.551250	103	183	0	26	80	0.3250000
NODE_8893_length_899_cov_3.551250	103	183	1	2	80	0.0250000
NODE_8893_length_899_cov_3.551250	103	183	2	52	80	0.6500000
NODE_8893_length_899_cov_3.551250	156	179	2	23	23	1.0000000
NODE_8914_length_898_cov_52.405507	299	379	17	10	80	0.1250000
NODE_8914_length_898_cov_52.405507	299	379	18	8	80	0.1000000
NODE_8914_length_898_cov_52.405507	299	379	20	4	80	0.0500000
NODE_8914_length_898_cov_52.405507	299	379	21	3	80	0.0375000
NODE_8914_length_898_cov_52.405507	299	379	23	20	80	0.2500000
NODE_8914_length_898_cov_52.405507	299	379	24	3	80	0.0375000
NODE_8914_length_898_cov_52.405507	299	379	26	1	80	0.0125000
NODE_8914_length_898_cov_52.405507	299	379	27	5	80	0.0625000
NODE_8914_length_898_cov_52.405507	299	379	28	4	80	0.0500000
NODE_8914_length_898_cov_52.405507	299	379	29	9	80	0.1125000
NODE_8914_length_898_cov_52.405507	299	379	30	7	80	0.0875000
NODE_8914_length_898_cov_52.405507	299	379	31	6	80	0.0750000
NODE_8914_length_898_cov_52.405507	352	432	27	1	80	0.0125000
NODE_8914_length_898_cov_52.405507	352	432	28	4	80	0.0500000
NODE_8914_length_898_cov_52.405507	352	432	29	17	80	0.2125000
NODE_8914_length_898_cov_52.405507	352	432	30	7	80	0.0875000
NODE_8914_length_898_cov_52.405507	352	432	31	15	80	0.1875000
NODE_8914_length_898_cov_52.405507	352	432	32	6	80	0.0750000
NODE_8914_length_898_cov_52.405507	352	432	33	16	80	0.2000000
NODE_8914_length_898_cov_52.405507	352	432	34	14	80	0.1750000
NODE_8914_length_898_cov_52.405507	428	508	18	3	80	0.0375000
NODE_8914_length_898_cov_52.405507	428	508	19	2	80	0.0250000
NODE_8914_length_898_cov_52.405507	428	508	20	5	80	0.0625000
NODE_8914_length_898_cov_52.405507	428	508	21	1	80	0.0125000
NODE_8914_length_898_cov_52.405507	428	508	23	3	80	0.0375000
NODE_8914_length_898_cov_52.405507	428	508	24	20	80	0.2500000
NODE_8914_length_898_cov_52.405507	428	508	26	3	80	0.0375000
NODE_8914_length_898_cov_52.405507	428	508	29	12	80	0.1500000
NODE_8914_length_898_cov_52.405507	428	508	32	16	80	0.2000000
NODE_8914_length_898_cov_52.405507	428	508	33	15	80	0.1875000
NODE_8914_length_898_cov_52.405507	481	561	8	12	80	0.1500000
NODE_8914_length_898_cov_52.405507	481	561	9	5	80	0.0625000
NODE_8914_length_898_cov_52.405507	481	561	10	2	80	0.0250000
NODE_8914_length_898_cov_52.405507	481	561	11	10	80	0.1250000
NODE_8914_length_898_cov_52.405507	481	561	12	3	80	0.0375000
NODE_8914_length_898_cov_52.405507	481	561	13	7	80	0.0875000
NODE_8914_length_898_cov_52.405507	481	561	16	7	80	0.0875000
NODE_8914_length_898_cov_52.405507	481	561	17	6	80	0.0750000
NODE_8914_length_898_cov_52.405507	481	561	18	4	80	0.0500000
NODE_8914_length_898_cov_52.405507	481	561	19	2	80	0.0250000
NODE_8914_length_898_cov_52.405507	481	561	20	5	80	0.0625000
NODE_8914_length_898_cov_52.405507	481	561	21	1	80	0.0125000
NODE_8914_length_898_cov_52.405507	481	561	23	3	80	0.0375000
NODE_8914_length_898_cov_52.405507	481	561	24	13	80	0.1625000
NODE_8915_length_898_cov_44.973717	363	443	12	33	80	0.4125000
NODE_8915_length_898_cov_44.973717	363	443	16	21	80	0.2625000
NODE_8915_length_898_cov_44.973717	363	443	22	26	80	0.3250000
NODE_8915_length_898_cov_44.973717	416	496	16	1	80	0.0125000
NODE_8915_length_898_cov_44.973717	416	496	19	8	80	0.1000000
NODE_8915_length_898_cov_44.973717	416	496	20	5	80	0.0625000
NODE_8915_length_898_cov_44.973717	416	496	21	12	80	0.1500000
NODE_8915_length_898_cov_44.973717	416	496	22	54	80	0.6750000
NODE_8916_length_898_cov_38.269086	425	505	14	44	80	0.5500000
NODE_8916_length_898_cov_38.269086	425	505	15	23	80	0.2875000
NODE_8916_length_898_cov_38.269086	425	505	16	13	80	0.1625000
NODE_8916_length_898_cov_38.269086	478	558	7	4	80	0.0500000
NODE_8916_length_898_cov_38.269086	478	558	8	39	80	0.4875000
NODE_8916_length_898_cov_38.269086	478	558	12	2	80	0.0250000
NODE_8916_length_898_cov_38.269086	478	558	13	4	80	0.0500000
NODE_8916_length_898_cov_38.269086	478	558	15	20	80	0.2500000
NODE_8916_length_898_cov_38.269086	478	558	16	11	80	0.1375000
NODE_8917_length_898_cov_27.006258	465	545	7	4	80	0.0500000
NODE_8917_length_898_cov_27.006258	465	545	8	5	80	0.0625000
NODE_8917_length_898_cov_27.006258	465	545	9	15	80	0.1875000
NODE_8917_length_898_cov_27.006258	465	545	10	11	80	0.1375000
NODE_8917_length_898_cov_27.006258	465	545	11	21	80	0.2625000
NODE_8917_length_898_cov_27.006258	465	545	12	16	80	0.2000000
NODE_8917_length_898_cov_27.006258	465	545	13	3	80	0.0375000
NODE_8917_length_898_cov_27.006258	465	545	15	5	80	0.0625000
NODE_8917_length_898_cov_27.006258	518	598	11	3	80	0.0375000
NODE_8917_length_898_cov_27.006258	518	598	12	16	80	0.2000000
NODE_8917_length_898_cov_27.006258	518	598	13	3	80	0.0375000
NODE_8917_length_898_cov_27.006258	518	598	15	58	80	0.7250000
NODE_8918_length_898_cov_25.902378	185	265	0	52	80	0.6500000
NODE_8918_length_898_cov_25.902378	185	265	2	15	80	0.1875000
NODE_8918_length_898_cov_25.902378	185	265	5	13	80	0.1625000
NODE_8918_length_898_cov_25.902378	238	318	2	14	80	0.1750000
NODE_8918_length_898_cov_25.902378	238	318	5	34	80	0.4250000
NODE_8918_length_898_cov_25.902378	238	318	6	5	80	0.0625000
NODE_8918_length_898_cov_25.902378	238	318	8	25	80	0.3125000
NODE_8918_length_898_cov_25.902378	238	318	9	2	80	0.0250000
NODE_8918_length_898_cov_25.902378	314	394	8	2	80	0.0250000
NODE_8918_length_898_cov_25.902378	314	394	9	30	80	0.3750000
NODE_8918_length_898_cov_25.902378	314	394	10	7	80	0.0875000
NODE_8918_length_898_cov_25.902378	314	394	12	41	80	0.5125000
NODE_8918_length_898_cov_25.902378	367	447	4	6	80	0.0750000
NODE_8918_length_898_cov_25.902378	367	447	6	5	80	0.0625000
NODE_8918_length_898_cov_25.902378	367	447	7	34	80	0.4250000
NODE_8918_length_898_cov_25.902378	367	447	10	15	80	0.1875000
NODE_8918_length_898_cov_25.902378	367	447	12	20	80	0.2500000
NODE_8919_length_898_cov_25.209011	368	448	11	6	80	0.0750000
NODE_8919_length_898_cov_25.209011	368	448	12	7	80	0.0875000
NODE_8919_length_898_cov_25.209011	368	448	13	2	80	0.0250000
NODE_8919_length_898_cov_25.209011	368	448	15	1	80	0.0125000
NODE_8919_length_898_cov_25.209011	368	448	16	3	80	0.0375000
NODE_8919_length_898_cov_25.209011	368	448	17	1	80	0.0125000
NODE_8919_length_898_cov_25.209011	368	448	18	17	80	0.2125000
NODE_8919_length_898_cov_25.209011	368	448	19	8	80	0.1000000
NODE_8919_length_898_cov_25.209011	368	448	20	8	80	0.1000000
NODE_8919_length_898_cov_25.209011	368	448	21	27	80	0.3375000
NODE_8919_length_898_cov_25.209011	421	501	14	13	80	0.1625000
NODE_8919_length_898_cov_25.209011	421	501	15	10	80	0.1250000
NODE_8919_length_898_cov_25.209011	421	501	16	1	80	0.0125000
NODE_8919_length_898_cov_25.209011	421	501	17	10	80	0.1250000
NODE_8919_length_898_cov_25.209011	421	501	18	35	80	0.4375000
NODE_8919_length_898_cov_25.209011	421	501	19	2	80	0.0250000
NODE_8919_length_898_cov_25.209011	421	501	20	8	80	0.1000000
NODE_8919_length_898_cov_25.209011	421	501	21	1	80	0.0125000
NODE_8920_length_898_cov_21.923655	325	405	8	4	80	0.0500000
NODE_8920_length_898_cov_21.923655	325	405	9	2	80	0.0250000
NODE_8920_length_898_cov_21.923655	325	405	10	7	80	0.0875000
NODE_8920_length_898_cov_21.923655	325	405	11	10	80	0.1250000
NODE_8920_length_898_cov_21.923655	325	405	12	11	80	0.1375000
NODE_8920_length_898_cov_21.923655	325	405	16	1	80	0.0125000
NODE_8920_length_898_cov_21.923655	325	405	18	16	80	0.2000000
NODE_8920_length_898_cov_21.923655	325	405	19	2	80	0.0250000
NODE_8920_length_898_cov_21.923655	325	405	23	9	80	0.1125000
NODE_8920_length_898_cov_21.923655	325	405	27	18	80	0.2250000
NODE_8920_length_898_cov_21.923655	378	458	21	12	80	0.1500000
NODE_8920_length_898_cov_21.923655	378	458	22	20	80	0.2500000
NODE_8920_length_898_cov_21.923655	378	458	23	30	80	0.3750000
NODE_8920_length_898_cov_21.923655	378	458	27	18	80	0.2250000
NODE_8921_length_898_cov_21.065081	306	386	4	80	80	1.0000000
NODE_8921_length_898_cov_21.065081	359	439	1	11	80	0.1375000
NODE_8921_length_898_cov_21.065081	359	439	2	2	80	0.0250000
NODE_8921_length_898_cov_21.065081	359	439	3	38	80	0.4750000
NODE_8921_length_898_cov_21.065081	359	439	4	29	80	0.3625000
NODE_8922_length_898_cov_20.954944	374	454	6	5	80	0.0625000
NODE_8922_length_898_cov_20.954944	374	454	11	16	80	0.2000000
NODE_8922_length_898_cov_20.954944	374	454	12	5	80	0.0625000
NODE_8922_length_898_cov_20.954944	374	454	13	28	80	0.3500000
NODE_8922_length_898_cov_20.954944	374	454	14	26	80	0.3250000
NODE_8922_length_898_cov_20.954944	427	507	12	2	80	0.0250000
NODE_8922_length_898_cov_20.954944	427	507	13	53	80	0.6625000
NODE_8922_length_898_cov_20.954944	427	507	14	12	80	0.1500000
NODE_8922_length_898_cov_20.954944	427	507	15	13	80	0.1625000
NODE_8923_length_898_cov_17.387985	398	478	3	1	80	0.0125000
NODE_8923_length_898_cov_17.387985	398	478	4	68	80	0.8500000
NODE_8923_length_898_cov_17.387985	398	478	5	11	80	0.1375000
NODE_8923_length_898_cov_17.387985	451	531	2	18	80	0.2250000
NODE_8923_length_898_cov_17.387985	451	531	3	22	80	0.2750000
NODE_8923_length_898_cov_17.387985	451	531	4	31	80	0.3875000
NODE_8923_length_898_cov_17.387985	451	531	5	9	80	0.1125000
NODE_8924_length_898_cov_17.252816	265	345	3	27	80	0.3375000
NODE_8924_length_898_cov_17.252816	265	345	4	27	80	0.3375000
NODE_8924_length_898_cov_17.252816	265	345	5	26	80	0.3250000
NODE_8924_length_898_cov_17.252816	318	398	4	7	80	0.0875000
NODE_8924_length_898_cov_17.252816	318	398	5	44	80	0.5500000
NODE_8924_length_898_cov_17.252816	318	398	6	29	80	0.3625000
NODE_8926_length_898_cov_13.152691	455	535	0	80	80	1.0000000
NODE_8926_length_898_cov_13.152691	508	588	0	80	80	1.0000000
NODE_8927_length_898_cov_12.612015	375	455	0	80	80	1.0000000
NODE_8927_length_898_cov_12.612015	428	508	0	80	80	1.0000000
NODE_8928_length_898_cov_12.498123	428	508	4	1	80	0.0125000
NODE_8928_length_898_cov_12.498123	428	508	11	33	80	0.4125000
NODE_8928_length_898_cov_12.498123	428	508	15	46	80	0.5750000
NODE_8928_length_898_cov_12.498123	481	561	11	56	80	0.7000000
NODE_8928_length_898_cov_12.498123	481	561	15	24	80	0.3000000
NODE_8932_length_898_cov_1.790989	0	56	0	56	56	1.0000000
NODE_8932_length_898_cov_1.790989	29	93	0	64	64	1.0000000
NODE_8944_length_897_cov_63.921053	350	430	27	1	80	0.0125000
NODE_8944_length_897_cov_63.921053	350	430	28	25	80	0.3125000
NODE_8944_length_897_cov_63.921053	350	430	29	1	80	0.0125000
NODE_8944_length_897_cov_63.921053	350	430	30	10	80	0.1250000
NODE_8944_length_897_cov_63.921053	350	430	34	9	80	0.1125000
NODE_8944_length_897_cov_63.921053	350	430	35	15	80	0.1875000
NODE_8944_length_897_cov_63.921053	350	430	36	12	80	0.1500000
NODE_8944_length_897_cov_63.921053	350	430	37	4	80	0.0500000
NODE_8944_length_897_cov_63.921053	350	430	38	3	80	0.0375000
NODE_8944_length_897_cov_63.921053	403	483	25	18	80	0.2250000
NODE_8944_length_897_cov_63.921053	403	483	26	13	80	0.1625000
NODE_8944_length_897_cov_63.921053	403	483	28	2	80	0.0250000
NODE_8944_length_897_cov_63.921053	403	483	29	3	80	0.0375000
NODE_8944_length_897_cov_63.921053	403	483	30	9	80	0.1125000
NODE_8944_length_897_cov_63.921053	403	483	31	2	80	0.0250000
NODE_8944_length_897_cov_63.921053	403	483	32	1	80	0.0125000
NODE_8944_length_897_cov_63.921053	403	483	33	3	80	0.0375000
NODE_8944_length_897_cov_63.921053	403	483	34	10	80	0.1250000
NODE_8944_length_897_cov_63.921053	403	483	35	1	80	0.0125000
NODE_8944_length_897_cov_63.921053	403	483	36	12	80	0.1500000
NODE_8944_length_897_cov_63.921053	403	483	37	3	80	0.0375000
NODE_8944_length_897_cov_63.921053	403	483	38	3	80	0.0375000
NODE_8945_length_897_cov_58.921053	316	396	28	2	80	0.0250000
NODE_8945_length_897_cov_58.921053	316	396	30	11	80	0.1375000
NODE_8945_length_897_cov_58.921053	316	396	31	6	80	0.0750000
NODE_8945_length_897_cov_58.921053	316	396	32	3	80	0.0375000
NODE_8945_length_897_cov_58.921053	316	396	33	2	80	0.0250000
NODE_8945_length_897_cov_58.921053	316	396	34	5	80	0.0625000
NODE_8945_length_897_cov_58.921053	316	396	35	2	80	0.0250000
NODE_8945_length_897_cov_58.921053	316	396	36	4	80	0.0500000
NODE_8945_length_897_cov_58.921053	316	396	37	10	80	0.1250000
NODE_8945_length_897_cov_58.921053	316	396	38	11	80	0.1375000
NODE_8945_length_897_cov_58.921053	316	396	39	3	80	0.0375000
NODE_8945_length_897_cov_58.921053	316	396	40	6	80	0.0750000
NODE_8945_length_897_cov_58.921053	316	396	41	11	80	0.1375000
NODE_8945_length_897_cov_58.921053	316	396	42	3	80	0.0375000
NODE_8945_length_897_cov_58.921053	316	396	43	1	80	0.0125000
NODE_8945_length_897_cov_58.921053	369	449	34	1	80	0.0125000
NODE_8945_length_897_cov_58.921053	369	449	35	8	80	0.1000000
NODE_8945_length_897_cov_58.921053	369	449	36	1	80	0.0125000
NODE_8945_length_897_cov_58.921053	369	449	37	6	80	0.0750000
NODE_8945_length_897_cov_58.921053	369	449	38	3	80	0.0375000
NODE_8945_length_897_cov_58.921053	369	449	39	13	80	0.1625000
NODE_8945_length_897_cov_58.921053	369	449	40	13	80	0.1625000
NODE_8945_length_897_cov_58.921053	369	449	41	25	80	0.3125000
NODE_8945_length_897_cov_58.921053	369	449	42	9	80	0.1125000
NODE_8945_length_897_cov_58.921053	369	449	43	1	80	0.0125000
NODE_8946_length_897_cov_35.946115	324	404	5	18	80	0.2250000
NODE_8946_length_897_cov_35.946115	324	404	6	38	80	0.4750000
NODE_8946_length_897_cov_35.946115	324	404	7	24	80	0.3000000
NODE_8946_length_897_cov_35.946115	377	457	3	10	80	0.1250000
NODE_8946_length_897_cov_35.946115	377	457	4	11	80	0.1375000
NODE_8946_length_897_cov_35.946115	377	457	5	50	80	0.6250000
NODE_8946_length_897_cov_35.946115	377	457	7	9	80	0.1125000
NODE_8947_length_897_cov_25.548872	238	318	0	80	80	1.0000000
NODE_8947_length_897_cov_25.548872	291	371	0	80	80	1.0000000
NODE_8948_length_897_cov_24.913534	399	479	8	5	80	0.0625000
NODE_8948_length_897_cov_24.913534	399	479	9	34	80	0.4250000
NODE_8948_length_897_cov_24.913534	399	479	10	39	80	0.4875000
NODE_8948_length_897_cov_24.913534	399	479	12	2	80	0.0250000
NODE_8948_length_897_cov_24.913534	452	532	5	3	80	0.0375000
NODE_8948_length_897_cov_24.913534	452	532	6	29	80	0.3625000
NODE_8948_length_897_cov_24.913534	452	532	9	13	80	0.1625000
NODE_8948_length_897_cov_24.913534	452	532	10	35	80	0.4375000
NODE_8949_length_897_cov_21.839599	308	388	8	17	80	0.2125000
NODE_8949_length_897_cov_21.839599	308	388	9	21	80	0.2625000
NODE_8949_length_897_cov_21.839599	308	388	10	23	80	0.2875000
NODE_8949_length_897_cov_21.839599	308	388	11	16	80	0.2000000
NODE_8949_length_897_cov_21.839599	308	388	12	3	80	0.0375000
NODE_8949_length_897_cov_21.839599	361	441	8	12	80	0.1500000
NODE_8949_length_897_cov_21.839599	361	441	9	38	80	0.4750000
NODE_8949_length_897_cov_21.839599	361	441	10	19	80	0.2375000
NODE_8949_length_897_cov_21.839599	361	441	11	8	80	0.1000000
NODE_8949_length_897_cov_21.839599	361	441	12	3	80	0.0375000
NODE_8950_length_897_cov_19.355890	489	569	11	13	80	0.1625000
NODE_8950_length_897_cov_19.355890	489	569	12	18	80	0.2250000
NODE_8950_length_897_cov_19.355890	489	569	13	21	80	0.2625000
NODE_8950_length_897_cov_19.355890	489	569	14	26	80	0.3250000
NODE_8950_length_897_cov_19.355890	489	569	15	2	80	0.0250000
NODE_8950_length_897_cov_19.355890	542	622	6	11	80	0.1375000
NODE_8950_length_897_cov_19.355890	542	622	7	5	80	0.0625000
NODE_8950_length_897_cov_19.355890	542	622	8	23	80	0.2875000
NODE_8950_length_897_cov_19.355890	542	622	9	4	80	0.0500000
NODE_8950_length_897_cov_19.355890	542	622	10	2	80	0.0250000
NODE_8950_length_897_cov_19.355890	542	622	12	1	80	0.0125000
NODE_8950_length_897_cov_19.355890	542	622	13	12	80	0.1500000
NODE_8950_length_897_cov_19.355890	542	622	14	22	80	0.2750000
NODE_8951_length_897_cov_16.295739	209	289	1	9	80	0.1125000
NODE_8951_length_897_cov_16.295739	209	289	3	12	80	0.1500000
NODE_8951_length_897_cov_16.295739	209	289	4	25	80	0.3125000
NODE_8951_length_897_cov_16.295739	209	289	5	34	80	0.4250000
NODE_8951_length_897_cov_16.295739	262	342	5	35	80	0.4375000
NODE_8951_length_897_cov_16.295739	262	342	6	14	80	0.1750000
NODE_8951_length_897_cov_16.295739	262	342	7	31	80	0.3875000
NODE_8952_length_897_cov_14.766917	395	475	14	10	80	0.1250000
NODE_8952_length_897_cov_14.766917	395	475	15	3	80	0.0375000
NODE_8952_length_897_cov_14.766917	395	475	16	1	80	0.0125000
NODE_8952_length_897_cov_14.766917	395	475	17	34	80	0.4250000
NODE_8952_length_897_cov_14.766917	395	475	18	1	80	0.0125000
NODE_8952_length_897_cov_14.766917	395	475	19	16	80	0.2000000
NODE_8952_length_897_cov_14.766917	395	475	20	1	80	0.0125000
NODE_8952_length_897_cov_14.766917	395	475	21	14	80	0.1750000
NODE_8952_length_897_cov_14.766917	448	528	12	27	80	0.3375000
NODE_8952_length_897_cov_14.766917	448	528	13	3	80	0.0375000
NODE_8952_length_897_cov_14.766917	448	528	14	9	80	0.1125000
NODE_8952_length_897_cov_14.766917	448	528	15	16	80	0.2000000
NODE_8952_length_897_cov_14.766917	448	528	17	10	80	0.1250000
NODE_8952_length_897_cov_14.766917	448	528	18	1	80	0.0125000
NODE_8952_length_897_cov_14.766917	448	528	19	5	80	0.0625000
NODE_8952_length_897_cov_14.766917	448	528	20	1	80	0.0125000
NODE_8952_length_897_cov_14.766917	448	528	21	8	80	0.1000000
NODE_8953_length_897_cov_14.219298	253	333	9	13	80	0.1625000
NODE_8953_length_897_cov_14.219298	253	333	13	8	80	0.1000000
NODE_8953_length_897_cov_14.219298	253	333	14	35	80	0.4375000
NODE_8953_length_897_cov_14.219298	253	333	17	1	80	0.0125000
NODE_8953_length_897_cov_14.219298	253	333	18	10	80	0.1250000
NODE_8953_length_897_cov_14.219298	253	333	19	13	80	0.1625000
NODE_8953_length_897_cov_14.219298	306	386	14	80	80	1.0000000
NODE_8954_length_897_cov_11.116541	182	262	0	54	80	0.6750000
NODE_8954_length_897_cov_11.116541	182	262	5	26	80	0.3250000
NODE_8954_length_897_cov_11.116541	235	315	0	1	80	0.0125000
NODE_8954_length_897_cov_11.116541	235	315	5	79	80	0.9875000
NODE_8955_length_897_cov_8.211779	303	383	2	80	80	1.0000000
NODE_8955_length_897_cov_8.211779	356	436	1	41	80	0.5125000
NODE_8955_length_897_cov_8.211779	356	436	2	39	80	0.4875000
NODE_8973_length_896_cov_48.249686	397	477	9	20	80	0.2500000
NODE_8973_length_896_cov_48.249686	397	477	10	26	80	0.3250000
NODE_8973_length_896_cov_48.249686	397	477	11	16	80	0.2000000
NODE_8973_length_896_cov_48.249686	397	477	12	18	80	0.2250000
NODE_8973_length_896_cov_48.249686	450	530	8	7	80	0.0875000
NODE_8973_length_896_cov_48.249686	450	530	10	42	80	0.5250000
NODE_8973_length_896_cov_48.249686	450	530	11	15	80	0.1875000
NODE_8973_length_896_cov_48.249686	450	530	12	16	80	0.2000000
NODE_8974_length_896_cov_24.824341	213	293	2	27	80	0.3375000
NODE_8974_length_896_cov_24.824341	213	293	3	18	80	0.2250000
NODE_8974_length_896_cov_24.824341	213	293	5	35	80	0.4375000
NODE_8974_length_896_cov_24.824341	266	346	5	47	80	0.5875000
NODE_8974_length_896_cov_24.824341	266	346	6	33	80	0.4125000
NODE_8975_length_896_cov_23.130489	333	413	1	12	80	0.1500000
NODE_8975_length_896_cov_23.130489	333	413	2	7	80	0.0875000
NODE_8975_length_896_cov_23.130489	333	413	3	16	80	0.2000000
NODE_8975_length_896_cov_23.130489	333	413	6	38	80	0.4750000
NODE_8975_length_896_cov_23.130489	333	413	7	1	80	0.0125000
NODE_8975_length_896_cov_23.130489	333	413	8	6	80	0.0750000
NODE_8975_length_896_cov_23.130489	386	466	6	20	80	0.2500000
NODE_8975_length_896_cov_23.130489	386	466	7	1	80	0.0125000
NODE_8975_length_896_cov_23.130489	386	466	8	9	80	0.1125000
NODE_8975_length_896_cov_23.130489	386	466	10	10	80	0.1250000
NODE_8975_length_896_cov_23.130489	386	466	11	40	80	0.5000000
NODE_8975_length_896_cov_23.130489	462	542	5	24	80	0.3000000
NODE_8975_length_896_cov_23.130489	462	542	6	10	80	0.1250000
NODE_8975_length_896_cov_23.130489	462	542	7	13	80	0.1625000
NODE_8975_length_896_cov_23.130489	462	542	9	6	80	0.0750000
NODE_8975_length_896_cov_23.130489	462	542	10	27	80	0.3375000
NODE_8975_length_896_cov_23.130489	515	595	3	9	80	0.1125000
NODE_8975_length_896_cov_23.130489	515	595	4	27	80	0.3375000
NODE_8975_length_896_cov_23.130489	515	595	5	41	80	0.5125000
NODE_8975_length_896_cov_23.130489	515	595	6	3	80	0.0375000
NODE_8976_length_896_cov_20.673777	361	441	3	21	80	0.2625000
NODE_8976_length_896_cov_20.673777	361	441	4	3	80	0.0375000
NODE_8976_length_896_cov_20.673777	361	441	5	56	80	0.7000000
NODE_8976_length_896_cov_20.673777	414	497	0	30	83	0.3614458
NODE_8976_length_896_cov_20.673777	414	497	1	4	83	0.0481928
NODE_8976_length_896_cov_20.673777	414	497	2	13	83	0.1566265
NODE_8976_length_896_cov_20.673777	414	497	3	30	83	0.3614458
NODE_8976_length_896_cov_20.673777	414	497	4	3	83	0.0361446
NODE_8976_length_896_cov_20.673777	414	497	5	3	83	0.0361446
NODE_8977_length_896_cov_18.979925	418	498	2	3	80	0.0375000
NODE_8977_length_896_cov_18.979925	418	498	3	9	80	0.1125000
NODE_8977_length_896_cov_18.979925	418	498	5	61	80	0.7625000
NODE_8977_length_896_cov_18.979925	418	498	6	7	80	0.0875000
NODE_8977_length_896_cov_18.979925	471	551	4	3	80	0.0375000
NODE_8977_length_896_cov_18.979925	471	551	5	64	80	0.8000000
NODE_8977_length_896_cov_18.979925	471	551	6	13	80	0.1625000
NODE_8978_length_896_cov_15.875784	340	420	3	58	80	0.7250000
NODE_8978_length_896_cov_15.875784	340	420	4	1	80	0.0125000
NODE_8978_length_896_cov_15.875784	340	420	5	21	80	0.2625000
NODE_8978_length_896_cov_15.875784	393	473	0	16	80	0.2000000
NODE_8978_length_896_cov_15.875784	393	473	3	64	80	0.8000000
NODE_8980_length_896_cov_10.646173	337	417	2	80	80	1.0000000
NODE_8980_length_896_cov_10.646173	390	470	1	34	80	0.4250000
NODE_8980_length_896_cov_10.646173	390	470	2	46	80	0.5750000
NODE_8981_length_896_cov_10.351317	327	407	5	19	80	0.2375000
NODE_8981_length_896_cov_10.351317	327	407	6	15	80	0.1875000
NODE_8981_length_896_cov_10.351317	327	407	7	45	80	0.5625000
NODE_8981_length_896_cov_10.351317	327	407	8	1	80	0.0125000
NODE_8981_length_896_cov_10.351317	380	460	3	1	80	0.0125000
NODE_8981_length_896_cov_10.351317	380	460	4	34	80	0.4250000
NODE_8981_length_896_cov_10.351317	380	460	6	18	80	0.2250000
NODE_8981_length_896_cov_10.351317	380	460	7	26	80	0.3250000
NODE_8981_length_896_cov_10.351317	380	460	8	1	80	0.0125000
NODE_8982_length_896_cov_9.754078	411	491	1	19	80	0.2375000
NODE_8982_length_896_cov_9.754078	411	491	2	61	80	0.7625000
NODE_8982_length_896_cov_9.754078	464	544	0	35	80	0.4375000
NODE_8982_length_896_cov_9.754078	464	544	1	37	80	0.4625000
NODE_8982_length_896_cov_9.754078	464	544	2	8	80	0.1000000
NODE_8983_length_896_cov_8.069009	340	422	3	15	82	0.1829268
NODE_8983_length_896_cov_8.069009	340	422	6	67	82	0.8170732
NODE_8983_length_896_cov_8.069009	395	475	3	68	80	0.8500000
NODE_8983_length_896_cov_8.069009	395	475	6	12	80	0.1500000
NODE_8986_length_896_cov_4.939774	384	464	0	80	80	1.0000000
NODE_8986_length_896_cov_4.939774	437	517	0	80	80	1.0000000
NODE_9005_length_895_cov_54.949749	378	458	19	5	80	0.0625000
NODE_9005_length_895_cov_54.949749	378	458	20	20	80	0.2500000
NODE_9005_length_895_cov_54.949749	378	458	21	46	80	0.5750000
NODE_9005_length_895_cov_54.949749	378	458	23	9	80	0.1125000
NODE_9005_length_895_cov_54.949749	431	511	16	4	80	0.0500000
NODE_9005_length_895_cov_54.949749	431	511	17	13	80	0.1625000
NODE_9005_length_895_cov_54.949749	431	511	18	4	80	0.0500000
NODE_9005_length_895_cov_54.949749	431	511	19	23	80	0.2875000
NODE_9005_length_895_cov_54.949749	431	511	20	10	80	0.1250000
NODE_9005_length_895_cov_54.949749	431	511	21	13	80	0.1625000
NODE_9005_length_895_cov_54.949749	431	511	22	2	80	0.0250000
NODE_9005_length_895_cov_54.949749	431	511	23	8	80	0.1000000
NODE_9005_length_895_cov_54.949749	431	511	24	3	80	0.0375000
NODE_9006_length_895_cov_53.945980	306	386	13	10	80	0.1250000
NODE_9006_length_895_cov_53.945980	306	386	14	21	80	0.2625000
NODE_9006_length_895_cov_53.945980	306	386	18	3	80	0.0375000
NODE_9006_length_895_cov_53.945980	306	386	19	1	80	0.0125000
NODE_9006_length_895_cov_53.945980	306	386	20	1	80	0.0125000
NODE_9006_length_895_cov_53.945980	306	386	21	6	80	0.0750000
NODE_9006_length_895_cov_53.945980	306	386	22	6	80	0.0750000
NODE_9006_length_895_cov_53.945980	306	386	24	2	80	0.0250000
NODE_9006_length_895_cov_53.945980	306	386	25	30	80	0.3750000
NODE_9006_length_895_cov_53.945980	359	439	23	4	80	0.0500000
NODE_9006_length_895_cov_53.945980	359	439	25	29	80	0.3625000
NODE_9006_length_895_cov_53.945980	359	439	26	10	80	0.1250000
NODE_9006_length_895_cov_53.945980	359	439	27	10	80	0.1250000
NODE_9006_length_895_cov_53.945980	359	439	29	2	80	0.0250000
NODE_9006_length_895_cov_53.945980	359	439	30	25	80	0.3125000
NODE_9007_length_895_cov_48.915829	369	449	8	17	80	0.2125000
NODE_9007_length_895_cov_48.915829	369	449	10	6	80	0.0750000
NODE_9007_length_895_cov_48.915829	369	449	11	44	80	0.5500000
NODE_9007_length_895_cov_48.915829	369	449	13	13	80	0.1625000
NODE_9007_length_895_cov_48.915829	422	502	8	26	80	0.3250000
NODE_9007_length_895_cov_48.915829	422	502	11	43	80	0.5375000
NODE_9007_length_895_cov_48.915829	422	502	13	11	80	0.1375000
NODE_9007_length_895_cov_48.915829	498	578	3	36	80	0.4500000
NODE_9007_length_895_cov_48.915829	498	578	4	25	80	0.3125000
NODE_9007_length_895_cov_48.915829	498	578	6	14	80	0.1750000
NODE_9007_length_895_cov_48.915829	498	578	8	5	80	0.0625000
NODE_9007_length_895_cov_48.915829	551	631	0	37	80	0.4625000
NODE_9007_length_895_cov_48.915829	551	631	3	43	80	0.5375000
NODE_9008_length_895_cov_38.347990	452	532	24	19	80	0.2375000
NODE_9008_length_895_cov_38.347990	452	532	25	25	80	0.3125000
NODE_9008_length_895_cov_38.347990	452	532	26	28	80	0.3500000
NODE_9008_length_895_cov_38.347990	452	532	27	5	80	0.0625000
NODE_9008_length_895_cov_38.347990	452	532	28	3	80	0.0375000
NODE_9008_length_895_cov_38.347990	505	585	17	4	80	0.0500000
NODE_9008_length_895_cov_38.347990	505	585	20	5	80	0.0625000
NODE_9008_length_895_cov_38.347990	505	585	22	8	80	0.1000000
NODE_9008_length_895_cov_38.347990	505	585	24	10	80	0.1250000
NODE_9008_length_895_cov_38.347990	505	585	25	19	80	0.2375000
NODE_9008_length_895_cov_38.347990	505	585	26	16	80	0.2000000
NODE_9008_length_895_cov_38.347990	505	585	27	5	80	0.0625000
NODE_9008_length_895_cov_38.347990	505	585	28	13	80	0.1625000
NODE_9009_length_895_cov_33.716080	418	499	0	53	81	0.6543210
NODE_9009_length_895_cov_33.716080	418	499	1	8	81	0.0987654
NODE_9009_length_895_cov_33.716080	418	499	2	20	81	0.2469136
NODE_9009_length_895_cov_33.716080	472	552	1	7	80	0.0875000
NODE_9009_length_895_cov_33.716080	472	552	2	73	80	0.9125000
NODE_9010_length_895_cov_21.630653	392	468	2	3	76	0.0394737
NODE_9010_length_895_cov_21.630653	392	468	3	1	76	0.0131579
NODE_9010_length_895_cov_21.630653	392	468	4	69	76	0.9078947
NODE_9010_length_895_cov_21.630653	392	468	6	3	76	0.0394737
NODE_9010_length_895_cov_21.630653	441	521	4	47	80	0.5875000
NODE_9010_length_895_cov_21.630653	441	521	6	33	80	0.4125000
NODE_9011_length_895_cov_19.932161	331	411	5	2	80	0.0250000
NODE_9011_length_895_cov_19.932161	331	411	6	67	80	0.8375000
NODE_9011_length_895_cov_19.932161	331	411	7	11	80	0.1375000
NODE_9011_length_895_cov_19.932161	384	464	6	58	80	0.7250000
NODE_9011_length_895_cov_19.932161	384	464	7	8	80	0.1000000
NODE_9011_length_895_cov_19.932161	384	464	8	2	80	0.0250000
NODE_9011_length_895_cov_19.932161	384	464	9	6	80	0.0750000
NODE_9011_length_895_cov_19.932161	384	464	11	6	80	0.0750000
NODE_9011_length_895_cov_19.932161	460	540	11	16	80	0.2000000
NODE_9011_length_895_cov_19.932161	460	540	12	18	80	0.2250000
NODE_9011_length_895_cov_19.932161	460	540	15	16	80	0.2000000
NODE_9011_length_895_cov_19.932161	460	540	16	30	80	0.3750000
NODE_9011_length_895_cov_19.932161	513	593	13	1	80	0.0125000
NODE_9011_length_895_cov_19.932161	513	593	14	20	80	0.2500000
NODE_9011_length_895_cov_19.932161	513	593	15	27	80	0.3375000
NODE_9011_length_895_cov_19.932161	513	593	16	32	80	0.4000000
NODE_9012_length_895_cov_16.037688	403	479	8	34	76	0.4473684
NODE_9012_length_895_cov_16.037688	403	479	9	1	76	0.0131579
NODE_9012_length_895_cov_16.037688	403	479	10	41	76	0.5394737
NODE_9012_length_895_cov_16.037688	452	532	5	3	80	0.0375000
NODE_9012_length_895_cov_16.037688	452	532	7	10	80	0.1250000
NODE_9012_length_895_cov_16.037688	452	532	8	40	80	0.5000000
NODE_9012_length_895_cov_16.037688	452	532	9	16	80	0.2000000
NODE_9012_length_895_cov_16.037688	452	532	10	11	80	0.1375000
NODE_9013_length_895_cov_13.003769	372	452	9	10	80	0.1250000
NODE_9013_length_895_cov_13.003769	372	452	10	3	80	0.0375000
NODE_9013_length_895_cov_13.003769	372	452	11	44	80	0.5500000
NODE_9013_length_895_cov_13.003769	372	452	12	1	80	0.0125000
NODE_9013_length_895_cov_13.003769	372	452	15	1	80	0.0125000
NODE_9013_length_895_cov_13.003769	372	452	17	1	80	0.0125000
NODE_9013_length_895_cov_13.003769	372	452	18	12	80	0.1500000
NODE_9013_length_895_cov_13.003769	372	452	19	8	80	0.1000000
NODE_9013_length_895_cov_13.003769	425	491	11	4	66	0.0606061
NODE_9013_length_895_cov_13.003769	425	491	12	1	66	0.0151515
NODE_9013_length_895_cov_13.003769	425	491	15	1	66	0.0151515
NODE_9013_length_895_cov_13.003769	425	491	17	1	66	0.0151515
NODE_9013_length_895_cov_13.003769	425	491	18	47	66	0.7121212
NODE_9013_length_895_cov_13.003769	425	491	19	12	66	0.1818182
NODE_9014_length_895_cov_12.736181	280	360	0	80	80	1.0000000
NODE_9014_length_895_cov_12.736181	333	413	0	80	80	1.0000000
NODE_9015_length_895_cov_11.090452	505	585	1	80	80	1.0000000
NODE_9015_length_895_cov_11.090452	558	638	0	52	80	0.6500000
NODE_9015_length_895_cov_11.090452	558	638	1	28	80	0.3500000
NODE_9016_length_895_cov_9.266332	468	548	6	22	80	0.2750000
NODE_9016_length_895_cov_9.266332	468	548	8	47	80	0.5875000
NODE_9016_length_895_cov_9.266332	468	548	10	11	80	0.1375000
NODE_9016_length_895_cov_9.266332	521	601	1	5	80	0.0625000
NODE_9016_length_895_cov_9.266332	521	601	2	1	80	0.0125000
NODE_9016_length_895_cov_9.266332	521	601	3	3	80	0.0375000
NODE_9016_length_895_cov_9.266332	521	601	4	9	80	0.1125000
NODE_9016_length_895_cov_9.266332	521	601	5	29	80	0.3625000
NODE_9016_length_895_cov_9.266332	521	601	6	28	80	0.3500000
NODE_9016_length_895_cov_9.266332	521	601	8	5	80	0.0625000
NODE_9018_length_895_cov_5.659548	472	552	0	1	80	0.0125000
NODE_9018_length_895_cov_5.659548	472	552	2	79	80	0.9875000
NODE_9018_length_895_cov_5.659548	525	605	0	54	80	0.6750000
NODE_9018_length_895_cov_5.659548	525	605	2	26	80	0.3250000
NODE_9019_length_895_cov_5.383166	42	123	0	81	81	1.0000000
NODE_9030_length_894_cov_60.153459	446	526	8	2	80	0.0250000
NODE_9030_length_894_cov_60.153459	446	526	9	9	80	0.1125000
NODE_9030_length_894_cov_60.153459	446	526	10	7	80	0.0875000
NODE_9030_length_894_cov_60.153459	446	526	11	6	80	0.0750000
NODE_9030_length_894_cov_60.153459	446	526	12	56	80	0.7000000
NODE_9030_length_894_cov_60.153459	499	579	7	26	80	0.3250000
NODE_9030_length_894_cov_60.153459	499	579	8	2	80	0.0250000
NODE_9030_length_894_cov_60.153459	499	579	9	33	80	0.4125000
NODE_9030_length_894_cov_60.153459	499	579	10	3	80	0.0375000
NODE_9030_length_894_cov_60.153459	499	579	11	6	80	0.0750000
NODE_9030_length_894_cov_60.153459	499	579	12	10	80	0.1250000
NODE_9031_length_894_cov_49.618868	373	453	1	15	80	0.1875000
NODE_9031_length_894_cov_49.618868	373	453	2	21	80	0.2625000
NODE_9031_length_894_cov_49.618868	373	453	3	44	80	0.5500000
NODE_9031_length_894_cov_49.618868	426	506	3	80	80	1.0000000
NODE_9032_length_894_cov_33.228931	459	539	27	4	80	0.0500000
NODE_9032_length_894_cov_33.228931	459	539	30	22	80	0.2750000
NODE_9032_length_894_cov_33.228931	459	539	31	6	80	0.0750000
NODE_9032_length_894_cov_33.228931	459	539	32	14	80	0.1750000
NODE_9032_length_894_cov_33.228931	459	539	33	3	80	0.0375000
NODE_9032_length_894_cov_33.228931	459	539	34	15	80	0.1875000
NODE_9032_length_894_cov_33.228931	459	539	35	4	80	0.0500000
NODE_9032_length_894_cov_33.228931	459	539	37	5	80	0.0625000
NODE_9032_length_894_cov_33.228931	459	539	38	7	80	0.0875000
NODE_9032_length_894_cov_33.228931	512	592	16	9	80	0.1125000
NODE_9032_length_894_cov_33.228931	512	592	17	18	80	0.2250000
NODE_9032_length_894_cov_33.228931	512	592	18	8	80	0.1000000
NODE_9032_length_894_cov_33.228931	512	592	19	1	80	0.0125000
NODE_9032_length_894_cov_33.228931	512	592	21	3	80	0.0375000
NODE_9032_length_894_cov_33.228931	512	592	22	8	80	0.1000000
NODE_9032_length_894_cov_33.228931	512	592	24	5	80	0.0625000
NODE_9032_length_894_cov_33.228931	512	592	27	5	80	0.0625000
NODE_9032_length_894_cov_33.228931	512	592	30	2	80	0.0250000
NODE_9032_length_894_cov_33.228931	512	592	32	10	80	0.1250000
NODE_9032_length_894_cov_33.228931	512	592	34	11	80	0.1375000
NODE_9033_length_894_cov_31.933333	411	491	7	10	80	0.1250000
NODE_9033_length_894_cov_31.933333	411	491	8	14	80	0.1750000
NODE_9033_length_894_cov_31.933333	411	491	11	52	80	0.6500000
NODE_9033_length_894_cov_31.933333	411	491	12	4	80	0.0500000
NODE_9033_length_894_cov_31.933333	464	544	3	10	80	0.1250000
NODE_9033_length_894_cov_31.933333	464	544	7	34	80	0.4250000
NODE_9033_length_894_cov_31.933333	464	544	8	14	80	0.1750000
NODE_9033_length_894_cov_31.933333	464	544	9	19	80	0.2375000
NODE_9033_length_894_cov_31.933333	464	544	12	3	80	0.0375000
NODE_9034_length_894_cov_30.499371	270	350	6	36	80	0.4500000
NODE_9034_length_894_cov_30.499371	270	350	7	14	80	0.1750000
NODE_9034_length_894_cov_30.499371	270	350	8	10	80	0.1250000
NODE_9034_length_894_cov_30.499371	270	350	9	20	80	0.2500000
NODE_9034_length_894_cov_30.499371	323	403	7	29	80	0.3625000
NODE_9034_length_894_cov_30.499371	323	403	8	23	80	0.2875000
NODE_9034_length_894_cov_30.499371	323	403	9	28	80	0.3500000
NODE_9034_length_894_cov_30.499371	399	479	4	5	80	0.0625000
NODE_9034_length_894_cov_30.499371	399	479	5	4	80	0.0500000
NODE_9034_length_894_cov_30.499371	399	479	6	9	80	0.1125000
NODE_9034_length_894_cov_30.499371	399	479	7	24	80	0.3000000
NODE_9034_length_894_cov_30.499371	399	479	8	35	80	0.4375000
NODE_9034_length_894_cov_30.499371	399	479	9	3	80	0.0375000
NODE_9034_length_894_cov_30.499371	452	532	3	16	80	0.2000000
NODE_9034_length_894_cov_30.499371	452	532	4	37	80	0.4625000
NODE_9034_length_894_cov_30.499371	452	532	5	9	80	0.1125000
NODE_9034_length_894_cov_30.499371	452	532	6	9	80	0.1125000
NODE_9034_length_894_cov_30.499371	452	532	7	9	80	0.1125000
NODE_9035_length_894_cov_23.046541	79	159	0	80	80	1.0000000
NODE_9035_length_894_cov_23.046541	132	212	0	80	80	1.0000000
NODE_9036_length_894_cov_22.266667	381	461	5	75	80	0.9375000
NODE_9036_length_894_cov_22.266667	381	461	6	5	80	0.0625000
NODE_9036_length_894_cov_22.266667	434	514	2	13	80	0.1625000
NODE_9036_length_894_cov_22.266667	434	514	3	16	80	0.2000000
NODE_9036_length_894_cov_22.266667	434	514	4	7	80	0.0875000
NODE_9036_length_894_cov_22.266667	434	514	5	35	80	0.4375000
NODE_9036_length_894_cov_22.266667	434	514	6	9	80	0.1125000
NODE_9037_length_894_cov_21.997484	332	412	5	22	80	0.2750000
NODE_9037_length_894_cov_21.997484	332	412	6	11	80	0.1375000
NODE_9037_length_894_cov_21.997484	332	412	7	35	80	0.4375000
NODE_9037_length_894_cov_21.997484	332	412	8	12	80	0.1500000
NODE_9037_length_894_cov_21.997484	385	465	6	12	80	0.1500000
NODE_9037_length_894_cov_21.997484	385	465	7	27	80	0.3375000
NODE_9037_length_894_cov_21.997484	385	465	8	41	80	0.5125000
NODE_9038_length_894_cov_21.205031	319	399	10	6	80	0.0750000
NODE_9038_length_894_cov_21.205031	319	399	11	2	80	0.0250000
NODE_9038_length_894_cov_21.205031	319	399	12	11	80	0.1375000
NODE_9038_length_894_cov_21.205031	319	399	13	24	80	0.3000000
NODE_9038_length_894_cov_21.205031	319	399	14	5	80	0.0625000
NODE_9038_length_894_cov_21.205031	319	399	15	11	80	0.1375000
NODE_9038_length_894_cov_21.205031	319	399	16	6	80	0.0750000
NODE_9038_length_894_cov_21.205031	319	399	17	2	80	0.0250000
NODE_9038_length_894_cov_21.205031	319	399	18	13	80	0.1625000
NODE_9038_length_894_cov_21.205031	372	452	5	10	80	0.1250000
NODE_9038_length_894_cov_21.205031	372	452	7	9	80	0.1125000
NODE_9038_length_894_cov_21.205031	372	452	8	2	80	0.0250000
NODE_9038_length_894_cov_21.205031	372	452	9	2	80	0.0250000
NODE_9038_length_894_cov_21.205031	372	452	10	36	80	0.4500000
NODE_9038_length_894_cov_21.205031	372	452	11	2	80	0.0250000
NODE_9038_length_894_cov_21.205031	372	452	12	6	80	0.0750000
NODE_9038_length_894_cov_21.205031	372	452	13	13	80	0.1625000
NODE_9038_length_894_cov_21.205031	448	528	4	14	80	0.1750000
NODE_9038_length_894_cov_21.205031	448	528	5	28	80	0.3500000
NODE_9038_length_894_cov_21.205031	448	528	6	1	80	0.0125000
NODE_9038_length_894_cov_21.205031	448	528	7	37	80	0.4625000
NODE_9038_length_894_cov_21.205031	501	581	3	16	80	0.2000000
NODE_9038_length_894_cov_21.205031	501	581	4	51	80	0.6375000
NODE_9038_length_894_cov_21.205031	501	581	5	13	80	0.1625000
NODE_9039_length_894_cov_21.132075	422	502	2	80	80	1.0000000
NODE_9039_length_894_cov_21.132075	475	555	0	23	80	0.2875000
NODE_9039_length_894_cov_21.132075	475	555	2	57	80	0.7125000
NODE_9040_length_894_cov_15.598742	338	418	6	4	80	0.0500000
NODE_9040_length_894_cov_15.598742	338	418	7	64	80	0.8000000
NODE_9040_length_894_cov_15.598742	338	418	8	7	80	0.0875000
NODE_9040_length_894_cov_15.598742	338	418	9	5	80	0.0625000
NODE_9040_length_894_cov_15.598742	391	471	4	12	80	0.1500000
NODE_9040_length_894_cov_15.598742	391	471	6	7	80	0.0875000
NODE_9040_length_894_cov_15.598742	391	471	7	38	80	0.4750000
NODE_9040_length_894_cov_15.598742	391	471	8	23	80	0.2875000
NODE_9041_length_894_cov_14.079245	344	424	2	3	80	0.0375000
NODE_9041_length_894_cov_14.079245	344	424	3	62	80	0.7750000
NODE_9041_length_894_cov_14.079245	344	424	4	15	80	0.1875000
NODE_9041_length_894_cov_14.079245	397	477	3	80	80	1.0000000
NODE_9042_length_894_cov_13.031447	336	416	3	1	80	0.0125000
NODE_9042_length_894_cov_13.031447	336	416	5	8	80	0.1000000
NODE_9042_length_894_cov_13.031447	336	416	6	6	80	0.0750000
NODE_9042_length_894_cov_13.031447	336	416	7	28	80	0.3500000
NODE_9042_length_894_cov_13.031447	336	416	8	20	80	0.2500000
NODE_9042_length_894_cov_13.031447	336	416	9	17	80	0.2125000
NODE_9042_length_894_cov_13.031447	389	469	7	2	80	0.0250000
NODE_9042_length_894_cov_13.031447	389	469	8	26	80	0.3250000
NODE_9042_length_894_cov_13.031447	389	469	9	52	80	0.6500000
NODE_9043_length_894_cov_13.031447	353	433	6	7	80	0.0875000
NODE_9043_length_894_cov_13.031447	353	433	7	53	80	0.6625000
NODE_9043_length_894_cov_13.031447	353	433	8	20	80	0.2500000
NODE_9043_length_894_cov_13.031447	406	486	4	3	80	0.0375000
NODE_9043_length_894_cov_13.031447	406	486	5	21	80	0.2625000
NODE_9043_length_894_cov_13.031447	406	486	6	20	80	0.2500000
NODE_9043_length_894_cov_13.031447	406	486	7	35	80	0.4375000
NODE_9043_length_894_cov_13.031447	406	486	8	1	80	0.0125000
NODE_9044_length_894_cov_9.706918	330	410	1	5	80	0.0625000
NODE_9044_length_894_cov_9.706918	330	410	2	75	80	0.9375000
NODE_9045_length_894_cov_6.963522	378	458	4	59	80	0.7375000
NODE_9045_length_894_cov_6.963522	378	458	5	16	80	0.2000000
NODE_9045_length_894_cov_6.963522	378	458	6	5	80	0.0625000
NODE_9045_length_894_cov_6.963522	431	511	4	40	80	0.5000000
NODE_9045_length_894_cov_6.963522	431	511	5	35	80	0.4375000
NODE_9045_length_894_cov_6.963522	431	511	6	5	80	0.0625000
NODE_9046_length_894_cov_4.993711	365	445	2	80	80	1.0000000
NODE_9046_length_894_cov_4.993711	418	498	1	41	80	0.5125000
NODE_9046_length_894_cov_4.993711	418	498	2	39	80	0.4875000
NODE_9066_length_893_cov_59.134761	261	341	4	29	80	0.3625000
NODE_9066_length_893_cov_59.134761	261	341	5	51	80	0.6375000
NODE_9066_length_893_cov_59.134761	314	394	1	8	80	0.1000000
NODE_9066_length_893_cov_59.134761	314	394	3	21	80	0.2625000
NODE_9066_length_893_cov_59.134761	314	394	4	47	80	0.5875000
NODE_9066_length_893_cov_59.134761	314	394	5	4	80	0.0500000
NODE_9067_length_893_cov_58.991184	388	468	2	21	80	0.2625000
NODE_9067_length_893_cov_58.991184	388	468	4	9	80	0.1125000
NODE_9067_length_893_cov_58.991184	388	468	8	6	80	0.0750000
NODE_9067_length_893_cov_58.991184	388	468	9	5	80	0.0625000
NODE_9067_length_893_cov_58.991184	388	468	10	20	80	0.2500000
NODE_9067_length_893_cov_58.991184	388	468	11	11	80	0.1375000
NODE_9067_length_893_cov_58.991184	388	468	12	5	80	0.0625000
NODE_9067_length_893_cov_58.991184	388	468	14	3	80	0.0375000
NODE_9067_length_893_cov_58.991184	441	521	10	8	80	0.1000000
NODE_9067_length_893_cov_58.991184	441	521	11	11	80	0.1375000
NODE_9067_length_893_cov_58.991184	441	521	12	5	80	0.0625000
NODE_9067_length_893_cov_58.991184	441	521	14	4	80	0.0500000
NODE_9067_length_893_cov_58.991184	441	521	15	21	80	0.2625000
NODE_9067_length_893_cov_58.991184	441	521	16	11	80	0.1375000
NODE_9067_length_893_cov_58.991184	441	521	18	1	80	0.0125000
NODE_9067_length_893_cov_58.991184	441	521	19	2	80	0.0250000
NODE_9067_length_893_cov_58.991184	441	521	21	2	80	0.0250000
NODE_9067_length_893_cov_58.991184	441	521	22	4	80	0.0500000
NODE_9067_length_893_cov_58.991184	441	521	23	4	80	0.0500000
NODE_9067_length_893_cov_58.991184	441	521	24	7	80	0.0875000
NODE_9067_length_893_cov_58.991184	517	597	19	18	80	0.2250000
NODE_9067_length_893_cov_58.991184	517	597	20	5	80	0.0625000
NODE_9067_length_893_cov_58.991184	517	597	21	6	80	0.0750000
NODE_9067_length_893_cov_58.991184	517	597	22	9	80	0.1125000
NODE_9067_length_893_cov_58.991184	517	597	23	19	80	0.2375000
NODE_9067_length_893_cov_58.991184	517	597	24	14	80	0.1750000
NODE_9067_length_893_cov_58.991184	517	597	25	9	80	0.1125000
NODE_9067_length_893_cov_58.991184	570	650	11	7	80	0.0875000
NODE_9067_length_893_cov_58.991184	570	650	14	3	80	0.0375000
NODE_9067_length_893_cov_58.991184	570	650	15	18	80	0.2250000
NODE_9067_length_893_cov_58.991184	570	650	16	4	80	0.0500000
NODE_9067_length_893_cov_58.991184	570	650	17	3	80	0.0375000
NODE_9067_length_893_cov_58.991184	570	650	18	5	80	0.0625000
NODE_9067_length_893_cov_58.991184	570	650	19	29	80	0.3625000
NODE_9067_length_893_cov_58.991184	570	650	20	7	80	0.0875000
NODE_9067_length_893_cov_58.991184	570	650	21	4	80	0.0500000
NODE_9068_length_893_cov_55.644836	434	514	10	7	80	0.0875000
NODE_9068_length_893_cov_55.644836	434	514	12	6	80	0.0750000
NODE_9068_length_893_cov_55.644836	434	514	13	3	80	0.0375000
NODE_9068_length_893_cov_55.644836	434	514	15	15	80	0.1875000
NODE_9068_length_893_cov_55.644836	434	514	16	27	80	0.3375000
NODE_9068_length_893_cov_55.644836	434	514	17	3	80	0.0375000
NODE_9068_length_893_cov_55.644836	434	514	18	5	80	0.0625000
NODE_9068_length_893_cov_55.644836	434	514	19	3	80	0.0375000
NODE_9068_length_893_cov_55.644836	434	514	21	2	80	0.0250000
NODE_9068_length_893_cov_55.644836	434	514	24	1	80	0.0125000
NODE_9068_length_893_cov_55.644836	434	514	25	1	80	0.0125000
NODE_9068_length_893_cov_55.644836	434	514	26	7	80	0.0875000
NODE_9068_length_893_cov_55.644836	487	567	16	5	80	0.0625000
NODE_9068_length_893_cov_55.644836	487	567	17	3	80	0.0375000
NODE_9068_length_893_cov_55.644836	487	567	18	5	80	0.0625000
NODE_9068_length_893_cov_55.644836	487	567	19	3	80	0.0375000
NODE_9068_length_893_cov_55.644836	487	567	21	2	80	0.0250000
NODE_9068_length_893_cov_55.644836	487	567	24	10	80	0.1250000
NODE_9068_length_893_cov_55.644836	487	567	25	1	80	0.0125000
NODE_9068_length_893_cov_55.644836	487	567	26	13	80	0.1625000
NODE_9068_length_893_cov_55.644836	487	567	27	20	80	0.2500000
NODE_9068_length_893_cov_55.644836	487	567	28	4	80	0.0500000
NODE_9068_length_893_cov_55.644836	487	567	29	12	80	0.1500000
NODE_9068_length_893_cov_55.644836	487	567	30	2	80	0.0250000
NODE_9068_length_893_cov_55.644836	563	643	17	32	80	0.4000000
NODE_9068_length_893_cov_55.644836	563	643	18	17	80	0.2125000
NODE_9068_length_893_cov_55.644836	563	643	20	2	80	0.0250000
NODE_9068_length_893_cov_55.644836	563	643	22	2	80	0.0250000
NODE_9068_length_893_cov_55.644836	563	643	23	9	80	0.1125000
NODE_9068_length_893_cov_55.644836	563	643	25	5	80	0.0625000
NODE_9068_length_893_cov_55.644836	563	643	29	13	80	0.1625000
NODE_9068_length_893_cov_55.644836	616	696	5	17	80	0.2125000
NODE_9068_length_893_cov_55.644836	616	696	8	22	80	0.2750000
NODE_9068_length_893_cov_55.644836	616	696	9	1	80	0.0125000
NODE_9068_length_893_cov_55.644836	616	696	10	1	80	0.0125000
NODE_9068_length_893_cov_55.644836	616	696	13	5	80	0.0625000
NODE_9068_length_893_cov_55.644836	616	696	14	5	80	0.0625000
NODE_9068_length_893_cov_55.644836	616	696	15	1	80	0.0125000
NODE_9068_length_893_cov_55.644836	616	696	17	24	80	0.3000000
NODE_9068_length_893_cov_55.644836	616	696	18	4	80	0.0500000
NODE_9069_length_893_cov_54.803526	479	559	4	65	80	0.8125000
NODE_9069_length_893_cov_54.803526	479	559	7	12	80	0.1500000
NODE_9069_length_893_cov_54.803526	479	559	8	3	80	0.0375000
NODE_9069_length_893_cov_54.803526	532	612	4	80	80	1.0000000
NODE_9070_length_893_cov_38.147355	391	471	0	80	80	1.0000000
NODE_9070_length_893_cov_38.147355	444	524	0	80	80	1.0000000
NODE_9071_length_893_cov_33.690176	387	467	3	15	80	0.1875000
NODE_9071_length_893_cov_33.690176	387	467	4	65	80	0.8125000
NODE_9071_length_893_cov_33.690176	440	520	2	7	80	0.0875000
NODE_9071_length_893_cov_33.690176	440	520	3	3	80	0.0375000
NODE_9071_length_893_cov_33.690176	440	520	4	70	80	0.8750000
NODE_9072_length_893_cov_32.162469	524	604	7	5	80	0.0625000
NODE_9072_length_893_cov_32.162469	524	604	8	5	80	0.0625000
NODE_9072_length_893_cov_32.162469	524	604	9	15	80	0.1875000
NODE_9072_length_893_cov_32.162469	524	604	11	23	80	0.2875000
NODE_9072_length_893_cov_32.162469	524	604	12	1	80	0.0125000
NODE_9072_length_893_cov_32.162469	524	604	13	31	80	0.3875000
NODE_9072_length_893_cov_32.162469	577	657	11	36	80	0.4500000
NODE_9072_length_893_cov_32.162469	577	657	12	2	80	0.0250000
NODE_9072_length_893_cov_32.162469	577	657	13	30	80	0.3750000
NODE_9072_length_893_cov_32.162469	577	657	15	12	80	0.1500000
NODE_9073_length_893_cov_31.916877	344	424	3	15	80	0.1875000
NODE_9073_length_893_cov_31.916877	344	424	4	65	80	0.8125000
NODE_9073_length_893_cov_31.916877	397	477	0	4	80	0.0500000
NODE_9073_length_893_cov_31.916877	397	477	1	29	80	0.3625000
NODE_9073_length_893_cov_31.916877	397	477	3	35	80	0.4375000
NODE_9073_length_893_cov_31.916877	397	477	4	12	80	0.1500000
NODE_9074_length_893_cov_28.693955	437	517	12	3	80	0.0375000
NODE_9074_length_893_cov_28.693955	437	517	13	31	80	0.3875000
NODE_9074_length_893_cov_28.693955	437	517	14	38	80	0.4750000
NODE_9074_length_893_cov_28.693955	437	517	15	8	80	0.1000000
NODE_9074_length_893_cov_28.693955	490	570	5	1	80	0.0125000
NODE_9074_length_893_cov_28.693955	490	570	6	9	80	0.1125000
NODE_9074_length_893_cov_28.693955	490	570	8	12	80	0.1500000
NODE_9074_length_893_cov_28.693955	490	570	9	5	80	0.0625000
NODE_9074_length_893_cov_28.693955	490	570	11	6	80	0.0750000
NODE_9074_length_893_cov_28.693955	490	570	12	20	80	0.2500000
NODE_9074_length_893_cov_28.693955	490	570	13	25	80	0.3125000
NODE_9074_length_893_cov_28.693955	490	570	14	2	80	0.0250000
NODE_9075_length_893_cov_23.564232	363	443	2	7	80	0.0875000
NODE_9075_length_893_cov_23.564232	363	443	3	28	80	0.3500000
NODE_9075_length_893_cov_23.564232	363	443	5	45	80	0.5625000
NODE_9075_length_893_cov_23.564232	416	496	0	38	80	0.4750000
NODE_9075_length_893_cov_23.564232	416	496	2	22	80	0.2750000
NODE_9075_length_893_cov_23.564232	416	496	3	20	80	0.2500000
NODE_9076_length_893_cov_22.633501	272	352	0	80	80	1.0000000
NODE_9076_length_893_cov_22.633501	272	352	0	80	80	1.0000000
NODE_9076_length_893_cov_22.633501	272	352	0	80	80	1.0000000
NODE_9076_length_893_cov_22.633501	325	405	0	80	80	1.0000000
NODE_9076_length_893_cov_22.633501	325	405	0	80	80	1.0000000
NODE_9076_length_893_cov_22.633501	325	405	0	80	80	1.0000000
NODE_9076_length_893_cov_22.633501	401	481	0	80	80	1.0000000
NODE_9076_length_893_cov_22.633501	454	534	0	80	80	1.0000000
NODE_9077_length_893_cov_22.403023	453	533	6	3	80	0.0375000
NODE_9077_length_893_cov_22.403023	453	533	7	4	80	0.0500000
NODE_9077_length_893_cov_22.403023	453	533	8	37	80	0.4625000
NODE_9077_length_893_cov_22.403023	453	533	9	2	80	0.0250000
NODE_9077_length_893_cov_22.403023	453	533	10	13	80	0.1625000
NODE_9077_length_893_cov_22.403023	453	533	11	7	80	0.0875000
NODE_9077_length_893_cov_22.403023	453	533	12	14	80	0.1750000
NODE_9077_length_893_cov_22.403023	506	586	3	28	80	0.3500000
NODE_9077_length_893_cov_22.403023	506	586	5	3	80	0.0375000
NODE_9077_length_893_cov_22.403023	506	586	6	25	80	0.3125000
NODE_9077_length_893_cov_22.403023	506	586	7	4	80	0.0500000
NODE_9077_length_893_cov_22.403023	506	586	8	20	80	0.2500000
NODE_9078_length_893_cov_19.423174	298	378	0	80	80	1.0000000
NODE_9078_length_893_cov_19.423174	351	431	0	63	80	0.7875000
NODE_9078_length_893_cov_19.423174	351	431	2	6	80	0.0750000
NODE_9078_length_893_cov_19.423174	351	431	3	11	80	0.1375000
NODE_9078_length_893_cov_19.423174	427	507	3	36	80	0.4500000
NODE_9078_length_893_cov_19.423174	427	507	4	19	80	0.2375000
NODE_9078_length_893_cov_19.423174	427	507	5	15	80	0.1875000
NODE_9078_length_893_cov_19.423174	427	507	6	10	80	0.1250000
NODE_9078_length_893_cov_19.423174	480	560	4	2	80	0.0250000
NODE_9078_length_893_cov_19.423174	480	560	5	25	80	0.3125000
NODE_9078_length_893_cov_19.423174	480	560	6	50	80	0.6250000
NODE_9078_length_893_cov_19.423174	480	560	7	3	80	0.0375000
NODE_9079_length_893_cov_19.389169	360	440	1	48	80	0.6000000
NODE_9079_length_893_cov_19.389169	360	440	2	32	80	0.4000000
NODE_9079_length_893_cov_19.389169	413	493	2	28	80	0.3500000
NODE_9079_length_893_cov_19.389169	413	493	3	10	80	0.1250000
NODE_9079_length_893_cov_19.389169	413	493	4	42	80	0.5250000
NODE_9079_length_893_cov_19.389169	489	569	3	11	80	0.1375000
NODE_9079_length_893_cov_19.389169	489	569	4	69	80	0.8625000
NODE_9079_length_893_cov_19.389169	542	622	1	50	80	0.6250000
NODE_9079_length_893_cov_19.389169	542	622	3	14	80	0.1750000
NODE_9079_length_893_cov_19.389169	542	622	4	16	80	0.2000000
NODE_9080_length_893_cov_18.152393	394	474	1	35	80	0.4375000
NODE_9080_length_893_cov_18.152393	394	474	3	19	80	0.2375000
NODE_9080_length_893_cov_18.152393	394	474	4	26	80	0.3250000
NODE_9080_length_893_cov_18.152393	447	527	3	1	80	0.0125000
NODE_9080_length_893_cov_18.152393	447	527	4	79	80	0.9875000
NODE_9081_length_893_cov_15.960957	442	522	2	4	80	0.0500000
NODE_9081_length_893_cov_15.960957	442	522	3	5	80	0.0625000
NODE_9081_length_893_cov_15.960957	442	522	4	61	80	0.7625000
NODE_9081_length_893_cov_15.960957	442	522	5	10	80	0.1250000
NODE_9081_length_893_cov_15.960957	495	575	3	37	80	0.4625000
NODE_9081_length_893_cov_15.960957	495	575	4	43	80	0.5375000
NODE_9082_length_893_cov_13.119647	473	553	0	80	80	1.0000000
NODE_9082_length_893_cov_13.119647	526	606	0	80	80	1.0000000
NODE_9084_length_893_cov_5.549118	353	415	2	54	62	0.8709677
NODE_9084_length_893_cov_5.549118	353	415	4	8	62	0.1290323
NODE_9100_length_893_cov_1.141058	28	108	0	80	80	1.0000000
NODE_9104_length_892_cov_74.968474	333	413	29	3	80	0.0375000
NODE_9104_length_892_cov_74.968474	333	413	30	1	80	0.0125000
NODE_9104_length_892_cov_74.968474	333	413	31	4	80	0.0500000
NODE_9104_length_892_cov_74.968474	333	413	33	6	80	0.0750000
NODE_9104_length_892_cov_74.968474	333	413	34	13	80	0.1625000
NODE_9104_length_892_cov_74.968474	333	413	35	14	80	0.1750000
NODE_9104_length_892_cov_74.968474	333	413	36	17	80	0.2125000
NODE_9104_length_892_cov_74.968474	333	413	37	5	80	0.0625000
NODE_9104_length_892_cov_74.968474	333	413	38	4	80	0.0500000
NODE_9104_length_892_cov_74.968474	333	413	40	9	80	0.1125000
NODE_9104_length_892_cov_74.968474	333	413	41	3	80	0.0375000
NODE_9104_length_892_cov_74.968474	333	413	42	1	80	0.0125000
NODE_9104_length_892_cov_74.968474	386	466	36	7	80	0.0875000
NODE_9104_length_892_cov_74.968474	386	466	37	5	80	0.0625000
NODE_9104_length_892_cov_74.968474	386	466	38	4	80	0.0500000
NODE_9104_length_892_cov_74.968474	386	466	40	12	80	0.1500000
NODE_9104_length_892_cov_74.968474	386	466	41	19	80	0.2375000
NODE_9104_length_892_cov_74.968474	386	466	42	1	80	0.0125000
NODE_9104_length_892_cov_74.968474	386	466	43	3	80	0.0375000
NODE_9104_length_892_cov_74.968474	386	466	44	12	80	0.1500000
NODE_9104_length_892_cov_74.968474	386	466	45	15	80	0.1875000
NODE_9104_length_892_cov_74.968474	386	466	46	2	80	0.0250000
NODE_9104_length_892_cov_74.968474	462	542	22	10	80	0.1250000
NODE_9104_length_892_cov_74.968474	462	542	23	3	80	0.0375000
NODE_9104_length_892_cov_74.968474	462	542	24	17	80	0.2125000
NODE_9104_length_892_cov_74.968474	462	542	25	15	80	0.1875000
NODE_9104_length_892_cov_74.968474	462	542	26	6	80	0.0750000
NODE_9104_length_892_cov_74.968474	462	542	28	4	80	0.0500000
NODE_9104_length_892_cov_74.968474	462	542	29	1	80	0.0125000
NODE_9104_length_892_cov_74.968474	462	542	30	7	80	0.0875000
NODE_9104_length_892_cov_74.968474	462	542	31	2	80	0.0250000
NODE_9104_length_892_cov_74.968474	462	542	33	2	80	0.0250000
NODE_9104_length_892_cov_74.968474	462	542	35	5	80	0.0625000
NODE_9104_length_892_cov_74.968474	462	542	36	1	80	0.0125000
NODE_9104_length_892_cov_74.968474	462	542	38	2	80	0.0250000
NODE_9104_length_892_cov_74.968474	462	542	40	3	80	0.0375000
NODE_9104_length_892_cov_74.968474	462	542	41	2	80	0.0250000
NODE_9104_length_892_cov_74.968474	515	595	10	4	80	0.0500000
NODE_9104_length_892_cov_74.968474	515	595	11	20	80	0.2500000
NODE_9104_length_892_cov_74.968474	515	595	12	6	80	0.0750000
NODE_9104_length_892_cov_74.968474	515	595	13	2	80	0.0250000
NODE_9104_length_892_cov_74.968474	515	595	15	2	80	0.0250000
NODE_9104_length_892_cov_74.968474	515	595	16	1	80	0.0125000
NODE_9104_length_892_cov_74.968474	515	595	17	10	80	0.1250000
NODE_9104_length_892_cov_74.968474	515	595	19	1	80	0.0125000
NODE_9104_length_892_cov_74.968474	515	595	20	1	80	0.0125000
NODE_9104_length_892_cov_74.968474	515	595	21	1	80	0.0125000
NODE_9104_length_892_cov_74.968474	515	595	22	15	80	0.1875000
NODE_9104_length_892_cov_74.968474	515	595	23	3	80	0.0375000
NODE_9104_length_892_cov_74.968474	515	595	24	12	80	0.1500000
NODE_9104_length_892_cov_74.968474	515	595	25	2	80	0.0250000
NODE_9105_length_892_cov_54.549811	463	550	9	1	87	0.0114943
NODE_9105_length_892_cov_54.549811	463	550	10	2	87	0.0229885
NODE_9105_length_892_cov_54.549811	463	550	12	23	87	0.2643678
NODE_9105_length_892_cov_54.549811	463	550	13	9	87	0.1034483
NODE_9105_length_892_cov_54.549811	463	550	14	13	87	0.1494253
NODE_9105_length_892_cov_54.549811	463	550	15	7	87	0.0804598
NODE_9105_length_892_cov_54.549811	463	550	16	15	87	0.1724138
NODE_9105_length_892_cov_54.549811	463	550	18	7	87	0.0804598
NODE_9105_length_892_cov_54.549811	463	550	19	10	87	0.1149425
NODE_9105_length_892_cov_54.549811	523	603	16	26	80	0.3250000
NODE_9105_length_892_cov_54.549811	523	603	17	37	80	0.4625000
NODE_9105_length_892_cov_54.549811	523	603	18	7	80	0.0875000
NODE_9105_length_892_cov_54.549811	523	603	19	10	80	0.1250000
NODE_9105_length_892_cov_54.549811	599	679	2	3	80	0.0375000
NODE_9105_length_892_cov_54.549811	599	679	4	8	80	0.1000000
NODE_9105_length_892_cov_54.549811	599	679	5	8	80	0.1000000
NODE_9105_length_892_cov_54.549811	599	679	9	16	80	0.2000000
NODE_9105_length_892_cov_54.549811	599	679	10	8	80	0.1000000
NODE_9105_length_892_cov_54.549811	599	679	11	12	80	0.1500000
NODE_9105_length_892_cov_54.549811	599	679	12	13	80	0.1625000
NODE_9105_length_892_cov_54.549811	599	679	17	12	80	0.1500000
NODE_9106_length_892_cov_37.887768	373	453	0	80	80	1.0000000
NODE_9106_length_892_cov_37.887768	426	506	0	80	80	1.0000000
NODE_9107_length_892_cov_19.732661	361	441	3	18	80	0.2250000
NODE_9107_length_892_cov_19.732661	361	441	4	1	80	0.0125000
NODE_9107_length_892_cov_19.732661	361	441	5	43	80	0.5375000
NODE_9107_length_892_cov_19.732661	361	441	6	18	80	0.2250000
NODE_9107_length_892_cov_19.732661	414	494	1	21	80	0.2625000
NODE_9107_length_892_cov_19.732661	414	494	2	10	80	0.1250000
NODE_9107_length_892_cov_19.732661	414	494	3	40	80	0.5000000
NODE_9107_length_892_cov_19.732661	414	494	4	1	80	0.0125000
NODE_9107_length_892_cov_19.732661	414	494	5	8	80	0.1000000
NODE_9108_length_892_cov_19.052963	290	370	1	15	80	0.1875000
NODE_9108_length_892_cov_19.052963	290	370	2	65	80	0.8125000
NODE_9108_length_892_cov_19.052963	343	423	1	6	80	0.0750000
NODE_9108_length_892_cov_19.052963	343	423	2	74	80	0.9250000
NODE_9108_length_892_cov_19.052963	419	499	0	44	80	0.5500000
NODE_9108_length_892_cov_19.052963	419	499	1	36	80	0.4500000
NODE_9108_length_892_cov_19.052963	472	552	0	80	80	1.0000000
NODE_9109_length_892_cov_17.276166	341	421	2	1	80	0.0125000
NODE_9109_length_892_cov_17.276166	341	421	3	18	80	0.2250000
NODE_9109_length_892_cov_17.276166	341	421	4	2	80	0.0250000
NODE_9109_length_892_cov_17.276166	341	421	6	59	80	0.7375000
NODE_9109_length_892_cov_17.276166	394	474	4	16	80	0.2000000
NODE_9109_length_892_cov_17.276166	394	474	5	23	80	0.2875000
NODE_9109_length_892_cov_17.276166	394	474	6	41	80	0.5125000
NODE_9110_length_892_cov_16.312736	411	491	6	13	80	0.1625000
NODE_9110_length_892_cov_16.312736	411	491	7	11	80	0.1375000
NODE_9110_length_892_cov_16.312736	411	491	8	56	80	0.7000000
NODE_9110_length_892_cov_16.312736	464	544	3	13	80	0.1625000
NODE_9110_length_892_cov_16.312736	464	544	4	3	80	0.0375000
NODE_9110_length_892_cov_16.312736	464	544	6	50	80	0.6250000
NODE_9110_length_892_cov_16.312736	464	544	8	14	80	0.1750000
NODE_9111_length_892_cov_15.808323	395	475	2	25	80	0.3125000
NODE_9111_length_892_cov_15.808323	395	475	3	1	80	0.0125000
NODE_9111_length_892_cov_15.808323	395	475	5	5	80	0.0625000
NODE_9111_length_892_cov_15.808323	395	475	6	49	80	0.6125000
NODE_9111_length_892_cov_15.808323	448	528	4	26	80	0.3250000
NODE_9111_length_892_cov_15.808323	448	528	5	29	80	0.3625000
NODE_9111_length_892_cov_15.808323	448	528	6	25	80	0.3125000
NODE_9112_length_892_cov_14.020177	522	602	4	40	80	0.5000000
NODE_9112_length_892_cov_14.020177	522	602	5	15	80	0.1875000
NODE_9112_length_892_cov_14.020177	522	602	6	25	80	0.3125000
NODE_9112_length_892_cov_14.020177	575	655	1	8	80	0.1000000
NODE_9112_length_892_cov_14.020177	575	655	3	25	80	0.3125000
NODE_9112_length_892_cov_14.020177	575	655	4	47	80	0.5875000
NODE_9114_length_892_cov_8.798235	400	480	2	22	80	0.2750000
NODE_9114_length_892_cov_8.798235	400	480	3	58	80	0.7250000
NODE_9114_length_892_cov_8.798235	453	533	3	49	80	0.6125000
NODE_9114_length_892_cov_8.798235	453	533	5	31	80	0.3875000
NODE_9115_length_892_cov_8.413619	428	508	0	80	80	1.0000000
NODE_9115_length_892_cov_8.413619	481	561	0	80	80	1.0000000
NODE_9116_length_892_cov_6.694830	374	454	0	9	80	0.1125000
NODE_9116_length_892_cov_6.694830	374	454	2	71	80	0.8875000
NODE_9116_length_892_cov_6.694830	427	507	0	62	80	0.7750000
NODE_9116_length_892_cov_6.694830	427	507	2	18	80	0.2250000
NODE_9134_length_891_cov_30.166667	295	375	5	11	80	0.1375000
NODE_9134_length_891_cov_30.166667	295	375	6	7	80	0.0875000
NODE_9134_length_891_cov_30.166667	295	375	7	19	80	0.2375000
NODE_9134_length_891_cov_30.166667	295	375	8	43	80	0.5375000
NODE_9134_length_891_cov_30.166667	348	428	4	16	80	0.2000000
NODE_9134_length_891_cov_30.166667	348	428	5	29	80	0.3625000
NODE_9134_length_891_cov_30.166667	348	428	6	13	80	0.1625000
NODE_9134_length_891_cov_30.166667	348	428	8	22	80	0.2750000
NODE_9135_length_891_cov_26.333333	319	399	20	3	80	0.0375000
NODE_9135_length_891_cov_26.333333	319	399	21	11	80	0.1375000
NODE_9135_length_891_cov_26.333333	319	399	22	9	80	0.1125000
NODE_9135_length_891_cov_26.333333	319	399	23	19	80	0.2375000
NODE_9135_length_891_cov_26.333333	319	399	24	11	80	0.1375000
NODE_9135_length_891_cov_26.333333	319	399	25	16	80	0.2000000
NODE_9135_length_891_cov_26.333333	319	399	26	11	80	0.1375000
NODE_9135_length_891_cov_26.333333	372	452	8	13	80	0.1625000
NODE_9135_length_891_cov_26.333333	372	452	9	5	80	0.0625000
NODE_9135_length_891_cov_26.333333	372	452	10	11	80	0.1375000
NODE_9135_length_891_cov_26.333333	372	452	11	4	80	0.0500000
NODE_9135_length_891_cov_26.333333	372	452	12	7	80	0.0875000
NODE_9135_length_891_cov_26.333333	372	452	13	4	80	0.0500000
NODE_9135_length_891_cov_26.333333	372	452	14	1	80	0.0125000
NODE_9135_length_891_cov_26.333333	372	452	18	7	80	0.0875000
NODE_9135_length_891_cov_26.333333	372	452	20	4	80	0.0500000
NODE_9135_length_891_cov_26.333333	372	452	21	7	80	0.0875000
NODE_9135_length_891_cov_26.333333	372	452	22	9	80	0.1125000
NODE_9135_length_891_cov_26.333333	372	452	24	2	80	0.0250000
NODE_9135_length_891_cov_26.333333	372	452	25	6	80	0.0750000
NODE_9136_length_891_cov_22.228535	336	416	5	66	80	0.8250000
NODE_9136_length_891_cov_22.228535	336	416	6	14	80	0.1750000
NODE_9136_length_891_cov_22.228535	389	469	3	1	80	0.0125000
NODE_9136_length_891_cov_22.228535	389	469	4	27	80	0.3375000
NODE_9136_length_891_cov_22.228535	389	469	5	47	80	0.5875000
NODE_9136_length_891_cov_22.228535	389	469	6	5	80	0.0625000
NODE_9137_length_891_cov_20.446970	377	457	8	27	80	0.3375000
NODE_9137_length_891_cov_20.446970	377	457	9	1	80	0.0125000
NODE_9137_length_891_cov_20.446970	377	457	10	52	80	0.6500000
NODE_9137_length_891_cov_20.446970	430	510	6	16	80	0.2000000
NODE_9137_length_891_cov_20.446970	430	510	8	18	80	0.2250000
NODE_9137_length_891_cov_20.446970	430	510	9	14	80	0.1750000
NODE_9137_length_891_cov_20.446970	430	510	10	32	80	0.4000000
NODE_9138_length_891_cov_20.226010	310	390	0	80	80	1.0000000
NODE_9138_length_891_cov_20.226010	363	443	0	80	80	1.0000000
NODE_9140_length_891_cov_13.207071	392	472	1	80	80	1.0000000
NODE_9140_length_891_cov_13.207071	445	525	1	68	80	0.8500000
NODE_9140_length_891_cov_13.207071	445	525	2	12	80	0.1500000
NODE_9141_length_891_cov_11.579545	379	459	4	9	80	0.1125000
NODE_9141_length_891_cov_11.579545	379	459	6	52	80	0.6500000
NODE_9141_length_891_cov_11.579545	379	459	7	19	80	0.2375000
NODE_9141_length_891_cov_11.579545	432	512	6	37	80	0.4625000
NODE_9141_length_891_cov_11.579545	432	512	7	43	80	0.5375000
NODE_9142_length_891_cov_11.117424	499	579	6	37	80	0.4625000
NODE_9142_length_891_cov_11.117424	499	579	7	43	80	0.5375000
NODE_9142_length_891_cov_11.117424	552	632	1	7	80	0.0875000
NODE_9142_length_891_cov_11.117424	552	632	2	20	80	0.2500000
NODE_9142_length_891_cov_11.117424	552	632	7	53	80	0.6625000
NODE_9153_length_890_cov_29.070796	284	364	7	14	80	0.1750000
NODE_9153_length_890_cov_29.070796	284	364	8	24	80	0.3000000
NODE_9153_length_890_cov_29.070796	284	364	9	42	80	0.5250000
NODE_9153_length_890_cov_29.070796	337	417	3	3	80	0.0375000
NODE_9153_length_890_cov_29.070796	337	417	4	38	80	0.4750000
NODE_9153_length_890_cov_29.070796	337	417	7	3	80	0.0375000
NODE_9153_length_890_cov_29.070796	337	417	8	33	80	0.4125000
NODE_9153_length_890_cov_29.070796	337	417	9	3	80	0.0375000
NODE_9153_length_890_cov_29.070796	413	497	2	49	84	0.5833333
NODE_9153_length_890_cov_29.070796	413	497	4	24	84	0.2857143
NODE_9153_length_890_cov_29.070796	413	497	5	11	84	0.1309524
NODE_9153_length_890_cov_29.070796	470	550	2	80	80	1.0000000
NODE_9154_length_890_cov_27.295828	550	630	6	3	80	0.0375000
NODE_9154_length_890_cov_27.295828	550	630	7	2	80	0.0250000
NODE_9154_length_890_cov_27.295828	550	630	9	61	80	0.7625000
NODE_9154_length_890_cov_27.295828	550	630	10	14	80	0.1750000
NODE_9154_length_890_cov_27.295828	603	683	9	29	80	0.3625000
NODE_9154_length_890_cov_27.295828	603	683	10	16	80	0.2000000
NODE_9154_length_890_cov_27.295828	603	683	11	15	80	0.1875000
NODE_9154_length_890_cov_27.295828	603	683	12	20	80	0.2500000
NODE_9155_length_890_cov_18.088496	80	135	1	15	55	0.2727273
NODE_9155_length_890_cov_18.088496	80	135	3	40	55	0.7272727
NODE_9155_length_890_cov_18.088496	276	356	11	2	80	0.0250000
NODE_9155_length_890_cov_18.088496	276	356	15	17	80	0.2125000
NODE_9155_length_890_cov_18.088496	276	356	16	3	80	0.0375000
NODE_9155_length_890_cov_18.088496	276	356	17	15	80	0.1875000
NODE_9155_length_890_cov_18.088496	276	356	18	38	80	0.4750000
NODE_9155_length_890_cov_18.088496	276	356	19	5	80	0.0625000
NODE_9155_length_890_cov_18.088496	329	406	11	7	77	0.0909091
NODE_9155_length_890_cov_18.088496	329	406	12	1	77	0.0129870
NODE_9155_length_890_cov_18.088496	329	406	13	4	77	0.0519481
NODE_9155_length_890_cov_18.088496	329	406	15	1	77	0.0129870
NODE_9155_length_890_cov_18.088496	329	406	17	49	77	0.6363636
NODE_9155_length_890_cov_18.088496	329	406	18	15	77	0.1948052
NODE_9156_length_890_cov_16.831858	402	482	5	1	80	0.0125000
NODE_9156_length_890_cov_16.831858	402	482	6	11	80	0.1375000
NODE_9156_length_890_cov_16.831858	402	482	8	68	80	0.8500000
NODE_9156_length_890_cov_16.831858	455	535	4	1	80	0.0125000
NODE_9156_length_890_cov_16.831858	455	535	5	33	80	0.4125000
NODE_9156_length_890_cov_16.831858	455	535	6	31	80	0.3875000
NODE_9156_length_890_cov_16.831858	455	535	8	15	80	0.1875000
NODE_9157_length_890_cov_11.881163	222	302	4	1	80	0.0125000
NODE_9157_length_890_cov_11.881163	222	302	6	79	80	0.9875000
NODE_9157_length_890_cov_11.881163	275	355	4	13	80	0.1625000
NODE_9157_length_890_cov_11.881163	275	355	5	39	80	0.4875000
NODE_9157_length_890_cov_11.881163	275	355	6	28	80	0.3500000
NODE_9158_length_890_cov_8.676359	335	415	0	80	80	1.0000000
NODE_9158_length_890_cov_8.676359	388	468	0	80	80	1.0000000
NODE_9183_length_889_cov_61.520253	334	414	6	9	80	0.1125000
NODE_9183_length_889_cov_61.520253	334	414	17	25	80	0.3125000
NODE_9183_length_889_cov_61.520253	334	414	19	10	80	0.1250000
NODE_9183_length_889_cov_61.520253	334	414	20	32	80	0.4000000
NODE_9183_length_889_cov_61.520253	334	414	21	1	80	0.0125000
NODE_9183_length_889_cov_61.520253	334	414	22	3	80	0.0375000
NODE_9183_length_889_cov_61.520253	387	467	20	23	80	0.2875000
NODE_9183_length_889_cov_61.520253	387	467	21	10	80	0.1250000
NODE_9183_length_889_cov_61.520253	387	467	22	27	80	0.3375000
NODE_9183_length_889_cov_61.520253	387	467	23	4	80	0.0500000
NODE_9183_length_889_cov_61.520253	387	467	27	6	80	0.0750000
NODE_9183_length_889_cov_61.520253	387	467	28	10	80	0.1250000
NODE_9183_length_889_cov_61.520253	463	543	9	1	80	0.0125000
NODE_9183_length_889_cov_61.520253	463	543	11	14	80	0.1750000
NODE_9183_length_889_cov_61.520253	463	543	12	10	80	0.1250000
NODE_9183_length_889_cov_61.520253	463	543	14	25	80	0.3125000
NODE_9183_length_889_cov_61.520253	463	543	25	17	80	0.2125000
NODE_9183_length_889_cov_61.520253	463	543	27	13	80	0.1625000
NODE_9183_length_889_cov_61.520253	516	596	6	6	80	0.0750000
NODE_9183_length_889_cov_61.520253	516	596	7	17	80	0.2125000
NODE_9183_length_889_cov_61.520253	516	596	8	10	80	0.1250000
NODE_9183_length_889_cov_61.520253	516	596	9	21	80	0.2625000
NODE_9183_length_889_cov_61.520253	516	596	11	14	80	0.1750000
NODE_9183_length_889_cov_61.520253	516	596	12	10	80	0.1250000
NODE_9183_length_889_cov_61.520253	516	596	14	2	80	0.0250000
NODE_9184_length_889_cov_30.012658	311	391	6	3	80	0.0375000
NODE_9184_length_889_cov_30.012658	311	391	7	17	80	0.2125000
NODE_9184_length_889_cov_30.012658	311	391	8	24	80	0.3000000
NODE_9184_length_889_cov_30.012658	311	391	9	9	80	0.1125000
NODE_9184_length_889_cov_30.012658	311	391	10	22	80	0.2750000
NODE_9184_length_889_cov_30.012658	311	391	11	5	80	0.0625000
NODE_9184_length_889_cov_30.012658	364	444	8	23	80	0.2875000
NODE_9184_length_889_cov_30.012658	364	444	9	3	80	0.0375000
NODE_9184_length_889_cov_30.012658	364	444	10	31	80	0.3875000
NODE_9184_length_889_cov_30.012658	364	444	11	23	80	0.2875000
NODE_9185_length_889_cov_28.217722	413	483	5	2	70	0.0285714
NODE_9185_length_889_cov_28.217722	413	483	8	10	70	0.1428571
NODE_9185_length_889_cov_28.217722	413	483	9	58	70	0.8285714
NODE_9185_length_889_cov_28.217722	466	542	2	14	76	0.1842105
NODE_9185_length_889_cov_28.217722	466	542	3	12	76	0.1578947
NODE_9185_length_889_cov_28.217722	466	542	4	15	76	0.1973684
NODE_9185_length_889_cov_28.217722	466	542	5	20	76	0.2631579
NODE_9185_length_889_cov_28.217722	466	542	8	1	76	0.0131579
NODE_9185_length_889_cov_28.217722	466	542	9	14	76	0.1842105
NODE_9186_length_889_cov_27.924051	379	449	8	27	70	0.3857143
NODE_9186_length_889_cov_27.924051	379	449	10	2	70	0.0285714
NODE_9186_length_889_cov_27.924051	379	449	11	19	70	0.2714286
NODE_9186_length_889_cov_27.924051	379	449	12	22	70	0.3142857
NODE_9186_length_889_cov_27.924051	432	512	10	1	80	0.0125000
NODE_9186_length_889_cov_27.924051	432	512	11	65	80	0.8125000
NODE_9186_length_889_cov_27.924051	432	512	12	10	80	0.1250000
NODE_9186_length_889_cov_27.924051	432	512	13	4	80	0.0500000
NODE_9187_length_889_cov_25.887342	227	285	16	21	58	0.3620690
NODE_9187_length_889_cov_25.887342	227	285	19	1	58	0.0172414
NODE_9187_length_889_cov_25.887342	227	285	20	2	58	0.0344828
NODE_9187_length_889_cov_25.887342	227	285	21	2	58	0.0344828
NODE_9187_length_889_cov_25.887342	227	285	23	6	58	0.1034483
NODE_9187_length_889_cov_25.887342	227	285	24	1	58	0.0172414
NODE_9187_length_889_cov_25.887342	227	285	25	13	58	0.2241379
NODE_9187_length_889_cov_25.887342	227	285	27	5	58	0.0862069
NODE_9187_length_889_cov_25.887342	227	285	28	7	58	0.1206897
NODE_9187_length_889_cov_25.887342	258	337	13	4	79	0.0506329
NODE_9187_length_889_cov_25.887342	258	337	16	4	79	0.0506329
NODE_9187_length_889_cov_25.887342	258	337	17	4	79	0.0506329
NODE_9187_length_889_cov_25.887342	258	337	19	1	79	0.0126582
NODE_9187_length_889_cov_25.887342	258	337	20	14	79	0.1772152
NODE_9187_length_889_cov_25.887342	258	337	22	7	79	0.0886076
NODE_9187_length_889_cov_25.887342	258	337	23	9	79	0.1139240
NODE_9187_length_889_cov_25.887342	258	337	24	11	79	0.1392405
NODE_9187_length_889_cov_25.887342	258	337	25	13	79	0.1645570
NODE_9187_length_889_cov_25.887342	258	337	27	5	79	0.0632911
NODE_9187_length_889_cov_25.887342	258	337	28	7	79	0.0886076
NODE_9188_length_889_cov_22.992405	451	531	4	14	80	0.1750000
NODE_9188_length_889_cov_22.992405	451	531	6	49	80	0.6125000
NODE_9188_length_889_cov_22.992405	451	531	7	6	80	0.0750000
NODE_9188_length_889_cov_22.992405	451	531	8	11	80	0.1375000
NODE_9188_length_889_cov_22.992405	504	584	4	35	80	0.4375000
NODE_9188_length_889_cov_22.992405	504	584	6	20	80	0.2500000
NODE_9188_length_889_cov_22.992405	504	584	7	17	80	0.2125000
NODE_9188_length_889_cov_22.992405	504	584	8	8	80	0.1000000
NODE_9189_length_889_cov_20.703797	331	411	5	3	80	0.0375000
NODE_9189_length_889_cov_20.703797	331	411	6	70	80	0.8750000
NODE_9189_length_889_cov_20.703797	331	411	7	1	80	0.0125000
NODE_9189_length_889_cov_20.703797	331	411	8	6	80	0.0750000
NODE_9189_length_889_cov_20.703797	384	464	5	1	80	0.0125000
NODE_9189_length_889_cov_20.703797	384	464	6	48	80	0.6000000
NODE_9189_length_889_cov_20.703797	384	464	7	6	80	0.0750000
NODE_9189_length_889_cov_20.703797	384	464	8	25	80	0.3125000
NODE_9190_length_889_cov_20.226582	234	314	3	20	80	0.2500000
NODE_9190_length_889_cov_20.226582	234	314	4	11	80	0.1375000
NODE_9190_length_889_cov_20.226582	234	314	5	49	80	0.6125000
NODE_9190_length_889_cov_20.226582	287	367	2	3	80	0.0375000
NODE_9190_length_889_cov_20.226582	287	367	3	6	80	0.0750000
NODE_9190_length_889_cov_20.226582	287	367	4	19	80	0.2375000
NODE_9190_length_889_cov_20.226582	287	367	5	52	80	0.6500000
NODE_9191_length_889_cov_15.587342	407	487	2	13	80	0.1625000
NODE_9191_length_889_cov_15.587342	407	487	3	67	80	0.8375000
NODE_9191_length_889_cov_15.587342	460	540	1	36	80	0.4500000
NODE_9191_length_889_cov_15.587342	460	540	2	30	80	0.3750000
NODE_9191_length_889_cov_15.587342	460	540	3	14	80	0.1750000
NODE_9192_length_889_cov_12.669620	313	393	0	80	80	1.0000000
NODE_9192_length_889_cov_12.669620	366	446	0	80	80	1.0000000
NODE_9193_length_889_cov_12.198734	399	479	2	25	80	0.3125000
NODE_9193_length_889_cov_12.198734	399	479	3	47	80	0.5875000
NODE_9193_length_889_cov_12.198734	399	479	5	8	80	0.1000000
NODE_9193_length_889_cov_12.198734	452	532	3	19	80	0.2375000
NODE_9193_length_889_cov_12.198734	452	532	4	3	80	0.0375000
NODE_9193_length_889_cov_12.198734	452	532	5	29	80	0.3625000
NODE_9193_length_889_cov_12.198734	452	532	6	29	80	0.3625000
NODE_9197_length_889_cov_3.841772	187	267	0	80	80	1.0000000
NODE_9197_length_889_cov_3.841772	240	320	0	80	80	1.0000000
NODE_9213_length_888_cov_37.102662	490	570	20	11	80	0.1375000
NODE_9213_length_888_cov_37.102662	490	570	21	19	80	0.2375000
NODE_9213_length_888_cov_37.102662	490	570	22	11	80	0.1375000
NODE_9213_length_888_cov_37.102662	490	570	23	18	80	0.2250000
NODE_9213_length_888_cov_37.102662	490	570	24	11	80	0.1375000
NODE_9213_length_888_cov_37.102662	490	570	25	10	80	0.1250000
NODE_9213_length_888_cov_37.102662	543	623	11	6	80	0.0750000
NODE_9213_length_888_cov_37.102662	543	623	13	4	80	0.0500000
NODE_9213_length_888_cov_37.102662	543	623	15	2	80	0.0250000
NODE_9213_length_888_cov_37.102662	543	623	17	13	80	0.1625000
NODE_9213_length_888_cov_37.102662	543	623	19	22	80	0.2750000
NODE_9213_length_888_cov_37.102662	543	623	21	7	80	0.0875000
NODE_9213_length_888_cov_37.102662	543	623	22	3	80	0.0375000
NODE_9213_length_888_cov_37.102662	543	623	23	18	80	0.2250000
NODE_9213_length_888_cov_37.102662	543	623	24	5	80	0.0625000
NODE_9214_length_888_cov_28.230672	366	446	3	4	80	0.0500000
NODE_9214_length_888_cov_28.230672	366	446	4	51	80	0.6375000
NODE_9214_length_888_cov_28.230672	366	446	5	7	80	0.0875000
NODE_9214_length_888_cov_28.230672	366	446	6	18	80	0.2250000
NODE_9214_length_888_cov_28.230672	419	499	4	7	80	0.0875000
NODE_9214_length_888_cov_28.230672	419	499	5	17	80	0.2125000
NODE_9214_length_888_cov_28.230672	419	499	6	56	80	0.7000000
NODE_9215_length_888_cov_25.243346	391	471	27	1	80	0.0125000
NODE_9215_length_888_cov_25.243346	391	471	30	21	80	0.2625000
NODE_9215_length_888_cov_25.243346	391	471	33	12	80	0.1500000
NODE_9215_length_888_cov_25.243346	391	471	34	8	80	0.1000000
NODE_9215_length_888_cov_25.243346	391	471	35	10	80	0.1250000
NODE_9215_length_888_cov_25.243346	391	471	38	1	80	0.0125000
NODE_9215_length_888_cov_25.243346	391	471	40	13	80	0.1625000
NODE_9215_length_888_cov_25.243346	391	471	41	2	80	0.0250000
NODE_9215_length_888_cov_25.243346	391	471	45	4	80	0.0500000
NODE_9215_length_888_cov_25.243346	391	471	47	1	80	0.0125000
NODE_9215_length_888_cov_25.243346	391	471	48	2	80	0.0250000
NODE_9215_length_888_cov_25.243346	391	471	51	1	80	0.0125000
NODE_9215_length_888_cov_25.243346	391	471	52	2	80	0.0250000
NODE_9215_length_888_cov_25.243346	391	471	53	1	80	0.0125000
NODE_9215_length_888_cov_25.243346	391	471	54	1	80	0.0125000
NODE_9215_length_888_cov_25.243346	444	524	40	13	80	0.1625000
NODE_9215_length_888_cov_25.243346	444	524	41	2	80	0.0250000
NODE_9215_length_888_cov_25.243346	444	524	45	4	80	0.0500000
NODE_9215_length_888_cov_25.243346	444	524	47	1	80	0.0125000
NODE_9215_length_888_cov_25.243346	444	524	48	2	80	0.0250000
NODE_9215_length_888_cov_25.243346	444	524	51	1	80	0.0125000
NODE_9215_length_888_cov_25.243346	444	524	52	3	80	0.0375000
NODE_9215_length_888_cov_25.243346	444	524	53	5	80	0.0625000
NODE_9215_length_888_cov_25.243346	444	524	54	24	80	0.3000000
NODE_9215_length_888_cov_25.243346	444	524	55	13	80	0.1625000
NODE_9215_length_888_cov_25.243346	444	524	57	2	80	0.0250000
NODE_9215_length_888_cov_25.243346	444	524	62	5	80	0.0625000
NODE_9215_length_888_cov_25.243346	444	524	63	3	80	0.0375000
NODE_9215_length_888_cov_25.243346	444	524	64	2	80	0.0250000
NODE_9216_length_888_cov_21.045627	236	316	6	7	80	0.0875000
NODE_9216_length_888_cov_21.045627	236	316	7	19	80	0.2375000
NODE_9216_length_888_cov_21.045627	236	316	8	39	80	0.4875000
NODE_9216_length_888_cov_21.045627	236	316	9	6	80	0.0750000
NODE_9216_length_888_cov_21.045627	236	316	10	9	80	0.1125000
NODE_9216_length_888_cov_21.045627	289	367	2	6	78	0.0769231
NODE_9216_length_888_cov_21.045627	289	367	3	4	78	0.0512821
NODE_9216_length_888_cov_21.045627	289	367	5	32	78	0.4102564
NODE_9216_length_888_cov_21.045627	289	367	6	16	78	0.2051282
NODE_9216_length_888_cov_21.045627	289	367	7	16	78	0.2051282
NODE_9216_length_888_cov_21.045627	289	367	8	4	78	0.0512821
NODE_9218_length_888_cov_13.447402	515	595	9	70	80	0.8750000
NODE_9218_length_888_cov_13.447402	515	595	10	10	80	0.1250000
NODE_9218_length_888_cov_13.447402	568	648	0	37	80	0.4625000
NODE_9218_length_888_cov_13.447402	568	648	1	1	80	0.0125000
NODE_9218_length_888_cov_13.447402	568	648	7	5	80	0.0625000
NODE_9218_length_888_cov_13.447402	568	648	9	37	80	0.4625000
NODE_9219_length_888_cov_12.806084	179	259	0	48	80	0.6000000
NODE_9219_length_888_cov_12.806084	179	259	1	32	80	0.4000000
NODE_9219_length_888_cov_12.806084	232	312	1	80	80	1.0000000
NODE_9219_length_888_cov_12.806084	308	388	1	21	80	0.2625000
NODE_9219_length_888_cov_12.806084	308	388	4	10	80	0.1250000
NODE_9219_length_888_cov_12.806084	308	388	5	49	80	0.6125000
NODE_9219_length_888_cov_12.806084	361	441	4	60	80	0.7500000
NODE_9219_length_888_cov_12.806084	361	441	5	20	80	0.2500000
NODE_9220_length_888_cov_12.551331	365	445	3	21	80	0.2625000
NODE_9220_length_888_cov_12.551331	365	445	4	42	80	0.5250000
NODE_9220_length_888_cov_12.551331	365	445	5	17	80	0.2125000
NODE_9220_length_888_cov_12.551331	418	498	3	45	80	0.5625000
NODE_9220_length_888_cov_12.551331	418	498	4	29	80	0.3625000
NODE_9220_length_888_cov_12.551331	418	498	5	6	80	0.0750000
NODE_9228_length_888_cov_2.041825	42	102	0	60	60	1.0000000
NODE_9237_length_887_cov_32.927665	514	594	24	18	80	0.2250000
NODE_9237_length_887_cov_32.927665	514	594	26	18	80	0.2250000
NODE_9237_length_887_cov_32.927665	514	594	27	1	80	0.0125000
NODE_9237_length_887_cov_32.927665	514	594	28	1	80	0.0125000
NODE_9237_length_887_cov_32.927665	514	594	29	17	80	0.2125000
NODE_9237_length_887_cov_32.927665	514	594	30	25	80	0.3125000
NODE_9237_length_887_cov_32.927665	567	647	3	7	80	0.0875000
NODE_9237_length_887_cov_32.927665	567	647	15	5	80	0.0625000
NODE_9237_length_887_cov_32.927665	567	647	17	12	80	0.1500000
NODE_9237_length_887_cov_32.927665	567	647	23	6	80	0.0750000
NODE_9237_length_887_cov_32.927665	567	647	24	31	80	0.3875000
NODE_9237_length_887_cov_32.927665	567	647	26	19	80	0.2375000
NODE_9238_length_887_cov_26.920051	358	438	4	24	80	0.3000000
NODE_9238_length_887_cov_26.920051	358	438	15	5	80	0.0625000
NODE_9238_length_887_cov_26.920051	358	438	29	51	80	0.6375000
NODE_9238_length_887_cov_26.920051	411	491	25	42	80	0.5250000
NODE_9238_length_887_cov_26.920051	411	491	27	6	80	0.0750000
NODE_9238_length_887_cov_26.920051	411	491	29	32	80	0.4000000
NODE_9239_length_887_cov_20.714467	304	384	2	50	80	0.6250000
NODE_9239_length_887_cov_20.714467	304	384	3	26	80	0.3250000
NODE_9239_length_887_cov_20.714467	304	384	5	4	80	0.0500000
NODE_9239_length_887_cov_20.714467	357	433	3	23	76	0.3026316
NODE_9239_length_887_cov_20.714467	357	433	5	53	76	0.6973684
NODE_9240_length_887_cov_19.771574	407	487	11	4	80	0.0500000
NODE_9240_length_887_cov_19.771574	407	487	12	3	80	0.0375000
NODE_9240_length_887_cov_19.771574	407	487	13	3	80	0.0375000
NODE_9240_length_887_cov_19.771574	407	487	14	19	80	0.2375000
NODE_9240_length_887_cov_19.771574	407	487	15	39	80	0.4875000
NODE_9240_length_887_cov_19.771574	407	487	16	12	80	0.1500000
NODE_9240_length_887_cov_19.771574	460	540	7	7	80	0.0875000
NODE_9240_length_887_cov_19.771574	460	540	8	3	80	0.0375000
NODE_9240_length_887_cov_19.771574	460	540	10	6	80	0.0750000
NODE_9240_length_887_cov_19.771574	460	540	12	3	80	0.0375000
NODE_9240_length_887_cov_19.771574	460	540	14	1	80	0.0125000
NODE_9240_length_887_cov_19.771574	460	540	15	60	80	0.7500000
NODE_9241_length_887_cov_14.535533	333	413	1	77	80	0.9625000
NODE_9241_length_887_cov_14.535533	333	413	2	3	80	0.0375000
NODE_9241_length_887_cov_14.535533	386	466	1	80	80	1.0000000
NODE_9242_length_887_cov_14.114213	345	425	3	11	80	0.1375000
NODE_9242_length_887_cov_14.114213	345	425	4	38	80	0.4750000
NODE_9242_length_887_cov_14.114213	345	425	5	19	80	0.2375000
NODE_9242_length_887_cov_14.114213	345	425	6	12	80	0.1500000
NODE_9242_length_887_cov_14.114213	398	478	3	64	80	0.8000000
NODE_9242_length_887_cov_14.114213	398	478	5	6	80	0.0750000
NODE_9242_length_887_cov_14.114213	398	478	6	10	80	0.1250000
NODE_9243_length_887_cov_9.451777	406	486	3	11	80	0.1375000
NODE_9243_length_887_cov_9.451777	406	486	4	32	80	0.4000000
NODE_9243_length_887_cov_9.451777	406	486	8	3	80	0.0375000
NODE_9243_length_887_cov_9.451777	406	486	9	5	80	0.0625000
NODE_9243_length_887_cov_9.451777	406	486	11	15	80	0.1875000
NODE_9243_length_887_cov_9.451777	406	486	12	14	80	0.1750000
NODE_9243_length_887_cov_9.451777	459	539	11	18	80	0.2250000
NODE_9243_length_887_cov_9.451777	459	539	12	21	80	0.2625000
NODE_9243_length_887_cov_9.451777	459	539	13	41	80	0.5125000
NODE_9245_length_887_cov_6.656091	473	553	2	80	80	1.0000000
NODE_9245_length_887_cov_6.656091	526	606	2	80	80	1.0000000
NODE_9246_length_887_cov_4.719543	420	500	0	80	80	1.0000000
NODE_9246_length_887_cov_4.719543	473	553	0	80	80	1.0000000
NODE_9250_length_887_cov_2.583756	385	429	0	44	44	1.0000000
NODE_9250_length_887_cov_2.583756	393	428	0	35	35	1.0000000
NODE_9261_length_887_cov_1.087563	754	829	0	75	75	1.0000000
NODE_9264_length_886_cov_35.482846	365	445	14	3	80	0.0375000
NODE_9264_length_886_cov_35.482846	365	445	15	14	80	0.1750000
NODE_9264_length_886_cov_35.482846	365	445	16	27	80	0.3375000
NODE_9264_length_886_cov_35.482846	365	445	17	36	80	0.4500000
NODE_9264_length_886_cov_35.482846	418	498	11	9	80	0.1125000
NODE_9264_length_886_cov_35.482846	418	498	12	7	80	0.0875000
NODE_9264_length_886_cov_35.482846	418	498	13	3	80	0.0375000
NODE_9264_length_886_cov_35.482846	418	498	14	15	80	0.1875000
NODE_9264_length_886_cov_35.482846	418	498	15	17	80	0.2125000
NODE_9264_length_886_cov_35.482846	418	498	16	21	80	0.2625000
NODE_9264_length_886_cov_35.482846	418	498	17	8	80	0.1000000
NODE_9265_length_886_cov_31.939009	438	518	4	1	80	0.0125000
NODE_9265_length_886_cov_31.939009	438	518	5	17	80	0.2125000
NODE_9265_length_886_cov_31.939009	438	518	6	59	80	0.7375000
NODE_9265_length_886_cov_31.939009	438	518	7	3	80	0.0375000
NODE_9265_length_886_cov_31.939009	491	571	4	1	80	0.0125000
NODE_9265_length_886_cov_31.939009	491	571	5	28	80	0.3500000
NODE_9265_length_886_cov_31.939009	491	571	6	13	80	0.1625000
NODE_9265_length_886_cov_31.939009	491	571	7	9	80	0.1125000
NODE_9265_length_886_cov_31.939009	491	571	8	6	80	0.0750000
NODE_9265_length_886_cov_31.939009	491	571	9	3	80	0.0375000
NODE_9265_length_886_cov_31.939009	491	571	10	20	80	0.2500000
NODE_9266_length_886_cov_25.301144	326	406	0	45	80	0.5625000
NODE_9266_length_886_cov_25.301144	326	406	1	23	80	0.2875000
NODE_9266_length_886_cov_25.301144	326	406	4	11	80	0.1375000
NODE_9266_length_886_cov_25.301144	326	406	5	1	80	0.0125000
NODE_9266_length_886_cov_25.301144	326	406	0	45	80	0.5625000
NODE_9266_length_886_cov_25.301144	326	406	1	23	80	0.2875000
NODE_9266_length_886_cov_25.301144	326	406	4	11	80	0.1375000
NODE_9266_length_886_cov_25.301144	326	406	5	1	80	0.0125000
NODE_9266_length_886_cov_25.301144	379	459	1	15	80	0.1875000
NODE_9266_length_886_cov_25.301144	379	459	4	11	80	0.1375000
NODE_9266_length_886_cov_25.301144	379	459	5	8	80	0.1000000
NODE_9266_length_886_cov_25.301144	379	459	6	6	80	0.0750000
NODE_9266_length_886_cov_25.301144	379	459	7	16	80	0.2000000
NODE_9266_length_886_cov_25.301144	379	459	8	24	80	0.3000000
NODE_9266_length_886_cov_25.301144	379	459	1	15	80	0.1875000
NODE_9266_length_886_cov_25.301144	379	459	4	11	80	0.1375000
NODE_9266_length_886_cov_25.301144	379	459	5	8	80	0.1000000
NODE_9266_length_886_cov_25.301144	379	459	6	6	80	0.0750000
NODE_9266_length_886_cov_25.301144	379	459	7	16	80	0.2000000
NODE_9266_length_886_cov_25.301144	379	459	8	24	80	0.3000000
NODE_9267_length_886_cov_14.463787	327	407	3	11	80	0.1375000
NODE_9267_length_886_cov_14.463787	327	407	4	69	80	0.8625000
NODE_9267_length_886_cov_14.463787	380	460	4	33	80	0.4125000
NODE_9267_length_886_cov_14.463787	380	460	5	47	80	0.5875000
NODE_9286_length_885_cov_35.510178	373	453	6	10	80	0.1250000
NODE_9286_length_885_cov_35.510178	373	453	7	16	80	0.2000000
NODE_9286_length_885_cov_35.510178	373	453	8	54	80	0.6750000
NODE_9286_length_885_cov_35.510178	426	506	4	12	80	0.1500000
NODE_9286_length_885_cov_35.510178	426	506	5	5	80	0.0625000
NODE_9286_length_885_cov_35.510178	426	506	7	11	80	0.1375000
NODE_9286_length_885_cov_35.510178	426	506	8	52	80	0.6500000
NODE_9287_length_885_cov_31.857506	368	448	3	40	80	0.5000000
NODE_9287_length_885_cov_31.857506	368	448	5	26	80	0.3250000
NODE_9287_length_885_cov_31.857506	368	448	7	14	80	0.1750000
NODE_9287_length_885_cov_31.857506	421	501	0	15	80	0.1875000
NODE_9287_length_885_cov_31.857506	421	501	1	8	80	0.1000000
NODE_9287_length_885_cov_31.857506	421	501	3	57	80	0.7125000
NODE_9288_length_885_cov_31.195929	395	475	3	9	80	0.1125000
NODE_9288_length_885_cov_31.195929	395	475	4	20	80	0.2500000
NODE_9288_length_885_cov_31.195929	395	475	5	11	80	0.1375000
NODE_9288_length_885_cov_31.195929	395	475	7	15	80	0.1875000
NODE_9288_length_885_cov_31.195929	395	475	8	25	80	0.3125000
NODE_9288_length_885_cov_31.195929	448	528	7	12	80	0.1500000
NODE_9288_length_885_cov_31.195929	448	528	8	65	80	0.8125000
NODE_9288_length_885_cov_31.195929	448	528	9	3	80	0.0375000
NODE_9289_length_885_cov_23.735369	356	436	13	25	80	0.3125000
NODE_9289_length_885_cov_23.735369	356	436	14	8	80	0.1000000
NODE_9289_length_885_cov_23.735369	356	436	15	12	80	0.1500000
NODE_9289_length_885_cov_23.735369	356	436	16	35	80	0.4375000
NODE_9289_length_885_cov_23.735369	409	489	6	1	80	0.0125000
NODE_9289_length_885_cov_23.735369	409	489	7	2	80	0.0250000
NODE_9289_length_885_cov_23.735369	409	489	8	9	80	0.1125000
NODE_9289_length_885_cov_23.735369	409	489	12	5	80	0.0625000
NODE_9289_length_885_cov_23.735369	409	489	13	5	80	0.0625000
NODE_9289_length_885_cov_23.735369	409	489	14	9	80	0.1125000
NODE_9289_length_885_cov_23.735369	409	489	15	17	80	0.2125000
NODE_9289_length_885_cov_23.735369	409	489	16	32	80	0.4000000
NODE_9289_length_885_cov_23.735369	485	565	3	1	80	0.0125000
NODE_9289_length_885_cov_23.735369	485	565	5	36	80	0.4500000
NODE_9289_length_885_cov_23.735369	485	565	7	6	80	0.0750000
NODE_9289_length_885_cov_23.735369	485	565	8	37	80	0.4625000
NODE_9289_length_885_cov_23.735369	538	618	2	51	80	0.6375000
NODE_9289_length_885_cov_23.735369	538	618	3	3	80	0.0375000
NODE_9289_length_885_cov_23.735369	538	618	5	26	80	0.3250000
NODE_9290_length_885_cov_22.174300	340	420	0	1	80	0.0125000
NODE_9290_length_885_cov_22.174300	340	420	2	79	80	0.9875000
NODE_9290_length_885_cov_22.174300	393	473	2	80	80	1.0000000
NODE_9290_length_885_cov_22.174300	469	549	1	34	80	0.4250000
NODE_9290_length_885_cov_22.174300	469	549	2	16	80	0.2000000
NODE_9290_length_885_cov_22.174300	469	549	3	30	80	0.3750000
NODE_9290_length_885_cov_22.174300	522	602	3	61	80	0.7625000
NODE_9290_length_885_cov_22.174300	522	602	4	19	80	0.2375000
NODE_9291_length_885_cov_17.852417	413	493	6	8	80	0.1000000
NODE_9291_length_885_cov_17.852417	413	493	7	28	80	0.3500000
NODE_9291_length_885_cov_17.852417	413	493	8	44	80	0.5500000
NODE_9291_length_885_cov_17.852417	466	546	6	16	80	0.2000000
NODE_9291_length_885_cov_17.852417	466	546	7	56	80	0.7000000
NODE_9291_length_885_cov_17.852417	466	546	8	8	80	0.1000000
NODE_9292_length_885_cov_15.652672	346	426	8	3	80	0.0375000
NODE_9292_length_885_cov_15.652672	346	426	9	4	80	0.0500000
NODE_9292_length_885_cov_15.652672	346	426	11	4	80	0.0500000
NODE_9292_length_885_cov_15.652672	346	426	12	69	80	0.8625000
NODE_9292_length_885_cov_15.652672	399	479	11	4	80	0.0500000
NODE_9292_length_885_cov_15.652672	399	479	12	25	80	0.3125000
NODE_9292_length_885_cov_15.652672	399	479	13	17	80	0.2125000
NODE_9292_length_885_cov_15.652672	399	479	14	9	80	0.1125000
NODE_9292_length_885_cov_15.652672	399	479	15	17	80	0.2125000
NODE_9292_length_885_cov_15.652672	399	479	16	8	80	0.1000000
NODE_9292_length_885_cov_15.652672	475	555	6	52	80	0.6500000
NODE_9292_length_885_cov_15.652672	475	555	9	4	80	0.0500000
NODE_9292_length_885_cov_15.652672	475	555	10	14	80	0.1750000
NODE_9292_length_885_cov_15.652672	475	555	13	5	80	0.0625000
NODE_9292_length_885_cov_15.652672	475	555	14	5	80	0.0625000
NODE_9292_length_885_cov_15.652672	528	608	0	10	80	0.1250000
NODE_9292_length_885_cov_15.652672	528	608	1	13	80	0.1625000
NODE_9292_length_885_cov_15.652672	528	608	3	5	80	0.0625000
NODE_9292_length_885_cov_15.652672	528	608	4	2	80	0.0250000
NODE_9292_length_885_cov_15.652672	528	608	5	12	80	0.1500000
NODE_9292_length_885_cov_15.652672	528	608	6	38	80	0.4750000
NODE_9293_length_885_cov_11.648855	530	610	4	14	80	0.1750000
NODE_9293_length_885_cov_11.648855	530	610	6	18	80	0.2250000
NODE_9293_length_885_cov_11.648855	530	610	8	48	80	0.6000000
NODE_9293_length_885_cov_11.648855	583	663	6	11	80	0.1375000
NODE_9293_length_885_cov_11.648855	583	663	7	1	80	0.0125000
NODE_9293_length_885_cov_11.648855	583	663	8	68	80	0.8500000
NODE_9294_length_885_cov_9.707379	611	691	0	42	80	0.5250000
NODE_9294_length_885_cov_9.707379	611	691	1	10	80	0.1250000
NODE_9294_length_885_cov_9.707379	611	691	2	28	80	0.3500000
NODE_9294_length_885_cov_9.707379	664	744	2	80	80	1.0000000
NODE_9311_length_884_cov_73.050955	536	616	16	4	80	0.0500000
NODE_9311_length_884_cov_73.050955	536	616	17	8	80	0.1000000
NODE_9311_length_884_cov_73.050955	536	616	18	15	80	0.1875000
NODE_9311_length_884_cov_73.050955	536	616	19	23	80	0.2875000
NODE_9311_length_884_cov_73.050955	536	616	20	1	80	0.0125000
NODE_9311_length_884_cov_73.050955	536	616	21	13	80	0.1625000
NODE_9311_length_884_cov_73.050955	536	616	22	16	80	0.2000000
NODE_9311_length_884_cov_73.050955	589	669	12	3	80	0.0375000
NODE_9311_length_884_cov_73.050955	589	669	13	6	80	0.0750000
NODE_9311_length_884_cov_73.050955	589	669	15	10	80	0.1250000
NODE_9311_length_884_cov_73.050955	589	669	16	9	80	0.1125000
NODE_9311_length_884_cov_73.050955	589	669	18	28	80	0.3500000
NODE_9311_length_884_cov_73.050955	589	669	19	8	80	0.1000000
NODE_9311_length_884_cov_73.050955	589	669	20	1	80	0.0125000
NODE_9311_length_884_cov_73.050955	589	669	21	13	80	0.1625000
NODE_9311_length_884_cov_73.050955	589	669	22	2	80	0.0250000
NODE_9312_length_884_cov_28.373248	381	461	15	5	80	0.0625000
NODE_9312_length_884_cov_28.373248	381	461	16	2	80	0.0250000
NODE_9312_length_884_cov_28.373248	381	461	17	24	80	0.3000000
NODE_9312_length_884_cov_28.373248	381	461	18	28	80	0.3500000
NODE_9312_length_884_cov_28.373248	381	461	22	1	80	0.0125000
NODE_9312_length_884_cov_28.373248	381	461	23	20	80	0.2500000
NODE_9312_length_884_cov_28.373248	434	514	15	13	80	0.1625000
NODE_9312_length_884_cov_28.373248	434	514	16	5	80	0.0625000
NODE_9312_length_884_cov_28.373248	434	514	17	13	80	0.1625000
NODE_9312_length_884_cov_28.373248	434	514	18	23	80	0.2875000
NODE_9312_length_884_cov_28.373248	434	514	19	8	80	0.1000000
NODE_9312_length_884_cov_28.373248	434	514	22	1	80	0.0125000
NODE_9312_length_884_cov_28.373248	434	514	23	17	80	0.2125000
NODE_9313_length_884_cov_20.649682	463	543	8	31	80	0.3875000
NODE_9313_length_884_cov_20.649682	463	543	9	2	80	0.0250000
NODE_9313_length_884_cov_20.649682	463	543	10	1	80	0.0125000
NODE_9313_length_884_cov_20.649682	463	543	11	30	80	0.3750000
NODE_9313_length_884_cov_20.649682	463	543	12	10	80	0.1250000
NODE_9313_length_884_cov_20.649682	463	543	13	6	80	0.0750000
NODE_9313_length_884_cov_20.649682	516	596	8	20	80	0.2500000
NODE_9313_length_884_cov_20.649682	516	596	10	3	80	0.0375000
NODE_9313_length_884_cov_20.649682	516	596	11	22	80	0.2750000
NODE_9313_length_884_cov_20.649682	516	596	12	22	80	0.2750000
NODE_9313_length_884_cov_20.649682	516	596	13	13	80	0.1625000
NODE_9314_length_884_cov_13.391083	225	305	7	14	80	0.1750000
NODE_9314_length_884_cov_13.391083	225	305	8	57	80	0.7125000
NODE_9314_length_884_cov_13.391083	225	305	9	9	80	0.1125000
NODE_9314_length_884_cov_13.391083	278	358	5	7	80	0.0875000
NODE_9314_length_884_cov_13.391083	278	358	6	1	80	0.0125000
NODE_9314_length_884_cov_13.391083	278	358	7	38	80	0.4750000
NODE_9314_length_884_cov_13.391083	278	358	8	25	80	0.3125000
NODE_9314_length_884_cov_13.391083	278	358	9	9	80	0.1125000
NODE_9315_length_884_cov_9.192357	278	358	4	17	80	0.2125000
NODE_9315_length_884_cov_9.192357	278	358	7	4	80	0.0500000
NODE_9315_length_884_cov_9.192357	278	358	8	40	80	0.5000000
NODE_9315_length_884_cov_9.192357	278	358	9	19	80	0.2375000
NODE_9315_length_884_cov_9.192357	331	411	6	4	80	0.0500000
NODE_9315_length_884_cov_9.192357	331	411	7	20	80	0.2500000
NODE_9315_length_884_cov_9.192357	331	411	8	37	80	0.4625000
NODE_9315_length_884_cov_9.192357	331	411	9	19	80	0.2375000
NODE_9315_length_884_cov_9.192357	407	487	2	19	80	0.2375000
NODE_9315_length_884_cov_9.192357	407	487	3	23	80	0.2875000
NODE_9315_length_884_cov_9.192357	407	487	6	38	80	0.4750000
NODE_9315_length_884_cov_9.192357	460	540	2	48	80	0.6000000
NODE_9315_length_884_cov_9.192357	460	540	3	32	80	0.4000000
NODE_9335_length_883_cov_46.780612	344	424	4	25	80	0.3125000
NODE_9335_length_883_cov_46.780612	344	424	5	34	80	0.4250000
NODE_9335_length_883_cov_46.780612	344	424	6	2	80	0.0250000
NODE_9335_length_883_cov_46.780612	344	424	7	4	80	0.0500000
NODE_9335_length_883_cov_46.780612	344	424	8	13	80	0.1625000
NODE_9335_length_883_cov_46.780612	344	424	10	2	80	0.0250000
NODE_9335_length_883_cov_46.780612	397	477	5	6	80	0.0750000
NODE_9335_length_883_cov_46.780612	397	477	6	2	80	0.0250000
NODE_9335_length_883_cov_46.780612	397	477	7	12	80	0.1500000
NODE_9335_length_883_cov_46.780612	397	477	8	32	80	0.4000000
NODE_9335_length_883_cov_46.780612	397	477	9	14	80	0.1750000
NODE_9335_length_883_cov_46.780612	397	477	10	14	80	0.1750000
NODE_9336_length_883_cov_46.304847	387	467	20	9	80	0.1125000
NODE_9336_length_883_cov_46.304847	387	467	23	7	80	0.0875000
NODE_9336_length_883_cov_46.304847	387	467	25	21	80	0.2625000
NODE_9336_length_883_cov_46.304847	387	467	26	22	80	0.2750000
NODE_9336_length_883_cov_46.304847	387	467	27	6	80	0.0750000
NODE_9336_length_883_cov_46.304847	387	467	29	9	80	0.1125000
NODE_9336_length_883_cov_46.304847	387	467	30	6	80	0.0750000
NODE_9336_length_883_cov_46.304847	440	520	21	7	80	0.0875000
NODE_9336_length_883_cov_46.304847	440	520	22	30	80	0.3750000
NODE_9336_length_883_cov_46.304847	440	520	23	3	80	0.0375000
NODE_9336_length_883_cov_46.304847	440	520	25	23	80	0.2875000
NODE_9336_length_883_cov_46.304847	440	520	26	12	80	0.1500000
NODE_9336_length_883_cov_46.304847	440	520	29	3	80	0.0375000
NODE_9336_length_883_cov_46.304847	440	520	30	2	80	0.0250000
NODE_9337_length_883_cov_39.579082	410	490	10	20	80	0.2500000
NODE_9337_length_883_cov_39.579082	410	490	11	21	80	0.2625000
NODE_9337_length_883_cov_39.579082	410	490	12	1	80	0.0125000
NODE_9337_length_883_cov_39.579082	410	490	15	6	80	0.0750000
NODE_9337_length_883_cov_39.579082	410	490	16	15	80	0.1875000
NODE_9337_length_883_cov_39.579082	410	490	17	17	80	0.2125000
NODE_9337_length_883_cov_39.579082	463	543	14	4	80	0.0500000
NODE_9337_length_883_cov_39.579082	463	543	15	7	80	0.0875000
NODE_9337_length_883_cov_39.579082	463	543	16	35	80	0.4375000
NODE_9337_length_883_cov_39.579082	463	543	17	34	80	0.4250000
NODE_9338_length_883_cov_28.307398	379	459	4	52	80	0.6500000
NODE_9338_length_883_cov_28.307398	379	459	5	18	80	0.2250000
NODE_9338_length_883_cov_28.307398	379	459	6	10	80	0.1250000
NODE_9338_length_883_cov_28.307398	432	512	3	37	80	0.4625000
NODE_9338_length_883_cov_28.307398	432	512	4	43	80	0.5375000
NODE_9339_length_883_cov_24.927296	429	509	4	29	80	0.3625000
NODE_9339_length_883_cov_24.927296	429	509	5	31	80	0.3875000
NODE_9339_length_883_cov_24.927296	429	509	6	20	80	0.2500000
NODE_9339_length_883_cov_24.927296	482	562	1	17	80	0.2125000
NODE_9339_length_883_cov_24.927296	482	562	2	17	80	0.2125000
NODE_9339_length_883_cov_24.927296	482	562	3	3	80	0.0375000
NODE_9339_length_883_cov_24.927296	482	562	4	43	80	0.5375000
NODE_9341_length_883_cov_17.445153	326	406	0	78	80	0.9750000
NODE_9341_length_883_cov_17.445153	326	406	7	1	80	0.0125000
NODE_9341_length_883_cov_17.445153	326	406	8	1	80	0.0125000
NODE_9341_length_883_cov_17.445153	379	459	0	25	80	0.3125000
NODE_9341_length_883_cov_17.445153	379	459	7	1	80	0.0125000
NODE_9341_length_883_cov_17.445153	379	459	8	54	80	0.6750000
NODE_9342_length_883_cov_14.660714	319	395	0	23	76	0.3026316
NODE_9342_length_883_cov_14.660714	319	395	2	53	76	0.6973684
NODE_9342_length_883_cov_14.660714	740	816	0	76	76	1.0000000
NODE_9343_length_883_cov_11.052296	223	303	5	1	80	0.0125000
NODE_9343_length_883_cov_11.052296	223	303	6	20	80	0.2500000
NODE_9343_length_883_cov_11.052296	223	303	7	59	80	0.7375000
NODE_9343_length_883_cov_11.052296	276	356	1	25	80	0.3125000
NODE_9343_length_883_cov_11.052296	276	356	4	1	80	0.0125000
NODE_9343_length_883_cov_11.052296	276	356	5	12	80	0.1500000
NODE_9343_length_883_cov_11.052296	276	356	6	25	80	0.3125000
NODE_9343_length_883_cov_11.052296	276	356	7	17	80	0.2125000
NODE_9344_length_883_cov_6.873724	0	66	0	66	66	1.0000000
NODE_9345_length_883_cov_3.873724	471	551	0	80	80	1.0000000
NODE_9345_length_883_cov_3.873724	524	604	0	80	80	1.0000000
NODE_9346_length_883_cov_3.247449	294	374	2	20	80	0.2500000
NODE_9346_length_883_cov_3.247449	294	374	4	60	80	0.7500000
NODE_9346_length_883_cov_3.247449	347	427	2	22	80	0.2750000
NODE_9346_length_883_cov_3.247449	347	427	4	58	80	0.7250000
NODE_9370_length_882_cov_24.241379	438	518	6	40	80	0.5000000
NODE_9370_length_882_cov_24.241379	438	518	7	40	80	0.5000000
NODE_9370_length_882_cov_24.241379	491	571	2	14	80	0.1750000
NODE_9370_length_882_cov_24.241379	491	571	4	22	80	0.2750000
NODE_9370_length_882_cov_24.241379	491	571	6	37	80	0.4625000
NODE_9370_length_882_cov_24.241379	491	571	7	7	80	0.0875000
NODE_9371_length_882_cov_23.145594	355	435	1	80	80	1.0000000
NODE_9371_length_882_cov_23.145594	408	488	1	60	80	0.7500000
NODE_9371_length_882_cov_23.145594	408	488	2	20	80	0.2500000
NODE_9372_length_882_cov_21.401022	335	415	0	4	80	0.0500000
NODE_9372_length_882_cov_21.401022	335	415	4	32	80	0.4000000
NODE_9372_length_882_cov_21.401022	335	415	5	4	80	0.0500000
NODE_9372_length_882_cov_21.401022	335	415	6	40	80	0.5000000
NODE_9372_length_882_cov_21.401022	388	468	6	80	80	1.0000000
NODE_9373_length_882_cov_19.579821	456	511	0	16	55	0.2909091
NODE_9373_length_882_cov_19.579821	456	511	1	6	55	0.1090909
NODE_9373_length_882_cov_19.579821	456	511	3	14	55	0.2545455
NODE_9373_length_882_cov_19.579821	456	511	4	12	55	0.2181818
NODE_9373_length_882_cov_19.579821	456	511	5	3	55	0.0545455
NODE_9373_length_882_cov_19.579821	456	511	6	1	55	0.0181818
NODE_9373_length_882_cov_19.579821	456	511	7	3	55	0.0545455
NODE_9373_length_882_cov_19.579821	506	586	5	1	80	0.0125000
NODE_9373_length_882_cov_19.579821	506	586	6	1	80	0.0125000
NODE_9373_length_882_cov_19.579821	506	586	7	44	80	0.5500000
NODE_9373_length_882_cov_19.579821	506	586	8	27	80	0.3375000
NODE_9373_length_882_cov_19.579821	506	586	9	7	80	0.0875000
NODE_9373_length_882_cov_19.579821	559	639	7	17	80	0.2125000
NODE_9373_length_882_cov_19.579821	559	639	8	34	80	0.4250000
NODE_9373_length_882_cov_19.579821	559	639	9	7	80	0.0875000
NODE_9373_length_882_cov_19.579821	559	639	10	22	80	0.2750000
NODE_9374_length_882_cov_19.342273	298	378	0	80	80	1.0000000
NODE_9374_length_882_cov_19.342273	351	431	0	77	80	0.9625000
NODE_9374_length_882_cov_19.342273	351	431	1	3	80	0.0375000
NODE_9374_length_882_cov_19.342273	427	508	0	1	81	0.0123457
NODE_9374_length_882_cov_19.342273	427	508	1	79	81	0.9753087
NODE_9374_length_882_cov_19.342273	427	508	2	1	81	0.0123457
NODE_9374_length_882_cov_19.342273	481	561	1	26	80	0.3250000
NODE_9374_length_882_cov_19.342273	481	561	2	54	80	0.6750000
NODE_9375_length_882_cov_11.873563	267	347	0	80	80	1.0000000
NODE_9375_length_882_cov_11.873563	320	400	0	80	80	1.0000000
NODE_9376_length_882_cov_8.794381	430	510	0	48	80	0.6000000
NODE_9376_length_882_cov_8.794381	430	510	1	13	80	0.1625000
NODE_9376_length_882_cov_8.794381	430	510	2	19	80	0.2375000
NODE_9376_length_882_cov_8.794381	483	563	1	8	80	0.1000000
NODE_9376_length_882_cov_8.794381	483	563	2	72	80	0.9000000
NODE_9377_length_882_cov_7.537676	527	608	2	81	81	1.0000000
NODE_9379_length_882_cov_6.696041	355	435	2	44	80	0.5500000
NODE_9379_length_882_cov_6.696041	355	435	3	36	80	0.4500000
NODE_9379_length_882_cov_6.696041	408	488	2	40	80	0.5000000
NODE_9379_length_882_cov_6.696041	408	488	3	40	80	0.5000000
NODE_9380_length_882_cov_4.734355	585	665	0	80	80	1.0000000
NODE_9380_length_882_cov_4.734355	638	718	0	80	80	1.0000000
NODE_9398_length_881_cov_32.875959	444	524	12	22	80	0.2750000
NODE_9398_length_881_cov_32.875959	444	524	14	16	80	0.2000000
NODE_9398_length_881_cov_32.875959	444	524	15	34	80	0.4250000
NODE_9398_length_881_cov_32.875959	444	524	16	8	80	0.1000000
NODE_9398_length_881_cov_32.875959	497	577	14	55	80	0.6875000
NODE_9398_length_881_cov_32.875959	497	577	15	15	80	0.1875000
NODE_9398_length_881_cov_32.875959	497	577	16	10	80	0.1250000
NODE_9399_length_881_cov_25.750639	43	117	12	12	74	0.1621622
NODE_9399_length_881_cov_25.750639	43	117	13	43	74	0.5810811
NODE_9399_length_881_cov_25.750639	43	117	17	19	74	0.2567568
NODE_9399_length_881_cov_25.750639	116	193	14	15	77	0.1948052
NODE_9399_length_881_cov_25.750639	116	193	15	1	77	0.0129870
NODE_9399_length_881_cov_25.750639	116	193	16	1	77	0.0129870
NODE_9399_length_881_cov_25.750639	116	193	17	27	77	0.3506494
NODE_9399_length_881_cov_25.750639	116	193	18	5	77	0.0649351
NODE_9399_length_881_cov_25.750639	116	193	19	11	77	0.1428571
NODE_9399_length_881_cov_25.750639	116	193	20	3	77	0.0389610
NODE_9399_length_881_cov_25.750639	116	193	21	11	77	0.1428571
NODE_9399_length_881_cov_25.750639	116	193	22	3	77	0.0389610
NODE_9400_length_881_cov_23.897698	286	365	1	10	79	0.1265823
NODE_9400_length_881_cov_23.897698	286	365	2	2	79	0.0253165
NODE_9400_length_881_cov_23.897698	286	365	3	13	79	0.1645570
NODE_9400_length_881_cov_23.897698	286	365	4	3	79	0.0379747
NODE_9400_length_881_cov_23.897698	286	365	5	24	79	0.3037975
NODE_9400_length_881_cov_23.897698	286	365	6	27	79	0.3417721
NODE_9400_length_881_cov_23.897698	338	418	5	34	80	0.4250000
NODE_9400_length_881_cov_23.897698	338	418	6	46	80	0.5750000
NODE_9401_length_881_cov_20.656010	359	439	13	4	80	0.0500000
NODE_9401_length_881_cov_20.656010	359	439	15	3	80	0.0375000
NODE_9401_length_881_cov_20.656010	359	439	16	24	80	0.3000000
NODE_9401_length_881_cov_20.656010	359	439	17	8	80	0.1000000
NODE_9401_length_881_cov_20.656010	359	439	18	3	80	0.0375000
NODE_9401_length_881_cov_20.656010	359	439	20	14	80	0.1750000
NODE_9401_length_881_cov_20.656010	359	439	22	24	80	0.3000000
NODE_9401_length_881_cov_20.656010	412	492	16	5	80	0.0625000
NODE_9401_length_881_cov_20.656010	412	492	18	16	80	0.2000000
NODE_9401_length_881_cov_20.656010	412	492	19	10	80	0.1250000
NODE_9401_length_881_cov_20.656010	412	492	20	6	80	0.0750000
NODE_9401_length_881_cov_20.656010	412	492	21	11	80	0.1375000
NODE_9401_length_881_cov_20.656010	412	492	22	32	80	0.4000000
NODE_9402_length_881_cov_20.340153	242	322	4	22	80	0.2750000
NODE_9402_length_881_cov_20.340153	242	322	5	6	80	0.0750000
NODE_9402_length_881_cov_20.340153	242	322	6	17	80	0.2125000
NODE_9402_length_881_cov_20.340153	242	322	7	35	80	0.4375000
NODE_9402_length_881_cov_20.340153	295	375	2	10	80	0.1250000
NODE_9402_length_881_cov_20.340153	295	375	4	65	80	0.8125000
NODE_9402_length_881_cov_20.340153	295	375	5	1	80	0.0125000
NODE_9402_length_881_cov_20.340153	295	375	6	4	80	0.0500000
NODE_9403_length_881_cov_18.234015	420	500	2	21	80	0.2625000
NODE_9403_length_881_cov_18.234015	420	500	3	59	80	0.7375000
NODE_9403_length_881_cov_18.234015	473	553	1	12	80	0.1500000
NODE_9403_length_881_cov_18.234015	473	553	2	44	80	0.5500000
NODE_9403_length_881_cov_18.234015	473	553	3	24	80	0.3000000
NODE_9404_length_881_cov_17.748082	291	371	4	7	80	0.0875000
NODE_9404_length_881_cov_17.748082	291	371	5	1	80	0.0125000
NODE_9404_length_881_cov_17.748082	291	371	6	19	80	0.2375000
NODE_9404_length_881_cov_17.748082	291	371	7	7	80	0.0875000
NODE_9404_length_881_cov_17.748082	291	371	8	9	80	0.1125000
NODE_9404_length_881_cov_17.748082	291	371	9	6	80	0.0750000
NODE_9404_length_881_cov_17.748082	291	371	10	31	80	0.3875000
NODE_9404_length_881_cov_17.748082	344	424	9	44	80	0.5500000
NODE_9404_length_881_cov_17.748082	344	424	10	33	80	0.4125000
NODE_9404_length_881_cov_17.748082	344	424	11	3	80	0.0375000
NODE_9405_length_881_cov_12.884910	332	412	3	80	80	1.0000000
NODE_9405_length_881_cov_12.884910	385	465	1	4	80	0.0500000
NODE_9405_length_881_cov_12.884910	385	465	2	10	80	0.1250000
NODE_9405_length_881_cov_12.884910	385	465	3	66	80	0.8250000
NODE_9406_length_881_cov_6.473146	474	553	1	79	79	1.0000000
NODE_9406_length_881_cov_6.473146	514	594	0	27	80	0.3375000
NODE_9406_length_881_cov_6.473146	514	594	1	53	80	0.6625000
NODE_9406_length_881_cov_6.473146	526	565	1	39	39	1.0000000
NODE_9406_length_881_cov_6.473146	555	606	0	39	51	0.7647059
NODE_9406_length_881_cov_6.473146	555	606	1	12	51	0.2352941
NODE_9406_length_881_cov_6.473146	567	647	0	80	80	1.0000000
NODE_9407_length_881_cov_5.615090	547	627	1	62	80	0.7750000
NODE_9407_length_881_cov_5.615090	547	627	2	18	80	0.2250000
NODE_9407_length_881_cov_5.615090	600	680	1	9	80	0.1125000
NODE_9407_length_881_cov_5.615090	600	680	2	71	80	0.8875000
NODE_9424_length_880_cov_26.663252	320	400	15	12	80	0.1500000
NODE_9424_length_880_cov_26.663252	320	400	19	6	80	0.0750000
NODE_9424_length_880_cov_26.663252	320	400	20	2	80	0.0250000
NODE_9424_length_880_cov_26.663252	320	400	22	38	80	0.4750000
NODE_9424_length_880_cov_26.663252	320	400	23	3	80	0.0375000
NODE_9424_length_880_cov_26.663252	320	400	24	1	80	0.0125000
NODE_9424_length_880_cov_26.663252	320	400	25	5	80	0.0625000
NODE_9424_length_880_cov_26.663252	320	400	26	4	80	0.0500000
NODE_9424_length_880_cov_26.663252	320	400	27	9	80	0.1125000
NODE_9424_length_880_cov_26.663252	373	453	20	4	80	0.0500000
NODE_9424_length_880_cov_26.663252	373	453	21	1	80	0.0125000
NODE_9424_length_880_cov_26.663252	373	453	22	13	80	0.1625000
NODE_9424_length_880_cov_26.663252	373	453	23	14	80	0.1750000
NODE_9424_length_880_cov_26.663252	373	453	24	23	80	0.2875000
NODE_9424_length_880_cov_26.663252	373	453	25	12	80	0.1500000
NODE_9424_length_880_cov_26.663252	373	453	26	4	80	0.0500000
NODE_9424_length_880_cov_26.663252	373	453	27	9	80	0.1125000
NODE_9425_length_880_cov_21.828425	328	408	1	46	80	0.5750000
NODE_9425_length_880_cov_21.828425	328	408	2	34	80	0.4250000
NODE_9425_length_880_cov_21.828425	381	461	0	14	80	0.1750000
NODE_9425_length_880_cov_21.828425	381	461	1	66	80	0.8250000
NODE_9426_length_880_cov_20.245839	427	507	5	61	80	0.7625000
NODE_9426_length_880_cov_20.245839	427	507	8	19	80	0.2375000
NODE_9426_length_880_cov_20.245839	480	560	3	1	80	0.0125000
NODE_9426_length_880_cov_20.245839	480	560	4	18	80	0.2250000
NODE_9426_length_880_cov_20.245839	480	560	5	8	80	0.1000000
NODE_9426_length_880_cov_20.245839	480	560	6	33	80	0.4125000
NODE_9426_length_880_cov_20.245839	480	560	8	20	80	0.2500000
NODE_9427_length_880_cov_19.434059	0	69	0	69	69	1.0000000
NODE_9428_length_880_cov_11.843790	363	430	7	14	67	0.2089552
NODE_9428_length_880_cov_11.843790	363	430	8	33	67	0.4925373
NODE_9428_length_880_cov_11.843790	363	430	13	20	67	0.2985075
NODE_9429_length_880_cov_11.544174	185	265	4	80	80	1.0000000
NODE_9429_length_880_cov_11.544174	238	318	0	13	80	0.1625000
NODE_9429_length_880_cov_11.544174	238	318	2	11	80	0.1375000
NODE_9429_length_880_cov_11.544174	238	318	3	5	80	0.0625000
NODE_9429_length_880_cov_11.544174	238	318	4	51	80	0.6375000
NODE_9430_length_880_cov_10.956466	354	434	3	23	80	0.2875000
NODE_9430_length_880_cov_10.956466	354	434	4	55	80	0.6875000
NODE_9430_length_880_cov_10.956466	354	434	7	2	80	0.0250000
NODE_9430_length_880_cov_10.956466	407	487	3	23	80	0.2875000
NODE_9430_length_880_cov_10.956466	407	487	4	2	80	0.0250000
NODE_9430_length_880_cov_10.956466	407	487	7	55	80	0.6875000
NODE_9431_length_880_cov_10.008963	395	474	0	79	79	1.0000000
NODE_9431_length_880_cov_10.008963	448	527	0	79	79	1.0000000
NODE_9453_length_879_cov_23.565385	326	406	4	6	80	0.0750000
NODE_9453_length_879_cov_23.565385	326	406	5	74	80	0.9250000
NODE_9453_length_879_cov_23.565385	379	459	0	10	80	0.1250000
NODE_9453_length_879_cov_23.565385	379	459	1	2	80	0.0250000
NODE_9453_length_879_cov_23.565385	379	459	2	32	80	0.4000000
NODE_9453_length_879_cov_23.565385	379	459	3	2	80	0.0250000
NODE_9453_length_879_cov_23.565385	379	459	4	13	80	0.1625000
NODE_9453_length_879_cov_23.565385	379	459	5	21	80	0.2625000
NODE_9453_length_879_cov_23.565385	455	535	0	3	80	0.0375000
NODE_9453_length_879_cov_23.565385	455	535	1	11	80	0.1375000
NODE_9453_length_879_cov_23.565385	455	535	3	66	80	0.8250000
NODE_9453_length_879_cov_23.565385	508	586	3	78	78	1.0000000
NODE_9454_length_879_cov_20.758974	355	439	2	6	84	0.0714286
NODE_9454_length_879_cov_20.758974	355	439	3	6	84	0.0714286
NODE_9454_length_879_cov_20.758974	355	439	4	26	84	0.3095238
NODE_9454_length_879_cov_20.758974	355	439	5	46	84	0.5476190
NODE_9454_length_879_cov_20.758974	412	492	2	46	80	0.5750000
NODE_9454_length_879_cov_20.758974	412	492	3	19	80	0.2375000
NODE_9454_length_879_cov_20.758974	412	492	5	15	80	0.1875000
NODE_9455_length_879_cov_19.685897	295	375	0	80	80	1.0000000
NODE_9455_length_879_cov_19.685897	348	428	0	80	80	1.0000000
NODE_9456_length_879_cov_17.738462	413	488	0	45	75	0.6000000
NODE_9456_length_879_cov_17.738462	413	488	1	30	75	0.4000000
NODE_9456_length_879_cov_17.738462	569	649	4	10	80	0.1250000
NODE_9456_length_879_cov_17.738462	569	649	5	70	80	0.8750000
NODE_9456_length_879_cov_17.738462	569	649	4	10	80	0.1250000
NODE_9456_length_879_cov_17.738462	569	649	5	70	80	0.8750000
NODE_9456_length_879_cov_17.738462	569	649	4	10	80	0.1250000
NODE_9456_length_879_cov_17.738462	569	649	5	70	80	0.8750000
NODE_9456_length_879_cov_17.738462	622	676	3	16	54	0.2962963
NODE_9456_length_879_cov_17.738462	622	676	4	4	54	0.0740741
NODE_9456_length_879_cov_17.738462	622	676	5	34	54	0.6296296
NODE_9458_length_879_cov_10.756410	335	415	3	17	80	0.2125000
NODE_9458_length_879_cov_10.756410	335	415	4	31	80	0.3875000
NODE_9458_length_879_cov_10.756410	335	415	5	1	80	0.0125000
NODE_9458_length_879_cov_10.756410	335	415	6	22	80	0.2750000
NODE_9458_length_879_cov_10.756410	335	415	7	9	80	0.1125000
NODE_9458_length_879_cov_10.756410	388	468	6	32	80	0.4000000
NODE_9458_length_879_cov_10.756410	388	468	7	35	80	0.4375000
NODE_9458_length_879_cov_10.756410	388	468	8	10	80	0.1250000
NODE_9458_length_879_cov_10.756410	388	468	9	3	80	0.0375000
NODE_9459_length_879_cov_7.432051	234	314	0	9	80	0.1125000
NODE_9459_length_879_cov_7.432051	234	314	1	20	80	0.2500000
NODE_9459_length_879_cov_7.432051	234	314	2	51	80	0.6375000
NODE_9459_length_879_cov_7.432051	288	367	0	62	79	0.7848101
NODE_9459_length_879_cov_7.432051	288	367	1	17	79	0.2151899
NODE_9473_length_878_cov_230.436457	415	495	54	2	80	0.0250000
NODE_9473_length_878_cov_230.436457	415	495	55	3	80	0.0375000
NODE_9473_length_878_cov_230.436457	415	495	58	17	80	0.2125000
NODE_9473_length_878_cov_230.436457	415	495	60	2	80	0.0250000
NODE_9473_length_878_cov_230.436457	415	495	61	3	80	0.0375000
NODE_9473_length_878_cov_230.436457	415	495	62	3	80	0.0375000
NODE_9473_length_878_cov_230.436457	415	495	63	1	80	0.0125000
NODE_9473_length_878_cov_230.436457	415	495	64	1	80	0.0125000
NODE_9473_length_878_cov_230.436457	415	495	65	1	80	0.0125000
NODE_9473_length_878_cov_230.436457	415	495	66	7	80	0.0875000
NODE_9473_length_878_cov_230.436457	415	495	68	2	80	0.0250000
NODE_9473_length_878_cov_230.436457	415	495	69	4	80	0.0500000
NODE_9473_length_878_cov_230.436457	415	495	70	2	80	0.0250000
NODE_9473_length_878_cov_230.436457	415	495	72	6	80	0.0750000
NODE_9473_length_878_cov_230.436457	415	495	73	4	80	0.0500000
NODE_9473_length_878_cov_230.436457	415	495	74	3	80	0.0375000
NODE_9473_length_878_cov_230.436457	415	495	76	8	80	0.1000000
NODE_9473_length_878_cov_230.436457	415	495	77	1	80	0.0125000
NODE_9473_length_878_cov_230.436457	415	495	78	1	80	0.0125000
NODE_9473_length_878_cov_230.436457	415	495	79	1	80	0.0125000
NODE_9473_length_878_cov_230.436457	415	495	81	4	80	0.0500000
NODE_9473_length_878_cov_230.436457	415	495	82	2	80	0.0250000
NODE_9473_length_878_cov_230.436457	415	495	83	2	80	0.0250000
NODE_9473_length_878_cov_230.436457	468	548	64	5	80	0.0625000
NODE_9473_length_878_cov_230.436457	468	548	65	3	80	0.0375000
NODE_9473_length_878_cov_230.436457	468	548	66	2	80	0.0250000
NODE_9473_length_878_cov_230.436457	468	548	68	1	80	0.0125000
NODE_9473_length_878_cov_230.436457	468	548	69	4	80	0.0500000
NODE_9473_length_878_cov_230.436457	468	548	70	2	80	0.0250000
NODE_9473_length_878_cov_230.436457	468	548	71	5	80	0.0625000
NODE_9473_length_878_cov_230.436457	468	548	72	4	80	0.0500000
NODE_9473_length_878_cov_230.436457	468	548	73	7	80	0.0875000
NODE_9473_length_878_cov_230.436457	468	548	74	8	80	0.1000000
NODE_9473_length_878_cov_230.436457	468	548	75	11	80	0.1375000
NODE_9473_length_878_cov_230.436457	468	548	76	8	80	0.1000000
NODE_9473_length_878_cov_230.436457	468	548	77	4	80	0.0500000
NODE_9473_length_878_cov_230.436457	468	548	78	7	80	0.0875000
NODE_9473_length_878_cov_230.436457	468	548	79	1	80	0.0125000
NODE_9473_length_878_cov_230.436457	468	548	81	4	80	0.0500000
NODE_9473_length_878_cov_230.436457	468	548	82	2	80	0.0250000
NODE_9473_length_878_cov_230.436457	468	548	83	2	80	0.0250000
NODE_9474_length_878_cov_49.514763	410	490	19	4	80	0.0500000
NODE_9474_length_878_cov_49.514763	410	490	21	24	80	0.3000000
NODE_9474_length_878_cov_49.514763	410	490	23	27	80	0.3375000
NODE_9474_length_878_cov_49.514763	410	490	25	1	80	0.0125000
NODE_9474_length_878_cov_49.514763	410	490	26	12	80	0.1500000
NODE_9474_length_878_cov_49.514763	410	490	28	12	80	0.1500000
NODE_9474_length_878_cov_49.514763	463	543	18	3	80	0.0375000
NODE_9474_length_878_cov_49.514763	463	543	19	19	80	0.2375000
NODE_9474_length_878_cov_49.514763	463	543	20	2	80	0.0250000
NODE_9474_length_878_cov_49.514763	463	543	21	6	80	0.0750000
NODE_9474_length_878_cov_49.514763	463	543	22	2	80	0.0250000
NODE_9474_length_878_cov_49.514763	463	543	23	2	80	0.0250000
NODE_9474_length_878_cov_49.514763	463	543	25	1	80	0.0125000
NODE_9474_length_878_cov_49.514763	463	543	26	21	80	0.2625000
NODE_9474_length_878_cov_49.514763	463	543	27	1	80	0.0125000
NODE_9474_length_878_cov_49.514763	463	543	28	23	80	0.2875000
NODE_9475_length_878_cov_38.862644	365	445	3	10	80	0.1250000
NODE_9475_length_878_cov_38.862644	365	445	4	1	80	0.0125000
NODE_9475_length_878_cov_38.862644	365	445	5	26	80	0.3250000
NODE_9475_length_878_cov_38.862644	365	445	6	43	80	0.5375000
NODE_9475_length_878_cov_38.862644	418	498	3	6	80	0.0750000
NODE_9475_length_878_cov_38.862644	418	498	4	41	80	0.5125000
NODE_9475_length_878_cov_38.862644	418	498	5	20	80	0.2500000
NODE_9475_length_878_cov_38.862644	418	498	6	13	80	0.1625000
NODE_9476_length_878_cov_36.517330	346	426	0	80	80	1.0000000
NODE_9476_length_878_cov_36.517330	399	479	0	71	80	0.8875000
NODE_9476_length_878_cov_36.517330	399	479	1	9	80	0.1125000
NODE_9476_length_878_cov_36.517330	475	555	1	14	80	0.1750000
NODE_9476_length_878_cov_36.517330	475	555	2	3	80	0.0375000
NODE_9476_length_878_cov_36.517330	475	555	3	63	80	0.7875000
NODE_9476_length_878_cov_36.517330	528	608	3	72	80	0.9000000
NODE_9476_length_878_cov_36.517330	528	608	4	8	80	0.1000000
NODE_9477_length_878_cov_34.404365	627	707	15	4	80	0.0500000
NODE_9477_length_878_cov_34.404365	627	707	16	13	80	0.1625000
NODE_9477_length_878_cov_34.404365	627	707	18	4	80	0.0500000
NODE_9477_length_878_cov_34.404365	627	707	19	4	80	0.0500000
NODE_9477_length_878_cov_34.404365	627	707	20	6	80	0.0750000
NODE_9477_length_878_cov_34.404365	627	707	22	1	80	0.0125000
NODE_9477_length_878_cov_34.404365	627	707	23	17	80	0.2125000
NODE_9477_length_878_cov_34.404365	627	707	24	7	80	0.0875000
NODE_9477_length_878_cov_34.404365	627	707	26	1	80	0.0125000
NODE_9477_length_878_cov_34.404365	627	707	27	4	80	0.0500000
NODE_9477_length_878_cov_34.404365	627	707	30	12	80	0.1500000
NODE_9477_length_878_cov_34.404365	627	707	31	7	80	0.0875000
NODE_9477_length_878_cov_34.404365	627	695	15	4	68	0.0588235
NODE_9477_length_878_cov_34.404365	627	695	16	13	68	0.1911765
NODE_9477_length_878_cov_34.404365	627	695	18	4	68	0.0588235
NODE_9477_length_878_cov_34.404365	627	695	19	4	68	0.0588235
NODE_9477_length_878_cov_34.404365	627	695	20	6	68	0.0882353
NODE_9477_length_878_cov_34.404365	627	695	22	1	68	0.0147059
NODE_9477_length_878_cov_34.404365	627	695	23	17	68	0.2500000
NODE_9477_length_878_cov_34.404365	627	695	24	7	68	0.1029412
NODE_9477_length_878_cov_34.404365	627	695	26	1	68	0.0147059
NODE_9477_length_878_cov_34.404365	627	695	27	4	68	0.0588235
NODE_9477_length_878_cov_34.404365	627	695	30	7	68	0.1029412
NODE_9477_length_878_cov_34.404365	680	760	24	3	80	0.0375000
NODE_9477_length_878_cov_34.404365	680	760	25	5	80	0.0625000
NODE_9477_length_878_cov_34.404365	680	760	26	20	80	0.2500000
NODE_9477_length_878_cov_34.404365	680	760	27	11	80	0.1375000
NODE_9477_length_878_cov_34.404365	680	760	28	5	80	0.0625000
NODE_9477_length_878_cov_34.404365	680	760	29	11	80	0.1375000
NODE_9477_length_878_cov_34.404365	680	760	30	14	80	0.1750000
NODE_9477_length_878_cov_34.404365	680	760	31	9	80	0.1125000
NODE_9477_length_878_cov_34.404365	680	760	32	2	80	0.0250000
NODE_9478_length_878_cov_28.761232	467	547	2	48	80	0.6000000
NODE_9478_length_878_cov_28.761232	467	547	4	32	80	0.4000000
NODE_9478_length_878_cov_28.761232	520	600	2	26	80	0.3250000
NODE_9478_length_878_cov_28.761232	520	600	4	54	80	0.6750000
NODE_9479_length_878_cov_24.899872	316	396	0	80	80	1.0000000
NODE_9479_length_878_cov_24.899872	369	449	0	80	80	1.0000000
NODE_9479_length_878_cov_24.899872	445	525	0	80	80	1.0000000
NODE_9479_length_878_cov_24.899872	498	578	0	80	80	1.0000000
NODE_9480_length_878_cov_21.446727	377	457	4	57	80	0.7125000
NODE_9480_length_878_cov_21.446727	377	457	6	10	80	0.1250000
NODE_9480_length_878_cov_21.446727	377	457	7	2	80	0.0250000
NODE_9480_length_878_cov_21.446727	377	457	8	11	80	0.1375000
NODE_9480_length_878_cov_21.446727	430	510	0	20	80	0.2500000
NODE_9480_length_878_cov_21.446727	430	510	2	22	80	0.2750000
NODE_9480_length_878_cov_21.446727	430	510	4	38	80	0.4750000
NODE_9481_length_878_cov_20.553273	424	504	5	21	80	0.2625000
NODE_9481_length_878_cov_20.553273	424	504	6	22	80	0.2750000
NODE_9481_length_878_cov_20.553273	424	504	7	37	80	0.4625000
NODE_9481_length_878_cov_20.553273	477	557	2	11	80	0.1375000
NODE_9481_length_878_cov_20.553273	477	557	5	10	80	0.1250000
NODE_9481_length_878_cov_20.553273	477	557	6	54	80	0.6750000
NODE_9481_length_878_cov_20.553273	477	557	7	5	80	0.0625000
NODE_9482_length_878_cov_14.016688	214	294	0	80	80	1.0000000
NODE_9482_length_878_cov_14.016688	267	347	0	80	80	1.0000000
NODE_9483_length_878_cov_9.252888	423	503	0	40	80	0.5000000
NODE_9483_length_878_cov_9.252888	423	503	1	3	80	0.0375000
NODE_9483_length_878_cov_9.252888	423	503	2	37	80	0.4625000
NODE_9483_length_878_cov_9.252888	476	556	2	78	80	0.9750000
NODE_9483_length_878_cov_9.252888	476	556	3	2	80	0.0250000
NODE_9484_length_878_cov_8.695764	333	413	4	28	80	0.3500000
NODE_9484_length_878_cov_8.695764	333	413	5	21	80	0.2625000
NODE_9484_length_878_cov_8.695764	333	413	6	31	80	0.3875000
NODE_9484_length_878_cov_8.695764	386	466	2	41	80	0.5125000
NODE_9484_length_878_cov_8.695764	386	466	3	3	80	0.0375000
NODE_9484_length_878_cov_8.695764	386	466	4	20	80	0.2500000
NODE_9484_length_878_cov_8.695764	386	466	5	5	80	0.0625000
NODE_9484_length_878_cov_8.695764	386	466	6	11	80	0.1375000
NODE_9485_length_878_cov_6.686778	65	145	0	80	80	1.0000000
NODE_9485_length_878_cov_6.686778	118	198	0	80	80	1.0000000
NODE_9487_length_878_cov_6.328626	426	506	0	80	80	1.0000000
NODE_9487_length_878_cov_6.328626	479	559	0	80	80	1.0000000
NODE_9488_length_878_cov_5.771502	470	513	0	43	43	1.0000000
NODE_9490_length_878_cov_2.672657	499	579	2	80	80	1.0000000
NODE_9490_length_878_cov_2.672657	552	631	0	9	79	0.1139240
NODE_9490_length_878_cov_2.672657	552	631	1	33	79	0.4177215
NODE_9490_length_878_cov_2.672657	552	631	2	37	79	0.4683544
NODE_9507_length_877_cov_59.021851	324	404	15	2	80	0.0250000
NODE_9507_length_877_cov_59.021851	324	404	18	2	80	0.0250000
NODE_9507_length_877_cov_59.021851	324	404	20	18	80	0.2250000
NODE_9507_length_877_cov_59.021851	324	404	21	22	80	0.2750000
NODE_9507_length_877_cov_59.021851	324	404	22	14	80	0.1750000
NODE_9507_length_877_cov_59.021851	324	404	23	15	80	0.1875000
NODE_9507_length_877_cov_59.021851	324	404	24	2	80	0.0250000
NODE_9507_length_877_cov_59.021851	324	404	26	3	80	0.0375000
NODE_9507_length_877_cov_59.021851	324	404	27	2	80	0.0250000
NODE_9507_length_877_cov_59.021851	377	457	17	3	80	0.0375000
NODE_9507_length_877_cov_59.021851	377	457	18	1	80	0.0125000
NODE_9507_length_877_cov_59.021851	377	457	19	1	80	0.0125000
NODE_9507_length_877_cov_59.021851	377	457	21	26	80	0.3250000
NODE_9507_length_877_cov_59.021851	377	457	23	11	80	0.1375000
NODE_9507_length_877_cov_59.021851	377	457	24	9	80	0.1125000
NODE_9507_length_877_cov_59.021851	377	457	26	27	80	0.3375000
NODE_9507_length_877_cov_59.021851	377	457	27	2	80	0.0250000
NODE_9508_length_877_cov_54.422879	418	498	48	5	80	0.0625000
NODE_9508_length_877_cov_54.422879	418	498	51	23	80	0.2875000
NODE_9508_length_877_cov_54.422879	418	498	52	52	80	0.6500000
NODE_9508_length_877_cov_54.422879	471	551	31	30	80	0.3750000
NODE_9508_length_877_cov_54.422879	471	551	45	1	80	0.0125000
NODE_9508_length_877_cov_54.422879	471	551	51	31	80	0.3875000
NODE_9508_length_877_cov_54.422879	471	551	52	4	80	0.0500000
NODE_9508_length_877_cov_54.422879	471	551	53	1	80	0.0125000
NODE_9508_length_877_cov_54.422879	471	551	58	3	80	0.0375000
NODE_9508_length_877_cov_54.422879	471	551	60	2	80	0.0250000
NODE_9508_length_877_cov_54.422879	471	551	61	8	80	0.1000000
NODE_9509_length_877_cov_47.672237	451	527	2	7	76	0.0921053
NODE_9509_length_877_cov_47.672237	451	527	4	12	76	0.1578947
NODE_9509_length_877_cov_47.672237	451	527	6	6	76	0.0789474
NODE_9509_length_877_cov_47.672237	451	527	8	40	76	0.5263158
NODE_9509_length_877_cov_47.672237	451	527	9	11	76	0.1447368
NODE_9509_length_877_cov_47.672237	500	580	6	2	80	0.0250000
NODE_9509_length_877_cov_47.672237	500	580	8	27	80	0.3375000
NODE_9509_length_877_cov_47.672237	500	580	9	28	80	0.3500000
NODE_9509_length_877_cov_47.672237	500	580	10	23	80	0.2875000
NODE_9510_length_877_cov_29.884319	349	429	23	17	80	0.2125000
NODE_9510_length_877_cov_29.884319	349	429	24	2	80	0.0250000
NODE_9510_length_877_cov_29.884319	349	429	25	1	80	0.0125000
NODE_9510_length_877_cov_29.884319	349	429	26	20	80	0.2500000
NODE_9510_length_877_cov_29.884319	349	429	27	3	80	0.0375000
NODE_9510_length_877_cov_29.884319	349	429	28	34	80	0.4250000
NODE_9510_length_877_cov_29.884319	349	429	30	3	80	0.0375000
NODE_9510_length_877_cov_29.884319	402	482	14	3	80	0.0375000
NODE_9510_length_877_cov_29.884319	402	482	16	2	80	0.0250000
NODE_9510_length_877_cov_29.884319	402	482	18	6	80	0.0750000
NODE_9510_length_877_cov_29.884319	402	482	19	6	80	0.0750000
NODE_9510_length_877_cov_29.884319	402	482	22	4	80	0.0500000
NODE_9510_length_877_cov_29.884319	402	482	23	1	80	0.0125000
NODE_9510_length_877_cov_29.884319	402	482	24	9	80	0.1125000
NODE_9510_length_877_cov_29.884319	402	482	26	10	80	0.1250000
NODE_9510_length_877_cov_29.884319	402	482	27	6	80	0.0750000
NODE_9510_length_877_cov_29.884319	402	482	28	27	80	0.3375000
NODE_9510_length_877_cov_29.884319	402	482	29	2	80	0.0250000
NODE_9510_length_877_cov_29.884319	402	482	30	4	80	0.0500000
NODE_9511_length_877_cov_17.681234	423	503	2	80	80	1.0000000
NODE_9511_length_877_cov_17.681234	476	556	1	28	80	0.3500000
NODE_9511_length_877_cov_17.681234	476	556	2	52	80	0.6500000
NODE_9512_length_877_cov_17.520566	228	308	5	2	80	0.0250000
NODE_9512_length_877_cov_17.520566	228	308	6	39	80	0.4875000
NODE_9512_length_877_cov_17.520566	228	308	7	27	80	0.3375000
NODE_9512_length_877_cov_17.520566	228	308	9	12	80	0.1500000
NODE_9512_length_877_cov_17.520566	281	361	5	10	80	0.1250000
NODE_9512_length_877_cov_17.520566	281	361	7	52	80	0.6500000
NODE_9512_length_877_cov_17.520566	281	361	8	18	80	0.2250000
NODE_9513_length_877_cov_17.374036	362	442	16	6	80	0.0750000
NODE_9513_length_877_cov_17.374036	362	442	19	9	80	0.1125000
NODE_9513_length_877_cov_17.374036	362	442	21	41	80	0.5125000
NODE_9513_length_877_cov_17.374036	362	442	22	2	80	0.0250000
NODE_9513_length_877_cov_17.374036	362	442	24	4	80	0.0500000
NODE_9513_length_877_cov_17.374036	362	442	25	3	80	0.0375000
NODE_9513_length_877_cov_17.374036	362	442	26	3	80	0.0375000
NODE_9513_length_877_cov_17.374036	362	442	28	12	80	0.1500000
NODE_9513_length_877_cov_17.374036	415	495	17	8	80	0.1000000
NODE_9513_length_877_cov_17.374036	415	495	19	24	80	0.3000000
NODE_9513_length_877_cov_17.374036	415	495	21	3	80	0.0375000
NODE_9513_length_877_cov_17.374036	415	495	22	2	80	0.0250000
NODE_9513_length_877_cov_17.374036	415	495	23	21	80	0.2625000
NODE_9513_length_877_cov_17.374036	415	495	24	4	80	0.0500000
NODE_9513_length_877_cov_17.374036	415	495	25	3	80	0.0375000
NODE_9513_length_877_cov_17.374036	415	495	26	3	80	0.0375000
NODE_9513_length_877_cov_17.374036	415	495	28	12	80	0.1500000
NODE_9515_length_877_cov_9.320051	395	475	5	36	80	0.4500000
NODE_9515_length_877_cov_9.320051	395	475	7	44	80	0.5500000
NODE_9515_length_877_cov_9.320051	448	528	0	3	80	0.0375000
NODE_9515_length_877_cov_9.320051	448	528	2	10	80	0.1250000
NODE_9515_length_877_cov_9.320051	448	528	4	1	80	0.0125000
NODE_9515_length_877_cov_9.320051	448	528	6	1	80	0.0125000
NODE_9515_length_877_cov_9.320051	448	528	7	65	80	0.8125000
NODE_9517_length_877_cov_6.755784	222	302	19	11	80	0.1375000
NODE_9517_length_877_cov_6.755784	222	302	20	39	80	0.4875000
NODE_9517_length_877_cov_6.755784	222	302	21	12	80	0.1500000
NODE_9517_length_877_cov_6.755784	222	302	23	18	80	0.2250000
NODE_9517_length_877_cov_6.755784	275	354	6	12	79	0.1518987
NODE_9517_length_877_cov_6.755784	275	354	8	3	79	0.0379747
NODE_9517_length_877_cov_6.755784	275	354	10	33	79	0.4177215
NODE_9517_length_877_cov_6.755784	275	354	19	9	79	0.1139240
NODE_9517_length_877_cov_6.755784	275	354	23	22	79	0.2784810
NODE_9537_length_876_cov_46.021879	389	469	0	80	80	1.0000000
NODE_9537_length_876_cov_46.021879	442	522	0	32	80	0.4000000
NODE_9537_length_876_cov_46.021879	442	522	9	48	80	0.6000000
NODE_9538_length_876_cov_34.441441	379	459	15	8	80	0.1000000
NODE_9538_length_876_cov_34.441441	379	459	16	25	80	0.3125000
NODE_9538_length_876_cov_34.441441	379	459	17	47	80	0.5875000
NODE_9538_length_876_cov_34.441441	432	512	13	37	80	0.4625000
NODE_9538_length_876_cov_34.441441	432	512	15	3	80	0.0375000
NODE_9538_length_876_cov_34.441441	432	512	17	40	80	0.5000000
NODE_9539_length_876_cov_30.742600	344	424	5	3	80	0.0375000
NODE_9539_length_876_cov_30.742600	344	424	7	8	80	0.1000000
NODE_9539_length_876_cov_30.742600	344	424	9	8	80	0.1000000
NODE_9539_length_876_cov_30.742600	344	424	11	2	80	0.0250000
NODE_9539_length_876_cov_30.742600	344	424	13	8	80	0.1000000
NODE_9539_length_876_cov_30.742600	344	424	14	16	80	0.2000000
NODE_9539_length_876_cov_30.742600	344	424	15	4	80	0.0500000
NODE_9539_length_876_cov_30.742600	344	424	16	13	80	0.1625000
NODE_9539_length_876_cov_30.742600	344	424	18	11	80	0.1375000
NODE_9539_length_876_cov_30.742600	344	424	20	7	80	0.0875000
NODE_9539_length_876_cov_30.742600	397	477	14	3	80	0.0375000
NODE_9539_length_876_cov_30.742600	397	477	15	4	80	0.0500000
NODE_9539_length_876_cov_30.742600	397	477	16	2	80	0.0250000
NODE_9539_length_876_cov_30.742600	397	477	18	11	80	0.1375000
NODE_9539_length_876_cov_30.742600	397	477	20	19	80	0.2375000
NODE_9539_length_876_cov_30.742600	397	477	22	4	80	0.0500000
NODE_9539_length_876_cov_30.742600	397	477	23	8	80	0.1000000
NODE_9539_length_876_cov_30.742600	397	477	24	20	80	0.2500000
NODE_9539_length_876_cov_30.742600	397	477	25	9	80	0.1125000
NODE_9540_length_876_cov_28.476190	345	425	9	21	80	0.2625000
NODE_9540_length_876_cov_28.476190	345	425	10	25	80	0.3125000
NODE_9540_length_876_cov_28.476190	345	425	11	34	80	0.4250000
NODE_9540_length_876_cov_28.476190	398	478	4	15	80	0.1875000
NODE_9540_length_876_cov_28.476190	398	478	6	1	80	0.0125000
NODE_9540_length_876_cov_28.476190	398	478	7	13	80	0.1625000
NODE_9540_length_876_cov_28.476190	398	478	8	13	80	0.1625000
NODE_9540_length_876_cov_28.476190	398	478	11	32	80	0.4000000
NODE_9540_length_876_cov_28.476190	398	478	13	6	80	0.0750000
NODE_9541_length_876_cov_22.722008	324	404	0	80	80	1.0000000
NODE_9541_length_876_cov_22.722008	377	457	0	80	80	1.0000000
NODE_9542_length_876_cov_17.458172	367	447	9	6	80	0.0750000
NODE_9542_length_876_cov_17.458172	367	447	10	6	80	0.0750000
NODE_9542_length_876_cov_17.458172	367	447	11	68	80	0.8500000
NODE_9542_length_876_cov_17.458172	420	500	2	27	80	0.3375000
NODE_9542_length_876_cov_17.458172	420	500	3	3	80	0.0375000
NODE_9542_length_876_cov_17.458172	420	500	4	1	80	0.0125000
NODE_9542_length_876_cov_17.458172	420	500	5	4	80	0.0500000
NODE_9542_length_876_cov_17.458172	420	500	7	10	80	0.1250000
NODE_9542_length_876_cov_17.458172	420	500	8	2	80	0.0250000
NODE_9542_length_876_cov_17.458172	420	500	9	12	80	0.1500000
NODE_9542_length_876_cov_17.458172	420	500	10	4	80	0.0500000
NODE_9542_length_876_cov_17.458172	420	500	11	17	80	0.2125000
NODE_9561_length_875_cov_52.965206	190	270	2	4	80	0.0500000
NODE_9561_length_875_cov_52.965206	190	270	3	16	80	0.2000000
NODE_9561_length_875_cov_52.965206	190	270	4	2	80	0.0250000
NODE_9561_length_875_cov_52.965206	190	270	8	15	80	0.1875000
NODE_9561_length_875_cov_52.965206	190	270	10	28	80	0.3500000
NODE_9561_length_875_cov_52.965206	190	270	11	12	80	0.1500000
NODE_9561_length_875_cov_52.965206	190	270	13	3	80	0.0375000
NODE_9561_length_875_cov_52.965206	243	323	10	21	80	0.2625000
NODE_9561_length_875_cov_52.965206	243	323	11	3	80	0.0375000
NODE_9561_length_875_cov_52.965206	243	323	13	19	80	0.2375000
NODE_9561_length_875_cov_52.965206	243	323	17	27	80	0.3375000
NODE_9561_length_875_cov_52.965206	243	323	18	4	80	0.0500000
NODE_9561_length_875_cov_52.965206	243	323	19	6	80	0.0750000
NODE_9561_length_875_cov_52.965206	319	399	16	9	80	0.1125000
NODE_9561_length_875_cov_52.965206	319	399	17	33	80	0.4125000
NODE_9561_length_875_cov_52.965206	319	399	18	25	80	0.3125000
NODE_9561_length_875_cov_52.965206	319	399	19	9	80	0.1125000
NODE_9561_length_875_cov_52.965206	319	399	20	4	80	0.0500000
NODE_9561_length_875_cov_52.965206	372	447	10	7	75	0.0933333
NODE_9561_length_875_cov_52.965206	372	447	11	2	75	0.0266667
NODE_9561_length_875_cov_52.965206	372	447	12	7	75	0.0933333
NODE_9561_length_875_cov_52.965206	372	447	16	22	75	0.2933333
NODE_9561_length_875_cov_52.965206	372	447	17	2	75	0.0266667
NODE_9561_length_875_cov_52.965206	372	447	18	28	75	0.3733333
NODE_9561_length_875_cov_52.965206	372	447	19	4	75	0.0533333
NODE_9561_length_875_cov_52.965206	372	447	20	3	75	0.0400000
NODE_9562_length_875_cov_35.634021	260	340	0	34	80	0.4250000
NODE_9562_length_875_cov_35.634021	260	340	1	15	80	0.1875000
NODE_9562_length_875_cov_35.634021	260	340	2	31	80	0.3875000
NODE_9562_length_875_cov_35.634021	313	393	2	42	80	0.5250000
NODE_9562_length_875_cov_35.634021	313	393	3	13	80	0.1625000
NODE_9562_length_875_cov_35.634021	313	393	4	25	80	0.3125000
NODE_9562_length_875_cov_35.634021	389	469	4	8	80	0.1000000
NODE_9562_length_875_cov_35.634021	389	469	6	10	80	0.1250000
NODE_9562_length_875_cov_35.634021	389	469	7	15	80	0.1875000
NODE_9562_length_875_cov_35.634021	389	469	8	47	80	0.5875000
NODE_9562_length_875_cov_35.634021	442	522	4	4	80	0.0500000
NODE_9562_length_875_cov_35.634021	442	522	5	13	80	0.1625000
NODE_9562_length_875_cov_35.634021	442	522	6	46	80	0.5750000
NODE_9562_length_875_cov_35.634021	442	522	7	15	80	0.1875000
NODE_9562_length_875_cov_35.634021	442	522	8	2	80	0.0250000
NODE_9563_length_875_cov_33.771907	363	441	1	10	78	0.1282051
NODE_9563_length_875_cov_33.771907	363	441	3	7	78	0.0897436
NODE_9563_length_875_cov_33.771907	363	441	5	6	78	0.0769231
NODE_9563_length_875_cov_33.771907	363	441	7	1	78	0.0128205
NODE_9563_length_875_cov_33.771907	363	441	8	13	78	0.1666667
NODE_9563_length_875_cov_33.771907	363	441	9	1	78	0.0128205
NODE_9563_length_875_cov_33.771907	363	441	10	40	78	0.5128205
NODE_9563_length_875_cov_33.771907	414	494	10	33	80	0.4125000
NODE_9563_length_875_cov_33.771907	414	494	11	15	80	0.1875000
NODE_9563_length_875_cov_33.771907	414	494	12	14	80	0.1750000
NODE_9563_length_875_cov_33.771907	414	494	15	1	80	0.0125000
NODE_9563_length_875_cov_33.771907	414	494	24	5	80	0.0625000
NODE_9563_length_875_cov_33.771907	414	494	25	12	80	0.1500000
NODE_9564_length_875_cov_29.698454	322	402	3	5	80	0.0625000
NODE_9564_length_875_cov_29.698454	322	402	4	9	80	0.1125000
NODE_9564_length_875_cov_29.698454	322	402	7	7	80	0.0875000
NODE_9564_length_875_cov_29.698454	322	402	8	41	80	0.5125000
NODE_9564_length_875_cov_29.698454	322	402	9	18	80	0.2250000
NODE_9564_length_875_cov_29.698454	375	455	8	32	80	0.4000000
NODE_9564_length_875_cov_29.698454	375	455	9	28	80	0.3500000
NODE_9564_length_875_cov_29.698454	375	455	10	20	80	0.2500000
NODE_9565_length_875_cov_23.041237	364	444	6	5	80	0.0625000
NODE_9565_length_875_cov_23.041237	364	444	7	37	80	0.4625000
NODE_9565_length_875_cov_23.041237	364	444	8	35	80	0.4375000
NODE_9565_length_875_cov_23.041237	364	444	9	3	80	0.0375000
NODE_9565_length_875_cov_23.041237	417	497	5	17	80	0.2125000
NODE_9565_length_875_cov_23.041237	417	497	7	22	80	0.2750000
NODE_9565_length_875_cov_23.041237	417	497	8	3	80	0.0375000
NODE_9565_length_875_cov_23.041237	417	497	9	31	80	0.3875000
NODE_9565_length_875_cov_23.041237	417	497	10	7	80	0.0875000
NODE_9565_length_875_cov_23.041237	493	573	5	41	80	0.5125000
NODE_9565_length_875_cov_23.041237	493	573	6	10	80	0.1250000
NODE_9565_length_875_cov_23.041237	493	573	8	29	80	0.3625000
NODE_9565_length_875_cov_23.041237	546	626	3	24	80	0.3000000
NODE_9565_length_875_cov_23.041237	546	626	4	10	80	0.1250000
NODE_9565_length_875_cov_23.041237	546	626	5	1	80	0.0125000
NODE_9565_length_875_cov_23.041237	546	626	6	28	80	0.3500000
NODE_9565_length_875_cov_23.041237	546	626	8	17	80	0.2125000
NODE_9566_length_875_cov_9.800258	242	322	5	19	80	0.2375000
NODE_9566_length_875_cov_9.800258	242	322	6	14	80	0.1750000
NODE_9566_length_875_cov_9.800258	242	322	7	20	80	0.2500000
NODE_9566_length_875_cov_9.800258	242	322	8	27	80	0.3375000
NODE_9566_length_875_cov_9.800258	295	376	4	6	81	0.0740741
NODE_9566_length_875_cov_9.800258	295	376	6	62	81	0.7654321
NODE_9566_length_875_cov_9.800258	295	376	8	13	81	0.1604938
NODE_9567_length_875_cov_8.195876	407	487	0	42	80	0.5250000
NODE_9567_length_875_cov_8.195876	407	487	1	38	80	0.4750000
NODE_9567_length_875_cov_8.195876	460	540	1	80	80	1.0000000
NODE_9585_length_874_cov_48.925161	185	265	13	1	80	0.0125000
NODE_9585_length_874_cov_48.925161	185	265	14	3	80	0.0375000
NODE_9585_length_874_cov_48.925161	185	265	16	7	80	0.0875000
NODE_9585_length_874_cov_48.925161	185	265	18	19	80	0.2375000
NODE_9585_length_874_cov_48.925161	185	265	19	1	80	0.0125000
NODE_9585_length_874_cov_48.925161	185	265	20	9	80	0.1125000
NODE_9585_length_874_cov_48.925161	185	265	21	19	80	0.2375000
NODE_9585_length_874_cov_48.925161	185	265	22	14	80	0.1750000
NODE_9585_length_874_cov_48.925161	185	265	23	5	80	0.0625000
NODE_9585_length_874_cov_48.925161	185	265	24	1	80	0.0125000
NODE_9585_length_874_cov_48.925161	185	265	25	1	80	0.0125000
NODE_9585_length_874_cov_48.925161	238	318	21	13	80	0.1625000
NODE_9585_length_874_cov_48.925161	238	318	22	12	80	0.1500000
NODE_9585_length_874_cov_48.925161	238	318	23	15	80	0.1875000
NODE_9585_length_874_cov_48.925161	238	318	24	24	80	0.3000000
NODE_9585_length_874_cov_48.925161	238	318	25	2	80	0.0250000
NODE_9585_length_874_cov_48.925161	238	318	26	14	80	0.1750000
NODE_9587_length_874_cov_37.354839	199	279	2	23	80	0.2875000
NODE_9587_length_874_cov_37.354839	199	279	3	57	80	0.7125000
NODE_9587_length_874_cov_37.354839	252	332	1	10	80	0.1250000
NODE_9587_length_874_cov_37.354839	252	332	2	27	80	0.3375000
NODE_9587_length_874_cov_37.354839	252	332	3	43	80	0.5375000
NODE_9588_length_874_cov_35.040000	231	311	4	11	80	0.1375000
NODE_9588_length_874_cov_35.040000	231	311	6	56	80	0.7000000
NODE_9588_length_874_cov_35.040000	231	311	8	13	80	0.1625000
NODE_9588_length_874_cov_35.040000	284	364	4	15	80	0.1875000
NODE_9588_length_874_cov_35.040000	284	364	6	65	80	0.8125000
NODE_9589_length_874_cov_23.415484	327	407	0	80	80	1.0000000
NODE_9589_length_874_cov_23.415484	380	460	0	80	80	1.0000000
NODE_9589_length_874_cov_23.415484	456	536	0	80	80	1.0000000
NODE_9589_length_874_cov_23.415484	509	589	0	80	80	1.0000000
NODE_9590_length_874_cov_21.885161	279	359	8	12	80	0.1500000
NODE_9590_length_874_cov_21.885161	279	359	9	9	80	0.1125000
NODE_9590_length_874_cov_21.885161	279	359	11	57	80	0.7125000
NODE_9590_length_874_cov_21.885161	279	359	12	2	80	0.0250000
NODE_9590_length_874_cov_21.885161	332	412	6	10	80	0.1250000
NODE_9590_length_874_cov_21.885161	332	412	8	10	80	0.1250000
NODE_9590_length_874_cov_21.885161	332	412	9	7	80	0.0875000
NODE_9590_length_874_cov_21.885161	332	412	11	25	80	0.3125000
NODE_9590_length_874_cov_21.885161	332	412	12	28	80	0.3500000
NODE_9591_length_874_cov_11.172903	67	147	6	14	80	0.1750000
NODE_9591_length_874_cov_11.172903	67	147	9	50	80	0.6250000
NODE_9591_length_874_cov_11.172903	67	147	10	16	80	0.2000000
NODE_9591_length_874_cov_11.172903	120	200	5	3	80	0.0375000
NODE_9591_length_874_cov_11.172903	120	200	6	18	80	0.2250000
NODE_9591_length_874_cov_11.172903	120	200	7	6	80	0.0750000
NODE_9591_length_874_cov_11.172903	120	200	8	20	80	0.2500000
NODE_9591_length_874_cov_11.172903	120	200	9	11	80	0.1375000
NODE_9591_length_874_cov_11.172903	120	200	10	22	80	0.2750000
NODE_9592_length_874_cov_9.645161	424	504	0	42	80	0.5250000
NODE_9592_length_874_cov_9.645161	424	504	1	29	80	0.3625000
NODE_9592_length_874_cov_9.645161	424	504	2	9	80	0.1125000
NODE_9592_length_874_cov_9.645161	477	557	1	18	80	0.2250000
NODE_9592_length_874_cov_9.645161	477	557	2	62	80	0.7750000
NODE_9593_length_874_cov_8.637419	359	439	7	17	80	0.2125000
NODE_9593_length_874_cov_8.637419	359	439	8	63	80	0.7875000
NODE_9593_length_874_cov_8.637419	412	499	6	22	87	0.2528736
NODE_9593_length_874_cov_8.637419	412	499	7	14	87	0.1609195
NODE_9593_length_874_cov_8.637419	412	499	8	42	87	0.4827586
NODE_9593_length_874_cov_8.637419	412	499	9	9	87	0.1034483
NODE_9596_length_874_cov_4.785806	829	874	1	45	45	1.0000000
NODE_9618_length_873_cov_100.625323	50	130	5	80	80	1.0000000
NODE_9619_length_873_cov_45.633075	226	306	8	8	80	0.1000000
NODE_9619_length_873_cov_45.633075	226	306	9	4	80	0.0500000
NODE_9619_length_873_cov_45.633075	226	306	10	32	80	0.4000000
NODE_9619_length_873_cov_45.633075	226	306	11	36	80	0.4500000
NODE_9619_length_873_cov_45.633075	279	359	8	1	80	0.0125000
NODE_9619_length_873_cov_45.633075	279	359	9	37	80	0.4625000
NODE_9619_length_873_cov_45.633075	279	359	10	32	80	0.4000000
NODE_9619_length_873_cov_45.633075	279	359	12	10	80	0.1250000
NODE_9619_length_873_cov_45.633075	693	773	5	80	80	1.0000000
NODE_9619_length_873_cov_45.633075	746	826	0	34	80	0.4250000
NODE_9619_length_873_cov_45.633075	746	826	4	1	80	0.0125000
NODE_9619_length_873_cov_45.633075	746	826	5	45	80	0.5625000
NODE_9620_length_873_cov_39.224806	190	270	2	80	80	1.0000000
NODE_9620_length_873_cov_39.224806	243	307	1	10	64	0.1562500
NODE_9620_length_873_cov_39.224806	243	307	2	54	64	0.8437500
NODE_9620_length_873_cov_39.224806	390	470	3	26	80	0.3250000
NODE_9620_length_873_cov_39.224806	390	470	4	22	80	0.2750000
NODE_9620_length_873_cov_39.224806	390	470	5	32	80	0.4000000
NODE_9620_length_873_cov_39.224806	443	523	2	47	80	0.5875000
NODE_9620_length_873_cov_39.224806	443	523	3	1	80	0.0125000
NODE_9620_length_873_cov_39.224806	443	523	4	26	80	0.3250000
NODE_9620_length_873_cov_39.224806	443	523	5	6	80	0.0750000
NODE_9620_length_873_cov_39.224806	504	523	2	19	19	1.0000000
NODE_9620_length_873_cov_39.224806	519	599	1	33	80	0.4125000
NODE_9620_length_873_cov_39.224806	519	599	2	15	80	0.1875000
NODE_9620_length_873_cov_39.224806	519	599	3	32	80	0.4000000
NODE_9620_length_873_cov_39.224806	572	652	0	44	80	0.5500000
NODE_9620_length_873_cov_39.224806	572	652	1	36	80	0.4500000
NODE_9621_length_873_cov_27.992248	372	452	2	80	80	1.0000000
NODE_9621_length_873_cov_27.992248	425	505	1	40	80	0.5000000
NODE_9621_length_873_cov_27.992248	425	505	2	40	80	0.5000000
NODE_9622_length_873_cov_23.270026	390	470	4	22	80	0.2750000
NODE_9622_length_873_cov_23.270026	390	470	5	10	80	0.1250000
NODE_9622_length_873_cov_23.270026	390	470	6	2	80	0.0250000
NODE_9622_length_873_cov_23.270026	390	470	7	46	80	0.5750000
NODE_9622_length_873_cov_23.270026	443	528	5	7	85	0.0823529
NODE_9622_length_873_cov_23.270026	443	528	7	58	85	0.6823530
NODE_9622_length_873_cov_23.270026	443	528	8	20	85	0.2352941
NODE_9623_length_873_cov_23.197674	293	373	11	20	80	0.2500000
NODE_9623_length_873_cov_23.197674	293	373	12	18	80	0.2250000
NODE_9623_length_873_cov_23.197674	293	373	13	9	80	0.1125000
NODE_9623_length_873_cov_23.197674	293	373	14	17	80	0.2125000
NODE_9623_length_873_cov_23.197674	293	373	15	7	80	0.0875000
NODE_9623_length_873_cov_23.197674	293	373	17	9	80	0.1125000
NODE_9623_length_873_cov_23.197674	346	426	12	8	80	0.1000000
NODE_9623_length_873_cov_23.197674	346	426	14	44	80	0.5500000
NODE_9623_length_873_cov_23.197674	346	426	15	14	80	0.1750000
NODE_9623_length_873_cov_23.197674	346	426	16	5	80	0.0625000
NODE_9623_length_873_cov_23.197674	346	426	17	9	80	0.1125000
NODE_9624_length_873_cov_20.432817	347	427	1	11	80	0.1375000
NODE_9624_length_873_cov_20.432817	347	427	2	12	80	0.1500000
NODE_9624_length_873_cov_20.432817	347	427	3	10	80	0.1250000
NODE_9624_length_873_cov_20.432817	347	427	4	6	80	0.0750000
NODE_9624_length_873_cov_20.432817	347	427	5	41	80	0.5125000
NODE_9624_length_873_cov_20.432817	400	480	5	55	80	0.6875000
NODE_9624_length_873_cov_20.432817	400	480	6	25	80	0.3125000
NODE_9624_length_873_cov_20.432817	476	556	4	22	80	0.2750000
NODE_9624_length_873_cov_20.432817	476	556	5	29	80	0.3625000
NODE_9624_length_873_cov_20.432817	476	556	6	29	80	0.3625000
NODE_9624_length_873_cov_20.432817	529	609	4	39	80	0.4875000
NODE_9624_length_873_cov_20.432817	529	609	5	40	80	0.5000000
NODE_9624_length_873_cov_20.432817	529	609	6	1	80	0.0125000
NODE_9625_length_873_cov_19.913437	445	525	4	80	80	1.0000000
NODE_9625_length_873_cov_19.913437	498	578	1	3	80	0.0375000
NODE_9625_length_873_cov_19.913437	498	578	2	3	80	0.0375000
NODE_9625_length_873_cov_19.913437	498	578	3	44	80	0.5500000
NODE_9625_length_873_cov_19.913437	498	578	4	30	80	0.3750000
NODE_9626_length_873_cov_16.718346	276	356	1	10	80	0.1250000
NODE_9626_length_873_cov_16.718346	276	356	2	15	80	0.1875000
NODE_9626_length_873_cov_16.718346	276	356	5	18	80	0.2250000
NODE_9626_length_873_cov_16.718346	276	356	6	37	80	0.4625000
NODE_9626_length_873_cov_16.718346	329	409	5	18	80	0.2250000
NODE_9626_length_873_cov_16.718346	329	409	6	62	80	0.7750000
NODE_9627_length_873_cov_16.422481	423	503	7	8	80	0.1000000
NODE_9627_length_873_cov_16.422481	423	503	8	12	80	0.1500000
NODE_9627_length_873_cov_16.422481	423	503	9	34	80	0.4250000
NODE_9627_length_873_cov_16.422481	423	503	10	26	80	0.3250000
NODE_9627_length_873_cov_16.422481	476	556	7	44	80	0.5500000
NODE_9627_length_873_cov_16.422481	476	556	8	17	80	0.2125000
NODE_9627_length_873_cov_16.422481	476	556	9	19	80	0.2375000
NODE_9628_length_873_cov_11.198966	410	490	2	65	80	0.8125000
NODE_9628_length_873_cov_11.198966	410	490	3	1	80	0.0125000
NODE_9628_length_873_cov_11.198966	410	490	4	11	80	0.1375000
NODE_9628_length_873_cov_11.198966	410	490	5	3	80	0.0375000
NODE_9628_length_873_cov_11.198966	463	543	2	24	80	0.3000000
NODE_9628_length_873_cov_11.198966	463	543	5	56	80	0.7000000
NODE_9629_length_873_cov_9.799742	334	414	3	9	80	0.1125000
NODE_9629_length_873_cov_9.799742	334	414	7	27	80	0.3375000
NODE_9629_length_873_cov_9.799742	334	414	10	10	80	0.1250000
NODE_9629_length_873_cov_9.799742	334	414	11	34	80	0.4250000
NODE_9629_length_873_cov_9.799742	387	467	11	50	80	0.6250000
NODE_9629_length_873_cov_9.799742	387	467	12	1	80	0.0125000
NODE_9629_length_873_cov_9.799742	387	467	13	19	80	0.2375000
NODE_9629_length_873_cov_9.799742	387	467	14	7	80	0.0875000
NODE_9629_length_873_cov_9.799742	387	467	16	3	80	0.0375000
NODE_9632_length_873_cov_3.828165	490	570	0	80	80	1.0000000
NODE_9632_length_873_cov_3.828165	543	583	0	40	40	1.0000000
NODE_9632_length_873_cov_3.828165	690	735	0	45	45	1.0000000
NODE_9633_length_873_cov_3.443152	716	746	0	30	30	1.0000000
NODE_9647_length_873_cov_1.239018	593	658	0	65	65	1.0000000
NODE_9651_length_872_cov_47.732212	432	512	9	1	80	0.0125000
NODE_9651_length_872_cov_47.732212	432	512	10	37	80	0.4625000
NODE_9651_length_872_cov_47.732212	432	512	11	12	80	0.1500000
NODE_9651_length_872_cov_47.732212	432	512	12	25	80	0.3125000
NODE_9651_length_872_cov_47.732212	432	512	14	5	80	0.0625000
NODE_9651_length_872_cov_47.732212	484	564	7	36	80	0.4500000
NODE_9651_length_872_cov_47.732212	484	564	8	2	80	0.0250000
NODE_9651_length_872_cov_47.732212	484	564	9	10	80	0.1250000
NODE_9651_length_872_cov_47.732212	484	564	10	2	80	0.0250000
NODE_9651_length_872_cov_47.732212	484	564	11	12	80	0.1500000
NODE_9651_length_872_cov_47.732212	484	564	12	18	80	0.2250000
NODE_9651_length_872_cov_47.732212	560	640	5	10	80	0.1250000
NODE_9651_length_872_cov_47.732212	560	640	7	11	80	0.1375000
NODE_9651_length_872_cov_47.732212	560	640	8	53	80	0.6625000
NODE_9651_length_872_cov_47.732212	560	640	9	6	80	0.0750000
NODE_9651_length_872_cov_47.732212	613	693	4	40	80	0.5000000
NODE_9651_length_872_cov_47.732212	613	693	5	23	80	0.2875000
NODE_9651_length_872_cov_47.732212	613	693	8	17	80	0.2125000
NODE_9652_length_872_cov_16.204398	349	429	1	80	80	1.0000000
NODE_9652_length_872_cov_16.204398	402	482	1	32	80	0.4000000
NODE_9652_length_872_cov_16.204398	402	482	2	48	80	0.6000000
NODE_9652_length_872_cov_16.204398	478	558	1	79	80	0.9875000
NODE_9652_length_872_cov_16.204398	478	558	2	1	80	0.0125000
NODE_9652_length_872_cov_16.204398	531	611	0	30	80	0.3750000
NODE_9652_length_872_cov_16.204398	531	611	1	50	80	0.6250000
NODE_9653_length_872_cov_12.835705	376	456	1	23	80	0.2875000
NODE_9653_length_872_cov_12.835705	376	456	2	16	80	0.2000000
NODE_9653_length_872_cov_12.835705	376	456	3	41	80	0.5125000
NODE_9653_length_872_cov_12.835705	429	509	3	80	80	1.0000000
NODE_9654_length_872_cov_9.657180	356	431	0	75	75	1.0000000
NODE_9660_length_872_cov_3.531695	425	505	5	26	80	0.3250000
NODE_9660_length_872_cov_3.531695	425	505	6	32	80	0.4000000
NODE_9660_length_872_cov_3.531695	425	505	7	22	80	0.2750000
NODE_9660_length_872_cov_3.531695	478	559	1	1	81	0.0123457
NODE_9660_length_872_cov_3.531695	478	559	3	8	81	0.0987654
NODE_9660_length_872_cov_3.531695	478	559	5	71	81	0.8765432
NODE_9660_length_872_cov_3.531695	478	559	7	1	81	0.0123457
NODE_9673_length_871_cov_56.841969	265	345	5	11	80	0.1375000
NODE_9673_length_871_cov_56.841969	265	345	6	27	80	0.3375000
NODE_9673_length_871_cov_56.841969	265	345	7	15	80	0.1875000
NODE_9673_length_871_cov_56.841969	265	345	8	4	80	0.0500000
NODE_9673_length_871_cov_56.841969	265	345	9	9	80	0.1125000
NODE_9673_length_871_cov_56.841969	265	345	14	1	80	0.0125000
NODE_9673_length_871_cov_56.841969	265	345	15	13	80	0.1625000
NODE_9673_length_871_cov_56.841969	318	398	8	4	80	0.0500000
NODE_9673_length_871_cov_56.841969	318	398	9	9	80	0.1125000
NODE_9673_length_871_cov_56.841969	318	398	13	16	80	0.2000000
NODE_9673_length_871_cov_56.841969	318	398	14	8	80	0.1000000
NODE_9673_length_871_cov_56.841969	318	398	15	24	80	0.3000000
NODE_9673_length_871_cov_56.841969	318	398	16	13	80	0.1625000
NODE_9673_length_871_cov_56.841969	318	398	17	6	80	0.0750000
NODE_9673_length_871_cov_56.841969	394	474	16	3	80	0.0375000
NODE_9673_length_871_cov_56.841969	394	474	17	11	80	0.1375000
NODE_9673_length_871_cov_56.841969	394	474	18	20	80	0.2500000
NODE_9673_length_871_cov_56.841969	394	474	19	4	80	0.0500000
NODE_9673_length_871_cov_56.841969	394	474	20	7	80	0.0875000
NODE_9673_length_871_cov_56.841969	394	474	21	35	80	0.4375000
NODE_9673_length_871_cov_56.841969	447	527	13	8	80	0.1000000
NODE_9673_length_871_cov_56.841969	447	527	18	7	80	0.0875000
NODE_9673_length_871_cov_56.841969	447	527	19	9	80	0.1125000
NODE_9673_length_871_cov_56.841969	447	527	20	6	80	0.0750000
NODE_9673_length_871_cov_56.841969	447	527	21	19	80	0.2375000
NODE_9673_length_871_cov_56.841969	447	527	22	5	80	0.0625000
NODE_9673_length_871_cov_56.841969	447	527	25	3	80	0.0375000
NODE_9673_length_871_cov_56.841969	447	527	26	23	80	0.2875000
NODE_9674_length_871_cov_47.528497	461	541	2	41	80	0.5125000
NODE_9674_length_871_cov_47.528497	461	541	3	39	80	0.4875000
NODE_9674_length_871_cov_47.528497	514	594	2	65	80	0.8125000
NODE_9674_length_871_cov_47.528497	514	594	3	15	80	0.1875000
NODE_9675_length_871_cov_31.145078	326	406	17	6	80	0.0750000
NODE_9675_length_871_cov_31.145078	326	406	18	2	80	0.0250000
NODE_9675_length_871_cov_31.145078	326	406	19	6	80	0.0750000
NODE_9675_length_871_cov_31.145078	326	406	21	17	80	0.2125000
NODE_9675_length_871_cov_31.145078	326	406	22	16	80	0.2000000
NODE_9675_length_871_cov_31.145078	326	406	23	4	80	0.0500000
NODE_9675_length_871_cov_31.145078	326	406	24	12	80	0.1500000
NODE_9675_length_871_cov_31.145078	326	406	25	5	80	0.0625000
NODE_9675_length_871_cov_31.145078	326	406	26	2	80	0.0250000
NODE_9675_length_871_cov_31.145078	326	406	28	6	80	0.0750000
NODE_9675_length_871_cov_31.145078	326	406	31	4	80	0.0500000
NODE_9675_length_871_cov_31.145078	379	459	23	4	80	0.0500000
NODE_9675_length_871_cov_31.145078	379	459	24	6	80	0.0750000
NODE_9675_length_871_cov_31.145078	379	459	25	5	80	0.0625000
NODE_9675_length_871_cov_31.145078	379	459	26	4	80	0.0500000
NODE_9675_length_871_cov_31.145078	379	459	27	6	80	0.0750000
NODE_9675_length_871_cov_31.145078	379	459	28	22	80	0.2750000
NODE_9675_length_871_cov_31.145078	379	459	29	3	80	0.0375000
NODE_9675_length_871_cov_31.145078	379	459	30	15	80	0.1875000
NODE_9675_length_871_cov_31.145078	379	459	31	15	80	0.1875000
NODE_9676_length_871_cov_27.993523	379	459	0	27	80	0.3375000
NODE_9676_length_871_cov_27.993523	379	459	7	53	80	0.6625000
NODE_9676_length_871_cov_27.993523	432	512	0	80	80	1.0000000
NODE_9677_length_871_cov_25.954663	463	543	7	8	80	0.1000000
NODE_9677_length_871_cov_25.954663	463	543	9	10	80	0.1250000
NODE_9677_length_871_cov_25.954663	463	543	10	36	80	0.4500000
NODE_9677_length_871_cov_25.954663	463	543	11	2	80	0.0250000
NODE_9677_length_871_cov_25.954663	463	543	13	24	80	0.3000000
NODE_9677_length_871_cov_25.954663	516	596	9	6	80	0.0750000
NODE_9677_length_871_cov_25.954663	516	596	10	52	80	0.6500000
NODE_9677_length_871_cov_25.954663	516	596	13	22	80	0.2750000
NODE_9678_length_871_cov_24.069948	492	558	5	2	66	0.0303030
NODE_9678_length_871_cov_24.069948	492	558	6	9	66	0.1363636
NODE_9678_length_871_cov_24.069948	492	558	11	4	66	0.0606061
NODE_9678_length_871_cov_24.069948	492	558	12	8	66	0.1212121
NODE_9678_length_871_cov_24.069948	492	558	15	4	66	0.0606061
NODE_9678_length_871_cov_24.069948	492	558	17	12	66	0.1818182
NODE_9678_length_871_cov_24.069948	492	558	18	2	66	0.0303030
NODE_9678_length_871_cov_24.069948	492	558	19	7	66	0.1060606
NODE_9678_length_871_cov_24.069948	492	558	21	18	66	0.2727273
NODE_9678_length_871_cov_24.069948	558	634	13	10	76	0.1315790
NODE_9678_length_871_cov_24.069948	558	634	15	2	76	0.0263158
NODE_9678_length_871_cov_24.069948	558	634	18	6	76	0.0789474
NODE_9678_length_871_cov_24.069948	558	634	19	3	76	0.0394737
NODE_9678_length_871_cov_24.069948	558	634	21	34	76	0.4473684
NODE_9678_length_871_cov_24.069948	558	634	22	6	76	0.0789474
NODE_9678_length_871_cov_24.069948	558	634	23	15	76	0.1973684
NODE_9679_length_871_cov_23.953368	445	522	0	42	77	0.5454546
NODE_9679_length_871_cov_23.953368	445	522	1	35	77	0.4545455
NODE_9680_length_871_cov_19.304404	335	415	2	39	80	0.4875000
NODE_9680_length_871_cov_19.304404	335	415	3	16	80	0.2000000
NODE_9680_length_871_cov_19.304404	335	415	5	25	80	0.3125000
NODE_9680_length_871_cov_19.304404	388	468	3	55	80	0.6875000
NODE_9680_length_871_cov_19.304404	388	468	5	25	80	0.3125000
NODE_9682_length_871_cov_18.108808	370	450	13	13	80	0.1625000
NODE_9682_length_871_cov_18.108808	370	450	14	28	80	0.3500000
NODE_9682_length_871_cov_18.108808	370	450	15	39	80	0.4875000
NODE_9682_length_871_cov_18.108808	423	503	11	6	80	0.0750000
NODE_9682_length_871_cov_18.108808	423	503	13	2	80	0.0250000
NODE_9682_length_871_cov_18.108808	423	503	14	41	80	0.5125000
NODE_9682_length_871_cov_18.108808	423	503	15	31	80	0.3875000
NODE_9683_length_871_cov_17.034974	362	442	2	16	80	0.2000000
NODE_9683_length_871_cov_17.034974	362	442	3	18	80	0.2250000
NODE_9683_length_871_cov_17.034974	362	442	4	8	80	0.1000000
NODE_9683_length_871_cov_17.034974	362	442	6	4	80	0.0500000
NODE_9683_length_871_cov_17.034974	362	442	7	1	80	0.0125000
NODE_9683_length_871_cov_17.034974	362	442	8	2	80	0.0250000
NODE_9683_length_871_cov_17.034974	362	442	10	31	80	0.3875000
NODE_9683_length_871_cov_17.034974	415	495	10	80	80	1.0000000
NODE_9684_length_871_cov_16.768135	374	454	2	20	80	0.2500000
NODE_9684_length_871_cov_16.768135	374	454	4	60	80	0.7500000
NODE_9685_length_871_cov_14.196891	267	347	0	80	80	1.0000000
NODE_9685_length_871_cov_14.196891	320	400	0	80	80	1.0000000
NODE_9686_length_871_cov_13.443005	246	326	0	80	80	1.0000000
NODE_9686_length_871_cov_13.443005	299	322	0	23	23	1.0000000
NODE_9687_length_871_cov_11.839378	29	109	0	80	80	1.0000000
NODE_9687_length_871_cov_11.839378	82	149	0	67	67	1.0000000
NODE_9687_length_871_cov_11.839378	331	411	1	9	80	0.1125000
NODE_9687_length_871_cov_11.839378	331	411	3	37	80	0.4625000
NODE_9687_length_871_cov_11.839378	331	411	4	34	80	0.4250000
NODE_9687_length_871_cov_11.839378	384	464	3	46	80	0.5750000
NODE_9687_length_871_cov_11.839378	384	464	5	34	80	0.4250000
NODE_9689_length_871_cov_5.730570	316	373	0	45	57	0.7894737
NODE_9689_length_871_cov_5.730570	316	373	4	12	57	0.2105263
NODE_9694_length_871_cov_3.544041	428	508	7	75	80	0.9375000
NODE_9694_length_871_cov_3.544041	428	508	11	5	80	0.0625000
NODE_9694_length_871_cov_3.544041	481	561	7	80	80	1.0000000
NODE_9716_length_870_cov_43.400778	542	622	24	10	80	0.1250000
NODE_9716_length_870_cov_43.400778	542	622	25	3	80	0.0375000
NODE_9716_length_870_cov_43.400778	542	622	26	9	80	0.1125000
NODE_9716_length_870_cov_43.400778	542	622	27	26	80	0.3250000
NODE_9716_length_870_cov_43.400778	542	622	28	30	80	0.3750000
NODE_9716_length_870_cov_43.400778	542	622	30	2	80	0.0250000
NODE_9716_length_870_cov_43.400778	595	675	15	12	80	0.1500000
NODE_9716_length_870_cov_43.400778	595	675	16	19	80	0.2375000
NODE_9716_length_870_cov_43.400778	595	675	18	2	80	0.0250000
NODE_9716_length_870_cov_43.400778	595	675	19	4	80	0.0500000
NODE_9716_length_870_cov_43.400778	595	675	24	6	80	0.0750000
NODE_9716_length_870_cov_43.400778	595	675	26	18	80	0.2250000
NODE_9716_length_870_cov_43.400778	595	675	27	14	80	0.1750000
NODE_9716_length_870_cov_43.400778	595	675	28	3	80	0.0375000
NODE_9716_length_870_cov_43.400778	595	675	30	2	80	0.0250000
NODE_9719_length_870_cov_28.249027	442	524	8	8	82	0.0975610
NODE_9719_length_870_cov_28.249027	442	524	9	14	82	0.1707317
NODE_9719_length_870_cov_28.249027	442	524	10	1	82	0.0121951
NODE_9719_length_870_cov_28.249027	442	524	11	3	82	0.0365854
NODE_9719_length_870_cov_28.249027	442	524	12	7	82	0.0853659
NODE_9719_length_870_cov_28.249027	442	524	13	11	82	0.1341463
NODE_9719_length_870_cov_28.249027	442	524	14	38	82	0.4634146
NODE_9719_length_870_cov_28.249027	497	577	3	9	80	0.1125000
NODE_9719_length_870_cov_28.249027	497	577	4	44	80	0.5500000
NODE_9719_length_870_cov_28.249027	497	577	8	8	80	0.1000000
NODE_9719_length_870_cov_28.249027	497	577	9	14	80	0.1750000
NODE_9719_length_870_cov_28.249027	497	577	10	1	80	0.0125000
NODE_9719_length_870_cov_28.249027	497	577	13	3	80	0.0375000
NODE_9719_length_870_cov_28.249027	497	577	14	1	80	0.0125000
NODE_9720_length_870_cov_26.992218	240	320	5	6	80	0.0750000
NODE_9720_length_870_cov_26.992218	240	320	6	17	80	0.2125000
NODE_9720_length_870_cov_26.992218	240	320	7	13	80	0.1625000
NODE_9720_length_870_cov_26.992218	240	320	8	8	80	0.1000000
NODE_9720_length_870_cov_26.992218	240	320	9	36	80	0.4500000
NODE_9720_length_870_cov_26.992218	293	373	8	7	80	0.0875000
NODE_9720_length_870_cov_26.992218	293	373	9	55	80	0.6875000
NODE_9720_length_870_cov_26.992218	293	373	10	16	80	0.2000000
NODE_9720_length_870_cov_26.992218	293	373	11	2	80	0.0250000
NODE_9720_length_870_cov_26.992218	369	449	4	23	80	0.2875000
NODE_9720_length_870_cov_26.992218	369	449	5	12	80	0.1500000
NODE_9720_length_870_cov_26.992218	369	449	6	2	80	0.0250000
NODE_9720_length_870_cov_26.992218	369	449	7	21	80	0.2625000
NODE_9720_length_870_cov_26.992218	369	449	8	22	80	0.2750000
NODE_9720_length_870_cov_26.992218	422	502	2	38	80	0.4750000
NODE_9720_length_870_cov_26.992218	422	502	4	38	80	0.4750000
NODE_9720_length_870_cov_26.992218	422	502	5	4	80	0.0500000
NODE_9721_length_870_cov_25.806744	186	237	0	13	51	0.2549020
NODE_9721_length_870_cov_25.806744	186	237	2	38	51	0.7450981
NODE_9721_length_870_cov_25.806744	391	471	0	8	80	0.1000000
NODE_9721_length_870_cov_25.806744	391	471	2	72	80	0.9000000
NODE_9721_length_870_cov_25.806744	444	524	0	61	80	0.7625000
NODE_9721_length_870_cov_25.806744	444	524	2	19	80	0.2375000
NODE_9722_length_870_cov_18.862516	345	425	17	9	80	0.1125000
NODE_9722_length_870_cov_18.862516	345	425	18	19	80	0.2375000
NODE_9722_length_870_cov_18.862516	345	425	21	1	80	0.0125000
NODE_9722_length_870_cov_18.862516	345	425	22	32	80	0.4000000
NODE_9722_length_870_cov_18.862516	345	425	24	7	80	0.0875000
NODE_9722_length_870_cov_18.862516	345	425	25	12	80	0.1500000
NODE_9722_length_870_cov_18.862516	398	478	18	8	80	0.1000000
NODE_9722_length_870_cov_18.862516	398	478	19	11	80	0.1375000
NODE_9722_length_870_cov_18.862516	398	478	20	3	80	0.0375000
NODE_9722_length_870_cov_18.862516	398	478	22	2	80	0.0250000
NODE_9722_length_870_cov_18.862516	398	478	23	26	80	0.3250000
NODE_9722_length_870_cov_18.862516	398	478	24	18	80	0.2250000
NODE_9722_length_870_cov_18.862516	398	478	25	12	80	0.1500000
NODE_9723_length_870_cov_15.686122	330	410	5	49	80	0.6125000
NODE_9723_length_870_cov_15.686122	330	410	7	31	80	0.3875000
NODE_9723_length_870_cov_15.686122	383	463	6	20	80	0.2500000
NODE_9723_length_870_cov_15.686122	383	463	7	60	80	0.7500000
NODE_9725_length_870_cov_13.334630	479	559	9	1	80	0.0125000
NODE_9725_length_870_cov_13.334630	479	559	10	65	80	0.8125000
NODE_9725_length_870_cov_13.334630	479	559	11	8	80	0.1000000
NODE_9725_length_870_cov_13.334630	479	559	12	6	80	0.0750000
NODE_9725_length_870_cov_13.334630	532	612	6	1	80	0.0125000
NODE_9725_length_870_cov_13.334630	532	612	8	6	80	0.0750000
NODE_9725_length_870_cov_13.334630	532	612	9	26	80	0.3250000
NODE_9725_length_870_cov_13.334630	532	612	10	15	80	0.1875000
NODE_9725_length_870_cov_13.334630	532	612	11	8	80	0.1000000
NODE_9725_length_870_cov_13.334630	532	612	12	24	80	0.3000000
NODE_9726_length_870_cov_9.712062	410	490	4	12	80	0.1500000
NODE_9726_length_870_cov_9.712062	410	490	5	33	80	0.4125000
NODE_9726_length_870_cov_9.712062	410	490	6	13	80	0.1625000
NODE_9726_length_870_cov_9.712062	410	490	7	22	80	0.2750000
NODE_9726_length_870_cov_9.712062	463	542	2	20	79	0.2531646
NODE_9726_length_870_cov_9.712062	463	542	5	59	79	0.7468355
NODE_9728_length_870_cov_7.556420	448	528	1	38	80	0.4750000
NODE_9728_length_870_cov_7.556420	448	528	2	11	80	0.1375000
NODE_9728_length_870_cov_7.556420	448	528	3	16	80	0.2000000
NODE_9728_length_870_cov_7.556420	448	528	4	15	80	0.1875000
NODE_9728_length_870_cov_7.556420	501	581	3	50	80	0.6250000
NODE_9728_length_870_cov_7.556420	501	581	4	30	80	0.3750000
NODE_9746_length_869_cov_42.784416	395	475	8	7	80	0.0875000
NODE_9746_length_869_cov_42.784416	395	475	9	44	80	0.5500000
NODE_9746_length_869_cov_42.784416	395	475	10	29	80	0.3625000
NODE_9746_length_869_cov_42.784416	448	528	5	11	80	0.1375000
NODE_9746_length_869_cov_42.784416	448	528	6	14	80	0.1750000
NODE_9746_length_869_cov_42.784416	448	528	7	16	80	0.2000000
NODE_9746_length_869_cov_42.784416	448	528	8	19	80	0.2375000
NODE_9746_length_869_cov_42.784416	448	528	9	17	80	0.2125000
NODE_9746_length_869_cov_42.784416	448	528	10	3	80	0.0375000
NODE_9747_length_869_cov_29.525974	211	291	5	11	80	0.1375000
NODE_9747_length_869_cov_29.525974	211	291	6	2	80	0.0250000
NODE_9747_length_869_cov_29.525974	211	291	7	31	80	0.3875000
NODE_9747_length_869_cov_29.525974	211	291	8	16	80	0.2000000
NODE_9747_length_869_cov_29.525974	211	291	10	20	80	0.2500000
NODE_9747_length_869_cov_29.525974	264	344	7	2	80	0.0250000
NODE_9747_length_869_cov_29.525974	264	344	8	16	80	0.2000000
NODE_9747_length_869_cov_29.525974	264	344	9	16	80	0.2000000
NODE_9747_length_869_cov_29.525974	264	344	10	46	80	0.5750000
NODE_9748_length_869_cov_16.258442	389	469	1	35	80	0.4375000
NODE_9748_length_869_cov_16.258442	389	469	2	45	80	0.5625000
NODE_9748_length_869_cov_16.258442	442	522	2	80	80	1.0000000
NODE_9749_length_869_cov_15.940260	321	401	7	5	80	0.0625000
NODE_9749_length_869_cov_15.940260	321	401	10	63	80	0.7875000
NODE_9749_length_869_cov_15.940260	321	401	11	12	80	0.1500000
NODE_9749_length_869_cov_15.940260	374	454	4	16	80	0.2000000
NODE_9749_length_869_cov_15.940260	374	454	6	12	80	0.1500000
NODE_9749_length_869_cov_15.940260	374	454	7	15	80	0.1875000
NODE_9749_length_869_cov_15.940260	374	454	9	1	80	0.0125000
NODE_9749_length_869_cov_15.940260	374	454	10	36	80	0.4500000
NODE_9750_length_869_cov_9.619481	402	442	8	18	40	0.4500000
NODE_9750_length_869_cov_9.619481	402	442	9	22	40	0.5500000
NODE_9751_length_869_cov_7.123377	392	472	0	80	80	1.0000000
NODE_9751_length_869_cov_7.123377	445	525	0	80	80	1.0000000
NODE_9753_length_869_cov_3.658442	310	378	0	68	68	1.0000000
NODE_9777_length_868_cov_57.465540	355	435	19	2	80	0.0250000
NODE_9777_length_868_cov_57.465540	355	435	20	1	80	0.0125000
NODE_9777_length_868_cov_57.465540	355	435	21	2	80	0.0250000
NODE_9777_length_868_cov_57.465540	355	435	22	5	80	0.0625000
NODE_9777_length_868_cov_57.465540	355	435	23	3	80	0.0375000
NODE_9777_length_868_cov_57.465540	355	435	24	14	80	0.1750000
NODE_9777_length_868_cov_57.465540	355	435	26	13	80	0.1625000
NODE_9777_length_868_cov_57.465540	355	435	27	22	80	0.2750000
NODE_9777_length_868_cov_57.465540	355	435	29	12	80	0.1500000
NODE_9777_length_868_cov_57.465540	355	435	30	6	80	0.0750000
NODE_9778_length_868_cov_46.509753	0	65	0	3	65	0.0461538
NODE_9778_length_868_cov_46.509753	0	65	4	5	65	0.0769231
NODE_9778_length_868_cov_46.509753	0	65	5	21	65	0.3230769
NODE_9778_length_868_cov_46.509753	0	65	6	14	65	0.2153846
NODE_9778_length_868_cov_46.509753	0	65	7	16	65	0.2461538
NODE_9778_length_868_cov_46.509753	0	65	8	6	65	0.0923077
NODE_9778_length_868_cov_46.509753	0	65	0	3	65	0.0461538
NODE_9778_length_868_cov_46.509753	0	65	4	5	65	0.0769231
NODE_9778_length_868_cov_46.509753	0	65	5	21	65	0.3230769
NODE_9778_length_868_cov_46.509753	0	65	6	14	65	0.2153846
NODE_9778_length_868_cov_46.509753	0	65	7	16	65	0.2461538
NODE_9778_length_868_cov_46.509753	0	65	8	6	65	0.0923077
NODE_9778_length_868_cov_46.509753	0	65	0	3	65	0.0461538
NODE_9778_length_868_cov_46.509753	0	65	4	5	65	0.0769231
NODE_9778_length_868_cov_46.509753	0	65	5	21	65	0.3230769
NODE_9778_length_868_cov_46.509753	0	65	6	14	65	0.2153846
NODE_9778_length_868_cov_46.509753	0	65	7	16	65	0.2461538
NODE_9778_length_868_cov_46.509753	0	65	8	6	65	0.0923077
NODE_9778_length_868_cov_46.509753	0	65	0	3	65	0.0461538
NODE_9778_length_868_cov_46.509753	0	65	4	5	65	0.0769231
NODE_9778_length_868_cov_46.509753	0	65	5	21	65	0.3230769
NODE_9778_length_868_cov_46.509753	0	65	6	14	65	0.2153846
NODE_9778_length_868_cov_46.509753	0	65	7	16	65	0.2461538
NODE_9778_length_868_cov_46.509753	0	65	8	6	65	0.0923077
NODE_9778_length_868_cov_46.509753	61	141	8	29	80	0.3625000
NODE_9778_length_868_cov_46.509753	61	141	9	17	80	0.2125000
NODE_9778_length_868_cov_46.509753	61	141	11	1	80	0.0125000
NODE_9778_length_868_cov_46.509753	61	141	12	18	80	0.2250000
NODE_9778_length_868_cov_46.509753	61	141	14	12	80	0.1500000
NODE_9778_length_868_cov_46.509753	61	141	15	3	80	0.0375000
NODE_9778_length_868_cov_46.509753	61	141	8	29	80	0.3625000
NODE_9778_length_868_cov_46.509753	61	141	9	17	80	0.2125000
NODE_9778_length_868_cov_46.509753	61	141	11	1	80	0.0125000
NODE_9778_length_868_cov_46.509753	61	141	12	18	80	0.2250000
NODE_9778_length_868_cov_46.509753	61	141	14	12	80	0.1500000
NODE_9778_length_868_cov_46.509753	61	141	15	3	80	0.0375000
NODE_9778_length_868_cov_46.509753	114	194	8	1	80	0.0125000
NODE_9778_length_868_cov_46.509753	114	194	9	14	80	0.1750000
NODE_9778_length_868_cov_46.509753	114	194	10	34	80	0.4250000
NODE_9778_length_868_cov_46.509753	114	194	11	5	80	0.0625000
NODE_9778_length_868_cov_46.509753	114	194	12	11	80	0.1375000
NODE_9778_length_868_cov_46.509753	114	194	14	12	80	0.1500000
NODE_9778_length_868_cov_46.509753	114	194	15	3	80	0.0375000
NODE_9778_length_868_cov_46.509753	114	194	8	1	80	0.0125000
NODE_9778_length_868_cov_46.509753	114	194	9	14	80	0.1750000
NODE_9778_length_868_cov_46.509753	114	194	10	34	80	0.4250000
NODE_9778_length_868_cov_46.509753	114	194	11	5	80	0.0625000
NODE_9778_length_868_cov_46.509753	114	194	12	11	80	0.1375000
NODE_9778_length_868_cov_46.509753	114	194	14	12	80	0.1500000
NODE_9778_length_868_cov_46.509753	114	194	15	3	80	0.0375000
NODE_9779_length_868_cov_26.092328	318	398	6	13	80	0.1625000
NODE_9779_length_868_cov_26.092328	318	398	7	30	80	0.3750000
NODE_9779_length_868_cov_26.092328	318	398	8	30	80	0.3750000
NODE_9779_length_868_cov_26.092328	318	398	9	7	80	0.0875000
NODE_9779_length_868_cov_26.092328	371	451	8	30	80	0.3750000
NODE_9779_length_868_cov_26.092328	371	451	9	15	80	0.1875000
NODE_9779_length_868_cov_26.092328	371	451	11	35	80	0.4375000
NODE_9781_length_868_cov_22.555267	377	457	16	4	80	0.0500000
NODE_9781_length_868_cov_22.555267	377	457	17	5	80	0.0625000
NODE_9781_length_868_cov_22.555267	377	457	20	7	80	0.0875000
NODE_9781_length_868_cov_22.555267	377	457	21	11	80	0.1375000
NODE_9781_length_868_cov_22.555267	377	457	22	21	80	0.2625000
NODE_9781_length_868_cov_22.555267	377	457	23	15	80	0.1875000
NODE_9781_length_868_cov_22.555267	377	457	24	17	80	0.2125000
NODE_9781_length_868_cov_22.555267	430	510	11	1	80	0.0125000
NODE_9781_length_868_cov_22.555267	430	510	12	1	80	0.0125000
NODE_9781_length_868_cov_22.555267	430	510	13	5	80	0.0625000
NODE_9781_length_868_cov_22.555267	430	510	14	6	80	0.0750000
NODE_9781_length_868_cov_22.555267	430	510	15	25	80	0.3125000
NODE_9781_length_868_cov_22.555267	430	510	16	5	80	0.0625000
NODE_9781_length_868_cov_22.555267	430	510	17	9	80	0.1125000
NODE_9781_length_868_cov_22.555267	430	510	18	10	80	0.1250000
NODE_9781_length_868_cov_22.555267	430	510	20	7	80	0.0875000
NODE_9781_length_868_cov_22.555267	430	510	21	8	80	0.1000000
NODE_9781_length_868_cov_22.555267	430	510	23	3	80	0.0375000
NODE_9782_length_868_cov_20.466840	259	339	2	54	80	0.6750000
NODE_9782_length_868_cov_20.466840	259	339	3	26	80	0.3250000
NODE_9782_length_868_cov_20.466840	312	392	2	1	80	0.0125000
NODE_9782_length_868_cov_20.466840	312	392	3	41	80	0.5125000
NODE_9782_length_868_cov_20.466840	312	392	4	7	80	0.0875000
NODE_9782_length_868_cov_20.466840	312	392	6	31	80	0.3875000
NODE_9782_length_868_cov_20.466840	388	468	3	5	80	0.0625000
NODE_9782_length_868_cov_20.466840	388	468	4	55	80	0.6875000
NODE_9782_length_868_cov_20.466840	388	468	5	3	80	0.0375000
NODE_9782_length_868_cov_20.466840	388	468	6	17	80	0.2125000
NODE_9782_length_868_cov_20.466840	441	521	0	10	80	0.1250000
NODE_9782_length_868_cov_20.466840	441	521	2	7	80	0.0875000
NODE_9782_length_868_cov_20.466840	441	521	3	41	80	0.5125000
NODE_9782_length_868_cov_20.466840	441	521	4	22	80	0.2750000
NODE_9783_length_868_cov_20.414824	311	391	4	54	80	0.6750000
NODE_9783_length_868_cov_20.414824	311	391	5	1	80	0.0125000
NODE_9783_length_868_cov_20.414824	311	391	6	25	80	0.3125000
NODE_9783_length_868_cov_20.414824	364	444	2	51	80	0.6375000
NODE_9783_length_868_cov_20.414824	364	444	3	1	80	0.0125000
NODE_9783_length_868_cov_20.414824	364	444	4	28	80	0.3500000
NODE_9784_length_868_cov_17.613784	340	420	0	80	80	1.0000000
NODE_9784_length_868_cov_17.613784	393	473	0	80	80	1.0000000
NODE_9785_length_868_cov_15.768531	353	433	0	38	80	0.4750000
NODE_9785_length_868_cov_15.768531	353	433	1	42	80	0.5250000
NODE_9785_length_868_cov_15.768531	406	486	0	80	80	1.0000000
NODE_9786_length_868_cov_13.997399	611	691	2	19	80	0.2375000
NODE_9786_length_868_cov_13.997399	611	691	3	28	80	0.3500000
NODE_9786_length_868_cov_13.997399	611	691	4	33	80	0.4125000
NODE_9786_length_868_cov_13.997399	664	744	2	37	80	0.4625000
NODE_9786_length_868_cov_13.997399	664	744	3	43	80	0.5375000
NODE_9787_length_868_cov_13.224967	451	531	17	8	80	0.1000000
NODE_9787_length_868_cov_13.224967	451	531	18	1	80	0.0125000
NODE_9787_length_868_cov_13.224967	451	531	19	2	80	0.0250000
NODE_9787_length_868_cov_13.224967	451	531	20	3	80	0.0375000
NODE_9787_length_868_cov_13.224967	451	531	21	40	80	0.5000000
NODE_9787_length_868_cov_13.224967	451	531	23	3	80	0.0375000
NODE_9787_length_868_cov_13.224967	451	531	24	1	80	0.0125000
NODE_9787_length_868_cov_13.224967	451	531	25	8	80	0.1000000
NODE_9787_length_868_cov_13.224967	451	531	26	12	80	0.1500000
NODE_9787_length_868_cov_13.224967	451	531	29	2	80	0.0250000
NODE_9787_length_868_cov_13.224967	504	583	19	8	79	0.1012658
NODE_9787_length_868_cov_13.224967	504	583	21	3	79	0.0379747
NODE_9787_length_868_cov_13.224967	504	583	22	4	79	0.0506329
NODE_9787_length_868_cov_13.224967	504	583	23	35	79	0.4430380
NODE_9787_length_868_cov_13.224967	504	583	24	1	79	0.0126582
NODE_9787_length_868_cov_13.224967	504	583	25	8	79	0.1012658
NODE_9787_length_868_cov_13.224967	504	583	26	20	79	0.2531646
NODE_9788_length_868_cov_11.851756	363	422	0	59	59	1.0000000
NODE_9788_length_868_cov_11.851756	395	475	0	80	80	1.0000000
NODE_9789_length_868_cov_11.352406	361	441	3	36	80	0.4500000
NODE_9789_length_868_cov_11.352406	361	441	4	8	80	0.1000000
NODE_9789_length_868_cov_11.352406	361	441	6	29	80	0.3625000
NODE_9789_length_868_cov_11.352406	361	441	7	7	80	0.0875000
NODE_9789_length_868_cov_11.352406	414	494	5	3	80	0.0375000
NODE_9789_length_868_cov_11.352406	414	494	6	38	80	0.4750000
NODE_9789_length_868_cov_11.352406	414	494	7	39	80	0.4875000
NODE_9790_length_868_cov_11.335501	289	369	1	4	80	0.0500000
NODE_9790_length_868_cov_11.335501	289	369	3	43	80	0.5375000
NODE_9790_length_868_cov_11.335501	289	369	4	33	80	0.4125000
NODE_9790_length_868_cov_11.335501	342	422	0	51	80	0.6375000
NODE_9790_length_868_cov_11.335501	342	422	1	6	80	0.0750000
NODE_9790_length_868_cov_11.335501	342	422	3	23	80	0.2875000
NODE_9791_length_868_cov_8.455137	401	481	4	7	80	0.0875000
NODE_9791_length_868_cov_8.455137	401	481	5	73	80	0.9125000
NODE_9791_length_868_cov_8.455137	454	534	1	11	80	0.1375000
NODE_9791_length_868_cov_8.455137	454	534	2	17	80	0.2125000
NODE_9791_length_868_cov_8.455137	454	534	5	52	80	0.6500000
NODE_9816_length_867_cov_27.756510	333	376	0	23	43	0.5348837
NODE_9816_length_867_cov_27.756510	333	376	1	20	43	0.4651163
NODE_9816_length_867_cov_27.756510	349	429	0	7	80	0.0875000
NODE_9816_length_867_cov_27.756510	349	429	1	67	80	0.8375000
NODE_9816_length_867_cov_27.756510	349	429	2	6	80	0.0750000
NODE_9816_length_867_cov_27.756510	425	505	2	14	80	0.1750000
NODE_9816_length_867_cov_27.756510	425	505	4	66	80	0.8250000
NODE_9816_length_867_cov_27.756510	478	542	3	36	64	0.5625000
NODE_9816_length_867_cov_27.756510	478	542	4	28	64	0.4375000
NODE_9817_length_867_cov_25.354167	280	345	6	65	65	1.0000000
NODE_9817_length_867_cov_25.354167	325	397	4	35	72	0.4861111
NODE_9817_length_867_cov_25.354167	325	397	6	37	72	0.5138889
NODE_9818_length_867_cov_23.968750	369	449	4	14	80	0.1750000
NODE_9818_length_867_cov_23.968750	369	449	6	66	80	0.8250000
NODE_9818_length_867_cov_23.968750	422	502	0	3	80	0.0375000
NODE_9818_length_867_cov_23.968750	422	502	2	12	80	0.1500000
NODE_9818_length_867_cov_23.968750	422	502	4	52	80	0.6500000
NODE_9818_length_867_cov_23.968750	422	502	6	13	80	0.1625000
NODE_9819_length_867_cov_21.220052	524	604	2	80	80	1.0000000
NODE_9819_length_867_cov_21.220052	577	657	2	32	80	0.4000000
NODE_9819_length_867_cov_21.220052	577	657	3	33	80	0.4125000
NODE_9819_length_867_cov_21.220052	577	657	4	15	80	0.1875000
NODE_9820_length_867_cov_15.042969	287	364	0	77	77	1.0000000
NODE_9821_length_867_cov_11.057292	305	373	1	22	68	0.3235294
NODE_9821_length_867_cov_11.057292	305	373	2	46	68	0.6764706
NODE_9821_length_867_cov_11.057292	346	426	2	38	80	0.4750000
NODE_9821_length_867_cov_11.057292	346	426	7	20	80	0.2500000
NODE_9821_length_867_cov_11.057292	346	426	8	22	80	0.2750000
NODE_9821_length_867_cov_11.057292	475	555	0	21	80	0.2625000
NODE_9821_length_867_cov_11.057292	475	555	5	1	80	0.0125000
NODE_9821_length_867_cov_11.057292	475	555	6	56	80	0.7000000
NODE_9821_length_867_cov_11.057292	475	555	7	2	80	0.0250000
NODE_9822_length_867_cov_8.127604	347	427	2	80	80	1.0000000
NODE_9822_length_867_cov_8.127604	400	480	0	1	80	0.0125000
NODE_9822_length_867_cov_8.127604	400	480	1	25	80	0.3125000
NODE_9822_length_867_cov_8.127604	400	480	2	54	80	0.6750000
NODE_9823_length_867_cov_7.621094	292	372	5	42	80	0.5250000
NODE_9823_length_867_cov_7.621094	292	372	7	38	80	0.4750000
NODE_9823_length_867_cov_7.621094	345	425	4	12	80	0.1500000
NODE_9823_length_867_cov_7.621094	345	425	6	14	80	0.1750000
NODE_9823_length_867_cov_7.621094	345	425	7	34	80	0.4250000
NODE_9823_length_867_cov_7.621094	345	425	8	3	80	0.0375000
NODE_9823_length_867_cov_7.621094	345	425	9	17	80	0.2125000
NODE_9826_length_867_cov_5.494792	445	525	0	23	80	0.2875000
NODE_9826_length_867_cov_5.494792	445	525	1	57	80	0.7125000
NODE_9826_length_867_cov_5.494792	498	578	1	80	80	1.0000000
NODE_9857_length_866_cov_49.224250	269	349	14	15	80	0.1875000
NODE_9857_length_866_cov_49.224250	269	349	18	1	80	0.0125000
NODE_9857_length_866_cov_49.224250	269	349	20	23	80	0.2875000
NODE_9857_length_866_cov_49.224250	269	349	21	41	80	0.5125000
NODE_9857_length_866_cov_49.224250	322	402	6	31	80	0.3875000
NODE_9857_length_866_cov_49.224250	322	402	15	5	80	0.0625000
NODE_9857_length_866_cov_49.224250	322	402	21	44	80	0.5500000
NODE_9858_length_866_cov_47.160365	428	508	9	9	80	0.1125000
NODE_9858_length_866_cov_47.160365	428	508	10	15	80	0.1875000
NODE_9858_length_866_cov_47.160365	428	508	11	22	80	0.2750000
NODE_9858_length_866_cov_47.160365	428	508	12	34	80	0.4250000
NODE_9858_length_866_cov_47.160365	481	561	8	19	80	0.2375000
NODE_9858_length_866_cov_47.160365	481	561	9	1	80	0.0125000
NODE_9858_length_866_cov_47.160365	481	561	10	30	80	0.3750000
NODE_9858_length_866_cov_47.160365	481	561	11	17	80	0.2125000
NODE_9858_length_866_cov_47.160365	481	561	12	13	80	0.1625000
NODE_9858_length_866_cov_47.160365	557	637	10	4	80	0.0500000
NODE_9858_length_866_cov_47.160365	557	637	11	19	80	0.2375000
NODE_9858_length_866_cov_47.160365	557	637	12	16	80	0.2000000
NODE_9858_length_866_cov_47.160365	557	637	13	32	80	0.4000000
NODE_9858_length_866_cov_47.160365	557	637	14	9	80	0.1125000
NODE_9858_length_866_cov_47.160365	610	690	11	30	80	0.3750000
NODE_9858_length_866_cov_47.160365	610	690	12	8	80	0.1000000
NODE_9858_length_866_cov_47.160365	610	690	13	1	80	0.0125000
NODE_9858_length_866_cov_47.160365	610	690	14	11	80	0.1375000
NODE_9858_length_866_cov_47.160365	610	690	15	1	80	0.0125000
NODE_9858_length_866_cov_47.160365	610	690	16	29	80	0.3625000
NODE_9859_length_866_cov_23.398957	281	361	8	1	80	0.0125000
NODE_9859_length_866_cov_23.398957	281	361	9	7	80	0.0875000
NODE_9859_length_866_cov_23.398957	281	361	10	24	80	0.3000000
NODE_9859_length_866_cov_23.398957	281	361	11	3	80	0.0375000
NODE_9859_length_866_cov_23.398957	281	361	12	25	80	0.3125000
NODE_9859_length_866_cov_23.398957	281	361	13	20	80	0.2500000
NODE_9859_length_866_cov_23.398957	334	414	10	36	80	0.4500000
NODE_9859_length_866_cov_23.398957	334	414	11	11	80	0.1375000
NODE_9859_length_866_cov_23.398957	334	414	12	17	80	0.2125000
NODE_9859_length_866_cov_23.398957	334	414	13	16	80	0.2000000
NODE_9860_length_866_cov_22.186441	455	535	11	22	80	0.2750000
NODE_9860_length_866_cov_22.186441	455	535	13	28	80	0.3500000
NODE_9860_length_866_cov_22.186441	455	535	14	7	80	0.0875000
NODE_9860_length_866_cov_22.186441	455	535	17	16	80	0.2000000
NODE_9860_length_866_cov_22.186441	455	535	19	7	80	0.0875000
NODE_9860_length_866_cov_22.186441	508	588	4	6	80	0.0750000
NODE_9860_length_866_cov_22.186441	508	588	10	12	80	0.1500000
NODE_9860_length_866_cov_22.186441	508	588	11	57	80	0.7125000
NODE_9860_length_866_cov_22.186441	508	588	13	5	80	0.0625000
NODE_9861_length_866_cov_18.362451	451	531	7	26	80	0.3250000
NODE_9861_length_866_cov_18.362451	451	531	8	32	80	0.4000000
NODE_9861_length_866_cov_18.362451	451	531	10	16	80	0.2000000
NODE_9861_length_866_cov_18.362451	451	531	12	6	80	0.0750000
NODE_9861_length_866_cov_18.362451	504	584	8	5	80	0.0625000
NODE_9861_length_866_cov_18.362451	504	584	9	25	80	0.3125000
NODE_9861_length_866_cov_18.362451	504	584	10	44	80	0.5500000
NODE_9861_length_866_cov_18.362451	504	584	12	6	80	0.0750000
NODE_9862_length_866_cov_16.830508	372	452	2	80	80	1.0000000
NODE_9862_length_866_cov_16.830508	425	505	2	80	80	1.0000000
NODE_9882_length_865_cov_63.137076	288	368	8	8	80	0.1000000
NODE_9882_length_865_cov_63.137076	288	368	10	6	80	0.0750000
NODE_9882_length_865_cov_63.137076	288	368	12	6	80	0.0750000
NODE_9882_length_865_cov_63.137076	288	368	13	1	80	0.0125000
NODE_9882_length_865_cov_63.137076	288	368	14	7	80	0.0875000
NODE_9882_length_865_cov_63.137076	288	368	16	5	80	0.0625000
NODE_9882_length_865_cov_63.137076	288	368	17	40	80	0.5000000
NODE_9882_length_865_cov_63.137076	288	368	20	7	80	0.0875000
NODE_9882_length_865_cov_63.137076	341	421	17	32	80	0.4000000
NODE_9882_length_865_cov_63.137076	341	421	20	37	80	0.4625000
NODE_9882_length_865_cov_63.137076	341	421	21	4	80	0.0500000
NODE_9882_length_865_cov_63.137076	341	421	22	7	80	0.0875000
NODE_9883_length_865_cov_19.882507	335	415	1	6	80	0.0750000
NODE_9883_length_865_cov_19.882507	335	415	2	74	80	0.9250000
NODE_9883_length_865_cov_19.882507	388	468	1	27	80	0.3375000
NODE_9883_length_865_cov_19.882507	388	468	2	53	80	0.6625000
NODE_9884_length_865_cov_17.784595	306	386	6	24	80	0.3000000
NODE_9884_length_865_cov_17.784595	306	386	7	56	80	0.7000000
NODE_9884_length_865_cov_17.784595	359	439	4	4	80	0.0500000
NODE_9884_length_865_cov_17.784595	359	439	5	24	80	0.3000000
NODE_9884_length_865_cov_17.784595	359	439	6	1	80	0.0125000
NODE_9884_length_865_cov_17.784595	359	439	7	38	80	0.4750000
NODE_9884_length_865_cov_17.784595	359	439	8	13	80	0.1625000
NODE_9885_length_865_cov_16.150131	451	531	4	11	80	0.1375000
NODE_9885_length_865_cov_16.150131	451	531	5	58	80	0.7250000
NODE_9885_length_865_cov_16.150131	451	531	6	4	80	0.0500000
NODE_9885_length_865_cov_16.150131	451	531	7	7	80	0.0875000
NODE_9885_length_865_cov_16.150131	504	584	4	10	80	0.1250000
NODE_9885_length_865_cov_16.150131	504	584	5	35	80	0.4375000
NODE_9885_length_865_cov_16.150131	504	584	6	13	80	0.1625000
NODE_9885_length_865_cov_16.150131	504	584	7	22	80	0.2750000
NODE_9886_length_865_cov_14.751958	473	553	5	9	80	0.1125000
NODE_9886_length_865_cov_14.751958	473	553	6	2	80	0.0250000
NODE_9886_length_865_cov_14.751958	473	553	9	69	80	0.8625000
NODE_9886_length_865_cov_14.751958	473	553	5	9	80	0.1125000
NODE_9886_length_865_cov_14.751958	473	553	6	2	80	0.0250000
NODE_9886_length_865_cov_14.751958	473	553	9	69	80	0.8625000
NODE_9886_length_865_cov_14.751958	526	589	2	4	63	0.0634921
NODE_9886_length_865_cov_14.751958	526	589	3	13	63	0.2063492
NODE_9886_length_865_cov_14.751958	526	589	5	28	63	0.4444444
NODE_9886_length_865_cov_14.751958	526	589	6	2	63	0.0317460
NODE_9886_length_865_cov_14.751958	526	589	9	16	63	0.2539683
NODE_9886_length_865_cov_14.751958	526	606	0	5	80	0.0625000
NODE_9886_length_865_cov_14.751958	526	606	2	16	80	0.2000000
NODE_9886_length_865_cov_14.751958	526	606	3	13	80	0.1625000
NODE_9886_length_865_cov_14.751958	526	606	5	28	80	0.3500000
NODE_9886_length_865_cov_14.751958	526	606	6	2	80	0.0250000
NODE_9886_length_865_cov_14.751958	526	606	9	16	80	0.2000000
NODE_9887_length_865_cov_10.937337	422	502	7	3	80	0.0375000
NODE_9887_length_865_cov_10.937337	422	502	8	38	80	0.4750000
NODE_9887_length_865_cov_10.937337	422	502	9	19	80	0.2375000
NODE_9887_length_865_cov_10.937337	422	502	11	20	80	0.2500000
NODE_9887_length_865_cov_10.937337	475	555	1	29	80	0.3625000
NODE_9887_length_865_cov_10.937337	475	555	2	11	80	0.1375000
NODE_9887_length_865_cov_10.937337	475	555	3	8	80	0.1000000
NODE_9887_length_865_cov_10.937337	475	555	5	4	80	0.0500000
NODE_9887_length_865_cov_10.937337	475	555	7	4	80	0.0500000
NODE_9887_length_865_cov_10.937337	475	555	8	24	80	0.3000000
NODE_9889_length_865_cov_9.167102	389	469	2	24	80	0.3000000
NODE_9889_length_865_cov_9.167102	389	469	3	56	80	0.7000000
NODE_9889_length_865_cov_9.167102	442	522	2	15	80	0.1875000
NODE_9889_length_865_cov_9.167102	442	522	3	63	80	0.7875000
NODE_9889_length_865_cov_9.167102	442	522	4	2	80	0.0250000
NODE_9912_length_864_cov_13.398693	491	571	2	32	80	0.4000000
NODE_9912_length_864_cov_13.398693	491	571	4	48	80	0.6000000
NODE_9912_length_864_cov_13.398693	544	624	4	80	80	1.0000000
NODE_9913_length_864_cov_8.466667	308	388	5	10	80	0.1250000
NODE_9913_length_864_cov_8.466667	308	388	6	40	80	0.5000000
NODE_9913_length_864_cov_8.466667	308	388	7	29	80	0.3625000
NODE_9913_length_864_cov_8.466667	308	388	8	1	80	0.0125000
NODE_9913_length_864_cov_8.466667	361	441	1	29	80	0.3625000
NODE_9913_length_864_cov_8.466667	361	441	2	5	80	0.0625000
NODE_9913_length_864_cov_8.466667	361	441	3	3	80	0.0375000
NODE_9913_length_864_cov_8.466667	361	441	5	26	80	0.3250000
NODE_9913_length_864_cov_8.466667	361	441	7	17	80	0.2125000
NODE_9917_length_864_cov_3.947712	651	676	0	25	25	1.0000000
NODE_9917_length_864_cov_3.947712	725	805	0	80	80	1.0000000
NODE_9917_length_864_cov_3.947712	778	844	0	66	66	1.0000000
NODE_9931_length_863_cov_72.856021	241	321	4	24	80	0.3000000
NODE_9931_length_863_cov_72.856021	241	321	5	15	80	0.1875000
NODE_9931_length_863_cov_72.856021	241	321	6	3	80	0.0375000
NODE_9931_length_863_cov_72.856021	241	321	8	17	80	0.2125000
NODE_9931_length_863_cov_72.856021	241	321	12	21	80	0.2625000
NODE_9931_length_863_cov_72.856021	294	374	8	6	80	0.0750000
NODE_9931_length_863_cov_72.856021	294	374	12	31	80	0.3875000
NODE_9931_length_863_cov_72.856021	294	374	13	5	80	0.0625000
NODE_9931_length_863_cov_72.856021	294	374	16	2	80	0.0250000
NODE_9931_length_863_cov_72.856021	294	374	17	10	80	0.1250000
NODE_9931_length_863_cov_72.856021	294	374	18	12	80	0.1500000
NODE_9931_length_863_cov_72.856021	294	374	19	10	80	0.1250000
NODE_9931_length_863_cov_72.856021	294	374	21	3	80	0.0375000
NODE_9931_length_863_cov_72.856021	294	374	22	1	80	0.0125000
NODE_9931_length_863_cov_72.856021	370	450	21	5	80	0.0625000
NODE_9931_length_863_cov_72.856021	370	450	22	1	80	0.0125000
NODE_9931_length_863_cov_72.856021	370	450	23	6	80	0.0750000
NODE_9931_length_863_cov_72.856021	370	450	24	1	80	0.0125000
NODE_9931_length_863_cov_72.856021	370	450	25	16	80	0.2000000
NODE_9931_length_863_cov_72.856021	370	450	26	2	80	0.0250000
NODE_9931_length_863_cov_72.856021	370	450	27	5	80	0.0625000
NODE_9931_length_863_cov_72.856021	370	450	28	24	80	0.3000000
NODE_9931_length_863_cov_72.856021	370	450	29	20	80	0.2500000
NODE_9931_length_863_cov_72.856021	423	503	15	5	80	0.0625000
NODE_9931_length_863_cov_72.856021	423	503	16	10	80	0.1250000
NODE_9931_length_863_cov_72.856021	423	503	17	2	80	0.0250000
NODE_9931_length_863_cov_72.856021	423	503	20	5	80	0.0625000
NODE_9931_length_863_cov_72.856021	423	503	21	31	80	0.3875000
NODE_9931_length_863_cov_72.856021	423	503	24	1	80	0.0125000
NODE_9931_length_863_cov_72.856021	423	503	25	16	80	0.2000000
NODE_9931_length_863_cov_72.856021	423	503	27	3	80	0.0375000
NODE_9931_length_863_cov_72.856021	423	503	28	7	80	0.0875000
NODE_9932_length_863_cov_37.130890	363	443	2	5	80	0.0625000
NODE_9932_length_863_cov_37.130890	363	443	3	32	80	0.4000000
NODE_9932_length_863_cov_37.130890	363	443	4	7	80	0.0875000
NODE_9932_length_863_cov_37.130890	363	443	5	36	80	0.4500000
NODE_9932_length_863_cov_37.130890	416	496	4	26	80	0.3250000
NODE_9932_length_863_cov_37.130890	416	496	5	48	80	0.6000000
NODE_9932_length_863_cov_37.130890	416	496	7	6	80	0.0750000
NODE_9932_length_863_cov_37.130890	492	572	6	40	80	0.5000000
NODE_9932_length_863_cov_37.130890	492	572	7	30	80	0.3750000
NODE_9932_length_863_cov_37.130890	492	572	8	10	80	0.1250000
NODE_9932_length_863_cov_37.130890	545	617	5	1	72	0.0138889
NODE_9932_length_863_cov_37.130890	545	617	6	62	72	0.8611111
NODE_9932_length_863_cov_37.130890	545	617	7	4	72	0.0555556
NODE_9932_length_863_cov_37.130890	545	617	8	5	72	0.0694444
NODE_9933_length_863_cov_33.159686	287	367	1	11	80	0.1375000
NODE_9933_length_863_cov_33.159686	287	367	3	11	80	0.1375000
NODE_9933_length_863_cov_33.159686	287	367	4	3	80	0.0375000
NODE_9933_length_863_cov_33.159686	287	367	5	45	80	0.5625000
NODE_9933_length_863_cov_33.159686	287	367	6	10	80	0.1250000
NODE_9933_length_863_cov_33.159686	340	420	5	50	80	0.6250000
NODE_9933_length_863_cov_33.159686	340	420	6	30	80	0.3750000
NODE_9934_length_863_cov_24.714660	370	450	4	80	80	1.0000000
NODE_9934_length_863_cov_24.714660	423	503	4	65	80	0.8125000
NODE_9934_length_863_cov_24.714660	423	503	5	10	80	0.1250000
NODE_9934_length_863_cov_24.714660	423	503	6	5	80	0.0625000
NODE_9935_length_863_cov_21.945026	341	421	10	58	80	0.7250000
NODE_9935_length_863_cov_21.945026	341	421	11	5	80	0.0625000
NODE_9935_length_863_cov_21.945026	341	421	12	17	80	0.2125000
NODE_9935_length_863_cov_21.945026	394	474	6	1	80	0.0125000
NODE_9935_length_863_cov_21.945026	394	474	7	20	80	0.2500000
NODE_9935_length_863_cov_21.945026	394	474	8	2	80	0.0250000
NODE_9935_length_863_cov_21.945026	394	474	10	15	80	0.1875000
NODE_9935_length_863_cov_21.945026	394	474	11	10	80	0.1250000
NODE_9935_length_863_cov_21.945026	394	474	12	32	80	0.4000000
NODE_9936_length_863_cov_19.794503	393	473	4	45	80	0.5625000
NODE_9936_length_863_cov_19.794503	393	473	5	21	80	0.2625000
NODE_9936_length_863_cov_19.794503	393	473	6	14	80	0.1750000
NODE_9936_length_863_cov_19.794503	446	526	2	29	80	0.3625000
NODE_9936_length_863_cov_19.794503	446	526	3	4	80	0.0500000
NODE_9936_length_863_cov_19.794503	446	526	4	28	80	0.3500000
NODE_9936_length_863_cov_19.794503	446	526	5	5	80	0.0625000
NODE_9936_length_863_cov_19.794503	446	526	6	14	80	0.1750000
NODE_9937_length_863_cov_11.778796	303	383	6	3	80	0.0375000
NODE_9937_length_863_cov_11.778796	303	383	7	2	80	0.0250000
NODE_9937_length_863_cov_11.778796	303	383	9	28	80	0.3500000
NODE_9937_length_863_cov_11.778796	303	383	10	4	80	0.0500000
NODE_9937_length_863_cov_11.778796	303	383	11	41	80	0.5125000
NODE_9937_length_863_cov_11.778796	303	383	12	2	80	0.0250000
NODE_9937_length_863_cov_11.778796	356	436	9	59	80	0.7375000
NODE_9937_length_863_cov_11.778796	356	436	10	17	80	0.2125000
NODE_9937_length_863_cov_11.778796	356	436	11	4	80	0.0500000
NODE_9938_length_863_cov_10.026178	283	363	4	5	80	0.0625000
NODE_9938_length_863_cov_10.026178	283	363	6	26	80	0.3250000
NODE_9938_length_863_cov_10.026178	283	363	8	32	80	0.4000000
NODE_9938_length_863_cov_10.026178	283	363	10	17	80	0.2125000
NODE_9938_length_863_cov_10.026178	336	416	8	40	80	0.5000000
NODE_9938_length_863_cov_10.026178	336	416	10	40	80	0.5000000
NODE_9957_length_862_cov_46.811271	272	352	5	7	80	0.0875000
NODE_9957_length_862_cov_46.811271	272	352	6	9	80	0.1125000
NODE_9957_length_862_cov_46.811271	272	352	7	28	80	0.3500000
NODE_9957_length_862_cov_46.811271	272	352	8	29	80	0.3625000
NODE_9957_length_862_cov_46.811271	272	352	10	7	80	0.0875000
NODE_9957_length_862_cov_46.811271	325	405	6	39	80	0.4875000
NODE_9957_length_862_cov_46.811271	325	405	7	15	80	0.1875000
NODE_9957_length_862_cov_46.811271	325	405	8	19	80	0.2375000
NODE_9957_length_862_cov_46.811271	325	405	10	7	80	0.0875000
NODE_9957_length_862_cov_46.811271	401	481	5	13	80	0.1625000
NODE_9957_length_862_cov_46.811271	401	481	6	8	80	0.1000000
NODE_9957_length_862_cov_46.811271	401	481	7	23	80	0.2875000
NODE_9957_length_862_cov_46.811271	401	481	8	36	80	0.4500000
NODE_9957_length_862_cov_46.811271	454	534	5	48	80	0.6000000
NODE_9957_length_862_cov_46.811271	454	534	7	16	80	0.2000000
NODE_9957_length_862_cov_46.811271	454	534	8	16	80	0.2000000
NODE_9958_length_862_cov_34.638270	259	339	3	30	80	0.3750000
NODE_9958_length_862_cov_34.638270	259	339	4	26	80	0.3250000
NODE_9958_length_862_cov_34.638270	259	339	5	24	80	0.3000000
NODE_9958_length_862_cov_34.638270	312	392	2	44	80	0.5500000
NODE_9958_length_862_cov_34.638270	312	392	3	6	80	0.0750000
NODE_9958_length_862_cov_34.638270	312	392	4	11	80	0.1375000
NODE_9958_length_862_cov_34.638270	312	392	5	19	80	0.2375000
NODE_9958_length_862_cov_34.638270	388	468	2	65	80	0.8125000
NODE_9958_length_862_cov_34.638270	388	468	3	15	80	0.1875000
NODE_9958_length_862_cov_34.638270	441	521	1	15	80	0.1875000
NODE_9958_length_862_cov_34.638270	441	521	2	60	80	0.7500000
NODE_9958_length_862_cov_34.638270	441	521	3	5	80	0.0625000
NODE_9959_length_862_cov_32.068152	468	548	5	11	80	0.1375000
NODE_9959_length_862_cov_32.068152	468	548	6	22	80	0.2750000
NODE_9959_length_862_cov_32.068152	468	548	7	16	80	0.2000000
NODE_9959_length_862_cov_32.068152	468	548	8	31	80	0.3875000
NODE_9959_length_862_cov_32.068152	521	601	2	7	80	0.0875000
NODE_9959_length_862_cov_32.068152	521	601	3	36	80	0.4500000
NODE_9959_length_862_cov_32.068152	521	601	4	1	80	0.0125000
NODE_9959_length_862_cov_32.068152	521	601	5	20	80	0.2500000
NODE_9959_length_862_cov_32.068152	521	601	6	16	80	0.2000000
NODE_9960_length_862_cov_23.584535	526	606	12	6	80	0.0750000
NODE_9960_length_862_cov_23.584535	526	606	13	18	80	0.2250000
NODE_9960_length_862_cov_23.584535	526	606	14	7	80	0.0875000
NODE_9960_length_862_cov_23.584535	526	606	15	5	80	0.0625000
NODE_9960_length_862_cov_23.584535	526	606	16	44	80	0.5500000
NODE_9960_length_862_cov_23.584535	579	659	9	7	80	0.0875000
NODE_9960_length_862_cov_23.584535	579	659	10	23	80	0.2875000
NODE_9960_length_862_cov_23.584535	579	659	11	22	80	0.2750000
NODE_9960_length_862_cov_23.584535	579	659	13	19	80	0.2375000
NODE_9960_length_862_cov_23.584535	579	659	16	9	80	0.1125000
NODE_9961_length_862_cov_19.980341	347	427	2	18	80	0.2250000
NODE_9961_length_862_cov_19.980341	347	427	4	43	80	0.5375000
NODE_9961_length_862_cov_19.980341	347	427	5	19	80	0.2375000
NODE_9961_length_862_cov_19.980341	400	480	3	30	80	0.3750000
NODE_9961_length_862_cov_19.980341	400	480	4	27	80	0.3375000
NODE_9961_length_862_cov_19.980341	400	480	5	23	80	0.2875000
NODE_9962_length_862_cov_19.079948	379	459	2	16	80	0.2000000
NODE_9962_length_862_cov_19.079948	379	459	3	44	80	0.5500000
NODE_9962_length_862_cov_19.079948	379	459	5	5	80	0.0625000
NODE_9962_length_862_cov_19.079948	379	459	7	4	80	0.0500000
NODE_9962_length_862_cov_19.079948	379	459	8	11	80	0.1375000
NODE_9962_length_862_cov_19.079948	432	512	2	7	80	0.0875000
NODE_9962_length_862_cov_19.079948	432	512	5	5	80	0.0625000
NODE_9962_length_862_cov_19.079948	432	512	7	4	80	0.0500000
NODE_9962_length_862_cov_19.079948	432	512	8	40	80	0.5000000
NODE_9962_length_862_cov_19.079948	432	512	9	6	80	0.0750000
NODE_9962_length_862_cov_19.079948	432	512	10	18	80	0.2250000
NODE_9963_length_862_cov_18.425950	94	174	0	80	80	1.0000000
NODE_9963_length_862_cov_18.425950	147	201	0	54	54	1.0000000
NODE_9963_length_862_cov_18.425950	392	472	13	6	80	0.0750000
NODE_9963_length_862_cov_18.425950	392	472	14	1	80	0.0125000
NODE_9963_length_862_cov_18.425950	392	472	15	6	80	0.0750000
NODE_9963_length_862_cov_18.425950	392	472	16	3	80	0.0375000
NODE_9963_length_862_cov_18.425950	392	472	17	2	80	0.0250000
NODE_9963_length_862_cov_18.425950	392	472	18	16	80	0.2000000
NODE_9963_length_862_cov_18.425950	392	472	19	27	80	0.3375000
NODE_9963_length_862_cov_18.425950	392	472	20	10	80	0.1250000
NODE_9963_length_862_cov_18.425950	392	472	21	9	80	0.1125000
NODE_9963_length_862_cov_18.425950	445	525	13	5	80	0.0625000
NODE_9963_length_862_cov_18.425950	445	525	15	6	80	0.0750000
NODE_9963_length_862_cov_18.425950	445	525	16	17	80	0.2125000
NODE_9963_length_862_cov_18.425950	445	525	18	4	80	0.0500000
NODE_9963_length_862_cov_18.425950	445	525	19	36	80	0.4500000
NODE_9963_length_862_cov_18.425950	445	525	20	6	80	0.0750000
NODE_9963_length_862_cov_18.425950	445	525	21	6	80	0.0750000
NODE_9964_length_862_cov_11.740498	348	428	5	36	80	0.4500000
NODE_9964_length_862_cov_11.740498	348	428	6	1	80	0.0125000
NODE_9964_length_862_cov_11.740498	348	428	9	43	80	0.5375000
NODE_9964_length_862_cov_11.740498	401	481	4	10	80	0.1250000
NODE_9964_length_862_cov_11.740498	401	481	5	67	80	0.8375000
NODE_9964_length_862_cov_11.740498	401	481	6	1	80	0.0125000
NODE_9964_length_862_cov_11.740498	401	481	9	2	80	0.0250000
NODE_9965_length_862_cov_11.685452	292	372	0	80	80	1.0000000
NODE_9965_length_862_cov_11.685452	345	425	0	80	80	1.0000000
NODE_9966_length_862_cov_8.259502	385	465	9	8	80	0.1000000
NODE_9966_length_862_cov_8.259502	385	465	10	33	80	0.4125000
NODE_9966_length_862_cov_8.259502	385	465	12	4	80	0.0500000
NODE_9966_length_862_cov_8.259502	385	465	13	8	80	0.1000000
NODE_9966_length_862_cov_8.259502	385	465	14	23	80	0.2875000
NODE_9966_length_862_cov_8.259502	385	465	15	4	80	0.0500000
NODE_9966_length_862_cov_8.259502	438	518	8	30	80	0.3750000
NODE_9966_length_862_cov_8.259502	438	518	11	1	80	0.0125000
NODE_9966_length_862_cov_8.259502	438	518	13	9	80	0.1125000
NODE_9966_length_862_cov_8.259502	438	518	14	16	80	0.2000000
NODE_9966_length_862_cov_8.259502	438	518	15	24	80	0.3000000
NODE_9970_length_862_cov_2.895151	388	468	0	16	80	0.2000000
NODE_9970_length_862_cov_2.895151	388	468	1	61	80	0.7625000
NODE_9970_length_862_cov_2.895151	388	468	2	3	80	0.0375000
NODE_9970_length_862_cov_2.895151	441	521	1	24	80	0.3000000
NODE_9970_length_862_cov_2.895151	441	521	2	56	80	0.7000000
NODE_9984_length_861_cov_52.679790	450	530	10	3	80	0.0375000
NODE_9984_length_861_cov_52.679790	450	530	11	5	80	0.0625000
NODE_9984_length_861_cov_52.679790	450	530	15	8	80	0.1000000
NODE_9984_length_861_cov_52.679790	450	530	16	20	80	0.2500000
NODE_9984_length_861_cov_52.679790	450	530	17	6	80	0.0750000
NODE_9984_length_861_cov_52.679790	450	530	18	27	80	0.3375000
NODE_9984_length_861_cov_52.679790	450	530	20	11	80	0.1375000
NODE_9984_length_861_cov_52.679790	503	583	13	15	80	0.1875000
NODE_9984_length_861_cov_52.679790	503	583	14	2	80	0.0250000
NODE_9984_length_861_cov_52.679790	503	583	15	5	80	0.0625000
NODE_9984_length_861_cov_52.679790	503	583	16	13	80	0.1625000
NODE_9984_length_861_cov_52.679790	503	583	17	4	80	0.0500000
NODE_9984_length_861_cov_52.679790	503	583	18	25	80	0.3125000
NODE_9984_length_861_cov_52.679790	503	583	19	3	80	0.0375000
NODE_9984_length_861_cov_52.679790	503	583	20	13	80	0.1625000
NODE_9985_length_861_cov_34.868766	470	550	10	2	80	0.0250000
NODE_9985_length_861_cov_34.868766	470	550	11	8	80	0.1000000
NODE_9985_length_861_cov_34.868766	470	550	12	7	80	0.0875000
NODE_9985_length_861_cov_34.868766	470	550	14	39	80	0.4875000
NODE_9985_length_861_cov_34.868766	470	550	15	24	80	0.3000000
NODE_9985_length_861_cov_34.868766	523	603	11	8	80	0.1000000
NODE_9985_length_861_cov_34.868766	523	603	12	21	80	0.2625000
NODE_9985_length_861_cov_34.868766	523	603	14	15	80	0.1875000
NODE_9985_length_861_cov_34.868766	523	603	15	2	80	0.0250000
NODE_9985_length_861_cov_34.868766	523	603	16	25	80	0.3125000
NODE_9985_length_861_cov_34.868766	523	603	17	9	80	0.1125000
NODE_9986_length_861_cov_25.622047	145	225	0	41	80	0.5125000
NODE_9986_length_861_cov_25.622047	145	225	1	39	80	0.4875000
NODE_9986_length_861_cov_25.622047	198	278	1	29	80	0.3625000
NODE_9986_length_861_cov_25.622047	198	278	2	51	80	0.6375000
NODE_9987_length_861_cov_22.052493	401	481	11	16	80	0.2000000
NODE_9987_length_861_cov_22.052493	401	481	13	2	80	0.0250000
NODE_9987_length_861_cov_22.052493	401	481	14	2	80	0.0250000
NODE_9987_length_861_cov_22.052493	401	481	15	3	80	0.0375000
NODE_9987_length_861_cov_22.052493	401	481	16	7	80	0.0875000
NODE_9987_length_861_cov_22.052493	401	481	17	14	80	0.1750000
NODE_9987_length_861_cov_22.052493	401	481	18	5	80	0.0625000
NODE_9987_length_861_cov_22.052493	401	481	19	31	80	0.3875000
NODE_9987_length_861_cov_22.052493	454	534	6	19	80	0.2375000
NODE_9987_length_861_cov_22.052493	454	534	7	3	80	0.0375000
NODE_9987_length_861_cov_22.052493	454	534	8	1	80	0.0125000
NODE_9987_length_861_cov_22.052493	454	534	11	41	80	0.5125000
NODE_9987_length_861_cov_22.052493	454	534	12	5	80	0.0625000
NODE_9987_length_861_cov_22.052493	454	534	13	2	80	0.0250000
NODE_9987_length_861_cov_22.052493	454	534	14	2	80	0.0250000
NODE_9987_length_861_cov_22.052493	454	534	15	3	80	0.0375000
NODE_9987_length_861_cov_22.052493	454	534	16	2	80	0.0250000
NODE_9987_length_861_cov_22.052493	454	534	17	2	80	0.0250000
NODE_9988_length_861_cov_19.913386	400	480	7	68	80	0.8500000
NODE_9988_length_861_cov_19.913386	400	480	9	12	80	0.1500000
NODE_9988_length_861_cov_19.913386	453	533	4	23	80	0.2875000
NODE_9988_length_861_cov_19.913386	453	533	5	10	80	0.1250000
NODE_9988_length_861_cov_19.913386	453	533	6	11	80	0.1375000
NODE_9988_length_861_cov_19.913386	453	533	7	25	80	0.3125000
NODE_9988_length_861_cov_19.913386	453	533	8	5	80	0.0625000
NODE_9988_length_861_cov_19.913386	453	533	9	6	80	0.0750000
NODE_9989_length_861_cov_15.237533	492	572	0	13	80	0.1625000
NODE_9989_length_861_cov_15.237533	492	572	1	9	80	0.1125000
NODE_9989_length_861_cov_15.237533	492	572	2	6	80	0.0750000
NODE_9989_length_861_cov_15.237533	492	572	3	52	80	0.6500000
NODE_9989_length_861_cov_15.237533	545	625	3	80	80	1.0000000
NODE_9990_length_861_cov_12.460630	451	531	1	5	80	0.0625000
NODE_9990_length_861_cov_12.460630	451	531	2	9	80	0.1125000
NODE_9990_length_861_cov_12.460630	451	531	3	3	80	0.0375000
NODE_9990_length_861_cov_12.460630	451	531	4	16	80	0.2000000
NODE_9990_length_861_cov_12.460630	451	531	5	31	80	0.3875000
NODE_9990_length_861_cov_12.460630	451	531	6	16	80	0.2000000
NODE_9990_length_861_cov_12.460630	504	584	5	20	80	0.2500000
NODE_9990_length_861_cov_12.460630	504	584	6	51	80	0.6375000
NODE_9990_length_861_cov_12.460630	504	584	7	9	80	0.1125000
NODE_9991_length_861_cov_9.463255	446	526	2	16	80	0.2000000
NODE_9991_length_861_cov_9.463255	446	526	4	8	80	0.1000000
NODE_9991_length_861_cov_9.463255	446	526	6	56	80	0.7000000
NODE_9991_length_861_cov_9.463255	499	579	4	61	80	0.7625000
NODE_9991_length_861_cov_9.463255	499	579	6	19	80	0.2375000
NODE_9992_length_861_cov_9.435696	348	423	3	75	75	1.0000000
NODE_9993_length_861_cov_7.009186	51	91	0	40	40	1.0000000
NODE_9993_length_861_cov_7.009186	185	265	0	80	80	1.0000000
NODE_9993_length_861_cov_7.009186	238	318	0	47	80	0.5875000
NODE_9993_length_861_cov_7.009186	238	318	2	33	80	0.4125000
NODE_10019_length_860_cov_54.315375	245	325	2	12	80	0.1500000
NODE_10019_length_860_cov_54.315375	245	325	3	45	80	0.5625000
NODE_10019_length_860_cov_54.315375	245	325	4	12	80	0.1500000
NODE_10019_length_860_cov_54.315375	245	325	5	3	80	0.0375000
NODE_10019_length_860_cov_54.315375	245	325	6	8	80	0.1000000
NODE_10019_length_860_cov_54.315375	298	378	3	4	80	0.0500000
NODE_10019_length_860_cov_54.315375	298	378	4	12	80	0.1500000
NODE_10019_length_860_cov_54.315375	298	378	5	3	80	0.0375000
NODE_10019_length_860_cov_54.315375	298	378	6	31	80	0.3875000
NODE_10019_length_860_cov_54.315375	298	378	7	29	80	0.3625000
NODE_10019_length_860_cov_54.315375	298	378	8	1	80	0.0125000
NODE_10019_length_860_cov_54.315375	374	454	6	2	80	0.0250000
NODE_10019_length_860_cov_54.315375	374	454	7	60	80	0.7500000
NODE_10019_length_860_cov_54.315375	374	454	8	18	80	0.2250000
NODE_10019_length_860_cov_54.315375	427	507	2	2	80	0.0250000
NODE_10019_length_860_cov_54.315375	427	507	3	7	80	0.0875000
NODE_10019_length_860_cov_54.315375	427	507	4	31	80	0.3875000
NODE_10019_length_860_cov_54.315375	427	507	5	3	80	0.0375000
NODE_10019_length_860_cov_54.315375	427	507	6	12	80	0.1500000
NODE_10019_length_860_cov_54.315375	427	507	7	25	80	0.3125000
NODE_10020_length_860_cov_29.618922	356	436	2	6	80	0.0750000
NODE_10020_length_860_cov_29.618922	356	436	5	31	80	0.3875000
NODE_10020_length_860_cov_29.618922	356	436	6	20	80	0.2500000
NODE_10020_length_860_cov_29.618922	356	436	7	1	80	0.0125000
NODE_10020_length_860_cov_29.618922	356	436	8	9	80	0.1125000
NODE_10020_length_860_cov_29.618922	356	436	13	8	80	0.1000000
NODE_10020_length_860_cov_29.618922	356	436	16	3	80	0.0375000
NODE_10020_length_860_cov_29.618922	356	436	17	2	80	0.0250000
NODE_10020_length_860_cov_29.618922	409	489	6	5	80	0.0625000
NODE_10020_length_860_cov_29.618922	409	489	8	9	80	0.1125000
NODE_10020_length_860_cov_29.618922	409	489	13	8	80	0.1000000
NODE_10020_length_860_cov_29.618922	409	489	16	3	80	0.0375000
NODE_10020_length_860_cov_29.618922	409	489	17	55	80	0.6875000
NODE_10021_length_860_cov_15.152431	393	473	8	7	80	0.0875000
NODE_10021_length_860_cov_15.152431	393	473	9	38	80	0.4750000
NODE_10021_length_860_cov_15.152431	393	473	11	21	80	0.2625000
NODE_10021_length_860_cov_15.152431	393	473	12	14	80	0.1750000
NODE_10021_length_860_cov_15.152431	446	526	5	29	80	0.3625000
NODE_10021_length_860_cov_15.152431	446	526	6	2	80	0.0250000
NODE_10021_length_860_cov_15.152431	446	526	8	29	80	0.3625000
NODE_10021_length_860_cov_15.152431	446	526	9	20	80	0.2500000
NODE_10022_length_860_cov_11.320631	343	423	2	60	80	0.7500000
NODE_10022_length_860_cov_11.320631	343	423	3	20	80	0.2500000
NODE_10022_length_860_cov_11.320631	396	476	2	34	80	0.4250000
NODE_10022_length_860_cov_11.320631	396	476	3	46	80	0.5750000
NODE_10049_length_859_cov_48.173684	432	512	9	1	80	0.0125000
NODE_10049_length_859_cov_48.173684	432	512	10	35	80	0.4375000
NODE_10049_length_859_cov_48.173684	432	512	11	18	80	0.2250000
NODE_10049_length_859_cov_48.173684	432	512	15	7	80	0.0875000
NODE_10049_length_859_cov_48.173684	432	512	16	4	80	0.0500000
NODE_10049_length_859_cov_48.173684	432	512	17	7	80	0.0875000
NODE_10049_length_859_cov_48.173684	432	512	18	8	80	0.1000000
NODE_10049_length_859_cov_48.173684	485	565	11	1	80	0.0125000
NODE_10049_length_859_cov_48.173684	485	565	15	29	80	0.3625000
NODE_10049_length_859_cov_48.173684	485	565	16	10	80	0.1250000
NODE_10049_length_859_cov_48.173684	485	565	17	32	80	0.4000000
NODE_10049_length_859_cov_48.173684	485	565	18	8	80	0.1000000
NODE_10050_length_859_cov_24.957895	402	482	2	80	80	1.0000000
NODE_10050_length_859_cov_24.957895	455	535	0	8	80	0.1000000
NODE_10050_length_859_cov_24.957895	455	535	1	1	80	0.0125000
NODE_10050_length_859_cov_24.957895	455	535	2	71	80	0.8875000
NODE_10051_length_859_cov_23.431579	251	331	20	20	80	0.2500000
NODE_10051_length_859_cov_23.431579	251	331	22	1	80	0.0125000
NODE_10051_length_859_cov_23.431579	251	331	24	1	80	0.0125000
NODE_10051_length_859_cov_23.431579	251	331	25	13	80	0.1625000
NODE_10051_length_859_cov_23.431579	251	331	26	7	80	0.0875000
NODE_10051_length_859_cov_23.431579	251	331	28	4	80	0.0500000
NODE_10051_length_859_cov_23.431579	251	331	32	1	80	0.0125000
NODE_10051_length_859_cov_23.431579	251	331	33	1	80	0.0125000
NODE_10051_length_859_cov_23.431579	251	331	34	15	80	0.1875000
NODE_10051_length_859_cov_23.431579	251	331	36	2	80	0.0250000
NODE_10051_length_859_cov_23.431579	251	331	38	9	80	0.1125000
NODE_10051_length_859_cov_23.431579	251	331	39	6	80	0.0750000
NODE_10051_length_859_cov_23.431579	304	384	26	19	80	0.2375000
NODE_10051_length_859_cov_23.431579	304	384	28	12	80	0.1500000
NODE_10051_length_859_cov_23.431579	304	384	30	8	80	0.1000000
NODE_10051_length_859_cov_23.431579	304	384	32	7	80	0.0875000
NODE_10051_length_859_cov_23.431579	304	384	33	8	80	0.1000000
NODE_10051_length_859_cov_23.431579	304	384	34	9	80	0.1125000
NODE_10051_length_859_cov_23.431579	304	384	36	2	80	0.0250000
NODE_10051_length_859_cov_23.431579	304	384	38	9	80	0.1125000
NODE_10051_length_859_cov_23.431579	304	384	39	6	80	0.0750000
NODE_10052_length_859_cov_20.523684	341	421	9	24	80	0.3000000
NODE_10052_length_859_cov_20.523684	341	421	10	5	80	0.0625000
NODE_10052_length_859_cov_20.523684	341	421	11	15	80	0.1875000
NODE_10052_length_859_cov_20.523684	341	421	12	26	80	0.3250000
NODE_10052_length_859_cov_20.523684	341	421	14	10	80	0.1250000
NODE_10052_length_859_cov_20.523684	394	474	9	10	80	0.1250000
NODE_10052_length_859_cov_20.523684	394	474	10	43	80	0.5375000
NODE_10052_length_859_cov_20.523684	394	474	11	4	80	0.0500000
NODE_10052_length_859_cov_20.523684	394	474	12	13	80	0.1625000
NODE_10052_length_859_cov_20.523684	394	474	14	10	80	0.1250000
NODE_10053_length_859_cov_17.996053	316	396	2	14	80	0.1750000
NODE_10053_length_859_cov_17.996053	316	396	4	39	80	0.4875000
NODE_10053_length_859_cov_17.996053	316	396	5	27	80	0.3375000
NODE_10053_length_859_cov_17.996053	369	449	2	13	80	0.1625000
NODE_10053_length_859_cov_17.996053	369	449	3	19	80	0.2375000
NODE_10053_length_859_cov_17.996053	369	449	4	16	80	0.2000000
NODE_10053_length_859_cov_17.996053	369	449	5	32	80	0.4000000
NODE_10054_length_859_cov_16.757895	404	484	20	24	80	0.3000000
NODE_10054_length_859_cov_16.757895	404	484	22	13	80	0.1625000
NODE_10054_length_859_cov_16.757895	404	484	23	13	80	0.1625000
NODE_10054_length_859_cov_16.757895	404	484	25	11	80	0.1375000
NODE_10054_length_859_cov_16.757895	404	484	26	7	80	0.0875000
NODE_10054_length_859_cov_16.757895	404	484	27	12	80	0.1500000
NODE_10054_length_859_cov_16.757895	457	537	13	1	80	0.0125000
NODE_10054_length_859_cov_16.757895	457	537	14	2	80	0.0250000
NODE_10054_length_859_cov_16.757895	457	537	15	4	80	0.0500000
NODE_10054_length_859_cov_16.757895	457	537	16	3	80	0.0375000
NODE_10054_length_859_cov_16.757895	457	537	18	7	80	0.0875000
NODE_10054_length_859_cov_16.757895	457	537	20	1	80	0.0125000
NODE_10054_length_859_cov_16.757895	457	537	21	17	80	0.2125000
NODE_10054_length_859_cov_16.757895	457	537	22	20	80	0.2500000
NODE_10054_length_859_cov_16.757895	457	537	23	7	80	0.0875000
NODE_10054_length_859_cov_16.757895	457	537	25	1	80	0.0125000
NODE_10054_length_859_cov_16.757895	457	537	26	7	80	0.0875000
NODE_10054_length_859_cov_16.757895	457	537	27	10	80	0.1250000
NODE_10055_length_859_cov_15.852632	346	426	8	22	80	0.2750000
NODE_10055_length_859_cov_15.852632	346	426	9	15	80	0.1875000
NODE_10055_length_859_cov_15.852632	346	426	10	15	80	0.1875000
NODE_10055_length_859_cov_15.852632	346	426	11	24	80	0.3000000
NODE_10055_length_859_cov_15.852632	346	426	12	4	80	0.0500000
NODE_10055_length_859_cov_15.852632	399	479	4	2	80	0.0250000
NODE_10055_length_859_cov_15.852632	399	479	5	15	80	0.1875000
NODE_10055_length_859_cov_15.852632	399	479	6	10	80	0.1250000
NODE_10055_length_859_cov_15.852632	399	479	7	15	80	0.1875000
NODE_10055_length_859_cov_15.852632	399	479	8	6	80	0.0750000
NODE_10055_length_859_cov_15.852632	399	479	9	11	80	0.1375000
NODE_10055_length_859_cov_15.852632	399	479	10	6	80	0.0750000
NODE_10055_length_859_cov_15.852632	399	479	11	11	80	0.1375000
NODE_10055_length_859_cov_15.852632	399	479	12	4	80	0.0500000
NODE_10056_length_859_cov_11.584211	407	487	6	8	80	0.1000000
NODE_10056_length_859_cov_11.584211	407	487	8	13	80	0.1625000
NODE_10056_length_859_cov_11.584211	407	487	9	53	80	0.6625000
NODE_10056_length_859_cov_11.584211	407	487	10	6	80	0.0750000
NODE_10056_length_859_cov_11.584211	460	540	3	4	80	0.0500000
NODE_10056_length_859_cov_11.584211	460	540	5	24	80	0.3000000
NODE_10056_length_859_cov_11.584211	460	540	6	27	80	0.3375000
NODE_10056_length_859_cov_11.584211	460	540	8	19	80	0.2375000
NODE_10056_length_859_cov_11.584211	460	540	10	6	80	0.0750000
NODE_10057_length_859_cov_10.296053	368	448	6	12	80	0.1500000
NODE_10057_length_859_cov_10.296053	368	448	7	2	80	0.0250000
NODE_10057_length_859_cov_10.296053	368	448	8	13	80	0.1625000
NODE_10057_length_859_cov_10.296053	368	448	9	20	80	0.2500000
NODE_10057_length_859_cov_10.296053	368	448	11	33	80	0.4125000
NODE_10057_length_859_cov_10.296053	421	501	6	5	80	0.0625000
NODE_10057_length_859_cov_10.296053	421	501	9	2	80	0.0250000
NODE_10057_length_859_cov_10.296053	421	501	10	12	80	0.1500000
NODE_10057_length_859_cov_10.296053	421	501	11	61	80	0.7625000
NODE_10066_length_859_cov_2.359211	498	578	1	53	80	0.6625000
NODE_10066_length_859_cov_2.359211	498	578	2	27	80	0.3375000
NODE_10066_length_859_cov_2.359211	551	631	1	62	80	0.7750000
NODE_10066_length_859_cov_2.359211	551	631	2	18	80	0.2250000
NODE_10079_length_858_cov_54.677207	277	357	0	9	80	0.1125000
NODE_10079_length_858_cov_54.677207	277	357	2	49	80	0.6125000
NODE_10079_length_858_cov_54.677207	277	357	18	22	80	0.2750000
NODE_10079_length_858_cov_54.677207	330	410	2	80	80	1.0000000
NODE_10080_length_858_cov_40.584980	500	580	5	40	80	0.5000000
NODE_10080_length_858_cov_40.584980	500	580	6	22	80	0.2750000
NODE_10080_length_858_cov_40.584980	500	580	7	18	80	0.2250000
NODE_10080_length_858_cov_40.584980	553	633	5	11	80	0.1375000
NODE_10080_length_858_cov_40.584980	553	633	6	38	80	0.4750000
NODE_10080_length_858_cov_40.584980	553	633	7	31	80	0.3875000
NODE_10081_length_858_cov_30.177866	363	443	5	36	80	0.4500000
NODE_10081_length_858_cov_30.177866	363	443	6	17	80	0.2125000
NODE_10081_length_858_cov_30.177866	363	443	7	27	80	0.3375000
NODE_10081_length_858_cov_30.177866	416	496	6	8	80	0.1000000
NODE_10081_length_858_cov_30.177866	416	496	7	33	80	0.4125000
NODE_10081_length_858_cov_30.177866	416	496	8	13	80	0.1625000
NODE_10081_length_858_cov_30.177866	416	496	9	5	80	0.0625000
NODE_10081_length_858_cov_30.177866	416	496	10	11	80	0.1375000
NODE_10081_length_858_cov_30.177866	416	496	11	10	80	0.1250000
NODE_10081_length_858_cov_30.177866	492	572	6	1	80	0.0125000
NODE_10081_length_858_cov_30.177866	492	572	7	12	80	0.1500000
NODE_10081_length_858_cov_30.177866	492	572	8	10	80	0.1250000
NODE_10081_length_858_cov_30.177866	492	572	9	57	80	0.7125000
NODE_10081_length_858_cov_30.177866	545	625	0	5	80	0.0625000
NODE_10081_length_858_cov_30.177866	545	625	3	4	80	0.0500000
NODE_10081_length_858_cov_30.177866	545	625	4	10	80	0.1250000
NODE_10081_length_858_cov_30.177866	545	625	5	4	80	0.0500000
NODE_10081_length_858_cov_30.177866	545	625	6	31	80	0.3875000
NODE_10081_length_858_cov_30.177866	545	625	7	12	80	0.1500000
NODE_10081_length_858_cov_30.177866	545	625	8	10	80	0.1250000
NODE_10081_length_858_cov_30.177866	545	625	9	4	80	0.0500000
NODE_10082_length_858_cov_18.534914	371	451	5	23	80	0.2875000
NODE_10082_length_858_cov_18.534914	371	451	8	57	80	0.7125000
NODE_10082_length_858_cov_18.534914	424	504	5	15	80	0.1875000
NODE_10082_length_858_cov_18.534914	424	504	8	65	80	0.8125000
NODE_10083_length_858_cov_15.378129	232	312	0	1	80	0.0125000
NODE_10083_length_858_cov_15.378129	232	312	1	39	80	0.4875000
NODE_10083_length_858_cov_15.378129	232	312	3	26	80	0.3250000
NODE_10083_length_858_cov_15.378129	232	312	5	14	80	0.1750000
NODE_10083_length_858_cov_15.378129	285	365	3	13	80	0.1625000
NODE_10083_length_858_cov_15.378129	285	365	5	67	80	0.8375000
NODE_10084_length_858_cov_12.310935	335	415	3	3	80	0.0375000
NODE_10084_length_858_cov_12.310935	335	415	4	19	80	0.2375000
NODE_10084_length_858_cov_12.310935	335	415	5	58	80	0.7250000
NODE_10084_length_858_cov_12.310935	388	468	3	24	80	0.3000000
NODE_10084_length_858_cov_12.310935	388	468	4	51	80	0.6375000
NODE_10084_length_858_cov_12.310935	388	468	5	5	80	0.0625000
NODE_10085_length_858_cov_7.835310	396	479	1	39	83	0.4698795
NODE_10085_length_858_cov_7.835310	396	479	2	44	83	0.5301205
NODE_10085_length_858_cov_7.835310	452	532	1	17	80	0.2125000
NODE_10085_length_858_cov_7.835310	452	532	2	63	80	0.7875000
NODE_10088_length_858_cov_4.953887	474	554	0	80	80	1.0000000
NODE_10088_length_858_cov_4.953887	527	607	0	80	80	1.0000000
NODE_10091_length_858_cov_3.475626	428	502	0	74	74	1.0000000
NODE_10091_length_858_cov_3.475626	498	578	0	80	80	1.0000000
NODE_10091_length_858_cov_3.475626	551	631	0	80	80	1.0000000
NODE_10108_length_857_cov_33.449868	384	455	22	2	71	0.0281690
NODE_10108_length_857_cov_33.449868	384	455	24	6	71	0.0845070
NODE_10108_length_857_cov_33.449868	384	455	25	1	71	0.0140845
NODE_10108_length_857_cov_33.449868	384	455	26	37	71	0.5211267
NODE_10108_length_857_cov_33.449868	384	455	27	9	71	0.1267606
NODE_10108_length_857_cov_33.449868	384	455	28	7	71	0.0985916
NODE_10108_length_857_cov_33.449868	384	455	32	9	71	0.1267606
NODE_10108_length_857_cov_33.449868	437	518	15	7	81	0.0864198
NODE_10108_length_857_cov_33.449868	437	518	16	1	81	0.0123457
NODE_10108_length_857_cov_33.449868	437	518	18	12	81	0.1481481
NODE_10108_length_857_cov_33.449868	437	518	19	7	81	0.0864198
NODE_10108_length_857_cov_33.449868	437	518	22	38	81	0.4691358
NODE_10108_length_857_cov_33.449868	437	518	26	11	81	0.1358025
NODE_10108_length_857_cov_33.449868	437	518	27	3	81	0.0370370
NODE_10108_length_857_cov_33.449868	437	518	28	2	81	0.0246914
NODE_10109_length_857_cov_32.527704	391	471	3	30	80	0.3750000
NODE_10109_length_857_cov_32.527704	391	471	5	1	80	0.0125000
NODE_10109_length_857_cov_32.527704	391	471	6	49	80	0.6125000
NODE_10109_length_857_cov_32.527704	444	524	3	13	80	0.1625000
NODE_10109_length_857_cov_32.527704	444	524	6	67	80	0.8375000
NODE_10110_length_857_cov_27.853562	310	390	0	41	80	0.5125000
NODE_10110_length_857_cov_27.853562	310	390	7	39	80	0.4875000
NODE_10110_length_857_cov_27.853562	363	443	7	43	80	0.5375000
NODE_10110_length_857_cov_27.853562	363	443	9	1	80	0.0125000
NODE_10110_length_857_cov_27.853562	363	443	10	20	80	0.2500000
NODE_10110_length_857_cov_27.853562	363	443	11	6	80	0.0750000
NODE_10110_length_857_cov_27.853562	363	443	12	5	80	0.0625000
NODE_10110_length_857_cov_27.853562	363	443	13	5	80	0.0625000
NODE_10111_length_857_cov_24.654354	282	362	0	80	80	1.0000000
NODE_10111_length_857_cov_24.654354	335	415	0	80	80	1.0000000
NODE_10112_length_857_cov_22.604222	374	456	8	15	82	0.1829268
NODE_10112_length_857_cov_22.604222	374	456	9	1	82	0.0121951
NODE_10112_length_857_cov_22.604222	374	456	10	1	82	0.0121951
NODE_10112_length_857_cov_22.604222	374	456	13	5	82	0.0609756
NODE_10112_length_857_cov_22.604222	374	456	15	11	82	0.1341463
NODE_10112_length_857_cov_22.604222	374	456	17	10	82	0.1219512
NODE_10112_length_857_cov_22.604222	374	456	18	12	82	0.1463415
NODE_10112_length_857_cov_22.604222	374	456	19	4	82	0.0487805
NODE_10112_length_857_cov_22.604222	374	456	20	18	82	0.2195122
NODE_10112_length_857_cov_22.604222	374	456	21	5	82	0.0609756
NODE_10112_length_857_cov_22.604222	427	509	18	22	82	0.2682927
NODE_10112_length_857_cov_22.604222	427	509	19	8	82	0.0975610
NODE_10112_length_857_cov_22.604222	427	509	20	44	82	0.5365854
NODE_10112_length_857_cov_22.604222	427	509	21	8	82	0.0975610
NODE_10113_length_857_cov_17.399736	320	400	2	36	80	0.4500000
NODE_10113_length_857_cov_17.399736	320	400	3	1	80	0.0125000
NODE_10113_length_857_cov_17.399736	320	400	5	19	80	0.2375000
NODE_10113_length_857_cov_17.399736	320	400	6	1	80	0.0125000
NODE_10113_length_857_cov_17.399736	320	400	7	23	80	0.2875000
NODE_10113_length_857_cov_17.399736	373	453	2	7	80	0.0875000
NODE_10113_length_857_cov_17.399736	373	453	3	5	80	0.0625000
NODE_10113_length_857_cov_17.399736	373	453	5	68	80	0.8500000
NODE_10114_length_857_cov_17.069921	388	468	2	18	80	0.2250000
NODE_10114_length_857_cov_17.069921	388	468	3	61	80	0.7625000
NODE_10114_length_857_cov_17.069921	388	468	4	1	80	0.0125000
NODE_10114_length_857_cov_17.069921	441	521	3	26	80	0.3250000
NODE_10114_length_857_cov_17.069921	441	521	4	54	80	0.6750000
NODE_10115_length_857_cov_11.816623	433	513	3	29	80	0.3625000
NODE_10115_length_857_cov_11.816623	433	513	4	31	80	0.3875000
NODE_10115_length_857_cov_11.816623	433	513	5	10	80	0.1250000
NODE_10115_length_857_cov_11.816623	433	513	6	10	80	0.1250000
NODE_10115_length_857_cov_11.816623	486	566	4	17	80	0.2125000
NODE_10115_length_857_cov_11.816623	486	566	6	41	80	0.5125000
NODE_10115_length_857_cov_11.816623	486	566	7	22	80	0.2750000
NODE_10116_length_857_cov_6.733509	513	593	0	80	80	1.0000000
NODE_10117_length_857_cov_6.251979	298	378	1	23	80	0.2875000
NODE_10117_length_857_cov_6.251979	298	378	2	25	80	0.3125000
NODE_10117_length_857_cov_6.251979	298	378	3	5	80	0.0625000
NODE_10117_length_857_cov_6.251979	298	378	4	27	80	0.3375000
NODE_10117_length_857_cov_6.251979	351	431	4	80	80	1.0000000
NODE_10118_length_857_cov_5.827177	323	403	0	56	80	0.7000000
NODE_10118_length_857_cov_5.827177	323	403	3	24	80	0.3000000
NODE_10118_length_857_cov_5.827177	376	456	0	3	80	0.0375000
NODE_10118_length_857_cov_5.827177	376	456	3	73	80	0.9125000
NODE_10118_length_857_cov_5.827177	376	456	6	4	80	0.0500000
NODE_10120_length_857_cov_4.530343	362	442	2	11	80	0.1375000
NODE_10120_length_857_cov_4.530343	362	442	3	32	80	0.4000000
NODE_10120_length_857_cov_4.530343	362	442	4	37	80	0.4625000
NODE_10120_length_857_cov_4.530343	415	495	2	63	80	0.7875000
NODE_10120_length_857_cov_4.530343	415	495	4	17	80	0.2125000
NODE_10128_length_857_cov_1.464380	179	249	0	70	70	1.0000000
NODE_10128_length_857_cov_1.464380	222	288	0	66	66	1.0000000
NODE_10138_length_856_cov_39.147952	157	237	3	23	80	0.2875000
NODE_10138_length_856_cov_39.147952	157	237	4	2	80	0.0250000
NODE_10138_length_856_cov_39.147952	157	237	5	11	80	0.1375000
NODE_10138_length_856_cov_39.147952	157	237	6	1	80	0.0125000
NODE_10138_length_856_cov_39.147952	157	237	7	1	80	0.0125000
NODE_10138_length_856_cov_39.147952	157	237	8	31	80	0.3875000
NODE_10138_length_856_cov_39.147952	157	237	9	4	80	0.0500000
NODE_10138_length_856_cov_39.147952	157	237	10	7	80	0.0875000
NODE_10138_length_856_cov_39.147952	210	290	8	16	80	0.2000000
NODE_10138_length_856_cov_39.147952	210	290	9	23	80	0.2875000
NODE_10138_length_856_cov_39.147952	210	290	10	11	80	0.1375000
NODE_10138_length_856_cov_39.147952	210	290	12	5	80	0.0625000
NODE_10138_length_856_cov_39.147952	210	290	13	25	80	0.3125000
NODE_10138_length_856_cov_39.147952	286	366	8	16	80	0.2000000
NODE_10138_length_856_cov_39.147952	286	366	9	2	80	0.0250000
NODE_10138_length_856_cov_39.147952	286	366	10	12	80	0.1500000
NODE_10138_length_856_cov_39.147952	286	366	11	18	80	0.2250000
NODE_10138_length_856_cov_39.147952	286	366	12	23	80	0.2875000
NODE_10138_length_856_cov_39.147952	286	366	13	9	80	0.1125000
NODE_10138_length_856_cov_39.147952	339	419	2	4	80	0.0500000
NODE_10138_length_856_cov_39.147952	339	419	3	6	80	0.0750000
NODE_10138_length_856_cov_39.147952	339	419	4	27	80	0.3375000
NODE_10138_length_856_cov_39.147952	339	419	5	2	80	0.0250000
NODE_10138_length_856_cov_39.147952	339	419	8	30	80	0.3750000
NODE_10138_length_856_cov_39.147952	339	419	9	2	80	0.0250000
NODE_10138_length_856_cov_39.147952	339	419	10	9	80	0.1125000
NODE_10139_length_856_cov_21.937913	353	433	2	30	80	0.3750000
NODE_10139_length_856_cov_21.937913	353	433	3	12	80	0.1500000
NODE_10139_length_856_cov_21.937913	353	433	4	38	80	0.4750000
NODE_10139_length_856_cov_21.937913	406	486	3	23	80	0.2875000
NODE_10139_length_856_cov_21.937913	406	486	4	57	80	0.7125000
NODE_10140_length_856_cov_20.227213	375	459	11	64	84	0.7619048
NODE_10140_length_856_cov_20.227213	375	459	17	10	84	0.1190476
NODE_10140_length_856_cov_20.227213	375	459	19	10	84	0.1190476
NODE_10140_length_856_cov_20.227213	432	512	11	7	80	0.0875000
NODE_10140_length_856_cov_20.227213	432	512	15	7	80	0.0875000
NODE_10140_length_856_cov_20.227213	432	512	16	1	80	0.0125000
NODE_10140_length_856_cov_20.227213	432	512	17	38	80	0.4750000
NODE_10140_length_856_cov_20.227213	432	512	18	4	80	0.0500000
NODE_10140_length_856_cov_20.227213	432	512	19	23	80	0.2875000
NODE_10141_length_856_cov_18.445178	340	420	2	1	80	0.0125000
NODE_10141_length_856_cov_18.445178	340	420	4	3	80	0.0375000
NODE_10141_length_856_cov_18.445178	340	420	6	14	80	0.1750000
NODE_10141_length_856_cov_18.445178	340	420	8	31	80	0.3875000
NODE_10141_length_856_cov_18.445178	340	420	9	11	80	0.1375000
NODE_10141_length_856_cov_18.445178	340	420	11	7	80	0.0875000
NODE_10141_length_856_cov_18.445178	340	420	13	13	80	0.1625000
NODE_10141_length_856_cov_18.445178	393	473	9	7	80	0.0875000
NODE_10141_length_856_cov_18.445178	393	473	11	7	80	0.0875000
NODE_10141_length_856_cov_18.445178	393	473	13	21	80	0.2625000
NODE_10141_length_856_cov_18.445178	393	473	14	45	80	0.5625000
NODE_10142_length_856_cov_16.564069	462	543	4	20	81	0.2469136
NODE_10142_length_856_cov_16.564069	462	543	5	37	81	0.4567901
NODE_10142_length_856_cov_16.564069	462	543	6	24	81	0.2962963
NODE_10142_length_856_cov_16.564069	516	596	2	17	80	0.2125000
NODE_10142_length_856_cov_16.564069	516	596	3	19	80	0.2375000
NODE_10142_length_856_cov_16.564069	516	596	4	37	80	0.4625000
NODE_10142_length_856_cov_16.564069	516	596	6	7	80	0.0875000
NODE_10142_length_856_cov_16.564069	516	593	2	14	77	0.1818182
NODE_10142_length_856_cov_16.564069	516	593	3	19	77	0.2467532
NODE_10142_length_856_cov_16.564069	516	593	4	37	77	0.4805195
NODE_10142_length_856_cov_16.564069	516	593	6	7	77	0.0909091
NODE_10143_length_856_cov_15.803170	403	483	0	4	80	0.0500000
NODE_10143_length_856_cov_15.803170	403	483	1	1	80	0.0125000
NODE_10143_length_856_cov_15.803170	403	483	2	75	80	0.9375000
NODE_10143_length_856_cov_15.803170	456	536	2	80	80	1.0000000
NODE_10144_length_856_cov_12.904888	345	425	3	52	80	0.6500000
NODE_10144_length_856_cov_12.904888	345	425	4	28	80	0.3500000
NODE_10144_length_856_cov_12.904888	398	478	3	9	80	0.1125000
NODE_10144_length_856_cov_12.904888	398	478	4	71	80	0.8875000
NODE_10145_length_856_cov_9.881110	338	418	4	13	80	0.1625000
NODE_10145_length_856_cov_9.881110	338	418	6	24	80	0.3000000
NODE_10145_length_856_cov_9.881110	338	418	8	21	80	0.2625000
NODE_10145_length_856_cov_9.881110	338	418	9	18	80	0.2250000
NODE_10145_length_856_cov_9.881110	338	418	10	4	80	0.0500000
NODE_10145_length_856_cov_9.881110	391	471	7	11	80	0.1375000
NODE_10145_length_856_cov_9.881110	391	471	8	5	80	0.0625000
NODE_10145_length_856_cov_9.881110	391	471	9	30	80	0.3750000
NODE_10145_length_856_cov_9.881110	391	471	10	10	80	0.1250000
NODE_10145_length_856_cov_9.881110	391	471	11	24	80	0.3000000
NODE_10146_length_856_cov_5.875826	405	485	0	6	80	0.0750000
NODE_10146_length_856_cov_5.875826	405	485	2	18	80	0.2250000
NODE_10146_length_856_cov_5.875826	405	485	3	56	80	0.7000000
NODE_10146_length_856_cov_5.875826	458	538	3	33	80	0.4125000
NODE_10146_length_856_cov_5.875826	458	538	5	15	80	0.1875000
NODE_10146_length_856_cov_5.875826	458	538	6	32	80	0.4000000
NODE_10149_length_856_cov_4.821664	466	546	0	80	80	1.0000000
NODE_10149_length_856_cov_4.821664	519	599	0	80	80	1.0000000
NODE_10151_length_856_cov_4.195509	248	328	1	53	80	0.6625000
NODE_10151_length_856_cov_4.195509	248	328	2	27	80	0.3375000
NODE_10151_length_856_cov_4.195509	301	381	2	61	80	0.7625000
NODE_10151_length_856_cov_4.195509	301	381	3	19	80	0.2375000
NODE_10152_length_856_cov_3.899604	262	339	0	77	77	1.0000000
NODE_10152_length_856_cov_3.899604	312	392	0	80	80	1.0000000
NODE_10176_length_855_cov_28.312169	541	621	11	2	80	0.0250000
NODE_10176_length_855_cov_28.312169	541	621	12	4	80	0.0500000
NODE_10176_length_855_cov_28.312169	541	621	13	4	80	0.0500000
NODE_10176_length_855_cov_28.312169	541	621	14	45	80	0.5625000
NODE_10176_length_855_cov_28.312169	541	621	15	5	80	0.0625000
NODE_10176_length_855_cov_28.312169	541	621	16	20	80	0.2500000
NODE_10176_length_855_cov_28.312169	594	674	4	3	80	0.0375000
NODE_10176_length_855_cov_28.312169	594	674	5	1	80	0.0125000
NODE_10176_length_855_cov_28.312169	594	674	6	7	80	0.0875000
NODE_10176_length_855_cov_28.312169	594	674	7	1	80	0.0125000
NODE_10176_length_855_cov_28.312169	594	674	8	12	80	0.1500000
NODE_10176_length_855_cov_28.312169	594	674	9	3	80	0.0375000
NODE_10176_length_855_cov_28.312169	594	674	10	14	80	0.1750000
NODE_10176_length_855_cov_28.312169	594	674	11	14	80	0.1750000
NODE_10176_length_855_cov_28.312169	594	674	12	4	80	0.0500000
NODE_10176_length_855_cov_28.312169	594	674	13	4	80	0.0500000
NODE_10176_length_855_cov_28.312169	594	674	14	1	80	0.0125000
NODE_10176_length_855_cov_28.312169	594	674	16	16	80	0.2000000
NODE_10177_length_855_cov_19.392857	692	772	16	12	80	0.1500000
NODE_10177_length_855_cov_19.392857	692	772	17	6	80	0.0750000
NODE_10177_length_855_cov_19.392857	692	772	19	4	80	0.0500000
NODE_10177_length_855_cov_19.392857	692	772	21	8	80	0.1000000
NODE_10177_length_855_cov_19.392857	692	772	25	10	80	0.1250000
NODE_10177_length_855_cov_19.392857	692	772	28	1	80	0.0125000
NODE_10177_length_855_cov_19.392857	692	772	29	6	80	0.0750000
NODE_10177_length_855_cov_19.392857	692	772	30	25	80	0.3125000
NODE_10177_length_855_cov_19.392857	692	772	32	8	80	0.1000000
NODE_10177_length_855_cov_19.392857	745	825	3	4	80	0.0500000
NODE_10177_length_855_cov_19.392857	745	825	5	7	80	0.0875000
NODE_10177_length_855_cov_19.392857	745	825	10	11	80	0.1375000
NODE_10177_length_855_cov_19.392857	745	825	11	15	80	0.1875000
NODE_10177_length_855_cov_19.392857	745	825	13	3	80	0.0375000
NODE_10177_length_855_cov_19.392857	745	825	15	3	80	0.0375000
NODE_10177_length_855_cov_19.392857	745	825	16	22	80	0.2750000
NODE_10177_length_855_cov_19.392857	745	825	17	6	80	0.0750000
NODE_10177_length_855_cov_19.392857	745	825	19	4	80	0.0500000
NODE_10177_length_855_cov_19.392857	745	825	21	5	80	0.0625000
NODE_10178_length_855_cov_13.402116	343	423	2	79	80	0.9875000
NODE_10178_length_855_cov_13.402116	343	423	3	1	80	0.0125000
NODE_10178_length_855_cov_13.402116	396	476	0	40	80	0.5000000
NODE_10178_length_855_cov_13.402116	396	476	1	9	80	0.1125000
NODE_10178_length_855_cov_13.402116	396	476	2	31	80	0.3875000
NODE_10179_length_855_cov_13.116402	295	375	4	18	80	0.2250000
NODE_10179_length_855_cov_13.116402	295	375	6	45	80	0.5625000
NODE_10179_length_855_cov_13.116402	295	375	7	14	80	0.1750000
NODE_10179_length_855_cov_13.116402	295	375	8	3	80	0.0375000
NODE_10179_length_855_cov_13.116402	348	428	6	10	80	0.1250000
NODE_10179_length_855_cov_13.116402	348	428	7	14	80	0.1750000
NODE_10179_length_855_cov_13.116402	348	428	8	28	80	0.3500000
NODE_10179_length_855_cov_13.116402	348	428	9	4	80	0.0500000
NODE_10179_length_855_cov_13.116402	348	428	11	24	80	0.3000000
NODE_10180_length_855_cov_11.179894	360	436	2	27	76	0.3552631
NODE_10180_length_855_cov_11.179894	360	436	4	45	76	0.5921053
NODE_10180_length_855_cov_11.179894	360	436	6	4	76	0.0526316
NODE_10180_length_855_cov_11.179894	409	489	4	23	80	0.2875000
NODE_10180_length_855_cov_11.179894	409	489	6	57	80	0.7125000
NODE_10183_length_855_cov_8.593915	339	419	0	80	80	1.0000000
NODE_10183_length_855_cov_8.593915	392	472	0	80	80	1.0000000
NODE_10206_length_854_cov_64.200000	586	666	6	21	80	0.2625000
NODE_10206_length_854_cov_64.200000	586	666	7	2	80	0.0250000
NODE_10206_length_854_cov_64.200000	586	666	8	3	80	0.0375000
NODE_10206_length_854_cov_64.200000	586	666	10	35	80	0.4375000
NODE_10206_length_854_cov_64.200000	586	666	13	10	80	0.1250000
NODE_10206_length_854_cov_64.200000	586	666	14	2	80	0.0250000
NODE_10206_length_854_cov_64.200000	586	666	15	7	80	0.0875000
NODE_10206_length_854_cov_64.200000	639	719	10	8	80	0.1000000
NODE_10206_length_854_cov_64.200000	639	719	11	4	80	0.0500000
NODE_10206_length_854_cov_64.200000	639	719	13	30	80	0.3750000
NODE_10206_length_854_cov_64.200000	639	719	14	3	80	0.0375000
NODE_10206_length_854_cov_64.200000	639	719	15	26	80	0.3250000
NODE_10206_length_854_cov_64.200000	639	719	16	9	80	0.1125000
NODE_10207_length_854_cov_46.037086	348	428	4	5	80	0.0625000
NODE_10207_length_854_cov_46.037086	348	428	5	47	80	0.5875000
NODE_10207_length_854_cov_46.037086	348	428	6	26	80	0.3250000
NODE_10207_length_854_cov_46.037086	348	428	7	2	80	0.0250000
NODE_10207_length_854_cov_46.037086	401	481	4	21	80	0.2625000
NODE_10207_length_854_cov_46.037086	401	481	5	30	80	0.3750000
NODE_10207_length_854_cov_46.037086	401	481	6	27	80	0.3375000
NODE_10207_length_854_cov_46.037086	401	481	7	2	80	0.0250000
NODE_10207_length_854_cov_46.037086	458	481	4	21	23	0.9130435
NODE_10207_length_854_cov_46.037086	458	481	5	2	23	0.0869565
NODE_10208_length_854_cov_45.633113	393	473	20	8	80	0.1000000
NODE_10208_length_854_cov_45.633113	393	473	21	1	80	0.0125000
NODE_10208_length_854_cov_45.633113	393	473	22	11	80	0.1375000
NODE_10208_length_854_cov_45.633113	393	473	23	9	80	0.1125000
NODE_10208_length_854_cov_45.633113	393	473	24	17	80	0.2125000
NODE_10208_length_854_cov_45.633113	393	473	25	22	80	0.2750000
NODE_10208_length_854_cov_45.633113	393	473	26	12	80	0.1500000
NODE_10208_length_854_cov_45.633113	446	526	14	9	80	0.1125000
NODE_10208_length_854_cov_45.633113	446	526	16	22	80	0.2750000
NODE_10208_length_854_cov_45.633113	446	526	17	1	80	0.0125000
NODE_10208_length_854_cov_45.633113	446	526	18	5	80	0.0625000
NODE_10208_length_854_cov_45.633113	446	526	19	7	80	0.0875000
NODE_10208_length_854_cov_45.633113	446	526	21	1	80	0.0125000
NODE_10208_length_854_cov_45.633113	446	526	23	11	80	0.1375000
NODE_10208_length_854_cov_45.633113	446	526	24	8	80	0.1000000
NODE_10208_length_854_cov_45.633113	446	526	25	16	80	0.2000000
NODE_10209_length_854_cov_40.407947	489	569	10	4	80	0.0500000
NODE_10209_length_854_cov_40.407947	489	569	11	5	80	0.0625000
NODE_10209_length_854_cov_40.407947	489	569	12	15	80	0.1875000
NODE_10209_length_854_cov_40.407947	489	569	15	26	80	0.3250000
NODE_10209_length_854_cov_40.407947	489	569	16	28	80	0.3500000
NODE_10209_length_854_cov_40.407947	489	569	17	2	80	0.0250000
NODE_10209_length_854_cov_40.407947	542	622	9	7	80	0.0875000
NODE_10209_length_854_cov_40.407947	542	622	10	5	80	0.0625000
NODE_10209_length_854_cov_40.407947	542	622	14	18	80	0.2250000
NODE_10209_length_854_cov_40.407947	542	622	15	18	80	0.2250000
NODE_10209_length_854_cov_40.407947	542	622	16	30	80	0.3750000
NODE_10209_length_854_cov_40.407947	542	622	17	2	80	0.0250000
NODE_10210_length_854_cov_29.773510	450	530	2	15	80	0.1875000
NODE_10210_length_854_cov_29.773510	450	530	3	28	80	0.3500000
NODE_10210_length_854_cov_29.773510	450	530	4	17	80	0.2125000
NODE_10210_length_854_cov_29.773510	450	530	5	16	80	0.2000000
NODE_10210_length_854_cov_29.773510	450	530	6	4	80	0.0500000
NODE_10210_length_854_cov_29.773510	503	583	3	5	80	0.0625000
NODE_10210_length_854_cov_29.773510	503	583	4	2	80	0.0250000
NODE_10210_length_854_cov_29.773510	503	583	5	16	80	0.2000000
NODE_10210_length_854_cov_29.773510	503	583	6	48	80	0.6000000
NODE_10210_length_854_cov_29.773510	503	583	7	9	80	0.1125000
NODE_10211_length_854_cov_22.968212	318	398	1	3	80	0.0375000
NODE_10211_length_854_cov_22.968212	318	398	2	34	80	0.4250000
NODE_10211_length_854_cov_22.968212	318	398	3	43	80	0.5375000
NODE_10211_length_854_cov_22.968212	371	451	2	7	80	0.0875000
NODE_10211_length_854_cov_22.968212	371	451	3	73	80	0.9125000
NODE_10212_length_854_cov_18.038411	387	467	15	7	80	0.0875000
NODE_10212_length_854_cov_18.038411	387	467	16	1	80	0.0125000
NODE_10212_length_854_cov_18.038411	387	467	17	1	80	0.0125000
NODE_10212_length_854_cov_18.038411	387	467	19	15	80	0.1875000
NODE_10212_length_854_cov_18.038411	387	467	20	31	80	0.3875000
NODE_10212_length_854_cov_18.038411	387	467	21	17	80	0.2125000
NODE_10212_length_854_cov_18.038411	387	467	22	1	80	0.0125000
NODE_10212_length_854_cov_18.038411	387	467	23	7	80	0.0875000
NODE_10212_length_854_cov_18.038411	440	520	14	2	80	0.0250000
NODE_10212_length_854_cov_18.038411	440	520	15	9	80	0.1125000
NODE_10212_length_854_cov_18.038411	440	520	16	1	80	0.0125000
NODE_10212_length_854_cov_18.038411	440	520	17	15	80	0.1875000
NODE_10212_length_854_cov_18.038411	440	520	19	34	80	0.4250000
NODE_10212_length_854_cov_18.038411	440	520	20	3	80	0.0375000
NODE_10212_length_854_cov_18.038411	440	520	21	8	80	0.1000000
NODE_10212_length_854_cov_18.038411	440	520	22	1	80	0.0125000
NODE_10212_length_854_cov_18.038411	440	520	23	7	80	0.0875000
NODE_10213_length_854_cov_13.774834	330	410	2	80	80	1.0000000
NODE_10213_length_854_cov_13.774834	383	463	0	11	80	0.1375000
NODE_10213_length_854_cov_13.774834	383	463	1	33	80	0.4125000
NODE_10213_length_854_cov_13.774834	383	463	2	36	80	0.4500000
NODE_10214_length_854_cov_11.998675	366	446	0	80	80	1.0000000
NODE_10214_length_854_cov_11.998675	419	499	0	80	80	1.0000000
NODE_10215_length_854_cov_7.600000	298	378	7	25	80	0.3125000
NODE_10215_length_854_cov_7.600000	298	378	8	31	80	0.3875000
NODE_10215_length_854_cov_7.600000	298	378	9	2	80	0.0250000
NODE_10215_length_854_cov_7.600000	298	378	10	22	80	0.2750000
NODE_10215_length_854_cov_7.600000	351	431	4	2	80	0.0250000
NODE_10215_length_854_cov_7.600000	351	431	5	26	80	0.3250000
NODE_10215_length_854_cov_7.600000	351	431	6	6	80	0.0750000
NODE_10215_length_854_cov_7.600000	351	431	7	4	80	0.0500000
NODE_10215_length_854_cov_7.600000	351	431	8	27	80	0.3375000
NODE_10215_length_854_cov_7.600000	351	431	10	15	80	0.1875000
NODE_10218_length_854_cov_4.939073	603	633	0	30	30	1.0000000
NODE_10226_length_854_cov_2.354967	613	633	1	20	20	1.0000000
NODE_10239_length_853_cov_61.988064	380	460	11	10	80	0.1250000
NODE_10239_length_853_cov_61.988064	380	460	12	3	80	0.0375000
NODE_10239_length_853_cov_61.988064	380	460	13	2	80	0.0250000
NODE_10239_length_853_cov_61.988064	380	460	14	7	80	0.0875000
NODE_10239_length_853_cov_61.988064	380	460	15	4	80	0.0500000
NODE_10239_length_853_cov_61.988064	380	460	16	7	80	0.0875000
NODE_10239_length_853_cov_61.988064	380	460	19	1	80	0.0125000
NODE_10239_length_853_cov_61.988064	380	460	20	7	80	0.0875000
NODE_10239_length_853_cov_61.988064	380	460	21	2	80	0.0250000
NODE_10239_length_853_cov_61.988064	380	460	22	17	80	0.2125000
NODE_10239_length_853_cov_61.988064	380	460	23	9	80	0.1125000
NODE_10239_length_853_cov_61.988064	380	460	25	1	80	0.0125000
NODE_10239_length_853_cov_61.988064	380	460	26	10	80	0.1250000
NODE_10239_length_853_cov_61.988064	433	513	22	7	80	0.0875000
NODE_10239_length_853_cov_61.988064	433	513	23	28	80	0.3500000
NODE_10239_length_853_cov_61.988064	433	513	24	1	80	0.0125000
NODE_10239_length_853_cov_61.988064	433	513	25	4	80	0.0500000
NODE_10239_length_853_cov_61.988064	433	513	26	12	80	0.1500000
NODE_10239_length_853_cov_61.988064	433	513	27	8	80	0.1000000
NODE_10239_length_853_cov_61.988064	433	513	28	20	80	0.2500000
NODE_10240_length_853_cov_33.683024	384	464	8	4	80	0.0500000
NODE_10240_length_853_cov_33.683024	384	464	9	9	80	0.1125000
NODE_10240_length_853_cov_33.683024	384	464	10	62	80	0.7750000
NODE_10240_length_853_cov_33.683024	384	464	12	1	80	0.0125000
NODE_10240_length_853_cov_33.683024	384	464	13	4	80	0.0500000
NODE_10240_length_853_cov_33.683024	437	517	4	17	80	0.2125000
NODE_10240_length_853_cov_33.683024	437	517	7	2	80	0.0250000
NODE_10240_length_853_cov_33.683024	437	517	8	18	80	0.2250000
NODE_10240_length_853_cov_33.683024	437	517	9	16	80	0.2000000
NODE_10240_length_853_cov_33.683024	437	517	10	15	80	0.1875000
NODE_10240_length_853_cov_33.683024	437	517	12	8	80	0.1000000
NODE_10240_length_853_cov_33.683024	437	517	13	4	80	0.0500000
NODE_10241_length_853_cov_31.965517	224	305	7	4	81	0.0493827
NODE_10241_length_853_cov_31.965517	224	305	8	3	81	0.0370370
NODE_10241_length_853_cov_31.965517	224	305	9	22	81	0.2716049
NODE_10241_length_853_cov_31.965517	224	305	10	5	81	0.0617284
NODE_10241_length_853_cov_31.965517	224	305	11	2	81	0.0246914
NODE_10241_length_853_cov_31.965517	224	305	12	4	81	0.0493827
NODE_10241_length_853_cov_31.965517	224	305	13	36	81	0.4444444
NODE_10241_length_853_cov_31.965517	224	305	14	5	81	0.0617284
NODE_10241_length_853_cov_31.965517	278	358	10	4	80	0.0500000
NODE_10241_length_853_cov_31.965517	278	358	12	5	80	0.0625000
NODE_10241_length_853_cov_31.965517	278	358	13	31	80	0.3875000
NODE_10241_length_853_cov_31.965517	278	358	14	35	80	0.4375000
NODE_10241_length_853_cov_31.965517	278	358	15	5	80	0.0625000
NODE_10241_length_853_cov_31.965517	354	434	8	9	80	0.1125000
NODE_10241_length_853_cov_31.965517	354	434	9	11	80	0.1375000
NODE_10241_length_853_cov_31.965517	354	434	10	20	80	0.2500000
NODE_10241_length_853_cov_31.965517	354	434	11	21	80	0.2625000
NODE_10241_length_853_cov_31.965517	354	434	12	19	80	0.2375000
NODE_10241_length_853_cov_31.965517	407	466	8	35	59	0.5932204
NODE_10241_length_853_cov_31.965517	407	466	9	16	59	0.2711864
NODE_10241_length_853_cov_31.965517	407	466	10	6	59	0.1016949
NODE_10241_length_853_cov_31.965517	407	466	11	2	59	0.0338983
NODE_10242_length_853_cov_16.551724	247	327	2	3	80	0.0375000
NODE_10242_length_853_cov_16.551724	247	327	3	18	80	0.2250000
NODE_10242_length_853_cov_16.551724	247	327	4	21	80	0.2625000
NODE_10242_length_853_cov_16.551724	247	327	5	30	80	0.3750000
NODE_10242_length_853_cov_16.551724	247	327	6	8	80	0.1000000
NODE_10242_length_853_cov_16.551724	300	380	3	1	80	0.0125000
NODE_10242_length_853_cov_16.551724	300	380	4	9	80	0.1125000
NODE_10242_length_853_cov_16.551724	300	380	5	9	80	0.1125000
NODE_10242_length_853_cov_16.551724	300	380	6	43	80	0.5375000
NODE_10242_length_853_cov_16.551724	300	380	7	16	80	0.2000000
NODE_10242_length_853_cov_16.551724	300	380	8	2	80	0.0250000
NODE_10242_length_853_cov_16.551724	376	456	6	30	80	0.3750000
NODE_10242_length_853_cov_16.551724	376	456	7	19	80	0.2375000
NODE_10242_length_853_cov_16.551724	376	456	8	11	80	0.1375000
NODE_10242_length_853_cov_16.551724	376	456	9	20	80	0.2500000
NODE_10242_length_853_cov_16.551724	429	509	5	1	80	0.0125000
NODE_10242_length_853_cov_16.551724	429	509	6	22	80	0.2750000
NODE_10242_length_853_cov_16.551724	429	509	7	27	80	0.3375000
NODE_10242_length_853_cov_16.551724	429	509	8	30	80	0.3750000
NODE_10243_length_853_cov_15.395225	395	475	2	80	80	1.0000000
NODE_10243_length_853_cov_15.395225	448	528	1	31	80	0.3875000
NODE_10243_length_853_cov_15.395225	448	528	2	49	80	0.6125000
NODE_10244_length_853_cov_15.086207	355	434	10	6	79	0.0759494
NODE_10244_length_853_cov_15.086207	355	434	11	8	79	0.1012658
NODE_10244_length_853_cov_15.086207	355	434	12	10	79	0.1265823
NODE_10244_length_853_cov_15.086207	355	434	13	55	79	0.6962025
NODE_10244_length_853_cov_15.086207	408	488	6	9	80	0.1125000
NODE_10244_length_853_cov_15.086207	408	488	7	2	80	0.0250000
NODE_10244_length_853_cov_15.086207	408	488	9	9	80	0.1125000
NODE_10244_length_853_cov_15.086207	408	488	10	4	80	0.0500000
NODE_10244_length_853_cov_15.086207	408	488	11	17	80	0.2125000
NODE_10244_length_853_cov_15.086207	408	488	12	6	80	0.0750000
NODE_10244_length_853_cov_15.086207	408	488	13	33	80	0.4125000
NODE_10245_length_853_cov_14.929708	160	240	1	8	80	0.1000000
NODE_10245_length_853_cov_14.929708	160	240	3	2	80	0.0250000
NODE_10245_length_853_cov_14.929708	160	240	4	19	80	0.2375000
NODE_10245_length_853_cov_14.929708	160	240	5	7	80	0.0875000
NODE_10245_length_853_cov_14.929708	160	240	6	8	80	0.1000000
NODE_10245_length_853_cov_14.929708	160	240	8	26	80	0.3250000
NODE_10245_length_853_cov_14.929708	160	240	9	10	80	0.1250000
NODE_10245_length_853_cov_14.929708	213	293	8	28	80	0.3500000
NODE_10245_length_853_cov_14.929708	213	293	9	52	80	0.6500000
NODE_10246_length_853_cov_11.299735	395	475	0	80	80	1.0000000
NODE_10246_length_853_cov_11.299735	448	528	0	80	80	1.0000000
NODE_10247_length_853_cov_9.571618	479	559	8	12	80	0.1500000
NODE_10247_length_853_cov_9.571618	479	559	9	47	80	0.5875000
NODE_10247_length_853_cov_9.571618	479	559	10	21	80	0.2625000
NODE_10247_length_853_cov_9.571618	532	612	8	5	80	0.0625000
NODE_10247_length_853_cov_9.571618	532	612	9	41	80	0.5125000
NODE_10247_length_853_cov_9.571618	532	612	10	29	80	0.3625000
NODE_10247_length_853_cov_9.571618	532	612	11	5	80	0.0625000
NODE_10248_length_853_cov_7.828912	265	345	3	14	80	0.1750000
NODE_10248_length_853_cov_7.828912	265	345	5	28	80	0.3500000
NODE_10248_length_853_cov_7.828912	265	345	6	38	80	0.4750000
NODE_10248_length_853_cov_7.828912	318	398	0	13	80	0.1625000
NODE_10248_length_853_cov_7.828912	318	398	2	12	80	0.1500000
NODE_10248_length_853_cov_7.828912	318	398	3	42	80	0.5250000
NODE_10248_length_853_cov_7.828912	318	398	5	13	80	0.1625000
NODE_10249_length_853_cov_7.623342	255	335	1	39	80	0.4875000
NODE_10249_length_853_cov_7.623342	255	335	2	41	80	0.5125000
NODE_10249_length_853_cov_7.623342	308	388	2	80	80	1.0000000
NODE_10253_length_853_cov_3.173740	212	292	0	42	80	0.5250000
NODE_10253_length_853_cov_3.173740	212	292	1	38	80	0.4750000
NODE_10253_length_853_cov_3.173740	265	343	1	40	78	0.5128205
NODE_10253_length_853_cov_3.173740	265	343	2	38	78	0.4871795
NODE_10258_length_853_cov_1.823607	710	773	0	60	63	0.9523810
NODE_10258_length_853_cov_1.823607	710	773	1	3	63	0.0476190
NODE_10258_length_853_cov_1.823607	711	773	0	60	62	0.9677419
NODE_10258_length_853_cov_1.823607	711	773	1	2	62	0.0322581
NODE_10258_length_853_cov_1.823607	711	773	0	60	62	0.9677419
NODE_10258_length_853_cov_1.823607	711	773	1	2	62	0.0322581
NODE_10258_length_853_cov_1.823607	746	826	0	80	80	1.0000000
NODE_10267_length_852_cov_30.022576	279	359	1	24	80	0.3000000
NODE_10267_length_852_cov_30.022576	279	359	2	56	80	0.7000000
NODE_10267_length_852_cov_30.022576	332	412	1	77	80	0.9625000
NODE_10267_length_852_cov_30.022576	332	412	2	3	80	0.0375000
NODE_10268_length_852_cov_19.373174	353	433	1	53	80	0.6625000
NODE_10268_length_852_cov_19.373174	353	433	2	27	80	0.3375000
NODE_10268_length_852_cov_19.373174	406	486	0	44	80	0.5500000
NODE_10268_length_852_cov_19.373174	406	486	1	36	80	0.4500000
NODE_10269_length_852_cov_18.853918	297	377	2	80	80	1.0000000
NODE_10269_length_852_cov_18.853918	350	430	0	4	80	0.0500000
NODE_10269_length_852_cov_18.853918	350	430	1	17	80	0.2125000
NODE_10269_length_852_cov_18.853918	350	430	2	59	80	0.7375000
NODE_10269_length_852_cov_18.853918	426	506	0	10	80	0.1250000
NODE_10269_length_852_cov_18.853918	426	506	1	5	80	0.0625000
NODE_10269_length_852_cov_18.853918	426	506	2	65	80	0.8125000
NODE_10269_length_852_cov_18.853918	489	559	2	70	70	1.0000000
NODE_10270_length_852_cov_17.391766	472	552	0	9	80	0.1125000
NODE_10270_length_852_cov_17.391766	472	552	1	52	80	0.6500000
NODE_10270_length_852_cov_17.391766	472	552	2	19	80	0.2375000
NODE_10270_length_852_cov_17.391766	525	605	0	62	80	0.7750000
NODE_10270_length_852_cov_17.391766	525	605	1	18	80	0.2250000
NODE_10271_length_852_cov_8.818061	513	593	2	19	80	0.2375000
NODE_10271_length_852_cov_8.818061	513	593	3	23	80	0.2875000
NODE_10271_length_852_cov_8.818061	513	593	4	38	80	0.4750000
NODE_10271_length_852_cov_8.818061	566	646	3	59	80	0.7375000
NODE_10271_length_852_cov_8.818061	566	646	4	21	80	0.2625000
NODE_10274_length_852_cov_4.403718	493	573	0	80	80	1.0000000
NODE_10274_length_852_cov_4.403718	546	626	0	80	80	1.0000000
NODE_10285_length_851_cov_33.953457	329	409	7	14	80	0.1750000
NODE_10285_length_851_cov_33.953457	329	409	8	19	80	0.2375000
NODE_10285_length_851_cov_33.953457	329	409	10	35	80	0.4375000
NODE_10285_length_851_cov_33.953457	329	409	11	4	80	0.0500000
NODE_10285_length_851_cov_33.953457	329	409	12	3	80	0.0375000
NODE_10285_length_851_cov_33.953457	329	409	13	5	80	0.0625000
NODE_10285_length_851_cov_33.953457	382	462	7	1	80	0.0125000
NODE_10285_length_851_cov_33.953457	382	462	8	4	80	0.0500000
NODE_10285_length_851_cov_33.953457	382	462	9	2	80	0.0250000
NODE_10285_length_851_cov_33.953457	382	462	10	31	80	0.3875000
NODE_10285_length_851_cov_33.953457	382	462	11	19	80	0.2375000
NODE_10285_length_851_cov_33.953457	382	462	12	18	80	0.2250000
NODE_10285_length_851_cov_33.953457	382	462	13	5	80	0.0625000
NODE_10286_length_851_cov_30.488032	395	475	8	1	80	0.0125000
NODE_10286_length_851_cov_30.488032	395	475	9	6	80	0.0750000
NODE_10286_length_851_cov_30.488032	395	475	10	13	80	0.1625000
NODE_10286_length_851_cov_30.488032	395	475	11	3	80	0.0375000
NODE_10286_length_851_cov_30.488032	395	475	12	18	80	0.2250000
NODE_10286_length_851_cov_30.488032	395	475	13	39	80	0.4875000
NODE_10286_length_851_cov_30.488032	448	528	5	9	80	0.1125000
NODE_10286_length_851_cov_30.488032	448	528	6	2	80	0.0250000
NODE_10286_length_851_cov_30.488032	448	528	8	15	80	0.1875000
NODE_10286_length_851_cov_30.488032	448	528	9	34	80	0.4250000
NODE_10286_length_851_cov_30.488032	448	528	10	13	80	0.1625000
NODE_10286_length_851_cov_30.488032	448	528	12	7	80	0.0875000
NODE_10287_length_851_cov_27.481383	353	433	6	21	80	0.2625000
NODE_10287_length_851_cov_27.481383	353	433	8	7	80	0.0875000
NODE_10287_length_851_cov_27.481383	353	433	9	42	80	0.5250000
NODE_10287_length_851_cov_27.481383	353	433	11	9	80	0.1125000
NODE_10287_length_851_cov_27.481383	353	433	12	1	80	0.0125000
NODE_10287_length_851_cov_27.481383	406	486	7	13	80	0.1625000
NODE_10287_length_851_cov_27.481383	406	486	8	11	80	0.1375000
NODE_10287_length_851_cov_27.481383	406	486	9	24	80	0.3000000
NODE_10287_length_851_cov_27.481383	406	486	11	12	80	0.1500000
NODE_10287_length_851_cov_27.481383	406	486	12	20	80	0.2500000
NODE_10288_length_851_cov_23.656915	345	425	8	17	80	0.2125000
NODE_10288_length_851_cov_23.656915	345	425	9	15	80	0.1875000
NODE_10288_length_851_cov_23.656915	345	425	10	48	80	0.6000000
NODE_10288_length_851_cov_23.656915	398	478	7	38	80	0.4750000
NODE_10288_length_851_cov_23.656915	398	478	8	28	80	0.3500000
NODE_10288_length_851_cov_23.656915	398	478	10	14	80	0.1750000
NODE_10289_length_851_cov_19.769947	298	378	6	35	80	0.4375000
NODE_10289_length_851_cov_19.769947	298	378	8	20	80	0.2500000
NODE_10289_length_851_cov_19.769947	298	378	9	25	80	0.3125000
NODE_10289_length_851_cov_19.769947	351	431	4	1	80	0.0125000
NODE_10289_length_851_cov_19.769947	351	431	8	5	80	0.0625000
NODE_10289_length_851_cov_19.769947	351	431	9	32	80	0.4000000
NODE_10289_length_851_cov_19.769947	351	431	10	42	80	0.5250000
NODE_10290_length_851_cov_17.386968	459	539	5	21	80	0.2625000
NODE_10290_length_851_cov_17.386968	459	539	6	16	80	0.2000000
NODE_10290_length_851_cov_17.386968	459	539	7	40	80	0.5000000
NODE_10290_length_851_cov_17.386968	459	539	8	3	80	0.0375000
NODE_10290_length_851_cov_17.386968	512	592	3	3	80	0.0375000
NODE_10290_length_851_cov_17.386968	512	592	4	34	80	0.4250000
NODE_10290_length_851_cov_17.386968	512	592	6	25	80	0.3125000
NODE_10290_length_851_cov_17.386968	512	592	7	18	80	0.2250000
NODE_10291_length_851_cov_13.519947	323	403	3	26	80	0.3250000
NODE_10291_length_851_cov_13.519947	323	403	4	23	80	0.2875000
NODE_10291_length_851_cov_13.519947	323	403	5	3	80	0.0375000
NODE_10291_length_851_cov_13.519947	323	403	7	28	80	0.3500000
NODE_10291_length_851_cov_13.519947	376	456	4	4	80	0.0500000
NODE_10291_length_851_cov_13.519947	376	456	5	34	80	0.4250000
NODE_10291_length_851_cov_13.519947	376	456	7	42	80	0.5250000
NODE_10292_length_851_cov_11.771277	403	483	0	80	80	1.0000000
NODE_10292_length_851_cov_11.771277	456	536	0	80	80	1.0000000
NODE_10293_length_851_cov_11.698138	227	307	0	44	80	0.5500000
NODE_10293_length_851_cov_11.698138	227	307	1	36	80	0.4500000
NODE_10293_length_851_cov_11.698138	280	360	1	44	80	0.5500000
NODE_10293_length_851_cov_11.698138	280	360	2	3	80	0.0375000
NODE_10293_length_851_cov_11.698138	280	360	3	33	80	0.4125000
NODE_10293_length_851_cov_11.698138	356	436	3	21	80	0.2625000
NODE_10293_length_851_cov_11.698138	356	436	4	33	80	0.4125000
NODE_10293_length_851_cov_11.698138	356	436	5	26	80	0.3250000
NODE_10293_length_851_cov_11.698138	409	489	3	18	80	0.2250000
NODE_10293_length_851_cov_11.698138	409	489	4	34	80	0.4250000
NODE_10293_length_851_cov_11.698138	409	489	5	28	80	0.3500000
NODE_10294_length_851_cov_11.672872	372	452	2	80	80	1.0000000
NODE_10294_length_851_cov_11.672872	425	505	0	32	80	0.4000000
NODE_10294_length_851_cov_11.672872	425	505	2	48	80	0.6000000
NODE_10295_length_851_cov_10.938830	418	499	0	81	81	1.0000000
NODE_10296_length_851_cov_10.074468	454	534	5	6	80	0.0750000
NODE_10296_length_851_cov_10.074468	454	534	6	6	80	0.0750000
NODE_10296_length_851_cov_10.074468	454	534	7	7	80	0.0875000
NODE_10296_length_851_cov_10.074468	454	534	8	4	80	0.0500000
NODE_10296_length_851_cov_10.074468	454	534	10	35	80	0.4375000
NODE_10296_length_851_cov_10.074468	454	534	11	22	80	0.2750000
NODE_10296_length_851_cov_10.074468	507	587	3	33	80	0.4125000
NODE_10296_length_851_cov_10.074468	507	587	4	2	80	0.0250000
NODE_10296_length_851_cov_10.074468	507	587	5	24	80	0.3000000
NODE_10296_length_851_cov_10.074468	507	587	6	6	80	0.0750000
NODE_10296_length_851_cov_10.074468	507	587	7	7	80	0.0875000
NODE_10296_length_851_cov_10.074468	507	587	8	4	80	0.0500000
NODE_10296_length_851_cov_10.074468	507	587	10	4	80	0.0500000
NODE_10297_length_851_cov_7.599734	330	410	1	63	80	0.7875000
NODE_10297_length_851_cov_7.599734	330	410	2	17	80	0.2125000
NODE_10297_length_851_cov_7.599734	383	463	1	12	80	0.1500000
NODE_10297_length_851_cov_7.599734	383	463	2	68	80	0.8500000
NODE_10298_length_851_cov_5.639628	379	459	0	63	80	0.7875000
NODE_10298_length_851_cov_5.639628	379	459	2	17	80	0.2125000
NODE_10298_length_851_cov_5.639628	432	512	0	10	80	0.1250000
NODE_10298_length_851_cov_5.639628	432	512	2	70	80	0.8750000
NODE_10300_length_851_cov_3.880319	729	765	0	36	36	1.0000000
NODE_10300_length_851_cov_3.880319	743	824	0	81	81	1.0000000
NODE_10301_length_851_cov_3.823138	380	460	2	57	80	0.7125000
NODE_10301_length_851_cov_3.823138	380	460	3	23	80	0.2875000
NODE_10301_length_851_cov_3.823138	433	513	1	51	80	0.6375000
NODE_10301_length_851_cov_3.823138	433	513	2	29	80	0.3625000
NODE_10318_length_851_cov_1.130319	33	103	0	70	70	1.0000000
NODE_10326_length_850_cov_36.527297	360	440	3	17	80	0.2125000
NODE_10326_length_850_cov_36.527297	360	440	4	40	80	0.5000000
NODE_10326_length_850_cov_36.527297	360	440	5	23	80	0.2875000
NODE_10326_length_850_cov_36.527297	413	493	2	11	80	0.1375000
NODE_10326_length_850_cov_36.527297	413	493	4	47	80	0.5875000
NODE_10326_length_850_cov_36.527297	413	493	5	22	80	0.2750000
NODE_10327_length_850_cov_31.006658	330	410	10	9	80	0.1125000
NODE_10327_length_850_cov_31.006658	330	410	11	13	80	0.1625000
NODE_10327_length_850_cov_31.006658	330	410	14	22	80	0.2750000
NODE_10327_length_850_cov_31.006658	330	410	15	35	80	0.4375000
NODE_10327_length_850_cov_31.006658	330	410	16	1	80	0.0125000
NODE_10327_length_850_cov_31.006658	383	463	13	7	80	0.0875000
NODE_10327_length_850_cov_31.006658	383	463	14	24	80	0.3000000
NODE_10327_length_850_cov_31.006658	383	463	15	38	80	0.4750000
NODE_10327_length_850_cov_31.006658	383	463	16	11	80	0.1375000
NODE_10328_length_850_cov_30.460719	251	331	7	4	80	0.0500000
NODE_10328_length_850_cov_30.460719	251	331	9	4	80	0.0500000
NODE_10328_length_850_cov_30.460719	251	331	10	72	80	0.9000000
NODE_10328_length_850_cov_30.460719	304	384	3	7	80	0.0875000
NODE_10328_length_850_cov_30.460719	304	384	4	3	80	0.0375000
NODE_10328_length_850_cov_30.460719	304	384	5	40	80	0.5000000
NODE_10328_length_850_cov_30.460719	304	384	6	3	80	0.0375000
NODE_10328_length_850_cov_30.460719	304	384	9	4	80	0.0500000
NODE_10328_length_850_cov_30.460719	304	384	10	23	80	0.2875000
NODE_10329_length_850_cov_25.263648	355	435	8	23	80	0.2875000
NODE_10329_length_850_cov_25.263648	355	435	10	9	80	0.1125000
NODE_10329_length_850_cov_25.263648	355	435	11	32	80	0.4000000
NODE_10329_length_850_cov_25.263648	355	435	12	12	80	0.1500000
NODE_10329_length_850_cov_25.263648	355	435	13	4	80	0.0500000
NODE_10329_length_850_cov_25.263648	408	488	10	10	80	0.1250000
NODE_10329_length_850_cov_25.263648	408	488	11	32	80	0.4000000
NODE_10329_length_850_cov_25.263648	408	488	12	12	80	0.1500000
NODE_10329_length_850_cov_25.263648	408	488	13	14	80	0.1750000
NODE_10329_length_850_cov_25.263648	408	488	15	12	80	0.1500000
NODE_10330_length_850_cov_21.368842	290	370	7	17	80	0.2125000
NODE_10330_length_850_cov_21.368842	290	370	8	30	80	0.3750000
NODE_10330_length_850_cov_21.368842	290	370	9	33	80	0.4125000
NODE_10330_length_850_cov_21.368842	343	423	6	14	80	0.1750000
NODE_10330_length_850_cov_21.368842	343	423	7	10	80	0.1250000
NODE_10330_length_850_cov_21.368842	343	423	9	43	80	0.5375000
NODE_10330_length_850_cov_21.368842	343	423	10	1	80	0.0125000
NODE_10330_length_850_cov_21.368842	343	423	11	12	80	0.1500000
NODE_10331_length_850_cov_20.500666	318	398	11	13	80	0.1625000
NODE_10331_length_850_cov_20.500666	318	398	12	20	80	0.2500000
NODE_10331_length_850_cov_20.500666	318	398	13	7	80	0.0875000
NODE_10331_length_850_cov_20.500666	318	398	19	21	80	0.2625000
NODE_10331_length_850_cov_20.500666	318	398	20	19	80	0.2375000
NODE_10331_length_850_cov_20.500666	371	451	14	35	80	0.4375000
NODE_10331_length_850_cov_20.500666	371	451	16	10	80	0.1250000
NODE_10331_length_850_cov_20.500666	371	451	19	8	80	0.1000000
NODE_10331_length_850_cov_20.500666	371	451	20	27	80	0.3375000
NODE_10332_length_850_cov_17.268975	398	478	2	68	80	0.8500000
NODE_10332_length_850_cov_17.268975	398	478	3	12	80	0.1500000
NODE_10332_length_850_cov_17.268975	451	531	1	15	80	0.1875000
NODE_10332_length_850_cov_17.268975	451	531	2	18	80	0.2250000
NODE_10332_length_850_cov_17.268975	451	531	3	47	80	0.5875000
NODE_10333_length_850_cov_14.728362	379	459	3	11	80	0.1375000
NODE_10333_length_850_cov_14.728362	379	459	5	1	80	0.0125000
NODE_10333_length_850_cov_14.728362	379	459	6	11	80	0.1375000
NODE_10333_length_850_cov_14.728362	379	459	8	18	80	0.2250000
NODE_10333_length_850_cov_14.728362	379	459	9	12	80	0.1500000
NODE_10333_length_850_cov_14.728362	379	459	10	9	80	0.1125000
NODE_10333_length_850_cov_14.728362	379	459	11	6	80	0.0750000
NODE_10333_length_850_cov_14.728362	379	459	12	12	80	0.1500000
NODE_10333_length_850_cov_14.728362	432	512	8	2	80	0.0250000
NODE_10333_length_850_cov_14.728362	432	512	10	7	80	0.0875000
NODE_10333_length_850_cov_14.728362	432	512	11	59	80	0.7375000
NODE_10333_length_850_cov_14.728362	432	512	12	12	80	0.1500000
NODE_10334_length_850_cov_14.230360	313	393	3	12	80	0.1500000
NODE_10334_length_850_cov_14.230360	313	393	4	46	80	0.5750000
NODE_10334_length_850_cov_14.230360	313	393	6	20	80	0.2500000
NODE_10334_length_850_cov_14.230360	313	393	7	2	80	0.0250000
NODE_10334_length_850_cov_14.230360	366	446	1	32	80	0.4000000
NODE_10334_length_850_cov_14.230360	366	446	3	1	80	0.0125000
NODE_10334_length_850_cov_14.230360	366	446	4	47	80	0.5875000
NODE_10335_length_850_cov_12.387483	337	417	1	80	80	1.0000000
NODE_10335_length_850_cov_12.387483	390	470	0	30	80	0.3750000
NODE_10335_length_850_cov_12.387483	390	470	1	50	80	0.6250000
NODE_10335_length_850_cov_12.387483	466	545	0	27	79	0.3417721
NODE_10335_length_850_cov_12.387483	466	545	2	52	79	0.6582279
NODE_10335_length_850_cov_12.387483	518	598	2	80	80	1.0000000
NODE_10336_length_850_cov_11.402130	329	409	5	10	80	0.1250000
NODE_10336_length_850_cov_11.402130	329	409	6	35	80	0.4375000
NODE_10336_length_850_cov_11.402130	329	409	7	23	80	0.2875000
NODE_10336_length_850_cov_11.402130	329	409	8	12	80	0.1500000
NODE_10336_length_850_cov_11.402130	382	462	6	1	80	0.0125000
NODE_10336_length_850_cov_11.402130	382	462	7	22	80	0.2750000
NODE_10336_length_850_cov_11.402130	382	462	8	12	80	0.1500000
NODE_10336_length_850_cov_11.402130	382	462	9	28	80	0.3500000
NODE_10336_length_850_cov_11.402130	382	462	10	8	80	0.1000000
NODE_10336_length_850_cov_11.402130	382	462	11	9	80	0.1125000
NODE_10337_length_850_cov_10.326232	330	410	2	80	80	1.0000000
NODE_10337_length_850_cov_10.326232	383	463	0	21	80	0.2625000
NODE_10337_length_850_cov_10.326232	383	463	2	59	80	0.7375000
NODE_10338_length_850_cov_9.675100	464	544	3	12	80	0.1500000
NODE_10338_length_850_cov_9.675100	464	544	4	19	80	0.2375000
NODE_10338_length_850_cov_9.675100	464	544	7	1	80	0.0125000
NODE_10338_length_850_cov_9.675100	464	544	8	11	80	0.1375000
NODE_10338_length_850_cov_9.675100	464	544	9	31	80	0.3875000
NODE_10338_length_850_cov_9.675100	464	544	10	6	80	0.0750000
NODE_10338_length_850_cov_9.675100	517	597	3	12	80	0.1500000
NODE_10338_length_850_cov_9.675100	517	597	4	27	80	0.3375000
NODE_10338_length_850_cov_9.675100	517	597	6	41	80	0.5125000
NODE_10367_length_849_cov_43.137333	336	416	14	9	80	0.1125000
NODE_10367_length_849_cov_43.137333	336	416	16	2	80	0.0250000
NODE_10367_length_849_cov_43.137333	336	416	18	7	80	0.0875000
NODE_10367_length_849_cov_43.137333	336	416	21	8	80	0.1000000
NODE_10367_length_849_cov_43.137333	336	416	22	17	80	0.2125000
NODE_10367_length_849_cov_43.137333	336	416	28	10	80	0.1250000
NODE_10367_length_849_cov_43.137333	336	416	29	1	80	0.0125000
NODE_10367_length_849_cov_43.137333	336	416	30	7	80	0.0875000
NODE_10367_length_849_cov_43.137333	336	416	32	16	80	0.2000000
NODE_10367_length_849_cov_43.137333	336	416	34	3	80	0.0375000
NODE_10367_length_849_cov_43.137333	389	469	10	19	80	0.2375000
NODE_10367_length_849_cov_43.137333	389	469	12	29	80	0.3625000
NODE_10367_length_849_cov_43.137333	389	469	13	2	80	0.0250000
NODE_10367_length_849_cov_43.137333	389	469	14	12	80	0.1500000
NODE_10367_length_849_cov_43.137333	389	469	16	2	80	0.0250000
NODE_10367_length_849_cov_43.137333	389	469	18	7	80	0.0875000
NODE_10367_length_849_cov_43.137333	389	469	22	9	80	0.1125000
NODE_10368_length_849_cov_36.562667	326	406	0	7	80	0.0875000
NODE_10368_length_849_cov_36.562667	326	406	1	27	80	0.3375000
NODE_10368_length_849_cov_36.562667	326	406	2	46	80	0.5750000
NODE_10368_length_849_cov_36.562667	379	459	2	61	80	0.7625000
NODE_10368_length_849_cov_36.562667	379	459	3	16	80	0.2000000
NODE_10368_length_849_cov_36.562667	379	459	4	3	80	0.0375000
NODE_10369_length_849_cov_35.449333	408	488	7	5	80	0.0625000
NODE_10369_length_849_cov_35.449333	408	488	9	17	80	0.2125000
NODE_10369_length_849_cov_35.449333	408	488	10	13	80	0.1625000
NODE_10369_length_849_cov_35.449333	408	488	11	32	80	0.4000000
NODE_10369_length_849_cov_35.449333	408	488	12	13	80	0.1625000
NODE_10369_length_849_cov_35.449333	461	541	3	13	80	0.1625000
NODE_10369_length_849_cov_35.449333	461	541	5	9	80	0.1125000
NODE_10369_length_849_cov_35.449333	461	541	6	18	80	0.2250000
NODE_10369_length_849_cov_35.449333	461	541	7	18	80	0.2250000
NODE_10369_length_849_cov_35.449333	461	541	9	17	80	0.2125000
NODE_10369_length_849_cov_35.449333	461	541	10	1	80	0.0125000
NODE_10369_length_849_cov_35.449333	461	541	11	2	80	0.0250000
NODE_10369_length_849_cov_35.449333	461	541	12	2	80	0.0250000
NODE_10370_length_849_cov_29.989333	332	412	1	25	80	0.3125000
NODE_10370_length_849_cov_29.989333	332	412	2	55	80	0.6875000
NODE_10370_length_849_cov_29.989333	385	465	1	33	80	0.4125000
NODE_10370_length_849_cov_29.989333	385	465	2	47	80	0.5875000
NODE_10371_length_849_cov_17.974667	343	423	10	25	80	0.3125000
NODE_10371_length_849_cov_17.974667	343	423	11	20	80	0.2500000
NODE_10371_length_849_cov_17.974667	343	423	12	9	80	0.1125000
NODE_10371_length_849_cov_17.974667	343	423	13	21	80	0.2625000
NODE_10371_length_849_cov_17.974667	343	423	14	5	80	0.0625000
NODE_10371_length_849_cov_17.974667	396	476	9	7	80	0.0875000
NODE_10371_length_849_cov_17.974667	396	476	10	24	80	0.3000000
NODE_10371_length_849_cov_17.974667	396	476	11	20	80	0.2500000
NODE_10371_length_849_cov_17.974667	396	476	12	2	80	0.0250000
NODE_10371_length_849_cov_17.974667	396	476	13	22	80	0.2750000
NODE_10371_length_849_cov_17.974667	396	476	14	5	80	0.0625000
NODE_10372_length_849_cov_17.018667	360	440	5	3	80	0.0375000
NODE_10372_length_849_cov_17.018667	360	440	7	31	80	0.3875000
NODE_10372_length_849_cov_17.018667	360	440	8	41	80	0.5125000
NODE_10372_length_849_cov_17.018667	360	440	9	2	80	0.0250000
NODE_10372_length_849_cov_17.018667	360	440	10	3	80	0.0375000
NODE_10372_length_849_cov_17.018667	416	493	5	4	77	0.0519481
NODE_10372_length_849_cov_17.018667	416	493	7	10	77	0.1298701
NODE_10372_length_849_cov_17.018667	416	493	8	19	77	0.2467532
NODE_10372_length_849_cov_17.018667	416	493	9	22	77	0.2857143
NODE_10372_length_849_cov_17.018667	416	493	10	22	77	0.2857143
NODE_10373_length_849_cov_15.581333	287	367	1	15	80	0.1875000
NODE_10373_length_849_cov_15.581333	287	367	2	65	80	0.8125000
NODE_10373_length_849_cov_15.581333	340	420	2	60	80	0.7500000
NODE_10373_length_849_cov_15.581333	340	420	3	20	80	0.2500000
NODE_10373_length_849_cov_15.581333	416	496	1	44	80	0.5500000
NODE_10373_length_849_cov_15.581333	416	496	2	36	80	0.4500000
NODE_10373_length_849_cov_15.581333	469	549	0	30	80	0.3750000
NODE_10373_length_849_cov_15.581333	469	549	1	50	80	0.6250000
NODE_10374_length_849_cov_9.460000	370	450	0	80	80	1.0000000
NODE_10374_length_849_cov_9.460000	423	503	0	80	80	1.0000000
NODE_10375_length_849_cov_4.893333	427	507	1	75	80	0.9375000
NODE_10375_length_849_cov_4.893333	427	507	2	5	80	0.0625000
NODE_10375_length_849_cov_4.893333	480	560	1	22	80	0.2750000
NODE_10375_length_849_cov_4.893333	480	560	2	58	80	0.7250000
NODE_10376_length_849_cov_4.860000	380	460	1	11	80	0.1375000
NODE_10376_length_849_cov_4.860000	380	460	2	69	80	0.8625000
NODE_10376_length_849_cov_4.860000	433	513	0	9	80	0.1125000
NODE_10376_length_849_cov_4.860000	433	513	1	55	80	0.6875000
NODE_10376_length_849_cov_4.860000	433	513	2	16	80	0.2000000
NODE_10379_length_849_cov_2.761333	254	334	0	80	80	1.0000000
NODE_10396_length_848_cov_27.287049	253	333	7	20	80	0.2500000
NODE_10396_length_848_cov_27.287049	253	333	8	22	80	0.2750000
NODE_10396_length_848_cov_27.287049	253	333	10	7	80	0.0875000
NODE_10396_length_848_cov_27.287049	253	333	11	2	80	0.0250000
NODE_10396_length_848_cov_27.287049	253	333	12	13	80	0.1625000
NODE_10396_length_848_cov_27.287049	253	333	14	11	80	0.1375000
NODE_10396_length_848_cov_27.287049	253	333	15	5	80	0.0625000
NODE_10396_length_848_cov_27.287049	306	386	12	11	80	0.1375000
NODE_10396_length_848_cov_27.287049	306	386	14	11	80	0.1375000
NODE_10396_length_848_cov_27.287049	306	386	15	14	80	0.1750000
NODE_10396_length_848_cov_27.287049	306	386	16	4	80	0.0500000
NODE_10396_length_848_cov_27.287049	306	386	17	7	80	0.0875000
NODE_10396_length_848_cov_27.287049	306	386	18	5	80	0.0625000
NODE_10396_length_848_cov_27.287049	306	386	19	20	80	0.2500000
NODE_10396_length_848_cov_27.287049	306	386	20	8	80	0.1000000
NODE_10396_length_848_cov_27.287049	382	458	14	4	76	0.0526316
NODE_10396_length_848_cov_27.287049	382	458	16	1	76	0.0131579
NODE_10396_length_848_cov_27.287049	382	458	18	9	76	0.1184211
NODE_10396_length_848_cov_27.287049	382	458	19	2	76	0.0263158
NODE_10396_length_848_cov_27.287049	382	458	20	48	76	0.6315789
NODE_10396_length_848_cov_27.287049	382	458	21	12	76	0.1578947
NODE_10396_length_848_cov_27.287049	435	513	3	4	78	0.0512821
NODE_10396_length_848_cov_27.287049	435	513	6	9	78	0.1153846
NODE_10396_length_848_cov_27.287049	435	513	7	7	78	0.0897436
NODE_10396_length_848_cov_27.287049	435	513	10	14	78	0.1794872
NODE_10396_length_848_cov_27.287049	435	513	11	4	78	0.0512821
NODE_10396_length_848_cov_27.287049	435	513	12	7	78	0.0897436
NODE_10396_length_848_cov_27.287049	435	513	14	14	78	0.1794872
NODE_10396_length_848_cov_27.287049	435	513	16	1	78	0.0128205
NODE_10396_length_848_cov_27.287049	435	513	18	9	78	0.1153846
NODE_10396_length_848_cov_27.287049	435	513	19	1	78	0.0128205
NODE_10396_length_848_cov_27.287049	435	513	21	8	78	0.1025641
NODE_10397_length_848_cov_23.511348	248	328	2	11	80	0.1375000
NODE_10397_length_848_cov_23.511348	248	328	3	1	80	0.0125000
NODE_10397_length_848_cov_23.511348	248	328	4	40	80	0.5000000
NODE_10397_length_848_cov_23.511348	248	328	5	1	80	0.0125000
NODE_10397_length_848_cov_23.511348	248	328	6	10	80	0.1250000
NODE_10397_length_848_cov_23.511348	248	328	7	14	80	0.1750000
NODE_10397_length_848_cov_23.511348	248	328	8	3	80	0.0375000
NODE_10397_length_848_cov_23.511348	301	381	6	10	80	0.1250000
NODE_10397_length_848_cov_23.511348	301	381	7	14	80	0.1750000
NODE_10397_length_848_cov_23.511348	301	381	8	34	80	0.4250000
NODE_10397_length_848_cov_23.511348	301	381	9	22	80	0.2750000
NODE_10397_length_848_cov_23.511348	377	457	7	6	80	0.0750000
NODE_10397_length_848_cov_23.511348	377	457	8	29	80	0.3625000
NODE_10397_length_848_cov_23.511348	377	457	9	14	80	0.1750000
NODE_10397_length_848_cov_23.511348	377	457	10	31	80	0.3875000
NODE_10397_length_848_cov_23.511348	430	508	4	13	78	0.1666667
NODE_10397_length_848_cov_23.511348	430	508	5	17	78	0.2179487
NODE_10397_length_848_cov_23.511348	430	508	6	13	78	0.1666667
NODE_10397_length_848_cov_23.511348	430	508	7	14	78	0.1794872
NODE_10397_length_848_cov_23.511348	430	508	8	8	78	0.1025641
NODE_10397_length_848_cov_23.511348	430	508	9	6	78	0.0769231
NODE_10397_length_848_cov_23.511348	430	508	10	7	78	0.0897436
NODE_10398_length_848_cov_21.939920	295	375	7	10	80	0.1250000
NODE_10398_length_848_cov_21.939920	295	375	10	9	80	0.1125000
NODE_10398_length_848_cov_21.939920	295	375	12	19	80	0.2375000
NODE_10398_length_848_cov_21.939920	295	375	13	14	80	0.1750000
NODE_10398_length_848_cov_21.939920	295	375	14	18	80	0.2250000
NODE_10398_length_848_cov_21.939920	295	375	15	10	80	0.1250000
NODE_10398_length_848_cov_21.939920	348	428	10	7	80	0.0875000
NODE_10398_length_848_cov_21.939920	348	428	11	1	80	0.0125000
NODE_10398_length_848_cov_21.939920	348	428	12	27	80	0.3375000
NODE_10398_length_848_cov_21.939920	348	428	13	38	80	0.4750000
NODE_10398_length_848_cov_21.939920	348	428	14	7	80	0.0875000
NODE_10399_length_848_cov_21.937250	434	514	11	2	80	0.0250000
NODE_10399_length_848_cov_21.937250	434	514	13	9	80	0.1125000
NODE_10399_length_848_cov_21.937250	434	514	14	12	80	0.1500000
NODE_10399_length_848_cov_21.937250	434	514	15	2	80	0.0250000
NODE_10399_length_848_cov_21.937250	434	514	16	18	80	0.2250000
NODE_10399_length_848_cov_21.937250	434	514	17	13	80	0.1625000
NODE_10399_length_848_cov_21.937250	434	514	18	7	80	0.0875000
NODE_10399_length_848_cov_21.937250	434	514	19	17	80	0.2125000
NODE_10399_length_848_cov_21.937250	487	567	13	11	80	0.1375000
NODE_10399_length_848_cov_21.937250	487	567	14	26	80	0.3250000
NODE_10399_length_848_cov_21.937250	487	567	15	4	80	0.0500000
NODE_10399_length_848_cov_21.937250	487	567	16	39	80	0.4875000
NODE_10400_length_848_cov_19.500668	367	392	1	14	25	0.5600000
NODE_10400_length_848_cov_19.500668	367	392	2	11	25	0.4400000
NODE_10400_length_848_cov_19.500668	388	468	2	80	80	1.0000000
NODE_10400_length_848_cov_19.500668	441	521	1	36	80	0.4500000
NODE_10400_length_848_cov_19.500668	441	521	2	44	80	0.5500000
NODE_10400_length_848_cov_19.500668	443	512	1	28	69	0.4057971
NODE_10400_length_848_cov_19.500668	443	512	2	41	69	0.5942029
NODE_10400_length_848_cov_19.500668	443	472	2	29	29	1.0000000
NODE_10401_length_848_cov_16.566088	323	403	5	2	80	0.0250000
NODE_10401_length_848_cov_16.566088	323	403	6	3	80	0.0375000
NODE_10401_length_848_cov_16.566088	323	403	7	9	80	0.1125000
NODE_10401_length_848_cov_16.566088	323	403	8	28	80	0.3500000
NODE_10401_length_848_cov_16.566088	323	403	9	13	80	0.1625000
NODE_10401_length_848_cov_16.566088	323	403	12	14	80	0.1750000
NODE_10401_length_848_cov_16.566088	323	403	13	11	80	0.1375000
NODE_10401_length_848_cov_16.566088	376	456	9	2	80	0.0250000
NODE_10401_length_848_cov_16.566088	376	456	12	15	80	0.1875000
NODE_10401_length_848_cov_16.566088	376	456	13	48	80	0.6000000
NODE_10401_length_848_cov_16.566088	376	456	14	9	80	0.1125000
NODE_10401_length_848_cov_16.566088	376	456	15	6	80	0.0750000
NODE_10402_length_848_cov_16.109479	256	336	0	80	80	1.0000000
NODE_10402_length_848_cov_16.109479	309	389	0	55	80	0.6875000
NODE_10402_length_848_cov_16.109479	309	389	1	14	80	0.1750000
NODE_10402_length_848_cov_16.109479	309	389	3	11	80	0.1375000
NODE_10402_length_848_cov_16.109479	385	465	3	58	80	0.7250000
NODE_10402_length_848_cov_16.109479	385	465	4	1	80	0.0125000
NODE_10402_length_848_cov_16.109479	385	465	5	21	80	0.2625000
NODE_10402_length_848_cov_16.109479	438	518	3	5	80	0.0625000
NODE_10402_length_848_cov_16.109479	438	518	4	1	80	0.0125000
NODE_10402_length_848_cov_16.109479	438	518	5	37	80	0.4625000
NODE_10402_length_848_cov_16.109479	438	518	6	37	80	0.4625000
NODE_10403_length_848_cov_15.919893	492	568	1	70	76	0.9210526
NODE_10403_length_848_cov_15.919893	492	568	2	6	76	0.0789474
NODE_10403_length_848_cov_15.919893	541	621	1	80	80	1.0000000
NODE_10404_length_848_cov_13.979973	269	349	2	63	80	0.7875000
NODE_10404_length_848_cov_13.979973	269	349	3	17	80	0.2125000
NODE_10404_length_848_cov_13.979973	322	402	2	12	80	0.1500000
NODE_10404_length_848_cov_13.979973	322	402	3	68	80	0.8500000
NODE_10405_length_848_cov_13.073431	343	423	2	22	80	0.2750000
NODE_10405_length_848_cov_13.073431	343	423	3	1	80	0.0125000
NODE_10405_length_848_cov_13.073431	343	423	5	57	80	0.7125000
NODE_10405_length_848_cov_13.073431	396	476	1	17	80	0.2125000
NODE_10405_length_848_cov_13.073431	396	476	2	31	80	0.3875000
NODE_10405_length_848_cov_13.073431	396	476	3	4	80	0.0500000
NODE_10405_length_848_cov_13.073431	396	476	4	24	80	0.3000000
NODE_10405_length_848_cov_13.073431	396	476	5	4	80	0.0500000
NODE_10406_length_848_cov_8.523364	232	312	4	18	80	0.2250000
NODE_10406_length_848_cov_8.523364	232	312	5	35	80	0.4375000
NODE_10406_length_848_cov_8.523364	232	312	6	27	80	0.3375000
NODE_10406_length_848_cov_8.523364	285	365	3	30	80	0.3750000
NODE_10406_length_848_cov_8.523364	285	365	4	20	80	0.2500000
NODE_10406_length_848_cov_8.523364	285	365	5	30	80	0.3750000
NODE_10406_length_848_cov_8.523364	361	441	2	42	80	0.5250000
NODE_10406_length_848_cov_8.523364	361	441	3	16	80	0.2000000
NODE_10406_length_848_cov_8.523364	361	441	4	22	80	0.2750000
NODE_10406_length_848_cov_8.523364	414	494	1	42	80	0.5250000
NODE_10406_length_848_cov_8.523364	414	494	2	38	80	0.4750000
NODE_10408_length_848_cov_5.903872	251	331	3	16	80	0.2000000
NODE_10408_length_848_cov_5.903872	251	331	4	64	80	0.8000000
NODE_10408_length_848_cov_5.903872	304	383	3	19	79	0.2405063
NODE_10408_length_848_cov_5.903872	304	383	4	60	79	0.7594936
NODE_10409_length_848_cov_5.236315	378	458	0	80	80	1.0000000
NODE_10409_length_848_cov_5.236315	431	507	0	76	76	1.0000000
NODE_10424_length_847_cov_56.417112	576	656	40	2	80	0.0250000
NODE_10424_length_847_cov_56.417112	576	656	41	1	80	0.0125000
NODE_10424_length_847_cov_56.417112	576	656	42	17	80	0.2125000
NODE_10424_length_847_cov_56.417112	576	656	43	3	80	0.0375000
NODE_10424_length_847_cov_56.417112	576	656	44	5	80	0.0625000
NODE_10424_length_847_cov_56.417112	576	656	47	1	80	0.0125000
NODE_10424_length_847_cov_56.417112	576	656	48	1	80	0.0125000
NODE_10424_length_847_cov_56.417112	576	656	49	2	80	0.0250000
NODE_10424_length_847_cov_56.417112	576	656	51	16	80	0.2000000
NODE_10424_length_847_cov_56.417112	576	656	52	7	80	0.0875000
NODE_10424_length_847_cov_56.417112	576	656	53	5	80	0.0625000
NODE_10424_length_847_cov_56.417112	576	656	54	15	80	0.1875000
NODE_10424_length_847_cov_56.417112	576	656	55	4	80	0.0500000
NODE_10424_length_847_cov_56.417112	576	656	56	1	80	0.0125000
NODE_10424_length_847_cov_56.417112	629	709	30	1	80	0.0125000
NODE_10424_length_847_cov_56.417112	629	709	31	2	80	0.0250000
NODE_10424_length_847_cov_56.417112	629	709	32	4	80	0.0500000
NODE_10424_length_847_cov_56.417112	629	709	33	4	80	0.0500000
NODE_10424_length_847_cov_56.417112	629	709	34	6	80	0.0750000
NODE_10424_length_847_cov_56.417112	629	709	36	1	80	0.0125000
NODE_10424_length_847_cov_56.417112	629	709	37	2	80	0.0250000
NODE_10424_length_847_cov_56.417112	629	709	39	4	80	0.0500000
NODE_10424_length_847_cov_56.417112	629	709	40	1	80	0.0125000
NODE_10424_length_847_cov_56.417112	629	709	41	7	80	0.0875000
NODE_10424_length_847_cov_56.417112	629	709	45	7	80	0.0875000
NODE_10424_length_847_cov_56.417112	629	709	46	4	80	0.0500000
NODE_10424_length_847_cov_56.417112	629	709	48	6	80	0.0750000
NODE_10424_length_847_cov_56.417112	629	709	49	1	80	0.0125000
NODE_10424_length_847_cov_56.417112	629	709	51	6	80	0.0750000
NODE_10424_length_847_cov_56.417112	629	709	53	4	80	0.0500000
NODE_10424_length_847_cov_56.417112	629	709	54	15	80	0.1875000
NODE_10424_length_847_cov_56.417112	629	709	55	4	80	0.0500000
NODE_10424_length_847_cov_56.417112	629	709	56	1	80	0.0125000
NODE_10425_length_847_cov_27.292781	390	470	3	1	80	0.0125000
NODE_10425_length_847_cov_27.292781	390	470	4	1	80	0.0125000
NODE_10425_length_847_cov_27.292781	390	470	5	7	80	0.0875000
NODE_10425_length_847_cov_27.292781	390	470	6	14	80	0.1750000
NODE_10425_length_847_cov_27.292781	390	470	11	2	80	0.0250000
NODE_10425_length_847_cov_27.292781	390	470	12	46	80	0.5750000
NODE_10425_length_847_cov_27.292781	390	470	13	9	80	0.1125000
NODE_10425_length_847_cov_27.292781	443	523	10	32	80	0.4000000
NODE_10425_length_847_cov_27.292781	443	523	11	7	80	0.0875000
NODE_10425_length_847_cov_27.292781	443	523	12	41	80	0.5125000
NODE_10426_length_847_cov_24.954545	342	422	0	5	80	0.0625000
NODE_10426_length_847_cov_24.954545	342	422	1	6	80	0.0750000
NODE_10426_length_847_cov_24.954545	342	422	2	7	80	0.0875000
NODE_10426_length_847_cov_24.954545	342	422	3	62	80	0.7750000
NODE_10426_length_847_cov_24.954545	395	475	3	76	80	0.9500000
NODE_10426_length_847_cov_24.954545	395	475	4	4	80	0.0500000
NODE_10427_length_847_cov_20.310160	341	421	2	11	80	0.1375000
NODE_10427_length_847_cov_20.310160	341	421	3	20	80	0.2500000
NODE_10427_length_847_cov_20.310160	341	421	4	22	80	0.2750000
NODE_10427_length_847_cov_20.310160	341	421	5	27	80	0.3375000
NODE_10427_length_847_cov_20.310160	394	474	2	21	80	0.2625000
NODE_10427_length_847_cov_20.310160	394	474	3	59	80	0.7375000
NODE_10428_length_847_cov_19.002674	368	448	0	21	80	0.2625000
NODE_10428_length_847_cov_19.002674	368	448	3	59	80	0.7375000
NODE_10428_length_847_cov_19.002674	421	501	3	80	80	1.0000000
NODE_10429_length_847_cov_16.879679	218	298	1	44	80	0.5500000
NODE_10429_length_847_cov_16.879679	218	298	2	25	80	0.3125000
NODE_10429_length_847_cov_16.879679	218	298	3	11	80	0.1375000
NODE_10429_length_847_cov_16.879679	271	351	2	16	80	0.2000000
NODE_10429_length_847_cov_16.879679	271	351	3	15	80	0.1875000
NODE_10429_length_847_cov_16.879679	271	351	4	4	80	0.0500000
NODE_10429_length_847_cov_16.879679	271	351	11	8	80	0.1000000
NODE_10429_length_847_cov_16.879679	271	351	12	37	80	0.4625000
NODE_10431_length_847_cov_11.784759	298	378	0	80	80	1.0000000
NODE_10431_length_847_cov_11.784759	351	431	0	80	80	1.0000000
NODE_10431_length_847_cov_11.784759	427	507	0	27	80	0.3375000
NODE_10431_length_847_cov_11.784759	427	507	2	37	80	0.4625000
NODE_10431_length_847_cov_11.784759	427	507	4	16	80	0.2000000
NODE_10431_length_847_cov_11.784759	480	560	2	11	80	0.1375000
NODE_10431_length_847_cov_11.784759	480	560	4	69	80	0.8625000
NODE_10432_length_847_cov_11.604278	407	487	4	23	80	0.2875000
NODE_10432_length_847_cov_11.604278	407	487	5	57	80	0.7125000
NODE_10432_length_847_cov_11.604278	460	540	0	9	80	0.1125000
NODE_10432_length_847_cov_11.604278	460	540	2	11	80	0.1375000
NODE_10432_length_847_cov_11.604278	460	540	3	29	80	0.3625000
NODE_10432_length_847_cov_11.604278	460	540	4	27	80	0.3375000
NODE_10432_length_847_cov_11.604278	460	540	5	4	80	0.0500000
NODE_10433_length_847_cov_10.221925	395	475	0	80	80	1.0000000
NODE_10433_length_847_cov_10.221925	448	528	0	80	80	1.0000000
NODE_10434_length_847_cov_4.602941	97	154	0	57	57	1.0000000
NODE_10434_length_847_cov_4.602941	127	207	0	80	80	1.0000000
NODE_10456_length_846_cov_39.476573	336	416	5	7	80	0.0875000
NODE_10456_length_846_cov_39.476573	336	416	7	22	80	0.2750000
NODE_10456_length_846_cov_39.476573	336	416	8	7	80	0.0875000
NODE_10456_length_846_cov_39.476573	336	416	10	26	80	0.3250000
NODE_10456_length_846_cov_39.476573	336	416	11	18	80	0.2250000
NODE_10456_length_846_cov_39.476573	389	469	8	19	80	0.2375000
NODE_10456_length_846_cov_39.476573	389	469	10	49	80	0.6125000
NODE_10456_length_846_cov_39.476573	389	469	11	8	80	0.1000000
NODE_10456_length_846_cov_39.476573	389	469	12	4	80	0.0500000
NODE_10456_length_846_cov_39.476573	465	545	2	3	80	0.0375000
NODE_10456_length_846_cov_39.476573	465	545	3	20	80	0.2500000
NODE_10456_length_846_cov_39.476573	465	545	5	7	80	0.0875000
NODE_10456_length_846_cov_39.476573	465	545	6	22	80	0.2750000
NODE_10456_length_846_cov_39.476573	465	545	8	28	80	0.3500000
NODE_10456_length_846_cov_39.476573	518	598	0	20	80	0.2500000
NODE_10456_length_846_cov_39.476573	518	598	2	5	80	0.0625000
NODE_10456_length_846_cov_39.476573	518	598	3	51	80	0.6375000
NODE_10456_length_846_cov_39.476573	518	598	5	4	80	0.0500000
NODE_10457_length_846_cov_37.297189	312	392	30	12	80	0.1500000
NODE_10457_length_846_cov_37.297189	312	392	31	13	80	0.1625000
NODE_10457_length_846_cov_37.297189	312	392	34	25	80	0.3125000
NODE_10457_length_846_cov_37.297189	312	392	38	8	80	0.1000000
NODE_10457_length_846_cov_37.297189	312	392	39	6	80	0.0750000
NODE_10457_length_846_cov_37.297189	312	392	40	10	80	0.1250000
NODE_10457_length_846_cov_37.297189	312	392	43	6	80	0.0750000
NODE_10457_length_846_cov_37.297189	365	445	25	3	80	0.0375000
NODE_10457_length_846_cov_37.297189	365	445	27	1	80	0.0125000
NODE_10457_length_846_cov_37.297189	365	445	31	1	80	0.0125000
NODE_10457_length_846_cov_37.297189	365	445	34	1	80	0.0125000
NODE_10457_length_846_cov_37.297189	365	445	36	2	80	0.0250000
NODE_10457_length_846_cov_37.297189	365	445	37	1	80	0.0125000
NODE_10457_length_846_cov_37.297189	365	445	38	10	80	0.1250000
NODE_10457_length_846_cov_37.297189	365	445	39	12	80	0.1500000
NODE_10457_length_846_cov_37.297189	365	445	40	7	80	0.0875000
NODE_10457_length_846_cov_37.297189	365	445	41	1	80	0.0125000
NODE_10457_length_846_cov_37.297189	365	445	42	21	80	0.2625000
NODE_10457_length_846_cov_37.297189	365	445	43	20	80	0.2500000
NODE_10458_length_846_cov_32.852744	279	359	9	24	80	0.3000000
NODE_10458_length_846_cov_32.852744	279	359	10	2	80	0.0250000
NODE_10458_length_846_cov_32.852744	279	359	12	22	80	0.2750000
NODE_10458_length_846_cov_32.852744	279	359	14	32	80	0.4000000
NODE_10458_length_846_cov_32.852744	332	412	5	26	80	0.3250000
NODE_10458_length_846_cov_32.852744	332	412	7	10	80	0.1250000
NODE_10458_length_846_cov_32.852744	332	412	11	15	80	0.1875000
NODE_10458_length_846_cov_32.852744	332	412	12	24	80	0.3000000
NODE_10458_length_846_cov_32.852744	332	412	14	5	80	0.0625000
NODE_10459_length_846_cov_31.717537	290	370	7	46	80	0.5750000
NODE_10459_length_846_cov_31.717537	290	370	8	10	80	0.1250000
NODE_10459_length_846_cov_31.717537	290	370	9	20	80	0.2500000
NODE_10459_length_846_cov_31.717537	290	370	11	4	80	0.0500000
NODE_10459_length_846_cov_31.717537	343	423	7	12	80	0.1500000
NODE_10459_length_846_cov_31.717537	343	423	8	1	80	0.0125000
NODE_10459_length_846_cov_31.717537	343	423	9	40	80	0.5000000
NODE_10459_length_846_cov_31.717537	343	423	11	27	80	0.3375000
NODE_10460_length_846_cov_24.380187	350	430	0	80	80	1.0000000
NODE_10460_length_846_cov_24.380187	403	483	0	80	80	1.0000000
NODE_10461_length_846_cov_16.155288	364	444	1	1	80	0.0125000
NODE_10461_length_846_cov_16.155288	364	444	2	79	80	0.9875000
NODE_10461_length_846_cov_16.155288	417	497	1	16	80	0.2000000
NODE_10461_length_846_cov_16.155288	417	497	2	64	80	0.8000000
NODE_10462_length_846_cov_15.917001	398	478	3	24	80	0.3000000
NODE_10462_length_846_cov_15.917001	398	478	4	1	80	0.0125000
NODE_10462_length_846_cov_15.917001	398	478	5	53	80	0.6625000
NODE_10462_length_846_cov_15.917001	398	478	6	2	80	0.0250000
NODE_10462_length_846_cov_15.917001	451	531	3	38	80	0.4750000
NODE_10462_length_846_cov_15.917001	451	531	4	16	80	0.2000000
NODE_10462_length_846_cov_15.917001	451	531	5	24	80	0.3000000
NODE_10462_length_846_cov_15.917001	451	531	6	2	80	0.0250000
NODE_10463_length_846_cov_15.275770	355	435	0	74	80	0.9250000
NODE_10463_length_846_cov_15.275770	355	435	2	6	80	0.0750000
NODE_10463_length_846_cov_15.275770	408	488	0	21	80	0.2625000
NODE_10463_length_846_cov_15.275770	408	488	2	59	80	0.7375000
NODE_10464_length_846_cov_13.618474	216	296	6	12	80	0.1500000
NODE_10464_length_846_cov_13.618474	216	296	9	7	80	0.0875000
NODE_10464_length_846_cov_13.618474	216	296	11	5	80	0.0625000
NODE_10464_length_846_cov_13.618474	216	296	12	44	80	0.5500000
NODE_10464_length_846_cov_13.618474	216	296	13	1	80	0.0125000
NODE_10464_length_846_cov_13.618474	216	296	14	1	80	0.0125000
NODE_10464_length_846_cov_13.618474	216	296	15	10	80	0.1250000
NODE_10464_length_846_cov_13.618474	269	349	12	32	80	0.4000000
NODE_10464_length_846_cov_13.618474	269	349	13	17	80	0.2125000
NODE_10464_length_846_cov_13.618474	269	349	14	16	80	0.2000000
NODE_10464_length_846_cov_13.618474	269	349	15	15	80	0.1875000
NODE_10464_length_846_cov_13.618474	345	425	6	7	80	0.0875000
NODE_10464_length_846_cov_13.618474	345	425	7	1	80	0.0125000
NODE_10464_length_846_cov_13.618474	345	425	8	8	80	0.1000000
NODE_10464_length_846_cov_13.618474	345	425	9	14	80	0.1750000
NODE_10464_length_846_cov_13.618474	345	425	10	16	80	0.2000000
NODE_10464_length_846_cov_13.618474	345	425	11	1	80	0.0125000
NODE_10464_length_846_cov_13.618474	345	425	13	10	80	0.1250000
NODE_10464_length_846_cov_13.618474	345	425	14	18	80	0.2250000
NODE_10464_length_846_cov_13.618474	345	425	15	5	80	0.0625000
NODE_10464_length_846_cov_13.618474	398	478	6	7	80	0.0875000
NODE_10464_length_846_cov_13.618474	398	478	7	11	80	0.1375000
NODE_10464_length_846_cov_13.618474	398	478	8	25	80	0.3125000
NODE_10464_length_846_cov_13.618474	398	478	9	32	80	0.4000000
NODE_10464_length_846_cov_13.618474	398	478	10	5	80	0.0625000
NODE_10465_length_846_cov_12.878179	425	505	4	13	80	0.1625000
NODE_10465_length_846_cov_12.878179	425	505	5	54	80	0.6750000
NODE_10465_length_846_cov_12.878179	425	505	6	9	80	0.1125000
NODE_10465_length_846_cov_12.878179	425	505	7	4	80	0.0500000
NODE_10465_length_846_cov_12.878179	478	558	2	13	80	0.1625000
NODE_10465_length_846_cov_12.878179	478	558	3	33	80	0.4125000
NODE_10465_length_846_cov_12.878179	478	558	4	20	80	0.2500000
NODE_10465_length_846_cov_12.878179	478	558	5	14	80	0.1750000
NODE_10467_length_846_cov_7.232932	407	487	1	42	80	0.5250000
NODE_10467_length_846_cov_7.232932	407	487	2	38	80	0.4750000
NODE_10467_length_846_cov_7.232932	460	540	2	80	80	1.0000000
NODE_10468_length_846_cov_6.776439	320	400	0	80	80	1.0000000
NODE_10468_length_846_cov_6.776439	373	453	0	80	80	1.0000000
NODE_10472_length_846_cov_3.025435	190	270	0	80	80	1.0000000
NODE_10472_length_846_cov_3.025435	243	323	0	80	80	1.0000000
NODE_10488_length_845_cov_34.458445	213	293	25	8	80	0.1000000
NODE_10488_length_845_cov_34.458445	213	293	26	3	80	0.0375000
NODE_10488_length_845_cov_34.458445	213	293	27	13	80	0.1625000
NODE_10488_length_845_cov_34.458445	213	293	30	4	80	0.0500000
NODE_10488_length_845_cov_34.458445	213	293	31	2	80	0.0250000
NODE_10488_length_845_cov_34.458445	213	293	32	1	80	0.0125000
NODE_10488_length_845_cov_34.458445	213	293	33	1	80	0.0125000
NODE_10488_length_845_cov_34.458445	213	293	34	3	80	0.0375000
NODE_10488_length_845_cov_34.458445	213	293	35	1	80	0.0125000
NODE_10488_length_845_cov_34.458445	213	293	39	14	80	0.1750000
NODE_10488_length_845_cov_34.458445	213	293	40	1	80	0.0125000
NODE_10488_length_845_cov_34.458445	213	293	41	23	80	0.2875000
NODE_10488_length_845_cov_34.458445	213	293	42	6	80	0.0750000
NODE_10488_length_845_cov_34.458445	266	346	27	2	80	0.0250000
NODE_10488_length_845_cov_34.458445	266	346	29	4	80	0.0500000
NODE_10488_length_845_cov_34.458445	266	346	30	10	80	0.1250000
NODE_10488_length_845_cov_34.458445	266	346	32	1	80	0.0125000
NODE_10488_length_845_cov_34.458445	266	346	33	6	80	0.0750000
NODE_10488_length_845_cov_34.458445	266	346	35	7	80	0.0875000
NODE_10488_length_845_cov_34.458445	266	346	36	8	80	0.1000000
NODE_10488_length_845_cov_34.458445	266	346	37	6	80	0.0750000
NODE_10488_length_845_cov_34.458445	266	346	38	2	80	0.0250000
NODE_10488_length_845_cov_34.458445	266	346	39	3	80	0.0375000
NODE_10488_length_845_cov_34.458445	266	346	40	8	80	0.1000000
NODE_10488_length_845_cov_34.458445	266	346	41	23	80	0.2875000
NODE_10489_length_845_cov_33.025469	309	389	0	80	80	1.0000000
NODE_10489_length_845_cov_33.025469	362	442	0	80	80	1.0000000
NODE_10490_length_845_cov_30.331099	288	368	10	44	80	0.5500000
NODE_10490_length_845_cov_30.331099	288	368	11	27	80	0.3375000
NODE_10490_length_845_cov_30.331099	288	368	12	9	80	0.1125000
NODE_10490_length_845_cov_30.331099	341	421	10	17	80	0.2125000
NODE_10490_length_845_cov_30.331099	341	421	11	28	80	0.3500000
NODE_10490_length_845_cov_30.331099	341	421	12	20	80	0.2500000
NODE_10490_length_845_cov_30.331099	341	421	13	3	80	0.0375000
NODE_10490_length_845_cov_30.331099	341	421	14	12	80	0.1500000
NODE_10491_length_845_cov_22.042895	455	535	3	22	80	0.2750000
NODE_10491_length_845_cov_22.042895	455	535	4	2	80	0.0250000
NODE_10491_length_845_cov_22.042895	455	535	5	22	80	0.2750000
NODE_10491_length_845_cov_22.042895	455	535	6	6	80	0.0750000
NODE_10491_length_845_cov_22.042895	455	535	7	28	80	0.3500000
NODE_10491_length_845_cov_22.042895	508	588	4	12	80	0.1500000
NODE_10491_length_845_cov_22.042895	508	588	5	2	80	0.0250000
NODE_10491_length_845_cov_22.042895	508	588	7	66	80	0.8250000
NODE_10492_length_845_cov_20.662198	325	406	1	6	81	0.0740741
NODE_10492_length_845_cov_20.662198	325	406	2	3	81	0.0370370
NODE_10492_length_845_cov_20.662198	325	406	3	56	81	0.6913580
NODE_10492_length_845_cov_20.662198	325	406	7	16	81	0.1975309
NODE_10492_length_845_cov_20.662198	379	459	3	11	80	0.1375000
NODE_10492_length_845_cov_20.662198	379	459	7	28	80	0.3500000
NODE_10492_length_845_cov_20.662198	379	459	9	10	80	0.1250000
NODE_10492_length_845_cov_20.662198	379	459	10	31	80	0.3875000
NODE_10493_length_845_cov_17.214477	352	432	1	16	80	0.2000000
NODE_10493_length_845_cov_17.214477	352	432	2	5	80	0.0625000
NODE_10493_length_845_cov_17.214477	352	432	3	2	80	0.0250000
NODE_10493_length_845_cov_17.214477	352	432	4	57	80	0.7125000
NODE_10493_length_845_cov_17.214477	405	485	1	20	80	0.2500000
NODE_10493_length_845_cov_17.214477	405	485	2	54	80	0.6750000
NODE_10493_length_845_cov_17.214477	405	485	3	2	80	0.0250000
NODE_10493_length_845_cov_17.214477	405	485	4	4	80	0.0500000
NODE_10494_length_845_cov_15.805630	409	489	5	12	80	0.1500000
NODE_10494_length_845_cov_15.805630	409	489	6	11	80	0.1375000
NODE_10494_length_845_cov_15.805630	409	489	8	57	80	0.7125000
NODE_10494_length_845_cov_15.805630	462	542	5	16	80	0.2000000
NODE_10494_length_845_cov_15.805630	462	542	6	1	80	0.0125000
NODE_10494_length_845_cov_15.805630	462	542	8	63	80	0.7875000
NODE_10495_length_845_cov_13.443700	329	409	11	39	80	0.4875000
NODE_10495_length_845_cov_13.443700	329	409	12	10	80	0.1250000
NODE_10495_length_845_cov_13.443700	329	409	13	21	80	0.2625000
NODE_10495_length_845_cov_13.443700	329	409	14	10	80	0.1250000
NODE_10495_length_845_cov_13.443700	382	462	9	2	80	0.0250000
NODE_10495_length_845_cov_13.443700	382	462	10	3	80	0.0375000
NODE_10495_length_845_cov_13.443700	382	462	11	2	80	0.0250000
NODE_10495_length_845_cov_13.443700	382	462	12	39	80	0.4875000
NODE_10495_length_845_cov_13.443700	382	462	13	28	80	0.3500000
NODE_10495_length_845_cov_13.443700	382	462	14	6	80	0.0750000
NODE_10496_length_845_cov_12.301609	334	414	5	24	80	0.3000000
NODE_10496_length_845_cov_12.301609	334	414	6	41	80	0.5125000
NODE_10496_length_845_cov_12.301609	334	414	8	15	80	0.1875000
NODE_10496_length_845_cov_12.301609	387	467	0	7	80	0.0875000
NODE_10496_length_845_cov_12.301609	387	467	2	14	80	0.1750000
NODE_10496_length_845_cov_12.301609	387	467	3	14	80	0.1750000
NODE_10496_length_845_cov_12.301609	387	467	4	5	80	0.0625000
NODE_10496_length_845_cov_12.301609	387	467	5	37	80	0.4625000
NODE_10496_length_845_cov_12.301609	387	467	6	3	80	0.0375000
NODE_10497_length_845_cov_11.836461	389	469	0	57	80	0.7125000
NODE_10497_length_845_cov_11.836461	389	469	1	23	80	0.2875000
NODE_10497_length_845_cov_11.836461	442	522	0	4	80	0.0500000
NODE_10497_length_845_cov_11.836461	442	522	1	76	80	0.9500000
NODE_10499_length_845_cov_8.140751	439	519	0	80	80	1.0000000
NODE_10499_length_845_cov_8.140751	492	572	0	80	80	1.0000000
NODE_10516_length_845_cov_1.680965	447	491	0	44	44	1.0000000
NODE_10528_length_844_cov_43.778523	313	393	3	7	80	0.0875000
NODE_10528_length_844_cov_43.778523	313	393	4	66	80	0.8250000
NODE_10528_length_844_cov_43.778523	313	393	6	7	80	0.0875000
NODE_10528_length_844_cov_43.778523	366	446	1	3	80	0.0375000
NODE_10528_length_844_cov_43.778523	366	446	2	15	80	0.1875000
NODE_10528_length_844_cov_43.778523	366	446	3	16	80	0.2000000
NODE_10528_length_844_cov_43.778523	366	446	4	32	80	0.4000000
NODE_10528_length_844_cov_43.778523	366	446	5	9	80	0.1125000
NODE_10528_length_844_cov_43.778523	366	446	7	5	80	0.0625000
NODE_10528_length_844_cov_43.778523	442	522	7	12	80	0.1500000
NODE_10528_length_844_cov_43.778523	442	522	8	7	80	0.0875000
NODE_10528_length_844_cov_43.778523	442	522	9	21	80	0.2625000
NODE_10528_length_844_cov_43.778523	442	522	12	3	80	0.0375000
NODE_10528_length_844_cov_43.778523	442	522	13	37	80	0.4625000
NODE_10528_length_844_cov_43.778523	495	575	11	4	80	0.0500000
NODE_10528_length_844_cov_43.778523	495	575	12	13	80	0.1625000
NODE_10528_length_844_cov_43.778523	495	575	13	44	80	0.5500000
NODE_10528_length_844_cov_43.778523	495	575	14	12	80	0.1500000
NODE_10528_length_844_cov_43.778523	495	575	16	7	80	0.0875000
NODE_10529_length_844_cov_36.762416	381	461	4	10	80	0.1250000
NODE_10529_length_844_cov_36.762416	381	461	5	18	80	0.2250000
NODE_10529_length_844_cov_36.762416	381	461	7	52	80	0.6500000
NODE_10529_length_844_cov_36.762416	434	514	5	52	80	0.6500000
NODE_10529_length_844_cov_36.762416	434	514	6	18	80	0.2250000
NODE_10529_length_844_cov_36.762416	434	514	7	9	80	0.1125000
NODE_10529_length_844_cov_36.762416	434	514	9	1	80	0.0125000
NODE_10529_length_844_cov_36.762416	510	590	6	53	80	0.6625000
NODE_10529_length_844_cov_36.762416	510	590	9	27	80	0.3375000
NODE_10529_length_844_cov_36.762416	563	644	5	42	81	0.5185185
NODE_10529_length_844_cov_36.762416	563	644	6	32	81	0.3950617
NODE_10529_length_844_cov_36.762416	563	644	7	7	81	0.0864198
NODE_10530_length_844_cov_35.765101	424	504	8	17	80	0.2125000
NODE_10530_length_844_cov_35.765101	424	504	9	3	80	0.0375000
NODE_10530_length_844_cov_35.765101	424	504	11	2	80	0.0250000
NODE_10530_length_844_cov_35.765101	424	504	12	11	80	0.1375000
NODE_10530_length_844_cov_35.765101	424	504	13	32	80	0.4000000
NODE_10530_length_844_cov_35.765101	424	504	14	15	80	0.1875000
NODE_10530_length_844_cov_35.765101	477	557	10	4	80	0.0500000
NODE_10530_length_844_cov_35.765101	477	557	11	15	80	0.1875000
NODE_10530_length_844_cov_35.765101	477	557	12	15	80	0.1875000
NODE_10530_length_844_cov_35.765101	477	557	13	27	80	0.3375000
NODE_10530_length_844_cov_35.765101	477	557	14	19	80	0.2375000
NODE_10531_length_844_cov_18.445638	353	420	2	26	67	0.3880597
NODE_10531_length_844_cov_18.445638	353	420	3	41	67	0.6119403
NODE_10531_length_844_cov_18.445638	393	473	3	47	80	0.5875000
NODE_10531_length_844_cov_18.445638	393	473	4	33	80	0.4125000
NODE_10532_length_844_cov_12.616107	363	443	2	4	80	0.0500000
NODE_10532_length_844_cov_12.616107	363	443	3	6	80	0.0750000
NODE_10532_length_844_cov_12.616107	363	443	4	9	80	0.1125000
NODE_10532_length_844_cov_12.616107	363	443	5	17	80	0.2125000
NODE_10532_length_844_cov_12.616107	363	443	6	25	80	0.3125000
NODE_10532_length_844_cov_12.616107	363	443	7	3	80	0.0375000
NODE_10532_length_844_cov_12.616107	363	443	8	16	80	0.2000000
NODE_10532_length_844_cov_12.616107	416	496	6	8	80	0.1000000
NODE_10532_length_844_cov_12.616107	416	496	7	3	80	0.0375000
NODE_10532_length_844_cov_12.616107	416	496	8	43	80	0.5375000
NODE_10532_length_844_cov_12.616107	416	496	9	7	80	0.0875000
NODE_10532_length_844_cov_12.616107	416	496	10	19	80	0.2375000
NODE_10533_length_844_cov_12.092617	171	251	0	80	80	1.0000000
NODE_10533_length_844_cov_12.092617	224	304	0	80	80	1.0000000
NODE_10534_length_844_cov_11.883221	341	421	4	18	80	0.2250000
NODE_10534_length_844_cov_11.883221	341	421	5	8	80	0.1000000
NODE_10534_length_844_cov_11.883221	341	421	6	11	80	0.1375000
NODE_10534_length_844_cov_11.883221	341	421	7	1	80	0.0125000
NODE_10534_length_844_cov_11.883221	341	421	8	5	80	0.0625000
NODE_10534_length_844_cov_11.883221	341	421	9	7	80	0.0875000
NODE_10534_length_844_cov_11.883221	341	421	10	30	80	0.3750000
NODE_10534_length_844_cov_11.883221	394	474	7	36	80	0.4500000
NODE_10534_length_844_cov_11.883221	394	474	8	17	80	0.2125000
NODE_10534_length_844_cov_11.883221	394	474	10	27	80	0.3375000
NODE_10535_length_844_cov_10.571812	390	448	0	8	58	0.1379310
NODE_10535_length_844_cov_10.571812	390	448	2	50	58	0.8620690
NODE_10537_length_844_cov_9.357047	370	450	0	80	80	1.0000000
NODE_10537_length_844_cov_9.357047	423	503	0	80	80	1.0000000
NODE_10538_length_844_cov_8.975839	355	435	0	11	80	0.1375000
NODE_10538_length_844_cov_8.975839	355	435	1	20	80	0.2500000
NODE_10538_length_844_cov_8.975839	355	435	2	49	80	0.6125000
NODE_10538_length_844_cov_8.975839	408	488	2	40	80	0.5000000
NODE_10538_length_844_cov_8.975839	408	488	3	22	80	0.2750000
NODE_10538_length_844_cov_8.975839	408	488	4	18	80	0.2250000
NODE_10539_length_844_cov_7.347651	357	438	0	81	81	1.0000000
NODE_10539_length_844_cov_7.347651	410	491	0	81	81	1.0000000
NODE_10540_length_844_cov_6.975839	444	524	0	80	80	1.0000000
NODE_10540_length_844_cov_6.975839	497	577	0	80	80	1.0000000
NODE_10567_length_843_cov_48.258065	203	262	20	1	59	0.0169492
NODE_10567_length_843_cov_48.258065	203	262	21	2	59	0.0338983
NODE_10567_length_843_cov_48.258065	203	262	23	7	59	0.1186441
NODE_10567_length_843_cov_48.258065	203	262	24	24	59	0.4067796
NODE_10567_length_843_cov_48.258065	203	262	25	2	59	0.0338983
NODE_10567_length_843_cov_48.258065	203	262	26	9	59	0.1525424
NODE_10567_length_843_cov_48.258065	203	262	27	14	59	0.2372881
NODE_10568_length_843_cov_31.279570	351	431	7	36	80	0.4500000
NODE_10568_length_843_cov_31.279570	351	431	8	23	80	0.2875000
NODE_10568_length_843_cov_31.279570	351	431	9	21	80	0.2625000
NODE_10568_length_843_cov_31.279570	404	484	4	7	80	0.0875000
NODE_10568_length_843_cov_31.279570	404	484	5	19	80	0.2375000
NODE_10568_length_843_cov_31.279570	404	484	6	7	80	0.0875000
NODE_10568_length_843_cov_31.279570	404	484	7	31	80	0.3875000
NODE_10568_length_843_cov_31.279570	404	484	8	16	80	0.2000000
NODE_10569_length_843_cov_27.060484	423	503	2	54	80	0.6750000
NODE_10569_length_843_cov_27.060484	423	503	3	7	80	0.0875000
NODE_10569_length_843_cov_27.060484	423	503	5	19	80	0.2375000
NODE_10569_length_843_cov_27.060484	476	556	2	1	80	0.0125000
NODE_10569_length_843_cov_27.060484	476	556	3	7	80	0.0875000
NODE_10569_length_843_cov_27.060484	476	556	5	22	80	0.2750000
NODE_10569_length_843_cov_27.060484	476	556	6	43	80	0.5375000
NODE_10569_length_843_cov_27.060484	476	556	7	7	80	0.0875000
NODE_10570_length_843_cov_22.725806	334	414	0	80	80	1.0000000
NODE_10570_length_843_cov_22.725806	339	396	0	57	57	1.0000000
NODE_10570_length_843_cov_22.725806	356	427	0	71	71	1.0000000
NODE_10570_length_843_cov_22.725806	387	455	0	47	68	0.6911765
NODE_10570_length_843_cov_22.725806	387	455	1	4	68	0.0588235
NODE_10570_length_843_cov_22.725806	387	455	2	17	68	0.2500000
NODE_10570_length_843_cov_22.725806	401	476	0	33	75	0.4400000
NODE_10570_length_843_cov_22.725806	401	476	1	4	75	0.0533333
NODE_10570_length_843_cov_22.725806	401	476	2	38	75	0.5066667
NODE_10570_length_843_cov_22.725806	418	486	0	16	68	0.2352941
NODE_10570_length_843_cov_22.725806	418	486	1	4	68	0.0588235
NODE_10570_length_843_cov_22.725806	418	486	2	48	68	0.7058824
NODE_10570_length_843_cov_22.725806	449	529	2	80	80	1.0000000
NODE_10571_length_843_cov_22.387097	412	492	20	32	80	0.4000000
NODE_10571_length_843_cov_22.387097	412	492	21	2	80	0.0250000
NODE_10571_length_843_cov_22.387097	412	492	22	3	80	0.0375000
NODE_10571_length_843_cov_22.387097	412	492	23	2	80	0.0250000
NODE_10571_length_843_cov_22.387097	412	492	24	13	80	0.1625000
NODE_10571_length_843_cov_22.387097	412	492	25	12	80	0.1500000
NODE_10571_length_843_cov_22.387097	412	492	26	16	80	0.2000000
NODE_10571_length_843_cov_22.387097	465	545	12	4	80	0.0500000
NODE_10571_length_843_cov_22.387097	465	545	14	5	80	0.0625000
NODE_10571_length_843_cov_22.387097	465	545	15	5	80	0.0625000
NODE_10571_length_843_cov_22.387097	465	545	16	2	80	0.0250000
NODE_10571_length_843_cov_22.387097	465	545	18	5	80	0.0625000
NODE_10571_length_843_cov_22.387097	465	545	19	5	80	0.0625000
NODE_10571_length_843_cov_22.387097	465	545	20	10	80	0.1250000
NODE_10571_length_843_cov_22.387097	465	545	21	4	80	0.0500000
NODE_10571_length_843_cov_22.387097	465	545	23	2	80	0.0250000
NODE_10571_length_843_cov_22.387097	465	545	24	14	80	0.1750000
NODE_10571_length_843_cov_22.387097	465	545	25	8	80	0.1000000
NODE_10571_length_843_cov_22.387097	465	545	26	16	80	0.2000000
NODE_10572_length_843_cov_16.326613	551	631	4	30	80	0.3750000
NODE_10572_length_843_cov_16.326613	551	631	5	31	80	0.3875000
NODE_10572_length_843_cov_16.326613	551	631	7	19	80	0.2375000
NODE_10572_length_843_cov_16.326613	604	684	2	6	80	0.0750000
NODE_10572_length_843_cov_16.326613	604	684	4	53	80	0.6625000
NODE_10572_length_843_cov_16.326613	604	684	5	21	80	0.2625000
NODE_10573_length_843_cov_13.478495	381	461	0	1	80	0.0125000
NODE_10573_length_843_cov_13.478495	381	461	1	45	80	0.5625000
NODE_10573_length_843_cov_13.478495	381	461	2	5	80	0.0625000
NODE_10573_length_843_cov_13.478495	381	461	3	6	80	0.0750000
NODE_10573_length_843_cov_13.478495	381	461	4	23	80	0.2875000
NODE_10573_length_843_cov_13.478495	434	514	3	4	80	0.0500000
NODE_10573_length_843_cov_13.478495	434	514	4	26	80	0.3250000
NODE_10573_length_843_cov_13.478495	434	514	5	2	80	0.0250000
NODE_10573_length_843_cov_13.478495	434	514	6	20	80	0.2500000
NODE_10573_length_843_cov_13.478495	434	514	7	14	80	0.1750000
NODE_10573_length_843_cov_13.478495	434	514	8	1	80	0.0125000
NODE_10573_length_843_cov_13.478495	434	514	9	13	80	0.1625000
NODE_10574_length_843_cov_13.150538	448	528	1	4	80	0.0500000
NODE_10574_length_843_cov_13.150538	448	528	2	76	80	0.9500000
NODE_10574_length_843_cov_13.150538	501	581	1	4	80	0.0500000
NODE_10574_length_843_cov_13.150538	501	581	2	45	80	0.5625000
NODE_10574_length_843_cov_13.150538	501	581	3	31	80	0.3875000
NODE_10575_length_843_cov_12.510753	360	440	3	20	80	0.2500000
NODE_10575_length_843_cov_12.510753	360	440	4	60	80	0.7500000
NODE_10575_length_843_cov_12.510753	413	493	2	20	80	0.2500000
NODE_10575_length_843_cov_12.510753	413	493	3	23	80	0.2875000
NODE_10575_length_843_cov_12.510753	413	493	4	37	80	0.4625000
NODE_10576_length_843_cov_11.090054	457	537	9	21	80	0.2625000
NODE_10576_length_843_cov_11.090054	457	537	11	59	80	0.7375000
NODE_10576_length_843_cov_11.090054	510	590	11	69	80	0.8625000
NODE_10576_length_843_cov_11.090054	510	590	12	11	80	0.1375000
NODE_10577_length_843_cov_7.672043	472	552	0	32	80	0.4000000
NODE_10577_length_843_cov_7.672043	472	552	1	48	80	0.6000000
NODE_10577_length_843_cov_7.672043	525	605	0	80	80	1.0000000
NODE_10601_length_842_cov_39.518170	390	470	7	1	80	0.0125000
NODE_10601_length_842_cov_39.518170	390	470	8	48	80	0.6000000
NODE_10601_length_842_cov_39.518170	390	470	9	25	80	0.3125000
NODE_10601_length_842_cov_39.518170	390	470	11	6	80	0.0750000
NODE_10601_length_842_cov_39.518170	443	523	7	5	80	0.0625000
NODE_10601_length_842_cov_39.518170	443	523	8	57	80	0.7125000
NODE_10601_length_842_cov_39.518170	443	523	9	3	80	0.0375000
NODE_10601_length_842_cov_39.518170	443	523	11	15	80	0.1875000
NODE_10602_length_842_cov_21.567968	331	411	0	1	80	0.0125000
NODE_10602_length_842_cov_21.567968	331	411	1	68	80	0.8500000
NODE_10602_length_842_cov_21.567968	331	411	2	11	80	0.1375000
NODE_10602_length_842_cov_21.567968	384	464	1	16	80	0.2000000
NODE_10602_length_842_cov_21.567968	384	464	2	36	80	0.4500000
NODE_10602_length_842_cov_21.567968	384	464	3	28	80	0.3500000
NODE_10603_length_842_cov_19.761777	228	308	4	11	80	0.1375000
NODE_10603_length_842_cov_19.761777	228	308	5	14	80	0.1750000
NODE_10603_length_842_cov_19.761777	228	308	8	9	80	0.1125000
NODE_10603_length_842_cov_19.761777	228	308	9	19	80	0.2375000
NODE_10603_length_842_cov_19.761777	228	308	12	8	80	0.1000000
NODE_10603_length_842_cov_19.761777	228	308	13	19	80	0.2375000
NODE_10603_length_842_cov_19.761777	281	361	12	9	80	0.1125000
NODE_10603_length_842_cov_19.761777	281	361	13	43	80	0.5375000
NODE_10603_length_842_cov_19.761777	281	361	14	8	80	0.1000000
NODE_10603_length_842_cov_19.761777	281	361	15	4	80	0.0500000
NODE_10603_length_842_cov_19.761777	281	361	16	1	80	0.0125000
NODE_10603_length_842_cov_19.761777	281	361	17	4	80	0.0500000
NODE_10603_length_842_cov_19.761777	281	361	19	1	80	0.0125000
NODE_10603_length_842_cov_19.761777	281	361	20	2	80	0.0250000
NODE_10603_length_842_cov_19.761777	281	361	22	8	80	0.1000000
NODE_10605_length_842_cov_8.703903	641	722	0	81	81	1.0000000
NODE_10608_length_842_cov_5.305518	287	367	2	57	80	0.7125000
NODE_10608_length_842_cov_5.305518	287	367	3	3	80	0.0375000
NODE_10608_length_842_cov_5.305518	287	367	4	20	80	0.2500000
NODE_10608_length_842_cov_5.305518	340	420	2	80	80	1.0000000
NODE_10617_length_842_cov_1.751009	35	66	0	31	31	1.0000000
NODE_10622_length_841_cov_23.815364	292	372	0	16	80	0.2000000
NODE_10622_length_841_cov_23.815364	292	372	1	64	80	0.8000000
NODE_10622_length_841_cov_23.815364	345	425	1	80	80	1.0000000
NODE_10623_length_841_cov_18.871968	338	418	4	58	80	0.7250000
NODE_10623_length_841_cov_18.871968	338	418	5	22	80	0.2750000
NODE_10623_length_841_cov_18.871968	391	471	4	10	80	0.1250000
NODE_10623_length_841_cov_18.871968	391	471	5	22	80	0.2750000
NODE_10623_length_841_cov_18.871968	391	471	7	48	80	0.6000000
NODE_10624_length_841_cov_14.663073	345	425	5	77	80	0.9625000
NODE_10624_length_841_cov_14.663073	345	425	7	3	80	0.0375000
NODE_10624_length_841_cov_14.663073	398	478	2	49	80	0.6125000
NODE_10624_length_841_cov_14.663073	398	478	5	31	80	0.3875000
NODE_10625_length_841_cov_14.149596	341	421	3	14	80	0.1750000
NODE_10625_length_841_cov_14.149596	341	421	4	23	80	0.2875000
NODE_10625_length_841_cov_14.149596	341	421	5	43	80	0.5375000
NODE_10625_length_841_cov_14.149596	394	474	4	68	80	0.8500000
NODE_10625_length_841_cov_14.149596	394	474	5	12	80	0.1500000
NODE_10626_length_841_cov_12.452830	240	320	0	80	80	1.0000000
NODE_10626_length_841_cov_12.452830	293	373	0	80	80	1.0000000
NODE_10628_length_841_cov_9.925876	394	474	0	80	80	1.0000000
NODE_10628_length_841_cov_9.925876	447	527	0	80	80	1.0000000
NODE_10629_length_841_cov_7.407008	317	397	4	32	80	0.4000000
NODE_10629_length_841_cov_7.407008	317	397	5	17	80	0.2125000
NODE_10629_length_841_cov_7.407008	317	397	6	21	80	0.2625000
NODE_10629_length_841_cov_7.407008	317	397	7	4	80	0.0500000
NODE_10629_length_841_cov_7.407008	317	397	8	6	80	0.0750000
NODE_10629_length_841_cov_7.407008	370	450	2	23	80	0.2875000
NODE_10629_length_841_cov_7.407008	370	450	3	1	80	0.0125000
NODE_10629_length_841_cov_7.407008	370	450	4	56	80	0.7000000
NODE_10632_length_841_cov_3.865229	305	356	1	11	51	0.2156863
NODE_10632_length_841_cov_3.865229	305	356	2	40	51	0.7843137
NODE_10651_length_840_cov_63.726046	461	541	0	27	80	0.3375000
NODE_10651_length_840_cov_63.726046	461	541	1	53	80	0.6625000
NODE_10651_length_840_cov_63.726046	514	594	1	80	80	1.0000000
NODE_10652_length_840_cov_35.874494	486	566	6	9	80	0.1125000
NODE_10652_length_840_cov_35.874494	486	566	7	31	80	0.3875000
NODE_10652_length_840_cov_35.874494	486	566	8	38	80	0.4750000
NODE_10652_length_840_cov_35.874494	486	566	9	2	80	0.0250000
NODE_10652_length_840_cov_35.874494	539	619	6	29	80	0.3625000
NODE_10652_length_840_cov_35.874494	539	619	7	36	80	0.4500000
NODE_10652_length_840_cov_35.874494	539	619	8	15	80	0.1875000
NODE_10653_length_840_cov_24.499325	224	304	2	80	80	1.0000000
NODE_10653_length_840_cov_24.499325	277	357	2	74	80	0.9250000
NODE_10653_length_840_cov_24.499325	277	357	3	6	80	0.0750000
NODE_10653_length_840_cov_24.499325	353	433	1	8	80	0.1000000
NODE_10653_length_840_cov_24.499325	353	433	2	35	80	0.4375000
NODE_10653_length_840_cov_24.499325	353	433	3	2	80	0.0250000
NODE_10653_length_840_cov_24.499325	353	433	4	35	80	0.4375000
NODE_10653_length_840_cov_24.499325	406	486	3	3	80	0.0375000
NODE_10653_length_840_cov_24.499325	406	486	4	77	80	0.9625000
NODE_10654_length_840_cov_23.272605	309	389	2	1	80	0.0125000
NODE_10654_length_840_cov_23.272605	309	389	3	79	80	0.9875000
NODE_10654_length_840_cov_23.272605	362	442	1	34	80	0.4250000
NODE_10654_length_840_cov_23.272605	362	442	2	19	80	0.2375000
NODE_10654_length_840_cov_23.272605	362	442	3	27	80	0.3375000
NODE_10655_length_840_cov_22.221323	293	373	0	29	80	0.3625000
NODE_10655_length_840_cov_22.221323	293	373	3	46	80	0.5750000
NODE_10655_length_840_cov_22.221323	293	373	4	5	80	0.0625000
NODE_10655_length_840_cov_22.221323	346	426	0	14	80	0.1750000
NODE_10655_length_840_cov_22.221323	346	426	3	8	80	0.1000000
NODE_10655_length_840_cov_22.221323	346	426	4	58	80	0.7250000
NODE_10656_length_840_cov_17.026991	348	432	4	14	84	0.1666667
NODE_10656_length_840_cov_17.026991	348	432	6	59	84	0.7023810
NODE_10656_length_840_cov_17.026991	348	432	7	3	84	0.0357143
NODE_10656_length_840_cov_17.026991	348	432	8	8	84	0.0952381
NODE_10656_length_840_cov_17.026991	405	485	4	47	80	0.5875000
NODE_10656_length_840_cov_17.026991	405	485	6	27	80	0.3375000
NODE_10656_length_840_cov_17.026991	405	485	7	3	80	0.0375000
NODE_10656_length_840_cov_17.026991	405	485	8	3	80	0.0375000
NODE_10657_length_840_cov_16.635628	347	427	5	7	80	0.0875000
NODE_10657_length_840_cov_16.635628	347	427	7	71	80	0.8875000
NODE_10657_length_840_cov_16.635628	347	427	8	2	80	0.0250000
NODE_10657_length_840_cov_16.635628	400	480	4	33	80	0.4125000
NODE_10657_length_840_cov_16.635628	400	480	5	8	80	0.1000000
NODE_10657_length_840_cov_16.635628	400	480	6	1	80	0.0125000
NODE_10657_length_840_cov_16.635628	400	480	7	38	80	0.4750000
NODE_10658_length_840_cov_12.133603	336	416	4	33	80	0.4125000
NODE_10658_length_840_cov_12.133603	336	416	5	12	80	0.1500000
NODE_10658_length_840_cov_12.133603	336	416	6	35	80	0.4375000
NODE_10658_length_840_cov_12.133603	389	469	2	11	80	0.1375000
NODE_10658_length_840_cov_12.133603	389	469	3	5	80	0.0625000
NODE_10658_length_840_cov_12.133603	389	469	4	41	80	0.5125000
NODE_10658_length_840_cov_12.133603	389	469	5	12	80	0.1500000
NODE_10658_length_840_cov_12.133603	389	469	6	11	80	0.1375000
NODE_10659_length_840_cov_12.041835	332	412	0	80	80	1.0000000
NODE_10659_length_840_cov_12.041835	385	465	0	80	80	1.0000000
NODE_10660_length_840_cov_10.719298	275	354	1	19	79	0.2405063
NODE_10660_length_840_cov_10.719298	275	354	2	60	79	0.7594936
NODE_10660_length_840_cov_10.719298	327	407	2	80	80	1.0000000
NODE_10663_length_840_cov_5.207827	427	507	2	20	80	0.2500000
NODE_10663_length_840_cov_5.207827	427	507	3	29	80	0.3625000
NODE_10663_length_840_cov_5.207827	427	507	4	31	80	0.3875000
NODE_10663_length_840_cov_5.207827	480	560	2	73	80	0.9125000
NODE_10663_length_840_cov_5.207827	480	560	3	7	80	0.0875000
NODE_10683_length_839_cov_274.987838	450	530	44	1	80	0.0125000
NODE_10683_length_839_cov_274.987838	450	530	50	3	80	0.0375000
NODE_10683_length_839_cov_274.987838	450	530	56	1	80	0.0125000
NODE_10683_length_839_cov_274.987838	450	530	57	1	80	0.0125000
NODE_10683_length_839_cov_274.987838	450	530	59	1	80	0.0125000
NODE_10683_length_839_cov_274.987838	450	530	60	4	80	0.0500000
NODE_10683_length_839_cov_274.987838	450	530	61	1	80	0.0125000
NODE_10683_length_839_cov_274.987838	450	530	63	1	80	0.0125000
NODE_10683_length_839_cov_274.987838	450	530	64	2	80	0.0250000
NODE_10683_length_839_cov_274.987838	450	530	65	1	80	0.0125000
NODE_10683_length_839_cov_274.987838	450	530	67	3	80	0.0375000
NODE_10683_length_839_cov_274.987838	450	530	69	3	80	0.0375000
NODE_10683_length_839_cov_274.987838	450	530	70	3	80	0.0375000
NODE_10683_length_839_cov_274.987838	450	530	71	7	80	0.0875000
NODE_10683_length_839_cov_274.987838	450	530	72	2	80	0.0250000
NODE_10683_length_839_cov_274.987838	450	530	74	1	80	0.0125000
NODE_10683_length_839_cov_274.987838	450	530	77	1	80	0.0125000
NODE_10683_length_839_cov_274.987838	450	530	78	1	80	0.0125000
NODE_10683_length_839_cov_274.987838	450	530	79	5	80	0.0625000
NODE_10683_length_839_cov_274.987838	450	530	81	2	80	0.0250000
NODE_10683_length_839_cov_274.987838	450	530	82	3	80	0.0375000
NODE_10683_length_839_cov_274.987838	450	530	83	6	80	0.0750000
NODE_10683_length_839_cov_274.987838	450	530	87	1	80	0.0125000
NODE_10683_length_839_cov_274.987838	450	530	88	1	80	0.0125000
NODE_10683_length_839_cov_274.987838	450	530	89	4	80	0.0500000
NODE_10683_length_839_cov_274.987838	450	530	90	2	80	0.0250000
NODE_10683_length_839_cov_274.987838	450	530	91	1	80	0.0125000
NODE_10683_length_839_cov_274.987838	450	530	93	4	80	0.0500000
NODE_10683_length_839_cov_274.987838	450	530	94	2	80	0.0250000
NODE_10683_length_839_cov_274.987838	450	530	95	1	80	0.0125000
NODE_10683_length_839_cov_274.987838	450	530	96	2	80	0.0250000
NODE_10683_length_839_cov_274.987838	450	530	97	7	80	0.0875000
NODE_10683_length_839_cov_274.987838	450	530	98	1	80	0.0125000
NODE_10683_length_839_cov_274.987838	450	530	102	1	80	0.0125000
NODE_10683_length_839_cov_274.987838	503	583	87	1	80	0.0125000
NODE_10683_length_839_cov_274.987838	503	583	88	1	80	0.0125000
NODE_10683_length_839_cov_274.987838	503	583	89	4	80	0.0500000
NODE_10683_length_839_cov_274.987838	503	583	90	2	80	0.0250000
NODE_10683_length_839_cov_274.987838	503	583	91	1	80	0.0125000
NODE_10683_length_839_cov_274.987838	503	583	93	4	80	0.0500000
NODE_10683_length_839_cov_274.987838	503	583	94	2	80	0.0250000
NODE_10683_length_839_cov_274.987838	503	583	95	1	80	0.0125000
NODE_10683_length_839_cov_274.987838	503	583	96	2	80	0.0250000
NODE_10683_length_839_cov_274.987838	503	583	97	7	80	0.0875000
NODE_10683_length_839_cov_274.987838	503	583	98	1	80	0.0125000
NODE_10683_length_839_cov_274.987838	503	583	102	1	80	0.0125000
NODE_10683_length_839_cov_274.987838	503	583	104	1	80	0.0125000
NODE_10683_length_839_cov_274.987838	503	583	105	1	80	0.0125000
NODE_10683_length_839_cov_274.987838	503	583	106	2	80	0.0250000
NODE_10683_length_839_cov_274.987838	503	583	107	1	80	0.0125000
NODE_10683_length_839_cov_274.987838	503	583	114	4	80	0.0500000
NODE_10683_length_839_cov_274.987838	503	583	116	1	80	0.0125000
NODE_10683_length_839_cov_274.987838	503	583	117	1	80	0.0125000
NODE_10683_length_839_cov_274.987838	503	583	118	1	80	0.0125000
NODE_10683_length_839_cov_274.987838	503	583	120	1	80	0.0125000
NODE_10683_length_839_cov_274.987838	503	583	121	7	80	0.0875000
NODE_10683_length_839_cov_274.987838	503	583	122	10	80	0.1250000
NODE_10683_length_839_cov_274.987838	503	583	123	9	80	0.1125000
NODE_10683_length_839_cov_274.987838	503	583	124	5	80	0.0625000
NODE_10683_length_839_cov_274.987838	503	583	125	1	80	0.0125000
NODE_10683_length_839_cov_274.987838	503	583	126	8	80	0.1000000
NODE_10684_length_839_cov_24.500000	303	383	1	41	80	0.5125000
NODE_10684_length_839_cov_24.500000	303	383	2	10	80	0.1250000
NODE_10684_length_839_cov_24.500000	303	383	3	29	80	0.3625000
NODE_10684_length_839_cov_24.500000	356	436	0	49	80	0.6125000
NODE_10684_length_839_cov_24.500000	356	436	1	31	80	0.3875000
NODE_10685_length_839_cov_16.390541	477	557	9	56	80	0.7000000
NODE_10685_length_839_cov_16.390541	477	557	10	7	80	0.0875000
NODE_10685_length_839_cov_16.390541	477	557	12	1	80	0.0125000
NODE_10685_length_839_cov_16.390541	477	557	13	16	80	0.2000000
NODE_10685_length_839_cov_16.390541	530	610	9	10	80	0.1250000
NODE_10685_length_839_cov_16.390541	530	610	12	14	80	0.1750000
NODE_10685_length_839_cov_16.390541	530	610	13	20	80	0.2500000
NODE_10685_length_839_cov_16.390541	530	610	14	28	80	0.3500000
NODE_10685_length_839_cov_16.390541	530	610	15	8	80	0.1000000
NODE_10686_length_839_cov_10.006757	383	463	6	6	80	0.0750000
NODE_10686_length_839_cov_10.006757	383	463	8	61	80	0.7625000
NODE_10686_length_839_cov_10.006757	383	463	10	13	80	0.1625000
NODE_10686_length_839_cov_10.006757	436	516	5	3	80	0.0375000
NODE_10686_length_839_cov_10.006757	436	516	6	4	80	0.0500000
NODE_10686_length_839_cov_10.006757	436	516	7	3	80	0.0375000
NODE_10686_length_839_cov_10.006757	436	516	8	70	80	0.8750000
NODE_10688_length_839_cov_7.612162	308	388	2	13	80	0.1625000
NODE_10688_length_839_cov_7.612162	308	388	3	40	80	0.5000000
NODE_10688_length_839_cov_7.612162	308	388	4	27	80	0.3375000
NODE_10688_length_839_cov_7.612162	361	441	2	31	80	0.3875000
NODE_10688_length_839_cov_7.612162	361	441	3	1	80	0.0125000
NODE_10688_length_839_cov_7.612162	361	441	4	48	80	0.6000000
NODE_10689_length_839_cov_6.693243	343	423	1	80	80	1.0000000
NODE_10706_length_838_cov_39.263870	383	463	18	4	80	0.0500000
NODE_10706_length_838_cov_39.263870	383	463	19	16	80	0.2000000
NODE_10706_length_838_cov_39.263870	383	463	20	16	80	0.2000000
NODE_10706_length_838_cov_39.263870	383	463	22	21	80	0.2625000
NODE_10706_length_838_cov_39.263870	383	463	23	10	80	0.1250000
NODE_10706_length_838_cov_39.263870	383	463	24	11	80	0.1375000
NODE_10706_length_838_cov_39.263870	383	463	25	2	80	0.0250000
NODE_10706_length_838_cov_39.263870	436	516	9	2	80	0.0250000
NODE_10706_length_838_cov_39.263870	436	516	13	2	80	0.0250000
NODE_10706_length_838_cov_39.263870	436	516	15	10	80	0.1250000
NODE_10706_length_838_cov_39.263870	436	516	18	2	80	0.0250000
NODE_10706_length_838_cov_39.263870	436	516	19	5	80	0.0625000
NODE_10706_length_838_cov_39.263870	436	516	20	15	80	0.1875000
NODE_10706_length_838_cov_39.263870	436	516	22	20	80	0.2500000
NODE_10706_length_838_cov_39.263870	436	516	23	4	80	0.0500000
NODE_10706_length_838_cov_39.263870	436	516	24	18	80	0.2250000
NODE_10706_length_838_cov_39.263870	436	516	25	2	80	0.0250000
NODE_10707_length_838_cov_27.843031	473	553	2	14	80	0.1750000
NODE_10707_length_838_cov_27.843031	473	553	3	13	80	0.1625000
NODE_10707_length_838_cov_27.843031	473	553	4	3	80	0.0375000
NODE_10707_length_838_cov_27.843031	473	553	5	2	80	0.0250000
NODE_10707_length_838_cov_27.843031	473	553	6	14	80	0.1750000
NODE_10707_length_838_cov_27.843031	473	553	7	34	80	0.4250000
NODE_10707_length_838_cov_27.843031	526	606	1	23	80	0.2875000
NODE_10707_length_838_cov_27.843031	526	606	2	44	80	0.5500000
NODE_10707_length_838_cov_27.843031	526	606	3	10	80	0.1250000
NODE_10707_length_838_cov_27.843031	526	606	4	3	80	0.0375000
NODE_10708_length_838_cov_27.238160	432	512	2	80	80	1.0000000
NODE_10708_length_838_cov_27.238160	485	565	0	31	80	0.3875000
NODE_10708_length_838_cov_27.238160	485	565	1	1	80	0.0125000
NODE_10708_length_838_cov_27.238160	485	565	2	48	80	0.6000000
NODE_10709_length_838_cov_22.691475	380	460	8	32	80	0.4000000
NODE_10709_length_838_cov_22.691475	380	460	10	48	80	0.6000000
NODE_10709_length_838_cov_22.691475	433	513	4	20	80	0.2500000
NODE_10709_length_838_cov_22.691475	433	513	5	23	80	0.2875000
NODE_10709_length_838_cov_22.691475	433	513	7	2	80	0.0250000
NODE_10709_length_838_cov_22.691475	433	513	8	17	80	0.2125000
NODE_10709_length_838_cov_22.691475	433	513	10	18	80	0.2250000
NODE_10710_length_838_cov_16.169147	312	392	6	47	80	0.5875000
NODE_10710_length_838_cov_16.169147	312	392	7	32	80	0.4000000
NODE_10710_length_838_cov_16.169147	312	392	8	1	80	0.0125000
NODE_10710_length_838_cov_16.169147	365	445	6	26	80	0.3250000
NODE_10710_length_838_cov_16.169147	365	445	8	2	80	0.0250000
NODE_10710_length_838_cov_16.169147	365	445	11	52	80	0.6500000
NODE_10711_length_838_cov_15.753721	328	408	10	22	80	0.2750000
NODE_10711_length_838_cov_15.753721	328	408	13	11	80	0.1375000
NODE_10711_length_838_cov_15.753721	328	408	14	43	80	0.5375000
NODE_10711_length_838_cov_15.753721	328	408	15	4	80	0.0500000
NODE_10711_length_838_cov_15.753721	381	461	8	17	80	0.2125000
NODE_10711_length_838_cov_15.753721	381	461	9	6	80	0.0750000
NODE_10711_length_838_cov_15.753721	381	461	10	11	80	0.1375000
NODE_10711_length_838_cov_15.753721	381	461	12	15	80	0.1875000
NODE_10711_length_838_cov_15.753721	381	461	13	15	80	0.1875000
NODE_10711_length_838_cov_15.753721	381	461	14	16	80	0.2000000
NODE_10712_length_838_cov_15.514208	294	374	0	80	80	1.0000000
NODE_10712_length_838_cov_15.514208	347	427	0	80	80	1.0000000
NODE_10713_length_838_cov_7.733424	350	430	2	80	80	1.0000000
NODE_10713_length_838_cov_7.733424	403	483	1	26	80	0.3250000
NODE_10713_length_838_cov_7.733424	403	483	2	54	80	0.6750000
NODE_10716_length_838_cov_4.511502	131	213	0	82	82	1.0000000
NODE_10716_length_838_cov_4.511502	184	252	0	68	68	1.0000000
NODE_10722_length_838_cov_2.247632	359	405	0	46	46	1.0000000
NODE_10727_length_838_cov_1.843031	732	752	0	20	20	1.0000000
NODE_10740_length_837_cov_32.691057	401	481	0	80	80	1.0000000
NODE_10740_length_837_cov_32.691057	454	534	0	80	80	1.0000000
NODE_10741_length_837_cov_30.995935	399	479	0	49	80	0.6125000
NODE_10741_length_837_cov_30.995935	399	479	1	14	80	0.1750000
NODE_10741_length_837_cov_30.995935	399	479	2	1	80	0.0125000
NODE_10741_length_837_cov_30.995935	399	479	4	16	80	0.2000000
NODE_10741_length_837_cov_30.995935	452	532	1	10	80	0.1250000
NODE_10741_length_837_cov_30.995935	452	532	2	1	80	0.0125000
NODE_10741_length_837_cov_30.995935	452	532	4	37	80	0.4625000
NODE_10741_length_837_cov_30.995935	452	532	5	32	80	0.4000000
NODE_10742_length_837_cov_30.883469	278	358	1	50	80	0.6250000
NODE_10742_length_837_cov_30.883469	278	358	2	30	80	0.3750000
NODE_10742_length_837_cov_30.883469	331	411	1	80	80	1.0000000
NODE_10742_length_837_cov_30.883469	407	487	0	73	80	0.9125000
NODE_10742_length_837_cov_30.883469	407	487	1	7	80	0.0875000
NODE_10742_length_837_cov_30.883469	460	540	0	80	80	1.0000000
NODE_10743_length_837_cov_14.573171	205	280	0	75	75	1.0000000
NODE_10743_length_837_cov_14.573171	258	337	0	79	79	1.0000000
NODE_10743_length_837_cov_14.573171	333	413	0	80	80	1.0000000
NODE_10743_length_837_cov_14.573171	386	466	0	80	80	1.0000000
NODE_10744_length_837_cov_12.582656	226	306	5	1	80	0.0125000
NODE_10744_length_837_cov_12.582656	226	306	6	44	80	0.5500000
NODE_10744_length_837_cov_12.582656	226	306	7	35	80	0.4375000
NODE_10744_length_837_cov_12.582656	279	359	3	4	80	0.0500000
NODE_10744_length_837_cov_12.582656	279	359	4	14	80	0.1750000
NODE_10744_length_837_cov_12.582656	279	359	5	18	80	0.2250000
NODE_10744_length_837_cov_12.582656	279	359	6	44	80	0.5500000
NODE_10745_length_837_cov_6.998645	389	474	5	13	85	0.1529412
NODE_10745_length_837_cov_6.998645	389	474	6	49	85	0.5764706
NODE_10745_length_837_cov_6.998645	389	474	7	23	85	0.2705882
NODE_10745_length_837_cov_6.998645	447	527	2	10	80	0.1250000
NODE_10745_length_837_cov_6.998645	447	527	3	35	80	0.4375000
NODE_10745_length_837_cov_6.998645	447	527	5	17	80	0.2125000
NODE_10745_length_837_cov_6.998645	447	527	6	2	80	0.0250000
NODE_10745_length_837_cov_6.998645	447	527	7	16	80	0.2000000
NODE_10750_length_837_cov_3.119241	373	453	0	28	80	0.3500000
NODE_10750_length_837_cov_3.119241	373	453	1	52	80	0.6500000
NODE_10750_length_837_cov_3.119241	426	506	1	80	80	1.0000000
NODE_10769_length_836_cov_40.141113	224	304	4	78	80	0.9750000
NODE_10769_length_836_cov_40.141113	224	304	6	2	80	0.0250000
NODE_10769_length_836_cov_40.141113	277	357	2	29	80	0.3625000
NODE_10769_length_836_cov_40.141113	277	357	4	51	80	0.6375000
NODE_10769_length_836_cov_40.141113	353	433	2	18	80	0.2250000
NODE_10769_length_836_cov_40.141113	353	433	3	29	80	0.3625000
NODE_10769_length_836_cov_40.141113	353	433	4	16	80	0.2000000
NODE_10769_length_836_cov_40.141113	353	433	5	17	80	0.2125000
NODE_10769_length_836_cov_40.141113	406	486	3	45	80	0.5625000
NODE_10769_length_836_cov_40.141113	406	486	5	7	80	0.0875000
NODE_10769_length_836_cov_40.141113	406	486	6	28	80	0.3500000
NODE_10770_length_836_cov_27.610583	344	424	4	3	80	0.0375000
NODE_10770_length_836_cov_27.610583	344	424	5	68	80	0.8500000
NODE_10770_length_836_cov_27.610583	344	424	7	9	80	0.1125000
NODE_10770_length_836_cov_27.610583	397	477	4	6	80	0.0750000
NODE_10770_length_836_cov_27.610583	397	477	5	15	80	0.1875000
NODE_10770_length_836_cov_27.610583	397	477	6	50	80	0.6250000
NODE_10770_length_836_cov_27.610583	397	477	7	9	80	0.1125000
NODE_10771_length_836_cov_15.719132	295	375	3	1	80	0.0125000
NODE_10771_length_836_cov_15.719132	295	375	4	79	80	0.9875000
NODE_10771_length_836_cov_15.719132	348	428	4	80	80	1.0000000
NODE_10772_length_836_cov_9.309362	295	375	2	80	80	1.0000000
NODE_10772_length_836_cov_9.309362	348	428	0	22	80	0.2750000
NODE_10772_length_836_cov_9.309362	348	428	1	1	80	0.0125000
NODE_10772_length_836_cov_9.309362	348	428	2	57	80	0.7125000
NODE_10773_length_836_cov_6.283582	336	416	2	1	80	0.0125000
NODE_10773_length_836_cov_6.283582	336	416	3	30	80	0.3750000
NODE_10773_length_836_cov_6.283582	336	416	4	49	80	0.6125000
NODE_10773_length_836_cov_6.283582	389	469	3	22	80	0.2750000
NODE_10773_length_836_cov_6.283582	389	469	4	58	80	0.7250000
NODE_10774_length_836_cov_4.979647	371	451	4	54	80	0.6750000
NODE_10774_length_836_cov_4.979647	371	451	5	14	80	0.1750000
NODE_10774_length_836_cov_4.979647	371	451	6	12	80	0.1500000
NODE_10774_length_836_cov_4.979647	424	504	1	20	80	0.2500000
NODE_10774_length_836_cov_4.979647	424	504	2	22	80	0.2750000
NODE_10774_length_836_cov_4.979647	424	504	4	38	80	0.4750000
NODE_10787_length_835_cov_61.033967	253	333	4	9	80	0.1125000
NODE_10787_length_835_cov_61.033967	253	333	6	8	80	0.1000000
NODE_10787_length_835_cov_61.033967	253	333	7	7	80	0.0875000
NODE_10787_length_835_cov_61.033967	253	333	8	27	80	0.3375000
NODE_10787_length_835_cov_61.033967	253	333	9	28	80	0.3500000
NODE_10787_length_835_cov_61.033967	253	333	10	1	80	0.0125000
NODE_10787_length_835_cov_61.033967	306	386	8	15	80	0.1875000
NODE_10787_length_835_cov_61.033967	306	386	9	26	80	0.3250000
NODE_10787_length_835_cov_61.033967	306	386	10	6	80	0.0750000
NODE_10787_length_835_cov_61.033967	306	386	12	33	80	0.4125000
NODE_10788_length_835_cov_32.380435	390	470	7	14	80	0.1750000
NODE_10788_length_835_cov_32.380435	390	470	8	35	80	0.4375000
NODE_10788_length_835_cov_32.380435	390	470	9	16	80	0.2000000
NODE_10788_length_835_cov_32.380435	390	470	10	15	80	0.1875000
NODE_10788_length_835_cov_32.380435	443	523	5	18	80	0.2250000
NODE_10788_length_835_cov_32.380435	443	523	6	13	80	0.1625000
NODE_10788_length_835_cov_32.380435	443	523	7	1	80	0.0125000
NODE_10788_length_835_cov_32.380435	443	523	8	42	80	0.5250000
NODE_10788_length_835_cov_32.380435	443	523	10	6	80	0.0750000
NODE_10789_length_835_cov_20.779891	415	495	0	4	80	0.0500000
NODE_10789_length_835_cov_20.779891	415	495	1	28	80	0.3500000
NODE_10789_length_835_cov_20.779891	415	495	2	48	80	0.6000000
NODE_10789_length_835_cov_20.779891	468	548	2	80	80	1.0000000
NODE_10808_length_835_cov_1.694293	18	80	0	62	62	1.0000000
NODE_10820_length_834_cov_13.689796	213	293	2	21	80	0.2625000
NODE_10820_length_834_cov_13.689796	213	293	3	8	80	0.1000000
NODE_10820_length_834_cov_13.689796	213	293	4	7	80	0.0875000
NODE_10820_length_834_cov_13.689796	213	293	5	13	80	0.1625000
NODE_10820_length_834_cov_13.689796	213	293	6	31	80	0.3875000
NODE_10820_length_834_cov_13.689796	266	346	5	4	80	0.0500000
NODE_10820_length_834_cov_13.689796	266	346	6	76	80	0.9500000
NODE_10822_length_834_cov_12.609524	406	486	2	6	80	0.0750000
NODE_10822_length_834_cov_12.609524	406	486	3	26	80	0.3250000
NODE_10822_length_834_cov_12.609524	406	486	4	48	80	0.6000000
NODE_10822_length_834_cov_12.609524	459	539	2	7	80	0.0875000
NODE_10822_length_834_cov_12.609524	459	539	3	22	80	0.2750000
NODE_10822_length_834_cov_12.609524	459	539	4	51	80	0.6375000
NODE_10823_length_834_cov_11.492517	248	328	1	6	80	0.0750000
NODE_10823_length_834_cov_11.492517	248	328	2	1	80	0.0125000
NODE_10823_length_834_cov_11.492517	248	328	3	5	80	0.0625000
NODE_10823_length_834_cov_11.492517	248	328	4	3	80	0.0375000
NODE_10823_length_834_cov_11.492517	248	328	7	1	80	0.0125000
NODE_10823_length_834_cov_11.492517	248	328	8	15	80	0.1875000
NODE_10823_length_834_cov_11.492517	248	328	10	22	80	0.2750000
NODE_10823_length_834_cov_11.492517	248	328	11	27	80	0.3375000
NODE_10823_length_834_cov_11.492517	301	381	11	35	80	0.4375000
NODE_10823_length_834_cov_11.492517	301	381	12	15	80	0.1875000
NODE_10823_length_834_cov_11.492517	301	381	15	8	80	0.1000000
NODE_10823_length_834_cov_11.492517	301	381	16	22	80	0.2750000
NODE_10824_length_834_cov_9.957823	212	292	0	4	80	0.0500000
NODE_10824_length_834_cov_9.957823	212	292	1	1	80	0.0125000
NODE_10824_length_834_cov_9.957823	212	292	2	49	80	0.6125000
NODE_10824_length_834_cov_9.957823	212	292	4	26	80	0.3250000
NODE_10824_length_834_cov_9.957823	265	345	2	1	80	0.0125000
NODE_10824_length_834_cov_9.957823	265	345	4	79	80	0.9875000
NODE_10825_length_834_cov_6.448980	482	546	2	41	64	0.6406250
NODE_10825_length_834_cov_6.448980	482	546	4	23	64	0.3593750
NODE_10833_length_834_cov_2.658503	589	641	2	52	52	1.0000000
NODE_10846_length_833_cov_57.702997	338	418	11	13	80	0.1625000
NODE_10846_length_833_cov_57.702997	338	418	12	2	80	0.0250000
NODE_10846_length_833_cov_57.702997	338	418	13	9	80	0.1125000
NODE_10846_length_833_cov_57.702997	338	418	15	20	80	0.2500000
NODE_10846_length_833_cov_57.702997	338	418	16	6	80	0.0750000
NODE_10846_length_833_cov_57.702997	338	418	19	2	80	0.0250000
NODE_10846_length_833_cov_57.702997	338	418	20	19	80	0.2375000
NODE_10846_length_833_cov_57.702997	338	418	21	9	80	0.1125000
NODE_10846_length_833_cov_57.702997	391	471	16	34	80	0.4250000
NODE_10846_length_833_cov_57.702997	391	471	19	11	80	0.1375000
NODE_10846_length_833_cov_57.702997	391	471	20	18	80	0.2250000
NODE_10846_length_833_cov_57.702997	391	471	21	17	80	0.2125000
NODE_10847_length_833_cov_38.153951	364	444	2	1	80	0.0125000
NODE_10847_length_833_cov_38.153951	364	444	4	27	80	0.3375000
NODE_10847_length_833_cov_38.153951	364	444	6	52	80	0.6500000
NODE_10847_length_833_cov_38.153951	417	497	0	36	80	0.4500000
NODE_10847_length_833_cov_38.153951	417	497	2	18	80	0.2250000
NODE_10847_length_833_cov_38.153951	417	497	4	26	80	0.3250000
NODE_10848_length_833_cov_34.302452	368	448	3	9	80	0.1125000
NODE_10848_length_833_cov_34.302452	368	448	5	16	80	0.2000000
NODE_10848_length_833_cov_34.302452	368	448	9	19	80	0.2375000
NODE_10848_length_833_cov_34.302452	368	448	10	19	80	0.2375000
NODE_10848_length_833_cov_34.302452	368	448	12	3	80	0.0375000
NODE_10848_length_833_cov_34.302452	368	448	15	14	80	0.1750000
NODE_10848_length_833_cov_34.302452	421	501	10	10	80	0.1250000
NODE_10848_length_833_cov_34.302452	421	501	12	3	80	0.0375000
NODE_10848_length_833_cov_34.302452	421	501	14	11	80	0.1375000
NODE_10848_length_833_cov_34.302452	421	501	15	27	80	0.3375000
NODE_10848_length_833_cov_34.302452	421	501	16	18	80	0.2250000
NODE_10848_length_833_cov_34.302452	421	501	17	7	80	0.0875000
NODE_10848_length_833_cov_34.302452	421	501	19	4	80	0.0500000
NODE_10849_length_833_cov_20.452316	311	392	1	26	81	0.3209876
NODE_10849_length_833_cov_20.452316	311	392	2	52	81	0.6419753
NODE_10849_length_833_cov_20.452316	311	392	3	3	81	0.0370370
NODE_10849_length_833_cov_20.452316	365	445	2	24	80	0.3000000
NODE_10849_length_833_cov_20.452316	365	445	3	49	80	0.6125000
NODE_10849_length_833_cov_20.452316	365	445	4	7	80	0.0875000
NODE_10850_length_833_cov_16.643052	238	318	3	17	80	0.2125000
NODE_10850_length_833_cov_16.643052	238	318	5	63	80	0.7875000
NODE_10851_length_833_cov_16.536785	84	164	0	3	80	0.0375000
NODE_10851_length_833_cov_16.536785	84	164	5	12	80	0.1500000
NODE_10851_length_833_cov_16.536785	84	164	7	60	80	0.7500000
NODE_10851_length_833_cov_16.536785	84	164	9	5	80	0.0625000
NODE_10851_length_833_cov_16.536785	137	217	7	22	80	0.2750000
NODE_10851_length_833_cov_16.536785	137	217	9	58	80	0.7250000
NODE_10865_length_833_cov_3.089918	467	547	4	5	80	0.0625000
NODE_10865_length_833_cov_3.089918	467	547	5	9	80	0.1125000
NODE_10865_length_833_cov_3.089918	467	547	6	40	80	0.5000000
NODE_10865_length_833_cov_3.089918	467	547	8	26	80	0.3250000
NODE_10865_length_833_cov_3.089918	520	600	6	16	80	0.2000000
NODE_10865_length_833_cov_3.089918	520	600	8	64	80	0.8000000
NODE_10891_length_832_cov_35.728513	460	540	2	2	80	0.0250000
NODE_10891_length_832_cov_35.728513	460	540	3	3	80	0.0375000
NODE_10891_length_832_cov_35.728513	460	540	4	17	80	0.2125000
NODE_10891_length_832_cov_35.728513	460	540	5	3	80	0.0375000
NODE_10891_length_832_cov_35.728513	460	540	8	2	80	0.0250000
NODE_10891_length_832_cov_35.728513	460	540	9	53	80	0.6625000
NODE_10891_length_832_cov_35.728513	513	593	2	18	80	0.2250000
NODE_10891_length_832_cov_35.728513	513	593	3	40	80	0.5000000
NODE_10891_length_832_cov_35.728513	513	593	4	17	80	0.2125000
NODE_10891_length_832_cov_35.728513	513	593	5	3	80	0.0375000
NODE_10891_length_832_cov_35.728513	513	593	9	2	80	0.0250000
NODE_10892_length_832_cov_25.450205	292	372	3	17	80	0.2125000
NODE_10892_length_832_cov_25.450205	292	372	6	16	80	0.2000000
NODE_10892_length_832_cov_25.450205	292	372	7	3	80	0.0375000
NODE_10892_length_832_cov_25.450205	292	372	8	16	80	0.2000000
NODE_10892_length_832_cov_25.450205	292	372	9	10	80	0.1250000
NODE_10892_length_832_cov_25.450205	292	372	10	8	80	0.1000000
NODE_10892_length_832_cov_25.450205	292	372	11	7	80	0.0875000
NODE_10892_length_832_cov_25.450205	292	372	12	3	80	0.0375000
NODE_10892_length_832_cov_25.450205	345	425	8	7	80	0.0875000
NODE_10892_length_832_cov_25.450205	345	425	9	10	80	0.1250000
NODE_10892_length_832_cov_25.450205	345	425	11	9	80	0.1125000
NODE_10892_length_832_cov_25.450205	345	425	12	54	80	0.6750000
NODE_10893_length_832_cov_18.858117	428	508	12	3	80	0.0375000
NODE_10893_length_832_cov_18.858117	428	508	16	12	80	0.1500000
NODE_10893_length_832_cov_18.858117	428	508	17	6	80	0.0750000
NODE_10893_length_832_cov_18.858117	428	508	18	15	80	0.1875000
NODE_10893_length_832_cov_18.858117	428	508	19	21	80	0.2625000
NODE_10893_length_832_cov_18.858117	428	508	20	4	80	0.0500000
NODE_10893_length_832_cov_18.858117	428	508	21	1	80	0.0125000
NODE_10893_length_832_cov_18.858117	428	508	22	11	80	0.1375000
NODE_10893_length_832_cov_18.858117	428	508	23	7	80	0.0875000
NODE_10893_length_832_cov_18.858117	481	561	18	42	80	0.5250000
NODE_10893_length_832_cov_18.858117	481	561	19	13	80	0.1625000
NODE_10893_length_832_cov_18.858117	481	561	20	4	80	0.0500000
NODE_10893_length_832_cov_18.858117	481	561	21	1	80	0.0125000
NODE_10893_length_832_cov_18.858117	481	561	22	11	80	0.1375000
NODE_10893_length_832_cov_18.858117	481	561	23	9	80	0.1125000
NODE_10894_length_832_cov_17.799454	314	394	5	24	80	0.3000000
NODE_10894_length_832_cov_17.799454	314	394	7	56	80	0.7000000
NODE_10894_length_832_cov_17.799454	367	447	7	74	80	0.9250000
NODE_10894_length_832_cov_17.799454	367	447	9	6	80	0.0750000
NODE_10895_length_832_cov_14.811733	353	433	4	2	80	0.0250000
NODE_10895_length_832_cov_14.811733	353	433	5	8	80	0.1000000
NODE_10895_length_832_cov_14.811733	353	433	6	1	80	0.0125000
NODE_10895_length_832_cov_14.811733	353	433	7	4	80	0.0500000
NODE_10895_length_832_cov_14.811733	353	433	8	9	80	0.1125000
NODE_10895_length_832_cov_14.811733	353	433	9	4	80	0.0500000
NODE_10895_length_832_cov_14.811733	353	433	10	7	80	0.0875000
NODE_10895_length_832_cov_14.811733	353	433	11	14	80	0.1750000
NODE_10895_length_832_cov_14.811733	353	433	14	7	80	0.0875000
NODE_10895_length_832_cov_14.811733	353	433	15	11	80	0.1375000
NODE_10895_length_832_cov_14.811733	353	433	16	13	80	0.1625000
NODE_10896_length_832_cov_14.770805	259	339	10	8	80	0.1000000
NODE_10896_length_832_cov_14.770805	259	339	13	5	80	0.0625000
NODE_10896_length_832_cov_14.770805	259	339	14	63	80	0.7875000
NODE_10896_length_832_cov_14.770805	259	339	15	4	80	0.0500000
NODE_10896_length_832_cov_14.770805	312	392	6	5	80	0.0625000
NODE_10896_length_832_cov_14.770805	312	392	8	31	80	0.3875000
NODE_10896_length_832_cov_14.770805	312	392	10	3	80	0.0375000
NODE_10896_length_832_cov_14.770805	312	392	11	12	80	0.1500000
NODE_10896_length_832_cov_14.770805	312	392	12	1	80	0.0125000
NODE_10896_length_832_cov_14.770805	312	392	14	28	80	0.3500000
NODE_10897_length_832_cov_8.305593	266	346	4	67	80	0.8375000
NODE_10897_length_832_cov_8.305593	266	346	7	13	80	0.1625000
NODE_10897_length_832_cov_8.305593	319	399	4	67	80	0.8375000
NODE_10897_length_832_cov_8.305593	319	399	5	13	80	0.1625000
NODE_10918_length_831_cov_18.403005	371	451	5	7	80	0.0875000
NODE_10918_length_831_cov_18.403005	371	451	6	37	80	0.4625000
NODE_10918_length_831_cov_18.403005	371	451	7	26	80	0.3250000
NODE_10918_length_831_cov_18.403005	371	451	8	7	80	0.0875000
NODE_10918_length_831_cov_18.403005	371	451	9	3	80	0.0375000
NODE_10918_length_831_cov_18.403005	424	504	3	4	80	0.0500000
NODE_10918_length_831_cov_18.403005	424	504	4	11	80	0.1375000
NODE_10918_length_831_cov_18.403005	424	504	5	18	80	0.2250000
NODE_10918_length_831_cov_18.403005	424	504	6	27	80	0.3375000
NODE_10918_length_831_cov_18.403005	424	504	7	20	80	0.2500000
NODE_10919_length_831_cov_16.017760	357	437	3	79	80	0.9875000
NODE_10919_length_831_cov_16.017760	357	437	4	1	80	0.0125000
NODE_10919_length_831_cov_16.017760	410	490	1	13	80	0.1625000
NODE_10919_length_831_cov_16.017760	410	490	2	6	80	0.0750000
NODE_10919_length_831_cov_16.017760	410	490	3	61	80	0.7625000
NODE_10920_length_831_cov_13.740437	405	485	3	13	80	0.1625000
NODE_10920_length_831_cov_13.740437	405	485	8	2	80	0.0250000
NODE_10920_length_831_cov_13.740437	405	485	9	65	80	0.8125000
NODE_10920_length_831_cov_13.740437	458	538	9	41	80	0.5125000
NODE_10920_length_831_cov_13.740437	458	538	10	15	80	0.1875000
NODE_10920_length_831_cov_13.740437	458	538	16	6	80	0.0750000
NODE_10920_length_831_cov_13.740437	458	538	17	7	80	0.0875000
NODE_10920_length_831_cov_13.740437	458	538	18	11	80	0.1375000
NODE_10921_length_831_cov_9.595628	281	361	5	4	80	0.0500000
NODE_10921_length_831_cov_9.595628	281	361	6	46	80	0.5750000
NODE_10921_length_831_cov_9.595628	281	361	7	30	80	0.3750000
NODE_10921_length_831_cov_9.595628	334	414	1	1	80	0.0125000
NODE_10921_length_831_cov_9.595628	334	414	3	9	80	0.1125000
NODE_10921_length_831_cov_9.595628	334	414	4	29	80	0.3625000
NODE_10921_length_831_cov_9.595628	334	414	6	41	80	0.5125000
NODE_10922_length_831_cov_8.199454	433	482	1	15	49	0.3061225
NODE_10922_length_831_cov_8.199454	433	482	2	34	49	0.6938776
NODE_10923_length_831_cov_7.607923	216	296	0	80	80	1.0000000
NODE_10923_length_831_cov_7.607923	269	349	0	80	80	1.0000000
NODE_10924_length_831_cov_6.454918	334	409	0	75	75	1.0000000
NODE_10924_length_831_cov_6.454918	382	462	0	80	80	1.0000000
NODE_10960_length_830_cov_40.856361	238	318	3	6	80	0.0750000
NODE_10960_length_830_cov_40.856361	238	318	4	74	80	0.9250000
NODE_10960_length_830_cov_40.856361	291	371	0	31	80	0.3875000
NODE_10960_length_830_cov_40.856361	291	371	1	6	80	0.0750000
NODE_10960_length_830_cov_40.856361	291	371	2	12	80	0.1500000
NODE_10960_length_830_cov_40.856361	291	371	3	10	80	0.1250000
NODE_10960_length_830_cov_40.856361	291	371	4	21	80	0.2625000
NODE_10961_length_830_cov_32.170999	302	378	15	48	76	0.6315789
NODE_10961_length_830_cov_32.170999	302	378	16	28	76	0.3684210
NODE_10961_length_830_cov_32.170999	303	383	15	47	80	0.5875000
NODE_10961_length_830_cov_32.170999	303	383	16	33	80	0.4125000
NODE_10961_length_830_cov_32.170999	356	436	4	1	80	0.0125000
NODE_10961_length_830_cov_32.170999	356	436	6	18	80	0.2250000
NODE_10961_length_830_cov_32.170999	356	436	9	8	80	0.1000000
NODE_10961_length_830_cov_32.170999	356	436	16	27	80	0.3375000
NODE_10961_length_830_cov_32.170999	356	436	17	24	80	0.3000000
NODE_10961_length_830_cov_32.170999	356	436	18	2	80	0.0250000
NODE_10962_length_830_cov_28.041040	393	473	4	10	80	0.1250000
NODE_10962_length_830_cov_28.041040	393	473	9	70	80	0.8750000
NODE_10962_length_830_cov_28.041040	446	526	5	30	80	0.3750000
NODE_10962_length_830_cov_28.041040	446	526	6	4	80	0.0500000
NODE_10962_length_830_cov_28.041040	446	526	8	14	80	0.1750000
NODE_10962_length_830_cov_28.041040	446	526	9	32	80	0.4000000
NODE_10963_length_830_cov_20.280438	360	440	1	10	80	0.1250000
NODE_10963_length_830_cov_20.280438	360	440	2	10	80	0.1250000
NODE_10963_length_830_cov_20.280438	360	440	3	3	80	0.0375000
NODE_10963_length_830_cov_20.280438	360	440	4	41	80	0.5125000
NODE_10963_length_830_cov_20.280438	360	440	5	16	80	0.2000000
NODE_10963_length_830_cov_20.280438	413	492	4	61	79	0.7721519
NODE_10963_length_830_cov_20.280438	413	492	5	18	79	0.2278481
NODE_10964_length_830_cov_19.495212	274	354	1	5	80	0.0625000
NODE_10964_length_830_cov_19.495212	274	354	2	75	80	0.9375000
NODE_10964_length_830_cov_19.495212	327	407	1	58	80	0.7250000
NODE_10964_length_830_cov_19.495212	327	407	2	22	80	0.2750000
NODE_10965_length_830_cov_18.522572	368	448	3	1	80	0.0125000
NODE_10965_length_830_cov_18.522572	368	448	4	8	80	0.1000000
NODE_10965_length_830_cov_18.522572	368	448	6	26	80	0.3250000
NODE_10965_length_830_cov_18.522572	368	448	7	45	80	0.5625000
NODE_10965_length_830_cov_18.522572	421	501	6	37	80	0.4625000
NODE_10965_length_830_cov_18.522572	421	501	7	43	80	0.5375000
NODE_10966_length_830_cov_13.830369	278	358	4	10	80	0.1250000
NODE_10966_length_830_cov_13.830369	278	358	5	6	80	0.0750000
NODE_10966_length_830_cov_13.830369	278	358	6	64	80	0.8000000
NODE_10966_length_830_cov_13.830369	331	411	4	18	80	0.2250000
NODE_10966_length_830_cov_13.830369	331	411	5	21	80	0.2625000
NODE_10966_length_830_cov_13.830369	331	411	6	41	80	0.5125000
NODE_10967_length_830_cov_12.459644	201	281	2	50	80	0.6250000
NODE_10967_length_830_cov_12.459644	201	281	3	30	80	0.3750000
NODE_10967_length_830_cov_12.459644	254	334	2	66	80	0.8250000
NODE_10967_length_830_cov_12.459644	254	334	3	14	80	0.1750000
NODE_10968_length_830_cov_8.344733	450	530	0	80	80	1.0000000
NODE_10968_length_830_cov_8.344733	503	583	0	80	80	1.0000000
NODE_10969_length_830_cov_8.227086	634	714	0	80	80	1.0000000
NODE_10969_length_830_cov_8.227086	687	767	0	80	80	1.0000000
NODE_10995_length_829_cov_74.910959	271	351	11	80	80	1.0000000
NODE_10995_length_829_cov_74.910959	324	404	0	11	80	0.1375000
NODE_10995_length_829_cov_74.910959	324	404	1	4	80	0.0500000
NODE_10995_length_829_cov_74.910959	324	404	2	10	80	0.1250000
NODE_10995_length_829_cov_74.910959	324	404	11	55	80	0.6875000
NODE_10996_length_829_cov_34.068493	302	382	5	7	80	0.0875000
NODE_10996_length_829_cov_34.068493	302	382	6	1	80	0.0125000
NODE_10996_length_829_cov_34.068493	302	382	7	10	80	0.1250000
NODE_10996_length_829_cov_34.068493	302	382	8	11	80	0.1375000
NODE_10996_length_829_cov_34.068493	302	382	9	40	80	0.5000000
NODE_10996_length_829_cov_34.068493	302	382	10	4	80	0.0500000
NODE_10996_length_829_cov_34.068493	302	382	11	7	80	0.0875000
NODE_10996_length_829_cov_34.068493	355	435	8	8	80	0.1000000
NODE_10996_length_829_cov_34.068493	355	435	9	72	80	0.9000000
NODE_10997_length_829_cov_24.027397	441	521	5	51	80	0.6375000
NODE_10997_length_829_cov_24.027397	441	521	6	25	80	0.3125000
NODE_10997_length_829_cov_24.027397	441	521	7	4	80	0.0500000
NODE_10997_length_829_cov_24.027397	494	574	5	2	80	0.0250000
NODE_10997_length_829_cov_24.027397	494	574	6	24	80	0.3000000
NODE_10997_length_829_cov_24.027397	494	574	7	54	80	0.6750000
NODE_10998_length_829_cov_21.735616	420	500	4	80	80	1.0000000
NODE_10998_length_829_cov_21.735616	473	553	0	6	80	0.0750000
NODE_10998_length_829_cov_21.735616	473	553	2	47	80	0.5875000
NODE_10998_length_829_cov_21.735616	473	553	4	27	80	0.3375000
NODE_10999_length_829_cov_18.446575	407	487	0	40	80	0.5000000
NODE_10999_length_829_cov_18.446575	407	487	1	40	80	0.5000000
NODE_10999_length_829_cov_18.446575	460	540	1	31	80	0.3875000
NODE_10999_length_829_cov_18.446575	460	540	2	49	80	0.6125000
NODE_11000_length_829_cov_10.971233	368	448	9	23	80	0.2875000
NODE_11000_length_829_cov_10.971233	368	448	11	3	80	0.0375000
NODE_11000_length_829_cov_10.971233	368	448	13	34	80	0.4250000
NODE_11000_length_829_cov_10.971233	368	448	15	20	80	0.2500000
NODE_11000_length_829_cov_10.971233	421	501	6	3	80	0.0375000
NODE_11000_length_829_cov_10.971233	421	501	7	36	80	0.4500000
NODE_11000_length_829_cov_10.971233	421	501	8	1	80	0.0125000
NODE_11000_length_829_cov_10.971233	421	501	9	4	80	0.0500000
NODE_11000_length_829_cov_10.971233	421	501	11	6	80	0.0750000
NODE_11000_length_829_cov_10.971233	421	501	13	16	80	0.2000000
NODE_11000_length_829_cov_10.971233	421	501	15	14	80	0.1750000
NODE_11001_length_829_cov_10.035616	387	467	0	80	80	1.0000000
NODE_11001_length_829_cov_10.035616	440	520	0	80	80	1.0000000
NODE_11002_length_829_cov_9.906849	326	406	0	80	80	1.0000000
NODE_11002_length_829_cov_9.906849	379	459	0	80	80	1.0000000
NODE_11003_length_829_cov_8.809589	450	530	0	80	80	1.0000000
NODE_11003_length_829_cov_8.809589	503	583	0	80	80	1.0000000
NODE_11006_length_829_cov_4.310959	473	553	0	80	80	1.0000000
NODE_11006_length_829_cov_4.310959	526	606	0	80	80	1.0000000
NODE_11008_length_829_cov_3.079452	507	587	1	63	80	0.7875000
NODE_11008_length_829_cov_3.079452	507	587	2	17	80	0.2125000
NODE_11008_length_829_cov_3.079452	507	587	1	63	80	0.7875000
NODE_11008_length_829_cov_3.079452	507	587	2	17	80	0.2125000
NODE_11008_length_829_cov_3.079452	560	640	1	63	80	0.7875000
NODE_11008_length_829_cov_3.079452	560	640	2	17	80	0.2125000
NODE_11025_length_828_cov_41.116598	436	516	5	4	80	0.0500000
NODE_11025_length_828_cov_41.116598	436	516	6	1	80	0.0125000
NODE_11025_length_828_cov_41.116598	436	516	7	2	80	0.0250000
NODE_11025_length_828_cov_41.116598	436	516	8	35	80	0.4375000
NODE_11025_length_828_cov_41.116598	436	516	9	26	80	0.3250000
NODE_11025_length_828_cov_41.116598	436	516	10	12	80	0.1500000
NODE_11025_length_828_cov_41.116598	489	569	7	5	80	0.0625000
NODE_11025_length_828_cov_41.116598	489	569	8	18	80	0.2250000
NODE_11025_length_828_cov_41.116598	489	569	9	46	80	0.5750000
NODE_11025_length_828_cov_41.116598	489	569	10	11	80	0.1375000
NODE_11026_length_828_cov_36.459534	372	452	4	13	80	0.1625000
NODE_11026_length_828_cov_36.459534	372	452	6	5	80	0.0625000
NODE_11026_length_828_cov_36.459534	372	452	10	5	80	0.0625000
NODE_11026_length_828_cov_36.459534	372	452	11	8	80	0.1000000
NODE_11026_length_828_cov_36.459534	372	452	12	24	80	0.3000000
NODE_11026_length_828_cov_36.459534	372	452	13	17	80	0.2125000
NODE_11026_length_828_cov_36.459534	372	452	14	8	80	0.1000000
NODE_11026_length_828_cov_36.459534	425	505	12	2	80	0.0250000
NODE_11026_length_828_cov_36.459534	425	505	13	17	80	0.2125000
NODE_11026_length_828_cov_36.459534	425	505	14	55	80	0.6875000
NODE_11026_length_828_cov_36.459534	425	505	15	5	80	0.0625000
NODE_11026_length_828_cov_36.459534	425	505	16	1	80	0.0125000
NODE_11027_length_828_cov_33.515775	443	523	0	33	80	0.4125000
NODE_11027_length_828_cov_33.515775	443	523	2	4	80	0.0500000
NODE_11027_length_828_cov_33.515775	443	523	3	40	80	0.5000000
NODE_11027_length_828_cov_33.515775	443	523	4	3	80	0.0375000
NODE_11027_length_828_cov_33.515775	496	576	3	24	80	0.3000000
NODE_11027_length_828_cov_33.515775	496	576	4	56	80	0.7000000
NODE_11028_length_828_cov_21.123457	380	460	6	6	80	0.0750000
NODE_11028_length_828_cov_21.123457	380	460	7	2	80	0.0250000
NODE_11028_length_828_cov_21.123457	380	460	8	9	80	0.1125000
NODE_11028_length_828_cov_21.123457	380	460	9	17	80	0.2125000
NODE_11028_length_828_cov_21.123457	380	460	10	33	80	0.4125000
NODE_11028_length_828_cov_21.123457	380	460	11	13	80	0.1625000
NODE_11028_length_828_cov_21.123457	433	513	8	22	80	0.2750000
NODE_11028_length_828_cov_21.123457	433	513	9	5	80	0.0625000
NODE_11028_length_828_cov_21.123457	433	513	10	52	80	0.6500000
NODE_11028_length_828_cov_21.123457	433	513	11	1	80	0.0125000
NODE_11029_length_828_cov_17.406036	304	392	14	9	88	0.1022727
NODE_11029_length_828_cov_17.406036	304	392	15	35	88	0.3977273
NODE_11029_length_828_cov_17.406036	304	392	16	10	88	0.1136364
NODE_11029_length_828_cov_17.406036	304	392	17	18	88	0.2045455
NODE_11029_length_828_cov_17.406036	304	392	19	5	88	0.0568182
NODE_11029_length_828_cov_17.406036	304	392	21	11	88	0.1250000
NODE_11029_length_828_cov_17.406036	369	445	14	28	76	0.3684210
NODE_11029_length_828_cov_17.406036	369	445	15	6	76	0.0789474
NODE_11029_length_828_cov_17.406036	369	445	16	9	76	0.1184211
NODE_11029_length_828_cov_17.406036	369	445	17	2	76	0.0263158
NODE_11029_length_828_cov_17.406036	369	445	18	7	76	0.0921053
NODE_11029_length_828_cov_17.406036	369	445	19	2	76	0.0263158
NODE_11029_length_828_cov_17.406036	369	445	20	10	76	0.1315790
NODE_11029_length_828_cov_17.406036	369	445	21	12	76	0.1578947
NODE_11030_length_828_cov_14.606310	287	367	0	11	80	0.1375000
NODE_11030_length_828_cov_14.606310	287	367	1	13	80	0.1625000
NODE_11030_length_828_cov_14.606310	287	367	3	1	80	0.0125000
NODE_11030_length_828_cov_14.606310	287	367	6	55	80	0.6875000
NODE_11030_length_828_cov_14.606310	340	420	6	31	80	0.3875000
NODE_11030_length_828_cov_14.606310	340	420	8	49	80	0.6125000
NODE_11031_length_828_cov_14.493827	326	406	0	80	80	1.0000000
NODE_11031_length_828_cov_14.493827	379	459	0	80	80	1.0000000
NODE_11031_length_828_cov_14.493827	455	535	0	80	80	1.0000000
NODE_11031_length_828_cov_14.493827	508	588	0	80	80	1.0000000
NODE_11032_length_828_cov_10.550069	280	360	0	10	80	0.1250000
NODE_11032_length_828_cov_10.550069	280	360	1	65	80	0.8125000
NODE_11032_length_828_cov_10.550069	280	360	2	5	80	0.0625000
NODE_11032_length_828_cov_10.550069	333	413	1	22	80	0.2750000
NODE_11032_length_828_cov_10.550069	333	413	2	58	80	0.7250000
NODE_11033_length_828_cov_9.292181	594	674	0	80	80	1.0000000
NODE_11033_length_828_cov_9.292181	647	727	0	80	80	1.0000000
NODE_11034_length_828_cov_8.747599	298	378	14	12	80	0.1500000
NODE_11034_length_828_cov_8.747599	298	378	16	36	80	0.4500000
NODE_11034_length_828_cov_8.747599	298	378	17	1	80	0.0125000
NODE_11034_length_828_cov_8.747599	298	378	18	2	80	0.0250000
NODE_11034_length_828_cov_8.747599	298	378	19	1	80	0.0125000
NODE_11034_length_828_cov_8.747599	298	378	20	28	80	0.3500000
NODE_11034_length_828_cov_8.747599	351	431	11	33	80	0.4125000
NODE_11034_length_828_cov_8.747599	351	431	12	1	80	0.0125000
NODE_11034_length_828_cov_8.747599	351	431	14	13	80	0.1625000
NODE_11034_length_828_cov_8.747599	351	431	15	2	80	0.0250000
NODE_11034_length_828_cov_8.747599	351	431	17	5	80	0.0625000
NODE_11034_length_828_cov_8.747599	351	431	19	1	80	0.0125000
NODE_11034_length_828_cov_8.747599	351	431	20	25	80	0.3125000
NODE_11035_length_828_cov_8.098765	199	279	0	80	80	1.0000000
NODE_11035_length_828_cov_8.098765	252	332	0	29	80	0.3625000
NODE_11035_length_828_cov_8.098765	252	332	1	51	80	0.6375000
NODE_11037_length_828_cov_7.473251	300	380	1	5	80	0.0625000
NODE_11037_length_828_cov_7.473251	300	380	2	75	80	0.9375000
NODE_11037_length_828_cov_7.473251	353	433	1	58	80	0.7250000
NODE_11037_length_828_cov_7.473251	353	433	2	22	80	0.2750000
NODE_11039_length_828_cov_5.481481	543	623	0	80	80	1.0000000
NODE_11039_length_828_cov_5.481481	596	676	0	80	80	1.0000000
NODE_11041_length_828_cov_5.069959	259	339	0	7	80	0.0875000
NODE_11041_length_828_cov_5.069959	259	339	1	73	80	0.9125000
NODE_11066_length_827_cov_34.567308	269	349	6	40	80	0.5000000
NODE_11066_length_827_cov_34.567308	269	349	7	10	80	0.1250000
NODE_11066_length_827_cov_34.567308	269	349	8	21	80	0.2625000
NODE_11066_length_827_cov_34.567308	269	349	10	9	80	0.1125000
NODE_11066_length_827_cov_34.567308	322	402	8	37	80	0.4625000
NODE_11066_length_827_cov_34.567308	322	402	10	43	80	0.5375000
NODE_11066_length_827_cov_34.567308	398	478	2	9	80	0.1125000
NODE_11066_length_827_cov_34.567308	398	478	3	10	80	0.1250000
NODE_11066_length_827_cov_34.567308	398	478	4	23	80	0.2875000
NODE_11066_length_827_cov_34.567308	398	478	6	32	80	0.4000000
NODE_11066_length_827_cov_34.567308	398	478	8	6	80	0.0750000
NODE_11066_length_827_cov_34.567308	451	531	0	20	80	0.2500000
NODE_11066_length_827_cov_34.567308	451	531	2	42	80	0.5250000
NODE_11066_length_827_cov_34.567308	451	531	3	10	80	0.1250000
NODE_11066_length_827_cov_34.567308	451	531	4	8	80	0.1000000
NODE_11067_length_827_cov_31.538462	320	400	6	16	80	0.2000000
NODE_11067_length_827_cov_31.538462	320	400	7	10	80	0.1250000
NODE_11067_length_827_cov_31.538462	320	400	8	17	80	0.2125000
NODE_11067_length_827_cov_31.538462	320	400	9	8	80	0.1000000
NODE_11067_length_827_cov_31.538462	320	400	10	21	80	0.2625000
NODE_11067_length_827_cov_31.538462	320	400	11	8	80	0.1000000
NODE_11067_length_827_cov_31.538462	373	453	9	8	80	0.1000000
NODE_11067_length_827_cov_31.538462	373	453	10	19	80	0.2375000
NODE_11067_length_827_cov_31.538462	373	453	11	38	80	0.4750000
NODE_11067_length_827_cov_31.538462	373	453	12	10	80	0.1250000
NODE_11067_length_827_cov_31.538462	373	453	13	5	80	0.0625000
NODE_11068_length_827_cov_19.548077	464	544	3	19	80	0.2375000
NODE_11068_length_827_cov_19.548077	464	544	4	32	80	0.4000000
NODE_11068_length_827_cov_19.548077	464	544	5	2	80	0.0250000
NODE_11068_length_827_cov_19.548077	464	544	6	27	80	0.3375000
NODE_11068_length_827_cov_19.548077	517	597	4	22	80	0.2750000
NODE_11068_length_827_cov_19.548077	517	597	6	58	80	0.7250000
NODE_11069_length_827_cov_17.490385	320	400	3	27	80	0.3375000
NODE_11069_length_827_cov_17.490385	320	400	4	19	80	0.2375000
NODE_11069_length_827_cov_17.490385	320	400	6	2	80	0.0250000
NODE_11069_length_827_cov_17.490385	320	400	8	32	80	0.4000000
NODE_11069_length_827_cov_17.490385	373	453	7	36	80	0.4500000
NODE_11069_length_827_cov_17.490385	373	453	8	44	80	0.5500000
NODE_11070_length_827_cov_15.247253	205	285	5	20	80	0.2500000
NODE_11070_length_827_cov_15.247253	205	285	6	60	80	0.7500000
NODE_11070_length_827_cov_15.247253	258	338	6	71	80	0.8875000
NODE_11070_length_827_cov_15.247253	258	338	7	9	80	0.1125000
NODE_11071_length_827_cov_14.151099	372	452	8	25	80	0.3125000
NODE_11071_length_827_cov_14.151099	372	452	10	10	80	0.1250000
NODE_11071_length_827_cov_14.151099	372	452	11	13	80	0.1625000
NODE_11071_length_827_cov_14.151099	372	452	12	1	80	0.0125000
NODE_11071_length_827_cov_14.151099	372	452	13	12	80	0.1500000
NODE_11071_length_827_cov_14.151099	372	452	14	19	80	0.2375000
NODE_11071_length_827_cov_14.151099	425	505	8	38	80	0.4750000
NODE_11071_length_827_cov_14.151099	425	505	10	25	80	0.3125000
NODE_11071_length_827_cov_14.151099	425	505	11	4	80	0.0500000
NODE_11071_length_827_cov_14.151099	425	505	12	1	80	0.0125000
NODE_11071_length_827_cov_14.151099	425	505	13	12	80	0.1500000
NODE_11072_length_827_cov_12.157967	262	342	0	80	80	1.0000000
NODE_11072_length_827_cov_12.157967	315	395	0	80	80	1.0000000
NODE_11073_length_827_cov_11.777473	316	396	0	22	80	0.2750000
NODE_11073_length_827_cov_11.777473	316	396	2	58	80	0.7250000
NODE_11073_length_827_cov_11.777473	369	449	2	80	80	1.0000000
NODE_11074_length_827_cov_11.651099	393	473	6	6	80	0.0750000
NODE_11074_length_827_cov_11.651099	393	473	7	19	80	0.2375000
NODE_11074_length_827_cov_11.651099	393	473	8	43	80	0.5375000
NODE_11074_length_827_cov_11.651099	393	473	9	12	80	0.1500000
NODE_11074_length_827_cov_11.651099	446	526	4	46	80	0.5750000
NODE_11074_length_827_cov_11.651099	446	526	6	6	80	0.0750000
NODE_11074_length_827_cov_11.651099	446	526	7	18	80	0.2250000
NODE_11074_length_827_cov_11.651099	446	526	8	10	80	0.1250000
NODE_11075_length_827_cov_10.711538	286	366	1	22	80	0.2750000
NODE_11075_length_827_cov_10.711538	286	366	2	27	80	0.3375000
NODE_11075_length_827_cov_10.711538	286	366	3	21	80	0.2625000
NODE_11075_length_827_cov_10.711538	286	366	4	10	80	0.1250000
NODE_11075_length_827_cov_10.711538	339	419	3	74	80	0.9250000
NODE_11075_length_827_cov_10.711538	339	419	4	6	80	0.0750000
NODE_11076_length_827_cov_10.262363	273	353	7	1	80	0.0125000
NODE_11076_length_827_cov_10.262363	273	353	9	2	80	0.0250000
NODE_11076_length_827_cov_10.262363	273	353	11	32	80	0.4000000
NODE_11076_length_827_cov_10.262363	273	353	12	4	80	0.0500000
NODE_11076_length_827_cov_10.262363	273	353	14	18	80	0.2250000
NODE_11076_length_827_cov_10.262363	273	353	15	14	80	0.1750000
NODE_11076_length_827_cov_10.262363	273	353	16	4	80	0.0500000
NODE_11076_length_827_cov_10.262363	273	353	17	5	80	0.0625000
NODE_11076_length_827_cov_10.262363	326	406	14	4	80	0.0500000
NODE_11076_length_827_cov_10.262363	326	406	15	14	80	0.1750000
NODE_11076_length_827_cov_10.262363	326	406	16	39	80	0.4875000
NODE_11076_length_827_cov_10.262363	326	406	17	16	80	0.2000000
NODE_11076_length_827_cov_10.262363	326	406	18	7	80	0.0875000
NODE_11077_length_827_cov_10.221154	256	336	2	76	80	0.9500000
NODE_11077_length_827_cov_10.221154	256	336	3	4	80	0.0500000
NODE_11078_length_827_cov_9.576923	359	439	0	80	80	1.0000000
NODE_11078_length_827_cov_9.576923	412	492	0	80	80	1.0000000
NODE_11079_length_827_cov_8.780220	361	441	2	42	80	0.5250000
NODE_11079_length_827_cov_8.780220	361	441	4	27	80	0.3375000
NODE_11079_length_827_cov_8.780220	361	441	5	11	80	0.1375000
NODE_11079_length_827_cov_8.780220	414	494	4	16	80	0.2000000
NODE_11079_length_827_cov_8.780220	414	494	5	64	80	0.8000000
NODE_11093_length_827_cov_1.412088	736	784	0	48	48	1.0000000
NODE_11106_length_826_cov_34.026135	211	291	4	22	80	0.2750000
NODE_11106_length_826_cov_34.026135	211	291	7	33	80	0.4125000
NODE_11106_length_826_cov_34.026135	211	291	8	25	80	0.3125000
NODE_11106_length_826_cov_34.026135	264	344	6	39	80	0.4875000
NODE_11106_length_826_cov_34.026135	264	344	7	10	80	0.1250000
NODE_11106_length_826_cov_34.026135	264	344	8	31	80	0.3875000
NODE_11107_length_826_cov_24.093535	282	362	8	2	80	0.0250000
NODE_11107_length_826_cov_24.093535	282	362	9	2	80	0.0250000
NODE_11107_length_826_cov_24.093535	282	362	10	42	80	0.5250000
NODE_11107_length_826_cov_24.093535	282	362	11	2	80	0.0250000
NODE_11107_length_826_cov_24.093535	282	362	12	3	80	0.0375000
NODE_11107_length_826_cov_24.093535	282	362	13	22	80	0.2750000
NODE_11107_length_826_cov_24.093535	282	362	14	7	80	0.0875000
NODE_11107_length_826_cov_24.093535	335	415	10	26	80	0.3250000
NODE_11107_length_826_cov_24.093535	335	415	11	2	80	0.0250000
NODE_11107_length_826_cov_24.093535	335	415	12	1	80	0.0125000
NODE_11107_length_826_cov_24.093535	335	415	13	18	80	0.2250000
NODE_11107_length_826_cov_24.093535	335	415	14	33	80	0.4125000
NODE_11108_length_826_cov_20.943604	207	287	6	10	80	0.1250000
NODE_11108_length_826_cov_20.943604	207	287	7	23	80	0.2875000
NODE_11108_length_826_cov_20.943604	207	287	8	31	80	0.3875000
NODE_11108_length_826_cov_20.943604	207	287	9	16	80	0.2000000
NODE_11108_length_826_cov_20.943604	260	340	6	6	80	0.0750000
NODE_11108_length_826_cov_20.943604	260	340	7	17	80	0.2125000
NODE_11108_length_826_cov_20.943604	260	340	8	25	80	0.3125000
NODE_11108_length_826_cov_20.943604	260	340	9	32	80	0.4000000
NODE_11109_length_826_cov_20.437414	413	493	2	2	80	0.0250000
NODE_11109_length_826_cov_20.437414	413	493	3	40	80	0.5000000
NODE_11109_length_826_cov_20.437414	413	493	5	38	80	0.4750000
NODE_11109_length_826_cov_20.437414	466	546	4	1	80	0.0125000
NODE_11109_length_826_cov_20.437414	466	546	5	44	80	0.5500000
NODE_11109_length_826_cov_20.437414	466	546	6	35	80	0.4375000
NODE_11110_length_826_cov_20.200825	432	512	15	14	80	0.1750000
NODE_11110_length_826_cov_20.200825	432	512	16	24	80	0.3000000
NODE_11110_length_826_cov_20.200825	432	512	17	26	80	0.3250000
NODE_11110_length_826_cov_20.200825	432	512	18	8	80	0.1000000
NODE_11110_length_826_cov_20.200825	432	512	19	8	80	0.1000000
NODE_11110_length_826_cov_20.200825	485	565	10	18	80	0.2250000
NODE_11110_length_826_cov_20.200825	485	565	12	6	80	0.0750000
NODE_11110_length_826_cov_20.200825	485	565	15	16	80	0.2000000
NODE_11110_length_826_cov_20.200825	485	565	16	40	80	0.5000000
NODE_11111_length_826_cov_18.489684	345	425	2	23	80	0.2875000
NODE_11111_length_826_cov_18.489684	345	425	4	57	80	0.7125000
NODE_11111_length_826_cov_18.489684	398	478	0	22	80	0.2750000
NODE_11111_length_826_cov_18.489684	398	478	2	54	80	0.6750000
NODE_11111_length_826_cov_18.489684	398	478	4	4	80	0.0500000
NODE_11112_length_826_cov_17.998624	336	416	4	55	80	0.6875000
NODE_11112_length_826_cov_17.998624	336	416	6	25	80	0.3125000
NODE_11112_length_826_cov_17.998624	389	469	4	62	80	0.7750000
NODE_11112_length_826_cov_17.998624	389	469	6	18	80	0.2250000
NODE_11113_length_826_cov_17.038514	358	438	2	9	80	0.1125000
NODE_11113_length_826_cov_17.038514	358	438	4	71	80	0.8875000
NODE_11113_length_826_cov_17.038514	411	491	0	16	80	0.2000000
NODE_11113_length_826_cov_17.038514	411	491	2	46	80	0.5750000
NODE_11113_length_826_cov_17.038514	411	491	4	18	80	0.2250000
NODE_11114_length_826_cov_16.777166	514	603	0	89	89	1.0000000
NODE_11115_length_826_cov_16.177442	361	441	4	21	80	0.2625000
NODE_11115_length_826_cov_16.177442	361	441	5	59	80	0.7375000
NODE_11115_length_826_cov_16.177442	414	494	2	12	80	0.1500000
NODE_11115_length_826_cov_16.177442	414	494	3	2	80	0.0250000
NODE_11115_length_826_cov_16.177442	414	494	4	38	80	0.4750000
NODE_11115_length_826_cov_16.177442	414	494	5	28	80	0.3500000
NODE_11116_length_826_cov_15.134801	346	426	0	80	80	1.0000000
NODE_11116_length_826_cov_15.134801	399	479	0	80	80	1.0000000
NODE_11117_length_826_cov_9.943604	320	400	1	29	80	0.3625000
NODE_11117_length_826_cov_9.943604	320	400	2	51	80	0.6375000
NODE_11117_length_826_cov_9.943604	373	453	1	69	80	0.8625000
NODE_11117_length_826_cov_9.943604	373	453	2	11	80	0.1375000
NODE_11120_length_826_cov_4.852820	501	579	3	37	78	0.4743590
NODE_11120_length_826_cov_4.852820	501	579	4	8	78	0.1025641
NODE_11120_length_826_cov_4.852820	501	579	6	12	78	0.1538462
NODE_11120_length_826_cov_4.852820	501	579	8	21	78	0.2692308
NODE_11120_length_826_cov_4.852820	552	632	6	9	80	0.1125000
NODE_11120_length_826_cov_4.852820	552	632	8	71	80	0.8875000
NODE_11161_length_825_cov_61.804408	382	462	8	4	80	0.0500000
NODE_11161_length_825_cov_61.804408	382	462	10	6	80	0.0750000
NODE_11161_length_825_cov_61.804408	382	462	12	19	80	0.2375000
NODE_11161_length_825_cov_61.804408	382	462	13	22	80	0.2750000
NODE_11161_length_825_cov_61.804408	382	462	14	1	80	0.0125000
NODE_11161_length_825_cov_61.804408	382	462	15	6	80	0.0750000
NODE_11161_length_825_cov_61.804408	382	462	17	1	80	0.0125000
NODE_11161_length_825_cov_61.804408	382	462	18	14	80	0.1750000
NODE_11161_length_825_cov_61.804408	382	462	21	7	80	0.0875000
NODE_11161_length_825_cov_61.804408	435	514	15	6	79	0.0759494
NODE_11161_length_825_cov_61.804408	435	514	18	16	79	0.2025317
NODE_11161_length_825_cov_61.804408	435	514	20	49	79	0.6202531
NODE_11161_length_825_cov_61.804408	435	514	21	8	79	0.1012658
NODE_11162_length_825_cov_43.825069	488	568	0	5	80	0.0625000
NODE_11162_length_825_cov_43.825069	488	568	1	45	80	0.5625000
NODE_11162_length_825_cov_43.825069	488	568	2	30	80	0.3750000
NODE_11162_length_825_cov_43.825069	541	621	2	80	80	1.0000000
NODE_11162_length_825_cov_43.825069	617	697	1	30	80	0.3750000
NODE_11162_length_825_cov_43.825069	617	697	2	35	80	0.4375000
NODE_11162_length_825_cov_43.825069	617	697	3	15	80	0.1875000
NODE_11162_length_825_cov_43.825069	670	750	1	3	80	0.0375000
NODE_11162_length_825_cov_43.825069	670	750	2	62	80	0.7750000
NODE_11162_length_825_cov_43.825069	670	750	3	15	80	0.1875000
NODE_11163_length_825_cov_43.389807	496	576	13	14	80	0.1750000
NODE_11163_length_825_cov_43.389807	496	576	14	46	80	0.5750000
NODE_11163_length_825_cov_43.389807	496	576	15	20	80	0.2500000
NODE_11163_length_825_cov_43.389807	549	629	7	16	80	0.2000000
NODE_11163_length_825_cov_43.389807	549	629	9	9	80	0.1125000
NODE_11163_length_825_cov_43.389807	549	629	10	1	80	0.0125000
NODE_11163_length_825_cov_43.389807	549	629	13	7	80	0.0875000
NODE_11163_length_825_cov_43.389807	549	629	14	13	80	0.1625000
NODE_11163_length_825_cov_43.389807	549	629	15	34	80	0.4250000
NODE_11164_length_825_cov_39.603306	386	466	10	2	80	0.0250000
NODE_11164_length_825_cov_39.603306	386	466	11	13	80	0.1625000
NODE_11164_length_825_cov_39.603306	386	466	13	7	80	0.0875000
NODE_11164_length_825_cov_39.603306	386	466	15	2	80	0.0250000
NODE_11164_length_825_cov_39.603306	386	466	16	56	80	0.7000000
NODE_11164_length_825_cov_39.603306	439	519	8	51	80	0.6375000
NODE_11164_length_825_cov_39.603306	439	519	9	2	80	0.0250000
NODE_11164_length_825_cov_39.603306	439	519	10	2	80	0.0250000
NODE_11164_length_825_cov_39.603306	439	519	11	13	80	0.1625000
NODE_11164_length_825_cov_39.603306	439	519	15	2	80	0.0250000
NODE_11164_length_825_cov_39.603306	439	519	16	10	80	0.1250000
NODE_11165_length_825_cov_32.205234	354	434	3	8	80	0.1000000
NODE_11165_length_825_cov_32.205234	354	434	4	43	80	0.5375000
NODE_11165_length_825_cov_32.205234	354	434	6	29	80	0.3625000
NODE_11165_length_825_cov_32.205234	407	487	1	20	80	0.2500000
NODE_11165_length_825_cov_32.205234	407	487	2	2	80	0.0250000
NODE_11165_length_825_cov_32.205234	407	487	4	58	80	0.7250000
NODE_11166_length_825_cov_29.411846	503	583	10	21	80	0.2625000
NODE_11166_length_825_cov_29.411846	503	583	11	47	80	0.5875000
NODE_11166_length_825_cov_29.411846	503	583	12	12	80	0.1500000
NODE_11166_length_825_cov_29.411846	556	636	8	2	80	0.0250000
NODE_11166_length_825_cov_29.411846	556	636	10	30	80	0.3750000
NODE_11166_length_825_cov_29.411846	556	636	11	15	80	0.1875000
NODE_11166_length_825_cov_29.411846	556	636	12	33	80	0.4125000
NODE_11167_length_825_cov_22.428375	312	392	4	6	80	0.0750000
NODE_11167_length_825_cov_22.428375	312	392	5	22	80	0.2750000
NODE_11167_length_825_cov_22.428375	312	392	6	35	80	0.4375000
NODE_11167_length_825_cov_22.428375	312	392	7	6	80	0.0750000
NODE_11167_length_825_cov_22.428375	312	392	8	9	80	0.1125000
NODE_11167_length_825_cov_22.428375	312	392	9	2	80	0.0250000
NODE_11167_length_825_cov_22.428375	365	445	6	10	80	0.1250000
NODE_11167_length_825_cov_22.428375	365	445	7	59	80	0.7375000
NODE_11167_length_825_cov_22.428375	365	445	8	9	80	0.1125000
NODE_11167_length_825_cov_22.428375	365	445	9	2	80	0.0250000
NODE_11167_length_825_cov_22.428375	441	521	5	3	80	0.0375000
NODE_11167_length_825_cov_22.428375	441	521	6	33	80	0.4125000
NODE_11167_length_825_cov_22.428375	441	521	7	30	80	0.3750000
NODE_11167_length_825_cov_22.428375	441	521	8	14	80	0.1750000
NODE_11167_length_825_cov_22.428375	494	574	1	40	80	0.5000000
NODE_11167_length_825_cov_22.428375	494	574	2	7	80	0.0875000
NODE_11167_length_825_cov_22.428375	494	574	4	2	80	0.0250000
NODE_11167_length_825_cov_22.428375	494	574	6	31	80	0.3875000
NODE_11168_length_825_cov_19.964187	249	329	2	42	80	0.5250000
NODE_11168_length_825_cov_19.964187	249	329	3	6	80	0.0750000
NODE_11168_length_825_cov_19.964187	249	329	4	32	80	0.4000000
NODE_11168_length_825_cov_19.964187	302	382	0	25	80	0.3125000
NODE_11168_length_825_cov_19.964187	302	382	1	16	80	0.2000000
NODE_11168_length_825_cov_19.964187	302	382	2	39	80	0.4875000
NODE_11169_length_825_cov_13.790634	273	353	2	36	80	0.4500000
NODE_11169_length_825_cov_13.790634	273	353	3	20	80	0.2500000
NODE_11169_length_825_cov_13.790634	273	353	4	24	80	0.3000000
NODE_11169_length_825_cov_13.790634	326	406	2	26	80	0.3250000
NODE_11169_length_825_cov_13.790634	326	406	3	47	80	0.5875000
NODE_11169_length_825_cov_13.790634	326	406	4	7	80	0.0875000
NODE_11170_length_825_cov_11.834711	331	411	3	12	80	0.1500000
NODE_11170_length_825_cov_11.834711	331	411	6	30	80	0.3750000
NODE_11170_length_825_cov_11.834711	331	411	7	13	80	0.1625000
NODE_11170_length_825_cov_11.834711	331	411	8	25	80	0.3125000
NODE_11170_length_825_cov_11.834711	384	464	3	30	80	0.3750000
NODE_11170_length_825_cov_11.834711	384	464	4	31	80	0.3875000
NODE_11170_length_825_cov_11.834711	384	464	5	4	80	0.0500000
NODE_11170_length_825_cov_11.834711	384	464	7	13	80	0.1625000
NODE_11170_length_825_cov_11.834711	384	464	8	2	80	0.0250000
NODE_11171_length_825_cov_11.477961	392	472	0	80	80	1.0000000
NODE_11172_length_825_cov_8.947658	259	339	0	35	80	0.4375000
NODE_11172_length_825_cov_8.947658	259	339	1	1	80	0.0125000
NODE_11172_length_825_cov_8.947658	259	339	2	44	80	0.5500000
NODE_11172_length_825_cov_8.947658	312	392	2	80	80	1.0000000
NODE_11173_length_825_cov_7.811295	379	459	0	36	80	0.4500000
NODE_11173_length_825_cov_7.811295	379	459	1	44	80	0.5500000
NODE_11173_length_825_cov_7.811295	432	512	1	28	80	0.3500000
NODE_11173_length_825_cov_7.811295	432	512	2	8	80	0.1000000
NODE_11173_length_825_cov_7.811295	432	512	3	44	80	0.5500000
NODE_11174_length_825_cov_7.104683	464	544	5	12	80	0.1500000
NODE_11174_length_825_cov_7.104683	464	544	6	2	80	0.0250000
NODE_11174_length_825_cov_7.104683	464	544	7	18	80	0.2250000
NODE_11174_length_825_cov_7.104683	464	544	8	43	80	0.5375000
NODE_11174_length_825_cov_7.104683	464	544	9	5	80	0.0625000
NODE_11174_length_825_cov_7.104683	517	597	6	21	80	0.2625000
NODE_11174_length_825_cov_7.104683	517	597	7	24	80	0.3000000
NODE_11174_length_825_cov_7.104683	517	597	8	25	80	0.3125000
NODE_11174_length_825_cov_7.104683	517	597	9	10	80	0.1250000
NODE_11176_length_825_cov_6.252066	542	622	4	19	80	0.2375000
NODE_11176_length_825_cov_6.252066	542	622	5	61	80	0.7625000
NODE_11176_length_825_cov_6.252066	595	675	3	5	80	0.0625000
NODE_11176_length_825_cov_6.252066	595	675	5	75	80	0.9375000
NODE_11178_length_825_cov_5.230028	264	344	0	80	80	1.0000000
NODE_11178_length_825_cov_5.230028	317	372	0	52	55	0.9454545
NODE_11178_length_825_cov_5.230028	317	372	1	3	55	0.0545455
NODE_11178_length_825_cov_5.230028	383	463	1	17	80	0.2125000
NODE_11178_length_825_cov_5.230028	383	463	2	57	80	0.7125000
NODE_11178_length_825_cov_5.230028	383	463	3	6	80	0.0750000
NODE_11178_length_825_cov_5.230028	436	516	2	21	80	0.2625000
NODE_11178_length_825_cov_5.230028	436	516	3	19	80	0.2375000
NODE_11178_length_825_cov_5.230028	436	516	5	38	80	0.4750000
NODE_11178_length_825_cov_5.230028	436	516	6	2	80	0.0250000
NODE_11205_length_825_cov_0.765840	0	50	0	50	50	1.0000000
NODE_11207_length_824_cov_27.074483	337	412	3	17	75	0.2266667
NODE_11207_length_824_cov_27.074483	337	412	5	11	75	0.1466667
NODE_11207_length_824_cov_27.074483	337	412	6	7	75	0.0933333
NODE_11207_length_824_cov_27.074483	337	412	7	39	75	0.5200000
NODE_11207_length_824_cov_27.074483	337	412	8	1	75	0.0133333
NODE_11207_length_824_cov_27.074483	390	470	6	39	80	0.4875000
NODE_11207_length_824_cov_27.074483	390	470	7	21	80	0.2625000
NODE_11207_length_824_cov_27.074483	390	470	8	20	80	0.2500000
NODE_11208_length_824_cov_23.936552	365	445	5	13	80	0.1625000
NODE_11208_length_824_cov_23.936552	365	445	6	1	80	0.0125000
NODE_11208_length_824_cov_23.936552	365	445	7	2	80	0.0250000
NODE_11208_length_824_cov_23.936552	365	445	8	64	80	0.8000000
NODE_11208_length_824_cov_23.936552	418	493	5	8	75	0.1066667
NODE_11208_length_824_cov_23.936552	418	493	6	1	75	0.0133333
NODE_11208_length_824_cov_23.936552	418	493	7	34	75	0.4533333
NODE_11208_length_824_cov_23.936552	418	493	8	32	75	0.4266667
NODE_11209_length_824_cov_22.129655	377	457	9	1	80	0.0125000
NODE_11209_length_824_cov_22.129655	377	457	10	7	80	0.0875000
NODE_11209_length_824_cov_22.129655	377	457	11	22	80	0.2750000
NODE_11209_length_824_cov_22.129655	377	457	15	37	80	0.4625000
NODE_11209_length_824_cov_22.129655	377	457	17	13	80	0.1625000
NODE_11209_length_824_cov_22.129655	430	510	3	10	80	0.1250000
NODE_11209_length_824_cov_22.129655	430	510	8	13	80	0.1625000
NODE_11209_length_824_cov_22.129655	430	510	9	1	80	0.0125000
NODE_11209_length_824_cov_22.129655	430	510	10	37	80	0.4625000
NODE_11209_length_824_cov_22.129655	430	510	11	19	80	0.2375000
NODE_11210_length_824_cov_17.914483	387	467	1	80	80	1.0000000
NODE_11210_length_824_cov_17.914483	440	520	0	10	80	0.1250000
NODE_11210_length_824_cov_17.914483	440	520	1	70	80	0.8750000
NODE_11211_length_824_cov_16.662069	362	442	5	7	80	0.0875000
NODE_11211_length_824_cov_16.662069	362	442	6	15	80	0.1875000
NODE_11211_length_824_cov_16.662069	362	442	7	58	80	0.7250000
NODE_11211_length_824_cov_16.662069	415	495	3	51	80	0.6375000
NODE_11211_length_824_cov_16.662069	415	495	5	9	80	0.1125000
NODE_11211_length_824_cov_16.662069	415	495	7	20	80	0.2500000
NODE_11212_length_824_cov_16.306207	352	432	10	7	80	0.0875000
NODE_11212_length_824_cov_16.306207	352	432	11	35	80	0.4375000
NODE_11212_length_824_cov_16.306207	352	432	12	38	80	0.4750000
NODE_11212_length_824_cov_16.306207	405	485	5	12	80	0.1500000
NODE_11212_length_824_cov_16.306207	405	485	6	4	80	0.0500000
NODE_11212_length_824_cov_16.306207	405	485	7	8	80	0.1000000
NODE_11212_length_824_cov_16.306207	405	485	8	16	80	0.2000000
NODE_11212_length_824_cov_16.306207	405	485	9	6	80	0.0750000
NODE_11212_length_824_cov_16.306207	405	485	11	7	80	0.0875000
NODE_11212_length_824_cov_16.306207	405	485	12	27	80	0.3375000
NODE_11213_length_824_cov_15.891034	342	422	4	34	80	0.4250000
NODE_11213_length_824_cov_15.891034	342	422	5	19	80	0.2375000
NODE_11213_length_824_cov_15.891034	342	422	7	27	80	0.3375000
NODE_11213_length_824_cov_15.891034	395	475	3	28	80	0.3500000
NODE_11213_length_824_cov_15.891034	395	475	4	52	80	0.6500000
NODE_11214_length_824_cov_12.485517	280	360	3	29	80	0.3625000
NODE_11214_length_824_cov_12.485517	280	360	6	6	80	0.0750000
NODE_11214_length_824_cov_12.485517	280	360	9	45	80	0.5625000
NODE_11214_length_824_cov_12.485517	333	413	3	43	80	0.5375000
NODE_11214_length_824_cov_12.485517	333	413	6	8	80	0.1000000
NODE_11214_length_824_cov_12.485517	333	413	7	1	80	0.0125000
NODE_11214_length_824_cov_12.485517	333	413	9	28	80	0.3500000
NODE_11216_length_824_cov_5.924138	269	349	0	80	80	1.0000000
NODE_11216_length_824_cov_5.924138	322	402	0	80	80	1.0000000
NODE_11222_length_824_cov_3.849655	191	271	2	80	80	1.0000000
NODE_11251_length_823_cov_75.169890	207	287	10	3	80	0.0375000
NODE_11251_length_823_cov_75.169890	207	287	12	1	80	0.0125000
NODE_11251_length_823_cov_75.169890	207	287	13	8	80	0.1000000
NODE_11251_length_823_cov_75.169890	207	287	15	9	80	0.1125000
NODE_11251_length_823_cov_75.169890	207	287	17	18	80	0.2250000
NODE_11251_length_823_cov_75.169890	207	287	18	30	80	0.3750000
NODE_11251_length_823_cov_75.169890	207	287	19	10	80	0.1250000
NODE_11251_length_823_cov_75.169890	207	287	20	1	80	0.0125000
NODE_11251_length_823_cov_75.169890	260	340	14	4	80	0.0500000
NODE_11251_length_823_cov_75.169890	260	340	15	9	80	0.1125000
NODE_11251_length_823_cov_75.169890	260	340	16	30	80	0.3750000
NODE_11251_length_823_cov_75.169890	260	340	17	9	80	0.1125000
NODE_11251_length_823_cov_75.169890	260	340	18	25	80	0.3125000
NODE_11251_length_823_cov_75.169890	260	340	19	1	80	0.0125000
NODE_11251_length_823_cov_75.169890	260	340	20	2	80	0.0250000
NODE_11251_length_823_cov_75.169890	336	416	17	2	80	0.0250000
NODE_11251_length_823_cov_75.169890	336	416	19	28	80	0.3500000
NODE_11251_length_823_cov_75.169890	336	416	20	18	80	0.2250000
NODE_11251_length_823_cov_75.169890	336	416	21	7	80	0.0875000
NODE_11251_length_823_cov_75.169890	336	416	23	14	80	0.1750000
NODE_11251_length_823_cov_75.169890	336	416	24	3	80	0.0375000
NODE_11251_length_823_cov_75.169890	336	416	25	5	80	0.0625000
NODE_11251_length_823_cov_75.169890	336	416	26	3	80	0.0375000
NODE_11251_length_823_cov_75.169890	389	469	15	15	80	0.1875000
NODE_11251_length_823_cov_75.169890	389	469	16	4	80	0.0500000
NODE_11251_length_823_cov_75.169890	389	469	17	8	80	0.1000000
NODE_11251_length_823_cov_75.169890	389	469	18	13	80	0.1625000
NODE_11251_length_823_cov_75.169890	389	469	19	33	80	0.4125000
NODE_11251_length_823_cov_75.169890	389	469	20	7	80	0.0875000
NODE_11253_length_823_cov_37.738950	332	412	12	9	80	0.1125000
NODE_11253_length_823_cov_37.738950	332	412	14	28	80	0.3500000
NODE_11253_length_823_cov_37.738950	332	412	15	6	80	0.0750000
NODE_11253_length_823_cov_37.738950	332	412	16	7	80	0.0875000
NODE_11253_length_823_cov_37.738950	332	412	17	9	80	0.1125000
NODE_11253_length_823_cov_37.738950	332	412	18	21	80	0.2625000
NODE_11253_length_823_cov_37.738950	385	466	11	4	81	0.0493827
NODE_11253_length_823_cov_37.738950	385	466	13	19	81	0.2345679
NODE_11253_length_823_cov_37.738950	385	466	14	1	81	0.0123457
NODE_11253_length_823_cov_37.738950	385	466	15	23	81	0.2839506
NODE_11253_length_823_cov_37.738950	385	466	16	19	81	0.2345679
NODE_11253_length_823_cov_37.738950	385	466	17	9	81	0.1111111
NODE_11253_length_823_cov_37.738950	385	466	18	6	81	0.0740741
NODE_11254_length_823_cov_29.349448	400	480	5	11	80	0.1375000
NODE_11254_length_823_cov_29.349448	400	480	6	41	80	0.5125000
NODE_11254_length_823_cov_29.349448	400	480	7	28	80	0.3500000
NODE_11254_length_823_cov_29.349448	453	533	2	33	80	0.4125000
NODE_11254_length_823_cov_29.349448	453	533	3	2	80	0.0250000
NODE_11254_length_823_cov_29.349448	453	533	4	2	80	0.0250000
NODE_11254_length_823_cov_29.349448	453	533	6	43	80	0.5375000
NODE_11255_length_823_cov_25.730663	338	418	11	26	80	0.3250000
NODE_11255_length_823_cov_25.730663	338	418	12	6	80	0.0750000
NODE_11255_length_823_cov_25.730663	338	418	13	12	80	0.1500000
NODE_11255_length_823_cov_25.730663	338	418	15	3	80	0.0375000
NODE_11255_length_823_cov_25.730663	338	418	16	15	80	0.1875000
NODE_11255_length_823_cov_25.730663	338	418	18	18	80	0.2250000
NODE_11255_length_823_cov_25.730663	391	471	16	11	80	0.1375000
NODE_11255_length_823_cov_25.730663	391	471	17	10	80	0.1250000
NODE_11255_length_823_cov_25.730663	391	471	18	41	80	0.5125000
NODE_11255_length_823_cov_25.730663	391	471	19	12	80	0.1500000
NODE_11255_length_823_cov_25.730663	391	471	20	4	80	0.0500000
NODE_11255_length_823_cov_25.730663	391	471	21	2	80	0.0250000
NODE_11256_length_823_cov_24.599448	349	429	1	25	80	0.3125000
NODE_11256_length_823_cov_24.599448	349	429	2	4	80	0.0500000
NODE_11256_length_823_cov_24.599448	349	429	3	9	80	0.1125000
NODE_11256_length_823_cov_24.599448	349	429	4	17	80	0.2125000
NODE_11256_length_823_cov_24.599448	349	429	6	25	80	0.3125000
NODE_11256_length_823_cov_24.599448	402	482	1	18	80	0.2250000
NODE_11256_length_823_cov_24.599448	402	482	2	33	80	0.4125000
NODE_11256_length_823_cov_24.599448	402	482	3	29	80	0.3625000
NODE_11257_length_823_cov_22.149171	356	436	6	42	80	0.5250000
NODE_11257_length_823_cov_22.149171	356	436	7	29	80	0.3625000
NODE_11257_length_823_cov_22.149171	356	436	8	9	80	0.1125000
NODE_11257_length_823_cov_22.149171	409	489	5	39	80	0.4875000
NODE_11257_length_823_cov_22.149171	409	489	6	22	80	0.2750000
NODE_11257_length_823_cov_22.149171	409	489	7	18	80	0.2250000
NODE_11257_length_823_cov_22.149171	409	489	8	1	80	0.0125000
NODE_11257_length_823_cov_22.149171	485	565	1	12	80	0.1500000
NODE_11257_length_823_cov_22.149171	485	565	2	11	80	0.1375000
NODE_11257_length_823_cov_22.149171	485	565	3	38	80	0.4750000
NODE_11257_length_823_cov_22.149171	485	565	4	6	80	0.0750000
NODE_11257_length_823_cov_22.149171	485	565	5	2	80	0.0250000
NODE_11257_length_823_cov_22.149171	485	565	6	11	80	0.1375000
NODE_11257_length_823_cov_22.149171	538	618	1	43	80	0.5375000
NODE_11257_length_823_cov_22.149171	538	618	2	33	80	0.4125000
NODE_11257_length_823_cov_22.149171	538	618	3	4	80	0.0500000
NODE_11258_length_823_cov_20.892265	329	409	0	16	80	0.2000000
NODE_11258_length_823_cov_20.892265	329	409	2	7	80	0.0875000
NODE_11258_length_823_cov_20.892265	329	409	4	12	80	0.1500000
NODE_11258_length_823_cov_20.892265	329	409	5	4	80	0.0500000
NODE_11258_length_823_cov_20.892265	329	409	6	14	80	0.1750000
NODE_11258_length_823_cov_20.892265	329	409	7	3	80	0.0375000
NODE_11258_length_823_cov_20.892265	329	409	9	3	80	0.0375000
NODE_11258_length_823_cov_20.892265	329	409	11	1	80	0.0125000
NODE_11258_length_823_cov_20.892265	329	409	14	5	80	0.0625000
NODE_11258_length_823_cov_20.892265	329	409	15	15	80	0.1875000
NODE_11258_length_823_cov_20.892265	382	462	7	3	80	0.0375000
NODE_11258_length_823_cov_20.892265	382	462	9	3	80	0.0375000
NODE_11258_length_823_cov_20.892265	382	462	11	1	80	0.0125000
NODE_11258_length_823_cov_20.892265	382	462	14	5	80	0.0625000
NODE_11258_length_823_cov_20.892265	382	462	15	27	80	0.3375000
NODE_11258_length_823_cov_20.892265	382	462	16	24	80	0.3000000
NODE_11258_length_823_cov_20.892265	382	462	17	17	80	0.2125000
NODE_11259_length_823_cov_19.281768	305	385	4	14	80	0.1750000
NODE_11259_length_823_cov_19.281768	305	385	6	26	80	0.3250000
NODE_11259_length_823_cov_19.281768	305	385	8	8	80	0.1000000
NODE_11259_length_823_cov_19.281768	305	385	9	32	80	0.4000000
NODE_11259_length_823_cov_19.281768	358	438	6	12	80	0.1500000
NODE_11259_length_823_cov_19.281768	358	438	8	55	80	0.6875000
NODE_11259_length_823_cov_19.281768	358	438	9	13	80	0.1625000
NODE_11260_length_823_cov_15.738950	409	489	3	6	80	0.0750000
NODE_11260_length_823_cov_15.738950	409	489	5	38	80	0.4750000
NODE_11260_length_823_cov_15.738950	409	489	7	9	80	0.1125000
NODE_11260_length_823_cov_15.738950	409	489	9	27	80	0.3375000
NODE_11260_length_823_cov_15.738950	462	542	6	15	80	0.1875000
NODE_11260_length_823_cov_15.738950	462	542	9	65	80	0.8125000
NODE_11261_length_823_cov_10.729282	362	437	2	26	75	0.3466667
NODE_11261_length_823_cov_10.729282	362	437	3	6	75	0.0800000
NODE_11261_length_823_cov_10.729282	362	437	5	16	75	0.2133333
NODE_11261_length_823_cov_10.729282	362	437	6	27	75	0.3600000
NODE_11261_length_823_cov_10.729282	410	484	5	34	74	0.4594595
NODE_11261_length_823_cov_10.729282	410	484	6	40	74	0.5405405
NODE_11262_length_823_cov_9.110497	394	474	0	80	80	1.0000000
NODE_11262_length_823_cov_9.110497	447	527	0	80	80	1.0000000
NODE_11265_length_823_cov_5.511050	168	248	0	80	80	1.0000000
NODE_11265_length_823_cov_5.511050	434	485	1	51	51	1.0000000
NODE_11292_length_823_cov_0.968232	86	154	0	68	68	1.0000000
NODE_11298_length_822_cov_25.423237	377	459	0	26	82	0.3170732
NODE_11298_length_822_cov_25.423237	377	459	1	13	82	0.1585366
NODE_11298_length_822_cov_25.423237	377	459	3	17	82	0.2073171
NODE_11298_length_822_cov_25.423237	377	459	4	26	82	0.3170732
NODE_11298_length_822_cov_25.423237	432	512	3	1	80	0.0125000
NODE_11298_length_822_cov_25.423237	432	512	4	35	80	0.4375000
NODE_11298_length_822_cov_25.423237	432	512	6	44	80	0.5500000
NODE_11299_length_822_cov_16.381743	394	474	1	29	80	0.3625000
NODE_11299_length_822_cov_16.381743	394	474	2	21	80	0.2625000
NODE_11299_length_822_cov_16.381743	394	474	3	30	80	0.3750000
NODE_11299_length_822_cov_16.381743	447	527	0	42	80	0.5250000
NODE_11299_length_822_cov_16.381743	447	527	1	38	80	0.4750000
NODE_11300_length_822_cov_12.426003	223	296	0	40	73	0.5479452
NODE_11300_length_822_cov_12.426003	223	296	2	33	73	0.4520548
NODE_11300_length_822_cov_12.426003	278	349	2	41	71	0.5774648
NODE_11300_length_822_cov_12.426003	278	349	3	1	71	0.0140845
NODE_11300_length_822_cov_12.426003	278	349	4	29	71	0.4084507
NODE_11301_length_822_cov_10.608575	464	544	3	13	80	0.1625000
NODE_11301_length_822_cov_10.608575	464	544	4	37	80	0.4625000
NODE_11301_length_822_cov_10.608575	464	544	5	30	80	0.3750000
NODE_11301_length_822_cov_10.608575	517	597	3	6	80	0.0750000
NODE_11301_length_822_cov_10.608575	517	597	4	74	80	0.9250000
NODE_11302_length_822_cov_9.496542	363	443	0	63	80	0.7875000
NODE_11302_length_822_cov_9.496542	363	443	1	17	80	0.2125000
NODE_11302_length_822_cov_9.496542	416	496	0	10	80	0.1250000
NODE_11302_length_822_cov_9.496542	416	496	1	70	80	0.8750000
NODE_11333_length_821_cov_39.818560	341	420	3	10	79	0.1265823
NODE_11333_length_821_cov_39.818560	341	420	5	69	79	0.8734177
NODE_11333_length_821_cov_39.818560	393	473	1	9	80	0.1125000
NODE_11333_length_821_cov_39.818560	393	473	2	28	80	0.3500000
NODE_11333_length_821_cov_39.818560	393	473	3	26	80	0.3250000
NODE_11333_length_821_cov_39.818560	393	473	5	17	80	0.2125000
NODE_11334_length_821_cov_27.721607	299	379	1	6	80	0.0750000
NODE_11334_length_821_cov_27.721607	299	379	2	2	80	0.0250000
NODE_11334_length_821_cov_27.721607	299	379	4	13	80	0.1625000
NODE_11334_length_821_cov_27.721607	299	379	6	9	80	0.1125000
NODE_11334_length_821_cov_27.721607	299	379	7	2	80	0.0250000
NODE_11334_length_821_cov_27.721607	299	379	8	6	80	0.0750000
NODE_11334_length_821_cov_27.721607	299	379	9	1	80	0.0125000
NODE_11334_length_821_cov_27.721607	299	379	10	2	80	0.0250000
NODE_11334_length_821_cov_27.721607	299	379	12	14	80	0.1750000
NODE_11334_length_821_cov_27.721607	299	379	13	25	80	0.3125000
NODE_11334_length_821_cov_27.721607	352	432	12	2	80	0.0250000
NODE_11334_length_821_cov_27.721607	352	432	13	42	80	0.5250000
NODE_11334_length_821_cov_27.721607	352	432	14	3	80	0.0375000
NODE_11334_length_821_cov_27.721607	352	432	15	2	80	0.0250000
NODE_11334_length_821_cov_27.721607	352	432	16	31	80	0.3875000
NODE_11335_length_821_cov_26.252078	386	466	8	37	80	0.4625000
NODE_11335_length_821_cov_26.252078	386	466	9	29	80	0.3625000
NODE_11335_length_821_cov_26.252078	386	466	10	14	80	0.1750000
NODE_11335_length_821_cov_26.252078	439	519	5	30	80	0.3750000
NODE_11335_length_821_cov_26.252078	439	519	6	1	80	0.0125000
NODE_11335_length_821_cov_26.252078	439	519	7	21	80	0.2625000
NODE_11335_length_821_cov_26.252078	439	519	8	6	80	0.0750000
NODE_11335_length_821_cov_26.252078	439	519	9	22	80	0.2750000
NODE_11336_length_821_cov_19.603878	353	433	0	80	80	1.0000000
NODE_11336_length_821_cov_19.603878	406	486	0	80	80	1.0000000
NODE_11337_length_821_cov_15.945983	310	390	3	20	80	0.2500000
NODE_11337_length_821_cov_15.945983	310	390	4	60	80	0.7500000
NODE_11337_length_821_cov_15.945983	363	443	2	23	80	0.2875000
NODE_11337_length_821_cov_15.945983	363	443	3	5	80	0.0625000
NODE_11337_length_821_cov_15.945983	363	443	4	52	80	0.6500000
NODE_11339_length_821_cov_8.711911	288	368	2	14	80	0.1750000
NODE_11339_length_821_cov_8.711911	288	368	3	37	80	0.4625000
NODE_11339_length_821_cov_8.711911	288	368	6	29	80	0.3625000
NODE_11339_length_821_cov_8.711911	341	421	6	34	80	0.4250000
NODE_11339_length_821_cov_8.711911	341	421	8	2	80	0.0250000
NODE_11339_length_821_cov_8.711911	341	421	9	24	80	0.3000000
NODE_11339_length_821_cov_8.711911	341	421	10	8	80	0.1000000
NODE_11339_length_821_cov_8.711911	341	421	11	1	80	0.0125000
NODE_11339_length_821_cov_8.711911	341	421	12	11	80	0.1375000
NODE_11349_length_821_cov_3.026316	310	390	0	80	80	1.0000000
NODE_11349_length_821_cov_3.026316	363	443	0	80	80	1.0000000
NODE_11361_length_820_cov_67.292649	328	408	6	14	80	0.1750000
NODE_11361_length_820_cov_67.292649	328	408	7	1	80	0.0125000
NODE_11361_length_820_cov_67.292649	328	408	8	38	80	0.4750000
NODE_11361_length_820_cov_67.292649	328	408	9	20	80	0.2500000
NODE_11361_length_820_cov_67.292649	328	408	10	7	80	0.0875000
NODE_11361_length_820_cov_67.292649	381	461	7	1	80	0.0125000
NODE_11361_length_820_cov_67.292649	381	461	8	75	80	0.9375000
NODE_11361_length_820_cov_67.292649	381	461	9	2	80	0.0250000
NODE_11361_length_820_cov_67.292649	381	461	10	2	80	0.0250000
NODE_11362_length_820_cov_26.915395	308	388	0	80	80	1.0000000
NODE_11363_length_820_cov_25.253814	301	381	3	80	80	1.0000000
NODE_11363_length_820_cov_25.253814	354	434	0	39	80	0.4875000
NODE_11363_length_820_cov_25.253814	354	434	3	41	80	0.5125000
NODE_11363_length_820_cov_25.253814	430	510	0	47	80	0.5875000
NODE_11363_length_820_cov_25.253814	430	510	2	12	80	0.1500000
NODE_11363_length_820_cov_25.253814	430	510	5	21	80	0.2625000
NODE_11363_length_820_cov_25.253814	483	563	2	6	80	0.0750000
NODE_11363_length_820_cov_25.253814	483	563	5	24	80	0.3000000
NODE_11363_length_820_cov_25.253814	483	563	8	38	80	0.4750000
NODE_11363_length_820_cov_25.253814	483	563	10	12	80	0.1500000
NODE_11364_length_820_cov_16.015257	325	405	1	23	80	0.2875000
NODE_11364_length_820_cov_16.015257	325	405	2	57	80	0.7125000
NODE_11364_length_820_cov_16.015257	378	458	1	65	80	0.8125000
NODE_11364_length_820_cov_16.015257	378	458	2	15	80	0.1875000
NODE_11365_length_820_cov_14.703190	371	451	4	6	80	0.0750000
NODE_11365_length_820_cov_14.703190	371	451	5	7	80	0.0875000
NODE_11365_length_820_cov_14.703190	371	451	6	1	80	0.0125000
NODE_11365_length_820_cov_14.703190	371	451	7	18	80	0.2250000
NODE_11365_length_820_cov_14.703190	371	451	8	48	80	0.6000000
NODE_11365_length_820_cov_14.703190	424	504	2	8	80	0.1000000
NODE_11365_length_820_cov_14.703190	424	504	4	51	80	0.6375000
NODE_11365_length_820_cov_14.703190	424	504	5	7	80	0.0875000
NODE_11365_length_820_cov_14.703190	424	504	6	1	80	0.0125000
NODE_11365_length_820_cov_14.703190	424	504	7	13	80	0.1625000
NODE_11366_length_820_cov_14.527046	249	329	2	14	80	0.1750000
NODE_11366_length_820_cov_14.527046	249	329	5	19	80	0.2375000
NODE_11366_length_820_cov_14.527046	249	329	7	26	80	0.3250000
NODE_11366_length_820_cov_14.527046	249	329	8	2	80	0.0250000
NODE_11366_length_820_cov_14.527046	249	329	9	9	80	0.1125000
NODE_11366_length_820_cov_14.527046	249	329	10	10	80	0.1250000
NODE_11366_length_820_cov_14.527046	302	382	7	6	80	0.0750000
NODE_11366_length_820_cov_14.527046	302	382	8	7	80	0.0875000
NODE_11366_length_820_cov_14.527046	302	382	9	57	80	0.7125000
NODE_11366_length_820_cov_14.527046	302	382	10	10	80	0.1250000
NODE_11367_length_820_cov_14.284327	286	366	3	17	80	0.2125000
NODE_11367_length_820_cov_14.284327	286	366	4	16	80	0.2000000
NODE_11367_length_820_cov_14.284327	286	366	5	5	80	0.0625000
NODE_11367_length_820_cov_14.284327	286	366	6	33	80	0.4125000
NODE_11367_length_820_cov_14.284327	286	366	7	9	80	0.1125000
NODE_11367_length_820_cov_14.284327	339	419	3	1	80	0.0125000
NODE_11367_length_820_cov_14.284327	339	419	6	71	80	0.8875000
NODE_11367_length_820_cov_14.284327	339	419	7	8	80	0.1000000
NODE_11367_length_820_cov_14.284327	619	699	0	80	80	1.0000000
NODE_11368_length_820_cov_13.036061	364	444	0	80	80	1.0000000
NODE_11368_length_820_cov_13.036061	417	497	0	80	80	1.0000000
NODE_11369_length_820_cov_12.830791	313	393	1	9	80	0.1125000
NODE_11369_length_820_cov_12.830791	313	393	2	11	80	0.1375000
NODE_11369_length_820_cov_12.830791	313	393	4	10	80	0.1250000
NODE_11369_length_820_cov_12.830791	313	393	5	1	80	0.0125000
NODE_11369_length_820_cov_12.830791	313	393	6	49	80	0.6125000
NODE_11369_length_820_cov_12.830791	366	446	6	50	80	0.6250000
NODE_11369_length_820_cov_12.830791	366	446	7	30	80	0.3750000
NODE_11370_length_820_cov_12.768377	366	443	3	10	77	0.1298701
NODE_11370_length_820_cov_12.768377	366	443	4	67	77	0.8701299
NODE_11370_length_820_cov_12.768377	496	525	2	22	29	0.7586207
NODE_11370_length_820_cov_12.768377	496	525	4	7	29	0.2413793
NODE_11371_length_820_cov_12.223301	452	519	0	67	67	1.0000000
NODE_11371_length_820_cov_12.223301	492	572	0	80	80	1.0000000
NODE_11396_length_819_cov_43.027778	403	483	2	29	80	0.3625000
NODE_11396_length_819_cov_43.027778	403	483	9	18	80	0.2250000
NODE_11396_length_819_cov_43.027778	403	483	10	6	80	0.0750000
NODE_11396_length_819_cov_43.027778	403	483	12	14	80	0.1750000
NODE_11396_length_819_cov_43.027778	403	483	13	5	80	0.0625000
NODE_11396_length_819_cov_43.027778	403	483	14	8	80	0.1000000
NODE_11396_length_819_cov_43.027778	456	536	12	14	80	0.1750000
NODE_11396_length_819_cov_43.027778	456	536	13	5	80	0.0625000
NODE_11396_length_819_cov_43.027778	456	536	14	19	80	0.2375000
NODE_11396_length_819_cov_43.027778	456	536	17	2	80	0.0250000
NODE_11396_length_819_cov_43.027778	456	536	18	5	80	0.0625000
NODE_11396_length_819_cov_43.027778	456	536	19	15	80	0.1875000
NODE_11396_length_819_cov_43.027778	456	536	20	17	80	0.2125000
NODE_11396_length_819_cov_43.027778	456	536	21	3	80	0.0375000
NODE_11396_length_819_cov_43.027778	532	612	18	6	80	0.0750000
NODE_11396_length_819_cov_43.027778	532	612	19	3	80	0.0375000
NODE_11396_length_819_cov_43.027778	532	612	20	5	80	0.0625000
NODE_11396_length_819_cov_43.027778	532	612	21	2	80	0.0250000
NODE_11396_length_819_cov_43.027778	532	612	22	26	80	0.3250000
NODE_11396_length_819_cov_43.027778	532	612	24	11	80	0.1375000
NODE_11396_length_819_cov_43.027778	532	612	26	1	80	0.0125000
NODE_11396_length_819_cov_43.027778	532	612	27	7	80	0.0875000
NODE_11396_length_819_cov_43.027778	532	612	28	19	80	0.2375000
NODE_11396_length_819_cov_43.027778	585	665	13	26	80	0.3250000
NODE_11396_length_819_cov_43.027778	585	665	15	4	80	0.0500000
NODE_11396_length_819_cov_43.027778	585	665	16	3	80	0.0375000
NODE_11396_length_819_cov_43.027778	585	665	18	8	80	0.1000000
NODE_11396_length_819_cov_43.027778	585	665	19	18	80	0.2250000
NODE_11396_length_819_cov_43.027778	585	665	20	4	80	0.0500000
NODE_11396_length_819_cov_43.027778	585	665	21	2	80	0.0250000
NODE_11396_length_819_cov_43.027778	585	665	22	15	80	0.1875000
NODE_11397_length_819_cov_42.758333	391	471	10	80	80	1.0000000
NODE_11397_length_819_cov_42.758333	444	524	5	4	80	0.0500000
NODE_11397_length_819_cov_42.758333	444	524	6	41	80	0.5125000
NODE_11397_length_819_cov_42.758333	444	524	10	35	80	0.4375000
NODE_11398_length_819_cov_41.341667	86	166	5	12	80	0.1500000
NODE_11398_length_819_cov_41.341667	86	166	6	68	80	0.8500000
NODE_11398_length_819_cov_41.341667	139	219	4	16	80	0.2000000
NODE_11398_length_819_cov_41.341667	139	219	5	30	80	0.3750000
NODE_11398_length_819_cov_41.341667	139	219	6	34	80	0.4250000
NODE_11398_length_819_cov_41.341667	215	295	3	12	80	0.1500000
NODE_11398_length_819_cov_41.341667	215	295	5	41	80	0.5125000
NODE_11398_length_819_cov_41.341667	215	295	6	23	80	0.2875000
NODE_11398_length_819_cov_41.341667	215	295	7	4	80	0.0500000
NODE_11398_length_819_cov_41.341667	268	348	2	1	80	0.0125000
NODE_11398_length_819_cov_41.341667	268	348	3	64	80	0.8000000
NODE_11398_length_819_cov_41.341667	268	348	5	15	80	0.1875000
NODE_11399_length_819_cov_23.656944	335	415	7	41	80	0.5125000
NODE_11399_length_819_cov_23.656944	335	415	8	39	80	0.4875000
NODE_11399_length_819_cov_23.656944	388	468	5	5	80	0.0625000
NODE_11399_length_819_cov_23.656944	388	468	6	1	80	0.0125000
NODE_11399_length_819_cov_23.656944	388	468	7	50	80	0.6250000
NODE_11399_length_819_cov_23.656944	388	468	8	24	80	0.3000000
NODE_11400_length_819_cov_20.633333	475	555	12	59	80	0.7375000
NODE_11400_length_819_cov_20.633333	475	555	13	14	80	0.1750000
NODE_11400_length_819_cov_20.633333	475	555	15	1	80	0.0125000
NODE_11400_length_819_cov_20.633333	475	555	16	6	80	0.0750000
NODE_11400_length_819_cov_20.633333	528	608	3	36	80	0.4500000
NODE_11400_length_819_cov_20.633333	528	608	6	2	80	0.0250000
NODE_11400_length_819_cov_20.633333	528	608	7	7	80	0.0875000
NODE_11400_length_819_cov_20.633333	528	608	11	7	80	0.0875000
NODE_11400_length_819_cov_20.633333	528	608	12	28	80	0.3500000
NODE_11401_length_819_cov_18.941667	307	387	0	26	80	0.3250000
NODE_11401_length_819_cov_18.941667	307	387	1	2	80	0.0250000
NODE_11401_length_819_cov_18.941667	307	387	2	43	80	0.5375000
NODE_11401_length_819_cov_18.941667	307	387	4	9	80	0.1125000
NODE_11401_length_819_cov_18.941667	360	440	2	18	80	0.2250000
NODE_11401_length_819_cov_18.941667	360	440	4	12	80	0.1500000
NODE_11401_length_819_cov_18.941667	360	440	5	9	80	0.1125000
NODE_11401_length_819_cov_18.941667	360	440	6	8	80	0.1000000
NODE_11401_length_819_cov_18.941667	360	440	7	20	80	0.2500000
NODE_11401_length_819_cov_18.941667	360	440	8	13	80	0.1625000
NODE_11401_length_819_cov_18.941667	436	516	8	19	80	0.2375000
NODE_11401_length_819_cov_18.941667	436	516	9	31	80	0.3875000
NODE_11401_length_819_cov_18.941667	436	516	10	14	80	0.1750000
NODE_11401_length_819_cov_18.941667	436	516	11	16	80	0.2000000
NODE_11401_length_819_cov_18.941667	489	569	5	12	80	0.1500000
NODE_11401_length_819_cov_18.941667	489	569	6	8	80	0.1000000
NODE_11401_length_819_cov_18.941667	489	569	7	9	80	0.1125000
NODE_11401_length_819_cov_18.941667	489	569	8	12	80	0.1500000
NODE_11401_length_819_cov_18.941667	489	569	9	30	80	0.3750000
NODE_11401_length_819_cov_18.941667	489	569	10	9	80	0.1125000
NODE_11402_length_819_cov_12.225000	431	511	5	32	80	0.4000000
NODE_11402_length_819_cov_12.225000	431	511	6	3	80	0.0375000
NODE_11402_length_819_cov_12.225000	431	511	10	45	80	0.5625000
NODE_11402_length_819_cov_12.225000	484	564	6	12	80	0.1500000
NODE_11402_length_819_cov_12.225000	484	564	7	6	80	0.0750000
NODE_11402_length_819_cov_12.225000	484	564	8	12	80	0.1500000
NODE_11402_length_819_cov_12.225000	484	564	9	21	80	0.2625000
NODE_11402_length_819_cov_12.225000	484	564	10	29	80	0.3625000
NODE_11403_length_819_cov_11.562500	273	353	1	33	80	0.4125000
NODE_11403_length_819_cov_11.562500	273	353	4	8	80	0.1000000
NODE_11403_length_819_cov_11.562500	273	353	5	18	80	0.2250000
NODE_11403_length_819_cov_11.562500	273	353	8	18	80	0.2250000
NODE_11403_length_819_cov_11.562500	273	353	10	1	80	0.0125000
NODE_11403_length_819_cov_11.562500	273	353	11	2	80	0.0250000
NODE_11403_length_819_cov_11.562500	326	406	5	6	80	0.0750000
NODE_11403_length_819_cov_11.562500	326	406	8	18	80	0.2250000
NODE_11403_length_819_cov_11.562500	326	406	10	23	80	0.2875000
NODE_11403_length_819_cov_11.562500	326	406	11	33	80	0.4125000
NODE_11404_length_819_cov_8.905556	477	557	0	80	80	1.0000000
NODE_11404_length_819_cov_8.905556	530	610	0	80	80	1.0000000
NODE_11405_length_819_cov_5.675000	232	312	0	80	80	1.0000000
NODE_11405_length_819_cov_5.675000	285	365	0	80	80	1.0000000
NODE_11431_length_818_cov_21.979138	342	422	2	1	80	0.0125000
NODE_11431_length_818_cov_21.979138	342	422	3	7	80	0.0875000
NODE_11431_length_818_cov_21.979138	342	422	4	72	80	0.9000000
NODE_11431_length_818_cov_21.979138	395	475	2	54	80	0.6750000
NODE_11431_length_818_cov_21.979138	395	475	4	26	80	0.3250000
NODE_11432_length_818_cov_15.326843	334	414	2	19	80	0.2375000
NODE_11432_length_818_cov_15.326843	334	414	3	39	80	0.4875000
NODE_11432_length_818_cov_15.326843	334	414	6	15	80	0.1875000
NODE_11432_length_818_cov_15.326843	334	414	7	7	80	0.0875000
NODE_11432_length_818_cov_15.326843	387	467	1	4	80	0.0500000
NODE_11432_length_818_cov_15.326843	387	467	3	76	80	0.9500000
NODE_11433_length_818_cov_14.880389	392	472	1	43	80	0.5375000
NODE_11433_length_818_cov_14.880389	392	472	3	37	80	0.4625000
NODE_11433_length_818_cov_14.880389	445	525	2	51	80	0.6375000
NODE_11433_length_818_cov_14.880389	445	525	3	29	80	0.3625000
NODE_11434_length_818_cov_12.369958	390	470	2	80	80	1.0000000
NODE_11434_length_818_cov_12.369958	443	523	2	55	80	0.6875000
NODE_11434_length_818_cov_12.369958	443	523	3	19	80	0.2375000
NODE_11434_length_818_cov_12.369958	443	523	4	6	80	0.0750000
NODE_11436_length_818_cov_8.421419	370	450	15	8	80	0.1000000
NODE_11436_length_818_cov_8.421419	370	450	18	1	80	0.0125000
NODE_11436_length_818_cov_8.421419	370	450	19	18	80	0.2250000
NODE_11436_length_818_cov_8.421419	370	450	22	13	80	0.1625000
NODE_11436_length_818_cov_8.421419	370	450	24	29	80	0.3625000
NODE_11436_length_818_cov_8.421419	370	450	25	11	80	0.1375000
NODE_11436_length_818_cov_8.421419	423	503	14	13	80	0.1625000
NODE_11436_length_818_cov_8.421419	423	503	15	11	80	0.1375000
NODE_11436_length_818_cov_8.421419	423	503	16	37	80	0.4625000
NODE_11436_length_818_cov_8.421419	423	503	18	1	80	0.0125000
NODE_11436_length_818_cov_8.421419	423	503	19	18	80	0.2250000
NODE_11437_length_818_cov_6.439499	706	741	0	35	35	1.0000000
NODE_11439_length_818_cov_4.098748	320	390	4	46	70	0.6571429
NODE_11439_length_818_cov_4.098748	320	390	5	24	70	0.3428572
NODE_11439_length_818_cov_4.098748	416	472	5	8	56	0.1428571
NODE_11439_length_818_cov_4.098748	416	472	6	1	56	0.0178571
NODE_11439_length_818_cov_4.098748	416	472	7	27	56	0.4821429
NODE_11439_length_818_cov_4.098748	416	472	9	20	56	0.3571429
NODE_11457_length_817_cov_7.238162	494	574	1	80	80	1.0000000
NODE_11457_length_817_cov_7.238162	547	627	0	41	80	0.5125000
NODE_11457_length_817_cov_7.238162	547	627	1	39	80	0.4875000
NODE_11458_length_817_cov_5.789694	400	480	0	80	80	1.0000000
NODE_11458_length_817_cov_5.789694	476	555	0	79	79	1.0000000
NODE_11458_length_817_cov_5.789694	528	608	0	80	80	1.0000000
NODE_11462_length_817_cov_4.357939	433	513	0	21	80	0.2625000
NODE_11462_length_817_cov_4.357939	433	513	2	59	80	0.7375000
NODE_11462_length_817_cov_4.357939	486	566	0	74	80	0.9250000
NODE_11462_length_817_cov_4.357939	486	566	2	6	80	0.0750000
NODE_11486_length_817_cov_0.692201	626	696	0	70	70	1.0000000
NODE_11488_length_816_cov_69.800558	395	475	8	32	80	0.4000000
NODE_11488_length_816_cov_69.800558	395	475	12	11	80	0.1375000
NODE_11488_length_816_cov_69.800558	395	475	13	2	80	0.0250000
NODE_11488_length_816_cov_69.800558	395	475	14	24	80	0.3000000
NODE_11488_length_816_cov_69.800558	395	475	15	11	80	0.1375000
NODE_11488_length_816_cov_69.800558	448	520	10	43	72	0.5972222
NODE_11488_length_816_cov_69.800558	448	520	13	4	72	0.0555556
NODE_11488_length_816_cov_69.800558	448	520	14	23	72	0.3194444
NODE_11488_length_816_cov_69.800558	448	520	15	2	72	0.0277778
NODE_11489_length_816_cov_19.044630	77	154	3	31	77	0.4025974
NODE_11489_length_816_cov_19.044630	77	154	5	20	77	0.2597403
NODE_11489_length_816_cov_19.044630	77	154	6	3	77	0.0389610
NODE_11489_length_816_cov_19.044630	77	154	8	23	77	0.2987013
NODE_11489_length_816_cov_19.044630	130	212	6	1	82	0.0121951
NODE_11489_length_816_cov_19.044630	130	212	8	67	82	0.8170732
NODE_11489_length_816_cov_19.044630	130	212	10	14	82	0.1707317
NODE_11490_length_816_cov_16.418410	381	461	4	10	80	0.1250000
NODE_11490_length_816_cov_16.418410	381	461	6	1	80	0.0125000
NODE_11490_length_816_cov_16.418410	381	461	7	5	80	0.0625000
NODE_11490_length_816_cov_16.418410	381	461	8	22	80	0.2750000
NODE_11490_length_816_cov_16.418410	381	461	9	4	80	0.0500000
NODE_11490_length_816_cov_16.418410	381	461	10	7	80	0.0875000
NODE_11490_length_816_cov_16.418410	381	461	11	7	80	0.0875000
NODE_11490_length_816_cov_16.418410	381	461	12	16	80	0.2000000
NODE_11490_length_816_cov_16.418410	381	461	13	8	80	0.1000000
NODE_11490_length_816_cov_16.418410	434	514	11	6	80	0.0750000
NODE_11490_length_816_cov_16.418410	434	514	12	26	80	0.3250000
NODE_11490_length_816_cov_16.418410	434	514	13	48	80	0.6000000
NODE_11491_length_816_cov_15.945607	319	399	0	4	80	0.0500000
NODE_11491_length_816_cov_15.945607	319	399	1	10	80	0.1250000
NODE_11491_length_816_cov_15.945607	319	399	2	7	80	0.0875000
NODE_11491_length_816_cov_15.945607	319	399	3	29	80	0.3625000
NODE_11491_length_816_cov_15.945607	319	399	4	30	80	0.3750000
NODE_11491_length_816_cov_15.945607	372	452	4	50	80	0.6250000
NODE_11491_length_816_cov_15.945607	372	452	5	30	80	0.3750000
NODE_11492_length_816_cov_12.797768	358	438	3	3	80	0.0375000
NODE_11492_length_816_cov_12.797768	358	438	4	45	80	0.5625000
NODE_11492_length_816_cov_12.797768	358	438	5	27	80	0.3375000
NODE_11492_length_816_cov_12.797768	358	438	7	5	80	0.0625000
NODE_11492_length_816_cov_12.797768	411	491	3	56	80	0.7000000
NODE_11492_length_816_cov_12.797768	411	491	5	23	80	0.2875000
NODE_11492_length_816_cov_12.797768	411	491	7	1	80	0.0125000
NODE_11493_length_816_cov_12.086471	242	322	0	4	80	0.0500000
NODE_11493_length_816_cov_12.086471	242	322	2	76	80	0.9500000
NODE_11493_length_816_cov_12.086471	295	375	2	34	80	0.4250000
NODE_11493_length_816_cov_12.086471	295	375	4	46	80	0.5750000
NODE_11495_length_816_cov_3.873082	412	492	0	80	80	1.0000000
NODE_11495_length_816_cov_3.873082	465	545	0	80	80	1.0000000
NODE_11516_length_815_cov_48.090782	334	414	5	36	80	0.4500000
NODE_11516_length_815_cov_48.090782	334	414	6	44	80	0.5500000
NODE_11516_length_815_cov_48.090782	387	467	2	20	80	0.2500000
NODE_11516_length_815_cov_48.090782	387	467	4	19	80	0.2375000
NODE_11516_length_815_cov_48.090782	387	467	5	41	80	0.5125000
NODE_11517_length_815_cov_27.748603	290	370	5	15	80	0.1875000
NODE_11517_length_815_cov_27.748603	290	370	7	19	80	0.2375000
NODE_11517_length_815_cov_27.748603	290	370	8	16	80	0.2000000
NODE_11517_length_815_cov_27.748603	290	370	9	22	80	0.2750000
NODE_11517_length_815_cov_27.748603	290	370	10	8	80	0.1000000
NODE_11517_length_815_cov_27.748603	343	423	5	1	80	0.0125000
NODE_11517_length_815_cov_27.748603	343	423	6	2	80	0.0250000
NODE_11517_length_815_cov_27.748603	343	423	8	53	80	0.6625000
NODE_11517_length_815_cov_27.748603	343	423	9	17	80	0.2125000
NODE_11517_length_815_cov_27.748603	343	423	10	7	80	0.0875000
NODE_11518_length_815_cov_23.748603	429	509	8	13	80	0.1625000
NODE_11518_length_815_cov_23.748603	429	509	9	4	80	0.0500000
NODE_11518_length_815_cov_23.748603	429	509	10	12	80	0.1500000
NODE_11518_length_815_cov_23.748603	429	509	11	51	80	0.6375000
NODE_11518_length_815_cov_23.748603	482	562	3	15	80	0.1875000
NODE_11518_length_815_cov_23.748603	482	562	4	5	80	0.0625000
NODE_11518_length_815_cov_23.748603	482	562	6	18	80	0.2250000
NODE_11518_length_815_cov_23.748603	482	562	8	28	80	0.3500000
NODE_11518_length_815_cov_23.748603	482	562	10	6	80	0.0750000
NODE_11518_length_815_cov_23.748603	482	562	11	8	80	0.1000000
NODE_11519_length_815_cov_14.870112	318	398	2	21	80	0.2625000
NODE_11519_length_815_cov_14.870112	318	398	3	35	80	0.4375000
NODE_11519_length_815_cov_14.870112	318	398	4	24	80	0.3000000
NODE_11519_length_815_cov_14.870112	371	451	1	10	80	0.1250000
NODE_11519_length_815_cov_14.870112	371	451	3	70	80	0.8750000
NODE_11520_length_815_cov_13.317039	338	418	2	70	80	0.8750000
NODE_11520_length_815_cov_13.317039	338	418	4	10	80	0.1250000
NODE_11520_length_815_cov_13.317039	391	471	2	32	80	0.4000000
NODE_11520_length_815_cov_13.317039	391	471	3	28	80	0.3500000
NODE_11520_length_815_cov_13.317039	391	471	4	20	80	0.2500000
NODE_11521_length_815_cov_12.270950	315	395	7	21	80	0.2625000
NODE_11521_length_815_cov_12.270950	315	395	10	40	80	0.5000000
NODE_11521_length_815_cov_12.270950	315	395	11	5	80	0.0625000
NODE_11521_length_815_cov_12.270950	315	395	12	3	80	0.0375000
NODE_11521_length_815_cov_12.270950	315	395	13	9	80	0.1125000
NODE_11521_length_815_cov_12.270950	315	395	14	2	80	0.0250000
NODE_11521_length_815_cov_12.270950	368	448	8	12	80	0.1500000
NODE_11521_length_815_cov_12.270950	368	448	9	36	80	0.4500000
NODE_11521_length_815_cov_12.270950	368	448	10	32	80	0.4000000
NODE_11522_length_815_cov_9.304469	150	230	0	80	80	1.0000000
NODE_11522_length_815_cov_9.304469	203	283	0	80	80	1.0000000
NODE_11524_length_815_cov_8.117318	437	517	3	80	80	1.0000000
NODE_11524_length_815_cov_8.117318	490	570	1	1	80	0.0125000
NODE_11524_length_815_cov_8.117318	490	570	2	42	80	0.5250000
NODE_11524_length_815_cov_8.117318	490	570	3	37	80	0.4625000
NODE_11530_length_815_cov_3.963687	275	355	0	80	80	1.0000000
NODE_11530_length_815_cov_3.963687	328	408	0	80	80	1.0000000
NODE_11532_length_815_cov_2.976257	441	508	1	35	67	0.5223880
NODE_11532_length_815_cov_2.976257	441	508	2	32	67	0.4776119
NODE_11554_length_814_cov_55.545455	304	384	11	12	80	0.1500000
NODE_11554_length_814_cov_55.545455	304	384	12	11	80	0.1375000
NODE_11554_length_814_cov_55.545455	304	384	13	11	80	0.1375000
NODE_11554_length_814_cov_55.545455	304	384	14	46	80	0.5750000
NODE_11554_length_814_cov_55.545455	357	437	9	29	80	0.3625000
NODE_11554_length_814_cov_55.545455	357	437	10	4	80	0.0500000
NODE_11554_length_814_cov_55.545455	357	437	11	2	80	0.0250000
NODE_11554_length_814_cov_55.545455	357	437	13	12	80	0.1500000
NODE_11554_length_814_cov_55.545455	357	437	14	33	80	0.4125000
NODE_11554_length_814_cov_55.545455	517	559	1	41	42	0.9761904
NODE_11554_length_814_cov_55.545455	517	559	2	1	42	0.0238095
NODE_11554_length_814_cov_55.545455	724	804	0	80	80	1.0000000
NODE_11555_length_814_cov_32.216783	317	397	9	17	80	0.2125000
NODE_11555_length_814_cov_32.216783	317	397	10	14	80	0.1750000
NODE_11555_length_814_cov_32.216783	317	397	11	8	80	0.1000000
NODE_11555_length_814_cov_32.216783	317	397	12	2	80	0.0250000
NODE_11555_length_814_cov_32.216783	317	397	13	2	80	0.0250000
NODE_11555_length_814_cov_32.216783	317	397	16	30	80	0.3750000
NODE_11555_length_814_cov_32.216783	317	397	17	7	80	0.0875000
NODE_11555_length_814_cov_32.216783	370	450	15	5	80	0.0625000
NODE_11555_length_814_cov_32.216783	370	450	16	39	80	0.4875000
NODE_11555_length_814_cov_32.216783	370	450	17	36	80	0.4500000
NODE_11556_length_814_cov_19.507692	174	254	1	7	80	0.0875000
NODE_11556_length_814_cov_19.507692	174	254	2	69	80	0.8625000
NODE_11556_length_814_cov_19.507692	174	254	3	4	80	0.0500000
NODE_11556_length_814_cov_19.507692	227	307	1	18	80	0.2250000
NODE_11556_length_814_cov_19.507692	227	307	2	20	80	0.2500000
NODE_11556_length_814_cov_19.507692	227	307	3	3	80	0.0375000
NODE_11556_length_814_cov_19.507692	227	307	4	7	80	0.0875000
NODE_11556_length_814_cov_19.507692	227	307	5	13	80	0.1625000
NODE_11556_length_814_cov_19.507692	227	307	6	19	80	0.2375000
NODE_11556_length_814_cov_19.507692	303	383	6	22	80	0.2750000
NODE_11556_length_814_cov_19.507692	303	383	7	11	80	0.1375000
NODE_11556_length_814_cov_19.507692	303	383	9	33	80	0.4125000
NODE_11556_length_814_cov_19.507692	303	383	10	14	80	0.1750000
NODE_11556_length_814_cov_19.507692	356	436	6	11	80	0.1375000
NODE_11556_length_814_cov_19.507692	356	436	7	7	80	0.0875000
NODE_11556_length_814_cov_19.507692	356	436	8	3	80	0.0375000
NODE_11556_length_814_cov_19.507692	356	436	9	37	80	0.4625000
NODE_11556_length_814_cov_19.507692	356	436	10	22	80	0.2750000
NODE_11557_length_814_cov_18.579021	433	513	3	61	80	0.7625000
NODE_11557_length_814_cov_18.579021	433	513	4	13	80	0.1625000
NODE_11557_length_814_cov_18.579021	433	513	5	6	80	0.0750000
NODE_11557_length_814_cov_18.579021	486	566	3	70	80	0.8750000
NODE_11557_length_814_cov_18.579021	486	566	5	10	80	0.1250000
NODE_11558_length_814_cov_17.183217	339	419	5	77	80	0.9625000
NODE_11558_length_814_cov_17.183217	339	419	8	3	80	0.0375000
NODE_11558_length_814_cov_17.183217	392	472	0	25	80	0.3125000
NODE_11558_length_814_cov_17.183217	392	472	1	7	80	0.0875000
NODE_11558_length_814_cov_17.183217	392	472	2	14	80	0.1750000
NODE_11558_length_814_cov_17.183217	392	472	5	34	80	0.4250000
NODE_11559_length_814_cov_15.306294	238	318	3	35	80	0.4375000
NODE_11559_length_814_cov_15.306294	238	318	4	45	80	0.5625000
NODE_11559_length_814_cov_15.306294	291	371	2	32	80	0.4000000
NODE_11559_length_814_cov_15.306294	291	371	3	20	80	0.2500000
NODE_11559_length_814_cov_15.306294	291	371	4	28	80	0.3500000
NODE_11560_length_814_cov_11.511888	397	477	6	2	80	0.0250000
NODE_11560_length_814_cov_11.511888	397	477	7	9	80	0.1125000
NODE_11560_length_814_cov_11.511888	397	477	8	1	80	0.0125000
NODE_11560_length_814_cov_11.511888	397	477	9	3	80	0.0375000
NODE_11560_length_814_cov_11.511888	397	477	10	65	80	0.8125000
NODE_11560_length_814_cov_11.511888	459	530	5	8	71	0.1126761
NODE_11560_length_814_cov_11.511888	459	530	7	29	71	0.4084507
NODE_11560_length_814_cov_11.511888	459	530	8	6	71	0.0845070
NODE_11560_length_814_cov_11.511888	459	530	10	28	71	0.3943662
NODE_11561_length_814_cov_10.395804	305	385	3	1	80	0.0125000
NODE_11561_length_814_cov_10.395804	305	385	4	61	80	0.7625000
NODE_11561_length_814_cov_10.395804	305	385	5	18	80	0.2250000
NODE_11561_length_814_cov_10.395804	358	438	3	15	80	0.1875000
NODE_11561_length_814_cov_10.395804	358	438	4	47	80	0.5875000
NODE_11561_length_814_cov_10.395804	358	438	5	18	80	0.2250000
NODE_11562_length_814_cov_9.692308	347	427	0	80	80	1.0000000
NODE_11562_length_814_cov_9.692308	400	480	0	80	80	1.0000000
NODE_11564_length_814_cov_9.274126	245	325	6	17	80	0.2125000
NODE_11564_length_814_cov_9.274126	245	325	7	9	80	0.1125000
NODE_11564_length_814_cov_9.274126	245	325	11	54	80	0.6750000
NODE_11564_length_814_cov_9.274126	298	378	6	40	80	0.5000000
NODE_11564_length_814_cov_9.274126	298	378	7	39	80	0.4875000
NODE_11564_length_814_cov_9.274126	298	378	11	1	80	0.0125000
NODE_11565_length_814_cov_8.973427	271	351	0	80	80	1.0000000
NODE_11565_length_814_cov_8.973427	324	404	0	80	80	1.0000000
NODE_11573_length_814_cov_2.145455	273	327	0	54	54	1.0000000
NODE_11573_length_814_cov_2.145455	307	371	0	64	64	1.0000000
NODE_11587_length_813_cov_39.228291	225	305	14	1	80	0.0125000
NODE_11587_length_813_cov_39.228291	225	305	16	19	80	0.2375000
NODE_11587_length_813_cov_39.228291	225	305	18	4	80	0.0500000
NODE_11587_length_813_cov_39.228291	225	305	19	9	80	0.1125000
NODE_11587_length_813_cov_39.228291	225	305	20	1	80	0.0125000
NODE_11587_length_813_cov_39.228291	225	305	21	9	80	0.1125000
NODE_11587_length_813_cov_39.228291	225	305	22	6	80	0.0750000
NODE_11587_length_813_cov_39.228291	225	305	23	17	80	0.2125000
NODE_11587_length_813_cov_39.228291	225	305	24	14	80	0.1750000
NODE_11587_length_813_cov_39.228291	278	358	15	6	80	0.0750000
NODE_11587_length_813_cov_39.228291	278	358	16	40	80	0.5000000
NODE_11587_length_813_cov_39.228291	278	358	18	9	80	0.1125000
NODE_11587_length_813_cov_39.228291	278	358	19	2	80	0.0250000
NODE_11587_length_813_cov_39.228291	278	358	20	1	80	0.0125000
NODE_11587_length_813_cov_39.228291	278	358	22	3	80	0.0375000
NODE_11587_length_813_cov_39.228291	278	358	23	7	80	0.0875000
NODE_11587_length_813_cov_39.228291	278	358	24	12	80	0.1500000
NODE_11588_length_813_cov_36.570028	406	486	3	4	80	0.0500000
NODE_11588_length_813_cov_36.570028	406	486	4	12	80	0.1500000
NODE_11588_length_813_cov_36.570028	406	486	5	13	80	0.1625000
NODE_11588_length_813_cov_36.570028	406	486	6	12	80	0.1500000
NODE_11588_length_813_cov_36.570028	406	486	7	39	80	0.4875000
NODE_11588_length_813_cov_36.570028	459	539	5	4	80	0.0500000
NODE_11588_length_813_cov_36.570028	459	539	6	61	80	0.7625000
NODE_11588_length_813_cov_36.570028	459	539	7	15	80	0.1875000
NODE_11589_length_813_cov_26.718487	209	289	19	27	80	0.3375000
NODE_11589_length_813_cov_26.718487	209	289	20	7	80	0.0875000
NODE_11589_length_813_cov_26.718487	209	289	21	26	80	0.3250000
NODE_11589_length_813_cov_26.718487	209	289	22	2	80	0.0250000
NODE_11589_length_813_cov_26.718487	209	289	23	18	80	0.2250000
NODE_11589_length_813_cov_26.718487	262	342	8	2	80	0.0250000
NODE_11589_length_813_cov_26.718487	262	342	9	1	80	0.0125000
NODE_11589_length_813_cov_26.718487	262	342	11	11	80	0.1375000
NODE_11589_length_813_cov_26.718487	262	342	12	1	80	0.0125000
NODE_11589_length_813_cov_26.718487	262	342	14	14	80	0.1750000
NODE_11589_length_813_cov_26.718487	262	342	15	3	80	0.0375000
NODE_11589_length_813_cov_26.718487	262	342	16	7	80	0.0875000
NODE_11589_length_813_cov_26.718487	262	342	17	5	80	0.0625000
NODE_11589_length_813_cov_26.718487	262	342	19	22	80	0.2750000
NODE_11589_length_813_cov_26.718487	262	342	21	14	80	0.1750000
NODE_11590_length_813_cov_17.537815	335	415	1	7	80	0.0875000
NODE_11590_length_813_cov_17.537815	335	415	2	53	80	0.6625000
NODE_11590_length_813_cov_17.537815	335	415	3	20	80	0.2500000
NODE_11590_length_813_cov_17.537815	388	468	1	7	80	0.0875000
NODE_11590_length_813_cov_17.537815	388	468	2	33	80	0.4125000
NODE_11590_length_813_cov_17.537815	388	468	3	5	80	0.0625000
NODE_11590_length_813_cov_17.537815	388	468	4	35	80	0.4375000
NODE_11591_length_813_cov_14.243697	279	359	1	57	80	0.7125000
NODE_11591_length_813_cov_14.243697	279	359	2	23	80	0.2875000
NODE_11591_length_813_cov_14.243697	332	412	1	6	80	0.0750000
NODE_11591_length_813_cov_14.243697	332	412	2	74	80	0.9250000
NODE_11592_length_813_cov_13.984594	307	387	3	2	80	0.0250000
NODE_11592_length_813_cov_13.984594	307	387	5	54	80	0.6750000
NODE_11592_length_813_cov_13.984594	307	387	6	24	80	0.3000000
NODE_11592_length_813_cov_13.984594	360	440	3	10	80	0.1250000
NODE_11592_length_813_cov_13.984594	360	440	4	37	80	0.4625000
NODE_11592_length_813_cov_13.984594	360	440	5	3	80	0.0375000
NODE_11592_length_813_cov_13.984594	360	440	6	30	80	0.3750000
NODE_11593_length_813_cov_13.242297	336	416	0	51	80	0.6375000
NODE_11593_length_813_cov_13.242297	336	416	1	29	80	0.3625000
NODE_11593_length_813_cov_13.242297	389	469	1	80	80	1.0000000
NODE_11594_length_813_cov_11.985994	374	454	0	46	80	0.5750000
NODE_11594_length_813_cov_11.985994	374	454	1	34	80	0.4250000
NODE_11594_length_813_cov_11.985994	427	507	1	80	80	1.0000000
NODE_11595_length_813_cov_11.668067	279	359	7	4	80	0.0500000
NODE_11595_length_813_cov_11.668067	279	359	9	76	80	0.9500000
NODE_11595_length_813_cov_11.668067	332	412	8	1	80	0.0125000
NODE_11595_length_813_cov_11.668067	332	412	9	32	80	0.4000000
NODE_11595_length_813_cov_11.668067	332	412	10	10	80	0.1250000
NODE_11595_length_813_cov_11.668067	332	412	11	19	80	0.2375000
NODE_11595_length_813_cov_11.668067	332	412	12	6	80	0.0750000
NODE_11595_length_813_cov_11.668067	332	412	14	12	80	0.1500000
NODE_11596_length_813_cov_8.149860	538	618	5	80	80	1.0000000
NODE_11596_length_813_cov_8.149860	591	671	1	28	80	0.3500000
NODE_11596_length_813_cov_8.149860	591	671	2	2	80	0.0250000
NODE_11596_length_813_cov_8.149860	591	671	5	29	80	0.3625000
NODE_11596_length_813_cov_8.149860	591	671	6	21	80	0.2625000
NODE_11597_length_813_cov_7.098039	234	314	1	35	80	0.4375000
NODE_11597_length_813_cov_7.098039	234	314	2	16	80	0.2000000
NODE_11597_length_813_cov_7.098039	234	314	4	10	80	0.1250000
NODE_11597_length_813_cov_7.098039	234	314	5	19	80	0.2375000
NODE_11597_length_813_cov_7.098039	287	367	1	11	80	0.1375000
NODE_11597_length_813_cov_7.098039	287	367	2	31	80	0.3875000
NODE_11597_length_813_cov_7.098039	287	367	6	38	80	0.4750000
NODE_11613_length_812_cov_45.183731	435	515	4	6	80	0.0750000
NODE_11613_length_812_cov_45.183731	435	515	5	24	80	0.3000000
NODE_11613_length_812_cov_45.183731	435	515	6	50	80	0.6250000
NODE_11613_length_812_cov_45.183731	488	568	3	7	80	0.0875000
NODE_11613_length_812_cov_45.183731	488	568	4	52	80	0.6500000
NODE_11613_length_812_cov_45.183731	488	568	5	21	80	0.2625000
NODE_11614_length_812_cov_23.862553	386	466	7	7	80	0.0875000
NODE_11614_length_812_cov_23.862553	386	466	8	5	80	0.0625000
NODE_11614_length_812_cov_23.862553	386	466	9	4	80	0.0500000
NODE_11614_length_812_cov_23.862553	386	466	10	64	80	0.8000000
NODE_11614_length_812_cov_23.862553	439	519	7	3	80	0.0375000
NODE_11614_length_812_cov_23.862553	439	519	9	47	80	0.5875000
NODE_11614_length_812_cov_23.862553	439	519	10	30	80	0.3750000
NODE_11615_length_812_cov_23.516129	295	375	0	2	80	0.0250000
NODE_11615_length_812_cov_23.516129	295	375	5	78	80	0.9750000
NODE_11615_length_812_cov_23.516129	348	428	0	55	80	0.6875000
NODE_11615_length_812_cov_23.516129	348	428	5	25	80	0.3125000
NODE_11616_length_812_cov_15.577840	509	589	4	27	80	0.3375000
NODE_11616_length_812_cov_15.577840	509	589	5	24	80	0.3000000
NODE_11616_length_812_cov_15.577840	509	589	7	29	80	0.3625000
NODE_11616_length_812_cov_15.577840	562	644	3	4	82	0.0487805
NODE_11616_length_812_cov_15.577840	562	644	5	27	82	0.3292683
NODE_11616_length_812_cov_15.577840	562	644	7	51	82	0.6219512
NODE_11617_length_812_cov_13.277700	257	331	2	74	74	1.0000000
NODE_11617_length_812_cov_13.277700	304	384	0	16	80	0.2000000
NODE_11617_length_812_cov_13.277700	304	384	2	64	80	0.8000000
NODE_11619_length_812_cov_6.697055	309	389	2	31	80	0.3875000
NODE_11619_length_812_cov_6.697055	309	389	3	49	80	0.6125000
NODE_11619_length_812_cov_6.697055	362	442	2	7	80	0.0875000
NODE_11619_length_812_cov_6.697055	362	442	3	73	80	0.9125000
NODE_11642_length_811_cov_65.762640	418	492	10	35	74	0.4729730
NODE_11642_length_811_cov_65.762640	418	492	11	11	74	0.1486486
NODE_11642_length_811_cov_65.762640	418	492	12	8	74	0.1081081
NODE_11642_length_811_cov_65.762640	418	492	13	3	74	0.0405405
NODE_11642_length_811_cov_65.762640	418	492	14	17	74	0.2297297
NODE_11642_length_811_cov_65.762640	471	545	6	2	74	0.0270270
NODE_11642_length_811_cov_65.762640	471	545	8	2	74	0.0270270
NODE_11642_length_811_cov_65.762640	471	545	9	25	74	0.3378378
NODE_11642_length_811_cov_65.762640	471	545	10	22	74	0.2972973
NODE_11642_length_811_cov_65.762640	471	545	11	23	74	0.3108108
NODE_11643_length_811_cov_62.933989	457	537	14	5	80	0.0625000
NODE_11643_length_811_cov_62.933989	457	537	15	23	80	0.2875000
NODE_11643_length_811_cov_62.933989	457	537	16	2	80	0.0250000
NODE_11643_length_811_cov_62.933989	457	537	17	43	80	0.5375000
NODE_11643_length_811_cov_62.933989	457	537	18	7	80	0.0875000
NODE_11643_length_811_cov_62.933989	510	590	15	6	80	0.0750000
NODE_11643_length_811_cov_62.933989	510	590	17	41	80	0.5125000
NODE_11643_length_811_cov_62.933989	510	590	18	5	80	0.0625000
NODE_11643_length_811_cov_62.933989	510	590	19	6	80	0.0750000
NODE_11643_length_811_cov_62.933989	510	590	20	22	80	0.2750000
NODE_11644_length_811_cov_26.401685	397	477	9	34	80	0.4250000
NODE_11644_length_811_cov_26.401685	397	477	10	4	80	0.0500000
NODE_11644_length_811_cov_26.401685	397	477	11	22	80	0.2750000
NODE_11644_length_811_cov_26.401685	397	477	12	4	80	0.0500000
NODE_11644_length_811_cov_26.401685	397	477	13	2	80	0.0250000
NODE_11644_length_811_cov_26.401685	397	477	15	5	80	0.0625000
NODE_11644_length_811_cov_26.401685	397	477	16	9	80	0.1125000
NODE_11644_length_811_cov_26.401685	450	530	10	6	80	0.0750000
NODE_11644_length_811_cov_26.401685	450	530	11	15	80	0.1875000
NODE_11644_length_811_cov_26.401685	450	530	13	12	80	0.1500000
NODE_11644_length_811_cov_26.401685	450	530	15	38	80	0.4750000
NODE_11644_length_811_cov_26.401685	450	530	16	9	80	0.1125000
NODE_11645_length_811_cov_23.009831	189	269	3	80	80	1.0000000
NODE_11645_length_811_cov_23.009831	242	322	3	64	80	0.8000000
NODE_11645_length_811_cov_23.009831	242	322	6	16	80	0.2000000
NODE_11646_length_811_cov_20.523876	375	455	11	7	80	0.0875000
NODE_11646_length_811_cov_20.523876	375	455	13	40	80	0.5000000
NODE_11646_length_811_cov_20.523876	375	455	14	22	80	0.2750000
NODE_11646_length_811_cov_20.523876	375	455	15	11	80	0.1375000
NODE_11646_length_811_cov_20.523876	428	508	5	2	80	0.0250000
NODE_11646_length_811_cov_20.523876	428	508	6	7	80	0.0875000
NODE_11646_length_811_cov_20.523876	428	508	8	11	80	0.1375000
NODE_11646_length_811_cov_20.523876	428	508	9	1	80	0.0125000
NODE_11646_length_811_cov_20.523876	428	508	11	3	80	0.0375000
NODE_11646_length_811_cov_20.523876	428	508	13	27	80	0.3375000
NODE_11646_length_811_cov_20.523876	428	508	14	24	80	0.3000000
NODE_11646_length_811_cov_20.523876	428	508	15	5	80	0.0625000
NODE_11647_length_811_cov_17.386236	421	501	1	1	80	0.0125000
NODE_11647_length_811_cov_17.386236	421	501	2	12	80	0.1500000
NODE_11647_length_811_cov_17.386236	421	501	3	67	80	0.8375000
NODE_11647_length_811_cov_17.386236	474	554	2	20	80	0.2500000
NODE_11647_length_811_cov_17.386236	474	554	3	52	80	0.6500000
NODE_11647_length_811_cov_17.386236	474	554	4	8	80	0.1000000
NODE_11648_length_811_cov_15.279494	368	448	0	80	80	1.0000000
NODE_11648_length_811_cov_15.279494	421	502	0	81	81	1.0000000
NODE_11649_length_811_cov_14.543539	222	302	4	1	80	0.0125000
NODE_11649_length_811_cov_14.543539	222	302	5	10	80	0.1250000
NODE_11649_length_811_cov_14.543539	222	302	6	63	80	0.7875000
NODE_11649_length_811_cov_14.543539	222	302	7	6	80	0.0750000
NODE_11649_length_811_cov_14.543539	275	355	3	37	80	0.4625000
NODE_11649_length_811_cov_14.543539	275	355	4	17	80	0.2125000
NODE_11649_length_811_cov_14.543539	275	355	5	10	80	0.1250000
NODE_11649_length_811_cov_14.543539	275	355	6	16	80	0.2000000
NODE_11650_length_811_cov_12.196629	402	482	0	31	80	0.3875000
NODE_11650_length_811_cov_12.196629	402	482	1	35	80	0.4375000
NODE_11650_length_811_cov_12.196629	402	482	2	14	80	0.1750000
NODE_11650_length_811_cov_12.196629	455	535	0	13	80	0.1625000
NODE_11650_length_811_cov_12.196629	455	535	2	67	80	0.8375000
NODE_11651_length_811_cov_12.117978	289	369	0	80	80	1.0000000
NODE_11651_length_811_cov_12.117978	342	422	0	80	80	1.0000000
NODE_11652_length_811_cov_11.886236	330	410	5	15	80	0.1875000
NODE_11652_length_811_cov_11.886236	330	410	6	18	80	0.2250000
NODE_11652_length_811_cov_11.886236	330	410	7	6	80	0.0750000
NODE_11652_length_811_cov_11.886236	330	410	8	41	80	0.5125000
NODE_11652_length_811_cov_11.886236	383	463	3	14	80	0.1750000
NODE_11652_length_811_cov_11.886236	383	463	4	14	80	0.1750000
NODE_11652_length_811_cov_11.886236	383	463	6	21	80	0.2625000
NODE_11652_length_811_cov_11.886236	383	463	7	9	80	0.1125000
NODE_11652_length_811_cov_11.886236	383	463	8	22	80	0.2750000
NODE_11653_length_811_cov_10.602528	342	422	1	18	80	0.2250000
NODE_11653_length_811_cov_10.602528	342	422	2	62	80	0.7750000
NODE_11653_length_811_cov_10.602528	395	461	0	30	66	0.4545455
NODE_11653_length_811_cov_10.602528	395	461	1	27	66	0.4090909
NODE_11653_length_811_cov_10.602528	395	461	2	9	66	0.1363636
NODE_11653_length_811_cov_10.602528	452	519	0	67	67	1.0000000
NODE_11653_length_811_cov_10.602528	492	572	0	80	80	1.0000000
NODE_11654_length_811_cov_7.539326	324	404	0	43	80	0.5375000
NODE_11654_length_811_cov_7.539326	324	404	2	32	80	0.4000000
NODE_11654_length_811_cov_7.539326	324	404	3	5	80	0.0625000
NODE_11654_length_811_cov_7.539326	377	457	2	22	80	0.2750000
NODE_11654_length_811_cov_7.539326	377	457	3	43	80	0.5375000
NODE_11654_length_811_cov_7.539326	377	457	4	15	80	0.1875000
NODE_11655_length_811_cov_6.398876	419	499	0	80	80	1.0000000
NODE_11655_length_811_cov_6.398876	472	552	0	80	80	1.0000000
NODE_11657_length_811_cov_5.939607	496	527	0	3	31	0.0967742
NODE_11657_length_811_cov_5.939607	496	527	1	14	31	0.4516129
NODE_11657_length_811_cov_5.939607	496	527	2	14	31	0.4516129
NODE_11657_length_811_cov_5.939607	528	603	2	75	75	1.0000000
NODE_11669_length_811_cov_1.501404	645	676	0	31	31	1.0000000
NODE_11684_length_810_cov_42.358650	484	564	0	80	80	1.0000000
NODE_11684_length_810_cov_42.358650	537	617	0	80	80	1.0000000
NODE_11685_length_810_cov_38.604782	370	450	12	10	80	0.1250000
NODE_11685_length_810_cov_38.604782	370	450	14	3	80	0.0375000
NODE_11685_length_810_cov_38.604782	370	450	16	23	80	0.2875000
NODE_11685_length_810_cov_38.604782	370	450	21	5	80	0.0625000
NODE_11685_length_810_cov_38.604782	370	450	22	14	80	0.1750000
NODE_11685_length_810_cov_38.604782	370	450	25	5	80	0.0625000
NODE_11685_length_810_cov_38.604782	370	450	26	9	80	0.1125000
NODE_11685_length_810_cov_38.604782	370	450	37	1	80	0.0125000
NODE_11685_length_810_cov_38.604782	370	450	38	10	80	0.1250000
NODE_11685_length_810_cov_38.604782	423	499	21	4	76	0.0526316
NODE_11685_length_810_cov_38.604782	423	499	22	7	76	0.0921053
NODE_11685_length_810_cov_38.604782	423	499	23	9	76	0.1184211
NODE_11685_length_810_cov_38.604782	423	499	24	3	76	0.0394737
NODE_11685_length_810_cov_38.604782	423	499	25	22	76	0.2894737
NODE_11685_length_810_cov_38.604782	423	499	26	10	76	0.1315790
NODE_11685_length_810_cov_38.604782	423	499	28	1	76	0.0131579
NODE_11685_length_810_cov_38.604782	423	499	33	2	76	0.0263158
NODE_11685_length_810_cov_38.604782	423	499	34	1	76	0.0131579
NODE_11685_length_810_cov_38.604782	423	499	35	1	76	0.0131579
NODE_11685_length_810_cov_38.604782	423	499	37	1	76	0.0131579
NODE_11685_length_810_cov_38.604782	423	499	38	15	76	0.1973684
NODE_11686_length_810_cov_20.354430	338	418	9	4	80	0.0500000
NODE_11686_length_810_cov_20.354430	338	418	11	20	80	0.2500000
NODE_11686_length_810_cov_20.354430	338	418	12	37	80	0.4625000
NODE_11686_length_810_cov_20.354430	338	418	13	1	80	0.0125000
NODE_11686_length_810_cov_20.354430	338	418	14	18	80	0.2250000
NODE_11686_length_810_cov_20.354430	391	471	4	2	80	0.0250000
NODE_11686_length_810_cov_20.354430	391	471	5	6	80	0.0750000
NODE_11686_length_810_cov_20.354430	391	471	7	33	80	0.4125000
NODE_11686_length_810_cov_20.354430	391	471	9	13	80	0.1625000
NODE_11686_length_810_cov_20.354430	391	471	11	7	80	0.0875000
NODE_11686_length_810_cov_20.354430	391	471	12	6	80	0.0750000
NODE_11686_length_810_cov_20.354430	391	471	13	1	80	0.0125000
NODE_11686_length_810_cov_20.354430	391	471	14	12	80	0.1500000
NODE_11688_length_810_cov_12.367089	144	224	5	9	80	0.1125000
NODE_11688_length_810_cov_12.367089	144	224	6	36	80	0.4500000
NODE_11688_length_810_cov_12.367089	144	224	7	3	80	0.0375000
NODE_11688_length_810_cov_12.367089	144	224	9	10	80	0.1250000
NODE_11688_length_810_cov_12.367089	144	224	10	5	80	0.0625000
NODE_11688_length_810_cov_12.367089	144	224	11	17	80	0.2125000
NODE_11688_length_810_cov_12.367089	197	277	9	22	80	0.2750000
NODE_11688_length_810_cov_12.367089	197	277	10	14	80	0.1750000
NODE_11688_length_810_cov_12.367089	197	277	11	44	80	0.5500000
NODE_11689_length_810_cov_8.886076	333	399	2	11	66	0.1666667
NODE_11689_length_810_cov_8.886076	333	399	4	55	66	0.8333333
NODE_11690_length_810_cov_8.291139	446	526	0	80	80	1.0000000
NODE_11690_length_810_cov_8.291139	499	579	0	80	80	1.0000000
NODE_11692_length_810_cov_7.213783	335	406	3	71	71	1.0000000
NODE_11692_length_810_cov_7.213783	335	416	3	81	81	1.0000000
NODE_11692_length_810_cov_7.213783	379	459	0	28	80	0.3500000
NODE_11692_length_810_cov_7.213783	379	459	3	52	80	0.6500000
NODE_11714_length_809_cov_40.536620	428	500	0	7	72	0.0972222
NODE_11714_length_809_cov_40.536620	428	500	2	55	72	0.7638889
NODE_11714_length_809_cov_40.536620	428	500	4	10	72	0.1388889
NODE_11714_length_809_cov_40.536620	473	553	2	17	80	0.2125000
NODE_11714_length_809_cov_40.536620	473	553	4	13	80	0.1625000
NODE_11714_length_809_cov_40.536620	473	553	5	7	80	0.0875000
NODE_11714_length_809_cov_40.536620	473	553	7	19	80	0.2375000
NODE_11714_length_809_cov_40.536620	473	553	9	20	80	0.2500000
NODE_11714_length_809_cov_40.536620	473	553	11	4	80	0.0500000
NODE_11715_length_809_cov_15.871831	385	465	0	80	80	1.0000000
NODE_11715_length_809_cov_15.871831	402	465	0	63	63	1.0000000
NODE_11715_length_809_cov_15.871831	438	518	0	80	80	1.0000000
NODE_11715_length_809_cov_15.871831	438	518	0	80	80	1.0000000
NODE_11716_length_809_cov_15.019718	286	366	7	1	80	0.0125000
NODE_11716_length_809_cov_15.019718	286	366	8	4	80	0.0500000
NODE_11716_length_809_cov_15.019718	286	366	9	21	80	0.2625000
NODE_11716_length_809_cov_15.019718	286	366	10	6	80	0.0750000
NODE_11716_length_809_cov_15.019718	286	366	11	44	80	0.5500000
NODE_11716_length_809_cov_15.019718	286	366	12	4	80	0.0500000
NODE_11716_length_809_cov_15.019718	339	419	7	1	80	0.0125000
NODE_11716_length_809_cov_15.019718	339	419	9	38	80	0.4750000
NODE_11716_length_809_cov_15.019718	339	419	10	25	80	0.3125000
NODE_11716_length_809_cov_15.019718	339	419	11	12	80	0.1500000
NODE_11716_length_809_cov_15.019718	339	419	12	4	80	0.0500000
NODE_11718_length_809_cov_4.483099	244	324	0	80	80	1.0000000
NODE_11718_length_809_cov_4.483099	278	324	0	46	46	1.0000000
NODE_11718_length_809_cov_4.483099	298	377	0	79	79	1.0000000
NODE_11718_length_809_cov_4.483099	308	377	0	69	69	1.0000000
NODE_11738_length_808_cov_45.023977	325	405	6	25	80	0.3125000
NODE_11738_length_808_cov_45.023977	325	405	7	39	80	0.4875000
NODE_11738_length_808_cov_45.023977	325	405	8	10	80	0.1250000
NODE_11738_length_808_cov_45.023977	325	405	9	6	80	0.0750000
NODE_11738_length_808_cov_45.023977	378	458	5	19	80	0.2375000
NODE_11738_length_808_cov_45.023977	378	458	6	12	80	0.1500000
NODE_11738_length_808_cov_45.023977	378	458	7	49	80	0.6125000
NODE_11739_length_808_cov_24.087447	287	367	9	77	80	0.9625000
NODE_11739_length_808_cov_24.087447	287	367	16	3	80	0.0375000
NODE_11739_length_808_cov_24.087447	340	420	0	33	80	0.4125000
NODE_11739_length_808_cov_24.087447	340	420	9	47	80	0.5875000
NODE_11740_length_808_cov_21.867419	324	404	7	57	80	0.7125000
NODE_11740_length_808_cov_21.867419	324	404	8	22	80	0.2750000
NODE_11740_length_808_cov_21.867419	324	404	10	1	80	0.0125000
NODE_11740_length_808_cov_21.867419	377	457	7	22	80	0.2750000
NODE_11740_length_808_cov_21.867419	377	457	8	57	80	0.7125000
NODE_11740_length_808_cov_21.867419	377	457	10	1	80	0.0125000
NODE_11741_length_808_cov_16.289140	333	413	4	46	80	0.5750000
NODE_11741_length_808_cov_16.289140	333	413	5	1	80	0.0125000
NODE_11741_length_808_cov_16.289140	333	413	6	33	80	0.4125000
NODE_11741_length_808_cov_16.289140	386	466	4	3	80	0.0375000
NODE_11741_length_808_cov_16.289140	386	466	5	1	80	0.0125000
NODE_11741_length_808_cov_16.289140	386	466	6	69	80	0.8625000
NODE_11741_length_808_cov_16.289140	386	466	7	1	80	0.0125000
NODE_11741_length_808_cov_16.289140	386	466	8	6	80	0.0750000
NODE_11742_length_808_cov_14.489422	307	387	0	80	80	1.0000000
NODE_11742_length_808_cov_14.489422	360	440	0	80	80	1.0000000
NODE_11744_length_808_cov_10.507757	317	397	0	80	80	1.0000000
NODE_11744_length_808_cov_10.507757	370	450	0	80	80	1.0000000
NODE_11745_length_808_cov_10.066291	483	563	3	9	80	0.1125000
NODE_11745_length_808_cov_10.066291	483	563	5	15	80	0.1875000
NODE_11745_length_808_cov_10.066291	483	563	7	56	80	0.7000000
NODE_11745_length_808_cov_10.066291	536	616	2	34	80	0.4250000
NODE_11745_length_808_cov_10.066291	536	616	3	28	80	0.3500000
NODE_11745_length_808_cov_10.066291	536	616	7	18	80	0.2250000
NODE_11746_length_808_cov_7.581100	358	438	0	24	80	0.3000000
NODE_11746_length_808_cov_7.581100	358	438	1	56	80	0.7000000
NODE_11746_length_808_cov_7.581100	411	491	0	77	80	0.9625000
NODE_11746_length_808_cov_7.581100	411	491	1	3	80	0.0375000
NODE_11756_length_808_cov_3.283498	471	551	1	9	80	0.1125000
NODE_11756_length_808_cov_3.283498	471	551	2	22	80	0.2750000
NODE_11756_length_808_cov_3.283498	471	551	3	37	80	0.4625000
NODE_11756_length_808_cov_3.283498	471	551	4	12	80	0.1500000
NODE_11756_length_808_cov_3.283498	524	604	3	19	80	0.2375000
NODE_11756_length_808_cov_3.283498	524	604	4	61	80	0.7625000
NODE_11783_length_807_cov_67.341808	2	25	1	6	23	0.2608696
NODE_11783_length_807_cov_67.341808	2	25	2	17	23	0.7391304
NODE_11783_length_807_cov_67.341808	339	370	19	1	31	0.0322581
NODE_11783_length_807_cov_67.341808	339	370	20	7	31	0.2258064
NODE_11783_length_807_cov_67.341808	339	370	21	18	31	0.5806451
NODE_11783_length_807_cov_67.341808	339	370	22	3	31	0.0967742
NODE_11783_length_807_cov_67.341808	339	370	23	2	31	0.0645161
NODE_11783_length_807_cov_67.341808	343	423	20	4	80	0.0500000
NODE_11783_length_807_cov_67.341808	343	423	21	18	80	0.2250000
NODE_11783_length_807_cov_67.341808	343	423	22	3	80	0.0375000
NODE_11783_length_807_cov_67.341808	343	423	23	16	80	0.2000000
NODE_11783_length_807_cov_67.341808	343	423	24	1	80	0.0125000
NODE_11783_length_807_cov_67.341808	343	423	26	1	80	0.0125000
NODE_11783_length_807_cov_67.341808	343	423	27	2	80	0.0250000
NODE_11783_length_807_cov_67.341808	343	423	28	25	80	0.3125000
NODE_11783_length_807_cov_67.341808	343	423	29	10	80	0.1250000
NODE_11784_length_807_cov_54.980226	683	749	24	4	66	0.0606061
NODE_11784_length_807_cov_54.980226	683	749	25	24	66	0.3636364
NODE_11784_length_807_cov_54.980226	683	749	28	11	66	0.1666667
NODE_11784_length_807_cov_54.980226	683	749	29	12	66	0.1818182
NODE_11784_length_807_cov_54.980226	683	749	30	11	66	0.1666667
NODE_11784_length_807_cov_54.980226	683	749	31	4	66	0.0606061
NODE_11784_length_807_cov_54.980226	727	802	8	2	75	0.0266667
NODE_11784_length_807_cov_54.980226	727	802	9	4	75	0.0533333
NODE_11784_length_807_cov_54.980226	727	802	10	5	75	0.0666667
NODE_11784_length_807_cov_54.980226	727	802	11	4	75	0.0533333
NODE_11784_length_807_cov_54.980226	727	802	13	1	75	0.0133333
NODE_11784_length_807_cov_54.980226	727	802	15	8	75	0.1066667
NODE_11784_length_807_cov_54.980226	727	802	17	2	75	0.0266667
NODE_11784_length_807_cov_54.980226	727	802	18	9	75	0.1200000
NODE_11784_length_807_cov_54.980226	727	802	21	12	75	0.1600000
NODE_11784_length_807_cov_54.980226	727	802	23	5	75	0.0666667
NODE_11784_length_807_cov_54.980226	727	802	24	5	75	0.0666667
NODE_11784_length_807_cov_54.980226	727	802	25	18	75	0.2400000
NODE_11785_length_807_cov_37.306497	435	515	11	12	80	0.1500000
NODE_11785_length_807_cov_37.306497	435	515	15	68	80	0.8500000
NODE_11785_length_807_cov_37.306497	488	568	3	11	80	0.1375000
NODE_11785_length_807_cov_37.306497	488	568	4	1	80	0.0125000
NODE_11785_length_807_cov_37.306497	488	568	8	40	80	0.5000000
NODE_11785_length_807_cov_37.306497	488	568	11	13	80	0.1625000
NODE_11785_length_807_cov_37.306497	488	568	15	15	80	0.1875000
NODE_11786_length_807_cov_31.177966	287	367	7	28	80	0.3500000
NODE_11786_length_807_cov_31.177966	287	367	8	10	80	0.1250000
NODE_11786_length_807_cov_31.177966	287	367	9	30	80	0.3750000
NODE_11786_length_807_cov_31.177966	287	367	11	12	80	0.1500000
NODE_11786_length_807_cov_31.177966	340	420	7	5	80	0.0625000
NODE_11786_length_807_cov_31.177966	340	420	9	16	80	0.2000000
NODE_11786_length_807_cov_31.177966	340	420	10	14	80	0.1750000
NODE_11786_length_807_cov_31.177966	340	420	11	27	80	0.3375000
NODE_11786_length_807_cov_31.177966	340	420	12	18	80	0.2250000
NODE_11787_length_807_cov_30.638418	250	329	5	9	79	0.1139240
NODE_11787_length_807_cov_30.638418	250	329	6	3	79	0.0379747
NODE_11787_length_807_cov_30.638418	250	329	7	37	79	0.4683544
NODE_11787_length_807_cov_30.638418	250	329	8	28	79	0.3544304
NODE_11787_length_807_cov_30.638418	250	329	9	2	79	0.0253165
NODE_11787_length_807_cov_30.638418	302	382	4	10	80	0.1250000
NODE_11787_length_807_cov_30.638418	302	382	5	48	80	0.6000000
NODE_11787_length_807_cov_30.638418	302	382	6	4	80	0.0500000
NODE_11787_length_807_cov_30.638418	302	382	7	11	80	0.1375000
NODE_11787_length_807_cov_30.638418	302	382	8	5	80	0.0625000
NODE_11787_length_807_cov_30.638418	302	382	9	2	80	0.0250000
NODE_11787_length_807_cov_30.638418	378	458	5	20	80	0.2500000
NODE_11787_length_807_cov_30.638418	378	458	6	25	80	0.3125000
NODE_11787_length_807_cov_30.638418	378	458	7	8	80	0.1000000
NODE_11787_length_807_cov_30.638418	378	458	8	2	80	0.0250000
NODE_11787_length_807_cov_30.638418	378	458	9	15	80	0.1875000
NODE_11787_length_807_cov_30.638418	378	458	10	10	80	0.1250000
NODE_11787_length_807_cov_30.638418	431	511	8	50	80	0.6250000
NODE_11787_length_807_cov_30.638418	431	511	9	15	80	0.1875000
NODE_11787_length_807_cov_30.638418	431	511	10	15	80	0.1875000
NODE_11788_length_807_cov_29.725989	362	442	2	80	80	1.0000000
NODE_11788_length_807_cov_29.725989	415	495	1	31	80	0.3875000
NODE_11788_length_807_cov_29.725989	415	495	2	49	80	0.6125000
NODE_11789_length_807_cov_23.200565	441	521	8	5	80	0.0625000
NODE_11789_length_807_cov_23.200565	441	521	9	22	80	0.2750000
NODE_11789_length_807_cov_23.200565	441	521	10	28	80	0.3500000
NODE_11789_length_807_cov_23.200565	441	521	11	9	80	0.1125000
NODE_11789_length_807_cov_23.200565	441	521	12	16	80	0.2000000
NODE_11789_length_807_cov_23.200565	494	574	8	9	80	0.1125000
NODE_11789_length_807_cov_23.200565	494	574	9	10	80	0.1250000
NODE_11789_length_807_cov_23.200565	494	574	10	48	80	0.6000000
NODE_11789_length_807_cov_23.200565	494	574	11	8	80	0.1000000
NODE_11789_length_807_cov_23.200565	494	574	12	5	80	0.0625000
NODE_11790_length_807_cov_21.888418	319	386	2	30	67	0.4477612
NODE_11790_length_807_cov_21.888418	319	386	3	6	67	0.0895522
NODE_11790_length_807_cov_21.888418	319	386	5	31	67	0.4626866
NODE_11790_length_807_cov_21.888418	390	440	0	6	50	0.1200000
NODE_11790_length_807_cov_21.888418	390	440	2	19	50	0.3800000
NODE_11790_length_807_cov_21.888418	390	440	3	22	50	0.4400000
NODE_11790_length_807_cov_21.888418	390	440	4	3	50	0.0600000
NODE_11791_length_807_cov_17.480226	339	419	2	44	80	0.5500000
NODE_11791_length_807_cov_17.480226	339	419	3	1	80	0.0125000
NODE_11791_length_807_cov_17.480226	339	419	4	35	80	0.4375000
NODE_11791_length_807_cov_17.480226	392	472	2	47	80	0.5875000
NODE_11791_length_807_cov_17.480226	392	472	3	1	80	0.0125000
NODE_11791_length_807_cov_17.480226	392	472	4	32	80	0.4000000
NODE_11792_length_807_cov_14.895480	350	430	4	36	80	0.4500000
NODE_11792_length_807_cov_14.895480	350	430	5	44	80	0.5500000
NODE_11792_length_807_cov_14.895480	403	483	4	32	80	0.4000000
NODE_11792_length_807_cov_14.895480	403	483	5	48	80	0.6000000
NODE_11794_length_807_cov_12.255650	440	520	3	38	80	0.4750000
NODE_11794_length_807_cov_12.255650	440	520	4	42	80	0.5250000
NODE_11794_length_807_cov_12.255650	493	573	3	29	80	0.3625000
NODE_11794_length_807_cov_12.255650	493	573	4	51	80	0.6375000
NODE_11795_length_807_cov_11.129944	359	439	8	3	80	0.0375000
NODE_11795_length_807_cov_11.129944	359	439	9	16	80	0.2000000
NODE_11795_length_807_cov_11.129944	359	439	10	61	80	0.7625000
NODE_11795_length_807_cov_11.129944	412	492	1	20	80	0.2500000
NODE_11795_length_807_cov_11.129944	412	492	2	6	80	0.0750000
NODE_11795_length_807_cov_11.129944	412	492	6	7	80	0.0875000
NODE_11795_length_807_cov_11.129944	412	492	8	23	80	0.2875000
NODE_11795_length_807_cov_11.129944	412	492	9	16	80	0.2000000
NODE_11795_length_807_cov_11.129944	412	492	10	8	80	0.1000000
NODE_11801_length_807_cov_3.847458	322	385	0	63	63	1.0000000
NODE_11822_length_806_cov_35.650636	397	477	17	13	80	0.1625000
NODE_11822_length_806_cov_35.650636	397	477	18	4	80	0.0500000
NODE_11822_length_806_cov_35.650636	397	477	20	11	80	0.1375000
NODE_11822_length_806_cov_35.650636	397	477	21	10	80	0.1250000
NODE_11822_length_806_cov_35.650636	397	477	22	6	80	0.0750000
NODE_11822_length_806_cov_35.650636	397	477	24	17	80	0.2125000
NODE_11822_length_806_cov_35.650636	397	477	25	19	80	0.2375000
NODE_11822_length_806_cov_35.650636	450	530	20	5	80	0.0625000
NODE_11822_length_806_cov_35.650636	450	530	21	1	80	0.0125000
NODE_11822_length_806_cov_35.650636	450	530	22	1	80	0.0125000
NODE_11822_length_806_cov_35.650636	450	530	23	17	80	0.2125000
NODE_11822_length_806_cov_35.650636	450	530	24	20	80	0.2500000
NODE_11822_length_806_cov_35.650636	450	530	25	21	80	0.2625000
NODE_11822_length_806_cov_35.650636	450	530	26	15	80	0.1875000
NODE_11822_length_806_cov_35.650636	526	606	16	15	80	0.1875000
NODE_11822_length_806_cov_35.650636	526	606	18	5	80	0.0625000
NODE_11822_length_806_cov_35.650636	526	606	19	4	80	0.0500000
NODE_11822_length_806_cov_35.650636	526	606	20	18	80	0.2250000
NODE_11822_length_806_cov_35.650636	526	606	22	17	80	0.2125000
NODE_11822_length_806_cov_35.650636	526	606	23	11	80	0.1375000
NODE_11822_length_806_cov_35.650636	526	606	24	10	80	0.1250000
NODE_11822_length_806_cov_35.650636	579	667	8	23	88	0.2613636
NODE_11822_length_806_cov_35.650636	579	667	9	9	88	0.1022727
NODE_11822_length_806_cov_35.650636	579	667	10	4	88	0.0454545
NODE_11822_length_806_cov_35.650636	579	667	11	5	88	0.0568182
NODE_11822_length_806_cov_35.650636	579	667	12	4	88	0.0454545
NODE_11822_length_806_cov_35.650636	579	667	13	3	88	0.0340909
NODE_11822_length_806_cov_35.650636	579	667	14	1	88	0.0113636
NODE_11822_length_806_cov_35.650636	579	667	15	2	88	0.0227273
NODE_11822_length_806_cov_35.650636	579	667	16	25	88	0.2840909
NODE_11822_length_806_cov_35.650636	579	667	18	1	88	0.0113636
NODE_11822_length_806_cov_35.650636	579	667	19	4	88	0.0454545
NODE_11822_length_806_cov_35.650636	579	667	20	7	88	0.0795455
NODE_11823_length_806_cov_29.615276	377	457	8	8	80	0.1000000
NODE_11823_length_806_cov_29.615276	377	457	10	1	80	0.0125000
NODE_11823_length_806_cov_29.615276	377	457	11	18	80	0.2250000
NODE_11823_length_806_cov_29.615276	377	457	12	2	80	0.0250000
NODE_11823_length_806_cov_29.615276	377	457	14	8	80	0.1000000
NODE_11823_length_806_cov_29.615276	377	457	16	6	80	0.0750000
NODE_11823_length_806_cov_29.615276	377	457	17	14	80	0.1750000
NODE_11823_length_806_cov_29.615276	377	457	18	23	80	0.2875000
NODE_11823_length_806_cov_29.615276	430	510	7	18	80	0.2250000
NODE_11823_length_806_cov_29.615276	430	510	8	40	80	0.5000000
NODE_11823_length_806_cov_29.615276	430	510	9	3	80	0.0375000
NODE_11823_length_806_cov_29.615276	430	510	10	1	80	0.0125000
NODE_11823_length_806_cov_29.615276	430	510	11	18	80	0.2250000
NODE_11824_length_806_cov_23.680339	394	474	10	2	80	0.0250000
NODE_11824_length_806_cov_23.680339	394	474	13	13	80	0.1625000
NODE_11824_length_806_cov_23.680339	394	474	14	12	80	0.1500000
NODE_11824_length_806_cov_23.680339	394	474	16	53	80	0.6625000
NODE_11824_length_806_cov_23.680339	447	527	5	9	80	0.1125000
NODE_11824_length_806_cov_23.680339	447	527	8	27	80	0.3375000
NODE_11824_length_806_cov_23.680339	447	527	10	19	80	0.2375000
NODE_11824_length_806_cov_23.680339	447	527	13	13	80	0.1625000
NODE_11824_length_806_cov_23.680339	447	527	16	12	80	0.1500000
NODE_11825_length_806_cov_19.107496	239	293	2	54	54	1.0000000
NODE_11825_length_806_cov_19.107496	248	293	2	45	45	1.0000000
NODE_11825_length_806_cov_19.107496	266	345	2	48	79	0.6075949
NODE_11825_length_806_cov_19.107496	266	345	4	21	79	0.2658228
NODE_11825_length_806_cov_19.107496	266	345	5	8	79	0.1012658
NODE_11825_length_806_cov_19.107496	266	345	6	2	79	0.0253165
NODE_11825_length_806_cov_19.107496	266	345	2	48	79	0.6075949
NODE_11825_length_806_cov_19.107496	266	345	4	21	79	0.2658228
NODE_11825_length_806_cov_19.107496	266	345	5	8	79	0.1012658
NODE_11825_length_806_cov_19.107496	266	345	6	2	79	0.0253165
NODE_11825_length_806_cov_19.107496	421	501	7	19	80	0.2375000
NODE_11825_length_806_cov_19.107496	421	501	8	9	80	0.1125000
NODE_11825_length_806_cov_19.107496	421	501	9	21	80	0.2625000
NODE_11825_length_806_cov_19.107496	421	501	10	22	80	0.2750000
NODE_11825_length_806_cov_19.107496	421	501	12	9	80	0.1125000
NODE_11826_length_806_cov_17.551627	308	388	2	80	80	1.0000000
NODE_11826_length_806_cov_17.551627	361	441	1	45	80	0.5625000
NODE_11826_length_806_cov_17.551627	361	441	2	35	80	0.4375000
NODE_11827_length_806_cov_15.608204	408	488	1	22	80	0.2750000
NODE_11827_length_806_cov_15.608204	408	488	2	58	80	0.7250000
NODE_11827_length_806_cov_15.608204	461	543	2	82	82	1.0000000
NODE_11864_length_805_cov_94.121813	398	478	17	4	80	0.0500000
NODE_11864_length_805_cov_94.121813	398	478	19	10	80	0.1250000
NODE_11864_length_805_cov_94.121813	398	478	20	4	80	0.0500000
NODE_11864_length_805_cov_94.121813	398	478	21	16	80	0.2000000
NODE_11864_length_805_cov_94.121813	398	478	22	20	80	0.2500000
NODE_11864_length_805_cov_94.121813	398	478	23	6	80	0.0750000
NODE_11864_length_805_cov_94.121813	398	478	24	7	80	0.0875000
NODE_11864_length_805_cov_94.121813	398	478	25	5	80	0.0625000
NODE_11864_length_805_cov_94.121813	398	478	26	8	80	0.1000000
NODE_11864_length_805_cov_94.121813	451	531	11	5	80	0.0625000
NODE_11864_length_805_cov_94.121813	451	531	14	8	80	0.1000000
NODE_11864_length_805_cov_94.121813	451	531	15	24	80	0.3000000
NODE_11864_length_805_cov_94.121813	451	531	18	13	80	0.1625000
NODE_11864_length_805_cov_94.121813	451	531	19	9	80	0.1125000
NODE_11864_length_805_cov_94.121813	451	531	23	6	80	0.0750000
NODE_11864_length_805_cov_94.121813	451	531	24	6	80	0.0750000
NODE_11864_length_805_cov_94.121813	451	531	25	1	80	0.0125000
NODE_11864_length_805_cov_94.121813	451	531	26	8	80	0.1000000
NODE_11865_length_805_cov_54.001416	284	364	4	18	80	0.2250000
NODE_11865_length_805_cov_54.001416	284	364	26	57	80	0.7125000
NODE_11865_length_805_cov_54.001416	284	364	27	5	80	0.0625000
NODE_11865_length_805_cov_54.001416	337	417	24	1	80	0.0125000
NODE_11865_length_805_cov_54.001416	337	417	25	20	80	0.2500000
NODE_11865_length_805_cov_54.001416	337	417	26	59	80	0.7375000
NODE_11865_length_805_cov_54.001416	413	493	3	14	80	0.1750000
NODE_11865_length_805_cov_54.001416	413	493	4	27	80	0.3375000
NODE_11865_length_805_cov_54.001416	413	493	26	39	80	0.4875000
NODE_11865_length_805_cov_54.001416	466	546	4	49	80	0.6125000
NODE_11865_length_805_cov_54.001416	466	546	5	31	80	0.3875000
NODE_11866_length_805_cov_42.325779	377	457	2	2	80	0.0250000
NODE_11866_length_805_cov_42.325779	377	457	4	28	80	0.3500000
NODE_11866_length_805_cov_42.325779	377	457	5	7	80	0.0875000
NODE_11866_length_805_cov_42.325779	377	457	6	13	80	0.1625000
NODE_11866_length_805_cov_42.325779	377	457	8	30	80	0.3750000
NODE_11866_length_805_cov_42.325779	430	510	2	15	80	0.1875000
NODE_11866_length_805_cov_42.325779	430	510	3	1	80	0.0125000
NODE_11866_length_805_cov_42.325779	430	510	4	49	80	0.6125000
NODE_11866_length_805_cov_42.325779	430	510	5	7	80	0.0875000
NODE_11866_length_805_cov_42.325779	430	510	6	8	80	0.1000000
NODE_11867_length_805_cov_36.742210	345	425	4	68	80	0.8500000
NODE_11867_length_805_cov_36.742210	345	425	8	12	80	0.1500000
NODE_11867_length_805_cov_36.742210	398	478	4	72	80	0.9000000
NODE_11867_length_805_cov_36.742210	398	478	8	8	80	0.1000000
NODE_11868_length_805_cov_25.879603	361	441	3	10	80	0.1250000
NODE_11868_length_805_cov_25.879603	361	441	4	70	80	0.8750000
NODE_11868_length_805_cov_25.879603	414	494	1	9	80	0.1125000
NODE_11868_length_805_cov_25.879603	414	494	3	14	80	0.1750000
NODE_11868_length_805_cov_25.879603	414	494	4	57	80	0.7125000
NODE_11869_length_805_cov_25.048159	306	386	4	5	80	0.0625000
NODE_11869_length_805_cov_25.048159	306	386	5	45	80	0.5625000
NODE_11869_length_805_cov_25.048159	306	386	6	15	80	0.1875000
NODE_11869_length_805_cov_25.048159	306	386	8	15	80	0.1875000
NODE_11869_length_805_cov_25.048159	359	439	6	12	80	0.1500000
NODE_11869_length_805_cov_25.048159	359	439	7	44	80	0.5500000
NODE_11869_length_805_cov_25.048159	359	439	8	24	80	0.3000000
NODE_11870_length_805_cov_15.453258	311	391	2	6	80	0.0750000
NODE_11870_length_805_cov_15.453258	311	391	3	4	80	0.0500000
NODE_11870_length_805_cov_15.453258	311	391	4	42	80	0.5250000
NODE_11870_length_805_cov_15.453258	311	391	5	28	80	0.3500000
NODE_11870_length_805_cov_15.453258	364	444	3	15	80	0.1875000
NODE_11870_length_805_cov_15.453258	364	444	4	42	80	0.5250000
NODE_11870_length_805_cov_15.453258	364	444	5	23	80	0.2875000
NODE_11871_length_805_cov_14.930595	264	344	0	42	80	0.5250000
NODE_11871_length_805_cov_14.930595	264	344	1	12	80	0.1500000
NODE_11871_length_805_cov_14.930595	264	344	2	21	80	0.2625000
NODE_11871_length_805_cov_14.930595	264	344	3	5	80	0.0625000
NODE_11871_length_805_cov_14.930595	317	397	1	1	80	0.0125000
NODE_11871_length_805_cov_14.930595	317	397	2	21	80	0.2625000
NODE_11871_length_805_cov_14.930595	317	397	3	7	80	0.0875000
NODE_11871_length_805_cov_14.930595	317	397	4	51	80	0.6375000
NODE_11872_length_805_cov_10.888102	259	339	2	8	80	0.1000000
NODE_11872_length_805_cov_10.888102	259	339	3	72	80	0.9000000
NODE_11872_length_805_cov_10.888102	312	392	0	43	80	0.5375000
NODE_11872_length_805_cov_10.888102	312	392	2	18	80	0.2250000
NODE_11872_length_805_cov_10.888102	312	392	3	19	80	0.2375000
NODE_11873_length_805_cov_10.716714	348	428	3	80	80	1.0000000
NODE_11873_length_805_cov_10.716714	401	481	1	5	80	0.0625000
NODE_11873_length_805_cov_10.716714	401	481	3	59	80	0.7375000
NODE_11873_length_805_cov_10.716714	401	481	4	16	80	0.2000000
NODE_11876_length_805_cov_7.212465	374	454	5	55	80	0.6875000
NODE_11876_length_805_cov_7.212465	374	454	6	25	80	0.3125000
NODE_11876_length_805_cov_7.212465	427	507	5	80	80	1.0000000
NODE_11877_length_805_cov_5.637394	323	403	0	80	80	1.0000000
NODE_11877_length_805_cov_5.637394	376	456	0	80	80	1.0000000
NODE_11878_length_805_cov_4.001416	304	384	2	80	80	1.0000000
NODE_11878_length_805_cov_4.001416	357	437	1	39	80	0.4875000
NODE_11878_length_805_cov_4.001416	357	437	2	41	80	0.5125000
NODE_11903_length_804_cov_26.204255	319	399	2	6	80	0.0750000
NODE_11903_length_804_cov_26.204255	319	399	4	2	80	0.0250000
NODE_11903_length_804_cov_26.204255	319	399	6	41	80	0.5125000
NODE_11903_length_804_cov_26.204255	319	399	9	31	80	0.3875000
NODE_11903_length_804_cov_26.204255	372	452	7	1	80	0.0125000
NODE_11903_length_804_cov_26.204255	372	452	8	2	80	0.0250000
NODE_11903_length_804_cov_26.204255	372	452	9	77	80	0.9625000
NODE_11904_length_804_cov_25.978723	242	322	4	4	80	0.0500000
NODE_11904_length_804_cov_25.978723	242	322	5	40	80	0.5000000
NODE_11904_length_804_cov_25.978723	242	322	6	36	80	0.4500000
NODE_11904_length_804_cov_25.978723	295	375	5	44	80	0.5500000
NODE_11904_length_804_cov_25.978723	295	375	6	29	80	0.3625000
NODE_11904_length_804_cov_25.978723	295	375	7	6	80	0.0750000
NODE_11904_length_804_cov_25.978723	295	375	8	1	80	0.0125000
NODE_11904_length_804_cov_25.978723	371	451	5	41	80	0.5125000
NODE_11904_length_804_cov_25.978723	371	451	6	22	80	0.2750000
NODE_11904_length_804_cov_25.978723	371	451	7	6	80	0.0750000
NODE_11904_length_804_cov_25.978723	371	451	8	11	80	0.1375000
NODE_11904_length_804_cov_25.978723	424	504	5	50	80	0.6250000
NODE_11904_length_804_cov_25.978723	424	504	6	23	80	0.2875000
NODE_11904_length_804_cov_25.978723	424	504	7	7	80	0.0875000
NODE_11905_length_804_cov_25.628369	444	524	0	9	80	0.1125000
NODE_11905_length_804_cov_25.628369	444	524	1	14	80	0.1750000
NODE_11905_length_804_cov_25.628369	444	524	2	11	80	0.1375000
NODE_11905_length_804_cov_25.628369	444	524	6	3	80	0.0375000
NODE_11905_length_804_cov_25.628369	444	524	15	43	80	0.5375000
NODE_11905_length_804_cov_25.628369	497	577	15	80	80	1.0000000
NODE_11906_length_804_cov_22.438298	269	349	0	4	80	0.0500000
NODE_11906_length_804_cov_22.438298	269	349	1	76	80	0.9500000
NODE_11906_length_804_cov_22.438298	322	402	0	57	80	0.7125000
NODE_11906_length_804_cov_22.438298	322	402	1	23	80	0.2875000
NODE_11907_length_804_cov_17.425532	273	353	10	32	80	0.4000000
NODE_11907_length_804_cov_17.425532	273	353	11	12	80	0.1500000
NODE_11907_length_804_cov_17.425532	273	353	12	13	80	0.1625000
NODE_11907_length_804_cov_17.425532	273	353	13	19	80	0.2375000
NODE_11907_length_804_cov_17.425532	273	353	14	4	80	0.0500000
NODE_11907_length_804_cov_17.425532	326	406	8	26	80	0.3250000
NODE_11907_length_804_cov_17.425532	326	406	9	10	80	0.1250000
NODE_11907_length_804_cov_17.425532	326	406	11	4	80	0.0500000
NODE_11907_length_804_cov_17.425532	326	406	13	30	80	0.3750000
NODE_11907_length_804_cov_17.425532	326	406	14	10	80	0.1250000
NODE_11908_length_804_cov_16.849645	229	309	0	12	80	0.1500000
NODE_11908_length_804_cov_16.849645	229	309	1	61	80	0.7625000
NODE_11908_length_804_cov_16.849645	229	309	2	7	80	0.0875000
NODE_11908_length_804_cov_16.849645	282	362	0	65	80	0.8125000
NODE_11908_length_804_cov_16.849645	282	362	1	15	80	0.1875000
NODE_11909_length_804_cov_16.024113	499	579	3	1	80	0.0125000
NODE_11909_length_804_cov_16.024113	499	579	4	74	80	0.9250000
NODE_11909_length_804_cov_16.024113	499	579	5	5	80	0.0625000
NODE_11909_length_804_cov_16.024113	552	632	3	16	80	0.2000000
NODE_11909_length_804_cov_16.024113	552	632	4	64	80	0.8000000
NODE_11910_length_804_cov_14.567376	375	455	0	80	80	1.0000000
NODE_11910_length_804_cov_14.567376	428	508	0	80	80	1.0000000
NODE_11911_length_804_cov_14.011348	262	342	14	2	80	0.0250000
NODE_11911_length_804_cov_14.011348	262	342	15	2	80	0.0250000
NODE_11911_length_804_cov_14.011348	262	342	16	5	80	0.0625000
NODE_11911_length_804_cov_14.011348	262	342	17	1	80	0.0125000
NODE_11911_length_804_cov_14.011348	262	342	18	4	80	0.0500000
NODE_11911_length_804_cov_14.011348	262	342	19	24	80	0.3000000
NODE_11911_length_804_cov_14.011348	262	342	22	16	80	0.2000000
NODE_11911_length_804_cov_14.011348	262	342	23	10	80	0.1250000
NODE_11911_length_804_cov_14.011348	262	342	24	3	80	0.0375000
NODE_11911_length_804_cov_14.011348	262	342	25	13	80	0.1625000
NODE_11911_length_804_cov_14.011348	315	395	21	16	80	0.2000000
NODE_11911_length_804_cov_14.011348	315	395	22	8	80	0.1000000
NODE_11911_length_804_cov_14.011348	315	395	23	32	80	0.4000000
NODE_11911_length_804_cov_14.011348	315	395	24	5	80	0.0625000
NODE_11911_length_804_cov_14.011348	315	395	25	19	80	0.2375000
NODE_11912_length_804_cov_13.800000	289	318	0	10	29	0.3448276
NODE_11912_length_804_cov_13.800000	289	318	1	19	29	0.6551724
NODE_11913_length_804_cov_12.585816	396	476	1	2	80	0.0250000
NODE_11913_length_804_cov_12.585816	396	476	2	78	80	0.9750000
NODE_11913_length_804_cov_12.585816	449	529	2	47	80	0.5875000
NODE_11913_length_804_cov_12.585816	449	529	3	33	80	0.4125000
NODE_11914_length_804_cov_12.375887	190	270	12	25	80	0.3125000
NODE_11914_length_804_cov_12.375887	190	270	15	3	80	0.0375000
NODE_11914_length_804_cov_12.375887	190	270	16	12	80	0.1500000
NODE_11914_length_804_cov_12.375887	190	270	17	2	80	0.0250000
NODE_11914_length_804_cov_12.375887	190	270	18	38	80	0.4750000
NODE_11914_length_804_cov_12.375887	243	323	8	20	80	0.2500000
NODE_11914_length_804_cov_12.375887	243	323	9	6	80	0.0750000
NODE_11914_length_804_cov_12.375887	243	323	12	9	80	0.1125000
NODE_11914_length_804_cov_12.375887	243	323	14	13	80	0.1625000
NODE_11914_length_804_cov_12.375887	243	323	17	1	80	0.0125000
NODE_11914_length_804_cov_12.375887	243	323	18	31	80	0.3875000
NODE_11915_length_804_cov_10.947518	363	443	0	1	80	0.0125000
NODE_11915_length_804_cov_10.947518	363	443	1	1	80	0.0125000
NODE_11915_length_804_cov_10.947518	363	443	2	78	80	0.9750000
NODE_11915_length_804_cov_10.947518	416	496	2	53	80	0.6625000
NODE_11915_length_804_cov_10.947518	416	496	3	27	80	0.3375000
NODE_11916_length_804_cov_8.164539	427	507	4	15	80	0.1875000
NODE_11916_length_804_cov_8.164539	427	507	6	65	80	0.8125000
NODE_11916_length_804_cov_8.164539	480	560	2	5	80	0.0625000
NODE_11916_length_804_cov_8.164539	480	560	4	49	80	0.6125000
NODE_11916_length_804_cov_8.164539	480	560	6	26	80	0.3250000
NODE_11917_length_804_cov_7.462411	345	425	2	29	80	0.3625000
NODE_11917_length_804_cov_7.462411	345	425	3	51	80	0.6375000
NODE_11917_length_804_cov_7.462411	398	478	2	12	80	0.1500000
NODE_11917_length_804_cov_7.462411	398	478	3	63	80	0.7875000
NODE_11917_length_804_cov_7.462411	398	478	4	5	80	0.0625000
NODE_11919_length_804_cov_3.663830	736	799	0	63	63	1.0000000
NODE_11933_length_804_cov_1.303546	480	560	0	10	80	0.1250000
NODE_11933_length_804_cov_1.303546	480	560	1	28	80	0.3500000
NODE_11933_length_804_cov_1.303546	480	560	2	20	80	0.2500000
NODE_11933_length_804_cov_1.303546	480	560	3	22	80	0.2750000
NODE_11933_length_804_cov_1.303546	533	613	2	5	80	0.0625000
NODE_11933_length_804_cov_1.303546	533	613	3	75	80	0.9375000
NODE_11942_length_803_cov_40.930398	374	454	1	36	80	0.4500000
NODE_11942_length_803_cov_40.930398	374	454	2	13	80	0.1625000
NODE_11942_length_803_cov_40.930398	374	454	3	31	80	0.3875000
NODE_11942_length_803_cov_40.930398	427	507	2	45	80	0.5625000
NODE_11942_length_803_cov_40.930398	427	507	3	35	80	0.4375000
NODE_11944_length_803_cov_28.346591	242	322	13	2	80	0.0250000
NODE_11944_length_803_cov_28.346591	242	322	14	7	80	0.0875000
NODE_11944_length_803_cov_28.346591	242	322	18	1	80	0.0125000
NODE_11944_length_803_cov_28.346591	242	322	19	2	80	0.0250000
NODE_11944_length_803_cov_28.346591	242	322	20	1	80	0.0125000
NODE_11944_length_803_cov_28.346591	242	322	21	8	80	0.1000000
NODE_11944_length_803_cov_28.346591	242	322	22	2	80	0.0250000
NODE_11944_length_803_cov_28.346591	242	322	25	5	80	0.0625000
NODE_11944_length_803_cov_28.346591	242	322	27	5	80	0.0625000
NODE_11944_length_803_cov_28.346591	242	322	28	9	80	0.1125000
NODE_11944_length_803_cov_28.346591	242	322	29	8	80	0.1000000
NODE_11944_length_803_cov_28.346591	242	322	30	1	80	0.0125000
NODE_11944_length_803_cov_28.346591	242	322	31	18	80	0.2250000
NODE_11944_length_803_cov_28.346591	242	322	32	2	80	0.0250000
NODE_11944_length_803_cov_28.346591	242	322	33	9	80	0.1125000
NODE_11944_length_803_cov_28.346591	295	375	31	16	80	0.2000000
NODE_11944_length_803_cov_28.346591	295	375	32	2	80	0.0250000
NODE_11944_length_803_cov_28.346591	295	375	33	19	80	0.2375000
NODE_11944_length_803_cov_28.346591	295	375	35	12	80	0.1500000
NODE_11944_length_803_cov_28.346591	295	375	37	4	80	0.0500000
NODE_11944_length_803_cov_28.346591	295	375	39	27	80	0.3375000
NODE_11945_length_803_cov_23.420455	288	368	2	70	80	0.8750000
NODE_11945_length_803_cov_23.420455	288	368	4	10	80	0.1250000
NODE_11945_length_803_cov_23.420455	341	421	0	7	80	0.0875000
NODE_11945_length_803_cov_23.420455	341	421	2	41	80	0.5125000
NODE_11945_length_803_cov_23.420455	341	421	3	32	80	0.4000000
NODE_11946_length_803_cov_20.977273	316	396	4	1	80	0.0125000
NODE_11946_length_803_cov_20.977273	316	396	5	31	80	0.3875000
NODE_11946_length_803_cov_20.977273	316	396	6	8	80	0.1000000
NODE_11946_length_803_cov_20.977273	316	396	8	40	80	0.5000000
NODE_11946_length_803_cov_20.977273	369	449	4	7	80	0.0875000
NODE_11946_length_803_cov_20.977273	369	449	5	7	80	0.0875000
NODE_11946_length_803_cov_20.977273	369	449	6	2	80	0.0250000
NODE_11946_length_803_cov_20.977273	369	449	8	64	80	0.8000000
NODE_11947_length_803_cov_18.458807	307	387	0	26	80	0.3250000
NODE_11947_length_803_cov_18.458807	307	387	1	5	80	0.0625000
NODE_11947_length_803_cov_18.458807	307	387	2	21	80	0.2625000
NODE_11947_length_803_cov_18.458807	307	387	4	16	80	0.2000000
NODE_11947_length_803_cov_18.458807	307	387	5	9	80	0.1125000
NODE_11947_length_803_cov_18.458807	307	387	6	3	80	0.0375000
NODE_11947_length_803_cov_18.458807	360	440	4	15	80	0.1875000
NODE_11947_length_803_cov_18.458807	360	440	5	9	80	0.1125000
NODE_11947_length_803_cov_18.458807	360	440	6	56	80	0.7000000
NODE_11948_length_803_cov_14.411932	386	466	2	80	80	1.0000000
NODE_11948_length_803_cov_14.411932	439	519	2	40	80	0.5000000
NODE_11948_length_803_cov_14.411932	439	519	4	40	80	0.5000000
NODE_11949_length_803_cov_10.157670	319	399	0	80	80	1.0000000
NODE_11949_length_803_cov_10.157670	372	452	0	80	80	1.0000000
NODE_11950_length_803_cov_8.977273	362	442	2	80	80	1.0000000
NODE_11950_length_803_cov_8.977273	415	485	0	42	70	0.6000000
NODE_11950_length_803_cov_8.977273	415	485	2	28	70	0.4000000
NODE_11951_length_803_cov_7.735795	195	275	0	80	80	1.0000000
NODE_11951_length_803_cov_7.735795	248	328	0	80	80	1.0000000
NODE_11955_length_803_cov_4.613636	266	346	3	6	80	0.0750000
NODE_11955_length_803_cov_4.613636	266	346	4	74	80	0.9250000
NODE_11955_length_803_cov_4.613636	319	399	4	75	80	0.9375000
NODE_11955_length_803_cov_4.613636	319	399	6	5	80	0.0625000
NODE_11957_length_803_cov_4.220170	72	152	0	80	80	1.0000000
NODE_11957_length_803_cov_4.220170	130	207	0	77	77	1.0000000
NODE_11985_length_802_cov_42.294452	289	369	16	1	80	0.0125000
NODE_11985_length_802_cov_42.294452	289	369	17	7	80	0.0875000
NODE_11985_length_802_cov_42.294452	289	369	18	30	80	0.3750000
NODE_11985_length_802_cov_42.294452	289	369	20	14	80	0.1750000
NODE_11985_length_802_cov_42.294452	289	369	21	21	80	0.2625000
NODE_11985_length_802_cov_42.294452	289	369	22	7	80	0.0875000
NODE_11985_length_802_cov_42.294452	342	422	9	1	80	0.0125000
NODE_11985_length_802_cov_42.294452	342	422	12	7	80	0.0875000
NODE_11985_length_802_cov_42.294452	342	422	14	3	80	0.0375000
NODE_11985_length_802_cov_42.294452	342	422	18	48	80	0.6000000
NODE_11985_length_802_cov_42.294452	342	422	19	3	80	0.0375000
NODE_11985_length_802_cov_42.294452	342	422	20	10	80	0.1250000
NODE_11985_length_802_cov_42.294452	342	422	21	8	80	0.1000000
NODE_11986_length_802_cov_31.896159	246	326	7	6	80	0.0750000
NODE_11986_length_802_cov_31.896159	246	326	9	70	80	0.8750000
NODE_11986_length_802_cov_31.896159	246	326	11	4	80	0.0500000
NODE_11986_length_802_cov_31.896159	299	379	9	25	80	0.3125000
NODE_11986_length_802_cov_31.896159	299	379	10	35	80	0.4375000
NODE_11986_length_802_cov_31.896159	299	379	11	8	80	0.1000000
NODE_11986_length_802_cov_31.896159	299	379	12	3	80	0.0375000
NODE_11986_length_802_cov_31.896159	299	379	14	9	80	0.1125000
NODE_11987_length_802_cov_30.786629	419	499	18	28	80	0.3500000
NODE_11987_length_802_cov_30.786629	419	499	19	46	80	0.5750000
NODE_11987_length_802_cov_30.786629	419	499	20	6	80	0.0750000
NODE_11987_length_802_cov_30.786629	472	552	6	13	80	0.1625000
NODE_11987_length_802_cov_30.786629	472	552	7	10	80	0.1250000
NODE_11987_length_802_cov_30.786629	472	552	9	3	80	0.0375000
NODE_11987_length_802_cov_30.786629	472	552	12	6	80	0.0750000
NODE_11987_length_802_cov_30.786629	472	552	13	13	80	0.1625000
NODE_11987_length_802_cov_30.786629	472	552	14	2	80	0.0250000
NODE_11987_length_802_cov_30.786629	472	552	18	26	80	0.3250000
NODE_11987_length_802_cov_30.786629	472	552	19	7	80	0.0875000
NODE_11988_length_802_cov_19.540541	368	448	7	16	80	0.2000000
NODE_11988_length_802_cov_19.540541	368	448	9	4	80	0.0500000
NODE_11988_length_802_cov_19.540541	368	448	10	8	80	0.1000000
NODE_11988_length_802_cov_19.540541	368	448	11	52	80	0.6500000
NODE_11988_length_802_cov_19.540541	421	501	6	1	80	0.0125000
NODE_11988_length_802_cov_19.540541	421	501	8	19	80	0.2375000
NODE_11988_length_802_cov_19.540541	421	501	9	27	80	0.3375000
NODE_11988_length_802_cov_19.540541	421	501	10	1	80	0.0125000
NODE_11988_length_802_cov_19.540541	421	501	11	32	80	0.4000000
NODE_11989_length_802_cov_17.689900	268	348	0	50	80	0.6250000
NODE_11989_length_802_cov_17.689900	268	348	3	20	80	0.2500000
NODE_11989_length_802_cov_17.689900	268	348	4	10	80	0.1250000
NODE_11989_length_802_cov_17.689900	321	401	3	17	80	0.2125000
NODE_11989_length_802_cov_17.689900	321	401	4	14	80	0.1750000
NODE_11989_length_802_cov_17.689900	321	401	6	31	80	0.3875000
NODE_11989_length_802_cov_17.689900	321	401	9	18	80	0.2250000
NODE_11990_length_802_cov_16.432432	364	444	5	37	80	0.4625000
NODE_11990_length_802_cov_16.432432	364	444	6	19	80	0.2375000
NODE_11990_length_802_cov_16.432432	364	444	7	3	80	0.0375000
NODE_11990_length_802_cov_16.432432	364	444	8	14	80	0.1750000
NODE_11990_length_802_cov_16.432432	364	444	9	7	80	0.0875000
NODE_11990_length_802_cov_16.432432	417	497	5	27	80	0.3375000
NODE_11990_length_802_cov_16.432432	417	497	6	42	80	0.5250000
NODE_11990_length_802_cov_16.432432	417	497	7	2	80	0.0250000
NODE_11990_length_802_cov_16.432432	417	497	8	9	80	0.1125000
NODE_11991_length_802_cov_15.409673	317	397	0	25	80	0.3125000
NODE_11991_length_802_cov_15.409673	317	397	1	2	80	0.0250000
NODE_11991_length_802_cov_15.409673	317	397	5	31	80	0.3875000
NODE_11991_length_802_cov_15.409673	317	397	6	22	80	0.2750000
NODE_11991_length_802_cov_15.409673	370	450	5	5	80	0.0625000
NODE_11991_length_802_cov_15.409673	370	450	6	75	80	0.9375000
NODE_11992_length_802_cov_12.507824	340	420	1	11	80	0.1375000
NODE_11992_length_802_cov_12.507824	340	420	3	44	80	0.5500000
NODE_11992_length_802_cov_12.507824	340	420	4	20	80	0.2500000
NODE_11992_length_802_cov_12.507824	340	420	5	5	80	0.0625000
NODE_11992_length_802_cov_12.507824	393	473	3	16	80	0.2000000
NODE_11992_length_802_cov_12.507824	393	473	4	64	80	0.8000000
NODE_11993_length_802_cov_9.310100	374	454	1	29	80	0.3625000
NODE_11993_length_802_cov_9.310100	374	454	2	51	80	0.6375000
NODE_11993_length_802_cov_9.310100	427	507	1	28	80	0.3500000
NODE_11993_length_802_cov_9.310100	427	507	2	52	80	0.6500000
NODE_11994_length_802_cov_8.421053	272	351	0	79	79	1.0000000
NODE_11994_length_802_cov_8.421053	324	404	0	80	80	1.0000000
NODE_11997_length_802_cov_5.576102	294	374	0	80	80	1.0000000
NODE_11997_length_802_cov_5.576102	347	427	0	70	80	0.8750000
NODE_11997_length_802_cov_5.576102	347	427	1	10	80	0.1250000
NODE_12025_length_801_cov_35.199430	334	414	10	1	80	0.0125000
NODE_12025_length_801_cov_35.199430	334	414	12	15	80	0.1875000
NODE_12025_length_801_cov_35.199430	334	414	13	7	80	0.0875000
NODE_12025_length_801_cov_35.199430	334	414	14	35	80	0.4375000
NODE_12025_length_801_cov_35.199430	334	414	15	2	80	0.0250000
NODE_12025_length_801_cov_35.199430	334	414	16	13	80	0.1625000
NODE_12025_length_801_cov_35.199430	334	414	17	7	80	0.0875000
NODE_12025_length_801_cov_35.199430	387	467	13	23	80	0.2875000
NODE_12025_length_801_cov_35.199430	387	467	14	2	80	0.0250000
NODE_12025_length_801_cov_35.199430	387	467	15	13	80	0.1625000
NODE_12025_length_801_cov_35.199430	387	467	16	35	80	0.4375000
NODE_12025_length_801_cov_35.199430	387	467	17	7	80	0.0875000
NODE_12026_length_801_cov_20.096866	347	427	3	3	80	0.0375000
NODE_12026_length_801_cov_20.096866	347	427	5	25	80	0.3125000
NODE_12026_length_801_cov_20.096866	347	427	6	20	80	0.2500000
NODE_12026_length_801_cov_20.096866	347	427	7	19	80	0.2375000
NODE_12026_length_801_cov_20.096866	347	427	8	13	80	0.1625000
NODE_12026_length_801_cov_20.096866	400	480	3	56	80	0.7000000
NODE_12026_length_801_cov_20.096866	400	480	5	24	80	0.3000000
NODE_12027_length_801_cov_18.643875	355	435	3	22	80	0.2750000
NODE_12027_length_801_cov_18.643875	355	435	4	56	80	0.7000000
NODE_12027_length_801_cov_18.643875	355	435	5	2	80	0.0250000
NODE_12027_length_801_cov_18.643875	408	488	2	2	80	0.0250000
NODE_12027_length_801_cov_18.643875	408	488	3	54	80	0.6750000
NODE_12027_length_801_cov_18.643875	408	488	4	24	80	0.3000000
NODE_12028_length_801_cov_16.099715	427	507	3	5	80	0.0625000
NODE_12028_length_801_cov_16.099715	427	507	5	75	80	0.9375000
NODE_12028_length_801_cov_16.099715	480	560	3	58	80	0.7250000
NODE_12028_length_801_cov_16.099715	480	560	5	22	80	0.2750000
NODE_12029_length_801_cov_12.307692	332	412	3	70	80	0.8750000
NODE_12029_length_801_cov_12.307692	332	412	4	10	80	0.1250000
NODE_12029_length_801_cov_12.307692	385	465	3	80	80	1.0000000
NODE_12030_length_801_cov_11.464387	293	373	6	3	80	0.0375000
NODE_12030_length_801_cov_11.464387	293	373	8	3	80	0.0375000
NODE_12030_length_801_cov_11.464387	293	373	9	10	80	0.1250000
NODE_12030_length_801_cov_11.464387	293	373	10	19	80	0.2375000
NODE_12030_length_801_cov_11.464387	293	373	11	29	80	0.3625000
NODE_12030_length_801_cov_11.464387	293	373	12	16	80	0.2000000
NODE_12030_length_801_cov_11.464387	346	426	9	8	80	0.1000000
NODE_12030_length_801_cov_11.464387	346	426	10	15	80	0.1875000
NODE_12030_length_801_cov_11.464387	346	426	11	37	80	0.4625000
NODE_12030_length_801_cov_11.464387	346	426	12	20	80	0.2500000
NODE_12031_length_801_cov_8.562678	309	389	1	70	80	0.8750000
NODE_12031_length_801_cov_8.562678	309	389	2	10	80	0.1250000
NODE_12031_length_801_cov_8.562678	362	442	1	80	80	1.0000000
NODE_12032_length_801_cov_3.927350	339	419	3	1	80	0.0125000
NODE_12032_length_801_cov_3.927350	339	419	4	79	80	0.9875000
NODE_12032_length_801_cov_3.927350	392	472	0	8	80	0.1000000
NODE_12032_length_801_cov_3.927350	392	472	1	29	80	0.3625000
NODE_12032_length_801_cov_3.927350	392	472	3	17	80	0.2125000
NODE_12032_length_801_cov_3.927350	392	472	4	26	80	0.3250000
NODE_12053_length_800_cov_72.029957	245	325	12	16	80	0.2000000
NODE_12053_length_800_cov_72.029957	245	325	13	23	80	0.2875000
NODE_12053_length_800_cov_72.029957	245	325	14	41	80	0.5125000
NODE_12053_length_800_cov_72.029957	298	378	8	11	80	0.1375000
NODE_12053_length_800_cov_72.029957	298	378	9	3	80	0.0375000
NODE_12053_length_800_cov_72.029957	298	378	11	23	80	0.2875000
NODE_12053_length_800_cov_72.029957	298	378	12	4	80	0.0500000
NODE_12053_length_800_cov_72.029957	298	378	13	22	80	0.2750000
NODE_12053_length_800_cov_72.029957	298	378	14	10	80	0.1250000
NODE_12053_length_800_cov_72.029957	298	378	15	7	80	0.0875000
NODE_12054_length_800_cov_22.631954	297	377	7	13	80	0.1625000
NODE_12054_length_800_cov_22.631954	297	377	8	7	80	0.0875000
NODE_12054_length_800_cov_22.631954	297	377	9	18	80	0.2250000
NODE_12054_length_800_cov_22.631954	297	377	12	11	80	0.1375000
NODE_12054_length_800_cov_22.631954	297	377	13	6	80	0.0750000
NODE_12054_length_800_cov_22.631954	297	377	14	25	80	0.3125000
NODE_12054_length_800_cov_22.631954	350	430	10	28	80	0.3500000
NODE_12054_length_800_cov_22.631954	350	430	11	12	80	0.1500000
NODE_12054_length_800_cov_22.631954	350	430	12	21	80	0.2625000
NODE_12054_length_800_cov_22.631954	350	430	14	19	80	0.2375000
NODE_12055_length_800_cov_9.457917	409	489	1	80	80	1.0000000
NODE_12055_length_800_cov_9.457917	462	542	0	19	80	0.2375000
NODE_12055_length_800_cov_9.457917	462	542	1	61	80	0.7625000
NODE_12084_length_799_cov_101.640000	101	132	1	10	31	0.3225806
NODE_12084_length_799_cov_101.640000	101	132	2	3	31	0.0967742
NODE_12084_length_799_cov_101.640000	101	132	4	12	31	0.3870968
NODE_12084_length_799_cov_101.640000	101	132	5	6	31	0.1935484
NODE_12085_length_799_cov_33.630000	367	447	7	1	80	0.0125000
NODE_12085_length_799_cov_33.630000	367	447	10	1	80	0.0125000
NODE_12085_length_799_cov_33.630000	367	447	11	1	80	0.0125000
NODE_12085_length_799_cov_33.630000	367	447	12	9	80	0.1125000
NODE_12085_length_799_cov_33.630000	367	447	13	3	80	0.0375000
NODE_12085_length_799_cov_33.630000	367	447	15	8	80	0.1000000
NODE_12085_length_799_cov_33.630000	367	447	16	37	80	0.4625000
NODE_12085_length_799_cov_33.630000	367	447	17	18	80	0.2250000
NODE_12085_length_799_cov_33.630000	367	447	21	2	80	0.0250000
NODE_12085_length_799_cov_33.630000	420	500	3	1	80	0.0125000
NODE_12085_length_799_cov_33.630000	420	500	4	6	80	0.0750000
NODE_12085_length_799_cov_33.630000	420	500	5	22	80	0.2750000
NODE_12085_length_799_cov_33.630000	420	500	6	12	80	0.1500000
NODE_12085_length_799_cov_33.630000	420	500	7	13	80	0.1625000
NODE_12085_length_799_cov_33.630000	420	500	10	1	80	0.0125000
NODE_12085_length_799_cov_33.630000	420	500	11	1	80	0.0125000
NODE_12085_length_799_cov_33.630000	420	500	12	9	80	0.1125000
NODE_12085_length_799_cov_33.630000	420	500	13	3	80	0.0375000
NODE_12085_length_799_cov_33.630000	420	500	15	8	80	0.1000000
NODE_12085_length_799_cov_33.630000	420	500	16	2	80	0.0250000
NODE_12085_length_799_cov_33.630000	420	500	17	2	80	0.0250000
NODE_12086_length_799_cov_15.717143	408	488	6	41	80	0.5125000
NODE_12086_length_799_cov_15.717143	408	488	8	1	80	0.0125000
NODE_12086_length_799_cov_15.717143	408	488	9	21	80	0.2625000
NODE_12086_length_799_cov_15.717143	408	488	10	12	80	0.1500000
NODE_12086_length_799_cov_15.717143	408	488	11	5	80	0.0625000
NODE_12086_length_799_cov_15.717143	461	541	6	10	80	0.1250000
NODE_12086_length_799_cov_15.717143	461	541	8	1	80	0.0125000
NODE_12086_length_799_cov_15.717143	461	541	9	9	80	0.1125000
NODE_12086_length_799_cov_15.717143	461	541	10	55	80	0.6875000
NODE_12086_length_799_cov_15.717143	461	541	11	5	80	0.0625000
NODE_12087_length_799_cov_15.175714	293	373	0	53	80	0.6625000
NODE_12087_length_799_cov_15.175714	293	373	4	27	80	0.3375000
NODE_12087_length_799_cov_15.175714	346	426	4	80	80	1.0000000
NODE_12088_length_799_cov_8.444286	408	488	3	35	80	0.4375000
NODE_12088_length_799_cov_8.444286	408	488	4	36	80	0.4500000
NODE_12088_length_799_cov_8.444286	408	488	5	9	80	0.1125000
NODE_12088_length_799_cov_8.444286	461	541	2	10	80	0.1250000
NODE_12088_length_799_cov_8.444286	461	541	3	3	80	0.0375000
NODE_12088_length_799_cov_8.444286	461	541	4	67	80	0.8375000
NODE_12120_length_798_cov_42.629471	148	228	29	1	80	0.0125000
NODE_12120_length_798_cov_42.629471	148	228	31	5	80	0.0625000
NODE_12120_length_798_cov_42.629471	148	228	35	10	80	0.1250000
NODE_12120_length_798_cov_42.629471	148	228	36	22	80	0.2750000
NODE_12120_length_798_cov_42.629471	148	228	37	19	80	0.2375000
NODE_12120_length_798_cov_42.629471	148	228	38	23	80	0.2875000
NODE_12120_length_798_cov_42.629471	201	281	20	18	80	0.2250000
NODE_12120_length_798_cov_42.629471	201	281	21	10	80	0.1250000
NODE_12120_length_798_cov_42.629471	201	281	25	1	80	0.0125000
NODE_12120_length_798_cov_42.629471	201	281	26	2	80	0.0250000
NODE_12120_length_798_cov_42.629471	201	281	27	2	80	0.0250000
NODE_12120_length_798_cov_42.629471	201	281	30	4	80	0.0500000
NODE_12120_length_798_cov_42.629471	201	281	31	2	80	0.0250000
NODE_12120_length_798_cov_42.629471	201	281	33	13	80	0.1625000
NODE_12120_length_798_cov_42.629471	201	281	35	3	80	0.0375000
NODE_12120_length_798_cov_42.629471	201	281	36	14	80	0.1750000
NODE_12120_length_798_cov_42.629471	201	281	37	4	80	0.0500000
NODE_12120_length_798_cov_42.629471	201	281	38	7	80	0.0875000
NODE_12121_length_798_cov_23.658083	368	448	5	51	80	0.6375000
NODE_12121_length_798_cov_23.658083	368	448	6	2	80	0.0250000
NODE_12121_length_798_cov_23.658083	368	448	7	27	80	0.3375000
NODE_12121_length_798_cov_23.658083	421	501	2	4	80	0.0500000
NODE_12121_length_798_cov_23.658083	421	501	3	16	80	0.2000000
NODE_12121_length_798_cov_23.658083	421	501	5	3	80	0.0375000
NODE_12121_length_798_cov_23.658083	421	501	6	15	80	0.1875000
NODE_12121_length_798_cov_23.658083	421	501	7	42	80	0.5250000
NODE_12122_length_798_cov_15.037196	341	421	3	29	80	0.3625000
NODE_12122_length_798_cov_15.037196	341	421	5	51	80	0.6375000
NODE_12122_length_798_cov_15.037196	394	474	5	63	80	0.7875000
NODE_12122_length_798_cov_15.037196	394	474	6	17	80	0.2125000
NODE_12123_length_798_cov_6.816881	404	483	0	79	79	1.0000000
NODE_12123_length_798_cov_6.816881	457	536	0	79	79	1.0000000
NODE_12129_length_798_cov_2.796853	246	326	0	80	80	1.0000000
NODE_12129_length_798_cov_2.796853	299	379	0	80	80	1.0000000
NODE_12151_length_797_cov_24.340974	207	287	9	9	80	0.1125000
NODE_12151_length_797_cov_24.340974	207	287	10	53	80	0.6625000
NODE_12151_length_797_cov_24.340974	207	287	11	18	80	0.2250000
NODE_12151_length_797_cov_24.340974	260	340	5	5	80	0.0625000
NODE_12151_length_797_cov_24.340974	260	340	7	1	80	0.0125000
NODE_12151_length_797_cov_24.340974	260	340	10	9	80	0.1125000
NODE_12151_length_797_cov_24.340974	260	340	11	23	80	0.2875000
NODE_12151_length_797_cov_24.340974	260	340	12	25	80	0.3125000
NODE_12151_length_797_cov_24.340974	260	340	13	17	80	0.2125000
NODE_12152_length_797_cov_21.071633	372	452	8	4	80	0.0500000
NODE_12152_length_797_cov_21.071633	372	452	9	25	80	0.3125000
NODE_12152_length_797_cov_21.071633	372	452	10	18	80	0.2250000
NODE_12152_length_797_cov_21.071633	372	452	12	19	80	0.2375000
NODE_12152_length_797_cov_21.071633	372	452	13	14	80	0.1750000
NODE_12152_length_797_cov_21.071633	425	505	11	30	80	0.3750000
NODE_12152_length_797_cov_21.071633	425	505	12	14	80	0.1750000
NODE_12152_length_797_cov_21.071633	425	505	13	36	80	0.4500000
NODE_12153_length_797_cov_18.286533	346	426	5	10	80	0.1250000
NODE_12153_length_797_cov_18.286533	346	426	6	26	80	0.3250000
NODE_12153_length_797_cov_18.286533	346	426	7	10	80	0.1250000
NODE_12153_length_797_cov_18.286533	346	426	8	16	80	0.2000000
NODE_12153_length_797_cov_18.286533	346	426	9	18	80	0.2250000
NODE_12153_length_797_cov_18.286533	399	479	2	1	80	0.0125000
NODE_12153_length_797_cov_18.286533	399	479	3	5	80	0.0625000
NODE_12153_length_797_cov_18.286533	399	479	4	19	80	0.2375000
NODE_12153_length_797_cov_18.286533	399	479	5	38	80	0.4750000
NODE_12153_length_797_cov_18.286533	399	479	6	17	80	0.2125000
NODE_12154_length_797_cov_16.628940	322	402	5	33	80	0.4125000
NODE_12154_length_797_cov_16.628940	322	402	6	47	80	0.5875000
NODE_12154_length_797_cov_16.628940	375	455	2	11	80	0.1375000
NODE_12154_length_797_cov_16.628940	375	455	3	1	80	0.0125000
NODE_12154_length_797_cov_16.628940	375	455	4	10	80	0.1250000
NODE_12154_length_797_cov_16.628940	375	455	5	58	80	0.7250000
NODE_12155_length_797_cov_15.266476	299	379	16	16	80	0.2000000
NODE_12155_length_797_cov_15.266476	299	379	17	13	80	0.1625000
NODE_12155_length_797_cov_15.266476	299	379	18	45	80	0.5625000
NODE_12155_length_797_cov_15.266476	299	379	19	6	80	0.0750000
NODE_12155_length_797_cov_15.266476	352	432	13	4	80	0.0500000
NODE_12155_length_797_cov_15.266476	352	432	14	26	80	0.3250000
NODE_12155_length_797_cov_15.266476	352	432	15	7	80	0.0875000
NODE_12155_length_797_cov_15.266476	352	432	16	10	80	0.1250000
NODE_12155_length_797_cov_15.266476	352	432	17	15	80	0.1875000
NODE_12155_length_797_cov_15.266476	352	432	18	7	80	0.0875000
NODE_12155_length_797_cov_15.266476	352	432	19	11	80	0.1375000
NODE_12156_length_797_cov_15.035817	263	343	2	21	80	0.2625000
NODE_12156_length_797_cov_15.035817	263	343	4	59	80	0.7375000
NODE_12156_length_797_cov_15.035817	316	396	2	74	80	0.9250000
NODE_12156_length_797_cov_15.035817	316	396	4	6	80	0.0750000
NODE_12157_length_797_cov_12.934097	403	484	3	39	81	0.4814815
NODE_12157_length_797_cov_12.934097	403	484	4	42	81	0.5185185
NODE_12157_length_797_cov_12.934097	457	537	1	15	80	0.1875000
NODE_12157_length_797_cov_12.934097	457	537	2	4	80	0.0500000
NODE_12157_length_797_cov_12.934097	457	537	3	51	80	0.6375000
NODE_12157_length_797_cov_12.934097	457	537	4	10	80	0.1250000
NODE_12158_length_797_cov_11.140401	201	281	1	21	80	0.2625000
NODE_12158_length_797_cov_11.140401	201	281	2	59	80	0.7375000
NODE_12158_length_797_cov_11.140401	254	334	0	48	80	0.6000000
NODE_12158_length_797_cov_11.140401	254	334	1	26	80	0.3250000
NODE_12158_length_797_cov_11.140401	254	334	2	6	80	0.0750000
NODE_12159_length_797_cov_8.681948	284	364	3	22	80	0.2750000
NODE_12159_length_797_cov_8.681948	284	364	4	25	80	0.3125000
NODE_12159_length_797_cov_8.681948	284	364	5	9	80	0.1125000
NODE_12159_length_797_cov_8.681948	284	364	6	24	80	0.3000000
NODE_12159_length_797_cov_8.681948	337	417	3	9	80	0.1125000
NODE_12159_length_797_cov_8.681948	337	417	4	36	80	0.4500000
NODE_12159_length_797_cov_8.681948	337	417	5	3	80	0.0375000
NODE_12159_length_797_cov_8.681948	337	417	6	32	80	0.4000000
NODE_12160_length_797_cov_7.616046	314	397	6	11	83	0.1325301
NODE_12160_length_797_cov_7.616046	314	397	7	28	83	0.3373494
NODE_12160_length_797_cov_7.616046	314	397	8	11	83	0.1325301
NODE_12160_length_797_cov_7.616046	314	397	9	24	83	0.2891566
NODE_12160_length_797_cov_7.616046	314	397	10	3	83	0.0361446
NODE_12160_length_797_cov_7.616046	314	397	11	6	83	0.0722892
NODE_12160_length_797_cov_7.616046	370	450	4	19	80	0.2375000
NODE_12160_length_797_cov_7.616046	370	450	6	45	80	0.5625000
NODE_12160_length_797_cov_7.616046	370	450	8	11	80	0.1375000
NODE_12160_length_797_cov_7.616046	370	450	10	3	80	0.0375000
NODE_12160_length_797_cov_7.616046	370	450	11	2	80	0.0250000
NODE_12161_length_797_cov_7.487106	275	347	5	20	72	0.2777778
NODE_12161_length_797_cov_7.487106	275	347	6	12	72	0.1666667
NODE_12161_length_797_cov_7.487106	275	347	7	36	72	0.5000000
NODE_12161_length_797_cov_7.487106	275	347	8	4	72	0.0555556
NODE_12161_length_797_cov_7.487106	320	400	4	10	80	0.1250000
NODE_12161_length_797_cov_7.487106	320	400	5	27	80	0.3375000
NODE_12161_length_797_cov_7.487106	320	400	7	29	80	0.3625000
NODE_12161_length_797_cov_7.487106	320	400	8	14	80	0.1750000
NODE_12163_length_797_cov_6.068768	357	437	1	6	80	0.0750000
NODE_12163_length_797_cov_6.068768	357	437	3	4	80	0.0500000
NODE_12163_length_797_cov_6.068768	357	437	4	62	80	0.7750000
NODE_12163_length_797_cov_6.068768	357	437	6	8	80	0.1000000
NODE_12163_length_797_cov_6.068768	410	490	4	19	80	0.2375000
NODE_12163_length_797_cov_6.068768	410	490	5	4	80	0.0500000
NODE_12163_length_797_cov_6.068768	410	490	6	57	80	0.7125000
NODE_12186_length_796_cov_20.862267	262	342	1	8	80	0.1000000
NODE_12186_length_796_cov_20.862267	262	342	2	72	80	0.9000000
NODE_12186_length_796_cov_20.862267	315	395	1	12	80	0.1500000
NODE_12186_length_796_cov_20.862267	315	395	2	68	80	0.8500000
NODE_12187_length_796_cov_18.291248	283	363	23	20	80	0.2500000
NODE_12187_length_796_cov_18.291248	283	363	36	2	80	0.0250000
NODE_12187_length_796_cov_18.291248	283	363	39	8	80	0.1000000
NODE_12187_length_796_cov_18.291248	283	363	48	15	80	0.1875000
NODE_12187_length_796_cov_18.291248	283	363	54	1	80	0.0125000
NODE_12187_length_796_cov_18.291248	283	363	55	3	80	0.0375000
NODE_12187_length_796_cov_18.291248	283	363	56	5	80	0.0625000
NODE_12187_length_796_cov_18.291248	283	363	57	26	80	0.3250000
NODE_12187_length_796_cov_18.291248	336	416	30	1	80	0.0125000
NODE_12187_length_796_cov_18.291248	336	416	36	10	80	0.1250000
NODE_12187_length_796_cov_18.291248	336	416	37	3	80	0.0375000
NODE_12187_length_796_cov_18.291248	336	416	38	3	80	0.0375000
NODE_12187_length_796_cov_18.291248	336	416	39	11	80	0.1375000
NODE_12187_length_796_cov_18.291248	336	416	44	2	80	0.0250000
NODE_12187_length_796_cov_18.291248	336	416	45	2	80	0.0250000
NODE_12187_length_796_cov_18.291248	336	416	46	2	80	0.0250000
NODE_12187_length_796_cov_18.291248	336	416	48	7	80	0.0875000
NODE_12187_length_796_cov_18.291248	336	416	51	7	80	0.0875000
NODE_12187_length_796_cov_18.291248	336	416	52	2	80	0.0250000
NODE_12187_length_796_cov_18.291248	336	416	53	2	80	0.0250000
NODE_12187_length_796_cov_18.291248	336	416	54	2	80	0.0250000
NODE_12187_length_796_cov_18.291248	336	416	55	3	80	0.0375000
NODE_12187_length_796_cov_18.291248	336	416	56	5	80	0.0625000
NODE_12187_length_796_cov_18.291248	336	416	57	18	80	0.2250000
NODE_12189_length_796_cov_7.880918	388	460	2	15	72	0.2083333
NODE_12189_length_796_cov_7.880918	388	460	3	57	72	0.7916667
NODE_12189_length_796_cov_7.880918	442	513	0	9	71	0.1267606
NODE_12189_length_796_cov_7.880918	442	513	1	41	71	0.5774648
NODE_12189_length_796_cov_7.880918	442	513	2	18	71	0.2535211
NODE_12189_length_796_cov_7.880918	442	513	3	3	71	0.0422535
NODE_12216_length_795_cov_31.729885	298	378	14	1	80	0.0125000
NODE_12216_length_795_cov_31.729885	298	378	15	29	80	0.3625000
NODE_12216_length_795_cov_31.729885	298	378	16	23	80	0.2875000
NODE_12216_length_795_cov_31.729885	298	378	18	14	80	0.1750000
NODE_12216_length_795_cov_31.729885	298	378	19	13	80	0.1625000
NODE_12216_length_795_cov_31.729885	351	431	11	38	80	0.4750000
NODE_12216_length_795_cov_31.729885	351	431	12	4	80	0.0500000
NODE_12216_length_795_cov_31.729885	351	431	15	35	80	0.4375000
NODE_12216_length_795_cov_31.729885	351	431	19	3	80	0.0375000
NODE_12217_length_795_cov_26.760057	367	447	4	11	80	0.1375000
NODE_12217_length_795_cov_26.760057	367	447	7	1	80	0.0125000
NODE_12217_length_795_cov_26.760057	367	447	8	6	80	0.0750000
NODE_12217_length_795_cov_26.760057	367	447	9	25	80	0.3125000
NODE_12217_length_795_cov_26.760057	367	447	11	9	80	0.1125000
NODE_12217_length_795_cov_26.760057	367	447	12	8	80	0.1000000
NODE_12217_length_795_cov_26.760057	367	447	13	20	80	0.2500000
NODE_12217_length_795_cov_26.760057	420	500	12	7	80	0.0875000
NODE_12217_length_795_cov_26.760057	420	500	13	73	80	0.9125000
NODE_12218_length_795_cov_24.522989	352	432	4	6	80	0.0750000
NODE_12218_length_795_cov_24.522989	352	432	5	20	80	0.2500000
NODE_12218_length_795_cov_24.522989	352	432	6	2	80	0.0250000
NODE_12218_length_795_cov_24.522989	352	432	7	17	80	0.2125000
NODE_12218_length_795_cov_24.522989	352	432	8	35	80	0.4375000
NODE_12218_length_795_cov_24.522989	405	485	4	11	80	0.1375000
NODE_12218_length_795_cov_24.522989	405	485	5	33	80	0.4125000
NODE_12218_length_795_cov_24.522989	405	485	7	1	80	0.0125000
NODE_12218_length_795_cov_24.522989	405	485	8	35	80	0.4375000
NODE_12219_length_795_cov_22.747126	363	443	4	18	80	0.2250000
NODE_12219_length_795_cov_22.747126	363	443	6	9	80	0.1125000
NODE_12219_length_795_cov_22.747126	363	443	7	2	80	0.0250000
NODE_12219_length_795_cov_22.747126	363	443	9	11	80	0.1375000
NODE_12219_length_795_cov_22.747126	363	443	10	1	80	0.0125000
NODE_12219_length_795_cov_22.747126	363	443	11	11	80	0.1375000
NODE_12219_length_795_cov_22.747126	363	443	12	7	80	0.0875000
NODE_12219_length_795_cov_22.747126	363	443	13	21	80	0.2625000
NODE_12219_length_795_cov_22.747126	416	496	12	12	80	0.1500000
NODE_12219_length_795_cov_22.747126	416	496	13	21	80	0.2625000
NODE_12219_length_795_cov_22.747126	416	496	14	24	80	0.3000000
NODE_12219_length_795_cov_22.747126	416	496	15	6	80	0.0750000
NODE_12219_length_795_cov_22.747126	416	496	16	17	80	0.2125000
NODE_12220_length_795_cov_9.439655	425	505	0	80	80	1.0000000
NODE_12220_length_795_cov_9.439655	478	558	0	80	80	1.0000000
NODE_12232_length_795_cov_3.359195	349	429	0	80	80	1.0000000
NODE_12232_length_795_cov_3.359195	402	482	0	80	80	1.0000000
NODE_12256_length_794_cov_24.680576	326	406	12	30	80	0.3750000
NODE_12256_length_794_cov_24.680576	326	406	13	17	80	0.2125000
NODE_12256_length_794_cov_24.680576	326	406	14	17	80	0.2125000
NODE_12256_length_794_cov_24.680576	326	406	15	16	80	0.2000000
NODE_12256_length_794_cov_24.680576	379	459	7	10	80	0.1250000
NODE_12256_length_794_cov_24.680576	379	459	8	2	80	0.0250000
NODE_12256_length_794_cov_24.680576	379	459	9	6	80	0.0750000
NODE_12256_length_794_cov_24.680576	379	459	10	10	80	0.1250000
NODE_12256_length_794_cov_24.680576	379	459	12	35	80	0.4375000
NODE_12256_length_794_cov_24.680576	379	459	13	17	80	0.2125000
NODE_12257_length_794_cov_20.057554	153	233	2	14	80	0.1750000
NODE_12257_length_794_cov_20.057554	153	233	6	19	80	0.2375000
NODE_12257_length_794_cov_20.057554	153	233	8	47	80	0.5875000
NODE_12257_length_794_cov_20.057554	206	286	6	40	80	0.5000000
NODE_12257_length_794_cov_20.057554	206	286	8	40	80	0.5000000
NODE_12257_length_794_cov_20.057554	282	362	4	26	80	0.3250000
NODE_12257_length_794_cov_20.057554	282	362	6	50	80	0.6250000
NODE_12257_length_794_cov_20.057554	282	362	10	4	80	0.0500000
NODE_12257_length_794_cov_20.057554	335	415	4	79	80	0.9875000
NODE_12257_length_794_cov_20.057554	335	415	6	1	80	0.0125000
NODE_12258_length_794_cov_16.602878	361	441	0	4	80	0.0500000
NODE_12258_length_794_cov_16.602878	361	441	2	67	80	0.8375000
NODE_12258_length_794_cov_16.602878	361	441	5	9	80	0.1125000
NODE_12258_length_794_cov_16.602878	414	494	2	18	80	0.2250000
NODE_12258_length_794_cov_16.602878	414	494	3	7	80	0.0875000
NODE_12258_length_794_cov_16.602878	414	494	5	55	80	0.6875000
NODE_12259_length_794_cov_16.362590	337	417	1	65	80	0.8125000
NODE_12259_length_794_cov_16.362590	337	417	2	15	80	0.1875000
NODE_12259_length_794_cov_16.362590	390	470	1	80	80	1.0000000
NODE_12260_length_794_cov_14.444604	101	160	0	59	59	1.0000000
NODE_12260_length_794_cov_14.444604	409	489	5	11	80	0.1375000
NODE_12260_length_794_cov_14.444604	409	489	7	50	80	0.6250000
NODE_12260_length_794_cov_14.444604	409	489	8	3	80	0.0375000
NODE_12260_length_794_cov_14.444604	409	489	9	16	80	0.2000000
NODE_12260_length_794_cov_14.444604	462	542	6	2	80	0.0250000
NODE_12260_length_794_cov_14.444604	462	542	7	25	80	0.3125000
NODE_12260_length_794_cov_14.444604	462	542	8	2	80	0.0250000
NODE_12260_length_794_cov_14.444604	462	542	10	5	80	0.0625000
NODE_12260_length_794_cov_14.444604	462	542	12	46	80	0.5750000
NODE_12261_length_794_cov_12.866187	442	522	7	14	80	0.1750000
NODE_12261_length_794_cov_12.866187	442	522	8	39	80	0.4875000
NODE_12261_length_794_cov_12.866187	442	522	9	24	80	0.3000000
NODE_12261_length_794_cov_12.866187	442	522	10	3	80	0.0375000
NODE_12261_length_794_cov_12.866187	495	575	7	35	80	0.4375000
NODE_12261_length_794_cov_12.866187	495	575	8	11	80	0.1375000
NODE_12261_length_794_cov_12.866187	495	575	9	31	80	0.3875000
NODE_12261_length_794_cov_12.866187	495	575	10	3	80	0.0375000
NODE_12262_length_794_cov_12.287770	235	315	2	16	80	0.2000000
NODE_12262_length_794_cov_12.287770	235	315	3	64	80	0.8000000
NODE_12262_length_794_cov_12.287770	288	368	2	16	80	0.2000000
NODE_12262_length_794_cov_12.287770	288	368	3	64	80	0.8000000
NODE_12263_length_794_cov_11.210072	315	395	1	56	80	0.7000000
NODE_12263_length_794_cov_11.210072	315	395	2	24	80	0.3000000
NODE_12263_length_794_cov_11.210072	368	448	0	53	80	0.6625000
NODE_12263_length_794_cov_11.210072	368	448	1	27	80	0.3375000
NODE_12264_length_794_cov_10.638849	325	406	2	81	81	1.0000000
NODE_12264_length_794_cov_10.638849	379	459	2	80	80	1.0000000
NODE_12266_length_794_cov_6.274820	412	492	5	37	80	0.4625000
NODE_12266_length_794_cov_6.274820	412	492	6	43	80	0.5375000
NODE_12266_length_794_cov_6.274820	465	545	3	18	80	0.2250000
NODE_12266_length_794_cov_6.274820	465	545	4	21	80	0.2625000
NODE_12266_length_794_cov_6.274820	465	545	5	13	80	0.1625000
NODE_12266_length_794_cov_6.274820	465	545	6	28	80	0.3500000
NODE_12271_length_794_cov_3.197122	273	338	0	65	65	1.0000000
NODE_12282_length_794_cov_1.848921	246	326	0	30	80	0.3750000
NODE_12282_length_794_cov_1.848921	246	326	2	50	80	0.6250000
NODE_12282_length_794_cov_1.848921	299	379	2	36	80	0.4500000
NODE_12282_length_794_cov_1.848921	299	379	3	44	80	0.5500000
NODE_12295_length_793_cov_29.878963	326	406	2	80	80	1.0000000
NODE_12295_length_793_cov_29.878963	379	459	0	26	80	0.3250000
NODE_12295_length_793_cov_29.878963	379	459	1	2	80	0.0250000
NODE_12295_length_793_cov_29.878963	379	459	2	52	80	0.6500000
NODE_12296_length_793_cov_25.981268	310	390	15	67	80	0.8375000
NODE_12296_length_793_cov_25.981268	310	390	16	10	80	0.1250000
NODE_12296_length_793_cov_25.981268	310	390	19	3	80	0.0375000
NODE_12296_length_793_cov_25.981268	363	445	4	10	82	0.1219512
NODE_12296_length_793_cov_25.981268	363	445	8	21	82	0.2560976
NODE_12296_length_793_cov_25.981268	363	445	10	17	82	0.2073171
NODE_12296_length_793_cov_25.981268	363	445	15	24	82	0.2926829
NODE_12296_length_793_cov_25.981268	363	445	19	10	82	0.1219512
NODE_12297_length_793_cov_24.840058	331	411	0	80	80	1.0000000
NODE_12297_length_793_cov_24.840058	384	464	0	80	80	1.0000000
NODE_12298_length_793_cov_21.707493	398	478	13	3	80	0.0375000
NODE_12298_length_793_cov_21.707493	398	478	16	4	80	0.0500000
NODE_12298_length_793_cov_21.707493	398	478	18	22	80	0.2750000
NODE_12298_length_793_cov_21.707493	398	478	19	1	80	0.0125000
NODE_12298_length_793_cov_21.707493	398	478	20	8	80	0.1000000
NODE_12298_length_793_cov_21.707493	398	478	21	23	80	0.2875000
NODE_12298_length_793_cov_21.707493	398	478	22	2	80	0.0250000
NODE_12298_length_793_cov_21.707493	398	478	24	4	80	0.0500000
NODE_12298_length_793_cov_21.707493	398	478	25	6	80	0.0750000
NODE_12298_length_793_cov_21.707493	398	478	26	7	80	0.0875000
NODE_12298_length_793_cov_21.707493	451	531	19	3	80	0.0375000
NODE_12298_length_793_cov_21.707493	451	531	20	12	80	0.1500000
NODE_12298_length_793_cov_21.707493	451	531	21	43	80	0.5375000
NODE_12298_length_793_cov_21.707493	451	531	23	7	80	0.0875000
NODE_12298_length_793_cov_21.707493	451	531	24	12	80	0.1500000
NODE_12298_length_793_cov_21.707493	451	531	25	3	80	0.0375000
NODE_12299_length_793_cov_8.358790	257	337	1	5	80	0.0625000
NODE_12299_length_793_cov_8.358790	257	337	2	75	80	0.9375000
NODE_12299_length_793_cov_8.358790	310	390	2	80	80	1.0000000
NODE_12300_length_793_cov_8.236311	477	557	2	2	80	0.0250000
NODE_12300_length_793_cov_8.236311	477	557	3	35	80	0.4375000
NODE_12300_length_793_cov_8.236311	477	557	4	26	80	0.3250000
NODE_12300_length_793_cov_8.236311	477	557	5	17	80	0.2125000
NODE_12300_length_793_cov_8.236311	530	610	2	55	80	0.6875000
NODE_12300_length_793_cov_8.236311	530	610	3	25	80	0.3125000
NODE_12302_length_793_cov_6.763689	461	541	0	80	80	1.0000000
NODE_12302_length_793_cov_6.763689	514	594	0	80	80	1.0000000
NODE_12307_length_793_cov_4.465418	501	549	1	48	48	1.0000000
NODE_12311_length_793_cov_4.138329	174	254	0	80	80	1.0000000
NODE_12311_length_793_cov_4.138329	227	307	0	80	80	1.0000000
NODE_12338_length_792_cov_40.025974	198	278	2	49	80	0.6125000
NODE_12338_length_792_cov_40.025974	198	278	5	2	80	0.0250000
NODE_12338_length_792_cov_40.025974	198	278	7	28	80	0.3500000
NODE_12338_length_792_cov_40.025974	198	278	8	1	80	0.0125000
NODE_12338_length_792_cov_40.025974	251	331	7	26	80	0.3250000
NODE_12338_length_792_cov_40.025974	251	331	8	24	80	0.3000000
NODE_12338_length_792_cov_40.025974	251	331	12	11	80	0.1375000
NODE_12338_length_792_cov_40.025974	251	331	14	15	80	0.1875000
NODE_12338_length_792_cov_40.025974	251	331	15	4	80	0.0500000
NODE_12338_length_792_cov_40.025974	327	408	14	7	81	0.0864198
NODE_12338_length_792_cov_40.025974	327	408	17	2	81	0.0246914
NODE_12338_length_792_cov_40.025974	327	408	18	1	81	0.0123457
NODE_12338_length_792_cov_40.025974	327	408	19	7	81	0.0864198
NODE_12338_length_792_cov_40.025974	327	408	20	3	81	0.0370370
NODE_12338_length_792_cov_40.025974	327	408	21	5	81	0.0617284
NODE_12338_length_792_cov_40.025974	327	408	23	15	81	0.1851852
NODE_12338_length_792_cov_40.025974	327	408	24	2	81	0.0246914
NODE_12338_length_792_cov_40.025974	327	408	25	19	81	0.2345679
NODE_12338_length_792_cov_40.025974	327	408	28	4	81	0.0493827
NODE_12338_length_792_cov_40.025974	327	408	30	4	81	0.0493827
NODE_12338_length_792_cov_40.025974	327	408	31	3	81	0.0370370
NODE_12338_length_792_cov_40.025974	327	408	33	1	81	0.0123457
NODE_12338_length_792_cov_40.025974	327	408	34	3	81	0.0370370
NODE_12338_length_792_cov_40.025974	327	408	35	5	81	0.0617284
NODE_12338_length_792_cov_40.025974	381	461	25	7	80	0.0875000
NODE_12338_length_792_cov_40.025974	381	461	28	4	80	0.0500000
NODE_12338_length_792_cov_40.025974	381	461	30	4	80	0.0500000
NODE_12338_length_792_cov_40.025974	381	461	31	3	80	0.0375000
NODE_12338_length_792_cov_40.025974	381	461	33	1	80	0.0125000
NODE_12338_length_792_cov_40.025974	381	461	34	3	80	0.0375000
NODE_12338_length_792_cov_40.025974	381	461	35	10	80	0.1250000
NODE_12338_length_792_cov_40.025974	381	461	38	3	80	0.0375000
NODE_12338_length_792_cov_40.025974	381	461	40	1	80	0.0125000
NODE_12338_length_792_cov_40.025974	381	461	42	6	80	0.0750000
NODE_12338_length_792_cov_40.025974	381	461	43	2	80	0.0250000
NODE_12338_length_792_cov_40.025974	381	461	44	31	80	0.3875000
NODE_12338_length_792_cov_40.025974	381	461	47	5	80	0.0625000
NODE_12339_length_792_cov_31.176046	331	411	0	49	80	0.6125000
NODE_12339_length_792_cov_31.176046	331	411	1	19	80	0.2375000
NODE_12339_length_792_cov_31.176046	331	411	3	12	80	0.1500000
NODE_12339_length_792_cov_31.176046	384	463	1	15	79	0.1898734
NODE_12339_length_792_cov_31.176046	384	463	3	24	79	0.3037975
NODE_12339_length_792_cov_31.176046	384	463	5	40	79	0.5063291
NODE_12339_length_792_cov_31.176046	459	539	5	62	80	0.7750000
NODE_12339_length_792_cov_31.176046	459	539	6	18	80	0.2250000
NODE_12339_length_792_cov_31.176046	512	546	5	16	34	0.4705882
NODE_12339_length_792_cov_31.176046	512	546	6	18	34	0.5294118
NODE_12340_length_792_cov_21.347763	303	383	4	8	80	0.1000000
NODE_12340_length_792_cov_21.347763	303	383	5	30	80	0.3750000
NODE_12340_length_792_cov_21.347763	303	383	6	1	80	0.0125000
NODE_12340_length_792_cov_21.347763	303	383	7	41	80	0.5125000
NODE_12340_length_792_cov_21.347763	356	436	3	9	80	0.1125000
NODE_12340_length_792_cov_21.347763	356	436	5	61	80	0.7625000
NODE_12340_length_792_cov_21.347763	356	436	6	1	80	0.0125000
NODE_12340_length_792_cov_21.347763	356	436	7	9	80	0.1125000
NODE_12341_length_792_cov_20.142857	361	441	6	6	80	0.0750000
NODE_12341_length_792_cov_20.142857	361	441	9	35	80	0.4375000
NODE_12341_length_792_cov_20.142857	361	441	10	12	80	0.1500000
NODE_12341_length_792_cov_20.142857	361	441	11	27	80	0.3375000
NODE_12341_length_792_cov_20.142857	414	494	9	54	80	0.6750000
NODE_12341_length_792_cov_20.142857	414	494	10	2	80	0.0250000
NODE_12341_length_792_cov_20.142857	414	494	11	19	80	0.2375000
NODE_12341_length_792_cov_20.142857	414	494	12	5	80	0.0625000
NODE_12342_length_792_cov_18.733045	320	400	2	80	80	1.0000000
NODE_12342_length_792_cov_18.733045	373	453	1	12	80	0.1500000
NODE_12342_length_792_cov_18.733045	373	453	2	68	80	0.8500000
NODE_12343_length_792_cov_12.024531	369	449	0	3	80	0.0375000
NODE_12343_length_792_cov_12.024531	369	449	1	17	80	0.2125000
NODE_12343_length_792_cov_12.024531	369	449	2	60	80	0.7500000
NODE_12343_length_792_cov_12.024531	422	502	2	80	80	1.0000000
NODE_12372_length_791_cov_53.573699	287	359	31	2	72	0.0277778
NODE_12372_length_791_cov_53.573699	287	359	32	15	72	0.2083333
NODE_12372_length_791_cov_53.573699	287	359	33	14	72	0.1944444
NODE_12372_length_791_cov_53.573699	287	359	35	34	72	0.4722222
NODE_12372_length_791_cov_53.573699	287	359	36	6	72	0.0833333
NODE_12372_length_791_cov_53.573699	287	359	40	1	72	0.0138889
NODE_12372_length_791_cov_53.573699	332	412	19	17	80	0.2125000
NODE_12372_length_791_cov_53.573699	332	412	21	1	80	0.0125000
NODE_12372_length_791_cov_53.573699	332	412	22	10	80	0.1250000
NODE_12372_length_791_cov_53.573699	332	412	24	7	80	0.0875000
NODE_12372_length_791_cov_53.573699	332	412	26	11	80	0.1375000
NODE_12372_length_791_cov_53.573699	332	412	27	2	80	0.0250000
NODE_12372_length_791_cov_53.573699	332	412	33	8	80	0.1000000
NODE_12372_length_791_cov_53.573699	332	412	35	18	80	0.2250000
NODE_12372_length_791_cov_53.573699	332	412	36	6	80	0.0750000
NODE_12373_length_791_cov_40.416185	238	318	0	80	80	1.0000000
NODE_12373_length_791_cov_40.416185	291	371	0	80	80	1.0000000
NODE_12374_length_791_cov_38.791908	309	389	8	14	80	0.1750000
NODE_12374_length_791_cov_38.791908	309	389	11	30	80	0.3750000
NODE_12374_length_791_cov_38.791908	309	389	13	7	80	0.0875000
NODE_12374_length_791_cov_38.791908	309	389	14	29	80	0.3625000
NODE_12374_length_791_cov_38.791908	362	442	11	7	80	0.0875000
NODE_12374_length_791_cov_38.791908	362	442	13	11	80	0.1375000
NODE_12374_length_791_cov_38.791908	362	442	14	29	80	0.3625000
NODE_12374_length_791_cov_38.791908	362	442	15	22	80	0.2750000
NODE_12374_length_791_cov_38.791908	362	442	16	11	80	0.1375000
NODE_12375_length_791_cov_23.468208	328	408	3	32	80	0.4000000
NODE_12375_length_791_cov_23.468208	328	408	6	11	80	0.1375000
NODE_12375_length_791_cov_23.468208	328	408	8	32	80	0.4000000
NODE_12375_length_791_cov_23.468208	328	408	11	5	80	0.0625000
NODE_12375_length_791_cov_23.468208	381	461	8	59	80	0.7375000
NODE_12375_length_791_cov_23.468208	381	461	11	21	80	0.2625000
NODE_12376_length_791_cov_20.897399	299	379	3	80	80	1.0000000
NODE_12376_length_791_cov_20.897399	352	432	3	80	80	1.0000000
NODE_12377_length_791_cov_13.504335	339	419	3	9	80	0.1125000
NODE_12377_length_791_cov_13.504335	339	419	4	3	80	0.0375000
NODE_12377_length_791_cov_13.504335	339	419	5	1	80	0.0125000
NODE_12377_length_791_cov_13.504335	339	419	7	67	80	0.8375000
NODE_12377_length_791_cov_13.504335	392	472	7	68	80	0.8500000
NODE_12377_length_791_cov_13.504335	392	472	11	12	80	0.1500000
NODE_12379_length_791_cov_12.547688	338	418	0	80	80	1.0000000
NODE_12379_length_791_cov_12.547688	391	471	0	80	80	1.0000000
NODE_12380_length_791_cov_11.791908	440	520	4	8	80	0.1000000
NODE_12380_length_791_cov_11.791908	440	520	5	22	80	0.2750000
NODE_12380_length_791_cov_11.791908	440	520	6	32	80	0.4000000
NODE_12380_length_791_cov_11.791908	440	520	7	18	80	0.2250000
NODE_12380_length_791_cov_11.791908	493	573	4	59	80	0.7375000
NODE_12380_length_791_cov_11.791908	493	573	6	21	80	0.2625000
NODE_12381_length_791_cov_11.011561	337	417	0	10	80	0.1250000
NODE_12381_length_791_cov_11.011561	337	417	1	51	80	0.6375000
NODE_12381_length_791_cov_11.011561	337	417	2	19	80	0.2375000
NODE_12381_length_791_cov_11.011561	390	470	0	63	80	0.7875000
NODE_12381_length_791_cov_11.011561	390	470	1	17	80	0.2125000
NODE_12382_length_791_cov_8.757225	325	405	0	80	80	1.0000000
NODE_12382_length_791_cov_8.757225	378	458	0	80	80	1.0000000
NODE_12384_length_791_cov_8.125723	416	496	1	18	80	0.2250000
NODE_12384_length_791_cov_8.125723	416	496	2	62	80	0.7750000
NODE_12384_length_791_cov_8.125723	469	549	2	80	80	1.0000000
NODE_12409_length_790_cov_48.021708	526	606	3	38	80	0.4750000
NODE_12409_length_790_cov_48.021708	526	606	4	3	80	0.0375000
NODE_12409_length_790_cov_48.021708	526	606	5	32	80	0.4000000
NODE_12409_length_790_cov_48.021708	526	606	6	7	80	0.0875000
NODE_12409_length_790_cov_48.021708	579	659	2	37	80	0.4625000
NODE_12409_length_790_cov_48.021708	579	659	3	43	80	0.5375000
NODE_12410_length_790_cov_44.151954	343	423	14	15	80	0.1875000
NODE_12410_length_790_cov_44.151954	343	423	16	36	80	0.4500000
NODE_12410_length_790_cov_44.151954	343	423	19	14	80	0.1750000
NODE_12410_length_790_cov_44.151954	343	423	20	15	80	0.1875000
NODE_12410_length_790_cov_44.151954	396	438	9	7	42	0.1666667
NODE_12410_length_790_cov_44.151954	396	438	10	2	42	0.0476190
NODE_12410_length_790_cov_44.151954	396	438	11	1	42	0.0238095
NODE_12410_length_790_cov_44.151954	396	438	13	2	42	0.0476190
NODE_12410_length_790_cov_44.151954	396	438	14	18	42	0.4285714
NODE_12410_length_790_cov_44.151954	396	438	16	12	42	0.2857143
NODE_12410_length_790_cov_44.151954	696	776	2	23	80	0.2875000
NODE_12410_length_790_cov_44.151954	696	776	6	24	80	0.3000000
NODE_12410_length_790_cov_44.151954	696	776	7	1	80	0.0125000
NODE_12410_length_790_cov_44.151954	696	776	8	9	80	0.1125000
NODE_12410_length_790_cov_44.151954	696	776	9	18	80	0.2250000
NODE_12410_length_790_cov_44.151954	696	776	13	5	80	0.0625000
NODE_12411_length_790_cov_27.144718	291	371	0	80	80	1.0000000
NODE_12411_length_790_cov_27.144718	344	424	0	80	80	1.0000000
NODE_12412_length_790_cov_16.973951	232	312	16	31	80	0.3875000
NODE_12412_length_790_cov_16.973951	232	312	25	5	80	0.0625000
NODE_12412_length_790_cov_16.973951	232	312	32	1	80	0.0125000
NODE_12412_length_790_cov_16.973951	232	312	33	1	80	0.0125000
NODE_12412_length_790_cov_16.973951	232	312	38	1	80	0.0125000
NODE_12412_length_790_cov_16.973951	232	312	39	15	80	0.1875000
NODE_12412_length_790_cov_16.973951	232	312	44	3	80	0.0375000
NODE_12412_length_790_cov_16.973951	232	312	45	23	80	0.2875000
NODE_12412_length_790_cov_16.973951	285	365	24	1	80	0.0125000
NODE_12412_length_790_cov_16.973951	285	365	25	1	80	0.0125000
NODE_12412_length_790_cov_16.973951	285	365	26	7	80	0.0875000
NODE_12412_length_790_cov_16.973951	285	365	27	3	80	0.0375000
NODE_12412_length_790_cov_16.973951	285	365	28	1	80	0.0125000
NODE_12412_length_790_cov_16.973951	285	365	29	2	80	0.0250000
NODE_12412_length_790_cov_16.973951	285	365	31	5	80	0.0625000
NODE_12412_length_790_cov_16.973951	285	365	32	5	80	0.0625000
NODE_12412_length_790_cov_16.973951	285	365	33	12	80	0.1500000
NODE_12412_length_790_cov_16.973951	285	365	34	3	80	0.0375000
NODE_12412_length_790_cov_16.973951	285	365	38	1	80	0.0125000
NODE_12412_length_790_cov_16.973951	285	365	40	1	80	0.0125000
NODE_12412_length_790_cov_16.973951	285	365	42	2	80	0.0250000
NODE_12412_length_790_cov_16.973951	285	365	43	4	80	0.0500000
NODE_12412_length_790_cov_16.973951	285	365	44	4	80	0.0500000
NODE_12412_length_790_cov_16.973951	285	365	45	28	80	0.3500000
NODE_12413_length_790_cov_13.374819	204	284	3	49	80	0.6125000
NODE_12413_length_790_cov_13.374819	204	284	4	31	80	0.3875000
NODE_12413_length_790_cov_13.374819	257	337	4	49	80	0.6125000
NODE_12413_length_790_cov_13.374819	257	337	6	31	80	0.3875000
NODE_12415_length_790_cov_10.613603	302	382	3	3	80	0.0375000
NODE_12415_length_790_cov_10.613603	302	382	4	53	80	0.6625000
NODE_12415_length_790_cov_10.613603	302	382	5	24	80	0.3000000
NODE_12415_length_790_cov_10.613603	355	435	2	12	80	0.1500000
NODE_12415_length_790_cov_10.613603	355	435	4	39	80	0.4875000
NODE_12415_length_790_cov_10.613603	355	435	5	29	80	0.3625000
NODE_12418_length_790_cov_5.493488	271	351	0	36	80	0.4500000
NODE_12418_length_790_cov_5.493488	271	351	2	44	80	0.5500000
NODE_12418_length_790_cov_5.493488	324	404	0	80	80	1.0000000
NODE_12434_length_790_cov_1.463097	313	376	0	63	63	1.0000000
NODE_12452_length_789_cov_39.123188	226	306	4	31	80	0.3875000
NODE_12452_length_789_cov_39.123188	226	306	5	2	80	0.0250000
NODE_12452_length_789_cov_39.123188	226	306	6	12	80	0.1500000
NODE_12452_length_789_cov_39.123188	226	306	7	12	80	0.1500000
NODE_12452_length_789_cov_39.123188	226	306	8	7	80	0.0875000
NODE_12452_length_789_cov_39.123188	226	306	9	16	80	0.2000000
NODE_12452_length_789_cov_39.123188	279	359	7	4	80	0.0500000
NODE_12452_length_789_cov_39.123188	279	359	8	40	80	0.5000000
NODE_12452_length_789_cov_39.123188	279	359	9	36	80	0.4500000
NODE_12453_length_789_cov_37.205797	423	503	2	10	80	0.1250000
NODE_12453_length_789_cov_37.205797	423	503	4	44	80	0.5500000
NODE_12453_length_789_cov_37.205797	423	503	5	2	80	0.0250000
NODE_12453_length_789_cov_37.205797	423	503	6	2	80	0.0250000
NODE_12453_length_789_cov_37.205797	423	503	7	1	80	0.0125000
NODE_12453_length_789_cov_37.205797	423	503	8	7	80	0.0875000
NODE_12453_length_789_cov_37.205797	423	503	10	2	80	0.0250000
NODE_12453_length_789_cov_37.205797	423	503	12	12	80	0.1500000
NODE_12453_length_789_cov_37.205797	476	556	4	1	80	0.0125000
NODE_12453_length_789_cov_37.205797	476	556	5	2	80	0.0250000
NODE_12453_length_789_cov_37.205797	476	556	6	2	80	0.0250000
NODE_12453_length_789_cov_37.205797	476	556	7	1	80	0.0125000
NODE_12453_length_789_cov_37.205797	476	556	8	7	80	0.0875000
NODE_12453_length_789_cov_37.205797	476	556	10	2	80	0.0250000
NODE_12453_length_789_cov_37.205797	476	556	12	39	80	0.4875000
NODE_12453_length_789_cov_37.205797	476	556	13	19	80	0.2375000
NODE_12453_length_789_cov_37.205797	476	556	15	7	80	0.0875000
NODE_12454_length_789_cov_31.311594	223	303	6	6	80	0.0750000
NODE_12454_length_789_cov_31.311594	223	303	8	18	80	0.2250000
NODE_12454_length_789_cov_31.311594	223	303	9	9	80	0.1125000
NODE_12454_length_789_cov_31.311594	223	303	10	20	80	0.2500000
NODE_12454_length_789_cov_31.311594	223	303	11	27	80	0.3375000
NODE_12454_length_789_cov_31.311594	276	356	8	9	80	0.1125000
NODE_12454_length_789_cov_31.311594	276	356	9	3	80	0.0375000
NODE_12454_length_789_cov_31.311594	276	356	10	25	80	0.3125000
NODE_12454_length_789_cov_31.311594	276	356	11	38	80	0.4750000
NODE_12454_length_789_cov_31.311594	276	356	12	5	80	0.0625000
NODE_12455_length_789_cov_30.536232	306	386	9	20	80	0.2500000
NODE_12455_length_789_cov_30.536232	306	386	11	35	80	0.4375000
NODE_12455_length_789_cov_30.536232	306	386	12	25	80	0.3125000
NODE_12455_length_789_cov_30.536232	359	439	5	16	80	0.2000000
NODE_12455_length_789_cov_30.536232	359	439	7	14	80	0.1750000
NODE_12455_length_789_cov_30.536232	359	439	8	8	80	0.1000000
NODE_12455_length_789_cov_30.536232	359	439	9	22	80	0.2750000
NODE_12455_length_789_cov_30.536232	359	439	12	20	80	0.2500000
NODE_12456_length_789_cov_24.886957	343	423	6	40	80	0.5000000
NODE_12456_length_789_cov_24.886957	343	423	8	40	80	0.5000000
NODE_12456_length_789_cov_24.886957	396	476	0	3	80	0.0375000
NODE_12456_length_789_cov_24.886957	396	476	4	15	80	0.1875000
NODE_12456_length_789_cov_24.886957	396	476	6	62	80	0.7750000
NODE_12457_length_789_cov_23.539130	357	437	3	37	80	0.4625000
NODE_12457_length_789_cov_23.539130	357	437	5	4	80	0.0500000
NODE_12457_length_789_cov_23.539130	357	437	7	11	80	0.1375000
NODE_12457_length_789_cov_23.539130	357	437	8	28	80	0.3500000
NODE_12457_length_789_cov_23.539130	410	490	8	60	80	0.7500000
NODE_12457_length_789_cov_23.539130	410	490	9	18	80	0.2250000
NODE_12457_length_789_cov_23.539130	410	490	11	2	80	0.0250000
NODE_12458_length_789_cov_16.169565	392	472	3	2	80	0.0250000
NODE_12458_length_789_cov_16.169565	392	472	4	20	80	0.2500000
NODE_12458_length_789_cov_16.169565	392	472	5	1	80	0.0125000
NODE_12458_length_789_cov_16.169565	392	472	6	23	80	0.2875000
NODE_12458_length_789_cov_16.169565	392	472	7	34	80	0.4250000
NODE_12458_length_789_cov_16.169565	445	525	5	15	80	0.1875000
NODE_12458_length_789_cov_16.169565	445	525	6	25	80	0.3125000
NODE_12458_length_789_cov_16.169565	445	525	7	37	80	0.4625000
NODE_12458_length_789_cov_16.169565	445	525	8	3	80	0.0375000
NODE_12459_length_789_cov_15.175362	242	322	0	6	80	0.0750000
NODE_12459_length_789_cov_15.175362	242	322	1	30	80	0.3750000
NODE_12459_length_789_cov_15.175362	242	322	2	44	80	0.5500000
NODE_12459_length_789_cov_15.175362	295	375	2	52	80	0.6500000
NODE_12459_length_789_cov_15.175362	295	375	3	28	80	0.3500000
NODE_12459_length_789_cov_15.175362	371	451	2	53	80	0.6625000
NODE_12459_length_789_cov_15.175362	371	451	3	27	80	0.3375000
NODE_12459_length_789_cov_15.175362	424	504	2	55	80	0.6875000
NODE_12459_length_789_cov_15.175362	424	504	3	25	80	0.3125000
NODE_12460_length_789_cov_7.276812	306	386	0	80	80	1.0000000
NODE_12460_length_789_cov_7.276812	359	439	0	80	80	1.0000000
NODE_12482_length_788_cov_43.091437	335	415	7	10	80	0.1250000
NODE_12482_length_788_cov_43.091437	335	415	9	15	80	0.1875000
NODE_12482_length_788_cov_43.091437	335	415	11	1	80	0.0125000
NODE_12482_length_788_cov_43.091437	335	415	12	12	80	0.1500000
NODE_12482_length_788_cov_43.091437	335	415	13	21	80	0.2625000
NODE_12482_length_788_cov_43.091437	335	415	14	2	80	0.0250000
NODE_12482_length_788_cov_43.091437	335	415	15	19	80	0.2375000
NODE_12482_length_788_cov_43.091437	388	460	13	8	72	0.1111111
NODE_12482_length_788_cov_43.091437	388	460	15	21	72	0.2916667
NODE_12482_length_788_cov_43.091437	388	460	17	3	72	0.0416667
NODE_12482_length_788_cov_43.091437	388	460	19	1	72	0.0138889
NODE_12482_length_788_cov_43.091437	388	460	20	29	72	0.4027778
NODE_12482_length_788_cov_43.091437	388	460	22	10	72	0.1388889
NODE_12483_length_788_cov_38.914369	345	425	3	11	80	0.1375000
NODE_12483_length_788_cov_38.914369	345	425	5	1	80	0.0125000
NODE_12483_length_788_cov_38.914369	345	425	7	17	80	0.2125000
NODE_12483_length_788_cov_38.914369	345	425	10	51	80	0.6375000
NODE_12483_length_788_cov_38.914369	398	478	6	10	80	0.1250000
NODE_12483_length_788_cov_38.914369	398	478	8	21	80	0.2625000
NODE_12483_length_788_cov_38.914369	398	478	9	14	80	0.1750000
NODE_12483_length_788_cov_38.914369	398	478	10	35	80	0.4375000
NODE_12484_length_788_cov_36.148041	320	400	5	3	80	0.0375000
NODE_12484_length_788_cov_36.148041	320	400	6	54	80	0.6750000
NODE_12484_length_788_cov_36.148041	320	400	7	9	80	0.1125000
NODE_12484_length_788_cov_36.148041	320	400	8	14	80	0.1750000
NODE_12484_length_788_cov_36.148041	373	453	3	15	80	0.1875000
NODE_12484_length_788_cov_36.148041	373	453	4	16	80	0.2000000
NODE_12484_length_788_cov_36.148041	373	453	6	19	80	0.2375000
NODE_12484_length_788_cov_36.148041	373	453	7	9	80	0.1125000
NODE_12484_length_788_cov_36.148041	373	453	8	21	80	0.2625000
NODE_12485_length_788_cov_35.460087	346	426	8	12	80	0.1500000
NODE_12485_length_788_cov_35.460087	346	426	10	10	80	0.1250000
NODE_12485_length_788_cov_35.460087	346	426	11	16	80	0.2000000
NODE_12485_length_788_cov_35.460087	346	426	12	9	80	0.1125000
NODE_12485_length_788_cov_35.460087	346	426	14	33	80	0.4125000
NODE_12485_length_788_cov_35.460087	399	479	9	13	80	0.1625000
NODE_12485_length_788_cov_35.460087	399	479	12	32	80	0.4000000
NODE_12485_length_788_cov_35.460087	399	479	14	35	80	0.4375000
NODE_12486_length_788_cov_30.785196	278	358	1	69	80	0.8625000
NODE_12486_length_788_cov_30.785196	278	358	3	11	80	0.1375000
NODE_12486_length_788_cov_30.785196	331	411	1	16	80	0.2000000
NODE_12486_length_788_cov_30.785196	331	411	2	24	80	0.3000000
NODE_12486_length_788_cov_30.785196	331	411	3	40	80	0.5000000
NODE_12488_length_788_cov_20.867925	300	380	3	80	80	1.0000000
NODE_12488_length_788_cov_20.867925	353	430	0	27	77	0.3506494
NODE_12488_length_788_cov_20.867925	353	430	3	50	77	0.6493506
NODE_12489_length_788_cov_20.821480	322	402	7	8	80	0.1000000
NODE_12489_length_788_cov_20.821480	322	402	9	7	80	0.0875000
NODE_12489_length_788_cov_20.821480	322	402	10	17	80	0.2125000
NODE_12489_length_788_cov_20.821480	322	402	11	13	80	0.1625000
NODE_12489_length_788_cov_20.821480	322	402	12	35	80	0.4375000
NODE_12489_length_788_cov_20.821480	375	455	5	30	80	0.3750000
NODE_12489_length_788_cov_20.821480	375	455	7	31	80	0.3875000
NODE_12489_length_788_cov_20.821480	375	455	9	7	80	0.0875000
NODE_12489_length_788_cov_20.821480	375	455	10	12	80	0.1500000
NODE_12490_length_788_cov_15.570392	342	422	0	19	80	0.2375000
NODE_12490_length_788_cov_15.570392	342	422	2	61	80	0.7625000
NODE_12490_length_788_cov_15.570392	395	475	2	27	80	0.3375000
NODE_12490_length_788_cov_15.570392	395	475	3	53	80	0.6625000
NODE_12491_length_788_cov_12.235123	241	321	0	80	80	1.0000000
NODE_12491_length_788_cov_12.235123	294	374	0	80	80	1.0000000
NODE_12492_length_788_cov_10.509434	405	480	3	11	75	0.1466667
NODE_12492_length_788_cov_10.509434	405	480	5	5	75	0.0666667
NODE_12492_length_788_cov_10.509434	405	480	6	59	75	0.7866667
NODE_12493_length_788_cov_9.737300	310	390	0	19	80	0.2375000
NODE_12493_length_788_cov_9.737300	310	390	1	61	80	0.7625000
NODE_12493_length_788_cov_9.737300	363	443	1	80	80	1.0000000
NODE_12494_length_788_cov_8.872279	280	360	3	22	80	0.2750000
NODE_12494_length_788_cov_8.872279	280	360	4	58	80	0.7250000
NODE_12494_length_788_cov_8.872279	333	413	2	19	80	0.2375000
NODE_12494_length_788_cov_8.872279	333	413	3	38	80	0.4750000
NODE_12494_length_788_cov_8.872279	333	413	4	23	80	0.2875000
NODE_12516_length_787_cov_34.683140	274	335	4	27	61	0.4426230
NODE_12516_length_787_cov_34.683140	274	335	6	24	61	0.3934426
NODE_12516_length_787_cov_34.683140	274	335	7	2	61	0.0327869
NODE_12516_length_787_cov_34.683140	274	335	8	8	61	0.1311475
NODE_12516_length_787_cov_34.683140	319	380	0	39	61	0.6393443
NODE_12516_length_787_cov_34.683140	319	380	1	6	61	0.0983607
NODE_12516_length_787_cov_34.683140	319	380	4	16	61	0.2622951
NODE_12517_length_787_cov_28.039244	252	329	21	7	77	0.0909091
NODE_12517_length_787_cov_28.039244	252	329	22	10	77	0.1298701
NODE_12517_length_787_cov_28.039244	252	329	23	14	77	0.1818182
NODE_12517_length_787_cov_28.039244	252	329	24	12	77	0.1558442
NODE_12517_length_787_cov_28.039244	252	329	25	4	77	0.0519481
NODE_12517_length_787_cov_28.039244	252	329	26	18	77	0.2337662
NODE_12517_length_787_cov_28.039244	252	329	27	6	77	0.0779221
NODE_12517_length_787_cov_28.039244	252	329	28	6	77	0.0779221
NODE_12517_length_787_cov_28.039244	302	370	16	1	68	0.0147059
NODE_12517_length_787_cov_28.039244	302	370	17	6	68	0.0882353
NODE_12517_length_787_cov_28.039244	302	370	21	13	68	0.1911765
NODE_12517_length_787_cov_28.039244	302	370	22	25	68	0.3676471
NODE_12517_length_787_cov_28.039244	302	370	23	5	68	0.0735294
NODE_12517_length_787_cov_28.039244	302	370	24	6	68	0.0882353
NODE_12517_length_787_cov_28.039244	302	370	26	12	68	0.1764706
NODE_12518_length_787_cov_25.422965	351	431	1	80	80	1.0000000
NODE_12518_length_787_cov_25.422965	404	484	0	37	80	0.4625000
NODE_12518_length_787_cov_25.422965	404	484	1	43	80	0.5375000
NODE_12519_length_787_cov_24.857558	319	399	5	48	80	0.6000000
NODE_12519_length_787_cov_24.857558	319	399	6	32	80	0.4000000
NODE_12519_length_787_cov_24.857558	372	452	1	15	80	0.1875000
NODE_12519_length_787_cov_24.857558	372	452	2	7	80	0.0875000
NODE_12519_length_787_cov_24.857558	372	452	3	23	80	0.2875000
NODE_12519_length_787_cov_24.857558	372	452	5	35	80	0.4375000
NODE_12520_length_787_cov_21.357558	291	371	1	38	80	0.4750000
NODE_12520_length_787_cov_21.357558	291	371	2	42	80	0.5250000
NODE_12520_length_787_cov_21.357558	344	424	1	80	80	1.0000000
NODE_12521_length_787_cov_17.360465	396	476	0	80	80	1.0000000
NODE_12521_length_787_cov_17.360465	449	529	0	80	80	1.0000000
NODE_12522_length_787_cov_14.677326	178	258	2	19	80	0.2375000
NODE_12522_length_787_cov_14.677326	178	258	4	42	80	0.5250000
NODE_12522_length_787_cov_14.677326	178	258	5	2	80	0.0250000
NODE_12522_length_787_cov_14.677326	178	258	6	7	80	0.0875000
NODE_12522_length_787_cov_14.677326	178	258	7	10	80	0.1250000
NODE_12522_length_787_cov_14.677326	231	311	4	8	80	0.1000000
NODE_12522_length_787_cov_14.677326	231	311	5	2	80	0.0250000
NODE_12522_length_787_cov_14.677326	231	311	6	7	80	0.0875000
NODE_12522_length_787_cov_14.677326	231	311	7	28	80	0.3500000
NODE_12522_length_787_cov_14.677326	231	311	8	35	80	0.4375000
NODE_12523_length_787_cov_12.959302	331	411	1	24	80	0.3000000
NODE_12523_length_787_cov_12.959302	331	411	2	56	80	0.7000000
NODE_12523_length_787_cov_12.959302	384	464	1	65	80	0.8125000
NODE_12523_length_787_cov_12.959302	384	464	2	15	80	0.1875000
NODE_12524_length_787_cov_12.748547	426	506	0	80	80	1.0000000
NODE_12524_length_787_cov_12.748547	479	559	0	80	80	1.0000000
NODE_12525_length_787_cov_12.369186	338	418	0	80	80	1.0000000
NODE_12525_length_787_cov_12.369186	391	471	0	80	80	1.0000000
NODE_12526_length_787_cov_9.213663	376	456	0	12	80	0.1500000
NODE_12526_length_787_cov_9.213663	376	456	1	68	80	0.8500000
NODE_12527_length_787_cov_8.857558	344	424	2	78	80	0.9750000
NODE_12527_length_787_cov_8.857558	344	424	4	2	80	0.0250000
NODE_12527_length_787_cov_8.857558	397	477	2	25	80	0.3125000
NODE_12527_length_787_cov_8.857558	397	477	3	16	80	0.2000000
NODE_12527_length_787_cov_8.857558	397	477	4	26	80	0.3250000
NODE_12527_length_787_cov_8.857558	397	477	5	13	80	0.1625000
NODE_12529_length_787_cov_8.186047	508	552	0	44	44	1.0000000
NODE_12541_length_787_cov_2.188953	505	552	0	47	47	1.0000000
NODE_12562_length_786_cov_36.441048	431	511	0	80	80	1.0000000
NODE_12562_length_786_cov_36.441048	484	564	0	80	80	1.0000000
NODE_12563_length_786_cov_23.771470	235	315	1	10	80	0.1250000
NODE_12563_length_786_cov_23.771470	235	315	3	38	80	0.4750000
NODE_12563_length_786_cov_23.771470	235	315	4	29	80	0.3625000
NODE_12563_length_786_cov_23.771470	235	315	6	3	80	0.0375000
NODE_12563_length_786_cov_23.771470	288	368	4	24	80	0.3000000
NODE_12563_length_786_cov_23.771470	288	368	5	1	80	0.0125000
NODE_12563_length_786_cov_23.771470	288	368	6	55	80	0.6875000
NODE_12564_length_786_cov_23.333333	361	436	1	32	75	0.4266667
NODE_12564_length_786_cov_23.333333	361	436	2	15	75	0.2000000
NODE_12564_length_786_cov_23.333333	361	436	3	11	75	0.1466667
NODE_12564_length_786_cov_23.333333	361	436	5	17	75	0.2266667
NODE_12564_length_786_cov_23.333333	362	436	1	31	74	0.4189189
NODE_12564_length_786_cov_23.333333	362	436	2	15	74	0.2027027
NODE_12564_length_786_cov_23.333333	362	436	3	11	74	0.1486486
NODE_12564_length_786_cov_23.333333	362	436	5	17	74	0.2297297
NODE_12564_length_786_cov_23.333333	375	436	1	18	61	0.2950820
NODE_12564_length_786_cov_23.333333	375	436	2	15	61	0.2459016
NODE_12564_length_786_cov_23.333333	375	436	3	11	61	0.1803279
NODE_12564_length_786_cov_23.333333	375	436	5	17	61	0.2786885
NODE_12564_length_786_cov_23.333333	414	489	3	5	75	0.0666667
NODE_12564_length_786_cov_23.333333	414	489	5	34	75	0.4533333
NODE_12564_length_786_cov_23.333333	414	489	6	36	75	0.4800000
NODE_12564_length_786_cov_23.333333	414	489	3	5	75	0.0666667
NODE_12564_length_786_cov_23.333333	414	489	5	34	75	0.4533333
NODE_12564_length_786_cov_23.333333	414	489	6	36	75	0.4800000
NODE_12564_length_786_cov_23.333333	414	489	3	5	75	0.0666667
NODE_12564_length_786_cov_23.333333	414	489	5	34	75	0.4533333
NODE_12564_length_786_cov_23.333333	414	489	6	36	75	0.4800000
NODE_12564_length_786_cov_23.333333	490	564	6	44	74	0.5945946
NODE_12564_length_786_cov_23.333333	490	564	7	18	74	0.2432432
NODE_12564_length_786_cov_23.333333	490	564	8	12	74	0.1621622
NODE_12565_length_786_cov_19.279476	310	375	2	30	65	0.4615385
NODE_12565_length_786_cov_19.279476	310	375	4	20	65	0.3076923
NODE_12565_length_786_cov_19.279476	310	375	6	8	65	0.1230769
NODE_12565_length_786_cov_19.279476	310	375	8	7	65	0.1076923
NODE_12565_length_786_cov_19.279476	371	441	8	70	70	1.0000000
NODE_12565_length_786_cov_19.279476	371	451	8	80	80	1.0000000
NODE_12565_length_786_cov_19.279476	424	491	8	67	67	1.0000000
NODE_12566_length_786_cov_18.652111	251	331	5	36	80	0.4500000
NODE_12566_length_786_cov_18.652111	251	331	7	44	80	0.5500000
NODE_12566_length_786_cov_18.652111	304	384	3	18	80	0.2250000
NODE_12566_length_786_cov_18.652111	304	384	4	1	80	0.0125000
NODE_12566_length_786_cov_18.652111	304	384	5	61	80	0.7625000
NODE_12567_length_786_cov_16.704512	319	399	5	3	80	0.0375000
NODE_12567_length_786_cov_16.704512	319	399	6	22	80	0.2750000
NODE_12567_length_786_cov_16.704512	319	399	7	1	80	0.0125000
NODE_12567_length_786_cov_16.704512	319	399	8	20	80	0.2500000
NODE_12567_length_786_cov_16.704512	319	399	9	30	80	0.3750000
NODE_12567_length_786_cov_16.704512	319	399	11	4	80	0.0500000
NODE_12567_length_786_cov_16.704512	372	452	7	20	80	0.2500000
NODE_12567_length_786_cov_16.704512	372	452	9	33	80	0.4125000
NODE_12567_length_786_cov_16.704512	372	452	10	11	80	0.1375000
NODE_12567_length_786_cov_16.704512	372	452	11	16	80	0.2000000
NODE_12568_length_786_cov_16.254731	378	458	4	18	80	0.2250000
NODE_12568_length_786_cov_16.254731	378	458	5	55	80	0.6875000
NODE_12568_length_786_cov_16.254731	378	458	7	7	80	0.0875000
NODE_12568_length_786_cov_16.254731	431	511	0	47	80	0.5875000
NODE_12568_length_786_cov_16.254731	431	511	4	1	80	0.0125000
NODE_12568_length_786_cov_16.254731	431	511	5	32	80	0.4000000
NODE_12571_length_786_cov_10.053857	381	461	0	21	80	0.2625000
NODE_12571_length_786_cov_10.053857	381	461	1	59	80	0.7375000
NODE_12571_length_786_cov_10.053857	434	514	1	69	80	0.8625000
NODE_12571_length_786_cov_10.053857	434	514	2	11	80	0.1375000
NODE_12572_length_786_cov_7.455604	400	473	0	73	73	1.0000000
NODE_12572_length_786_cov_7.455604	453	533	0	80	80	1.0000000
NODE_12573_length_786_cov_7.119360	276	356	2	80	80	1.0000000
NODE_12573_length_786_cov_7.119360	329	409	2	80	80	1.0000000
NODE_12575_length_786_cov_6.771470	382	462	1	21	80	0.2625000
NODE_12575_length_786_cov_6.771470	382	462	2	39	80	0.4875000
NODE_12575_length_786_cov_6.771470	382	462	3	20	80	0.2500000
NODE_12575_length_786_cov_6.771470	435	515	2	7	80	0.0875000
NODE_12575_length_786_cov_6.771470	435	515	3	52	80	0.6500000
NODE_12575_length_786_cov_6.771470	435	515	4	21	80	0.2625000
NODE_12603_length_785_cov_83.972303	315	395	19	4	80	0.0500000
NODE_12603_length_785_cov_83.972303	315	395	21	3	80	0.0375000
NODE_12603_length_785_cov_83.972303	315	395	22	1	80	0.0125000
NODE_12603_length_785_cov_83.972303	315	395	23	32	80	0.4000000
NODE_12603_length_785_cov_83.972303	315	395	24	19	80	0.2375000
NODE_12603_length_785_cov_83.972303	315	395	25	9	80	0.1125000
NODE_12603_length_785_cov_83.972303	315	395	27	1	80	0.0125000
NODE_12603_length_785_cov_83.972303	315	395	28	4	80	0.0500000
NODE_12603_length_785_cov_83.972303	315	395	29	7	80	0.0875000
NODE_12603_length_785_cov_83.972303	368	448	19	24	80	0.3000000
NODE_12603_length_785_cov_83.972303	368	448	20	4	80	0.0500000
NODE_12603_length_785_cov_83.972303	368	448	22	5	80	0.0625000
NODE_12603_length_785_cov_83.972303	368	448	23	13	80	0.1625000
NODE_12603_length_785_cov_83.972303	368	448	24	6	80	0.0750000
NODE_12603_length_785_cov_83.972303	368	448	26	4	80	0.0500000
NODE_12603_length_785_cov_83.972303	368	448	27	11	80	0.1375000
NODE_12603_length_785_cov_83.972303	368	448	28	4	80	0.0500000
NODE_12603_length_785_cov_83.972303	368	448	29	9	80	0.1125000
NODE_12604_length_785_cov_33.911079	477	557	1	13	80	0.1625000
NODE_12604_length_785_cov_33.911079	477	557	2	5	80	0.0625000
NODE_12604_length_785_cov_33.911079	477	557	3	17	80	0.2125000
NODE_12604_length_785_cov_33.911079	477	557	4	2	80	0.0250000
NODE_12604_length_785_cov_33.911079	477	557	5	43	80	0.5375000
NODE_12604_length_785_cov_33.911079	530	610	4	55	80	0.6875000
NODE_12604_length_785_cov_33.911079	530	610	5	25	80	0.3125000
NODE_12605_length_785_cov_21.174927	265	299	0	27	34	0.7941176
NODE_12605_length_785_cov_21.174927	265	299	1	7	34	0.2058824
NODE_12605_length_785_cov_21.174927	295	375	1	9	80	0.1125000
NODE_12605_length_785_cov_21.174927	295	375	2	4	80	0.0500000
NODE_12605_length_785_cov_21.174927	295	375	3	26	80	0.3250000
NODE_12605_length_785_cov_21.174927	295	375	5	12	80	0.1500000
NODE_12605_length_785_cov_21.174927	295	375	6	21	80	0.2625000
NODE_12605_length_785_cov_21.174927	295	375	7	8	80	0.1000000
NODE_12605_length_785_cov_21.174927	348	428	6	19	80	0.2375000
NODE_12605_length_785_cov_21.174927	348	428	7	13	80	0.1625000
NODE_12605_length_785_cov_21.174927	348	428	9	48	80	0.6000000
NODE_12606_length_785_cov_18.612245	291	371	0	9	80	0.1125000
NODE_12606_length_785_cov_18.612245	291	371	1	23	80	0.2875000
NODE_12606_length_785_cov_18.612245	291	371	2	3	80	0.0375000
NODE_12606_length_785_cov_18.612245	291	371	3	15	80	0.1875000
NODE_12606_length_785_cov_18.612245	291	371	4	24	80	0.3000000
NODE_12606_length_785_cov_18.612245	291	371	5	6	80	0.0750000
NODE_12606_length_785_cov_18.612245	344	424	4	21	80	0.2625000
NODE_12606_length_785_cov_18.612245	344	424	5	31	80	0.3875000
NODE_12606_length_785_cov_18.612245	344	424	6	28	80	0.3500000
NODE_12606_length_785_cov_18.612245	684	705	0	21	21	1.0000000
NODE_12607_length_785_cov_9.893586	153	233	2	49	80	0.6125000
NODE_12607_length_785_cov_9.893586	153	233	3	1	80	0.0125000
NODE_12607_length_785_cov_9.893586	153	233	4	30	80	0.3750000
NODE_12607_length_785_cov_9.893586	206	286	2	80	80	1.0000000
NODE_12645_length_784_cov_203.604380	5	85	9	36	80	0.4500000
NODE_12645_length_784_cov_203.604380	5	85	11	3	80	0.0375000
NODE_12645_length_784_cov_203.604380	5	85	14	9	80	0.1125000
NODE_12645_length_784_cov_203.604380	5	85	15	1	80	0.0125000
NODE_12645_length_784_cov_203.604380	5	85	17	2	80	0.0250000
NODE_12645_length_784_cov_203.604380	5	85	21	4	80	0.0500000
NODE_12645_length_784_cov_203.604380	5	85	23	10	80	0.1250000
NODE_12645_length_784_cov_203.604380	5	85	24	15	80	0.1875000
NODE_12645_length_784_cov_203.604380	58	138	21	2	80	0.0250000
NODE_12645_length_784_cov_203.604380	58	138	23	10	80	0.1250000
NODE_12645_length_784_cov_203.604380	58	138	24	54	80	0.6750000
NODE_12645_length_784_cov_203.604380	58	138	25	14	80	0.1750000
NODE_12646_length_784_cov_45.210219	49	129	0	9	80	0.1125000
NODE_12646_length_784_cov_45.210219	49	129	2	71	80	0.8875000
NODE_12646_length_784_cov_45.210219	102	182	2	48	80	0.6000000
NODE_12646_length_784_cov_45.210219	102	182	4	32	80	0.4000000
NODE_12646_length_784_cov_45.210219	218	298	6	7	80	0.0875000
NODE_12646_length_784_cov_45.210219	218	298	7	20	80	0.2500000
NODE_12646_length_784_cov_45.210219	218	298	8	53	80	0.6625000
NODE_12646_length_784_cov_45.210219	271	351	6	10	80	0.1250000
NODE_12646_length_784_cov_45.210219	271	351	7	41	80	0.5125000
NODE_12646_length_784_cov_45.210219	271	351	8	29	80	0.3625000
NODE_12646_length_784_cov_45.210219	347	427	1	32	80	0.4000000
NODE_12646_length_784_cov_45.210219	347	427	2	20	80	0.2500000
NODE_12646_length_784_cov_45.210219	347	427	3	9	80	0.1125000
NODE_12646_length_784_cov_45.210219	347	427	4	3	80	0.0375000
NODE_12646_length_784_cov_45.210219	347	427	6	9	80	0.1125000
NODE_12646_length_784_cov_45.210219	347	427	7	7	80	0.0875000
NODE_12646_length_784_cov_45.210219	347	427	1	32	80	0.4000000
NODE_12646_length_784_cov_45.210219	347	427	2	20	80	0.2500000
NODE_12646_length_784_cov_45.210219	347	427	3	9	80	0.1125000
NODE_12646_length_784_cov_45.210219	347	427	4	3	80	0.0375000
NODE_12646_length_784_cov_45.210219	347	427	6	9	80	0.1125000
NODE_12646_length_784_cov_45.210219	347	427	7	7	80	0.0875000
NODE_12646_length_784_cov_45.210219	347	427	1	32	80	0.4000000
NODE_12646_length_784_cov_45.210219	347	427	2	20	80	0.2500000
NODE_12646_length_784_cov_45.210219	347	427	3	9	80	0.1125000
NODE_12646_length_784_cov_45.210219	347	427	4	3	80	0.0375000
NODE_12646_length_784_cov_45.210219	347	427	6	9	80	0.1125000
NODE_12646_length_784_cov_45.210219	347	427	7	7	80	0.0875000
NODE_12646_length_784_cov_45.210219	400	447	1	47	47	1.0000000
NODE_12646_length_784_cov_45.210219	400	480	0	20	80	0.2500000
NODE_12646_length_784_cov_45.210219	400	480	1	60	80	0.7500000
NODE_12646_length_784_cov_45.210219	400	455	1	55	55	1.0000000
NODE_12647_length_784_cov_33.543066	405	485	7	22	80	0.2750000
NODE_12647_length_784_cov_33.543066	405	485	8	3	80	0.0375000
NODE_12647_length_784_cov_33.543066	405	485	9	11	80	0.1375000
NODE_12647_length_784_cov_33.543066	405	485	13	2	80	0.0250000
NODE_12647_length_784_cov_33.543066	405	485	17	25	80	0.3125000
NODE_12647_length_784_cov_33.543066	405	485	18	17	80	0.2125000
NODE_12647_length_784_cov_33.543066	458	538	15	28	80	0.3500000
NODE_12647_length_784_cov_33.543066	458	538	16	8	80	0.1000000
NODE_12647_length_784_cov_33.543066	458	538	17	27	80	0.3375000
NODE_12647_length_784_cov_33.543066	458	538	18	17	80	0.2125000
NODE_12648_length_784_cov_21.762044	318	398	4	3	80	0.0375000
NODE_12648_length_784_cov_21.762044	318	398	5	3	80	0.0375000
NODE_12648_length_784_cov_21.762044	318	398	6	33	80	0.4125000
NODE_12648_length_784_cov_21.762044	318	398	7	12	80	0.1500000
NODE_12648_length_784_cov_21.762044	318	398	8	29	80	0.3625000
NODE_12648_length_784_cov_21.762044	371	451	8	33	80	0.4125000
NODE_12648_length_784_cov_21.762044	371	451	9	47	80	0.5875000
NODE_12649_length_784_cov_20.583942	286	366	1	17	80	0.2125000
NODE_12649_length_784_cov_20.583942	286	366	2	5	80	0.0625000
NODE_12649_length_784_cov_20.583942	286	366	4	58	80	0.7250000
NODE_12649_length_784_cov_20.583942	339	419	0	25	80	0.3125000
NODE_12649_length_784_cov_20.583942	339	419	1	45	80	0.5625000
NODE_12649_length_784_cov_20.583942	339	419	2	5	80	0.0625000
NODE_12649_length_784_cov_20.583942	339	419	4	5	80	0.0625000
NODE_12649_length_784_cov_20.583942	415	495	0	80	80	1.0000000
NODE_12649_length_784_cov_20.583942	468	548	0	80	80	1.0000000
NODE_12650_length_784_cov_19.448175	217	297	4	69	80	0.8625000
NODE_12650_length_784_cov_19.448175	217	297	5	11	80	0.1375000
NODE_12650_length_784_cov_19.448175	270	350	2	8	80	0.1000000
NODE_12650_length_784_cov_19.448175	270	350	3	14	80	0.1750000
NODE_12650_length_784_cov_19.448175	270	350	4	57	80	0.7125000
NODE_12650_length_784_cov_19.448175	270	350	5	1	80	0.0125000
NODE_12652_length_784_cov_12.480292	297	377	14	25	80	0.3125000
NODE_12652_length_784_cov_12.480292	297	377	15	55	80	0.6875000
NODE_12652_length_784_cov_12.480292	350	430	12	37	80	0.4625000
NODE_12652_length_784_cov_12.480292	350	430	14	22	80	0.2750000
NODE_12652_length_784_cov_12.480292	350	430	15	21	80	0.2625000
NODE_12653_length_784_cov_9.296350	250	330	2	46	80	0.5750000
NODE_12653_length_784_cov_9.296350	250	330	3	34	80	0.4250000
NODE_12653_length_784_cov_9.296350	303	383	2	19	80	0.2375000
NODE_12653_length_784_cov_9.296350	303	383	3	16	80	0.2000000
NODE_12653_length_784_cov_9.296350	303	383	4	45	80	0.5625000
NODE_12653_length_784_cov_9.296350	379	459	4	33	80	0.4125000
NODE_12653_length_784_cov_9.296350	379	459	5	36	80	0.4500000
NODE_12653_length_784_cov_9.296350	379	459	6	11	80	0.1375000
NODE_12653_length_784_cov_9.296350	432	512	3	24	80	0.3000000
NODE_12653_length_784_cov_9.296350	432	512	4	46	80	0.5750000
NODE_12653_length_784_cov_9.296350	432	512	5	10	80	0.1250000
NODE_12654_length_784_cov_6.316788	274	354	5	13	80	0.1625000
NODE_12654_length_784_cov_6.316788	274	354	6	50	80	0.6250000
NODE_12654_length_784_cov_6.316788	274	354	7	17	80	0.2125000
NODE_12654_length_784_cov_6.316788	327	407	3	27	80	0.3375000
NODE_12654_length_784_cov_6.316788	327	407	4	23	80	0.2875000
NODE_12654_length_784_cov_6.316788	327	407	5	13	80	0.1625000
NODE_12654_length_784_cov_6.316788	327	407	7	17	80	0.2125000
NODE_12688_length_783_cov_41.849415	459	539	16	6	80	0.0750000
NODE_12688_length_783_cov_41.849415	459	539	17	10	80	0.1250000
NODE_12688_length_783_cov_41.849415	459	539	18	33	80	0.4125000
NODE_12688_length_783_cov_41.849415	459	539	19	10	80	0.1250000
NODE_12688_length_783_cov_41.849415	459	539	20	12	80	0.1500000
NODE_12688_length_783_cov_41.849415	459	539	22	9	80	0.1125000
NODE_12688_length_783_cov_41.849415	512	592	12	8	80	0.1000000
NODE_12688_length_783_cov_41.849415	512	592	13	39	80	0.4875000
NODE_12688_length_783_cov_41.849415	512	592	15	2	80	0.0250000
NODE_12688_length_783_cov_41.849415	512	592	16	10	80	0.1250000
NODE_12688_length_783_cov_41.849415	512	592	17	10	80	0.1250000
NODE_12688_length_783_cov_41.849415	512	592	19	1	80	0.0125000
NODE_12688_length_783_cov_41.849415	512	592	20	6	80	0.0750000
NODE_12688_length_783_cov_41.849415	512	592	22	4	80	0.0500000
NODE_12689_length_783_cov_39.881579	230	310	3	7	80	0.0875000
NODE_12689_length_783_cov_39.881579	230	310	5	11	80	0.1375000
NODE_12689_length_783_cov_39.881579	230	310	7	9	80	0.1125000
NODE_12689_length_783_cov_39.881579	230	310	8	19	80	0.2375000
NODE_12689_length_783_cov_39.881579	230	310	9	27	80	0.3375000
NODE_12689_length_783_cov_39.881579	230	310	10	7	80	0.0875000
NODE_12689_length_783_cov_39.881579	283	363	9	26	80	0.3250000
NODE_12689_length_783_cov_39.881579	283	363	10	25	80	0.3125000
NODE_12689_length_783_cov_39.881579	283	363	11	10	80	0.1250000
NODE_12689_length_783_cov_39.881579	283	363	13	18	80	0.2250000
NODE_12689_length_783_cov_39.881579	283	363	17	1	80	0.0125000
NODE_12689_length_783_cov_39.881579	359	439	13	19	80	0.2375000
NODE_12689_length_783_cov_39.881579	359	439	14	25	80	0.3125000
NODE_12689_length_783_cov_39.881579	359	439	15	11	80	0.1375000
NODE_12689_length_783_cov_39.881579	359	439	17	22	80	0.2750000
NODE_12689_length_783_cov_39.881579	359	439	18	3	80	0.0375000
NODE_12689_length_783_cov_39.881579	412	492	12	8	80	0.1000000
NODE_12689_length_783_cov_39.881579	412	492	13	19	80	0.2375000
NODE_12689_length_783_cov_39.881579	412	492	14	53	80	0.6625000
NODE_12690_length_783_cov_35.967836	229	309	7	11	80	0.1375000
NODE_12690_length_783_cov_35.967836	229	309	9	2	80	0.0250000
NODE_12690_length_783_cov_35.967836	229	309	10	5	80	0.0625000
NODE_12690_length_783_cov_35.967836	229	309	12	1	80	0.0125000
NODE_12690_length_783_cov_35.967836	229	309	13	21	80	0.2625000
NODE_12690_length_783_cov_35.967836	229	309	15	4	80	0.0500000
NODE_12690_length_783_cov_35.967836	229	309	16	11	80	0.1375000
NODE_12690_length_783_cov_35.967836	229	309	17	25	80	0.3125000
NODE_12690_length_783_cov_35.967836	282	362	11	8	80	0.1000000
NODE_12690_length_783_cov_35.967836	282	362	13	9	80	0.1125000
NODE_12690_length_783_cov_35.967836	282	362	15	6	80	0.0750000
NODE_12690_length_783_cov_35.967836	282	362	16	14	80	0.1750000
NODE_12690_length_783_cov_35.967836	282	362	17	27	80	0.3375000
NODE_12690_length_783_cov_35.967836	282	362	18	16	80	0.2000000
NODE_12691_length_783_cov_28.203216	292	372	0	8	80	0.1000000
NODE_12691_length_783_cov_28.203216	292	372	1	1	80	0.0125000
NODE_12691_length_783_cov_28.203216	292	372	2	6	80	0.0750000
NODE_12691_length_783_cov_28.203216	292	372	4	26	80	0.3250000
NODE_12691_length_783_cov_28.203216	292	372	5	17	80	0.2125000
NODE_12691_length_783_cov_28.203216	292	372	7	3	80	0.0375000
NODE_12691_length_783_cov_28.203216	292	372	9	19	80	0.2375000
NODE_12691_length_783_cov_28.203216	345	425	5	5	80	0.0625000
NODE_12691_length_783_cov_28.203216	345	425	7	3	80	0.0375000
NODE_12691_length_783_cov_28.203216	345	425	9	53	80	0.6625000
NODE_12691_length_783_cov_28.203216	345	425	10	3	80	0.0375000
NODE_12691_length_783_cov_28.203216	345	425	12	8	80	0.1000000
NODE_12691_length_783_cov_28.203216	345	425	14	2	80	0.0250000
NODE_12691_length_783_cov_28.203216	345	425	16	6	80	0.0750000
NODE_12692_length_783_cov_16.695906	393	473	4	80	80	1.0000000
NODE_12692_length_783_cov_16.695906	446	526	0	22	80	0.2750000
NODE_12692_length_783_cov_16.695906	446	526	1	6	80	0.0750000
NODE_12692_length_783_cov_16.695906	446	526	2	22	80	0.2750000
NODE_12692_length_783_cov_16.695906	446	526	4	30	80	0.3750000
NODE_12693_length_783_cov_15.656433	418	498	15	23	80	0.2875000
NODE_12693_length_783_cov_15.656433	418	498	16	2	80	0.0250000
NODE_12693_length_783_cov_15.656433	418	498	17	5	80	0.0625000
NODE_12693_length_783_cov_15.656433	418	498	18	12	80	0.1500000
NODE_12693_length_783_cov_15.656433	418	498	19	8	80	0.1000000
NODE_12693_length_783_cov_15.656433	418	498	20	3	80	0.0375000
NODE_12693_length_783_cov_15.656433	418	498	21	9	80	0.1125000
NODE_12693_length_783_cov_15.656433	418	498	22	11	80	0.1375000
NODE_12693_length_783_cov_15.656433	418	498	23	7	80	0.0875000
NODE_12693_length_783_cov_15.656433	471	551	12	12	80	0.1500000
NODE_12693_length_783_cov_15.656433	471	551	13	4	80	0.0500000
NODE_12693_length_783_cov_15.656433	471	551	14	1	80	0.0125000
NODE_12693_length_783_cov_15.656433	471	551	15	1	80	0.0125000
NODE_12693_length_783_cov_15.656433	471	551	16	12	80	0.1500000
NODE_12693_length_783_cov_15.656433	471	551	17	4	80	0.0500000
NODE_12693_length_783_cov_15.656433	471	551	18	31	80	0.3875000
NODE_12693_length_783_cov_15.656433	471	551	19	7	80	0.0875000
NODE_12693_length_783_cov_15.656433	471	551	20	2	80	0.0250000
NODE_12693_length_783_cov_15.656433	471	551	22	6	80	0.0750000
NODE_12694_length_783_cov_14.904971	321	401	2	80	80	1.0000000
NODE_12694_length_783_cov_14.904971	374	454	0	5	80	0.0625000
NODE_12694_length_783_cov_14.904971	374	454	1	37	80	0.4625000
NODE_12694_length_783_cov_14.904971	374	454	2	38	80	0.4750000
NODE_12728_length_782_cov_22.461201	347	427	6	13	80	0.1625000
NODE_12728_length_782_cov_22.461201	347	427	8	26	80	0.3250000
NODE_12728_length_782_cov_22.461201	347	427	9	9	80	0.1125000
NODE_12728_length_782_cov_22.461201	347	427	10	3	80	0.0375000
NODE_12728_length_782_cov_22.461201	347	427	11	29	80	0.3625000
NODE_12728_length_782_cov_22.461201	400	480	8	31	80	0.3875000
NODE_12728_length_782_cov_22.461201	400	480	10	5	80	0.0625000
NODE_12728_length_782_cov_22.461201	400	480	11	35	80	0.4375000
NODE_12728_length_782_cov_22.461201	400	480	12	9	80	0.1125000
NODE_12729_length_782_cov_19.163982	306	386	0	80	80	1.0000000
NODE_12729_length_782_cov_19.163982	382	462	0	41	80	0.5125000
NODE_12729_length_782_cov_19.163982	382	462	1	8	80	0.1000000
NODE_12729_length_782_cov_19.163982	382	462	2	31	80	0.3875000
NODE_12729_length_782_cov_19.163982	435	515	2	80	80	1.0000000
NODE_12730_length_782_cov_19.090776	295	375	2	30	80	0.3750000
NODE_12730_length_782_cov_19.090776	295	375	4	50	80	0.6250000
NODE_12730_length_782_cov_19.090776	348	428	4	43	80	0.5375000
NODE_12730_length_782_cov_19.090776	348	428	5	37	80	0.4625000
NODE_12731_length_782_cov_13.509517	323	403	0	38	80	0.4750000
NODE_12731_length_782_cov_13.509517	323	403	1	22	80	0.2750000
NODE_12731_length_782_cov_13.509517	323	403	2	20	80	0.2500000
NODE_12731_length_782_cov_13.509517	376	456	1	7	80	0.0875000
NODE_12731_length_782_cov_13.509517	376	456	2	73	80	0.9125000
NODE_12732_length_782_cov_11.364568	367	447	0	80	80	1.0000000
NODE_12732_length_782_cov_11.364568	420	500	0	80	80	1.0000000
NODE_12735_length_782_cov_7.976574	245	325	0	80	80	1.0000000
NODE_12735_length_782_cov_7.976574	298	378	0	80	80	1.0000000
NODE_12737_length_782_cov_5.500732	384	464	2	23	80	0.2875000
NODE_12737_length_782_cov_5.500732	384	464	3	47	80	0.5875000
NODE_12737_length_782_cov_5.500732	384	464	4	10	80	0.1250000
NODE_12737_length_782_cov_5.500732	437	517	3	74	80	0.9250000
NODE_12737_length_782_cov_5.500732	437	517	4	6	80	0.0750000
NODE_12739_length_782_cov_4.434846	309	389	0	80	80	1.0000000
NODE_12739_length_782_cov_4.434846	362	442	0	80	80	1.0000000
NODE_12740_length_782_cov_3.352855	177	196	0	19	19	1.0000000
NODE_12741_length_782_cov_3.231332	160	240	0	80	80	1.0000000
NODE_12741_length_782_cov_3.231332	213	298	0	85	85	1.0000000
NODE_12765_length_781_cov_34.247801	174	254	14	18	80	0.2250000
NODE_12765_length_781_cov_34.247801	174	254	16	2	80	0.0250000
NODE_12765_length_781_cov_34.247801	174	254	17	11	80	0.1375000
NODE_12765_length_781_cov_34.247801	174	254	19	1	80	0.0125000
NODE_12765_length_781_cov_34.247801	174	254	20	5	80	0.0625000
NODE_12765_length_781_cov_34.247801	174	254	21	2	80	0.0250000
NODE_12765_length_781_cov_34.247801	174	254	23	3	80	0.0375000
NODE_12765_length_781_cov_34.247801	174	254	24	17	80	0.2125000
NODE_12765_length_781_cov_34.247801	174	254	25	1	80	0.0125000
NODE_12765_length_781_cov_34.247801	174	254	26	3	80	0.0375000
NODE_12765_length_781_cov_34.247801	174	254	28	17	80	0.2125000
NODE_12765_length_781_cov_34.247801	227	307	21	3	80	0.0375000
NODE_12765_length_781_cov_34.247801	227	307	22	3	80	0.0375000
NODE_12765_length_781_cov_34.247801	227	307	23	7	80	0.0875000
NODE_12765_length_781_cov_34.247801	227	307	24	9	80	0.1125000
NODE_12765_length_781_cov_34.247801	227	307	25	26	80	0.3250000
NODE_12765_length_781_cov_34.247801	227	307	26	15	80	0.1875000
NODE_12765_length_781_cov_34.247801	227	307	28	17	80	0.2125000
NODE_12766_length_781_cov_27.530792	490	570	24	6	80	0.0750000
NODE_12766_length_781_cov_27.530792	490	570	25	15	80	0.1875000
NODE_12766_length_781_cov_27.530792	490	570	26	12	80	0.1500000
NODE_12766_length_781_cov_27.530792	490	570	27	9	80	0.1125000
NODE_12766_length_781_cov_27.530792	490	570	28	27	80	0.3375000
NODE_12766_length_781_cov_27.530792	490	570	29	11	80	0.1375000
NODE_12766_length_781_cov_27.530792	543	623	10	2	80	0.0250000
NODE_12766_length_781_cov_27.530792	543	623	11	20	80	0.2500000
NODE_12766_length_781_cov_27.530792	543	623	12	6	80	0.0750000
NODE_12766_length_781_cov_27.530792	543	623	19	10	80	0.1250000
NODE_12766_length_781_cov_27.530792	543	623	20	8	80	0.1000000
NODE_12766_length_781_cov_27.530792	543	623	22	2	80	0.0250000
NODE_12766_length_781_cov_27.530792	543	623	24	2	80	0.0250000
NODE_12766_length_781_cov_27.530792	543	623	25	5	80	0.0625000
NODE_12766_length_781_cov_27.530792	543	623	26	16	80	0.2000000
NODE_12766_length_781_cov_27.530792	543	623	27	1	80	0.0125000
NODE_12766_length_781_cov_27.530792	543	623	28	8	80	0.1000000
NODE_12766_length_781_cov_27.530792	619	699	1	1	80	0.0125000
NODE_12766_length_781_cov_27.530792	619	699	2	15	80	0.1875000
NODE_12766_length_781_cov_27.530792	619	699	3	13	80	0.1625000
NODE_12766_length_781_cov_27.530792	619	699	6	11	80	0.1375000
NODE_12766_length_781_cov_27.530792	619	699	7	7	80	0.0875000
NODE_12766_length_781_cov_27.530792	619	699	8	28	80	0.3500000
NODE_12766_length_781_cov_27.530792	619	699	9	1	80	0.0125000
NODE_12766_length_781_cov_27.530792	619	699	10	2	80	0.0250000
NODE_12766_length_781_cov_27.530792	619	699	11	2	80	0.0250000
NODE_12766_length_781_cov_27.530792	672	752	0	53	80	0.6625000
NODE_12766_length_781_cov_27.530792	672	752	1	1	80	0.0125000
NODE_12766_length_781_cov_27.530792	672	752	2	15	80	0.1875000
NODE_12766_length_781_cov_27.530792	672	752	3	11	80	0.1375000
NODE_12767_length_781_cov_22.768328	427	507	2	42	80	0.5250000
NODE_12767_length_781_cov_22.768328	427	507	3	37	80	0.4625000
NODE_12767_length_781_cov_22.768328	427	507	4	1	80	0.0125000
NODE_12767_length_781_cov_22.768328	480	560	3	26	80	0.3250000
NODE_12767_length_781_cov_22.768328	480	560	4	2	80	0.0250000
NODE_12767_length_781_cov_22.768328	480	560	5	18	80	0.2250000
NODE_12767_length_781_cov_22.768328	480	560	6	34	80	0.4250000
NODE_12768_length_781_cov_17.894428	411	491	4	28	80	0.3500000
NODE_12768_length_781_cov_17.894428	411	491	5	23	80	0.2875000
NODE_12768_length_781_cov_17.894428	411	491	7	29	80	0.3625000
NODE_12768_length_781_cov_17.894428	464	544	4	80	80	1.0000000
NODE_12769_length_781_cov_14.922287	486	565	1	11	79	0.1392405
NODE_12769_length_781_cov_14.922287	486	565	2	2	79	0.0253165
NODE_12769_length_781_cov_14.922287	486	565	3	57	79	0.7215190
NODE_12769_length_781_cov_14.922287	486	565	4	9	79	0.1139240
NODE_12769_length_781_cov_14.922287	538	618	3	23	80	0.2875000
NODE_12769_length_781_cov_14.922287	538	618	4	57	80	0.7125000
NODE_12770_length_781_cov_12.529326	318	398	9	10	80	0.1250000
NODE_12770_length_781_cov_12.529326	318	398	11	22	80	0.2750000
NODE_12770_length_781_cov_12.529326	318	398	12	38	80	0.4750000
NODE_12770_length_781_cov_12.529326	318	398	13	10	80	0.1250000
NODE_12770_length_781_cov_12.529326	371	451	7	7	80	0.0875000
NODE_12770_length_781_cov_12.529326	371	451	9	1	80	0.0125000
NODE_12770_length_781_cov_12.529326	371	451	10	20	80	0.2500000
NODE_12770_length_781_cov_12.529326	371	451	11	1	80	0.0125000
NODE_12770_length_781_cov_12.529326	371	451	12	48	80	0.6000000
NODE_12770_length_781_cov_12.529326	371	451	15	3	80	0.0375000
NODE_12771_length_781_cov_10.303519	444	524	0	33	80	0.4125000
NODE_12771_length_781_cov_10.303519	444	524	2	47	80	0.5875000
NODE_12772_length_781_cov_9.851906	374	454	2	8	80	0.1000000
NODE_12772_length_781_cov_9.851906	374	454	3	11	80	0.1375000
NODE_12772_length_781_cov_9.851906	374	454	4	17	80	0.2125000
NODE_12772_length_781_cov_9.851906	374	454	5	44	80	0.5500000
NODE_12772_length_781_cov_9.851906	427	507	2	61	80	0.7625000
NODE_12772_length_781_cov_9.851906	427	507	3	11	80	0.1375000
NODE_12772_length_781_cov_9.851906	427	507	5	8	80	0.1000000
NODE_12775_length_781_cov_8.557185	113	194	6	22	81	0.2716049
NODE_12775_length_781_cov_8.557185	113	194	7	23	81	0.2839506
NODE_12775_length_781_cov_8.557185	113	194	8	36	81	0.4444444
NODE_12775_length_781_cov_8.557185	166	239	5	4	73	0.0547945
NODE_12775_length_781_cov_8.557185	166	239	6	25	73	0.3424658
NODE_12775_length_781_cov_8.557185	166	239	7	22	73	0.3013699
NODE_12775_length_781_cov_8.557185	166	239	8	13	73	0.1780822
NODE_12775_length_781_cov_8.557185	166	239	9	9	73	0.1232877
NODE_12778_length_781_cov_4.734604	30	110	1	63	80	0.7875000
NODE_12778_length_781_cov_4.734604	30	110	3	17	80	0.2125000
NODE_12778_length_781_cov_4.734604	83	163	1	10	80	0.1250000
NODE_12778_length_781_cov_4.734604	83	163	3	41	80	0.5125000
NODE_12778_length_781_cov_4.734604	83	163	5	29	80	0.3625000
NODE_12780_length_781_cov_4.077713	269	349	2	80	80	1.0000000
NODE_12780_length_781_cov_4.077713	322	402	0	10	80	0.1250000
NODE_12780_length_781_cov_4.077713	322	402	2	70	80	0.8750000
NODE_12812_length_780_cov_37.693098	165	245	0	46	80	0.5750000
NODE_12812_length_780_cov_37.693098	165	245	1	24	80	0.3000000
NODE_12812_length_780_cov_37.693098	165	245	2	1	80	0.0125000
NODE_12812_length_780_cov_37.693098	165	245	4	9	80	0.1125000
NODE_12812_length_780_cov_37.693098	218	298	1	17	80	0.2125000
NODE_12812_length_780_cov_37.693098	218	298	2	1	80	0.0125000
NODE_12812_length_780_cov_37.693098	218	298	4	54	80	0.6750000
NODE_12812_length_780_cov_37.693098	218	298	5	8	80	0.1000000
NODE_12813_length_780_cov_22.132159	407	487	0	80	80	1.0000000
NODE_12813_length_780_cov_22.132159	460	540	0	80	80	1.0000000
NODE_12814_length_780_cov_21.831131	299	379	0	34	80	0.4250000
NODE_12814_length_780_cov_21.831131	299	379	1	10	80	0.1250000
NODE_12814_length_780_cov_21.831131	299	379	2	10	80	0.1250000
NODE_12814_length_780_cov_21.831131	299	379	3	26	80	0.3250000
NODE_12814_length_780_cov_21.831131	352	432	2	1	80	0.0125000
NODE_12814_length_780_cov_21.831131	352	432	3	79	80	0.9875000
NODE_12815_length_780_cov_16.722467	165	245	4	11	80	0.1375000
NODE_12815_length_780_cov_16.722467	165	245	5	10	80	0.1250000
NODE_12815_length_780_cov_16.722467	165	245	6	31	80	0.3875000
NODE_12815_length_780_cov_16.722467	165	245	7	28	80	0.3500000
NODE_12815_length_780_cov_16.722467	218	298	4	16	80	0.2000000
NODE_12815_length_780_cov_16.722467	218	298	5	31	80	0.3875000
NODE_12815_length_780_cov_16.722467	218	298	6	6	80	0.0750000
NODE_12815_length_780_cov_16.722467	218	298	7	27	80	0.3375000
NODE_12816_length_780_cov_13.189427	150	254	2	67	104	0.6442308
NODE_12816_length_780_cov_13.189427	150	254	4	37	104	0.3557692
NODE_12816_length_780_cov_13.189427	227	307	2	65	80	0.8125000
NODE_12816_length_780_cov_13.189427	227	307	4	15	80	0.1875000
NODE_12817_length_780_cov_12.910426	276	356	5	32	80	0.4000000
NODE_12817_length_780_cov_12.910426	276	356	6	18	80	0.2250000
NODE_12817_length_780_cov_12.910426	276	356	7	20	80	0.2500000
NODE_12817_length_780_cov_12.910426	276	356	8	10	80	0.1250000
NODE_12817_length_780_cov_12.910426	329	409	5	18	80	0.2250000
NODE_12817_length_780_cov_12.910426	329	409	6	62	80	0.7750000
NODE_12818_length_780_cov_8.455213	141	221	2	80	80	1.0000000
NODE_12818_length_780_cov_8.455213	194	274	0	9	80	0.1125000
NODE_12818_length_780_cov_8.455213	194	274	1	20	80	0.2500000
NODE_12818_length_780_cov_8.455213	194	274	2	51	80	0.6375000
NODE_12848_length_779_cov_51.022059	8	43	1	6	35	0.1714286
NODE_12848_length_779_cov_51.022059	8	43	2	29	35	0.8285714
NODE_12848_length_779_cov_51.022059	53	96	2	6	43	0.1395349
NODE_12848_length_779_cov_51.022059	53	96	3	13	43	0.3023256
NODE_12848_length_779_cov_51.022059	53	96	5	24	43	0.5581396
NODE_12848_length_779_cov_51.022059	97	177	3	8	80	0.1000000
NODE_12848_length_779_cov_51.022059	97	177	4	16	80	0.2000000
NODE_12848_length_779_cov_51.022059	97	177	6	11	80	0.1375000
NODE_12848_length_779_cov_51.022059	97	177	8	3	80	0.0375000
NODE_12848_length_779_cov_51.022059	97	177	9	3	80	0.0375000
NODE_12848_length_779_cov_51.022059	97	177	11	39	80	0.4875000
NODE_12848_length_779_cov_51.022059	150	230	11	44	80	0.5500000
NODE_12848_length_779_cov_51.022059	150	230	12	16	80	0.2000000
NODE_12848_length_779_cov_51.022059	150	230	13	14	80	0.1750000
NODE_12848_length_779_cov_51.022059	150	230	14	6	80	0.0750000
NODE_12849_length_779_cov_23.682353	362	442	7	30	80	0.3750000
NODE_12849_length_779_cov_23.682353	362	442	8	50	80	0.6250000
NODE_12849_length_779_cov_23.682353	415	495	3	6	80	0.0750000
NODE_12849_length_779_cov_23.682353	415	495	5	3	80	0.0375000
NODE_12849_length_779_cov_23.682353	415	495	7	17	80	0.2125000
NODE_12849_length_779_cov_23.682353	415	495	8	49	80	0.6125000
NODE_12849_length_779_cov_23.682353	415	495	9	5	80	0.0625000
NODE_12850_length_779_cov_15.994118	320	400	0	65	80	0.8125000
NODE_12850_length_779_cov_15.994118	320	400	2	15	80	0.1875000
NODE_12850_length_779_cov_15.994118	373	453	0	12	80	0.1500000
NODE_12850_length_779_cov_15.994118	373	453	2	68	80	0.8500000
NODE_12851_length_779_cov_14.386765	258	320	1	43	62	0.6935484
NODE_12851_length_779_cov_14.386765	258	320	3	8	62	0.1290323
NODE_12851_length_779_cov_14.386765	258	320	4	11	62	0.1774193
NODE_12851_length_779_cov_14.386765	293	368	1	8	75	0.1066667
NODE_12851_length_779_cov_14.386765	293	368	3	8	75	0.1066667
NODE_12851_length_779_cov_14.386765	293	368	4	59	75	0.7866667
NODE_12851_length_779_cov_14.386765	369	443	3	42	74	0.5675676
NODE_12851_length_779_cov_14.386765	369	443	4	32	74	0.4324324
NODE_12852_length_779_cov_11.861765	180	263	0	26	83	0.3132530
NODE_12852_length_779_cov_11.861765	180	263	7	31	83	0.3734940
NODE_12852_length_779_cov_11.861765	180	263	8	3	83	0.0361446
NODE_12852_length_779_cov_11.861765	180	263	9	23	83	0.2771084
NODE_12852_length_779_cov_11.861765	236	316	7	1	80	0.0125000
NODE_12852_length_779_cov_11.861765	236	316	8	3	80	0.0375000
NODE_12852_length_779_cov_11.861765	236	316	9	30	80	0.3750000
NODE_12852_length_779_cov_11.861765	236	316	10	20	80	0.2500000
NODE_12852_length_779_cov_11.861765	236	316	11	24	80	0.3000000
NODE_12852_length_779_cov_11.861765	236	316	18	2	80	0.0250000
NODE_12852_length_779_cov_11.861765	312	392	10	1	80	0.0125000
NODE_12852_length_779_cov_11.861765	312	392	11	12	80	0.1500000
NODE_12852_length_779_cov_11.861765	312	392	12	10	80	0.1250000
NODE_12852_length_779_cov_11.861765	312	392	13	17	80	0.2125000
NODE_12852_length_779_cov_11.861765	312	392	14	1	80	0.0125000
NODE_12852_length_779_cov_11.861765	312	392	16	3	80	0.0375000
NODE_12852_length_779_cov_11.861765	312	392	17	2	80	0.0250000
NODE_12852_length_779_cov_11.861765	312	392	18	34	80	0.4250000
NODE_12852_length_779_cov_11.861765	365	445	11	1	80	0.0125000
NODE_12852_length_779_cov_11.861765	365	445	12	26	80	0.3250000
NODE_12852_length_779_cov_11.861765	365	445	13	53	80	0.6625000
NODE_12853_length_779_cov_11.735294	285	365	0	78	80	0.9750000
NODE_12853_length_779_cov_11.735294	285	365	1	2	80	0.0250000
NODE_12853_length_779_cov_11.735294	338	418	0	25	80	0.3125000
NODE_12853_length_779_cov_11.735294	338	418	1	55	80	0.6875000
NODE_12854_length_779_cov_7.211765	333	413	2	7	80	0.0875000
NODE_12854_length_779_cov_7.211765	333	413	6	66	80	0.8250000
NODE_12854_length_779_cov_7.211765	333	413	7	7	80	0.0875000
NODE_12854_length_779_cov_7.211765	386	466	5	22	80	0.2750000
NODE_12854_length_779_cov_7.211765	386	466	6	58	80	0.7250000
NODE_12857_length_779_cov_5.611765	271	351	2	34	80	0.4250000
NODE_12857_length_779_cov_5.611765	271	351	4	46	80	0.5750000
NODE_12857_length_779_cov_5.611765	324	404	2	62	80	0.7750000
NODE_12857_length_779_cov_5.611765	324	404	4	18	80	0.2250000
NODE_12859_length_779_cov_4.695588	216	296	0	80	80	1.0000000
NODE_12859_length_779_cov_4.695588	269	349	0	80	80	1.0000000
NODE_12863_length_779_cov_2.329412	615	672	1	57	57	1.0000000
NODE_12883_length_778_cov_21.615611	325	405	3	40	80	0.5000000
NODE_12883_length_778_cov_21.615611	325	405	5	7	80	0.0875000
NODE_12883_length_778_cov_21.615611	325	405	6	33	80	0.4125000
NODE_12883_length_778_cov_21.615611	378	458	3	6	80	0.0750000
NODE_12883_length_778_cov_21.615611	378	458	4	6	80	0.0750000
NODE_12883_length_778_cov_21.615611	378	458	5	47	80	0.5875000
NODE_12883_length_778_cov_21.615611	378	458	6	21	80	0.2625000
NODE_12884_length_778_cov_19.549337	348	428	8	13	80	0.1625000
NODE_12884_length_778_cov_19.549337	348	428	9	7	80	0.0875000
NODE_12884_length_778_cov_19.549337	348	428	10	2	80	0.0250000
NODE_12884_length_778_cov_19.549337	348	428	13	19	80	0.2375000
NODE_12884_length_778_cov_19.549337	348	428	14	2	80	0.0250000
NODE_12884_length_778_cov_19.549337	348	428	15	1	80	0.0125000
NODE_12884_length_778_cov_19.549337	348	428	16	22	80	0.2750000
NODE_12884_length_778_cov_19.549337	348	428	18	4	80	0.0500000
NODE_12884_length_778_cov_19.549337	348	428	19	10	80	0.1250000
NODE_12884_length_778_cov_19.549337	401	481	12	27	80	0.3375000
NODE_12884_length_778_cov_19.549337	401	481	14	28	80	0.3500000
NODE_12884_length_778_cov_19.549337	401	481	15	1	80	0.0125000
NODE_12884_length_778_cov_19.549337	401	481	16	15	80	0.1875000
NODE_12884_length_778_cov_19.549337	401	481	18	1	80	0.0125000
NODE_12884_length_778_cov_19.549337	401	481	19	8	80	0.1000000
NODE_12885_length_778_cov_15.403535	312	392	7	36	80	0.4500000
NODE_12885_length_778_cov_15.403535	312	392	8	23	80	0.2875000
NODE_12885_length_778_cov_15.403535	312	392	9	21	80	0.2625000
NODE_12885_length_778_cov_15.403535	365	445	5	47	80	0.5875000
NODE_12885_length_778_cov_15.403535	365	445	7	21	80	0.2625000
NODE_12885_length_778_cov_15.403535	365	445	8	12	80	0.1500000
NODE_12886_length_778_cov_14.614138	101	181	7	6	80	0.0750000
NODE_12886_length_778_cov_14.614138	101	181	9	14	80	0.1750000
NODE_12886_length_778_cov_14.614138	101	181	11	8	80	0.1000000
NODE_12886_length_778_cov_14.614138	101	181	12	3	80	0.0375000
NODE_12886_length_778_cov_14.614138	101	181	14	48	80	0.6000000
NODE_12886_length_778_cov_14.614138	101	181	16	1	80	0.0125000
NODE_12886_length_778_cov_14.614138	154	234	11	1	80	0.0125000
NODE_12886_length_778_cov_14.614138	154	234	12	3	80	0.0375000
NODE_12886_length_778_cov_14.614138	154	234	13	2	80	0.0250000
NODE_12886_length_778_cov_14.614138	154	234	14	73	80	0.9125000
NODE_12886_length_778_cov_14.614138	154	234	16	1	80	0.0125000
NODE_12887_length_778_cov_13.368189	256	336	3	20	80	0.2500000
NODE_12887_length_778_cov_13.368189	256	336	4	4	80	0.0500000
NODE_12887_length_778_cov_13.368189	256	336	5	56	80	0.7000000
NODE_12887_length_778_cov_13.368189	309	389	2	4	80	0.0500000
NODE_12887_length_778_cov_13.368189	309	389	3	69	80	0.8625000
NODE_12887_length_778_cov_13.368189	309	389	4	4	80	0.0500000
NODE_12887_length_778_cov_13.368189	309	389	5	3	80	0.0375000
NODE_12891_length_778_cov_6.307806	349	429	0	80	80	1.0000000
NODE_12891_length_778_cov_6.307806	402	482	0	80	80	1.0000000
NODE_12893_length_778_cov_5.985272	385	465	4	80	80	1.0000000
NODE_12893_length_778_cov_5.985272	438	518	4	48	80	0.6000000
NODE_12893_length_778_cov_5.985272	438	518	5	1	80	0.0125000
NODE_12893_length_778_cov_5.985272	438	518	7	31	80	0.3875000
NODE_12928_length_777_cov_25.504425	323	403	0	80	80	1.0000000
NODE_12928_length_777_cov_25.504425	376	456	0	80	80	1.0000000
NODE_12929_length_777_cov_25.410029	346	426	5	38	80	0.4750000
NODE_12929_length_777_cov_25.410029	346	426	6	31	80	0.3875000
NODE_12929_length_777_cov_25.410029	346	426	7	11	80	0.1375000
NODE_12929_length_777_cov_25.410029	399	479	4	3	80	0.0375000
NODE_12929_length_777_cov_25.410029	399	479	5	8	80	0.1000000
NODE_12929_length_777_cov_25.410029	399	479	6	23	80	0.2875000
NODE_12929_length_777_cov_25.410029	399	479	7	46	80	0.5750000
NODE_12930_length_777_cov_25.333333	97	177	6	17	80	0.2125000
NODE_12930_length_777_cov_25.333333	97	177	7	21	80	0.2625000
NODE_12930_length_777_cov_25.333333	97	177	8	12	80	0.1500000
NODE_12930_length_777_cov_25.333333	97	177	9	13	80	0.1625000
NODE_12930_length_777_cov_25.333333	97	177	10	17	80	0.2125000
NODE_12930_length_777_cov_25.333333	150	230	8	9	80	0.1125000
NODE_12930_length_777_cov_25.333333	150	230	9	14	80	0.1750000
NODE_12930_length_777_cov_25.333333	150	230	10	54	80	0.6750000
NODE_12930_length_777_cov_25.333333	150	230	11	3	80	0.0375000
NODE_12931_length_777_cov_21.600295	408	485	9	18	77	0.2337662
NODE_12931_length_777_cov_21.600295	408	485	10	3	77	0.0389610
NODE_12931_length_777_cov_21.600295	408	485	11	3	77	0.0389610
NODE_12931_length_777_cov_21.600295	408	485	12	34	77	0.4415585
NODE_12931_length_777_cov_21.600295	408	485	13	19	77	0.2467532
NODE_12931_length_777_cov_21.600295	458	538	8	4	80	0.0500000
NODE_12931_length_777_cov_21.600295	458	538	9	41	80	0.5125000
NODE_12931_length_777_cov_21.600295	458	538	10	17	80	0.2125000
NODE_12931_length_777_cov_21.600295	458	538	12	6	80	0.0750000
NODE_12931_length_777_cov_21.600295	458	538	13	12	80	0.1500000
NODE_12932_length_777_cov_19.561947	343	423	6	28	80	0.3500000
NODE_12932_length_777_cov_19.561947	343	423	7	34	80	0.4250000
NODE_12932_length_777_cov_19.561947	343	423	8	18	80	0.2250000
NODE_12932_length_777_cov_19.561947	396	476	2	10	80	0.1250000
NODE_12932_length_777_cov_19.561947	396	476	4	17	80	0.2125000
NODE_12932_length_777_cov_19.561947	396	476	5	7	80	0.0875000
NODE_12932_length_777_cov_19.561947	396	476	7	9	80	0.1125000
NODE_12932_length_777_cov_19.561947	396	476	8	37	80	0.4625000
NODE_12933_length_777_cov_16.961652	264	344	6	30	80	0.3750000
NODE_12933_length_777_cov_16.961652	264	344	8	11	80	0.1375000
NODE_12933_length_777_cov_16.961652	264	344	11	27	80	0.3375000
NODE_12933_length_777_cov_16.961652	264	344	13	12	80	0.1500000
NODE_12933_length_777_cov_16.961652	317	397	9	21	80	0.2625000
NODE_12933_length_777_cov_16.961652	317	397	11	24	80	0.3000000
NODE_12933_length_777_cov_16.961652	317	397	12	23	80	0.2875000
NODE_12933_length_777_cov_16.961652	317	397	13	12	80	0.1500000
NODE_12934_length_777_cov_16.081121	299	379	4	13	80	0.1625000
NODE_12934_length_777_cov_16.081121	299	379	5	67	80	0.8375000
NODE_12934_length_777_cov_16.081121	352	432	4	10	80	0.1250000
NODE_12934_length_777_cov_16.081121	352	432	5	35	80	0.4375000
NODE_12934_length_777_cov_16.081121	352	432	6	18	80	0.2250000
NODE_12934_length_777_cov_16.081121	352	432	8	17	80	0.2125000
NODE_12935_length_777_cov_13.827434	380	460	3	2	80	0.0250000
NODE_12935_length_777_cov_13.827434	380	460	4	78	80	0.9750000
NODE_12935_length_777_cov_13.827434	433	513	1	19	80	0.2375000
NODE_12935_length_777_cov_13.827434	433	513	2	1	80	0.0125000
NODE_12935_length_777_cov_13.827434	433	513	3	35	80	0.4375000
NODE_12935_length_777_cov_13.827434	433	513	4	25	80	0.3125000
NODE_12936_length_777_cov_12.497050	413	493	2	55	80	0.6875000
NODE_12936_length_777_cov_12.497050	413	493	4	25	80	0.3125000
NODE_12936_length_777_cov_12.497050	466	546	2	6	80	0.0750000
NODE_12936_length_777_cov_12.497050	466	546	4	74	80	0.9250000
NODE_12937_length_777_cov_10.787611	213	286	0	35	73	0.4794520
NODE_12937_length_777_cov_10.787611	213	286	2	38	73	0.5205479
NODE_12938_length_777_cov_8.530973	362	422	4	39	60	0.6500000
NODE_12938_length_777_cov_8.530973	362	422	5	21	60	0.3500000
NODE_12939_length_777_cov_7.634218	79	159	2	51	80	0.6375000
NODE_12939_length_777_cov_7.634218	79	159	5	13	80	0.1625000
NODE_12939_length_777_cov_7.634218	79	159	6	16	80	0.2000000
NODE_12939_length_777_cov_7.634218	132	212	5	66	80	0.8250000
NODE_12939_length_777_cov_7.634218	132	212	6	14	80	0.1750000
NODE_12940_length_777_cov_6.963127	256	336	0	80	80	1.0000000
NODE_12940_length_777_cov_6.963127	309	389	0	80	80	1.0000000
NODE_12941_length_777_cov_6.417404	565	638	0	73	73	1.0000000
NODE_12942_length_777_cov_5.868732	443	523	0	80	80	1.0000000
NODE_12942_length_777_cov_5.868732	496	576	0	76	80	0.9500000
NODE_12942_length_777_cov_5.868732	496	576	3	4	80	0.0500000
NODE_12971_length_776_cov_81.002954	237	317	11	24	80	0.3000000
NODE_12971_length_776_cov_81.002954	237	317	12	42	80	0.5250000
NODE_12971_length_776_cov_81.002954	237	317	14	14	80	0.1750000
NODE_12971_length_776_cov_81.002954	290	370	7	14	80	0.1750000
NODE_12971_length_776_cov_81.002954	290	370	10	2	80	0.0250000
NODE_12971_length_776_cov_81.002954	290	370	12	13	80	0.1625000
NODE_12971_length_776_cov_81.002954	290	370	14	49	80	0.6125000
NODE_12971_length_776_cov_81.002954	290	370	15	2	80	0.0250000
NODE_12972_length_776_cov_40.502216	345	425	2	11	80	0.1375000
NODE_12972_length_776_cov_40.502216	345	425	3	40	80	0.5000000
NODE_12972_length_776_cov_40.502216	345	425	4	29	80	0.3625000
NODE_12972_length_776_cov_40.502216	398	478	3	8	80	0.1000000
NODE_12972_length_776_cov_40.502216	398	478	4	72	80	0.9000000
NODE_12973_length_776_cov_34.921713	204	284	5	9	80	0.1125000
NODE_12973_length_776_cov_34.921713	204	284	6	12	80	0.1500000
NODE_12973_length_776_cov_34.921713	204	284	7	48	80	0.6000000
NODE_12973_length_776_cov_34.921713	204	284	8	11	80	0.1375000
NODE_12973_length_776_cov_34.921713	257	337	3	2	80	0.0250000
NODE_12973_length_776_cov_34.921713	257	337	6	61	80	0.7625000
NODE_12973_length_776_cov_34.921713	257	337	7	17	80	0.2125000
NODE_12974_length_776_cov_29.998523	177	257	5	61	80	0.7625000
NODE_12974_length_776_cov_29.998523	177	257	6	16	80	0.2000000
NODE_12974_length_776_cov_29.998523	177	257	7	3	80	0.0375000
NODE_12974_length_776_cov_29.998523	230	310	5	36	80	0.4500000
NODE_12974_length_776_cov_29.998523	230	310	6	42	80	0.5250000
NODE_12974_length_776_cov_29.998523	230	310	7	2	80	0.0250000
NODE_12975_length_776_cov_25.683900	417	497	5	48	80	0.6000000
NODE_12975_length_776_cov_25.683900	417	497	6	3	80	0.0375000
NODE_12975_length_776_cov_25.683900	417	497	7	6	80	0.0750000
NODE_12975_length_776_cov_25.683900	417	497	9	16	80	0.2000000
NODE_12975_length_776_cov_25.683900	417	497	10	7	80	0.0875000
NODE_12975_length_776_cov_25.683900	470	550	7	7	80	0.0875000
NODE_12975_length_776_cov_25.683900	470	550	8	15	80	0.1875000
NODE_12975_length_776_cov_25.683900	470	550	9	41	80	0.5125000
NODE_12975_length_776_cov_25.683900	470	550	10	17	80	0.2125000
NODE_12976_length_776_cov_22.276219	367	447	5	10	80	0.1250000
NODE_12976_length_776_cov_22.276219	367	447	7	32	80	0.4000000
NODE_12976_length_776_cov_22.276219	367	447	9	7	80	0.0875000
NODE_12976_length_776_cov_22.276219	367	447	10	31	80	0.3875000
NODE_12976_length_776_cov_22.276219	420	500	6	36	80	0.4500000
NODE_12976_length_776_cov_22.276219	420	500	7	3	80	0.0375000
NODE_12976_length_776_cov_22.276219	420	500	8	7	80	0.0875000
NODE_12976_length_776_cov_22.276219	420	500	10	34	80	0.4250000
NODE_12977_length_776_cov_19.574594	242	322	3	11	80	0.1375000
NODE_12977_length_776_cov_19.574594	242	322	4	6	80	0.0750000
NODE_12977_length_776_cov_19.574594	242	322	5	59	80	0.7375000
NODE_12977_length_776_cov_19.574594	242	322	6	4	80	0.0500000
NODE_12977_length_776_cov_19.574594	295	375	5	23	80	0.2875000
NODE_12977_length_776_cov_19.574594	295	375	6	34	80	0.4250000
NODE_12977_length_776_cov_19.574594	295	375	7	7	80	0.0875000
NODE_12977_length_776_cov_19.574594	295	375	8	16	80	0.2000000
NODE_12978_length_776_cov_18.262925	384	464	0	80	80	1.0000000
NODE_12978_length_776_cov_18.262925	437	517	0	80	80	1.0000000
NODE_12979_length_776_cov_16.023634	334	414	0	80	80	1.0000000
NODE_12979_length_776_cov_16.023634	387	467	0	80	80	1.0000000
NODE_12980_length_776_cov_15.841950	282	362	14	20	80	0.2500000
NODE_12980_length_776_cov_15.841950	282	362	15	1	80	0.0125000
NODE_12980_length_776_cov_15.841950	282	362	16	17	80	0.2125000
NODE_12980_length_776_cov_15.841950	282	362	17	36	80	0.4500000
NODE_12980_length_776_cov_15.841950	282	362	18	4	80	0.0500000
NODE_12980_length_776_cov_15.841950	282	362	19	2	80	0.0250000
NODE_12980_length_776_cov_15.841950	335	415	12	16	80	0.2000000
NODE_12980_length_776_cov_15.841950	335	415	13	10	80	0.1250000
NODE_12980_length_776_cov_15.841950	335	415	14	3	80	0.0375000
NODE_12980_length_776_cov_15.841950	335	415	16	8	80	0.1000000
NODE_12980_length_776_cov_15.841950	335	415	17	21	80	0.2625000
NODE_12980_length_776_cov_15.841950	335	415	18	7	80	0.0875000
NODE_12980_length_776_cov_15.841950	335	415	19	8	80	0.1000000
NODE_12980_length_776_cov_15.841950	335	415	20	7	80	0.0875000
NODE_12981_length_776_cov_14.131462	240	320	3	27	80	0.3375000
NODE_12981_length_776_cov_14.131462	240	320	4	16	80	0.2000000
NODE_12981_length_776_cov_14.131462	240	320	5	17	80	0.2125000
NODE_12981_length_776_cov_14.131462	240	320	6	20	80	0.2500000
NODE_12981_length_776_cov_14.131462	293	373	5	59	80	0.7375000
NODE_12981_length_776_cov_14.131462	293	373	6	10	80	0.1250000
NODE_12981_length_776_cov_14.131462	293	373	7	11	80	0.1375000
NODE_12981_length_776_cov_14.131462	369	449	2	16	80	0.2000000
NODE_12981_length_776_cov_14.131462	369	449	4	16	80	0.2000000
NODE_12981_length_776_cov_14.131462	369	449	5	31	80	0.3875000
NODE_12981_length_776_cov_14.131462	369	449	7	17	80	0.2125000
NODE_12981_length_776_cov_14.131462	422	502	0	13	80	0.1625000
NODE_12981_length_776_cov_14.131462	422	502	2	56	80	0.7000000
NODE_12981_length_776_cov_14.131462	422	502	4	11	80	0.1375000
NODE_12983_length_776_cov_13.890694	302	382	2	3	80	0.0375000
NODE_12983_length_776_cov_13.890694	302	382	3	26	80	0.3250000
NODE_12983_length_776_cov_13.890694	302	382	4	51	80	0.6375000
NODE_12983_length_776_cov_13.890694	355	435	2	16	80	0.2000000
NODE_12983_length_776_cov_13.890694	355	435	4	64	80	0.8000000
NODE_12984_length_776_cov_12.097489	488	568	10	9	80	0.1125000
NODE_12984_length_776_cov_12.097489	488	568	12	24	80	0.3000000
NODE_12984_length_776_cov_12.097489	488	568	14	22	80	0.2750000
NODE_12984_length_776_cov_12.097489	488	568	18	17	80	0.2125000
NODE_12984_length_776_cov_12.097489	488	568	19	8	80	0.1000000
NODE_12984_length_776_cov_12.097489	541	621	3	14	80	0.1750000
NODE_12984_length_776_cov_12.097489	541	621	5	10	80	0.1250000
NODE_12984_length_776_cov_12.097489	541	621	6	1	80	0.0125000
NODE_12984_length_776_cov_12.097489	541	621	7	8	80	0.1000000
NODE_12984_length_776_cov_12.097489	541	621	8	8	80	0.1000000
NODE_12984_length_776_cov_12.097489	541	621	10	21	80	0.2625000
NODE_12984_length_776_cov_12.097489	541	621	12	18	80	0.2250000
NODE_12985_length_776_cov_11.923191	422	498	0	76	76	1.0000000
NODE_12985_length_776_cov_11.923191	475	551	0	76	76	1.0000000
NODE_12986_length_776_cov_11.163959	312	392	0	29	80	0.3625000
NODE_12986_length_776_cov_11.163959	312	392	2	9	80	0.1125000
NODE_12986_length_776_cov_11.163959	312	392	3	4	80	0.0500000
NODE_12986_length_776_cov_11.163959	312	392	4	38	80	0.4750000
NODE_12986_length_776_cov_11.163959	365	445	4	80	80	1.0000000
NODE_12987_length_776_cov_9.754801	370	450	2	80	80	1.0000000
NODE_12987_length_776_cov_9.754801	423	503	0	25	80	0.3125000
NODE_12987_length_776_cov_9.754801	423	503	2	55	80	0.6875000
NODE_12989_length_776_cov_8.271787	332	412	8	7	80	0.0875000
NODE_12989_length_776_cov_8.271787	332	412	9	32	80	0.4000000
NODE_12989_length_776_cov_8.271787	332	412	10	32	80	0.4000000
NODE_12989_length_776_cov_8.271787	332	412	11	2	80	0.0250000
NODE_12989_length_776_cov_8.271787	332	412	12	7	80	0.0875000
NODE_12989_length_776_cov_8.271787	385	465	5	13	80	0.1625000
NODE_12989_length_776_cov_8.271787	385	465	6	11	80	0.1375000
NODE_12989_length_776_cov_8.271787	385	465	9	3	80	0.0375000
NODE_12989_length_776_cov_8.271787	385	465	10	53	80	0.6625000
NODE_12990_length_776_cov_4.874446	330	410	2	80	80	1.0000000
NODE_12990_length_776_cov_4.874446	383	463	0	29	80	0.3625000
NODE_12990_length_776_cov_4.874446	383	463	1	15	80	0.1875000
NODE_12990_length_776_cov_4.874446	383	463	2	36	80	0.4500000
NODE_13022_length_775_cov_33.612426	372	452	13	2	80	0.0250000
NODE_13022_length_775_cov_33.612426	372	452	15	25	80	0.3125000
NODE_13022_length_775_cov_33.612426	372	452	16	18	80	0.2250000
NODE_13022_length_775_cov_33.612426	372	452	17	7	80	0.0875000
NODE_13022_length_775_cov_33.612426	372	452	19	21	80	0.2625000
NODE_13022_length_775_cov_33.612426	372	452	20	7	80	0.0875000
NODE_13022_length_775_cov_33.612426	425	505	15	5	80	0.0625000
NODE_13022_length_775_cov_33.612426	425	505	16	35	80	0.4375000
NODE_13022_length_775_cov_33.612426	425	505	17	31	80	0.3875000
NODE_13022_length_775_cov_33.612426	425	505	19	9	80	0.1125000
NODE_13023_length_775_cov_25.500000	361	434	17	31	73	0.4246575
NODE_13023_length_775_cov_25.500000	361	434	20	32	73	0.4383562
NODE_13023_length_775_cov_25.500000	361	434	21	1	73	0.0136986
NODE_13023_length_775_cov_25.500000	361	434	23	9	73	0.1232877
NODE_13023_length_775_cov_25.500000	413	487	14	20	74	0.2702703
NODE_13023_length_775_cov_25.500000	413	487	15	1	74	0.0135135
NODE_13023_length_775_cov_25.500000	413	487	16	26	74	0.3513514
NODE_13023_length_775_cov_25.500000	413	487	17	27	74	0.3648649
NODE_13024_length_775_cov_24.128698	220	300	9	5	80	0.0625000
NODE_13024_length_775_cov_24.128698	220	300	10	2	80	0.0250000
NODE_13024_length_775_cov_24.128698	220	300	11	4	80	0.0500000
NODE_13024_length_775_cov_24.128698	220	300	12	13	80	0.1625000
NODE_13024_length_775_cov_24.128698	220	300	14	17	80	0.2125000
NODE_13024_length_775_cov_24.128698	220	300	15	2	80	0.0250000
NODE_13024_length_775_cov_24.128698	220	300	16	7	80	0.0875000
NODE_13024_length_775_cov_24.128698	220	300	18	2	80	0.0250000
NODE_13024_length_775_cov_24.128698	220	300	19	6	80	0.0750000
NODE_13024_length_775_cov_24.128698	220	300	21	7	80	0.0875000
NODE_13024_length_775_cov_24.128698	220	300	22	2	80	0.0250000
NODE_13024_length_775_cov_24.128698	220	300	23	8	80	0.1000000
NODE_13024_length_775_cov_24.128698	220	300	24	5	80	0.0625000
NODE_13024_length_775_cov_24.128698	273	353	17	14	80	0.1750000
NODE_13024_length_775_cov_24.128698	273	353	19	5	80	0.0625000
NODE_13024_length_775_cov_24.128698	273	353	20	2	80	0.0250000
NODE_13024_length_775_cov_24.128698	273	353	21	7	80	0.0875000
NODE_13024_length_775_cov_24.128698	273	353	22	2	80	0.0250000
NODE_13024_length_775_cov_24.128698	273	353	23	26	80	0.3250000
NODE_13024_length_775_cov_24.128698	273	353	24	19	80	0.2375000
NODE_13024_length_775_cov_24.128698	273	353	25	5	80	0.0625000
NODE_13026_length_775_cov_16.165680	358	438	3	12	80	0.1500000
NODE_13026_length_775_cov_16.165680	358	438	4	33	80	0.4125000
NODE_13026_length_775_cov_16.165680	358	438	5	35	80	0.4375000
NODE_13026_length_775_cov_16.165680	411	491	0	32	80	0.4000000
NODE_13026_length_775_cov_16.165680	411	491	1	7	80	0.0875000
NODE_13026_length_775_cov_16.165680	411	491	2	13	80	0.1625000
NODE_13026_length_775_cov_16.165680	411	491	3	13	80	0.1625000
NODE_13026_length_775_cov_16.165680	411	491	4	15	80	0.1875000
NODE_13027_length_775_cov_8.522189	440	520	4	80	80	1.0000000
NODE_13027_length_775_cov_8.522189	493	573	0	8	80	0.1000000
NODE_13027_length_775_cov_8.522189	493	573	1	6	80	0.0750000
NODE_13027_length_775_cov_8.522189	493	573	2	2	80	0.0250000
NODE_13027_length_775_cov_8.522189	493	573	3	23	80	0.2875000
NODE_13027_length_775_cov_8.522189	493	573	4	41	80	0.5125000
NODE_13028_length_775_cov_8.258876	247	327	1	31	80	0.3875000
NODE_13028_length_775_cov_8.258876	247	327	2	49	80	0.6125000
NODE_13028_length_775_cov_8.258876	300	380	0	10	80	0.1250000
NODE_13028_length_775_cov_8.258876	300	380	1	70	80	0.8750000
NODE_13031_length_775_cov_3.786982	299	379	0	80	80	1.0000000
NODE_13031_length_775_cov_3.786982	352	432	0	80	80	1.0000000
NODE_13059_length_774_cov_27.386667	433	514	3	8	81	0.0987654
NODE_13059_length_774_cov_27.386667	433	514	4	11	81	0.1358025
NODE_13059_length_774_cov_27.386667	433	514	5	62	81	0.7654321
NODE_13059_length_774_cov_27.386667	487	567	3	7	80	0.0875000
NODE_13059_length_774_cov_27.386667	487	567	4	45	80	0.5625000
NODE_13059_length_774_cov_27.386667	487	567	5	28	80	0.3500000
NODE_13060_length_774_cov_19.721481	239	319	4	9	80	0.1125000
NODE_13060_length_774_cov_19.721481	239	319	5	5	80	0.0625000
NODE_13060_length_774_cov_19.721481	239	319	6	2	80	0.0250000
NODE_13060_length_774_cov_19.721481	239	319	7	25	80	0.3125000
NODE_13060_length_774_cov_19.721481	239	319	8	39	80	0.4875000
NODE_13060_length_774_cov_19.721481	292	372	4	3	80	0.0375000
NODE_13060_length_774_cov_19.721481	292	372	5	2	80	0.0250000
NODE_13060_length_774_cov_19.721481	292	372	6	32	80	0.4000000
NODE_13060_length_774_cov_19.721481	292	372	7	18	80	0.2250000
NODE_13060_length_774_cov_19.721481	292	372	8	25	80	0.3125000
NODE_13063_length_774_cov_4.594074	216	294	2	30	78	0.3846154
NODE_13063_length_774_cov_4.594074	216	294	3	48	78	0.6153846
NODE_13063_length_774_cov_4.594074	269	347	0	21	78	0.2692308
NODE_13063_length_774_cov_4.594074	269	347	1	16	78	0.2051282
NODE_13063_length_774_cov_4.594074	269	347	2	41	78	0.5256410
NODE_13063_length_774_cov_4.594074	405	485	0	80	80	1.0000000
NODE_13103_length_773_cov_60.566766	249	328	16	22	79	0.2784810
NODE_13103_length_773_cov_60.566766	249	328	18	23	79	0.2911392
NODE_13103_length_773_cov_60.566766	249	328	20	21	79	0.2658228
NODE_13103_length_773_cov_60.566766	249	328	21	4	79	0.0506329
NODE_13103_length_773_cov_60.566766	249	328	23	1	79	0.0126582
NODE_13103_length_773_cov_60.566766	249	328	24	5	79	0.0632911
NODE_13103_length_773_cov_60.566766	249	328	27	3	79	0.0379747
NODE_13103_length_773_cov_60.566766	304	381	13	10	77	0.1298701
NODE_13103_length_773_cov_60.566766	304	381	15	3	77	0.0389610
NODE_13103_length_773_cov_60.566766	304	381	17	9	77	0.1168831
NODE_13103_length_773_cov_60.566766	304	381	19	14	77	0.1818182
NODE_13103_length_773_cov_60.566766	304	381	20	20	77	0.2597403
NODE_13103_length_773_cov_60.566766	304	381	21	4	77	0.0519481
NODE_13103_length_773_cov_60.566766	304	381	23	1	77	0.0129870
NODE_13103_length_773_cov_60.566766	304	381	24	5	77	0.0649351
NODE_13103_length_773_cov_60.566766	304	381	27	11	77	0.1428571
NODE_13104_length_773_cov_27.299703	230	310	5	1	80	0.0125000
NODE_13104_length_773_cov_27.299703	230	310	6	23	80	0.2875000
NODE_13104_length_773_cov_27.299703	230	310	7	26	80	0.3250000
NODE_13104_length_773_cov_27.299703	230	310	8	30	80	0.3750000
NODE_13104_length_773_cov_27.299703	283	363	5	2	80	0.0250000
NODE_13104_length_773_cov_27.299703	283	363	7	78	80	0.9750000
NODE_13105_length_773_cov_24.250742	392	470	7	2	78	0.0256410
NODE_13105_length_773_cov_24.250742	392	470	9	19	78	0.2435897
NODE_13105_length_773_cov_24.250742	392	470	10	8	78	0.1025641
NODE_13105_length_773_cov_24.250742	392	470	11	49	78	0.6282051
NODE_13105_length_773_cov_24.250742	443	523	7	2	80	0.0250000
NODE_13105_length_773_cov_24.250742	443	523	8	4	80	0.0500000
NODE_13105_length_773_cov_24.250742	443	523	9	26	80	0.3250000
NODE_13105_length_773_cov_24.250742	443	523	10	25	80	0.3125000
NODE_13105_length_773_cov_24.250742	443	523	11	23	80	0.2875000
NODE_13106_length_773_cov_20.683976	367	447	0	8	80	0.1000000
NODE_13106_length_773_cov_20.683976	367	447	1	72	80	0.9000000
NODE_13106_length_773_cov_20.683976	420	500	1	80	80	1.0000000
NODE_13107_length_773_cov_18.498516	248	328	7	15	80	0.1875000
NODE_13107_length_773_cov_18.498516	248	328	8	3	80	0.0375000
NODE_13107_length_773_cov_18.498516	248	328	9	62	80	0.7750000
NODE_13107_length_773_cov_18.498516	301	381	1	12	80	0.1500000
NODE_13107_length_773_cov_18.498516	301	381	6	32	80	0.4000000
NODE_13107_length_773_cov_18.498516	301	381	7	24	80	0.3000000
NODE_13107_length_773_cov_18.498516	301	381	8	3	80	0.0375000
NODE_13107_length_773_cov_18.498516	301	381	9	9	80	0.1125000
NODE_13108_length_773_cov_14.063798	405	485	5	80	80	1.0000000
NODE_13108_length_773_cov_14.063798	458	538	1	3	80	0.0375000
NODE_13108_length_773_cov_14.063798	458	538	3	2	80	0.0250000
NODE_13108_length_773_cov_14.063798	458	538	4	2	80	0.0250000
NODE_13108_length_773_cov_14.063798	458	538	5	73	80	0.9125000
NODE_13109_length_773_cov_12.482196	421	501	5	49	80	0.6125000
NODE_13109_length_773_cov_12.482196	421	501	7	31	80	0.3875000
NODE_13109_length_773_cov_12.482196	474	554	2	7	80	0.0875000
NODE_13109_length_773_cov_12.482196	474	554	7	73	80	0.9125000
NODE_13114_length_773_cov_9.136499	214	294	5	5	80	0.0625000
NODE_13114_length_773_cov_9.136499	214	294	6	42	80	0.5250000
NODE_13114_length_773_cov_9.136499	214	294	8	33	80	0.4125000
NODE_13114_length_773_cov_9.136499	267	347	5	8	80	0.1000000
NODE_13114_length_773_cov_9.136499	267	347	6	69	80	0.8625000
NODE_13114_length_773_cov_9.136499	267	347	7	3	80	0.0375000
NODE_13115_length_773_cov_8.609792	461	541	0	80	80	1.0000000
NODE_13115_length_773_cov_8.609792	514	594	0	80	80	1.0000000
NODE_13116_length_773_cov_7.224036	200	280	2	34	80	0.4250000
NODE_13116_length_773_cov_7.224036	200	280	3	46	80	0.5750000
NODE_13116_length_773_cov_7.224036	253	333	1	1	80	0.0125000
NODE_13116_length_773_cov_7.224036	253	333	2	11	80	0.1375000
NODE_13116_length_773_cov_7.224036	253	333	3	68	80	0.8500000
NODE_13117_length_773_cov_6.910979	522	615	7	4	93	0.0430108
NODE_13117_length_773_cov_6.910979	522	615	8	55	93	0.5913978
NODE_13117_length_773_cov_6.910979	522	615	9	4	93	0.0430108
NODE_13117_length_773_cov_6.910979	522	615	10	9	93	0.0967742
NODE_13117_length_773_cov_6.910979	522	615	11	21	93	0.2258064
NODE_13117_length_773_cov_6.910979	588	668	1	4	80	0.0500000
NODE_13117_length_773_cov_6.910979	588	668	3	1	80	0.0125000
NODE_13117_length_773_cov_6.910979	588	668	5	5	80	0.0625000
NODE_13117_length_773_cov_6.910979	588	668	6	2	80	0.0250000
NODE_13117_length_773_cov_6.910979	588	668	7	45	80	0.5625000
NODE_13117_length_773_cov_6.910979	588	668	8	22	80	0.2750000
NODE_13117_length_773_cov_6.910979	588	668	9	1	80	0.0125000
NODE_13147_length_772_cov_28.044577	231	311	4	7	80	0.0875000
NODE_13147_length_772_cov_28.044577	231	311	5	9	80	0.1125000
NODE_13147_length_772_cov_28.044577	231	311	6	33	80	0.4125000
NODE_13147_length_772_cov_28.044577	231	311	8	31	80	0.3875000
NODE_13147_length_772_cov_28.044577	284	364	7	6	80	0.0750000
NODE_13147_length_772_cov_28.044577	284	364	8	30	80	0.3750000
NODE_13147_length_772_cov_28.044577	284	364	9	35	80	0.4375000
NODE_13147_length_772_cov_28.044577	284	364	10	9	80	0.1125000
NODE_13149_length_772_cov_9.523031	288	368	2	60	80	0.7500000
NODE_13149_length_772_cov_9.523031	288	368	3	20	80	0.2500000
NODE_13149_length_772_cov_9.523031	341	421	2	53	80	0.6625000
NODE_13149_length_772_cov_9.523031	341	421	3	27	80	0.3375000
NODE_13150_length_772_cov_8.778603	133	213	2	80	80	1.0000000
NODE_13150_length_772_cov_8.778603	186	266	0	19	80	0.2375000
NODE_13150_length_772_cov_8.778603	186	266	1	27	80	0.3375000
NODE_13150_length_772_cov_8.778603	186	266	2	34	80	0.4250000
NODE_13151_length_772_cov_7.921248	351	431	0	80	80	1.0000000
NODE_13151_length_772_cov_7.921248	404	480	0	76	76	1.0000000
NODE_13152_length_772_cov_7.059435	276	356	0	80	80	1.0000000
NODE_13152_length_772_cov_7.059435	329	409	0	80	80	1.0000000
NODE_13153_length_772_cov_5.536404	269	299	2	30	30	1.0000000
NODE_13153_length_772_cov_5.536404	272	341	2	69	69	1.0000000
NODE_13156_length_772_cov_4.838039	430	510	0	80	80	1.0000000
NODE_13156_length_772_cov_4.838039	483	563	0	80	80	1.0000000
NODE_13162_length_772_cov_3.041605	339	419	0	25	80	0.3125000
NODE_13162_length_772_cov_3.041605	339	419	1	55	80	0.6875000
NODE_13162_length_772_cov_3.041605	392	472	1	43	80	0.5375000
NODE_13162_length_772_cov_3.041605	392	472	2	37	80	0.4625000
NODE_13195_length_771_cov_36.729167	223	304	0	81	81	1.0000000
NODE_13195_length_771_cov_36.729167	277	357	0	80	80	1.0000000
NODE_13195_length_771_cov_36.729167	353	434	0	81	81	1.0000000
NODE_13195_length_771_cov_36.729167	407	487	0	80	80	1.0000000
NODE_13196_length_771_cov_28.903274	337	417	11	4	80	0.0500000
NODE_13196_length_771_cov_28.903274	337	417	13	10	80	0.1250000
NODE_13196_length_771_cov_28.903274	337	417	14	28	80	0.3500000
NODE_13196_length_771_cov_28.903274	337	417	15	38	80	0.4750000
NODE_13196_length_771_cov_28.903274	390	470	8	10	80	0.1250000
NODE_13196_length_771_cov_28.903274	390	470	9	2	80	0.0250000
NODE_13196_length_771_cov_28.903274	390	470	10	25	80	0.3125000
NODE_13196_length_771_cov_28.903274	390	470	12	3	80	0.0375000
NODE_13196_length_771_cov_28.903274	390	470	13	20	80	0.2500000
NODE_13196_length_771_cov_28.903274	390	470	14	11	80	0.1375000
NODE_13196_length_771_cov_28.903274	390	470	15	9	80	0.1125000
NODE_13197_length_771_cov_28.165179	453	533	4	7	80	0.0875000
NODE_13197_length_771_cov_28.165179	453	533	5	18	80	0.2250000
NODE_13197_length_771_cov_28.165179	453	533	6	28	80	0.3500000
NODE_13197_length_771_cov_28.165179	453	533	7	2	80	0.0250000
NODE_13197_length_771_cov_28.165179	453	533	8	3	80	0.0375000
NODE_13197_length_771_cov_28.165179	453	533	9	2	80	0.0250000
NODE_13197_length_771_cov_28.165179	453	533	10	20	80	0.2500000
NODE_13197_length_771_cov_28.165179	506	586	7	2	80	0.0250000
NODE_13197_length_771_cov_28.165179	506	586	8	3	80	0.0375000
NODE_13197_length_771_cov_28.165179	506	586	9	8	80	0.1000000
NODE_13197_length_771_cov_28.165179	506	586	10	67	80	0.8375000
NODE_13198_length_771_cov_14.336310	259	339	5	15	80	0.1875000
NODE_13198_length_771_cov_14.336310	259	339	6	4	80	0.0500000
NODE_13198_length_771_cov_14.336310	259	339	7	11	80	0.1375000
NODE_13198_length_771_cov_14.336310	259	339	8	50	80	0.6250000
NODE_13198_length_771_cov_14.336310	312	392	5	8	80	0.1000000
NODE_13198_length_771_cov_14.336310	312	392	6	14	80	0.1750000
NODE_13198_length_771_cov_14.336310	312	392	7	24	80	0.3000000
NODE_13198_length_771_cov_14.336310	312	392	8	34	80	0.4250000
NODE_13199_length_771_cov_13.592262	428	508	5	1	80	0.0125000
NODE_13199_length_771_cov_13.592262	428	508	6	51	80	0.6375000
NODE_13199_length_771_cov_13.592262	428	508	7	1	80	0.0125000
NODE_13199_length_771_cov_13.592262	428	508	10	22	80	0.2750000
NODE_13199_length_771_cov_13.592262	428	508	11	5	80	0.0625000
NODE_13199_length_771_cov_13.592262	481	561	7	41	80	0.5125000
NODE_13199_length_771_cov_13.592262	481	561	10	34	80	0.4250000
NODE_13199_length_771_cov_13.592262	481	561	11	5	80	0.0625000
NODE_13200_length_771_cov_12.226190	407	487	0	16	80	0.2000000
NODE_13200_length_771_cov_12.226190	407	487	1	22	80	0.2750000
NODE_13200_length_771_cov_12.226190	407	487	2	42	80	0.5250000
NODE_13200_length_771_cov_12.226190	460	540	2	80	80	1.0000000
NODE_13201_length_771_cov_11.188988	348	428	0	80	80	1.0000000
NODE_13201_length_771_cov_11.188988	401	481	0	80	80	1.0000000
NODE_13202_length_771_cov_10.525298	171	251	3	65	80	0.8125000
NODE_13202_length_771_cov_10.525298	171	251	5	15	80	0.1875000
NODE_13202_length_771_cov_10.525298	224	304	3	13	80	0.1625000
NODE_13202_length_771_cov_10.525298	224	304	5	52	80	0.6500000
NODE_13202_length_771_cov_10.525298	224	304	6	15	80	0.1875000
NODE_13207_length_771_cov_3.357143	238	318	1	36	80	0.4500000
NODE_13207_length_771_cov_3.357143	238	318	2	44	80	0.5500000
NODE_13207_length_771_cov_3.357143	291	371	0	53	80	0.6625000
NODE_13207_length_771_cov_3.357143	291	371	1	27	80	0.3375000
NODE_13209_length_771_cov_3.129464	476	518	0	42	42	1.0000000
NODE_13238_length_770_cov_45.312966	212	292	9	9	80	0.1125000
NODE_13238_length_770_cov_45.312966	212	292	13	9	80	0.1125000
NODE_13238_length_770_cov_45.312966	212	292	14	5	80	0.0625000
NODE_13238_length_770_cov_45.312966	212	292	15	3	80	0.0375000
NODE_13238_length_770_cov_45.312966	212	292	17	11	80	0.1375000
NODE_13238_length_770_cov_45.312966	212	292	18	16	80	0.2000000
NODE_13238_length_770_cov_45.312966	212	292	22	8	80	0.1000000
NODE_13238_length_770_cov_45.312966	212	292	23	15	80	0.1875000
NODE_13238_length_770_cov_45.312966	212	292	25	4	80	0.0500000
NODE_13238_length_770_cov_45.312966	265	345	22	8	80	0.1000000
NODE_13238_length_770_cov_45.312966	265	345	23	15	80	0.1875000
NODE_13238_length_770_cov_45.312966	265	345	25	13	80	0.1625000
NODE_13238_length_770_cov_45.312966	265	345	26	3	80	0.0375000
NODE_13238_length_770_cov_45.312966	265	345	27	2	80	0.0250000
NODE_13238_length_770_cov_45.312966	265	345	28	11	80	0.1375000
NODE_13238_length_770_cov_45.312966	265	345	29	18	80	0.2250000
NODE_13238_length_770_cov_45.312966	265	345	30	4	80	0.0500000
NODE_13238_length_770_cov_45.312966	265	345	31	2	80	0.0250000
NODE_13238_length_770_cov_45.312966	265	345	32	4	80	0.0500000
NODE_13239_length_770_cov_23.153502	348	428	3	37	80	0.4625000
NODE_13239_length_770_cov_23.153502	348	428	4	15	80	0.1875000
NODE_13239_length_770_cov_23.153502	348	428	5	26	80	0.3250000
NODE_13239_length_770_cov_23.153502	348	428	6	2	80	0.0250000
NODE_13239_length_770_cov_23.153502	401	481	5	50	80	0.6250000
NODE_13239_length_770_cov_23.153502	401	481	6	30	80	0.3750000
NODE_13240_length_770_cov_22.463487	340	420	3	13	80	0.1625000
NODE_13240_length_770_cov_22.463487	340	420	4	8	80	0.1000000
NODE_13240_length_770_cov_22.463487	340	420	5	51	80	0.6375000
NODE_13240_length_770_cov_22.463487	340	420	6	8	80	0.1000000
NODE_13240_length_770_cov_22.463487	393	473	2	19	80	0.2375000
NODE_13240_length_770_cov_22.463487	393	473	4	42	80	0.5250000
NODE_13240_length_770_cov_22.463487	393	473	5	11	80	0.1375000
NODE_13240_length_770_cov_22.463487	393	473	6	8	80	0.1000000
NODE_13241_length_770_cov_18.594635	335	416	1	58	81	0.7160494
NODE_13241_length_770_cov_18.594635	335	416	2	23	81	0.2839506
NODE_13241_length_770_cov_18.594635	389	469	0	51	80	0.6375000
NODE_13241_length_770_cov_18.594635	389	469	1	29	80	0.3625000
NODE_13242_length_770_cov_18.092399	292	372	3	36	80	0.4500000
NODE_13242_length_770_cov_18.092399	292	372	5	18	80	0.2250000
NODE_13242_length_770_cov_18.092399	292	372	6	20	80	0.2500000
NODE_13242_length_770_cov_18.092399	292	372	7	6	80	0.0750000
NODE_13242_length_770_cov_18.092399	345	425	5	4	80	0.0500000
NODE_13242_length_770_cov_18.092399	345	425	6	17	80	0.2125000
NODE_13242_length_770_cov_18.092399	345	425	7	22	80	0.2750000
NODE_13242_length_770_cov_18.092399	345	425	8	17	80	0.2125000
NODE_13242_length_770_cov_18.092399	345	425	9	20	80	0.2500000
NODE_13243_length_770_cov_7.064083	294	374	0	80	80	1.0000000
NODE_13243_length_770_cov_7.064083	347	426	0	79	79	1.0000000
NODE_13246_length_770_cov_5.184799	341	421	0	52	80	0.6500000
NODE_13246_length_770_cov_5.184799	341	421	1	28	80	0.3500000
NODE_13246_length_770_cov_5.184799	394	474	1	63	80	0.7875000
NODE_13246_length_770_cov_5.184799	394	474	2	17	80	0.2125000
NODE_13250_length_770_cov_4.120715	325	405	0	80	80	1.0000000
NODE_13250_length_770_cov_4.120715	378	458	0	80	80	1.0000000
NODE_13272_length_769_cov_11.008955	355	435	0	80	80	1.0000000
NODE_13272_length_769_cov_11.008955	408	488	0	80	80	1.0000000
NODE_13274_length_769_cov_9.077612	263	343	3	12	80	0.1500000
NODE_13274_length_769_cov_9.077612	263	343	4	17	80	0.2125000
NODE_13274_length_769_cov_9.077612	263	343	5	36	80	0.4500000
NODE_13274_length_769_cov_9.077612	263	343	6	15	80	0.1875000
NODE_13274_length_769_cov_9.077612	316	396	5	12	80	0.1500000
NODE_13274_length_769_cov_9.077612	316	396	6	68	80	0.8500000
NODE_13275_length_769_cov_7.034328	289	367	0	78	78	1.0000000
NODE_13275_length_769_cov_7.034328	340	420	0	80	80	1.0000000
NODE_13307_length_769_cov_1.262687	620	668	0	17	48	0.3541667
NODE_13307_length_769_cov_1.262687	620	668	1	31	48	0.6458333
NODE_13316_length_768_cov_19.195815	266	346	0	22	80	0.2750000
NODE_13316_length_768_cov_19.195815	266	346	1	58	80	0.7250000
NODE_13316_length_768_cov_19.195815	319	399	1	53	80	0.6625000
NODE_13316_length_768_cov_19.195815	319	399	2	27	80	0.3375000
NODE_13316_length_768_cov_19.195815	395	475	2	31	80	0.3875000
NODE_13316_length_768_cov_19.195815	395	475	3	48	80	0.6000000
NODE_13316_length_768_cov_19.195815	395	475	4	1	80	0.0125000
NODE_13316_length_768_cov_19.195815	448	528	2	6	80	0.0750000
NODE_13316_length_768_cov_19.195815	448	528	3	74	80	0.9250000
NODE_13317_length_768_cov_16.420030	246	326	3	5	80	0.0625000
NODE_13317_length_768_cov_16.420030	246	326	4	75	80	0.9375000
NODE_13317_length_768_cov_16.420030	299	379	1	8	80	0.1000000
NODE_13317_length_768_cov_16.420030	299	379	2	24	80	0.3000000
NODE_13317_length_768_cov_16.420030	299	379	4	48	80	0.6000000
NODE_13318_length_768_cov_14.508221	309	389	2	53	80	0.6625000
NODE_13318_length_768_cov_14.508221	309	389	3	1	80	0.0125000
NODE_13318_length_768_cov_14.508221	309	389	4	26	80	0.3250000
NODE_13318_length_768_cov_14.508221	362	442	2	44	80	0.5500000
NODE_13318_length_768_cov_14.508221	362	442	4	36	80	0.4500000
NODE_13319_length_768_cov_11.635277	309	389	5	46	80	0.5750000
NODE_13319_length_768_cov_11.635277	309	389	7	1	80	0.0125000
NODE_13319_length_768_cov_11.635277	309	389	8	27	80	0.3375000
NODE_13319_length_768_cov_11.635277	309	389	9	6	80	0.0750000
NODE_13319_length_768_cov_11.635277	362	442	5	9	80	0.1125000
NODE_13319_length_768_cov_11.635277	362	442	8	51	80	0.6375000
NODE_13319_length_768_cov_11.635277	362	442	9	20	80	0.2500000
NODE_13321_length_768_cov_9.064275	392	472	0	80	80	1.0000000
NODE_13321_length_768_cov_9.064275	445	525	0	80	80	1.0000000
NODE_13324_length_768_cov_3.605381	512	592	0	42	80	0.5250000
NODE_13324_length_768_cov_3.605381	512	592	2	38	80	0.4750000
NODE_13324_length_768_cov_3.605381	565	645	2	80	80	1.0000000
NODE_13354_length_767_cov_38.161677	28	108	0	80	80	1.0000000
NODE_13354_length_767_cov_38.161677	254	334	11	32	80	0.4000000
NODE_13354_length_767_cov_38.161677	254	334	13	1	80	0.0125000
NODE_13354_length_767_cov_38.161677	254	334	14	23	80	0.2875000
NODE_13354_length_767_cov_38.161677	254	334	15	18	80	0.2250000
NODE_13354_length_767_cov_38.161677	254	334	17	6	80	0.0750000
NODE_13354_length_767_cov_38.161677	307	387	13	7	80	0.0875000
NODE_13354_length_767_cov_38.161677	307	387	14	29	80	0.3625000
NODE_13354_length_767_cov_38.161677	307	387	15	30	80	0.3750000
NODE_13354_length_767_cov_38.161677	307	387	17	14	80	0.1750000
NODE_13355_length_767_cov_24.107784	279	359	12	9	80	0.1125000
NODE_13355_length_767_cov_24.107784	279	359	13	6	80	0.0750000
NODE_13355_length_767_cov_24.107784	279	359	14	32	80	0.4000000
NODE_13355_length_767_cov_24.107784	279	359	16	19	80	0.2375000
NODE_13355_length_767_cov_24.107784	279	359	17	14	80	0.1750000
NODE_13355_length_767_cov_24.107784	332	412	13	5	80	0.0625000
NODE_13355_length_767_cov_24.107784	332	412	14	13	80	0.1625000
NODE_13355_length_767_cov_24.107784	332	412	16	12	80	0.1500000
NODE_13355_length_767_cov_24.107784	332	412	17	25	80	0.3125000
NODE_13355_length_767_cov_24.107784	332	412	19	25	80	0.3125000
NODE_13356_length_767_cov_22.823353	286	366	3	32	80	0.4000000
NODE_13356_length_767_cov_22.823353	286	366	4	48	80	0.6000000
NODE_13356_length_767_cov_22.823353	339	419	2	16	80	0.2000000
NODE_13356_length_767_cov_22.823353	339	419	3	47	80	0.5875000
NODE_13356_length_767_cov_22.823353	339	419	4	17	80	0.2125000
NODE_13357_length_767_cov_20.898204	312	392	0	23	80	0.2875000
NODE_13357_length_767_cov_20.898204	312	392	2	57	80	0.7125000
NODE_13357_length_767_cov_20.898204	365	445	2	30	80	0.3750000
NODE_13357_length_767_cov_20.898204	365	445	3	5	80	0.0625000
NODE_13357_length_767_cov_20.898204	365	445	9	19	80	0.2375000
NODE_13357_length_767_cov_20.898204	365	445	11	26	80	0.3250000
NODE_13358_length_767_cov_20.058383	357	439	0	1	82	0.0121951
NODE_13358_length_767_cov_20.058383	357	439	1	40	82	0.4878049
NODE_13358_length_767_cov_20.058383	357	439	2	41	82	0.5000000
NODE_13358_length_767_cov_20.058383	410	490	2	30	80	0.3750000
NODE_13358_length_767_cov_20.058383	410	490	3	21	80	0.2625000
NODE_13358_length_767_cov_20.058383	410	490	4	29	80	0.3625000
NODE_13359_length_767_cov_20.020958	191	271	1	28	80	0.3500000
NODE_13359_length_767_cov_20.020958	191	271	2	52	80	0.6500000
NODE_13359_length_767_cov_20.020958	244	324	1	62	80	0.7750000
NODE_13359_length_767_cov_20.020958	244	324	2	18	80	0.2250000
NODE_13360_length_767_cov_18.687126	270	350	3	12	80	0.1500000
NODE_13360_length_767_cov_18.687126	270	350	5	17	80	0.2125000
NODE_13360_length_767_cov_18.687126	270	350	6	51	80	0.6375000
NODE_13360_length_767_cov_18.687126	323	403	2	9	80	0.1125000
NODE_13360_length_767_cov_18.687126	323	403	3	26	80	0.3250000
NODE_13360_length_767_cov_18.687126	323	403	5	3	80	0.0375000
NODE_13360_length_767_cov_18.687126	323	403	6	42	80	0.5250000
NODE_13362_length_767_cov_13.323353	45	125	5	60	80	0.7500000
NODE_13362_length_767_cov_13.323353	45	125	13	3	80	0.0375000
NODE_13362_length_767_cov_13.323353	45	125	14	13	80	0.1625000
NODE_13362_length_767_cov_13.323353	45	125	15	4	80	0.0500000
NODE_13362_length_767_cov_13.323353	98	178	5	7	80	0.0875000
NODE_13362_length_767_cov_13.323353	98	178	10	2	80	0.0250000
NODE_13362_length_767_cov_13.323353	98	178	11	4	80	0.0500000
NODE_13362_length_767_cov_13.323353	98	178	12	2	80	0.0250000
NODE_13362_length_767_cov_13.323353	98	178	13	3	80	0.0375000
NODE_13362_length_767_cov_13.323353	98	178	14	14	80	0.1750000
NODE_13362_length_767_cov_13.323353	98	178	15	48	80	0.6000000
NODE_13366_length_767_cov_8.787425	377	447	0	70	70	1.0000000
NODE_13366_length_767_cov_8.787425	420	500	0	80	80	1.0000000
NODE_13367_length_767_cov_7.206587	306	386	0	80	80	1.0000000
NODE_13367_length_767_cov_7.206587	359	440	0	74	81	0.9135802
NODE_13367_length_767_cov_7.206587	359	440	2	7	81	0.0864198
NODE_13403_length_766_cov_59.388306	322	402	2	42	80	0.5250000
NODE_13403_length_766_cov_59.388306	322	402	5	1	80	0.0125000
NODE_13403_length_766_cov_59.388306	322	402	6	9	80	0.1125000
NODE_13403_length_766_cov_59.388306	322	402	7	28	80	0.3500000
NODE_13403_length_766_cov_59.388306	375	455	5	7	80	0.0875000
NODE_13403_length_766_cov_59.388306	375	455	7	32	80	0.4000000
NODE_13403_length_766_cov_59.388306	375	455	9	41	80	0.5125000
NODE_13403_length_766_cov_59.388306	451	531	4	7	80	0.0875000
NODE_13403_length_766_cov_59.388306	451	531	5	5	80	0.0625000
NODE_13403_length_766_cov_59.388306	451	531	8	1	80	0.0125000
NODE_13403_length_766_cov_59.388306	451	531	9	67	80	0.8375000
NODE_13403_length_766_cov_59.388306	504	584	4	7	80	0.0875000
NODE_13403_length_766_cov_59.388306	504	584	5	25	80	0.3125000
NODE_13403_length_766_cov_59.388306	504	584	7	1	80	0.0125000
NODE_13403_length_766_cov_59.388306	504	584	8	4	80	0.0500000
NODE_13403_length_766_cov_59.388306	504	584	9	43	80	0.5375000
NODE_13404_length_766_cov_23.361319	308	388	6	13	80	0.1625000
NODE_13404_length_766_cov_23.361319	308	388	7	55	80	0.6875000
NODE_13404_length_766_cov_23.361319	308	388	8	10	80	0.1250000
NODE_13404_length_766_cov_23.361319	308	388	10	2	80	0.0250000
NODE_13404_length_766_cov_23.361319	361	441	3	3	80	0.0375000
NODE_13404_length_766_cov_23.361319	361	441	4	28	80	0.3500000
NODE_13404_length_766_cov_23.361319	361	441	5	2	80	0.0250000
NODE_13404_length_766_cov_23.361319	361	441	6	33	80	0.4125000
NODE_13404_length_766_cov_23.361319	361	441	7	14	80	0.1750000
NODE_13405_length_766_cov_22.751124	229	309	1	18	80	0.2250000
NODE_13405_length_766_cov_22.751124	229	309	2	12	80	0.1500000
NODE_13405_length_766_cov_22.751124	229	309	3	3	80	0.0375000
NODE_13405_length_766_cov_22.751124	229	309	4	31	80	0.3875000
NODE_13405_length_766_cov_22.751124	229	309	5	16	80	0.2000000
NODE_13405_length_766_cov_22.751124	282	362	4	58	80	0.7250000
NODE_13405_length_766_cov_22.751124	282	362	5	22	80	0.2750000
NODE_13406_length_766_cov_20.011994	285	363	1	13	78	0.1666667
NODE_13406_length_766_cov_20.011994	285	363	2	32	78	0.4102564
NODE_13406_length_766_cov_20.011994	285	363	3	4	78	0.0512821
NODE_13406_length_766_cov_20.011994	285	363	5	29	78	0.3717949
NODE_13406_length_766_cov_20.011994	336	416	4	52	80	0.6500000
NODE_13406_length_766_cov_20.011994	336	416	5	28	80	0.3500000
NODE_13407_length_766_cov_18.685157	288	368	3	57	80	0.7125000
NODE_13407_length_766_cov_18.685157	288	368	5	23	80	0.2875000
NODE_13407_length_766_cov_18.685157	341	421	3	19	80	0.2375000
NODE_13407_length_766_cov_18.685157	341	421	4	17	80	0.2125000
NODE_13407_length_766_cov_18.685157	341	421	5	40	80	0.5000000
NODE_13407_length_766_cov_18.685157	341	421	6	4	80	0.0500000
NODE_13408_length_766_cov_13.131934	271	351	2	5	80	0.0625000
NODE_13408_length_766_cov_13.131934	271	351	3	1	80	0.0125000
NODE_13408_length_766_cov_13.131934	271	351	4	11	80	0.1375000
NODE_13408_length_766_cov_13.131934	271	351	5	6	80	0.0750000
NODE_13408_length_766_cov_13.131934	271	351	6	21	80	0.2625000
NODE_13408_length_766_cov_13.131934	271	351	7	28	80	0.3500000
NODE_13408_length_766_cov_13.131934	271	351	8	8	80	0.1000000
NODE_13408_length_766_cov_13.131934	324	404	7	27	80	0.3375000
NODE_13408_length_766_cov_13.131934	324	404	8	18	80	0.2250000
NODE_13408_length_766_cov_13.131934	324	404	9	35	80	0.4375000
NODE_13410_length_766_cov_9.479760	274	354	3	78	80	0.9750000
NODE_13410_length_766_cov_9.479760	274	354	4	2	80	0.0250000
NODE_13410_length_766_cov_9.479760	327	407	3	80	80	1.0000000
NODE_13415_length_766_cov_4.500750	333	413	0	80	80	1.0000000
NODE_13415_length_766_cov_4.500750	369	404	0	35	35	1.0000000
NODE_13415_length_766_cov_4.500750	371	413	0	42	42	1.0000000
NODE_13415_length_766_cov_4.500750	397	466	0	69	69	1.0000000
NODE_13447_length_765_cov_92.851351	16	96	6	1	80	0.0125000
NODE_13447_length_765_cov_92.851351	16	96	9	7	80	0.0875000
NODE_13447_length_765_cov_92.851351	16	96	10	5	80	0.0625000
NODE_13447_length_765_cov_92.851351	16	96	11	3	80	0.0375000
NODE_13447_length_765_cov_92.851351	16	96	12	1	80	0.0125000
NODE_13447_length_765_cov_92.851351	16	96	13	6	80	0.0750000
NODE_13447_length_765_cov_92.851351	16	96	17	3	80	0.0375000
NODE_13447_length_765_cov_92.851351	16	96	18	11	80	0.1375000
NODE_13447_length_765_cov_92.851351	16	96	19	1	80	0.0125000
NODE_13447_length_765_cov_92.851351	16	96	21	4	80	0.0500000
NODE_13447_length_765_cov_92.851351	16	96	23	10	80	0.1250000
NODE_13447_length_765_cov_92.851351	16	96	24	9	80	0.1125000
NODE_13447_length_765_cov_92.851351	16	96	27	9	80	0.1125000
NODE_13447_length_765_cov_92.851351	16	96	28	2	80	0.0250000
NODE_13447_length_765_cov_92.851351	16	96	29	4	80	0.0500000
NODE_13447_length_765_cov_92.851351	16	96	30	1	80	0.0125000
NODE_13447_length_765_cov_92.851351	16	96	33	3	80	0.0375000
NODE_13448_length_765_cov_36.345345	504	584	27	14	80	0.1750000
NODE_13448_length_765_cov_36.345345	504	584	29	14	80	0.1750000
NODE_13448_length_765_cov_36.345345	504	584	34	1	80	0.0125000
NODE_13448_length_765_cov_36.345345	504	584	36	26	80	0.3250000
NODE_13448_length_765_cov_36.345345	504	584	38	9	80	0.1125000
NODE_13448_length_765_cov_36.345345	504	584	40	1	80	0.0125000
NODE_13448_length_765_cov_36.345345	504	584	41	3	80	0.0375000
NODE_13448_length_765_cov_36.345345	504	584	44	4	80	0.0500000
NODE_13448_length_765_cov_36.345345	504	584	45	1	80	0.0125000
NODE_13448_length_765_cov_36.345345	504	584	46	2	80	0.0250000
NODE_13448_length_765_cov_36.345345	504	584	47	5	80	0.0625000
NODE_13448_length_765_cov_36.345345	557	637	24	40	80	0.5000000
NODE_13448_length_765_cov_36.345345	557	637	26	8	80	0.1000000
NODE_13448_length_765_cov_36.345345	557	637	27	9	80	0.1125000
NODE_13448_length_765_cov_36.345345	557	637	38	7	80	0.0875000
NODE_13448_length_765_cov_36.345345	557	637	40	1	80	0.0125000
NODE_13448_length_765_cov_36.345345	557	637	41	3	80	0.0375000
NODE_13448_length_765_cov_36.345345	557	637	44	4	80	0.0500000
NODE_13448_length_765_cov_36.345345	557	637	45	1	80	0.0125000
NODE_13448_length_765_cov_36.345345	557	637	46	2	80	0.0250000
NODE_13448_length_765_cov_36.345345	557	637	47	5	80	0.0625000
NODE_13449_length_765_cov_27.334835	370	450	1	22	80	0.2750000
NODE_13449_length_765_cov_27.334835	370	450	2	20	80	0.2500000
NODE_13449_length_765_cov_27.334835	370	450	4	38	80	0.4750000
NODE_13449_length_765_cov_27.334835	423	503	3	26	80	0.3250000
NODE_13449_length_765_cov_27.334835	423	503	4	41	80	0.5125000
NODE_13449_length_765_cov_27.334835	423	503	5	13	80	0.1625000
NODE_13450_length_765_cov_23.355856	251	331	1	20	80	0.2500000
NODE_13450_length_765_cov_23.355856	251	331	2	17	80	0.2125000
NODE_13450_length_765_cov_23.355856	251	331	3	1	80	0.0125000
NODE_13450_length_765_cov_23.355856	251	331	4	42	80	0.5250000
NODE_13450_length_765_cov_23.355856	304	384	4	60	80	0.7500000
NODE_13450_length_765_cov_23.355856	304	384	5	20	80	0.2500000
NODE_13450_length_765_cov_23.355856	380	460	1	21	80	0.2625000
NODE_13450_length_765_cov_23.355856	380	460	2	1	80	0.0125000
NODE_13450_length_765_cov_23.355856	380	460	3	17	80	0.2125000
NODE_13450_length_765_cov_23.355856	380	460	4	41	80	0.5125000
NODE_13450_length_765_cov_23.355856	433	506	0	11	73	0.1506849
NODE_13450_length_765_cov_23.355856	433	506	1	56	73	0.7671233
NODE_13450_length_765_cov_23.355856	433	506	2	1	73	0.0136986
NODE_13450_length_765_cov_23.355856	433	506	3	5	73	0.0684932
NODE_13451_length_765_cov_23.322823	256	336	0	80	80	1.0000000
NODE_13451_length_765_cov_23.322823	309	389	0	80	80	1.0000000
NODE_13452_length_765_cov_21.741742	379	452	3	44	73	0.6027398
NODE_13452_length_765_cov_21.741742	379	452	4	15	73	0.2054795
NODE_13452_length_765_cov_21.741742	379	452	5	14	73	0.1917808
NODE_13452_length_765_cov_21.741742	425	505	2	7	80	0.0875000
NODE_13452_length_765_cov_21.741742	425	505	3	48	80	0.6000000
NODE_13452_length_765_cov_21.741742	425	505	4	11	80	0.1375000
NODE_13452_length_765_cov_21.741742	425	505	5	14	80	0.1750000
NODE_13453_length_765_cov_14.253754	450	530	5	53	80	0.6625000
NODE_13453_length_765_cov_14.253754	450	530	6	1	80	0.0125000
NODE_13453_length_765_cov_14.253754	450	530	8	26	80	0.3250000
NODE_13453_length_765_cov_14.253754	503	583	3	32	80	0.4000000
NODE_13453_length_765_cov_14.253754	503	583	6	22	80	0.2750000
NODE_13453_length_765_cov_14.253754	503	583	8	26	80	0.3250000
NODE_13454_length_765_cov_13.627628	313	393	0	22	80	0.2750000
NODE_13454_length_765_cov_13.627628	313	393	2	58	80	0.7250000
NODE_13454_length_765_cov_13.627628	366	446	2	32	80	0.4000000
NODE_13454_length_765_cov_13.627628	366	446	3	12	80	0.1500000
NODE_13454_length_765_cov_13.627628	366	446	4	36	80	0.4500000
NODE_13455_length_765_cov_5.561562	319	349	0	30	30	1.0000000
NODE_13458_length_765_cov_4.367868	433	513	1	72	80	0.9000000
NODE_13458_length_765_cov_4.367868	433	513	2	8	80	0.1000000
NODE_13458_length_765_cov_4.367868	486	566	0	34	80	0.4250000
NODE_13458_length_765_cov_4.367868	486	566	1	46	80	0.5750000
NODE_13483_length_764_cov_30.096241	436	516	3	32	80	0.4000000
NODE_13483_length_764_cov_30.096241	436	516	4	48	80	0.6000000
NODE_13483_length_764_cov_30.096241	489	569	1	21	80	0.2625000
NODE_13483_length_764_cov_30.096241	489	569	2	4	80	0.0500000
NODE_13483_length_764_cov_30.096241	489	569	3	55	80	0.6875000
NODE_13484_length_764_cov_29.218045	304	384	15	22	80	0.2750000
NODE_13484_length_764_cov_29.218045	304	384	16	34	80	0.4250000
NODE_13484_length_764_cov_29.218045	304	384	17	24	80	0.3000000
NODE_13484_length_764_cov_29.218045	357	437	13	7	80	0.0875000
NODE_13484_length_764_cov_29.218045	357	437	14	14	80	0.1750000
NODE_13484_length_764_cov_29.218045	357	437	15	25	80	0.3125000
NODE_13484_length_764_cov_29.218045	357	437	16	10	80	0.1250000
NODE_13484_length_764_cov_29.218045	357	437	17	10	80	0.1250000
NODE_13484_length_764_cov_29.218045	357	437	18	14	80	0.1750000
NODE_13485_length_764_cov_25.951880	421	501	8	60	80	0.7500000
NODE_13485_length_764_cov_25.951880	421	501	14	20	80	0.2500000
NODE_13485_length_764_cov_25.951880	474	554	0	22	80	0.2750000
NODE_13485_length_764_cov_25.951880	474	554	6	22	80	0.2750000
NODE_13485_length_764_cov_25.951880	474	554	7	6	80	0.0750000
NODE_13485_length_764_cov_25.951880	474	554	8	30	80	0.3750000
NODE_13486_length_764_cov_23.590977	204	284	16	32	80	0.4000000
NODE_13486_length_764_cov_23.590977	204	284	17	6	80	0.0750000
NODE_13486_length_764_cov_23.590977	204	284	18	1	80	0.0125000
NODE_13486_length_764_cov_23.590977	204	284	21	2	80	0.0250000
NODE_13486_length_764_cov_23.590977	204	284	23	21	80	0.2625000
NODE_13486_length_764_cov_23.590977	204	284	24	2	80	0.0250000
NODE_13486_length_764_cov_23.590977	204	284	25	16	80	0.2000000
NODE_13486_length_764_cov_23.590977	257	337	11	6	80	0.0750000
NODE_13486_length_764_cov_23.590977	257	337	12	11	80	0.1375000
NODE_13486_length_764_cov_23.590977	257	337	13	8	80	0.1000000
NODE_13486_length_764_cov_23.590977	257	337	16	12	80	0.1500000
NODE_13486_length_764_cov_23.590977	257	337	19	5	80	0.0625000
NODE_13486_length_764_cov_23.590977	257	337	21	1	80	0.0125000
NODE_13486_length_764_cov_23.590977	257	337	22	2	80	0.0250000
NODE_13486_length_764_cov_23.590977	257	337	23	29	80	0.3625000
NODE_13486_length_764_cov_23.590977	257	337	24	1	80	0.0125000
NODE_13486_length_764_cov_23.590977	257	337	25	5	80	0.0625000
NODE_13488_length_764_cov_6.804511	281	361	4	45	80	0.5625000
NODE_13488_length_764_cov_6.804511	281	361	6	35	80	0.4375000
NODE_13488_length_764_cov_6.804511	334	414	3	48	80	0.6000000
NODE_13488_length_764_cov_6.804511	334	414	4	32	80	0.4000000
NODE_13489_length_764_cov_6.700752	392	458	0	15	66	0.2272727
NODE_13489_length_764_cov_6.700752	392	458	2	51	66	0.7727273
NODE_13508_length_764_cov_1.171429	475	537	0	62	62	1.0000000
NODE_13520_length_763_cov_28.807229	311	391	4	5	80	0.0625000
NODE_13520_length_763_cov_28.807229	311	391	5	35	80	0.4375000
NODE_13520_length_763_cov_28.807229	311	391	7	40	80	0.5000000
NODE_13520_length_763_cov_28.807229	364	444	7	28	80	0.3500000
NODE_13520_length_763_cov_28.807229	364	444	8	3	80	0.0375000
NODE_13520_length_763_cov_28.807229	364	444	9	37	80	0.4625000
NODE_13520_length_763_cov_28.807229	364	444	10	8	80	0.1000000
NODE_13520_length_763_cov_28.807229	364	444	11	4	80	0.0500000
NODE_13521_length_763_cov_25.299699	598	673	9	9	75	0.1200000
NODE_13521_length_763_cov_25.299699	598	673	10	35	75	0.4666667
NODE_13521_length_763_cov_25.299699	598	673	11	31	75	0.4133333
NODE_13521_length_763_cov_25.299699	598	678	9	9	80	0.1125000
NODE_13521_length_763_cov_25.299699	598	678	10	40	80	0.5000000
NODE_13521_length_763_cov_25.299699	598	678	11	31	80	0.3875000
NODE_13521_length_763_cov_25.299699	605	675	9	9	70	0.1285714
NODE_13521_length_763_cov_25.299699	605	675	10	37	70	0.5285714
NODE_13521_length_763_cov_25.299699	605	675	11	24	70	0.3428572
NODE_13521_length_763_cov_25.299699	607	678	9	9	71	0.1267606
NODE_13521_length_763_cov_25.299699	607	678	10	40	71	0.5633803
NODE_13521_length_763_cov_25.299699	607	678	11	22	71	0.3098592
NODE_13521_length_763_cov_25.299699	651	731	7	3	80	0.0375000
NODE_13521_length_763_cov_25.299699	651	731	8	18	80	0.2250000
NODE_13521_length_763_cov_25.299699	651	731	10	50	80	0.6250000
NODE_13521_length_763_cov_25.299699	651	731	11	9	80	0.1125000
NODE_13521_length_763_cov_25.299699	651	731	7	3	80	0.0375000
NODE_13521_length_763_cov_25.299699	651	731	8	18	80	0.2250000
NODE_13521_length_763_cov_25.299699	651	731	10	50	80	0.6250000
NODE_13521_length_763_cov_25.299699	651	731	11	9	80	0.1125000
NODE_13521_length_763_cov_25.299699	651	731	7	3	80	0.0375000
NODE_13521_length_763_cov_25.299699	651	731	8	18	80	0.2250000
NODE_13521_length_763_cov_25.299699	651	731	10	50	80	0.6250000
NODE_13521_length_763_cov_25.299699	651	731	11	9	80	0.1125000
NODE_13521_length_763_cov_25.299699	651	731	7	3	80	0.0375000
NODE_13521_length_763_cov_25.299699	651	731	8	18	80	0.2250000
NODE_13521_length_763_cov_25.299699	651	731	10	50	80	0.6250000
NODE_13521_length_763_cov_25.299699	651	731	11	9	80	0.1125000
NODE_13522_length_763_cov_12.887048	336	416	2	18	80	0.2250000
NODE_13522_length_763_cov_12.887048	336	416	4	62	80	0.7750000
NODE_13522_length_763_cov_12.887048	389	469	2	69	80	0.8625000
NODE_13522_length_763_cov_12.887048	389	469	3	1	80	0.0125000
NODE_13522_length_763_cov_12.887048	389	469	4	10	80	0.1250000
NODE_13523_length_763_cov_11.599398	547	627	4	16	80	0.2000000
NODE_13523_length_763_cov_11.599398	547	627	7	64	80	0.8000000
NODE_13523_length_763_cov_11.599398	600	680	3	17	80	0.2125000
NODE_13523_length_763_cov_11.599398	600	680	4	20	80	0.2500000
NODE_13523_length_763_cov_11.599398	600	680	7	43	80	0.5375000
NODE_13524_length_763_cov_9.378012	297	377	0	2	80	0.0250000
NODE_13524_length_763_cov_9.378012	297	377	1	78	80	0.9750000
NODE_13524_length_763_cov_9.378012	350	430	1	51	80	0.6375000
NODE_13524_length_763_cov_9.378012	350	430	2	29	80	0.3625000
NODE_13526_length_763_cov_7.246988	368	448	0	36	80	0.4500000
NODE_13526_length_763_cov_7.246988	368	448	2	44	80	0.5500000
NODE_13526_length_763_cov_7.246988	421	501	2	80	80	1.0000000
NODE_13527_length_763_cov_6.414157	371	451	0	18	80	0.2250000
NODE_13527_length_763_cov_6.414157	371	451	1	1	80	0.0125000
NODE_13527_length_763_cov_6.414157	371	451	2	61	80	0.7625000
NODE_13527_length_763_cov_6.414157	424	504	2	80	80	1.0000000
NODE_13558_length_762_cov_21.236802	368	448	3	1	80	0.0125000
NODE_13558_length_762_cov_21.236802	368	448	5	23	80	0.2875000
NODE_13558_length_762_cov_21.236802	368	448	6	56	80	0.7000000
NODE_13558_length_762_cov_21.236802	421	501	2	33	80	0.4125000
NODE_13558_length_762_cov_21.236802	421	501	3	21	80	0.2625000
NODE_13558_length_762_cov_21.236802	421	501	5	23	80	0.2875000
NODE_13558_length_762_cov_21.236802	421	501	6	3	80	0.0375000
NODE_13559_length_762_cov_19.984917	327	407	5	33	80	0.4125000
NODE_13559_length_762_cov_19.984917	327	407	6	47	80	0.5875000
NODE_13559_length_762_cov_19.984917	380	460	2	13	80	0.1625000
NODE_13559_length_762_cov_19.984917	380	460	3	25	80	0.3125000
NODE_13559_length_762_cov_19.984917	380	460	5	42	80	0.5250000
NODE_13560_length_762_cov_15.975867	318	398	3	21	80	0.2625000
NODE_13560_length_762_cov_15.975867	318	398	4	59	80	0.7375000
NODE_13560_length_762_cov_15.975867	371	439	2	25	68	0.3676471
NODE_13560_length_762_cov_15.975867	371	439	3	36	68	0.5294118
NODE_13560_length_762_cov_15.975867	371	439	4	7	68	0.1029412
NODE_13561_length_762_cov_12.728507	381	461	3	56	80	0.7000000
NODE_13561_length_762_cov_12.728507	381	461	4	24	80	0.3000000
NODE_13561_length_762_cov_12.728507	434	514	1	15	80	0.1875000
NODE_13561_length_762_cov_12.728507	434	514	2	10	80	0.1250000
NODE_13561_length_762_cov_12.728507	434	514	3	55	80	0.6875000
NODE_13562_length_762_cov_10.078431	277	357	2	80	80	1.0000000
NODE_13562_length_762_cov_10.078431	330	410	0	16	80	0.2000000
NODE_13562_length_762_cov_10.078431	330	410	2	64	80	0.8000000
NODE_13563_length_762_cov_9.705882	339	419	5	5	80	0.0625000
NODE_13563_length_762_cov_9.705882	339	419	6	3	80	0.0375000
NODE_13563_length_762_cov_9.705882	339	419	7	24	80	0.3000000
NODE_13563_length_762_cov_9.705882	339	419	8	15	80	0.1875000
NODE_13563_length_762_cov_9.705882	339	419	9	33	80	0.4125000
NODE_13563_length_762_cov_9.705882	392	472	8	8	80	0.1000000
NODE_13563_length_762_cov_9.705882	392	472	9	53	80	0.6625000
NODE_13563_length_762_cov_9.705882	392	472	10	1	80	0.0125000
NODE_13563_length_762_cov_9.705882	392	472	11	18	80	0.2250000
NODE_13564_length_762_cov_7.276018	316	395	0	60	79	0.7594936
NODE_13564_length_762_cov_7.276018	316	395	1	19	79	0.2405063
NODE_13564_length_762_cov_7.276018	368	448	0	8	80	0.1000000
NODE_13564_length_762_cov_7.276018	368	448	1	38	80	0.4750000
NODE_13564_length_762_cov_7.276018	368	448	2	34	80	0.4250000
NODE_13565_length_762_cov_6.168929	222	302	1	19	80	0.2375000
NODE_13565_length_762_cov_6.168929	222	302	2	61	80	0.7625000
NODE_13565_length_762_cov_6.168929	275	355	0	27	80	0.3375000
NODE_13565_length_762_cov_6.168929	275	355	1	45	80	0.5625000
NODE_13565_length_762_cov_6.168929	275	355	2	8	80	0.1000000
NODE_13613_length_761_cov_44.243202	531	582	28	5	51	0.0980392
NODE_13613_length_761_cov_44.243202	531	582	29	6	51	0.1176471
NODE_13613_length_761_cov_44.243202	531	582	30	9	51	0.1764706
NODE_13613_length_761_cov_44.243202	531	582	32	10	51	0.1960784
NODE_13613_length_761_cov_44.243202	531	582	34	7	51	0.1372549
NODE_13613_length_761_cov_44.243202	531	582	35	7	51	0.1372549
NODE_13613_length_761_cov_44.243202	531	582	36	7	51	0.1372549
NODE_13614_length_761_cov_38.809668	342	422	6	61	80	0.7625000
NODE_13614_length_761_cov_38.809668	342	422	7	19	80	0.2375000
NODE_13614_length_761_cov_38.809668	395	475	4	8	80	0.1000000
NODE_13614_length_761_cov_38.809668	395	475	5	22	80	0.2750000
NODE_13614_length_761_cov_38.809668	395	475	6	50	80	0.6250000
NODE_13615_length_761_cov_38.694864	314	394	13	14	80	0.1750000
NODE_13615_length_761_cov_38.694864	314	394	14	8	80	0.1000000
NODE_13615_length_761_cov_38.694864	314	394	15	3	80	0.0375000
NODE_13615_length_761_cov_38.694864	314	394	16	27	80	0.3375000
NODE_13615_length_761_cov_38.694864	314	394	17	28	80	0.3500000
NODE_13615_length_761_cov_38.694864	367	447	10	9	80	0.1125000
NODE_13615_length_761_cov_38.694864	367	447	11	2	80	0.0250000
NODE_13615_length_761_cov_38.694864	367	447	12	5	80	0.0625000
NODE_13615_length_761_cov_38.694864	367	447	13	48	80	0.6000000
NODE_13615_length_761_cov_38.694864	367	447	16	16	80	0.2000000
NODE_13616_length_761_cov_32.382175	432	512	10	16	80	0.2000000
NODE_13616_length_761_cov_32.382175	432	512	12	3	80	0.0375000
NODE_13616_length_761_cov_32.382175	432	512	13	16	80	0.2000000
NODE_13616_length_761_cov_32.382175	432	512	14	8	80	0.1000000
NODE_13616_length_761_cov_32.382175	432	512	15	2	80	0.0250000
NODE_13616_length_761_cov_32.382175	432	512	16	35	80	0.4375000
NODE_13616_length_761_cov_32.382175	485	565	8	25	80	0.3125000
NODE_13616_length_761_cov_32.382175	485	565	9	9	80	0.1125000
NODE_13616_length_761_cov_32.382175	485	565	10	35	80	0.4375000
NODE_13616_length_761_cov_32.382175	485	565	12	3	80	0.0375000
NODE_13616_length_761_cov_32.382175	485	565	13	1	80	0.0125000
NODE_13616_length_761_cov_32.382175	485	565	14	1	80	0.0125000
NODE_13616_length_761_cov_32.382175	485	565	15	1	80	0.0125000
NODE_13616_length_761_cov_32.382175	485	565	16	5	80	0.0625000
NODE_13617_length_761_cov_31.444109	323	403	5	12	80	0.1500000
NODE_13617_length_761_cov_31.444109	323	403	6	17	80	0.2125000
NODE_13617_length_761_cov_31.444109	323	403	8	3	80	0.0375000
NODE_13617_length_761_cov_31.444109	323	403	9	11	80	0.1375000
NODE_13617_length_761_cov_31.444109	323	403	10	10	80	0.1250000
NODE_13617_length_761_cov_31.444109	323	403	11	24	80	0.3000000
NODE_13617_length_761_cov_31.444109	323	403	12	3	80	0.0375000
NODE_13617_length_761_cov_31.444109	376	467	10	2	91	0.0219780
NODE_13617_length_761_cov_31.444109	376	467	11	70	91	0.7692308
NODE_13617_length_761_cov_31.444109	376	467	12	19	91	0.2087912
NODE_13618_length_761_cov_14.004532	366	446	2	9	80	0.1125000
NODE_13618_length_761_cov_14.004532	366	446	5	1	80	0.0125000
NODE_13618_length_761_cov_14.004532	366	446	6	49	80	0.6125000
NODE_13618_length_761_cov_14.004532	366	446	8	21	80	0.2625000
NODE_13618_length_761_cov_14.004532	419	499	6	11	80	0.1375000
NODE_13618_length_761_cov_14.004532	419	499	8	69	80	0.8625000
NODE_13619_length_761_cov_13.287009	336	415	2	79	79	1.0000000
NODE_13619_length_761_cov_13.287009	388	468	0	50	80	0.6250000
NODE_13619_length_761_cov_13.287009	388	468	2	30	80	0.3750000
NODE_13621_length_761_cov_9.654079	274	354	0	80	80	1.0000000
NODE_13621_length_761_cov_9.654079	327	407	0	80	80	1.0000000
NODE_13622_length_761_cov_7.306647	308	388	0	80	80	1.0000000
NODE_13622_length_761_cov_7.306647	361	441	0	80	80	1.0000000
NODE_13625_length_761_cov_4.314199	354	434	0	80	80	1.0000000
NODE_13625_length_761_cov_4.314199	407	487	0	80	80	1.0000000
NODE_13658_length_760_cov_48.290469	215	295	10	24	80	0.3000000
NODE_13658_length_760_cov_48.290469	215	295	11	14	80	0.1750000
NODE_13658_length_760_cov_48.290469	215	295	12	10	80	0.1250000
NODE_13658_length_760_cov_48.290469	215	295	13	13	80	0.1625000
NODE_13658_length_760_cov_48.290469	215	295	14	15	80	0.1875000
NODE_13658_length_760_cov_48.290469	215	295	16	4	80	0.0500000
NODE_13658_length_760_cov_48.290469	268	348	4	18	80	0.2250000
NODE_13658_length_760_cov_48.290469	268	348	6	2	80	0.0250000
NODE_13658_length_760_cov_48.290469	268	348	8	4	80	0.0500000
NODE_13658_length_760_cov_48.290469	268	348	9	22	80	0.2750000
NODE_13658_length_760_cov_48.290469	268	348	10	6	80	0.0750000
NODE_13658_length_760_cov_48.290469	268	348	11	14	80	0.1750000
NODE_13658_length_760_cov_48.290469	268	348	12	1	80	0.0125000
NODE_13658_length_760_cov_48.290469	268	348	13	13	80	0.1625000
NODE_13658_length_760_cov_48.290469	344	424	4	48	80	0.6000000
NODE_13658_length_760_cov_48.290469	344	424	5	32	80	0.4000000
NODE_13658_length_760_cov_48.290469	397	477	2	45	80	0.5625000
NODE_13658_length_760_cov_48.290469	397	477	3	1	80	0.0125000
NODE_13658_length_760_cov_48.290469	397	477	4	22	80	0.2750000
NODE_13658_length_760_cov_48.290469	397	477	5	12	80	0.1500000
NODE_13659_length_760_cov_28.314675	384	464	11	13	80	0.1625000
NODE_13659_length_760_cov_28.314675	384	464	12	19	80	0.2375000
NODE_13659_length_760_cov_28.314675	384	464	16	6	80	0.0750000
NODE_13659_length_760_cov_28.314675	384	464	17	2	80	0.0250000
NODE_13659_length_760_cov_28.314675	384	464	19	40	80	0.5000000
NODE_13659_length_760_cov_28.314675	437	517	11	8	80	0.1000000
NODE_13659_length_760_cov_28.314675	437	517	12	34	80	0.4250000
NODE_13659_length_760_cov_28.314675	437	517	13	8	80	0.1000000
NODE_13659_length_760_cov_28.314675	437	517	14	14	80	0.1750000
NODE_13659_length_760_cov_28.314675	437	517	17	13	80	0.1625000
NODE_13659_length_760_cov_28.314675	437	517	18	1	80	0.0125000
NODE_13659_length_760_cov_28.314675	437	517	19	2	80	0.0250000
NODE_13660_length_760_cov_27.981846	432	512	4	2	80	0.0250000
NODE_13660_length_760_cov_27.981846	432	512	5	18	80	0.2250000
NODE_13660_length_760_cov_27.981846	432	512	6	11	80	0.1375000
NODE_13660_length_760_cov_27.981846	432	512	7	29	80	0.3625000
NODE_13660_length_760_cov_27.981846	432	512	9	3	80	0.0375000
NODE_13660_length_760_cov_27.981846	432	512	12	17	80	0.2125000
NODE_13660_length_760_cov_27.981846	485	565	7	7	80	0.0875000
NODE_13660_length_760_cov_27.981846	485	565	9	3	80	0.0375000
NODE_13660_length_760_cov_27.981846	485	565	10	36	80	0.4500000
NODE_13660_length_760_cov_27.981846	485	565	11	1	80	0.0125000
NODE_13660_length_760_cov_27.981846	485	565	12	22	80	0.2750000
NODE_13660_length_760_cov_27.981846	485	565	13	11	80	0.1375000
NODE_13661_length_760_cov_17.500756	372	452	10	5	80	0.0625000
NODE_13661_length_760_cov_17.500756	372	452	11	5	80	0.0625000
NODE_13661_length_760_cov_17.500756	372	452	15	61	80	0.7625000
NODE_13661_length_760_cov_17.500756	372	452	17	9	80	0.1125000
NODE_13661_length_760_cov_17.500756	425	505	11	10	80	0.1250000
NODE_13661_length_760_cov_17.500756	425	505	13	10	80	0.1250000
NODE_13661_length_760_cov_17.500756	425	505	14	2	80	0.0250000
NODE_13661_length_760_cov_17.500756	425	505	15	28	80	0.3500000
NODE_13661_length_760_cov_17.500756	425	505	16	8	80	0.1000000
NODE_13661_length_760_cov_17.500756	425	505	18	8	80	0.1000000
NODE_13661_length_760_cov_17.500756	425	505	19	14	80	0.1750000
NODE_13662_length_760_cov_17.420575	183	263	3	24	80	0.3000000
NODE_13662_length_760_cov_17.420575	183	263	4	56	80	0.7000000
NODE_13662_length_760_cov_17.420575	236	316	4	38	80	0.4750000
NODE_13662_length_760_cov_17.420575	236	316	5	41	80	0.5125000
NODE_13662_length_760_cov_17.420575	236	316	7	1	80	0.0125000
NODE_13663_length_760_cov_13.444781	357	437	0	28	80	0.3500000
NODE_13663_length_760_cov_13.444781	357	437	1	21	80	0.2625000
NODE_13663_length_760_cov_13.444781	357	437	2	7	80	0.0875000
NODE_13663_length_760_cov_13.444781	357	437	3	3	80	0.0375000
NODE_13663_length_760_cov_13.444781	357	437	4	21	80	0.2625000
NODE_13663_length_760_cov_13.444781	410	490	2	3	80	0.0375000
NODE_13663_length_760_cov_13.444781	410	490	3	3	80	0.0375000
NODE_13663_length_760_cov_13.444781	410	490	4	74	80	0.9250000
NODE_13664_length_760_cov_13.196672	282	362	3	80	80	1.0000000
NODE_13664_length_760_cov_13.196672	335	415	0	1	80	0.0125000
NODE_13664_length_760_cov_13.196672	335	415	1	16	80	0.2000000
NODE_13664_length_760_cov_13.196672	335	415	2	2	80	0.0250000
NODE_13664_length_760_cov_13.196672	335	415	3	61	80	0.7625000
NODE_13665_length_760_cov_12.692890	295	375	5	48	80	0.6000000
NODE_13665_length_760_cov_12.692890	295	375	8	23	80	0.2875000
NODE_13665_length_760_cov_12.692890	295	375	9	9	80	0.1125000
NODE_13665_length_760_cov_12.692890	348	428	4	10	80	0.1250000
NODE_13665_length_760_cov_12.692890	348	428	7	5	80	0.0625000
NODE_13665_length_760_cov_12.692890	348	428	8	18	80	0.2250000
NODE_13665_length_760_cov_12.692890	348	428	9	47	80	0.5875000
NODE_13671_length_760_cov_4.282905	388	468	2	80	80	1.0000000
NODE_13671_length_760_cov_4.282905	441	521	0	8	80	0.1000000
NODE_13671_length_760_cov_4.282905	441	521	2	72	80	0.9000000
NODE_13671_length_760_cov_4.282905	517	597	0	80	80	1.0000000
NODE_13683_length_760_cov_1.990923	490	570	0	80	80	1.0000000
NODE_13683_length_760_cov_1.990923	543	623	0	80	80	1.0000000
NODE_13709_length_759_cov_24.757576	376	456	0	40	80	0.5000000
NODE_13709_length_759_cov_24.757576	376	456	1	40	80	0.5000000
NODE_13709_length_759_cov_24.757576	429	509	0	80	80	1.0000000
NODE_13710_length_759_cov_14.356061	210	290	0	15	80	0.1875000
NODE_13710_length_759_cov_14.356061	210	290	2	35	80	0.4375000
NODE_13710_length_759_cov_14.356061	210	290	4	30	80	0.3750000
NODE_13710_length_759_cov_14.356061	263	343	4	80	80	1.0000000
NODE_13711_length_759_cov_10.956061	328	408	2	5	80	0.0625000
NODE_13711_length_759_cov_10.956061	328	408	3	75	80	0.9375000
NODE_13711_length_759_cov_10.956061	381	461	2	37	80	0.4625000
NODE_13711_length_759_cov_10.956061	381	461	3	43	80	0.5375000
NODE_13712_length_759_cov_10.639394	330	410	5	55	80	0.6875000
NODE_13712_length_759_cov_10.639394	330	410	7	25	80	0.3125000
NODE_13712_length_759_cov_10.639394	383	463	3	8	80	0.1000000
NODE_13712_length_759_cov_10.639394	383	463	5	17	80	0.2125000
NODE_13712_length_759_cov_10.639394	383	463	7	55	80	0.6875000
NODE_13713_length_759_cov_9.192424	209	290	0	81	81	1.0000000
NODE_13713_length_759_cov_9.192424	262	310	0	43	48	0.8958333
NODE_13713_length_759_cov_9.192424	262	310	1	5	48	0.1041667
NODE_13714_length_759_cov_8.771212	292	372	6	16	80	0.2000000
NODE_13714_length_759_cov_8.771212	292	372	7	9	80	0.1125000
NODE_13714_length_759_cov_8.771212	292	372	9	52	80	0.6500000
NODE_13714_length_759_cov_8.771212	292	372	10	3	80	0.0375000
NODE_13714_length_759_cov_8.771212	345	425	3	33	80	0.4125000
NODE_13714_length_759_cov_8.771212	345	425	7	16	80	0.2000000
NODE_13714_length_759_cov_8.771212	345	425	9	31	80	0.3875000
NODE_13715_length_759_cov_8.650000	324	404	3	38	80	0.4750000
NODE_13715_length_759_cov_8.650000	324	404	5	28	80	0.3500000
NODE_13715_length_759_cov_8.650000	324	404	6	14	80	0.1750000
NODE_13715_length_759_cov_8.650000	377	457	5	80	80	1.0000000
NODE_13716_length_759_cov_8.268182	604	684	0	80	80	1.0000000
NODE_13716_length_759_cov_8.268182	657	737	0	80	80	1.0000000
NODE_13717_length_759_cov_6.833333	381	461	0	80	80	1.0000000
NODE_13717_length_759_cov_6.833333	434	515	0	81	81	1.0000000
NODE_13718_length_759_cov_6.407576	319	399	9	80	80	1.0000000
NODE_13718_length_759_cov_6.407576	372	452	9	80	80	1.0000000
NODE_13725_length_759_cov_3.400000	355	435	0	6	80	0.0750000
NODE_13725_length_759_cov_3.400000	355	435	1	74	80	0.9250000
NODE_13725_length_759_cov_3.400000	408	488	1	80	80	1.0000000
NODE_13726_length_759_cov_3.346970	240	322	0	82	82	1.0000000
NODE_13760_length_758_cov_38.414264	215	295	2	34	80	0.4250000
NODE_13760_length_758_cov_38.414264	215	295	3	13	80	0.1625000
NODE_13760_length_758_cov_38.414264	215	295	4	33	80	0.4125000
NODE_13760_length_758_cov_38.414264	268	348	0	28	80	0.3500000
NODE_13760_length_758_cov_38.414264	268	348	1	6	80	0.0750000
NODE_13760_length_758_cov_38.414264	268	348	2	46	80	0.5750000
NODE_13760_length_758_cov_38.414264	344	424	0	43	80	0.5375000
NODE_13760_length_758_cov_38.414264	344	424	1	7	80	0.0875000
NODE_13760_length_758_cov_38.414264	344	424	2	30	80	0.3750000
NODE_13760_length_758_cov_38.414264	397	477	2	80	80	1.0000000
NODE_13761_length_758_cov_36.722307	331	411	13	9	80	0.1125000
NODE_13761_length_758_cov_36.722307	331	411	14	17	80	0.2125000
NODE_13761_length_758_cov_36.722307	331	411	15	3	80	0.0375000
NODE_13761_length_758_cov_36.722307	331	411	19	29	80	0.3625000
NODE_13761_length_758_cov_36.722307	331	411	20	22	80	0.2750000
NODE_13761_length_758_cov_36.722307	384	464	13	6	80	0.0750000
NODE_13761_length_758_cov_36.722307	384	464	14	11	80	0.1375000
NODE_13761_length_758_cov_36.722307	384	464	15	11	80	0.1375000
NODE_13761_length_758_cov_36.722307	384	464	16	2	80	0.0250000
NODE_13761_length_758_cov_36.722307	384	464	18	2	80	0.0250000
NODE_13761_length_758_cov_36.722307	384	464	19	27	80	0.3375000
NODE_13761_length_758_cov_36.722307	384	464	20	21	80	0.2625000
NODE_13762_length_758_cov_29.910470	235	315	8	13	80	0.1625000
NODE_13762_length_758_cov_29.910470	235	315	10	35	80	0.4375000
NODE_13762_length_758_cov_29.910470	235	315	11	32	80	0.4000000
NODE_13762_length_758_cov_29.910470	288	368	4	2	80	0.0250000
NODE_13762_length_758_cov_29.910470	288	368	5	33	80	0.4125000
NODE_13762_length_758_cov_29.910470	288	368	7	9	80	0.1125000
NODE_13762_length_758_cov_29.910470	288	368	8	15	80	0.1875000
NODE_13762_length_758_cov_29.910470	288	368	9	7	80	0.0875000
NODE_13762_length_758_cov_29.910470	288	368	10	14	80	0.1750000
NODE_13763_length_758_cov_16.226100	386	466	5	31	80	0.3875000
NODE_13763_length_758_cov_16.226100	386	466	6	45	80	0.5625000
NODE_13763_length_758_cov_16.226100	386	466	7	4	80	0.0500000
NODE_13763_length_758_cov_16.226100	439	519	4	21	80	0.2625000
NODE_13763_length_758_cov_16.226100	439	519	5	9	80	0.1125000
NODE_13763_length_758_cov_16.226100	439	519	6	27	80	0.3375000
NODE_13763_length_758_cov_16.226100	439	519	7	23	80	0.2875000
NODE_13764_length_758_cov_16.097117	311	391	6	9	80	0.1125000
NODE_13764_length_758_cov_16.097117	311	391	7	71	80	0.8875000
NODE_13764_length_758_cov_16.097117	364	444	3	9	80	0.1125000
NODE_13764_length_758_cov_16.097117	364	444	4	16	80	0.2000000
NODE_13764_length_758_cov_16.097117	364	444	5	11	80	0.1375000
NODE_13764_length_758_cov_16.097117	364	444	7	44	80	0.5500000
NODE_13765_length_758_cov_15.525038	260	340	0	36	80	0.4500000
NODE_13765_length_758_cov_15.525038	260	340	2	44	80	0.5500000
NODE_13765_length_758_cov_15.525038	313	393	2	27	80	0.3375000
NODE_13765_length_758_cov_15.525038	313	393	4	53	80	0.6625000
NODE_13768_length_758_cov_9.153263	224	299	0	50	75	0.6666667
NODE_13768_length_758_cov_9.153263	224	299	1	25	75	0.3333333
NODE_13771_length_758_cov_4.241275	508	588	0	80	80	1.0000000
NODE_13772_length_758_cov_3.902883	346	426	4	80	80	1.0000000
NODE_13772_length_758_cov_3.902883	399	479	2	4	80	0.0500000
NODE_13772_length_758_cov_3.902883	399	479	4	76	80	0.9500000
NODE_13794_length_757_cov_49.057751	155	235	8	7	80	0.0875000
NODE_13794_length_757_cov_49.057751	155	235	9	3	80	0.0375000
NODE_13794_length_757_cov_49.057751	155	235	10	3	80	0.0375000
NODE_13794_length_757_cov_49.057751	155	235	11	19	80	0.2375000
NODE_13794_length_757_cov_49.057751	155	235	12	19	80	0.2375000
NODE_13794_length_757_cov_49.057751	155	235	13	15	80	0.1875000
NODE_13794_length_757_cov_49.057751	155	235	14	2	80	0.0250000
NODE_13794_length_757_cov_49.057751	155	235	15	12	80	0.1500000
NODE_13794_length_757_cov_49.057751	208	288	12	2	80	0.0250000
NODE_13794_length_757_cov_49.057751	208	288	13	11	80	0.1375000
NODE_13794_length_757_cov_49.057751	208	288	14	2	80	0.0250000
NODE_13794_length_757_cov_49.057751	208	288	15	29	80	0.3625000
NODE_13794_length_757_cov_49.057751	208	288	16	19	80	0.2375000
NODE_13794_length_757_cov_49.057751	208	288	17	13	80	0.1625000
NODE_13794_length_757_cov_49.057751	208	288	18	4	80	0.0500000
NODE_13795_length_757_cov_29.954407	181	262	0	35	81	0.4320988
NODE_13795_length_757_cov_29.954407	181	262	2	27	81	0.3333333
NODE_13795_length_757_cov_29.954407	181	262	4	19	81	0.2345679
NODE_13795_length_757_cov_29.954407	235	315	2	8	80	0.1000000
NODE_13795_length_757_cov_29.954407	235	315	4	72	80	0.9000000
NODE_13795_length_757_cov_29.954407	311	391	3	7	80	0.0875000
NODE_13795_length_757_cov_29.954407	311	391	4	42	80	0.5250000
NODE_13795_length_757_cov_29.954407	311	391	5	31	80	0.3875000
NODE_13795_length_757_cov_29.954407	364	444	3	58	80	0.7250000
NODE_13795_length_757_cov_29.954407	364	444	5	22	80	0.2750000
NODE_13796_length_757_cov_25.565350	352	432	2	80	80	1.0000000
NODE_13796_length_757_cov_25.565350	405	483	0	41	78	0.5256410
NODE_13796_length_757_cov_25.565350	405	483	1	9	78	0.1153846
NODE_13796_length_757_cov_25.565350	405	483	2	28	78	0.3589744
NODE_13797_length_757_cov_18.338906	264	344	1	15	80	0.1875000
NODE_13797_length_757_cov_18.338906	264	344	2	22	80	0.2750000
NODE_13797_length_757_cov_18.338906	264	344	3	3	80	0.0375000
NODE_13797_length_757_cov_18.338906	264	344	5	29	80	0.3625000
NODE_13797_length_757_cov_18.338906	264	344	6	5	80	0.0625000
NODE_13797_length_757_cov_18.338906	264	344	7	6	80	0.0750000
NODE_13797_length_757_cov_18.338906	317	397	5	16	80	0.2000000
NODE_13797_length_757_cov_18.338906	317	397	6	57	80	0.7125000
NODE_13797_length_757_cov_18.338906	317	397	7	7	80	0.0875000
NODE_13798_length_757_cov_15.879939	58	138	3	52	80	0.6500000
NODE_13798_length_757_cov_15.879939	58	138	5	28	80	0.3500000
NODE_13798_length_757_cov_15.879939	111	191	2	18	80	0.2250000
NODE_13798_length_757_cov_15.879939	111	191	3	4	80	0.0500000
NODE_13798_length_757_cov_15.879939	111	191	4	19	80	0.2375000
NODE_13798_length_757_cov_15.879939	111	191	5	37	80	0.4625000
NODE_13798_length_757_cov_15.879939	111	191	6	1	80	0.0125000
NODE_13798_length_757_cov_15.879939	111	191	7	1	80	0.0125000
NODE_13800_length_757_cov_15.291793	314	394	10	33	80	0.4125000
NODE_13800_length_757_cov_15.291793	314	394	12	47	80	0.5875000
NODE_13800_length_757_cov_15.291793	367	447	8	2	80	0.0250000
NODE_13800_length_757_cov_15.291793	367	447	10	49	80	0.6125000
NODE_13800_length_757_cov_15.291793	367	447	12	29	80	0.3625000
NODE_13807_length_757_cov_3.182371	423	503	0	34	80	0.4250000
NODE_13807_length_757_cov_3.182371	423	503	1	46	80	0.5750000
NODE_13807_length_757_cov_3.182371	476	556	1	80	80	1.0000000
NODE_13832_length_756_cov_26.441400	287	367	3	6	80	0.0750000
NODE_13832_length_756_cov_26.441400	287	367	4	59	80	0.7375000
NODE_13832_length_756_cov_26.441400	287	367	5	15	80	0.1875000
NODE_13832_length_756_cov_26.441400	340	420	2	34	80	0.4250000
NODE_13832_length_756_cov_26.441400	340	420	3	25	80	0.3125000
NODE_13832_length_756_cov_26.441400	340	420	4	21	80	0.2625000
NODE_13834_length_756_cov_13.097412	154	234	0	80	80	1.0000000
NODE_13834_length_756_cov_13.097412	207	287	0	80	80	1.0000000
NODE_13835_length_756_cov_12.732116	377	457	0	80	80	1.0000000
NODE_13836_length_756_cov_9.254186	241	321	2	80	80	1.0000000
NODE_13836_length_756_cov_9.254186	294	374	1	45	80	0.5625000
NODE_13836_length_756_cov_9.254186	294	374	2	35	80	0.4375000
NODE_13837_length_756_cov_8.304414	363	409	0	46	46	1.0000000
NODE_13838_length_756_cov_8.105023	271	351	0	21	80	0.2625000
NODE_13838_length_756_cov_8.105023	271	351	1	6	80	0.0750000
NODE_13838_length_756_cov_8.105023	271	351	2	53	80	0.6625000
NODE_13838_length_756_cov_8.105023	324	404	2	80	80	1.0000000
NODE_13840_length_756_cov_6.622527	431	511	6	15	80	0.1875000
NODE_13840_length_756_cov_6.622527	431	511	7	43	80	0.5375000
NODE_13840_length_756_cov_6.622527	431	511	8	10	80	0.1250000
NODE_13840_length_756_cov_6.622527	431	511	9	12	80	0.1500000
NODE_13840_length_756_cov_6.622527	484	565	6	53	81	0.6543210
NODE_13840_length_756_cov_6.622527	484	565	7	21	81	0.2592593
NODE_13840_length_756_cov_6.622527	484	565	8	7	81	0.0864198
NODE_13888_length_755_cov_64.705793	303	383	14	2	80	0.0250000
NODE_13888_length_755_cov_64.705793	303	383	16	22	80	0.2750000
NODE_13888_length_755_cov_64.705793	303	383	22	3	80	0.0375000
NODE_13888_length_755_cov_64.705793	303	383	23	6	80	0.0750000
NODE_13888_length_755_cov_64.705793	303	383	24	47	80	0.5875000
NODE_13888_length_755_cov_64.705793	356	436	14	3	80	0.0375000
NODE_13888_length_755_cov_64.705793	356	436	15	52	80	0.6500000
NODE_13888_length_755_cov_64.705793	356	436	16	22	80	0.2750000
NODE_13888_length_755_cov_64.705793	356	436	24	3	80	0.0375000
NODE_13889_length_755_cov_58.214939	425	505	0	80	80	1.0000000
NODE_13889_length_755_cov_58.214939	425	505	0	80	80	1.0000000
NODE_13889_length_755_cov_58.214939	478	556	0	78	78	1.0000000
NODE_13889_length_755_cov_58.214939	478	556	0	78	78	1.0000000
NODE_13890_length_755_cov_25.945122	237	317	9	15	80	0.1875000
NODE_13890_length_755_cov_25.945122	237	317	10	1	80	0.0125000
NODE_13890_length_755_cov_25.945122	237	317	13	37	80	0.4625000
NODE_13890_length_755_cov_25.945122	237	317	16	14	80	0.1750000
NODE_13890_length_755_cov_25.945122	237	317	17	7	80	0.0875000
NODE_13890_length_755_cov_25.945122	237	317	18	6	80	0.0750000
NODE_13890_length_755_cov_25.945122	290	370	16	15	80	0.1875000
NODE_13890_length_755_cov_25.945122	290	370	17	10	80	0.1250000
NODE_13890_length_755_cov_25.945122	290	370	18	55	80	0.6875000
NODE_13891_length_755_cov_24.263720	334	414	0	80	80	1.0000000
NODE_13891_length_755_cov_24.263720	387	467	0	80	80	1.0000000
NODE_13892_length_755_cov_15.559451	306	386	4	12	80	0.1500000
NODE_13892_length_755_cov_15.559451	306	386	6	30	80	0.3750000
NODE_13892_length_755_cov_15.559451	306	386	8	38	80	0.4750000
NODE_13892_length_755_cov_15.559451	359	439	4	37	80	0.4625000
NODE_13892_length_755_cov_15.559451	359	439	8	43	80	0.5375000
NODE_13894_length_755_cov_10.196646	332	412	0	80	80	1.0000000
NODE_13894_length_755_cov_10.196646	385	465	0	80	80	1.0000000
NODE_13895_length_755_cov_9.772866	210	290	2	14	80	0.1750000
NODE_13895_length_755_cov_9.772866	210	290	4	4	80	0.0500000
NODE_13895_length_755_cov_9.772866	210	290	5	5	80	0.0625000
NODE_13895_length_755_cov_9.772866	210	290	7	57	80	0.7125000
NODE_13895_length_755_cov_9.772866	263	343	5	32	80	0.4000000
NODE_13895_length_755_cov_9.772866	263	343	7	48	80	0.6000000
NODE_13936_length_754_cov_87.432061	208	288	22	2	80	0.0250000
NODE_13936_length_754_cov_87.432061	208	288	24	6	80	0.0750000
NODE_13936_length_754_cov_87.432061	208	288	25	9	80	0.1125000
NODE_13936_length_754_cov_87.432061	208	288	26	4	80	0.0500000
NODE_13936_length_754_cov_87.432061	208	288	28	9	80	0.1125000
NODE_13936_length_754_cov_87.432061	208	288	29	7	80	0.0875000
NODE_13936_length_754_cov_87.432061	208	288	31	13	80	0.1625000
NODE_13936_length_754_cov_87.432061	208	288	33	3	80	0.0375000
NODE_13936_length_754_cov_87.432061	208	288	34	14	80	0.1750000
NODE_13936_length_754_cov_87.432061	208	288	35	13	80	0.1625000
NODE_13936_length_754_cov_87.432061	261	341	19	1	80	0.0125000
NODE_13936_length_754_cov_87.432061	261	341	20	12	80	0.1500000
NODE_13936_length_754_cov_87.432061	261	341	22	25	80	0.3125000
NODE_13936_length_754_cov_87.432061	261	341	23	6	80	0.0750000
NODE_13936_length_754_cov_87.432061	261	341	24	5	80	0.0625000
NODE_13936_length_754_cov_87.432061	261	341	25	13	80	0.1625000
NODE_13936_length_754_cov_87.432061	261	341	26	6	80	0.0750000
NODE_13936_length_754_cov_87.432061	261	341	28	9	80	0.1125000
NODE_13936_length_754_cov_87.432061	261	341	29	3	80	0.0375000
NODE_13937_length_754_cov_16.549618	156	236	0	65	80	0.8125000
NODE_13937_length_754_cov_16.549618	156	236	1	6	80	0.0750000
NODE_13937_length_754_cov_16.549618	156	236	2	9	80	0.1125000
NODE_13937_length_754_cov_16.549618	209	289	0	12	80	0.1500000
NODE_13937_length_754_cov_16.549618	209	289	1	6	80	0.0750000
NODE_13937_length_754_cov_16.549618	209	289	2	62	80	0.7750000
NODE_13939_length_754_cov_9.068702	316	396	0	10	80	0.1250000
NODE_13939_length_754_cov_9.068702	316	396	1	14	80	0.1750000
NODE_13939_length_754_cov_9.068702	316	396	2	46	80	0.5750000
NODE_13939_length_754_cov_9.068702	316	396	3	10	80	0.1250000
NODE_13939_length_754_cov_9.068702	369	449	2	17	80	0.2125000
NODE_13939_length_754_cov_9.068702	369	449	3	17	80	0.2125000
NODE_13939_length_754_cov_9.068702	369	449	4	46	80	0.5750000
NODE_13940_length_754_cov_5.925191	287	367	2	69	80	0.8625000
NODE_13940_length_754_cov_5.925191	287	367	4	11	80	0.1375000
NODE_13940_length_754_cov_5.925191	340	420	2	69	80	0.8625000
NODE_13940_length_754_cov_5.925191	340	420	4	11	80	0.1375000
NODE_13974_length_753_cov_10.434251	386	466	4	22	80	0.2750000
NODE_13974_length_753_cov_10.434251	386	466	7	22	80	0.2750000
NODE_13974_length_753_cov_10.434251	386	466	8	36	80	0.4500000
NODE_13974_length_753_cov_10.434251	439	519	4	21	80	0.2625000
NODE_13974_length_753_cov_10.434251	439	519	7	49	80	0.6125000
NODE_13974_length_753_cov_10.434251	439	519	8	10	80	0.1250000
NODE_13976_length_753_cov_7.056575	344	424	0	80	80	1.0000000
NODE_13976_length_753_cov_7.056575	397	477	0	80	80	1.0000000
NODE_13977_length_753_cov_4.597859	321	401	0	80	80	1.0000000
NODE_13977_length_753_cov_4.597859	374	454	0	80	80	1.0000000
NODE_14003_length_752_cov_66.281776	617	697	30	5	80	0.0625000
NODE_14003_length_752_cov_66.281776	617	697	32	9	80	0.1125000
NODE_14003_length_752_cov_66.281776	617	697	33	1	80	0.0125000
NODE_14003_length_752_cov_66.281776	617	697	35	13	80	0.1625000
NODE_14003_length_752_cov_66.281776	617	697	39	16	80	0.2000000
NODE_14003_length_752_cov_66.281776	617	697	41	10	80	0.1250000
NODE_14003_length_752_cov_66.281776	617	697	43	18	80	0.2250000
NODE_14003_length_752_cov_66.281776	617	697	46	6	80	0.0750000
NODE_14003_length_752_cov_66.281776	617	697	47	2	80	0.0250000
NODE_14003_length_752_cov_66.281776	670	751	3	8	81	0.0987654
NODE_14003_length_752_cov_66.281776	670	751	4	2	81	0.0246914
NODE_14003_length_752_cov_66.281776	670	751	5	4	81	0.0493827
NODE_14003_length_752_cov_66.281776	670	751	7	2	81	0.0246914
NODE_14003_length_752_cov_66.281776	670	751	10	4	81	0.0493827
NODE_14003_length_752_cov_66.281776	670	751	11	1	81	0.0123457
NODE_14003_length_752_cov_66.281776	670	751	13	1	81	0.0123457
NODE_14003_length_752_cov_66.281776	670	751	14	3	81	0.0370370
NODE_14003_length_752_cov_66.281776	670	751	15	6	81	0.0740741
NODE_14003_length_752_cov_66.281776	670	751	16	1	81	0.0123457
NODE_14003_length_752_cov_66.281776	670	751	20	1	81	0.0123457
NODE_14003_length_752_cov_66.281776	670	751	22	11	81	0.1358025
NODE_14003_length_752_cov_66.281776	670	751	23	2	81	0.0246914
NODE_14003_length_752_cov_66.281776	670	751	26	6	81	0.0740741
NODE_14003_length_752_cov_66.281776	670	751	29	2	81	0.0246914
NODE_14003_length_752_cov_66.281776	670	751	30	5	81	0.0617284
NODE_14003_length_752_cov_66.281776	670	751	32	9	81	0.1111111
NODE_14003_length_752_cov_66.281776	670	751	33	1	81	0.0123457
NODE_14003_length_752_cov_66.281776	670	751	35	12	81	0.1481481
NODE_14004_length_752_cov_60.274119	193	273	15	2	80	0.0250000
NODE_14004_length_752_cov_60.274119	193	273	16	27	80	0.3375000
NODE_14004_length_752_cov_60.274119	193	273	17	27	80	0.3375000
NODE_14004_length_752_cov_60.274119	193	273	23	19	80	0.2375000
NODE_14004_length_752_cov_60.274119	193	273	24	5	80	0.0625000
NODE_14004_length_752_cov_60.274119	246	326	15	31	80	0.3875000
NODE_14004_length_752_cov_60.274119	246	326	16	2	80	0.0250000
NODE_14004_length_752_cov_60.274119	246	326	17	4	80	0.0500000
NODE_14004_length_752_cov_60.274119	246	326	22	2	80	0.0250000
NODE_14004_length_752_cov_60.274119	246	326	23	36	80	0.4500000
NODE_14004_length_752_cov_60.274119	246	326	24	5	80	0.0625000
NODE_14005_length_752_cov_19.811639	299	379	19	8	80	0.1000000
NODE_14005_length_752_cov_19.811639	299	379	20	22	80	0.2750000
NODE_14005_length_752_cov_19.811639	299	379	21	2	80	0.0250000
NODE_14005_length_752_cov_19.811639	299	379	22	6	80	0.0750000
NODE_14005_length_752_cov_19.811639	299	379	23	21	80	0.2625000
NODE_14005_length_752_cov_19.811639	299	379	24	2	80	0.0250000
NODE_14005_length_752_cov_19.811639	299	379	25	1	80	0.0125000
NODE_14005_length_752_cov_19.811639	299	379	29	18	80	0.2250000
NODE_14005_length_752_cov_19.811639	352	432	15	10	80	0.1250000
NODE_14005_length_752_cov_19.811639	352	432	16	17	80	0.2125000
NODE_14005_length_752_cov_19.811639	352	432	18	26	80	0.3250000
NODE_14005_length_752_cov_19.811639	352	432	20	16	80	0.2000000
NODE_14005_length_752_cov_19.811639	352	432	21	2	80	0.0250000
NODE_14005_length_752_cov_19.811639	352	432	22	6	80	0.0750000
NODE_14005_length_752_cov_19.811639	352	432	24	2	80	0.0250000
NODE_14005_length_752_cov_19.811639	352	432	25	1	80	0.0125000
NODE_14006_length_752_cov_17.661562	118	198	1	5	80	0.0625000
NODE_14006_length_752_cov_17.661562	118	198	2	8	80	0.1000000
NODE_14006_length_752_cov_17.661562	118	198	4	42	80	0.5250000
NODE_14006_length_752_cov_17.661562	118	198	6	25	80	0.3125000
NODE_14006_length_752_cov_17.661562	171	251	4	2	80	0.0250000
NODE_14006_length_752_cov_17.661562	171	251	5	24	80	0.3000000
NODE_14006_length_752_cov_17.661562	171	251	6	54	80	0.6750000
NODE_14007_length_752_cov_13.275651	241	321	3	2	80	0.0250000
NODE_14007_length_752_cov_13.275651	241	321	4	39	80	0.4875000
NODE_14007_length_752_cov_13.275651	241	321	5	15	80	0.1875000
NODE_14007_length_752_cov_13.275651	241	321	6	8	80	0.1000000
NODE_14007_length_752_cov_13.275651	241	321	8	16	80	0.2000000
NODE_14007_length_752_cov_13.275651	294	374	5	3	80	0.0375000
NODE_14007_length_752_cov_13.275651	294	374	6	28	80	0.3500000
NODE_14007_length_752_cov_13.275651	294	374	7	32	80	0.4000000
NODE_14007_length_752_cov_13.275651	294	374	8	17	80	0.2125000
NODE_14008_length_752_cov_10.928025	313	393	1	40	80	0.5000000
NODE_14008_length_752_cov_10.928025	313	393	2	40	80	0.5000000
NODE_14011_length_752_cov_9.558959	249	329	2	12	80	0.1500000
NODE_14011_length_752_cov_9.558959	249	329	4	68	80	0.8500000
NODE_14011_length_752_cov_9.558959	302	382	2	40	80	0.5000000
NODE_14011_length_752_cov_9.558959	302	382	4	40	80	0.5000000
NODE_14014_length_752_cov_8.281776	237	317	3	80	80	1.0000000
NODE_14014_length_752_cov_8.281776	290	370	3	33	80	0.4125000
NODE_14014_length_752_cov_8.281776	290	370	4	41	80	0.5125000
NODE_14014_length_752_cov_8.281776	290	370	6	2	80	0.0250000
NODE_14014_length_752_cov_8.281776	290	370	7	4	80	0.0500000
NODE_14015_length_752_cov_8.082695	352	432	0	80	80	1.0000000
NODE_14015_length_752_cov_8.082695	405	485	0	80	80	1.0000000
NODE_14044_length_751_cov_20.730061	238	318	7	2	80	0.0250000
NODE_14044_length_751_cov_20.730061	238	318	11	9	80	0.1125000
NODE_14044_length_751_cov_20.730061	238	318	12	56	80	0.7000000
NODE_14044_length_751_cov_20.730061	238	318	13	13	80	0.1625000
NODE_14044_length_751_cov_20.730061	291	371	11	10	80	0.1250000
NODE_14044_length_751_cov_20.730061	291	371	12	46	80	0.5750000
NODE_14044_length_751_cov_20.730061	291	371	14	1	80	0.0125000
NODE_14044_length_751_cov_20.730061	291	371	17	23	80	0.2875000
NODE_14045_length_751_cov_18.478528	328	409	2	77	81	0.9506173
NODE_14045_length_751_cov_18.478528	328	409	4	4	81	0.0493827
NODE_14045_length_751_cov_18.478528	382	462	2	31	80	0.3875000
NODE_14045_length_751_cov_18.478528	382	462	4	49	80	0.6125000
NODE_14046_length_751_cov_13.016871	172	252	9	27	80	0.3375000
NODE_14046_length_751_cov_13.016871	172	252	11	1	80	0.0125000
NODE_14046_length_751_cov_13.016871	172	252	12	52	80	0.6500000
NODE_14046_length_751_cov_13.016871	225	305	5	23	80	0.2875000
NODE_14046_length_751_cov_13.016871	225	305	6	9	80	0.1125000
NODE_14046_length_751_cov_13.016871	225	305	7	15	80	0.1875000
NODE_14046_length_751_cov_13.016871	225	305	8	1	80	0.0125000
NODE_14046_length_751_cov_13.016871	225	305	9	26	80	0.3250000
NODE_14046_length_751_cov_13.016871	225	305	11	6	80	0.0750000
NODE_14047_length_751_cov_12.363497	397	477	3	80	80	1.0000000
NODE_14047_length_751_cov_12.363497	450	530	0	3	80	0.0375000
NODE_14047_length_751_cov_12.363497	450	530	1	31	80	0.3875000
NODE_14047_length_751_cov_12.363497	450	530	2	3	80	0.0375000
NODE_14047_length_751_cov_12.363497	450	530	3	43	80	0.5375000
NODE_14085_length_750_cov_46.371736	396	476	3	8	80	0.1000000
NODE_14085_length_750_cov_46.371736	396	476	5	36	80	0.4500000
NODE_14085_length_750_cov_46.371736	396	476	6	36	80	0.4500000
NODE_14085_length_750_cov_46.371736	449	529	5	7	80	0.0875000
NODE_14085_length_750_cov_46.371736	449	529	6	68	80	0.8500000
NODE_14085_length_750_cov_46.371736	449	529	7	5	80	0.0625000
NODE_14086_length_750_cov_24.428571	524	604	2	3	80	0.0375000
NODE_14086_length_750_cov_24.428571	524	604	4	15	80	0.1875000
NODE_14086_length_750_cov_24.428571	524	604	5	2	80	0.0250000
NODE_14086_length_750_cov_24.428571	524	604	8	4	80	0.0500000
NODE_14086_length_750_cov_24.428571	524	604	9	8	80	0.1000000
NODE_14086_length_750_cov_24.428571	524	604	10	13	80	0.1625000
NODE_14086_length_750_cov_24.428571	524	604	11	2	80	0.0250000
NODE_14086_length_750_cov_24.428571	524	604	14	16	80	0.2000000
NODE_14086_length_750_cov_24.428571	524	604	15	5	80	0.0625000
NODE_14086_length_750_cov_24.428571	524	604	16	12	80	0.1500000
NODE_14086_length_750_cov_24.428571	683	746	0	63	63	1.0000000
NODE_14087_length_750_cov_24.311828	325	405	6	45	80	0.5625000
NODE_14087_length_750_cov_24.311828	325	405	7	7	80	0.0875000
NODE_14087_length_750_cov_24.311828	325	405	8	28	80	0.3500000
NODE_14087_length_750_cov_24.311828	378	458	2	18	80	0.2250000
NODE_14087_length_750_cov_24.311828	378	458	4	25	80	0.3125000
NODE_14087_length_750_cov_24.311828	378	458	6	29	80	0.3625000
NODE_14087_length_750_cov_24.311828	378	458	7	7	80	0.0875000
NODE_14087_length_750_cov_24.311828	378	458	8	1	80	0.0125000
NODE_14089_length_750_cov_8.529954	336	416	0	5	80	0.0625000
NODE_14089_length_750_cov_8.529954	336	416	2	75	80	0.9375000
NODE_14089_length_750_cov_8.529954	395	469	2	74	74	1.0000000
NODE_14137_length_749_cov_18.986154	221	301	1	29	80	0.3625000
NODE_14137_length_749_cov_18.986154	221	301	2	28	80	0.3500000
NODE_14137_length_749_cov_18.986154	221	301	4	4	80	0.0500000
NODE_14137_length_749_cov_18.986154	221	301	6	19	80	0.2375000
NODE_14137_length_749_cov_18.986154	274	354	2	4	80	0.0500000
NODE_14137_length_749_cov_18.986154	274	354	4	4	80	0.0500000
NODE_14137_length_749_cov_18.986154	274	354	6	72	80	0.9000000
NODE_14138_length_749_cov_18.836923	273	355	4	35	82	0.4268293
NODE_14138_length_749_cov_18.836923	273	355	6	47	82	0.5731707
NODE_14138_length_749_cov_18.836923	328	408	2	9	80	0.1125000
NODE_14138_length_749_cov_18.836923	328	408	3	3	80	0.0375000
NODE_14138_length_749_cov_18.836923	328	408	4	13	80	0.1625000
NODE_14138_length_749_cov_18.836923	328	408	6	55	80	0.6875000
NODE_14138_length_749_cov_18.836923	404	484	0	47	80	0.5875000
NODE_14138_length_749_cov_18.836923	404	484	2	33	80	0.4125000
NODE_14138_length_749_cov_18.836923	457	535	0	78	78	1.0000000
NODE_14139_length_749_cov_16.160000	232	253	34	10	21	0.4761905
NODE_14139_length_749_cov_16.160000	232	253	35	7	21	0.3333333
NODE_14139_length_749_cov_16.160000	232	253	38	4	21	0.1904762
NODE_14139_length_749_cov_16.160000	232	306	31	8	74	0.1081081
NODE_14139_length_749_cov_16.160000	232	306	32	17	74	0.2297297
NODE_14139_length_749_cov_16.160000	232	306	33	5	74	0.0675676
NODE_14139_length_749_cov_16.160000	232	306	34	10	74	0.1351351
NODE_14139_length_749_cov_16.160000	232	306	35	10	74	0.1351351
NODE_14139_length_749_cov_16.160000	232	306	38	16	74	0.2162162
NODE_14139_length_749_cov_16.160000	232	306	39	5	74	0.0675676
NODE_14139_length_749_cov_16.160000	232	306	40	3	74	0.0405405
NODE_14140_length_749_cov_16.115385	307	387	2	12	80	0.1500000
NODE_14140_length_749_cov_16.115385	307	387	4	54	80	0.6750000
NODE_14140_length_749_cov_16.115385	307	387	5	14	80	0.1750000
NODE_14140_length_749_cov_16.115385	360	440	3	4	80	0.0500000
NODE_14140_length_749_cov_16.115385	360	440	4	76	80	0.9500000
NODE_14141_length_749_cov_11.210769	340	420	2	25	80	0.3125000
NODE_14141_length_749_cov_11.210769	340	420	5	55	80	0.6875000
NODE_14141_length_749_cov_11.210769	393	473	3	12	80	0.1500000
NODE_14141_length_749_cov_11.210769	393	473	5	68	80	0.8500000
NODE_14142_length_749_cov_8.424615	372	452	0	80	80	1.0000000
NODE_14142_length_749_cov_8.424615	425	505	0	80	80	1.0000000
NODE_14145_length_749_cov_4.521538	550	630	0	80	80	1.0000000
NODE_14145_length_749_cov_4.521538	603	683	0	80	80	1.0000000
NODE_14185_length_748_cov_55.348228	393	473	50	3	80	0.0375000
NODE_14185_length_748_cov_55.348228	393	473	51	5	80	0.0625000
NODE_14185_length_748_cov_55.348228	393	473	52	2	80	0.0250000
NODE_14185_length_748_cov_55.348228	393	473	53	6	80	0.0750000
NODE_14185_length_748_cov_55.348228	393	473	54	1	80	0.0125000
NODE_14185_length_748_cov_55.348228	393	473	58	14	80	0.1750000
NODE_14185_length_748_cov_55.348228	393	473	59	9	80	0.1125000
NODE_14185_length_748_cov_55.348228	393	473	62	1	80	0.0125000
NODE_14185_length_748_cov_55.348228	393	473	63	1	80	0.0125000
NODE_14185_length_748_cov_55.348228	393	473	65	1	80	0.0125000
NODE_14185_length_748_cov_55.348228	393	473	66	8	80	0.1000000
NODE_14185_length_748_cov_55.348228	393	473	67	12	80	0.1500000
NODE_14185_length_748_cov_55.348228	393	473	68	2	80	0.0250000
NODE_14185_length_748_cov_55.348228	393	473	70	1	80	0.0125000
NODE_14185_length_748_cov_55.348228	393	473	75	1	80	0.0125000
NODE_14185_length_748_cov_55.348228	393	473	76	1	80	0.0125000
NODE_14185_length_748_cov_55.348228	393	473	79	1	80	0.0125000
NODE_14185_length_748_cov_55.348228	393	473	80	1	80	0.0125000
NODE_14185_length_748_cov_55.348228	393	473	88	1	80	0.0125000
NODE_14185_length_748_cov_55.348228	393	473	89	1	80	0.0125000
NODE_14185_length_748_cov_55.348228	393	473	90	7	80	0.0875000
NODE_14185_length_748_cov_55.348228	393	473	92	1	80	0.0125000
NODE_14185_length_748_cov_55.348228	446	526	35	6	80	0.0750000
NODE_14185_length_748_cov_55.348228	446	526	45	1	80	0.0125000
NODE_14185_length_748_cov_55.348228	446	526	46	6	80	0.0750000
NODE_14185_length_748_cov_55.348228	446	526	58	9	80	0.1125000
NODE_14185_length_748_cov_55.348228	446	526	59	9	80	0.1125000
NODE_14185_length_748_cov_55.348228	446	526	63	3	80	0.0375000
NODE_14185_length_748_cov_55.348228	446	526	66	1	80	0.0125000
NODE_14185_length_748_cov_55.348228	446	526	67	12	80	0.1500000
NODE_14185_length_748_cov_55.348228	446	526	68	3	80	0.0375000
NODE_14185_length_748_cov_55.348228	446	526	69	12	80	0.1500000
NODE_14185_length_748_cov_55.348228	446	526	70	15	80	0.1875000
NODE_14185_length_748_cov_55.348228	446	526	71	3	80	0.0375000
NODE_14186_length_748_cov_51.838213	369	449	26	17	80	0.2125000
NODE_14186_length_748_cov_51.838213	369	449	27	13	80	0.1625000
NODE_14186_length_748_cov_51.838213	369	449	28	2	80	0.0250000
NODE_14186_length_748_cov_51.838213	369	449	29	2	80	0.0250000
NODE_14186_length_748_cov_51.838213	369	449	31	5	80	0.0625000
NODE_14186_length_748_cov_51.838213	369	449	32	3	80	0.0375000
NODE_14186_length_748_cov_51.838213	369	449	34	6	80	0.0750000
NODE_14186_length_748_cov_51.838213	369	449	35	10	80	0.1250000
NODE_14186_length_748_cov_51.838213	369	449	36	12	80	0.1500000
NODE_14186_length_748_cov_51.838213	369	449	37	9	80	0.1125000
NODE_14186_length_748_cov_51.838213	369	449	38	1	80	0.0125000
NODE_14186_length_748_cov_51.838213	422	502	28	7	80	0.0875000
NODE_14186_length_748_cov_51.838213	422	502	29	1	80	0.0125000
NODE_14186_length_748_cov_51.838213	422	502	30	5	80	0.0625000
NODE_14186_length_748_cov_51.838213	422	502	31	2	80	0.0250000
NODE_14186_length_748_cov_51.838213	422	502	32	1	80	0.0125000
NODE_14186_length_748_cov_51.838213	422	502	34	6	80	0.0750000
NODE_14186_length_748_cov_51.838213	422	502	35	5	80	0.0625000
NODE_14186_length_748_cov_51.838213	422	502	36	12	80	0.1500000
NODE_14186_length_748_cov_51.838213	422	502	37	10	80	0.1250000
NODE_14186_length_748_cov_51.838213	422	502	38	6	80	0.0750000
NODE_14186_length_748_cov_51.838213	422	502	39	11	80	0.1375000
NODE_14186_length_748_cov_51.838213	422	502	40	8	80	0.1000000
NODE_14186_length_748_cov_51.838213	422	502	41	6	80	0.0750000
NODE_14187_length_748_cov_46.952234	293	373	9	10	80	0.1250000
NODE_14187_length_748_cov_46.952234	293	373	10	21	80	0.2625000
NODE_14187_length_748_cov_46.952234	293	373	12	20	80	0.2500000
NODE_14187_length_748_cov_46.952234	293	373	14	5	80	0.0625000
NODE_14187_length_748_cov_46.952234	293	373	21	1	80	0.0125000
NODE_14187_length_748_cov_46.952234	293	373	23	16	80	0.2000000
NODE_14187_length_748_cov_46.952234	293	373	24	7	80	0.0875000
NODE_14187_length_748_cov_46.952234	346	426	14	3	80	0.0375000
NODE_14187_length_748_cov_46.952234	346	426	17	1	80	0.0125000
NODE_14187_length_748_cov_46.952234	346	426	19	4	80	0.0500000
NODE_14187_length_748_cov_46.952234	346	426	20	18	80	0.2250000
NODE_14187_length_748_cov_46.952234	346	426	21	31	80	0.3875000
NODE_14187_length_748_cov_46.952234	346	426	23	16	80	0.2000000
NODE_14187_length_748_cov_46.952234	346	426	24	7	80	0.0875000
NODE_14188_length_748_cov_45.001541	272	352	18	1	80	0.0125000
NODE_14188_length_748_cov_45.001541	272	352	25	25	80	0.3125000
NODE_14188_length_748_cov_45.001541	272	352	26	15	80	0.1875000
NODE_14188_length_748_cov_45.001541	272	352	27	23	80	0.2875000
NODE_14188_length_748_cov_45.001541	272	352	28	16	80	0.2000000
NODE_14188_length_748_cov_45.001541	325	405	16	14	80	0.1750000
NODE_14188_length_748_cov_45.001541	325	405	17	6	80	0.0750000
NODE_14188_length_748_cov_45.001541	325	405	18	2	80	0.0250000
NODE_14188_length_748_cov_45.001541	325	405	21	1	80	0.0125000
NODE_14188_length_748_cov_45.001541	325	405	25	9	80	0.1125000
NODE_14188_length_748_cov_45.001541	325	405	26	1	80	0.0125000
NODE_14188_length_748_cov_45.001541	325	405	27	26	80	0.3250000
NODE_14188_length_748_cov_45.001541	325	405	28	21	80	0.2625000
NODE_14189_length_748_cov_34.355932	488	568	13	7	80	0.0875000
NODE_14189_length_748_cov_34.355932	488	568	14	27	80	0.3375000
NODE_14189_length_748_cov_34.355932	488	568	19	2	80	0.0250000
NODE_14189_length_748_cov_34.355932	488	568	25	13	80	0.1625000
NODE_14189_length_748_cov_34.355932	488	568	26	31	80	0.3875000
NODE_14189_length_748_cov_34.355932	541	621	18	6	80	0.0750000
NODE_14189_length_748_cov_34.355932	541	621	19	7	80	0.0875000
NODE_14189_length_748_cov_34.355932	541	621	20	9	80	0.1125000
NODE_14189_length_748_cov_34.355932	541	621	22	1	80	0.0125000
NODE_14189_length_748_cov_34.355932	541	621	24	18	80	0.2250000
NODE_14189_length_748_cov_34.355932	541	621	25	19	80	0.2375000
NODE_14189_length_748_cov_34.355932	541	621	26	20	80	0.2500000
NODE_14190_length_748_cov_25.972265	297	377	14	5	80	0.0625000
NODE_14190_length_748_cov_25.972265	297	377	16	8	80	0.1000000
NODE_14190_length_748_cov_25.972265	297	377	17	27	80	0.3375000
NODE_14190_length_748_cov_25.972265	297	377	18	18	80	0.2250000
NODE_14190_length_748_cov_25.972265	297	377	19	22	80	0.2750000
NODE_14190_length_748_cov_25.972265	350	430	14	5	80	0.0625000
NODE_14190_length_748_cov_25.972265	350	430	15	9	80	0.1125000
NODE_14190_length_748_cov_25.972265	350	430	16	15	80	0.1875000
NODE_14190_length_748_cov_25.972265	350	430	17	51	80	0.6375000
NODE_14191_length_748_cov_21.050847	362	442	8	17	80	0.2125000
NODE_14191_length_748_cov_21.050847	362	442	9	12	80	0.1500000
NODE_14191_length_748_cov_21.050847	362	442	10	12	80	0.1500000
NODE_14191_length_748_cov_21.050847	362	442	11	30	80	0.3750000
NODE_14191_length_748_cov_21.050847	362	442	12	4	80	0.0500000
NODE_14191_length_748_cov_21.050847	362	442	13	5	80	0.0625000
NODE_14191_length_748_cov_21.050847	415	495	5	5	80	0.0625000
NODE_14191_length_748_cov_21.050847	415	495	6	31	80	0.3875000
NODE_14191_length_748_cov_21.050847	415	495	8	8	80	0.1000000
NODE_14191_length_748_cov_21.050847	415	495	9	1	80	0.0125000
NODE_14191_length_748_cov_21.050847	415	495	10	20	80	0.2500000
NODE_14191_length_748_cov_21.050847	415	495	11	15	80	0.1875000
NODE_14192_length_748_cov_20.682589	353	433	1	8	80	0.1000000
NODE_14192_length_748_cov_20.682589	353	433	2	11	80	0.1375000
NODE_14192_length_748_cov_20.682589	353	433	3	61	80	0.7625000
NODE_14192_length_748_cov_20.682589	406	486	1	61	80	0.7625000
NODE_14192_length_748_cov_20.682589	406	486	2	5	80	0.0625000
NODE_14192_length_748_cov_20.682589	406	486	3	14	80	0.1750000
NODE_14193_length_748_cov_19.081664	261	341	0	3	80	0.0375000
NODE_14193_length_748_cov_19.081664	261	341	1	19	80	0.2375000
NODE_14193_length_748_cov_19.081664	261	341	3	5	80	0.0625000
NODE_14193_length_748_cov_19.081664	261	341	4	46	80	0.5750000
NODE_14193_length_748_cov_19.081664	261	341	5	7	80	0.0875000
NODE_14193_length_748_cov_19.081664	314	394	4	20	80	0.2500000
NODE_14193_length_748_cov_19.081664	314	394	5	47	80	0.5875000
NODE_14193_length_748_cov_19.081664	314	394	6	13	80	0.1625000
NODE_14193_length_748_cov_19.081664	390	470	2	32	80	0.4000000
NODE_14193_length_748_cov_19.081664	390	470	3	6	80	0.0750000
NODE_14193_length_748_cov_19.081664	390	470	5	18	80	0.2250000
NODE_14193_length_748_cov_19.081664	390	470	6	24	80	0.3000000
NODE_14193_length_748_cov_19.081664	443	522	1	38	79	0.4810127
NODE_14193_length_748_cov_19.081664	443	522	2	41	79	0.5189874
NODE_14194_length_748_cov_16.579353	81	161	0	4	80	0.0500000
NODE_14194_length_748_cov_16.579353	81	161	2	44	80	0.5500000
NODE_14194_length_748_cov_16.579353	81	161	3	15	80	0.1875000
NODE_14194_length_748_cov_16.579353	81	161	5	5	80	0.0625000
NODE_14194_length_748_cov_16.579353	81	161	7	12	80	0.1500000
NODE_14194_length_748_cov_16.579353	134	214	3	10	80	0.1250000
NODE_14194_length_748_cov_16.579353	134	214	5	5	80	0.0625000
NODE_14194_length_748_cov_16.579353	134	214	7	30	80	0.3750000
NODE_14194_length_748_cov_16.579353	134	214	8	1	80	0.0125000
NODE_14194_length_748_cov_16.579353	134	214	9	31	80	0.3875000
NODE_14194_length_748_cov_16.579353	134	214	11	3	80	0.0375000
NODE_14194_length_748_cov_16.579353	210	290	9	1	80	0.0125000
NODE_14194_length_748_cov_16.579353	210	290	11	13	80	0.1625000
NODE_14194_length_748_cov_16.579353	210	290	12	11	80	0.1375000
NODE_14194_length_748_cov_16.579353	210	290	13	15	80	0.1875000
NODE_14194_length_748_cov_16.579353	210	290	14	40	80	0.5000000
NODE_14194_length_748_cov_16.579353	263	343	7	13	80	0.1625000
NODE_14194_length_748_cov_16.579353	263	343	8	1	80	0.0125000
NODE_14194_length_748_cov_16.579353	263	343	9	30	80	0.3750000
NODE_14194_length_748_cov_16.579353	263	343	11	5	80	0.0625000
NODE_14194_length_748_cov_16.579353	263	343	13	15	80	0.1875000
NODE_14194_length_748_cov_16.579353	263	343	14	16	80	0.2000000
NODE_14196_length_748_cov_11.983051	375	455	4	54	80	0.6750000
NODE_14196_length_748_cov_11.983051	375	455	5	26	80	0.3250000
NODE_14196_length_748_cov_11.983051	428	508	3	17	80	0.2125000
NODE_14196_length_748_cov_11.983051	428	508	4	13	80	0.1625000
NODE_14196_length_748_cov_11.983051	428	508	5	34	80	0.4250000
NODE_14196_length_748_cov_11.983051	428	508	6	16	80	0.2000000
NODE_14197_length_748_cov_11.474576	257	337	0	80	80	1.0000000
NODE_14197_length_748_cov_11.474576	310	390	0	80	80	1.0000000
NODE_14200_length_748_cov_7.979969	223	303	10	10	80	0.1250000
NODE_14200_length_748_cov_7.979969	223	303	12	70	80	0.8750000
NODE_14200_length_748_cov_7.979969	276	356	6	51	80	0.6375000
NODE_14200_length_748_cov_7.979969	276	356	10	12	80	0.1500000
NODE_14200_length_748_cov_7.979969	276	356	12	17	80	0.2125000
NODE_14240_length_747_cov_24.279321	205	285	17	6	80	0.0750000
NODE_14240_length_747_cov_24.279321	205	285	18	15	80	0.1875000
NODE_14240_length_747_cov_24.279321	205	285	20	33	80	0.4125000
NODE_14240_length_747_cov_24.279321	205	285	21	4	80	0.0500000
NODE_14240_length_747_cov_24.279321	205	285	22	17	80	0.2125000
NODE_14240_length_747_cov_24.279321	205	285	24	5	80	0.0625000
NODE_14240_length_747_cov_24.279321	258	338	16	2	80	0.0250000
NODE_14240_length_747_cov_24.279321	258	338	17	7	80	0.0875000
NODE_14240_length_747_cov_24.279321	258	338	19	9	80	0.1125000
NODE_14240_length_747_cov_24.279321	258	338	20	3	80	0.0375000
NODE_14240_length_747_cov_24.279321	258	338	21	13	80	0.1625000
NODE_14240_length_747_cov_24.279321	258	338	22	27	80	0.3375000
NODE_14240_length_747_cov_24.279321	258	338	23	12	80	0.1500000
NODE_14240_length_747_cov_24.279321	258	338	24	7	80	0.0875000
NODE_14241_length_747_cov_15.438272	352	432	3	75	80	0.9375000
NODE_14241_length_747_cov_15.438272	352	432	4	5	80	0.0625000
NODE_14241_length_747_cov_15.438272	405	485	0	24	80	0.3000000
NODE_14241_length_747_cov_15.438272	405	485	2	23	80	0.2875000
NODE_14241_length_747_cov_15.438272	405	485	3	33	80	0.4125000
NODE_14244_length_747_cov_7.979938	237	317	1	10	80	0.1250000
NODE_14244_length_747_cov_7.979938	237	317	2	1	80	0.0125000
NODE_14244_length_747_cov_7.979938	237	317	3	15	80	0.1875000
NODE_14244_length_747_cov_7.979938	237	317	4	9	80	0.1125000
NODE_14244_length_747_cov_7.979938	237	317	5	37	80	0.4625000
NODE_14244_length_747_cov_7.979938	237	317	6	4	80	0.0500000
NODE_14244_length_747_cov_7.979938	237	317	7	4	80	0.0500000
NODE_14244_length_747_cov_7.979938	290	370	5	19	80	0.2375000
NODE_14244_length_747_cov_7.979938	290	370	6	4	80	0.0500000
NODE_14244_length_747_cov_7.979938	290	370	7	57	80	0.7125000
NODE_14248_length_747_cov_4.918210	157	237	0	22	80	0.2750000
NODE_14248_length_747_cov_4.918210	157	237	2	58	80	0.7250000
NODE_14248_length_747_cov_4.918210	210	290	0	14	80	0.1750000
NODE_14248_length_747_cov_4.918210	210	290	2	66	80	0.8250000
NODE_14277_length_746_cov_44.041731	153	233	2	4	80	0.0500000
NODE_14277_length_746_cov_44.041731	153	233	3	44	80	0.5500000
NODE_14277_length_746_cov_44.041731	153	233	4	3	80	0.0375000
NODE_14277_length_746_cov_44.041731	153	233	6	15	80	0.1875000
NODE_14277_length_746_cov_44.041731	153	233	7	2	80	0.0250000
NODE_14277_length_746_cov_44.041731	153	233	9	12	80	0.1500000
NODE_14277_length_746_cov_44.041731	206	286	6	14	80	0.1750000
NODE_14277_length_746_cov_44.041731	206	286	7	1	80	0.0125000
NODE_14277_length_746_cov_44.041731	206	286	9	14	80	0.1750000
NODE_14277_length_746_cov_44.041731	206	286	11	12	80	0.1500000
NODE_14277_length_746_cov_44.041731	206	286	12	39	80	0.4875000
NODE_14278_length_746_cov_24.435858	334	414	6	13	80	0.1625000
NODE_14278_length_746_cov_24.435858	334	414	7	2	80	0.0250000
NODE_14278_length_746_cov_24.435858	334	414	8	24	80	0.3000000
NODE_14278_length_746_cov_24.435858	334	414	9	9	80	0.1125000
NODE_14278_length_746_cov_24.435858	334	414	10	19	80	0.2375000
NODE_14278_length_746_cov_24.435858	334	414	11	13	80	0.1625000
NODE_14278_length_746_cov_24.435858	387	467	7	8	80	0.1000000
NODE_14278_length_746_cov_24.435858	387	467	8	23	80	0.2875000
NODE_14278_length_746_cov_24.435858	387	467	9	10	80	0.1250000
NODE_14278_length_746_cov_24.435858	387	467	10	20	80	0.2500000
NODE_14278_length_746_cov_24.435858	387	467	11	19	80	0.2375000
NODE_14279_length_746_cov_20.225657	114	194	5	1	80	0.0125000
NODE_14279_length_746_cov_20.225657	114	194	6	14	80	0.1750000
NODE_14279_length_746_cov_20.225657	114	194	7	1	80	0.0125000
NODE_14279_length_746_cov_20.225657	114	194	8	34	80	0.4250000
NODE_14279_length_746_cov_20.225657	114	194	9	7	80	0.0875000
NODE_14279_length_746_cov_20.225657	114	194	10	7	80	0.0875000
NODE_14279_length_746_cov_20.225657	114	194	11	16	80	0.2000000
NODE_14279_length_746_cov_20.225657	167	247	7	3	80	0.0375000
NODE_14279_length_746_cov_20.225657	167	247	8	15	80	0.1875000
NODE_14279_length_746_cov_20.225657	167	247	9	15	80	0.1875000
NODE_14279_length_746_cov_20.225657	167	247	10	14	80	0.1750000
NODE_14279_length_746_cov_20.225657	167	247	11	33	80	0.4125000
NODE_14280_length_746_cov_17.919629	330	410	4	27	80	0.3375000
NODE_14280_length_746_cov_17.919629	330	410	5	53	80	0.6625000
NODE_14280_length_746_cov_17.919629	383	463	0	25	80	0.3125000
NODE_14280_length_746_cov_17.919629	383	463	1	14	80	0.1750000
NODE_14280_length_746_cov_17.919629	383	463	4	41	80	0.5125000
NODE_14281_length_746_cov_17.523957	292	372	2	80	80	1.0000000
NODE_14281_length_746_cov_17.523957	345	425	0	42	80	0.5250000
NODE_14281_length_746_cov_17.523957	345	425	1	3	80	0.0375000
NODE_14281_length_746_cov_17.523957	345	425	2	35	80	0.4375000
NODE_14282_length_746_cov_17.214838	306	386	1	3	80	0.0375000
NODE_14282_length_746_cov_17.214838	306	386	2	77	80	0.9625000
NODE_14282_length_746_cov_17.214838	359	439	2	34	80	0.4250000
NODE_14282_length_746_cov_17.214838	359	439	3	46	80	0.5750000
NODE_14283_length_746_cov_16.765070	344	424	0	80	80	1.0000000
NODE_14283_length_746_cov_16.765070	397	477	0	80	80	1.0000000
NODE_14284_length_746_cov_13.153014	126	206	2	80	80	1.0000000
NODE_14284_length_746_cov_13.153014	179	259	1	30	80	0.3750000
NODE_14284_length_746_cov_13.153014	179	259	2	50	80	0.6250000
NODE_14284_length_746_cov_13.153014	244	263	1	19	19	1.0000000
NODE_14285_length_746_cov_12.316847	364	442	0	78	78	1.0000000
NODE_14286_length_746_cov_11.301391	349	429	4	80	80	1.0000000
NODE_14286_length_746_cov_11.301391	402	482	0	14	80	0.1750000
NODE_14286_length_746_cov_11.301391	402	482	4	66	80	0.8250000
NODE_14302_length_746_cov_2.639876	331	411	2	80	80	1.0000000
NODE_14307_length_746_cov_1.879444	435	502	0	67	67	1.0000000
NODE_14310_length_746_cov_1.727975	65	121	0	56	56	1.0000000
NODE_14310_length_746_cov_1.727975	494	540	0	46	46	1.0000000
NODE_14329_length_745_cov_40.360681	257	337	0	80	80	1.0000000
NODE_14329_length_745_cov_40.360681	310	390	0	40	80	0.5000000
NODE_14329_length_745_cov_40.360681	310	390	1	40	80	0.5000000
NODE_14330_length_745_cov_30.817337	339	419	3	21	80	0.2625000
NODE_14330_length_745_cov_30.817337	339	419	4	35	80	0.4375000
NODE_14330_length_745_cov_30.817337	339	419	5	24	80	0.3000000
NODE_14330_length_745_cov_30.817337	392	459	4	11	67	0.1641791
NODE_14330_length_745_cov_30.817337	392	459	5	56	67	0.8358209
NODE_14335_length_745_cov_8.620743	225	275	20	4	50	0.0800000
NODE_14335_length_745_cov_8.620743	225	275	24	1	50	0.0200000
NODE_14335_length_745_cov_8.620743	225	275	25	17	50	0.3400000
NODE_14335_length_745_cov_8.620743	225	275	26	15	50	0.3000000
NODE_14335_length_745_cov_8.620743	225	275	28	9	50	0.1800000
NODE_14335_length_745_cov_8.620743	225	275	33	4	50	0.0800000
NODE_14335_length_745_cov_8.620743	248	328	25	4	80	0.0500000
NODE_14335_length_745_cov_8.620743	248	328	26	19	80	0.2375000
NODE_14335_length_745_cov_8.620743	248	328	27	26	80	0.3250000
NODE_14335_length_745_cov_8.620743	248	328	28	26	80	0.3250000
NODE_14335_length_745_cov_8.620743	248	328	32	1	80	0.0125000
NODE_14335_length_745_cov_8.620743	248	328	33	4	80	0.0500000
NODE_14343_length_745_cov_3.922601	249	280	2	31	31	1.0000000
NODE_14343_length_745_cov_3.922601	253	333	1	30	80	0.3750000
NODE_14343_length_745_cov_3.922601	253	333	2	50	80	0.6250000
NODE_14381_length_744_cov_44.953488	553	633	2	12	80	0.1500000
NODE_14381_length_744_cov_44.953488	553	633	4	1	80	0.0125000
NODE_14381_length_744_cov_44.953488	553	633	5	15	80	0.1875000
NODE_14381_length_744_cov_44.953488	553	633	6	37	80	0.4625000
NODE_14381_length_744_cov_44.953488	553	633	7	12	80	0.1500000
NODE_14381_length_744_cov_44.953488	553	633	9	3	80	0.0375000
NODE_14381_length_744_cov_44.953488	553	633	2	12	80	0.1500000
NODE_14381_length_744_cov_44.953488	553	633	4	1	80	0.0125000
NODE_14381_length_744_cov_44.953488	553	633	5	15	80	0.1875000
NODE_14381_length_744_cov_44.953488	553	633	6	37	80	0.4625000
NODE_14381_length_744_cov_44.953488	553	633	7	12	80	0.1500000
NODE_14381_length_744_cov_44.953488	553	633	9	3	80	0.0375000
NODE_14381_length_744_cov_44.953488	553	633	2	12	80	0.1500000
NODE_14381_length_744_cov_44.953488	553	633	4	1	80	0.0125000
NODE_14381_length_744_cov_44.953488	553	633	5	15	80	0.1875000
NODE_14381_length_744_cov_44.953488	553	633	6	37	80	0.4625000
NODE_14381_length_744_cov_44.953488	553	633	7	12	80	0.1500000
NODE_14381_length_744_cov_44.953488	553	633	9	3	80	0.0375000
NODE_14381_length_744_cov_44.953488	553	633	2	12	80	0.1500000
NODE_14381_length_744_cov_44.953488	553	633	4	1	80	0.0125000
NODE_14381_length_744_cov_44.953488	553	633	5	15	80	0.1875000
NODE_14381_length_744_cov_44.953488	553	633	6	37	80	0.4625000
NODE_14381_length_744_cov_44.953488	553	633	7	12	80	0.1500000
NODE_14381_length_744_cov_44.953488	553	633	9	3	80	0.0375000
NODE_14382_length_744_cov_35.333333	163	243	7	3	80	0.0375000
NODE_14382_length_744_cov_35.333333	163	243	8	1	80	0.0125000
NODE_14382_length_744_cov_35.333333	163	243	9	16	80	0.2000000
NODE_14382_length_744_cov_35.333333	163	243	11	4	80	0.0500000
NODE_14382_length_744_cov_35.333333	163	243	12	4	80	0.0500000
NODE_14382_length_744_cov_35.333333	163	243	13	25	80	0.3125000
NODE_14382_length_744_cov_35.333333	163	243	14	27	80	0.3375000
NODE_14382_length_744_cov_35.333333	216	296	9	32	80	0.4000000
NODE_14382_length_744_cov_35.333333	216	296	10	18	80	0.2250000
NODE_14382_length_744_cov_35.333333	216	296	11	11	80	0.1375000
NODE_14382_length_744_cov_35.333333	216	296	12	4	80	0.0500000
NODE_14382_length_744_cov_35.333333	216	296	13	15	80	0.1875000
NODE_14382_length_744_cov_35.333333	292	372	6	38	80	0.4750000
NODE_14382_length_744_cov_35.333333	292	372	7	15	80	0.1875000
NODE_14382_length_744_cov_35.333333	292	372	9	2	80	0.0250000
NODE_14382_length_744_cov_35.333333	292	372	10	1	80	0.0125000
NODE_14382_length_744_cov_35.333333	292	372	11	22	80	0.2750000
NODE_14382_length_744_cov_35.333333	292	372	12	2	80	0.0250000
NODE_14382_length_744_cov_35.333333	345	425	5	14	80	0.1750000
NODE_14382_length_744_cov_35.333333	345	425	6	66	80	0.8250000
NODE_14383_length_744_cov_34.503876	294	374	5	9	80	0.1125000
NODE_14383_length_744_cov_34.503876	294	374	6	3	80	0.0375000
NODE_14383_length_744_cov_34.503876	294	374	7	4	80	0.0500000
NODE_14383_length_744_cov_34.503876	294	374	8	33	80	0.4125000
NODE_14383_length_744_cov_34.503876	294	374	9	25	80	0.3125000
NODE_14383_length_744_cov_34.503876	294	374	10	6	80	0.0750000
NODE_14383_length_744_cov_34.503876	347	427	7	23	80	0.2875000
NODE_14383_length_744_cov_34.503876	347	427	8	13	80	0.1625000
NODE_14383_length_744_cov_34.503876	347	427	9	30	80	0.3750000
NODE_14383_length_744_cov_34.503876	347	427	10	14	80	0.1750000
NODE_14384_length_744_cov_32.282171	333	403	0	70	70	1.0000000
NODE_14384_length_744_cov_32.282171	440	520	0	80	80	1.0000000
NODE_14384_length_744_cov_32.282171	493	573	0	80	80	1.0000000
NODE_14390_length_744_cov_4.537984	260	340	0	33	80	0.4125000
NODE_14390_length_744_cov_4.537984	260	340	1	36	80	0.4500000
NODE_14390_length_744_cov_4.537984	260	340	2	11	80	0.1375000
NODE_14390_length_744_cov_4.537984	313	393	1	16	80	0.2000000
NODE_14390_length_744_cov_4.537984	313	393	2	64	80	0.8000000
NODE_14396_length_744_cov_2.784496	335	387	0	52	52	1.0000000
NODE_14396_length_744_cov_2.784496	360	437	0	77	77	1.0000000
NODE_14427_length_743_cov_26.369565	354	434	0	80	80	1.0000000
NODE_14427_length_743_cov_26.369565	407	487	0	80	80	1.0000000
NODE_14428_length_743_cov_21.759317	138	218	0	18	80	0.2250000
NODE_14428_length_743_cov_21.759317	138	218	2	14	80	0.1750000
NODE_14428_length_743_cov_21.759317	138	218	3	36	80	0.4500000
NODE_14428_length_743_cov_21.759317	138	218	5	12	80	0.1500000
NODE_14428_length_743_cov_21.759317	191	271	3	15	80	0.1875000
NODE_14428_length_743_cov_21.759317	191	271	5	65	80	0.8125000
NODE_14429_length_743_cov_18.173913	213	293	1	33	80	0.4125000
NODE_14429_length_743_cov_18.173913	213	293	2	47	80	0.5875000
NODE_14429_length_743_cov_18.173913	266	346	1	31	80	0.3875000
NODE_14429_length_743_cov_18.173913	266	346	2	49	80	0.6125000
NODE_14431_length_743_cov_17.066770	400	480	0	80	80	1.0000000
NODE_14431_length_743_cov_17.066770	453	532	0	79	79	1.0000000
NODE_14432_length_743_cov_16.354037	350	430	0	46	80	0.5750000
NODE_14432_length_743_cov_16.354037	350	430	2	34	80	0.4250000
NODE_14432_length_743_cov_16.354037	403	483	2	80	80	1.0000000
NODE_14433_length_743_cov_15.667702	220	300	2	13	80	0.1625000
NODE_14433_length_743_cov_15.667702	220	300	3	20	80	0.2500000
NODE_14433_length_743_cov_15.667702	220	300	4	30	80	0.3750000
NODE_14433_length_743_cov_15.667702	220	300	5	17	80	0.2125000
NODE_14433_length_743_cov_15.667702	273	353	4	10	80	0.1250000
NODE_14433_length_743_cov_15.667702	273	353	5	68	80	0.8500000
NODE_14433_length_743_cov_15.667702	273	353	6	2	80	0.0250000
NODE_14433_length_743_cov_15.667702	349	429	3	32	80	0.4000000
NODE_14433_length_743_cov_15.667702	349	429	4	28	80	0.3500000
NODE_14433_length_743_cov_15.667702	349	429	5	20	80	0.2500000
NODE_14433_length_743_cov_15.667702	402	482	1	8	80	0.1000000
NODE_14433_length_743_cov_15.667702	402	482	2	41	80	0.5125000
NODE_14433_length_743_cov_15.667702	402	482	3	30	80	0.3750000
NODE_14433_length_743_cov_15.667702	402	482	4	1	80	0.0125000
NODE_14434_length_743_cov_14.975155	289	362	2	30	73	0.4109589
NODE_14434_length_743_cov_14.975155	289	362	4	1	73	0.0136986
NODE_14434_length_743_cov_14.975155	289	362	5	42	73	0.5753425
NODE_14435_length_743_cov_14.100932	232	312	6	3	80	0.0375000
NODE_14435_length_743_cov_14.100932	232	312	7	67	80	0.8375000
NODE_14435_length_743_cov_14.100932	232	312	8	1	80	0.0125000
NODE_14435_length_743_cov_14.100932	232	312	9	9	80	0.1125000
NODE_14435_length_743_cov_14.100932	285	365	6	4	80	0.0500000
NODE_14435_length_743_cov_14.100932	285	365	7	16	80	0.2000000
NODE_14435_length_743_cov_14.100932	285	365	8	15	80	0.1875000
NODE_14435_length_743_cov_14.100932	285	365	9	38	80	0.4750000
NODE_14435_length_743_cov_14.100932	285	365	10	7	80	0.0875000
NODE_14435_length_743_cov_14.100932	361	441	7	15	80	0.1875000
NODE_14435_length_743_cov_14.100932	361	441	8	2	80	0.0250000
NODE_14435_length_743_cov_14.100932	361	441	9	5	80	0.0625000
NODE_14435_length_743_cov_14.100932	361	441	10	33	80	0.4125000
NODE_14435_length_743_cov_14.100932	361	441	12	25	80	0.3125000
NODE_14435_length_743_cov_14.100932	414	494	9	11	80	0.1375000
NODE_14435_length_743_cov_14.100932	414	494	10	3	80	0.0375000
NODE_14435_length_743_cov_14.100932	414	494	11	4	80	0.0500000
NODE_14435_length_743_cov_14.100932	414	494	12	36	80	0.4500000
NODE_14435_length_743_cov_14.100932	414	494	14	18	80	0.2250000
NODE_14435_length_743_cov_14.100932	414	494	16	8	80	0.1000000
NODE_14436_length_743_cov_12.968944	268	348	0	18	80	0.2250000
NODE_14436_length_743_cov_12.968944	268	348	1	10	80	0.1250000
NODE_14436_length_743_cov_12.968944	268	348	2	25	80	0.3125000
NODE_14436_length_743_cov_12.968944	268	348	4	27	80	0.3375000
NODE_14436_length_743_cov_12.968944	321	401	4	80	80	1.0000000
NODE_14437_length_743_cov_12.847826	485	565	14	51	80	0.6375000
NODE_14437_length_743_cov_12.847826	485	565	15	11	80	0.1375000
NODE_14437_length_743_cov_12.847826	485	565	16	18	80	0.2250000
NODE_14437_length_743_cov_12.847826	538	618	8	5	80	0.0625000
NODE_14437_length_743_cov_12.847826	538	618	9	3	80	0.0375000
NODE_14437_length_743_cov_12.847826	538	618	10	14	80	0.1750000
NODE_14437_length_743_cov_12.847826	538	618	11	13	80	0.1625000
NODE_14437_length_743_cov_12.847826	538	618	14	32	80	0.4000000
NODE_14437_length_743_cov_12.847826	538	618	15	11	80	0.1375000
NODE_14437_length_743_cov_12.847826	538	618	16	2	80	0.0250000
NODE_14438_length_743_cov_11.871118	403	483	0	49	80	0.6125000
NODE_14438_length_743_cov_11.871118	403	483	1	31	80	0.3875000
NODE_14438_length_743_cov_11.871118	456	536	0	80	80	1.0000000
NODE_14439_length_743_cov_11.760870	337	417	8	4	80	0.0500000
NODE_14439_length_743_cov_11.760870	337	417	9	7	80	0.0875000
NODE_14439_length_743_cov_11.760870	337	417	10	37	80	0.4625000
NODE_14439_length_743_cov_11.760870	337	417	11	32	80	0.4000000
NODE_14439_length_743_cov_11.760870	390	470	9	18	80	0.2250000
NODE_14439_length_743_cov_11.760870	390	470	10	21	80	0.2625000
NODE_14439_length_743_cov_11.760870	390	470	11	37	80	0.4625000
NODE_14439_length_743_cov_11.760870	390	470	12	4	80	0.0500000
NODE_14440_length_743_cov_9.006211	351	431	0	19	80	0.2375000
NODE_14440_length_743_cov_9.006211	351	431	1	61	80	0.7625000
NODE_14440_length_743_cov_9.006211	404	484	1	80	80	1.0000000
NODE_14441_length_743_cov_8.063665	290	370	2	73	80	0.9125000
NODE_14441_length_743_cov_8.063665	290	370	4	7	80	0.0875000
NODE_14441_length_743_cov_8.063665	343	423	0	1	80	0.0125000
NODE_14441_length_743_cov_8.063665	343	423	2	79	80	0.9875000
NODE_14456_length_743_cov_2.029503	260	284	0	24	24	1.0000000
NODE_14456_length_743_cov_2.029503	301	363	2	62	62	1.0000000
NODE_14473_length_743_cov_0.989130	592	670	0	78	78	1.0000000
NODE_14477_length_742_cov_23.664075	271	351	4	25	80	0.3125000
NODE_14477_length_742_cov_23.664075	271	351	5	52	80	0.6500000
NODE_14477_length_742_cov_23.664075	271	351	7	3	80	0.0375000
NODE_14477_length_742_cov_23.664075	324	404	5	24	80	0.3000000
NODE_14477_length_742_cov_23.664075	324	404	7	27	80	0.3375000
NODE_14477_length_742_cov_23.664075	324	404	8	29	80	0.3625000
NODE_14478_length_742_cov_19.488336	288	368	5	41	80	0.5125000
NODE_14478_length_742_cov_19.488336	288	368	10	39	80	0.4875000
NODE_14478_length_742_cov_19.488336	341	421	5	75	80	0.9375000
NODE_14478_length_742_cov_19.488336	341	421	10	5	80	0.0625000
NODE_14479_length_742_cov_18.528771	319	399	1	14	80	0.1750000
NODE_14479_length_742_cov_18.528771	319	399	2	66	80	0.8250000
NODE_14479_length_742_cov_18.528771	372	452	1	13	80	0.1625000
NODE_14479_length_742_cov_18.528771	372	452	2	67	80	0.8375000
NODE_14480_length_742_cov_17.401244	126	206	1	5	80	0.0625000
NODE_14480_length_742_cov_17.401244	126	206	2	35	80	0.4375000
NODE_14480_length_742_cov_17.401244	126	206	3	26	80	0.3250000
NODE_14480_length_742_cov_17.401244	126	206	4	7	80	0.0875000
NODE_14480_length_742_cov_17.401244	126	206	5	6	80	0.0750000
NODE_14480_length_742_cov_17.401244	126	206	6	1	80	0.0125000
NODE_14480_length_742_cov_17.401244	179	259	3	13	80	0.1625000
NODE_14480_length_742_cov_17.401244	179	259	4	7	80	0.0875000
NODE_14480_length_742_cov_17.401244	179	259	5	11	80	0.1375000
NODE_14480_length_742_cov_17.401244	179	259	6	49	80	0.6125000
NODE_14482_length_742_cov_7.679627	274	354	4	7	80	0.0875000
NODE_14482_length_742_cov_7.679627	274	354	5	3	80	0.0375000
NODE_14482_length_742_cov_7.679627	274	354	6	2	80	0.0250000
NODE_14482_length_742_cov_7.679627	274	354	7	68	80	0.8500000
NODE_14482_length_742_cov_7.679627	327	407	5	56	80	0.7000000
NODE_14482_length_742_cov_7.679627	327	407	6	2	80	0.0250000
NODE_14482_length_742_cov_7.679627	327	407	7	22	80	0.2750000
NODE_14521_length_741_cov_12.168224	316	392	1	3	76	0.0394737
NODE_14521_length_741_cov_12.168224	316	392	2	73	76	0.9605263
NODE_14521_length_741_cov_12.168224	598	663	0	65	65	1.0000000
NODE_14522_length_741_cov_8.542056	198	278	0	80	80	1.0000000
NODE_14522_length_741_cov_8.542056	251	331	0	80	80	1.0000000
NODE_14525_length_741_cov_5.989097	457	538	4	9	81	0.1111111
NODE_14525_length_741_cov_5.989097	457	538	5	11	81	0.1358025
NODE_14525_length_741_cov_5.989097	457	538	6	33	81	0.4074074
NODE_14525_length_741_cov_5.989097	457	538	8	28	81	0.3456790
NODE_14536_length_741_cov_2.556075	212	289	0	77	77	1.0000000
NODE_14571_length_740_cov_54.372855	192	272	3	11	80	0.1375000
NODE_14571_length_740_cov_54.372855	192	272	4	1	80	0.0125000
NODE_14571_length_740_cov_54.372855	192	272	5	67	80	0.8375000
NODE_14571_length_740_cov_54.372855	192	272	6	1	80	0.0125000
NODE_14571_length_740_cov_54.372855	245	325	5	71	80	0.8875000
NODE_14571_length_740_cov_54.372855	245	325	6	9	80	0.1125000
NODE_14571_length_740_cov_54.372855	321	401	3	47	80	0.5875000
NODE_14571_length_740_cov_54.372855	321	401	4	1	80	0.0125000
NODE_14571_length_740_cov_54.372855	321	401	5	32	80	0.4000000
NODE_14571_length_740_cov_54.372855	374	454	0	3	80	0.0375000
NODE_14571_length_740_cov_54.372855	374	454	1	49	80	0.6125000
NODE_14571_length_740_cov_54.372855	374	454	3	28	80	0.3500000
NODE_14572_length_740_cov_51.758190	194	274	13	5	80	0.0625000
NODE_14572_length_740_cov_51.758190	194	274	15	1	80	0.0125000
NODE_14572_length_740_cov_51.758190	194	274	16	3	80	0.0375000
NODE_14572_length_740_cov_51.758190	194	274	18	5	80	0.0625000
NODE_14572_length_740_cov_51.758190	194	274	20	7	80	0.0875000
NODE_14572_length_740_cov_51.758190	194	274	22	2	80	0.0250000
NODE_14572_length_740_cov_51.758190	194	274	24	1	80	0.0125000
NODE_14572_length_740_cov_51.758190	194	274	25	2	80	0.0250000
NODE_14572_length_740_cov_51.758190	194	274	26	15	80	0.1875000
NODE_14572_length_740_cov_51.758190	194	274	27	15	80	0.1875000
NODE_14572_length_740_cov_51.758190	194	274	28	15	80	0.1875000
NODE_14572_length_740_cov_51.758190	194	274	29	9	80	0.1125000
NODE_14572_length_740_cov_51.758190	247	327	24	4	80	0.0500000
NODE_14572_length_740_cov_51.758190	247	327	25	15	80	0.1875000
NODE_14572_length_740_cov_51.758190	247	327	26	26	80	0.3250000
NODE_14572_length_740_cov_51.758190	247	327	27	13	80	0.1625000
NODE_14572_length_740_cov_51.758190	247	327	28	15	80	0.1875000
NODE_14572_length_740_cov_51.758190	247	327	29	7	80	0.0875000
NODE_14573_length_740_cov_34.185647	359	439	12	3	80	0.0375000
NODE_14573_length_740_cov_34.185647	359	439	13	39	80	0.4875000
NODE_14573_length_740_cov_34.185647	359	439	14	5	80	0.0625000
NODE_14573_length_740_cov_34.185647	359	439	15	10	80	0.1250000
NODE_14573_length_740_cov_34.185647	359	439	16	23	80	0.2875000
NODE_14573_length_740_cov_34.185647	412	492	3	8	80	0.1000000
NODE_14573_length_740_cov_34.185647	412	492	4	6	80	0.0750000
NODE_14573_length_740_cov_34.185647	412	492	5	5	80	0.0625000
NODE_14573_length_740_cov_34.185647	412	492	6	16	80	0.2000000
NODE_14573_length_740_cov_34.185647	412	492	8	1	80	0.0125000
NODE_14573_length_740_cov_34.185647	412	492	9	4	80	0.0500000
NODE_14573_length_740_cov_34.185647	412	492	10	3	80	0.0375000
NODE_14573_length_740_cov_34.185647	412	492	11	8	80	0.1000000
NODE_14573_length_740_cov_34.185647	412	492	12	1	80	0.0125000
NODE_14573_length_740_cov_34.185647	412	492	13	28	80	0.3500000
NODE_14574_length_740_cov_24.794072	286	366	6	31	80	0.3875000
NODE_14574_length_740_cov_24.794072	286	366	7	18	80	0.2250000
NODE_14574_length_740_cov_24.794072	286	366	8	4	80	0.0500000
NODE_14574_length_740_cov_24.794072	286	366	9	18	80	0.2250000
NODE_14574_length_740_cov_24.794072	286	366	10	9	80	0.1125000
NODE_14574_length_740_cov_24.794072	339	419	2	1	80	0.0125000
NODE_14574_length_740_cov_24.794072	339	419	4	3	80	0.0375000
NODE_14574_length_740_cov_24.794072	339	419	5	3	80	0.0375000
NODE_14574_length_740_cov_24.794072	339	419	6	73	80	0.9125000
NODE_14575_length_740_cov_20.361934	316	396	1	22	80	0.2750000
NODE_14575_length_740_cov_20.361934	316	396	2	17	80	0.2125000
NODE_14575_length_740_cov_20.361934	316	396	3	41	80	0.5125000
NODE_14575_length_740_cov_20.361934	369	449	2	70	80	0.8750000
NODE_14575_length_740_cov_20.361934	369	449	3	10	80	0.1250000
NODE_14576_length_740_cov_18.982839	266	348	3	79	82	0.9634146
NODE_14576_length_740_cov_18.982839	266	348	4	3	82	0.0365854
NODE_14576_length_740_cov_18.982839	321	401	0	11	80	0.1375000
NODE_14576_length_740_cov_18.982839	321	401	1	27	80	0.3375000
NODE_14576_length_740_cov_18.982839	321	401	2	14	80	0.1750000
NODE_14576_length_740_cov_18.982839	321	401	3	28	80	0.3500000
NODE_14577_length_740_cov_16.755070	354	434	6	40	80	0.5000000
NODE_14577_length_740_cov_16.755070	354	434	7	12	80	0.1500000
NODE_14577_length_740_cov_16.755070	354	434	9	10	80	0.1250000
NODE_14577_length_740_cov_16.755070	354	434	10	18	80	0.2250000
NODE_14577_length_740_cov_16.755070	407	487	7	12	80	0.1500000
NODE_14577_length_740_cov_16.755070	407	487	8	23	80	0.2875000
NODE_14577_length_740_cov_16.755070	407	487	9	10	80	0.1250000
NODE_14577_length_740_cov_16.755070	407	487	10	19	80	0.2375000
NODE_14577_length_740_cov_16.755070	407	487	11	16	80	0.2000000
NODE_14579_length_740_cov_7.585023	206	286	8	16	80	0.2000000
NODE_14579_length_740_cov_7.585023	206	286	9	45	80	0.5625000
NODE_14579_length_740_cov_7.585023	206	286	11	19	80	0.2375000
NODE_14579_length_740_cov_7.585023	259	339	5	20	80	0.2500000
NODE_14579_length_740_cov_7.585023	259	339	6	4	80	0.0500000
NODE_14579_length_740_cov_7.585023	259	339	8	21	80	0.2625000
NODE_14579_length_740_cov_7.585023	259	339	9	33	80	0.4125000
NODE_14579_length_740_cov_7.585023	259	339	11	2	80	0.0250000
NODE_14580_length_740_cov_7.174727	165	245	0	80	80	1.0000000
NODE_14580_length_740_cov_7.174727	218	298	0	80	80	1.0000000
NODE_14614_length_739_cov_52.970312	346	426	52	1	80	0.0125000
NODE_14614_length_739_cov_52.970312	346	426	53	11	80	0.1375000
NODE_14614_length_739_cov_52.970312	346	426	56	3	80	0.0375000
NODE_14614_length_739_cov_52.970312	346	426	57	2	80	0.0250000
NODE_14614_length_739_cov_52.970312	346	426	58	4	80	0.0500000
NODE_14614_length_739_cov_52.970312	346	426	59	7	80	0.0875000
NODE_14614_length_739_cov_52.970312	346	426	60	21	80	0.2625000
NODE_14614_length_739_cov_52.970312	346	426	61	5	80	0.0625000
NODE_14614_length_739_cov_52.970312	346	426	62	1	80	0.0125000
NODE_14614_length_739_cov_52.970312	346	426	63	2	80	0.0250000
NODE_14614_length_739_cov_52.970312	346	426	64	1	80	0.0125000
NODE_14614_length_739_cov_52.970312	346	426	65	4	80	0.0500000
NODE_14614_length_739_cov_52.970312	346	426	66	1	80	0.0125000
NODE_14614_length_739_cov_52.970312	346	426	67	1	80	0.0125000
NODE_14614_length_739_cov_52.970312	346	426	68	9	80	0.1125000
NODE_14614_length_739_cov_52.970312	346	426	69	1	80	0.0125000
NODE_14614_length_739_cov_52.970312	346	426	70	3	80	0.0375000
NODE_14614_length_739_cov_52.970312	346	426	71	3	80	0.0375000
NODE_14614_length_739_cov_52.970312	399	479	46	3	80	0.0375000
NODE_14614_length_739_cov_52.970312	399	479	47	4	80	0.0500000
NODE_14614_length_739_cov_52.970312	399	479	48	6	80	0.0750000
NODE_14614_length_739_cov_52.970312	399	479	49	13	80	0.1625000
NODE_14614_length_739_cov_52.970312	399	479	50	7	80	0.0875000
NODE_14614_length_739_cov_52.970312	399	479	51	1	80	0.0125000
NODE_14614_length_739_cov_52.970312	399	479	52	1	80	0.0125000
NODE_14614_length_739_cov_52.970312	399	479	55	3	80	0.0375000
NODE_14614_length_739_cov_52.970312	399	479	56	7	80	0.0875000
NODE_14614_length_739_cov_52.970312	399	479	58	1	80	0.0125000
NODE_14614_length_739_cov_52.970312	399	479	59	5	80	0.0625000
NODE_14614_length_739_cov_52.970312	399	479	61	5	80	0.0625000
NODE_14614_length_739_cov_52.970312	399	479	63	1	80	0.0125000
NODE_14614_length_739_cov_52.970312	399	479	64	1	80	0.0125000
NODE_14614_length_739_cov_52.970312	399	479	65	4	80	0.0500000
NODE_14614_length_739_cov_52.970312	399	479	66	1	80	0.0125000
NODE_14614_length_739_cov_52.970312	399	479	67	1	80	0.0125000
NODE_14614_length_739_cov_52.970312	399	479	68	9	80	0.1125000
NODE_14614_length_739_cov_52.970312	399	479	69	1	80	0.0125000
NODE_14614_length_739_cov_52.970312	399	479	70	3	80	0.0375000
NODE_14614_length_739_cov_52.970312	399	479	71	3	80	0.0375000
NODE_14615_length_739_cov_31.175000	204	284	3	10	80	0.1250000
NODE_14615_length_739_cov_31.175000	204	284	12	36	80	0.4500000
NODE_14615_length_739_cov_31.175000	204	284	13	2	80	0.0250000
NODE_14615_length_739_cov_31.175000	204	284	14	32	80	0.4000000
NODE_14615_length_739_cov_31.175000	257	337	2	12	80	0.1500000
NODE_14615_length_739_cov_31.175000	257	337	5	10	80	0.1250000
NODE_14615_length_739_cov_31.175000	257	337	14	58	80	0.7250000
NODE_14616_length_739_cov_25.482813	487	567	10	15	80	0.1875000
NODE_14616_length_739_cov_25.482813	487	567	12	3	80	0.0375000
NODE_14616_length_739_cov_25.482813	487	567	13	1	80	0.0125000
NODE_14616_length_739_cov_25.482813	487	567	14	34	80	0.4250000
NODE_14616_length_739_cov_25.482813	487	567	16	27	80	0.3375000
NODE_14616_length_739_cov_25.482813	540	620	10	14	80	0.1750000
NODE_14616_length_739_cov_25.482813	540	620	12	26	80	0.3250000
NODE_14616_length_739_cov_25.482813	540	620	14	9	80	0.1125000
NODE_14616_length_739_cov_25.482813	540	620	16	31	80	0.3875000
NODE_14617_length_739_cov_24.871875	191	271	8	6	80	0.0750000
NODE_14617_length_739_cov_24.871875	191	271	9	34	80	0.4250000
NODE_14617_length_739_cov_24.871875	191	271	13	8	80	0.1000000
NODE_14617_length_739_cov_24.871875	191	271	14	32	80	0.4000000
NODE_14617_length_739_cov_24.871875	244	324	3	3	80	0.0375000
NODE_14617_length_739_cov_24.871875	244	324	5	4	80	0.0500000
NODE_14617_length_739_cov_24.871875	244	324	7	32	80	0.4000000
NODE_14617_length_739_cov_24.871875	244	324	8	20	80	0.2500000
NODE_14617_length_739_cov_24.871875	244	324	9	21	80	0.2625000
NODE_14618_length_739_cov_18.360937	146	226	4	38	80	0.4750000
NODE_14618_length_739_cov_18.360937	146	226	5	42	80	0.5250000
NODE_14618_length_739_cov_18.360937	199	279	4	9	80	0.1125000
NODE_14618_length_739_cov_18.360937	199	279	5	63	80	0.7875000
NODE_14618_length_739_cov_18.360937	199	279	7	2	80	0.0250000
NODE_14618_length_739_cov_18.360937	199	279	8	6	80	0.0750000
NODE_14619_length_739_cov_13.195312	273	353	7	3	80	0.0375000
NODE_14619_length_739_cov_13.195312	273	353	8	26	80	0.3250000
NODE_14619_length_739_cov_13.195312	273	353	9	1	80	0.0125000
NODE_14619_length_739_cov_13.195312	273	353	10	12	80	0.1500000
NODE_14619_length_739_cov_13.195312	273	353	12	28	80	0.3500000
NODE_14619_length_739_cov_13.195312	273	353	13	10	80	0.1250000
NODE_14619_length_739_cov_13.195312	326	406	5	12	80	0.1500000
NODE_14619_length_739_cov_13.195312	326	406	6	16	80	0.2000000
NODE_14619_length_739_cov_13.195312	326	406	7	3	80	0.0375000
NODE_14619_length_739_cov_13.195312	326	406	8	41	80	0.5125000
NODE_14619_length_739_cov_13.195312	326	406	9	8	80	0.1000000
NODE_14620_length_739_cov_10.314063	231	311	0	80	80	1.0000000
NODE_14620_length_739_cov_10.314063	284	364	0	80	80	1.0000000
NODE_14622_length_739_cov_8.523438	468	548	1	13	80	0.1625000
NODE_14622_length_739_cov_8.523438	468	548	2	67	80	0.8375000
NODE_14622_length_739_cov_8.523438	521	600	2	79	79	1.0000000
NODE_14623_length_739_cov_7.398438	342	422	7	7	80	0.0875000
NODE_14623_length_739_cov_7.398438	342	422	8	73	80	0.9125000
NODE_14623_length_739_cov_7.398438	395	475	1	19	80	0.2375000
NODE_14623_length_739_cov_7.398438	395	475	2	3	80	0.0375000
NODE_14623_length_739_cov_7.398438	395	475	4	2	80	0.0250000
NODE_14623_length_739_cov_7.398438	395	475	5	26	80	0.3250000
NODE_14623_length_739_cov_7.398438	395	475	7	10	80	0.1250000
NODE_14623_length_739_cov_7.398438	395	475	8	20	80	0.2500000
NODE_14625_length_739_cov_5.826562	252	332	3	12	80	0.1500000
NODE_14625_length_739_cov_5.826562	252	332	4	68	80	0.8500000
NODE_14625_length_739_cov_5.826562	305	385	2	26	80	0.3250000
NODE_14625_length_739_cov_5.826562	305	385	3	22	80	0.2750000
NODE_14625_length_739_cov_5.826562	305	385	4	32	80	0.4000000
NODE_14634_length_739_cov_3.232813	355	435	2	52	80	0.6500000
NODE_14634_length_739_cov_3.232813	355	435	3	19	80	0.2375000
NODE_14634_length_739_cov_3.232813	355	435	4	9	80	0.1125000
NODE_14634_length_739_cov_3.232813	408	488	1	6	80	0.0750000
NODE_14634_length_739_cov_3.232813	408	488	2	74	80	0.9250000
NODE_14679_length_738_cov_35.278560	274	318	17	22	44	0.5000000
NODE_14679_length_738_cov_35.278560	274	318	18	17	44	0.3863636
NODE_14679_length_738_cov_35.278560	274	318	20	5	44	0.1136364
NODE_14680_length_738_cov_21.672926	208	288	13	4	80	0.0500000
NODE_14680_length_738_cov_21.672926	208	288	15	3	80	0.0375000
NODE_14680_length_738_cov_21.672926	208	288	18	3	80	0.0375000
NODE_14680_length_738_cov_21.672926	208	288	19	3	80	0.0375000
NODE_14680_length_738_cov_21.672926	208	288	20	14	80	0.1750000
NODE_14680_length_738_cov_21.672926	208	288	21	9	80	0.1125000
NODE_14680_length_738_cov_21.672926	208	288	22	2	80	0.0250000
NODE_14680_length_738_cov_21.672926	208	288	24	15	80	0.1875000
NODE_14680_length_738_cov_21.672926	208	288	26	10	80	0.1250000
NODE_14680_length_738_cov_21.672926	208	288	27	14	80	0.1750000
NODE_14680_length_738_cov_21.672926	208	288	28	3	80	0.0375000
NODE_14680_length_738_cov_21.672926	261	341	26	10	80	0.1250000
NODE_14680_length_738_cov_21.672926	261	341	27	18	80	0.2250000
NODE_14680_length_738_cov_21.672926	261	341	28	8	80	0.1000000
NODE_14680_length_738_cov_21.672926	261	341	29	8	80	0.1000000
NODE_14680_length_738_cov_21.672926	261	341	30	1	80	0.0125000
NODE_14680_length_738_cov_21.672926	261	341	31	14	80	0.1750000
NODE_14680_length_738_cov_21.672926	261	341	32	13	80	0.1625000
NODE_14680_length_738_cov_21.672926	261	341	33	8	80	0.1000000
NODE_14681_length_738_cov_15.665102	302	382	0	80	80	1.0000000
NODE_14681_length_738_cov_15.665102	355	435	0	80	80	1.0000000
NODE_14682_length_738_cov_15.661972	338	418	1	71	80	0.8875000
NODE_14682_length_738_cov_15.661972	338	418	2	9	80	0.1125000
NODE_14682_length_738_cov_15.661972	391	471	1	42	80	0.5250000
NODE_14682_length_738_cov_15.661972	391	471	2	13	80	0.1625000
NODE_14682_length_738_cov_15.661972	391	471	3	25	80	0.3125000
NODE_14683_length_738_cov_12.594679	49	129	0	80	80	1.0000000
NODE_14683_length_738_cov_12.594679	102	182	0	80	80	1.0000000
NODE_14683_length_738_cov_12.594679	178	258	0	80	80	1.0000000
NODE_14683_length_738_cov_12.594679	231	311	0	80	80	1.0000000
NODE_14691_length_738_cov_4.056338	254	326	0	72	72	1.0000000
NODE_14691_length_738_cov_4.056338	437	528	0	91	91	1.0000000
NODE_14724_length_737_cov_22.363636	303	383	5	21	80	0.2625000
NODE_14724_length_737_cov_22.363636	303	383	6	59	80	0.7375000
NODE_14724_length_737_cov_22.363636	356	436	5	4	80	0.0500000
NODE_14724_length_737_cov_22.363636	356	436	6	33	80	0.4125000
NODE_14724_length_737_cov_22.363636	356	436	7	5	80	0.0625000
NODE_14724_length_737_cov_22.363636	356	436	8	38	80	0.4750000
NODE_14725_length_737_cov_21.318182	208	288	5	9	80	0.1125000
NODE_14725_length_737_cov_21.318182	208	288	6	16	80	0.2000000
NODE_14725_length_737_cov_21.318182	208	288	7	40	80	0.5000000
NODE_14725_length_737_cov_21.318182	208	288	8	15	80	0.1875000
NODE_14725_length_737_cov_21.318182	261	341	2	36	80	0.4500000
NODE_14725_length_737_cov_21.318182	261	341	4	6	80	0.0750000
NODE_14725_length_737_cov_21.318182	261	341	5	20	80	0.2500000
NODE_14725_length_737_cov_21.318182	261	341	6	16	80	0.2000000
NODE_14725_length_737_cov_21.318182	261	341	7	2	80	0.0250000
NODE_14726_length_737_cov_17.161442	346	426	0	15	80	0.1875000
NODE_14726_length_737_cov_17.161442	346	426	1	2	80	0.0250000
NODE_14726_length_737_cov_17.161442	346	426	2	6	80	0.0750000
NODE_14726_length_737_cov_17.161442	346	426	3	12	80	0.1500000
NODE_14726_length_737_cov_17.161442	346	426	4	26	80	0.3250000
NODE_14726_length_737_cov_17.161442	346	426	5	15	80	0.1875000
NODE_14726_length_737_cov_17.161442	346	426	6	4	80	0.0500000
NODE_14726_length_737_cov_17.161442	399	479	4	8	80	0.1000000
NODE_14726_length_737_cov_17.161442	399	479	5	15	80	0.1875000
NODE_14726_length_737_cov_17.161442	399	479	6	57	80	0.7125000
NODE_14727_length_737_cov_11.835423	211	291	0	26	80	0.3250000
NODE_14727_length_737_cov_11.835423	211	291	2	54	80	0.6750000
NODE_14727_length_737_cov_11.835423	264	344	2	76	80	0.9500000
NODE_14727_length_737_cov_11.835423	264	344	4	4	80	0.0500000
NODE_14729_length_737_cov_6.782132	488	548	0	60	60	1.0000000
NODE_14732_length_737_cov_6.089342	241	321	1	11	80	0.1375000
NODE_14732_length_737_cov_6.089342	241	321	2	25	80	0.3125000
NODE_14732_length_737_cov_6.089342	241	321	3	44	80	0.5500000
NODE_14732_length_737_cov_6.089342	294	374	1	2	80	0.0250000
NODE_14732_length_737_cov_6.089342	294	374	2	78	80	0.9750000
NODE_14747_length_737_cov_2.548589	386	416	0	30	30	1.0000000
NODE_14781_length_736_cov_46.601256	226	306	2	6	80	0.0750000
NODE_14781_length_736_cov_46.601256	226	306	4	28	80	0.3500000
NODE_14781_length_736_cov_46.601256	226	306	6	46	80	0.5750000
NODE_14781_length_736_cov_46.601256	279	359	2	44	80	0.5500000
NODE_14781_length_736_cov_46.601256	279	359	4	36	80	0.4500000
NODE_14782_length_736_cov_32.442700	215	295	5	1	80	0.0125000
NODE_14782_length_736_cov_32.442700	215	295	9	33	80	0.4125000
NODE_14782_length_736_cov_32.442700	215	295	10	22	80	0.2750000
NODE_14782_length_736_cov_32.442700	215	295	13	1	80	0.0125000
NODE_14782_length_736_cov_32.442700	215	295	14	10	80	0.1250000
NODE_14782_length_736_cov_32.442700	215	295	18	13	80	0.1625000
NODE_14782_length_736_cov_32.442700	268	350	9	1	82	0.0121951
NODE_14782_length_736_cov_32.442700	268	350	10	2	82	0.0243902
NODE_14782_length_736_cov_32.442700	268	350	13	1	82	0.0121951
NODE_14782_length_736_cov_32.442700	268	350	14	19	82	0.2317073
NODE_14782_length_736_cov_32.442700	268	350	18	59	82	0.7195122
NODE_14783_length_736_cov_26.364207	220	300	17	4	80	0.0500000
NODE_14783_length_736_cov_26.364207	220	300	18	40	80	0.5000000
NODE_14783_length_736_cov_26.364207	220	300	19	30	80	0.3750000
NODE_14783_length_736_cov_26.364207	220	300	20	2	80	0.0250000
NODE_14783_length_736_cov_26.364207	220	300	21	1	80	0.0125000
NODE_14783_length_736_cov_26.364207	220	300	22	3	80	0.0375000
NODE_14783_length_736_cov_26.364207	273	353	13	13	80	0.1625000
NODE_14783_length_736_cov_26.364207	273	353	14	6	80	0.0750000
NODE_14783_length_736_cov_26.364207	273	353	16	8	80	0.1000000
NODE_14783_length_736_cov_26.364207	273	353	17	11	80	0.1375000
NODE_14783_length_736_cov_26.364207	273	353	18	21	80	0.2625000
NODE_14783_length_736_cov_26.364207	273	353	20	2	80	0.0250000
NODE_14783_length_736_cov_26.364207	273	353	21	1	80	0.0125000
NODE_14783_length_736_cov_26.364207	273	353	22	18	80	0.2250000
NODE_14785_length_736_cov_10.317111	313	393	0	10	80	0.1250000
NODE_14785_length_736_cov_10.317111	313	393	4	14	80	0.1750000
NODE_14785_length_736_cov_10.317111	313	393	5	39	80	0.4875000
NODE_14785_length_736_cov_10.317111	313	393	6	17	80	0.2125000
NODE_14785_length_736_cov_10.317111	366	446	5	10	80	0.1250000
NODE_14785_length_736_cov_10.317111	366	446	6	31	80	0.3875000
NODE_14785_length_736_cov_10.317111	366	446	9	1	80	0.0125000
NODE_14785_length_736_cov_10.317111	366	446	10	32	80	0.4000000
NODE_14785_length_736_cov_10.317111	366	446	11	6	80	0.0750000
NODE_14786_length_736_cov_9.188383	292	372	2	52	80	0.6500000
NODE_14786_length_736_cov_9.188383	292	372	3	5	80	0.0625000
NODE_14786_length_736_cov_9.188383	292	372	4	1	80	0.0125000
NODE_14786_length_736_cov_9.188383	292	372	12	11	80	0.1375000
NODE_14786_length_736_cov_9.188383	292	372	13	11	80	0.1375000
NODE_14786_length_736_cov_9.188383	345	425	2	21	80	0.2625000
NODE_14786_length_736_cov_9.188383	345	425	3	23	80	0.2875000
NODE_14786_length_736_cov_9.188383	345	425	4	36	80	0.4500000
NODE_14787_length_736_cov_8.149137	315	391	0	45	76	0.5921053
NODE_14787_length_736_cov_8.149137	315	391	2	31	76	0.4078947
NODE_14787_length_736_cov_8.149137	365	445	2	80	80	1.0000000
NODE_14788_length_736_cov_8.103611	295	375	2	33	80	0.4125000
NODE_14788_length_736_cov_8.103611	295	375	4	47	80	0.5875000
NODE_14788_length_736_cov_8.103611	348	428	3	38	80	0.4750000
NODE_14788_length_736_cov_8.103611	348	428	4	42	80	0.5250000
NODE_14789_length_736_cov_7.513344	239	319	0	80	80	1.0000000
NODE_14789_length_736_cov_7.513344	292	372	0	80	80	1.0000000
NODE_14792_length_736_cov_5.967033	253	333	0	80	80	1.0000000
NODE_14792_length_736_cov_5.967033	306	386	0	80	80	1.0000000
NODE_14795_length_736_cov_4.908948	258	338	3	52	80	0.6500000
NODE_14795_length_736_cov_4.908948	258	338	6	28	80	0.3500000
NODE_14795_length_736_cov_4.908948	311	391	3	16	80	0.2000000
NODE_14795_length_736_cov_4.908948	311	391	6	64	80	0.8000000
NODE_14825_length_735_cov_21.099057	265	345	8	6	80	0.0750000
NODE_14825_length_735_cov_21.099057	265	345	9	3	80	0.0375000
NODE_14825_length_735_cov_21.099057	265	345	11	10	80	0.1250000
NODE_14825_length_735_cov_21.099057	265	345	12	8	80	0.1000000
NODE_14825_length_735_cov_21.099057	265	345	13	53	80	0.6625000
NODE_14825_length_735_cov_21.099057	318	398	9	4	80	0.0500000
NODE_14825_length_735_cov_21.099057	318	398	10	47	80	0.5875000
NODE_14825_length_735_cov_21.099057	318	398	11	1	80	0.0125000
NODE_14825_length_735_cov_21.099057	318	398	12	4	80	0.0500000
NODE_14825_length_735_cov_21.099057	318	398	13	24	80	0.3000000
NODE_14826_length_735_cov_16.696541	190	270	2	51	80	0.6375000
NODE_14826_length_735_cov_16.696541	190	270	3	29	80	0.3625000
NODE_14826_length_735_cov_16.696541	243	323	1	9	80	0.1125000
NODE_14826_length_735_cov_16.696541	243	323	2	71	80	0.8875000
NODE_14826_length_735_cov_16.696541	479	538	0	59	59	1.0000000
NODE_14827_length_735_cov_13.143082	231	311	5	24	80	0.3000000
NODE_14827_length_735_cov_13.143082	231	311	6	1	80	0.0125000
NODE_14827_length_735_cov_13.143082	231	311	7	7	80	0.0875000
NODE_14827_length_735_cov_13.143082	231	311	8	7	80	0.0875000
NODE_14827_length_735_cov_13.143082	231	311	9	12	80	0.1500000
NODE_14827_length_735_cov_13.143082	231	311	10	9	80	0.1125000
NODE_14827_length_735_cov_13.143082	231	311	11	17	80	0.2125000
NODE_14827_length_735_cov_13.143082	231	311	12	3	80	0.0375000
NODE_14827_length_735_cov_13.143082	284	364	10	9	80	0.1125000
NODE_14827_length_735_cov_13.143082	284	364	11	19	80	0.2375000
NODE_14827_length_735_cov_13.143082	284	364	12	28	80	0.3500000
NODE_14827_length_735_cov_13.143082	284	364	13	10	80	0.1250000
NODE_14827_length_735_cov_13.143082	284	364	14	14	80	0.1750000
NODE_14828_length_735_cov_12.415094	434	514	0	5	80	0.0625000
NODE_14828_length_735_cov_12.415094	434	514	1	67	80	0.8375000
NODE_14828_length_735_cov_12.415094	434	514	4	8	80	0.1000000
NODE_14828_length_735_cov_12.415094	487	567	1	19	80	0.2375000
NODE_14828_length_735_cov_12.415094	487	567	4	61	80	0.7625000
NODE_14836_length_735_cov_5.603774	326	394	0	68	68	1.0000000
NODE_14836_length_735_cov_5.603774	367	409	0	42	42	1.0000000
NODE_14880_length_734_cov_26.787402	209	289	1	12	80	0.1500000
NODE_14880_length_734_cov_26.787402	209	289	2	68	80	0.8500000
NODE_14880_length_734_cov_26.787402	262	342	1	25	80	0.3125000
NODE_14880_length_734_cov_26.787402	262	342	2	55	80	0.6875000
NODE_14881_length_734_cov_23.214173	200	280	0	21	80	0.2625000
NODE_14881_length_734_cov_23.214173	200	280	1	59	80	0.7375000
NODE_14881_length_734_cov_23.214173	253	333	0	74	80	0.9250000
NODE_14881_length_734_cov_23.214173	253	333	1	6	80	0.0750000
NODE_14883_length_734_cov_21.645669	245	325	4	80	80	1.0000000
NODE_14883_length_734_cov_21.645669	298	378	2	4	80	0.0500000
NODE_14883_length_734_cov_21.645669	298	378	4	76	80	0.9500000
NODE_14884_length_734_cov_14.393701	249	329	3	80	80	1.0000000
NODE_14884_length_734_cov_14.393701	302	382	0	34	80	0.4250000
NODE_14884_length_734_cov_14.393701	302	382	3	46	80	0.5750000
NODE_14885_length_734_cov_11.324409	133	196	2	36	63	0.5714286
NODE_14885_length_734_cov_11.324409	133	196	4	27	63	0.4285714
NODE_14885_length_734_cov_11.324409	169	229	4	60	60	1.0000000
NODE_14886_length_734_cov_10.872441	302	331	0	29	29	1.0000000
NODE_14890_length_734_cov_6.352756	371	451	0	80	80	1.0000000
NODE_14890_length_734_cov_6.352756	424	504	0	80	80	1.0000000
NODE_14896_length_734_cov_2.705512	231	302	0	71	71	1.0000000
NODE_14934_length_733_cov_35.041009	268	348	5	5	80	0.0625000
NODE_14934_length_733_cov_35.041009	268	348	6	17	80	0.2125000
NODE_14934_length_733_cov_35.041009	268	348	7	19	80	0.2375000
NODE_14934_length_733_cov_35.041009	268	348	8	39	80	0.4875000
NODE_14934_length_733_cov_35.041009	321	402	3	17	81	0.2098765
NODE_14934_length_733_cov_35.041009	321	402	4	17	81	0.2098765
NODE_14934_length_733_cov_35.041009	321	402	5	24	81	0.2962963
NODE_14934_length_733_cov_35.041009	321	402	6	1	81	0.0123457
NODE_14934_length_733_cov_35.041009	321	402	7	13	81	0.1604938
NODE_14934_length_733_cov_35.041009	321	402	8	9	81	0.1111111
NODE_14935_length_733_cov_29.810726	28	108	0	80	80	1.0000000
NODE_14935_length_733_cov_29.810726	81	161	0	80	80	1.0000000
NODE_14935_length_733_cov_29.810726	157	237	0	80	80	1.0000000
NODE_14935_length_733_cov_29.810726	210	290	0	80	80	1.0000000
NODE_14936_length_733_cov_13.738170	333	413	0	80	80	1.0000000
NODE_14936_length_733_cov_13.738170	386	466	0	80	80	1.0000000
NODE_14937_length_733_cov_11.471609	314	389	3	75	75	1.0000000
NODE_14938_length_733_cov_11.321767	245	325	0	80	80	1.0000000
NODE_14938_length_733_cov_11.321767	298	378	0	80	80	1.0000000
NODE_14940_length_733_cov_8.481073	318	395	3	39	77	0.5064935
NODE_14940_length_733_cov_8.481073	318	395	4	38	77	0.4935065
NODE_14940_length_733_cov_8.481073	371	451	1	18	80	0.2250000
NODE_14940_length_733_cov_8.481073	371	451	3	60	80	0.7500000
NODE_14940_length_733_cov_8.481073	371	451	4	2	80	0.0250000
NODE_14944_length_733_cov_5.485804	659	715	0	56	56	1.0000000
NODE_14944_length_733_cov_5.485804	696	733	0	37	37	1.0000000
NODE_14957_length_733_cov_2.272871	312	392	0	80	80	1.0000000
NODE_14957_length_733_cov_2.272871	365	445	0	80	80	1.0000000
NODE_14975_length_732_cov_19.519747	229	309	4	18	80	0.2250000
NODE_14975_length_732_cov_19.519747	229	309	5	62	80	0.7750000
NODE_14975_length_732_cov_19.519747	282	362	1	21	80	0.2625000
NODE_14975_length_732_cov_19.519747	282	362	2	13	80	0.1625000
NODE_14975_length_732_cov_19.519747	282	362	3	1	80	0.0125000
NODE_14975_length_732_cov_19.519747	282	362	4	14	80	0.1750000
NODE_14975_length_732_cov_19.519747	282	362	5	31	80	0.3875000
NODE_14976_length_732_cov_10.846761	247	327	6	31	80	0.3875000
NODE_14976_length_732_cov_10.846761	247	327	11	15	80	0.1875000
NODE_14976_length_732_cov_10.846761	247	327	14	27	80	0.3375000
NODE_14976_length_732_cov_10.846761	247	327	15	7	80	0.0875000
NODE_14976_length_732_cov_10.846761	300	380	11	21	80	0.2625000
NODE_14976_length_732_cov_10.846761	300	380	14	34	80	0.4250000
NODE_14976_length_732_cov_10.846761	300	380	15	20	80	0.2500000
NODE_14976_length_732_cov_10.846761	300	380	16	5	80	0.0625000
NODE_14977_length_732_cov_9.807267	276	356	5	18	80	0.2250000
NODE_14977_length_732_cov_9.807267	276	356	6	57	80	0.7125000
NODE_14977_length_732_cov_9.807267	276	356	8	5	80	0.0625000
NODE_14977_length_732_cov_9.807267	329	409	5	8	80	0.1000000
NODE_14977_length_732_cov_9.807267	329	409	6	15	80	0.1875000
NODE_14977_length_732_cov_9.807267	329	409	7	32	80	0.4000000
NODE_14977_length_732_cov_9.807267	329	409	8	14	80	0.1750000
NODE_14977_length_732_cov_9.807267	329	409	9	11	80	0.1375000
NODE_14978_length_732_cov_8.053712	415	495	4	12	80	0.1500000
NODE_14978_length_732_cov_8.053712	415	495	5	32	80	0.4000000
NODE_14978_length_732_cov_8.053712	415	495	7	2	80	0.0250000
NODE_14978_length_732_cov_8.053712	415	495	8	19	80	0.2375000
NODE_14978_length_732_cov_8.053712	415	495	9	9	80	0.1125000
NODE_14978_length_732_cov_8.053712	415	495	10	3	80	0.0375000
NODE_14978_length_732_cov_8.053712	415	495	11	3	80	0.0375000
NODE_14978_length_732_cov_8.053712	468	548	8	12	80	0.1500000
NODE_14978_length_732_cov_8.053712	468	548	9	51	80	0.6375000
NODE_14978_length_732_cov_8.053712	468	548	10	3	80	0.0375000
NODE_14978_length_732_cov_8.053712	468	548	11	14	80	0.1750000
NODE_14980_length_732_cov_5.194313	319	399	0	10	80	0.1250000
NODE_14980_length_732_cov_5.194313	319	399	1	70	80	0.8750000
NODE_14980_length_732_cov_5.194313	372	452	1	80	80	1.0000000
NODE_14981_length_732_cov_4.998420	293	373	0	80	80	1.0000000
NODE_14981_length_732_cov_4.998420	346	426	0	80	80	1.0000000
NODE_14983_length_732_cov_4.758294	483	524	0	41	41	1.0000000
NODE_15021_length_731_cov_36.123418	464	544	6	6	80	0.0750000
NODE_15021_length_731_cov_36.123418	464	544	9	36	80	0.4500000
NODE_15021_length_731_cov_36.123418	464	544	10	38	80	0.4750000
NODE_15021_length_731_cov_36.123418	517	597	1	7	80	0.0875000
NODE_15021_length_731_cov_36.123418	517	597	2	12	80	0.1500000
NODE_15021_length_731_cov_36.123418	517	597	3	14	80	0.1750000
NODE_15021_length_731_cov_36.123418	517	597	5	11	80	0.1375000
NODE_15021_length_731_cov_36.123418	517	597	6	15	80	0.1875000
NODE_15021_length_731_cov_36.123418	517	597	9	21	80	0.2625000
NODE_15022_length_731_cov_27.721519	294	374	0	1	80	0.0125000
NODE_15022_length_731_cov_27.721519	294	374	1	47	80	0.5875000
NODE_15022_length_731_cov_27.721519	294	374	2	32	80	0.4000000
NODE_15022_length_731_cov_27.721519	347	427	0	54	80	0.6750000
NODE_15022_length_731_cov_27.721519	347	427	1	26	80	0.3250000
NODE_15023_length_731_cov_19.655063	394	474	1	20	80	0.2500000
NODE_15023_length_731_cov_19.655063	394	474	3	60	80	0.7500000
NODE_15023_length_731_cov_19.655063	447	527	3	80	80	1.0000000
NODE_15024_length_731_cov_16.346519	429	509	1	23	80	0.2875000
NODE_15024_length_731_cov_16.346519	429	509	2	26	80	0.3250000
NODE_15024_length_731_cov_16.346519	429	509	4	31	80	0.3875000
NODE_15024_length_731_cov_16.346519	482	562	4	52	80	0.6500000
NODE_15024_length_731_cov_16.346519	482	562	5	28	80	0.3500000
NODE_15025_length_731_cov_13.892405	321	401	6	9	80	0.1125000
NODE_15025_length_731_cov_13.892405	321	401	8	71	80	0.8875000
NODE_15025_length_731_cov_13.892405	374	454	2	21	80	0.2625000
NODE_15025_length_731_cov_13.892405	374	454	6	41	80	0.5125000
NODE_15025_length_731_cov_13.892405	374	454	8	18	80	0.2250000
NODE_15027_length_731_cov_8.800633	218	298	6	23	80	0.2875000
NODE_15027_length_731_cov_8.800633	218	298	8	13	80	0.1625000
NODE_15027_length_731_cov_8.800633	218	298	9	39	80	0.4875000
NODE_15027_length_731_cov_8.800633	218	298	11	5	80	0.0625000
NODE_15027_length_731_cov_8.800633	271	352	9	22	81	0.2716049
NODE_15027_length_731_cov_8.800633	271	352	11	29	81	0.3580247
NODE_15027_length_731_cov_8.800633	271	352	13	30	81	0.3703704
NODE_15028_length_731_cov_7.658228	335	406	1	8	71	0.1126761
NODE_15028_length_731_cov_7.658228	335	406	2	63	71	0.8873239
NODE_15028_length_731_cov_7.658228	387	468	0	44	81	0.5432099
NODE_15028_length_731_cov_7.658228	387	468	1	26	81	0.3209876
NODE_15028_length_731_cov_7.658228	387	468	2	11	81	0.1358025
NODE_15031_length_731_cov_5.471519	261	341	0	80	80	1.0000000
NODE_15031_length_731_cov_5.471519	314	394	0	80	80	1.0000000
NODE_15034_length_731_cov_4.083861	361	441	0	4	80	0.0500000
NODE_15034_length_731_cov_4.083861	361	441	2	76	80	0.9500000
NODE_15034_length_731_cov_4.083861	458	482	0	21	24	0.8750000
NODE_15034_length_731_cov_4.083861	458	482	2	3	24	0.1250000
NODE_15050_length_731_cov_2.226266	466	548	0	68	82	0.8292683
NODE_15050_length_731_cov_2.226266	466	548	1	14	82	0.1707317
NODE_15077_length_730_cov_51.556260	349	429	6	3	80	0.0375000
NODE_15077_length_730_cov_51.556260	349	429	7	8	80	0.1000000
NODE_15077_length_730_cov_51.556260	349	429	8	33	80	0.4125000
NODE_15077_length_730_cov_51.556260	349	429	9	18	80	0.2250000
NODE_15077_length_730_cov_51.556260	349	429	10	18	80	0.2250000
NODE_15077_length_730_cov_51.556260	402	482	3	5	80	0.0625000
NODE_15077_length_730_cov_51.556260	402	482	4	28	80	0.3500000
NODE_15077_length_730_cov_51.556260	402	482	5	20	80	0.2500000
NODE_15077_length_730_cov_51.556260	402	482	6	3	80	0.0375000
NODE_15077_length_730_cov_51.556260	402	482	7	8	80	0.1000000
NODE_15077_length_730_cov_51.556260	402	482	8	16	80	0.2000000
NODE_15078_length_730_cov_39.862124	370	450	4	4	80	0.0500000
NODE_15078_length_730_cov_39.862124	370	450	5	76	80	0.9500000
NODE_15078_length_730_cov_39.862124	423	503	3	21	80	0.2625000
NODE_15078_length_730_cov_39.862124	423	503	4	34	80	0.4250000
NODE_15078_length_730_cov_39.862124	423	503	5	25	80	0.3125000
NODE_15079_length_730_cov_15.801902	261	341	6	72	80	0.9000000
NODE_15079_length_730_cov_15.801902	261	341	7	8	80	0.1000000
NODE_15079_length_730_cov_15.801902	314	394	4	1	80	0.0125000
NODE_15079_length_730_cov_15.801902	314	394	5	41	80	0.5125000
NODE_15079_length_730_cov_15.801902	314	394	6	34	80	0.4250000
NODE_15079_length_730_cov_15.801902	314	394	7	4	80	0.0500000
NODE_15080_length_730_cov_11.746434	242	322	2	4	80	0.0500000
NODE_15080_length_730_cov_11.746434	242	322	4	57	80	0.7125000
NODE_15080_length_730_cov_11.746434	242	322	5	19	80	0.2375000
NODE_15080_length_730_cov_11.746434	295	375	3	2	80	0.0250000
NODE_15080_length_730_cov_11.746434	295	375	4	8	80	0.1000000
NODE_15080_length_730_cov_11.746434	295	375	5	70	80	0.8750000
NODE_15081_length_730_cov_9.209192	358	438	1	41	80	0.5125000
NODE_15081_length_730_cov_9.209192	358	438	2	19	80	0.2375000
NODE_15081_length_730_cov_9.209192	358	438	5	20	80	0.2500000
NODE_15081_length_730_cov_9.209192	411	483	0	5	72	0.0694444
NODE_15081_length_730_cov_9.209192	411	483	1	67	72	0.9305556
NODE_15131_length_729_cov_44.188889	418	498	5	18	80	0.2250000
NODE_15131_length_729_cov_44.188889	418	498	6	23	80	0.2875000
NODE_15131_length_729_cov_44.188889	418	498	7	26	80	0.3250000
NODE_15131_length_729_cov_44.188889	418	498	8	13	80	0.1625000
NODE_15131_length_729_cov_44.188889	471	551	3	12	80	0.1500000
NODE_15131_length_729_cov_44.188889	471	551	4	23	80	0.2875000
NODE_15131_length_729_cov_44.188889	471	551	5	30	80	0.3750000
NODE_15131_length_729_cov_44.188889	471	551	6	15	80	0.1875000
NODE_15132_length_729_cov_40.390476	330	410	3	17	80	0.2125000
NODE_15132_length_729_cov_40.390476	330	410	4	46	80	0.5750000
NODE_15132_length_729_cov_40.390476	330	410	5	17	80	0.2125000
NODE_15132_length_729_cov_40.390476	383	463	3	22	80	0.2750000
NODE_15132_length_729_cov_40.390476	383	463	4	4	80	0.0500000
NODE_15132_length_729_cov_40.390476	383	463	5	20	80	0.2500000
NODE_15132_length_729_cov_40.390476	383	463	6	28	80	0.3500000
NODE_15132_length_729_cov_40.390476	383	463	7	6	80	0.0750000
NODE_15133_length_729_cov_35.973016	231	311	21	7	80	0.0875000
NODE_15133_length_729_cov_35.973016	231	311	22	2	80	0.0250000
NODE_15133_length_729_cov_35.973016	231	311	24	24	80	0.3000000
NODE_15133_length_729_cov_35.973016	231	311	25	6	80	0.0750000
NODE_15133_length_729_cov_35.973016	231	311	26	33	80	0.4125000
NODE_15133_length_729_cov_35.973016	231	311	27	8	80	0.1000000
NODE_15133_length_729_cov_35.973016	284	363	13	7	79	0.0886076
NODE_15133_length_729_cov_35.973016	284	363	14	2	79	0.0253165
NODE_15133_length_729_cov_35.973016	284	363	17	2	79	0.0253165
NODE_15133_length_729_cov_35.973016	284	363	18	3	79	0.0379747
NODE_15133_length_729_cov_35.973016	284	363	19	7	79	0.0886076
NODE_15133_length_729_cov_35.973016	284	363	20	8	79	0.1012658
NODE_15133_length_729_cov_35.973016	284	363	21	13	79	0.1645570
NODE_15133_length_729_cov_35.973016	284	363	22	3	79	0.0379747
NODE_15133_length_729_cov_35.973016	284	363	24	11	79	0.1392405
NODE_15133_length_729_cov_35.973016	284	363	25	22	79	0.2784810
NODE_15133_length_729_cov_35.973016	284	363	26	1	79	0.0126582
NODE_15134_length_729_cov_18.357143	170	250	5	14	80	0.1750000
NODE_15134_length_729_cov_18.357143	170	250	7	14	80	0.1750000
NODE_15134_length_729_cov_18.357143	170	250	8	52	80	0.6500000
NODE_15134_length_729_cov_18.357143	223	303	5	6	80	0.0750000
NODE_15134_length_729_cov_18.357143	223	303	8	51	80	0.6375000
NODE_15134_length_729_cov_18.357143	223	303	9	23	80	0.2875000
NODE_15135_length_729_cov_17.928571	194	274	4	8	80	0.1000000
NODE_15135_length_729_cov_17.928571	194	274	6	22	80	0.2750000
NODE_15135_length_729_cov_17.928571	194	274	7	50	80	0.6250000
NODE_15135_length_729_cov_17.928571	247	327	4	5	80	0.0625000
NODE_15135_length_729_cov_17.928571	247	327	5	9	80	0.1125000
NODE_15135_length_729_cov_17.928571	247	327	6	8	80	0.1000000
NODE_15135_length_729_cov_17.928571	247	327	7	48	80	0.6000000
NODE_15135_length_729_cov_17.928571	247	327	8	10	80	0.1250000
NODE_15136_length_729_cov_17.373016	369	449	8	21	80	0.2625000
NODE_15136_length_729_cov_17.373016	369	449	11	16	80	0.2000000
NODE_15136_length_729_cov_17.373016	369	449	12	37	80	0.4625000
NODE_15136_length_729_cov_17.373016	369	449	13	4	80	0.0500000
NODE_15136_length_729_cov_17.373016	369	449	14	2	80	0.0250000
NODE_15136_length_729_cov_17.373016	422	502	9	2	80	0.0250000
NODE_15136_length_729_cov_17.373016	422	502	10	15	80	0.1875000
NODE_15136_length_729_cov_17.373016	422	502	11	42	80	0.5250000
NODE_15136_length_729_cov_17.373016	422	502	12	21	80	0.2625000
NODE_15137_length_729_cov_12.452381	347	427	11	5	80	0.0625000
NODE_15137_length_729_cov_12.452381	347	427	12	27	80	0.3375000
NODE_15137_length_729_cov_12.452381	347	427	13	3	80	0.0375000
NODE_15137_length_729_cov_12.452381	347	427	14	11	80	0.1375000
NODE_15137_length_729_cov_12.452381	347	427	15	34	80	0.4250000
NODE_15137_length_729_cov_12.452381	400	480	7	8	80	0.1000000
NODE_15137_length_729_cov_12.452381	400	480	9	10	80	0.1250000
NODE_15137_length_729_cov_12.452381	400	480	10	21	80	0.2625000
NODE_15137_length_729_cov_12.452381	400	480	12	25	80	0.3125000
NODE_15137_length_729_cov_12.452381	400	480	14	10	80	0.1250000
NODE_15137_length_729_cov_12.452381	400	480	15	6	80	0.0750000
NODE_15138_length_729_cov_10.388889	296	376	5	55	80	0.6875000
NODE_15138_length_729_cov_10.388889	296	376	8	25	80	0.3125000
NODE_15138_length_729_cov_10.388889	349	429	5	2	80	0.0250000
NODE_15138_length_729_cov_10.388889	349	429	8	51	80	0.6375000
NODE_15138_length_729_cov_10.388889	349	429	9	18	80	0.2250000
NODE_15138_length_729_cov_10.388889	349	429	10	9	80	0.1125000
NODE_15185_length_728_cov_23.503975	338	418	0	41	80	0.5125000
NODE_15185_length_728_cov_23.503975	338	418	2	39	80	0.4875000
NODE_15185_length_728_cov_23.503975	391	471	2	80	80	1.0000000
NODE_15186_length_728_cov_22.496025	310	390	4	2	80	0.0250000
NODE_15186_length_728_cov_22.496025	310	390	5	74	80	0.9250000
NODE_15186_length_728_cov_22.496025	310	390	7	4	80	0.0500000
NODE_15186_length_728_cov_22.496025	363	443	3	27	80	0.3375000
NODE_15186_length_728_cov_22.496025	363	443	4	3	80	0.0375000
NODE_15186_length_728_cov_22.496025	363	443	5	31	80	0.3875000
NODE_15186_length_728_cov_22.496025	363	443	7	19	80	0.2375000
NODE_15187_length_728_cov_16.596184	257	337	2	17	80	0.2125000
NODE_15187_length_728_cov_16.596184	257	337	4	49	80	0.6125000
NODE_15187_length_728_cov_16.596184	257	337	5	14	80	0.1750000
NODE_15187_length_728_cov_16.596184	310	387	4	13	77	0.1688312
NODE_15187_length_728_cov_16.596184	310	387	5	64	77	0.8311688
NODE_15188_length_728_cov_16.114467	192	272	0	30	80	0.3750000
NODE_15188_length_728_cov_16.114467	192	272	4	50	80	0.6250000
NODE_15188_length_728_cov_16.114467	245	325	0	72	80	0.9000000
NODE_15188_length_728_cov_16.114467	245	325	4	8	80	0.1000000
NODE_15189_length_728_cov_15.128776	298	377	1	2	79	0.0253165
NODE_15189_length_728_cov_15.128776	298	377	2	56	79	0.7088608
NODE_15189_length_728_cov_15.128776	298	377	3	21	79	0.2658228
NODE_15189_length_728_cov_15.128776	350	430	1	55	80	0.6875000
NODE_15189_length_728_cov_15.128776	350	430	2	25	80	0.3125000
NODE_15190_length_728_cov_10.613672	269	349	1	4	80	0.0500000
NODE_15190_length_728_cov_10.613672	269	349	2	6	80	0.0750000
NODE_15190_length_728_cov_10.613672	269	349	3	19	80	0.2375000
NODE_15190_length_728_cov_10.613672	269	349	4	45	80	0.5625000
NODE_15190_length_728_cov_10.613672	269	349	6	1	80	0.0125000
NODE_15190_length_728_cov_10.613672	269	349	7	5	80	0.0625000
NODE_15190_length_728_cov_10.613672	322	402	4	21	80	0.2625000
NODE_15190_length_728_cov_10.613672	322	402	6	1	80	0.0125000
NODE_15190_length_728_cov_10.613672	322	402	7	39	80	0.4875000
NODE_15190_length_728_cov_10.613672	322	402	8	19	80	0.2375000
NODE_15191_length_728_cov_7.613672	408	488	3	13	80	0.1625000
NODE_15191_length_728_cov_7.613672	408	488	4	7	80	0.0875000
NODE_15191_length_728_cov_7.613672	408	488	29	27	80	0.3375000
NODE_15191_length_728_cov_7.613672	408	488	33	13	80	0.1625000
NODE_15191_length_728_cov_7.613672	408	488	34	12	80	0.1500000
NODE_15191_length_728_cov_7.613672	408	488	36	8	80	0.1000000
NODE_15191_length_728_cov_7.613672	461	541	33	7	80	0.0875000
NODE_15191_length_728_cov_7.613672	461	541	34	12	80	0.1500000
NODE_15191_length_728_cov_7.613672	461	541	35	15	80	0.1875000
NODE_15191_length_728_cov_7.613672	461	541	36	33	80	0.4125000
NODE_15191_length_728_cov_7.613672	461	541	37	13	80	0.1625000
NODE_15196_length_728_cov_3.405405	335	415	0	80	80	1.0000000
NODE_15244_length_727_cov_34.883758	57	137	4	12	80	0.1500000
NODE_15244_length_727_cov_34.883758	57	137	5	9	80	0.1125000
NODE_15244_length_727_cov_34.883758	57	137	6	4	80	0.0500000
NODE_15244_length_727_cov_34.883758	57	137	7	30	80	0.3750000
NODE_15244_length_727_cov_34.883758	57	137	8	20	80	0.2500000
NODE_15244_length_727_cov_34.883758	57	137	9	1	80	0.0125000
NODE_15244_length_727_cov_34.883758	57	137	10	4	80	0.0500000
NODE_15244_length_727_cov_34.883758	57	137	4	12	80	0.1500000
NODE_15244_length_727_cov_34.883758	57	137	5	9	80	0.1125000
NODE_15244_length_727_cov_34.883758	57	137	6	4	80	0.0500000
NODE_15244_length_727_cov_34.883758	57	137	7	30	80	0.3750000
NODE_15244_length_727_cov_34.883758	57	137	8	20	80	0.2500000
NODE_15244_length_727_cov_34.883758	57	137	9	1	80	0.0125000
NODE_15244_length_727_cov_34.883758	57	137	10	4	80	0.0500000
NODE_15244_length_727_cov_34.883758	57	137	4	12	80	0.1500000
NODE_15244_length_727_cov_34.883758	57	137	5	9	80	0.1125000
NODE_15244_length_727_cov_34.883758	57	137	6	4	80	0.0500000
NODE_15244_length_727_cov_34.883758	57	137	7	30	80	0.3750000
NODE_15244_length_727_cov_34.883758	57	137	8	20	80	0.2500000
NODE_15244_length_727_cov_34.883758	57	137	9	1	80	0.0125000
NODE_15244_length_727_cov_34.883758	57	137	10	4	80	0.0500000
NODE_15244_length_727_cov_34.883758	110	190	6	5	80	0.0625000
NODE_15244_length_727_cov_34.883758	110	190	7	2	80	0.0250000
NODE_15244_length_727_cov_34.883758	110	190	8	30	80	0.3750000
NODE_15244_length_727_cov_34.883758	110	190	9	38	80	0.4750000
NODE_15244_length_727_cov_34.883758	110	190	10	5	80	0.0625000
NODE_15244_length_727_cov_34.883758	110	190	6	5	80	0.0625000
NODE_15244_length_727_cov_34.883758	110	190	7	2	80	0.0250000
NODE_15244_length_727_cov_34.883758	110	190	8	30	80	0.3750000
NODE_15244_length_727_cov_34.883758	110	190	9	38	80	0.4750000
NODE_15244_length_727_cov_34.883758	110	190	10	5	80	0.0625000
NODE_15245_length_727_cov_32.025478	275	355	3	1	80	0.0125000
NODE_15245_length_727_cov_32.025478	275	355	4	77	80	0.9625000
NODE_15245_length_727_cov_32.025478	275	355	5	2	80	0.0250000
NODE_15245_length_727_cov_32.025478	328	408	4	39	80	0.4875000
NODE_15245_length_727_cov_32.025478	328	408	5	4	80	0.0500000
NODE_15245_length_727_cov_32.025478	328	408	6	37	80	0.4625000
NODE_15246_length_727_cov_28.523885	307	381	3	10	74	0.1351351
NODE_15246_length_727_cov_28.523885	307	381	4	16	74	0.2162162
NODE_15246_length_727_cov_28.523885	307	381	8	11	74	0.1486486
NODE_15246_length_727_cov_28.523885	307	381	9	37	74	0.5000000
NODE_15246_length_727_cov_28.523885	360	381	3	10	21	0.4761905
NODE_15246_length_727_cov_28.523885	360	381	4	8	21	0.3809524
NODE_15246_length_727_cov_28.523885	360	381	8	3	21	0.1428571
NODE_15246_length_727_cov_28.523885	378	415	5	2	37	0.0540541
NODE_15246_length_727_cov_28.523885	378	415	8	13	37	0.3513514
NODE_15246_length_727_cov_28.523885	378	415	9	22	37	0.5945946
NODE_15247_length_727_cov_25.826433	325	405	2	1	80	0.0125000
NODE_15247_length_727_cov_25.826433	325	405	3	19	80	0.2375000
NODE_15247_length_727_cov_25.826433	325	405	4	5	80	0.0625000
NODE_15247_length_727_cov_25.826433	325	405	5	5	80	0.0625000
NODE_15247_length_727_cov_25.826433	325	405	6	27	80	0.3375000
NODE_15247_length_727_cov_25.826433	325	405	7	23	80	0.2875000
NODE_15247_length_727_cov_25.826433	378	458	5	4	80	0.0500000
NODE_15247_length_727_cov_25.826433	378	458	6	26	80	0.3250000
NODE_15247_length_727_cov_25.826433	378	458	7	50	80	0.6250000
NODE_15248_length_727_cov_22.253185	150	230	0	68	80	0.8500000
NODE_15248_length_727_cov_22.253185	150	230	1	12	80	0.1500000
NODE_15248_length_727_cov_22.253185	203	283	0	15	80	0.1875000
NODE_15248_length_727_cov_22.253185	203	283	1	40	80	0.5000000
NODE_15248_length_727_cov_22.253185	203	283	2	25	80	0.3125000
NODE_15249_length_727_cov_18.972930	263	343	3	6	80	0.0750000
NODE_15249_length_727_cov_18.972930	263	343	4	30	80	0.3750000
NODE_15249_length_727_cov_18.972930	263	343	5	21	80	0.2625000
NODE_15249_length_727_cov_18.972930	263	343	6	1	80	0.0125000
NODE_15249_length_727_cov_18.972930	263	343	7	9	80	0.1125000
NODE_15249_length_727_cov_18.972930	263	343	8	13	80	0.1625000
NODE_15249_length_727_cov_18.972930	316	396	5	4	80	0.0500000
NODE_15249_length_727_cov_18.972930	316	396	6	1	80	0.0125000
NODE_15249_length_727_cov_18.972930	316	396	7	9	80	0.1125000
NODE_15249_length_727_cov_18.972930	316	396	8	64	80	0.8000000
NODE_15249_length_727_cov_18.972930	316	396	9	2	80	0.0250000
NODE_15250_length_727_cov_15.531847	269	349	15	59	80	0.7375000
NODE_15250_length_727_cov_15.531847	269	349	17	21	80	0.2625000
NODE_15250_length_727_cov_15.531847	322	402	6	7	80	0.0875000
NODE_15250_length_727_cov_15.531847	322	402	8	35	80	0.4375000
NODE_15250_length_727_cov_15.531847	322	402	10	3	80	0.0375000
NODE_15250_length_727_cov_15.531847	322	402	15	9	80	0.1125000
NODE_15250_length_727_cov_15.531847	322	402	17	26	80	0.3250000
NODE_15252_length_727_cov_10.178344	280	360	4	11	80	0.1375000
NODE_15252_length_727_cov_10.178344	280	360	5	47	80	0.5875000
NODE_15252_length_727_cov_10.178344	280	360	6	22	80	0.2750000
NODE_15252_length_727_cov_10.178344	333	413	5	8	80	0.1000000
NODE_15252_length_727_cov_10.178344	333	413	6	72	80	0.9000000
NODE_15258_length_727_cov_4.955414	360	440	0	80	80	1.0000000
NODE_15258_length_727_cov_4.955414	413	493	0	80	80	1.0000000
NODE_15287_length_726_cov_52.923445	415	495	10	13	80	0.1625000
NODE_15287_length_726_cov_52.923445	415	495	11	2	80	0.0250000
NODE_15287_length_726_cov_52.923445	415	495	12	2	80	0.0250000
NODE_15287_length_726_cov_52.923445	415	495	14	27	80	0.3375000
NODE_15287_length_726_cov_52.923445	415	495	15	12	80	0.1500000
NODE_15287_length_726_cov_52.923445	415	495	16	24	80	0.3000000
NODE_15287_length_726_cov_52.923445	468	548	15	30	80	0.3750000
NODE_15287_length_726_cov_52.923445	468	548	16	25	80	0.3125000
NODE_15287_length_726_cov_52.923445	468	548	17	25	80	0.3125000
NODE_15288_length_726_cov_35.896332	108	188	8	26	80	0.3250000
NODE_15288_length_726_cov_35.896332	108	188	9	16	80	0.2000000
NODE_15288_length_726_cov_35.896332	108	188	12	37	80	0.4625000
NODE_15288_length_726_cov_35.896332	108	188	14	1	80	0.0125000
NODE_15288_length_726_cov_35.896332	161	241	3	17	80	0.2125000
NODE_15288_length_726_cov_35.896332	161	241	8	57	80	0.7125000
NODE_15288_length_726_cov_35.896332	161	241	9	6	80	0.0750000
NODE_15288_length_726_cov_35.896332	237	317	0	16	80	0.2000000
NODE_15288_length_726_cov_35.896332	237	317	1	54	80	0.6750000
NODE_15288_length_726_cov_35.896332	237	317	3	10	80	0.1250000
NODE_15288_length_726_cov_35.896332	290	370	0	24	80	0.3000000
NODE_15288_length_726_cov_35.896332	290	370	1	56	80	0.7000000
NODE_15291_length_726_cov_8.534290	355	435	1	68	80	0.8500000
NODE_15291_length_726_cov_8.534290	355	435	2	12	80	0.1500000
NODE_15291_length_726_cov_8.534290	408	488	0	34	80	0.4250000
NODE_15291_length_726_cov_8.534290	408	488	1	46	80	0.5750000
NODE_15330_length_725_cov_40.856230	203	283	1	64	80	0.8000000
NODE_15330_length_725_cov_40.856230	203	283	2	16	80	0.2000000
NODE_15330_length_725_cov_40.856230	256	336	1	80	80	1.0000000
NODE_15330_length_725_cov_40.856230	332	412	0	15	80	0.1875000
NODE_15330_length_725_cov_40.856230	332	412	1	27	80	0.3375000
NODE_15330_length_725_cov_40.856230	332	412	2	38	80	0.4750000
NODE_15330_length_725_cov_40.856230	385	465	0	10	80	0.1250000
NODE_15330_length_725_cov_40.856230	385	465	2	70	80	0.8750000
NODE_15331_length_725_cov_25.036741	366	446	21	21	80	0.2625000
NODE_15331_length_725_cov_25.036741	366	446	22	41	80	0.5125000
NODE_15331_length_725_cov_25.036741	366	446	24	2	80	0.0250000
NODE_15331_length_725_cov_25.036741	366	446	25	2	80	0.0250000
NODE_15331_length_725_cov_25.036741	366	446	26	1	80	0.0125000
NODE_15331_length_725_cov_25.036741	366	446	27	6	80	0.0750000
NODE_15331_length_725_cov_25.036741	366	446	31	1	80	0.0125000
NODE_15331_length_725_cov_25.036741	366	446	32	2	80	0.0250000
NODE_15331_length_725_cov_25.036741	366	446	33	4	80	0.0500000
NODE_15331_length_725_cov_25.036741	419	499	21	17	80	0.2125000
NODE_15331_length_725_cov_25.036741	419	499	24	1	80	0.0125000
NODE_15331_length_725_cov_25.036741	419	499	25	2	80	0.0250000
NODE_15331_length_725_cov_25.036741	419	499	26	1	80	0.0125000
NODE_15331_length_725_cov_25.036741	419	499	27	15	80	0.1875000
NODE_15331_length_725_cov_25.036741	419	499	28	4	80	0.0500000
NODE_15331_length_725_cov_25.036741	419	499	30	1	80	0.0125000
NODE_15331_length_725_cov_25.036741	419	499	31	1	80	0.0125000
NODE_15331_length_725_cov_25.036741	419	499	32	2	80	0.0250000
NODE_15331_length_725_cov_25.036741	419	499	33	5	80	0.0625000
NODE_15331_length_725_cov_25.036741	419	499	35	21	80	0.2625000
NODE_15331_length_725_cov_25.036741	419	499	36	10	80	0.1250000
NODE_15332_length_725_cov_23.009585	455	536	2	48	81	0.5925926
NODE_15332_length_725_cov_23.009585	455	536	3	33	81	0.4074074
NODE_15333_length_725_cov_20.474441	112	192	0	6	80	0.0750000
NODE_15333_length_725_cov_20.474441	112	192	5	13	80	0.1625000
NODE_15333_length_725_cov_20.474441	112	192	6	6	80	0.0750000
NODE_15333_length_725_cov_20.474441	112	192	8	55	80	0.6875000
NODE_15333_length_725_cov_20.474441	165	245	8	32	80	0.4000000
NODE_15333_length_725_cov_20.474441	165	245	9	8	80	0.1000000
NODE_15333_length_725_cov_20.474441	165	245	10	16	80	0.2000000
NODE_15333_length_725_cov_20.474441	165	245	11	24	80	0.3000000
NODE_15334_length_725_cov_15.455272	106	186	3	27	80	0.3375000
NODE_15334_length_725_cov_15.455272	106	186	4	1	80	0.0125000
NODE_15334_length_725_cov_15.455272	106	186	6	52	80	0.6500000
NODE_15334_length_725_cov_15.455272	159	239	3	19	80	0.2375000
NODE_15334_length_725_cov_15.455272	159	239	4	54	80	0.6750000
NODE_15334_length_725_cov_15.455272	159	239	6	7	80	0.0875000
NODE_15334_length_725_cov_15.455272	235	315	1	44	80	0.5500000
NODE_15334_length_725_cov_15.455272	235	315	2	5	80	0.0625000
NODE_15334_length_725_cov_15.455272	235	315	4	31	80	0.3875000
NODE_15334_length_725_cov_15.455272	288	368	1	20	80	0.2500000
NODE_15334_length_725_cov_15.455272	288	368	2	5	80	0.0625000
NODE_15334_length_725_cov_15.455272	288	368	3	33	80	0.4125000
NODE_15334_length_725_cov_15.455272	288	368	4	22	80	0.2750000
NODE_15335_length_725_cov_10.426518	289	369	0	80	80	1.0000000
NODE_15335_length_725_cov_10.426518	342	422	0	80	80	1.0000000
NODE_15337_length_725_cov_7.781150	189	269	1	41	80	0.5125000
NODE_15337_length_725_cov_7.781150	189	269	2	39	80	0.4875000
NODE_15337_length_725_cov_7.781150	242	322	2	80	80	1.0000000
NODE_15388_length_724_cov_28.132800	354	434	5	14	80	0.1750000
NODE_15388_length_724_cov_28.132800	354	434	6	66	80	0.8250000
NODE_15388_length_724_cov_28.132800	407	473	3	35	66	0.5303030
NODE_15388_length_724_cov_28.132800	407	473	5	18	66	0.2727273
NODE_15388_length_724_cov_28.132800	407	473	6	13	66	0.1969697
NODE_15389_length_724_cov_24.710400	376	461	2	25	85	0.2941177
NODE_15389_length_724_cov_24.710400	376	461	3	1	85	0.0117647
NODE_15389_length_724_cov_24.710400	376	461	4	20	85	0.2352941
NODE_15389_length_724_cov_24.710400	376	461	5	39	85	0.4588235
NODE_15389_length_724_cov_24.710400	434	514	5	33	80	0.4125000
NODE_15389_length_724_cov_24.710400	434	514	6	13	80	0.1625000
NODE_15389_length_724_cov_24.710400	434	514	7	34	80	0.4250000
NODE_15390_length_724_cov_13.960000	152	232	0	80	80	1.0000000
NODE_15390_length_724_cov_13.960000	205	248	0	43	43	1.0000000
NODE_15390_length_724_cov_13.960000	237	286	0	49	49	1.0000000
NODE_15390_length_724_cov_13.960000	259	302	0	43	43	1.0000000
NODE_15390_length_724_cov_13.960000	288	340	0	52	52	1.0000000
NODE_15390_length_724_cov_13.960000	313	393	0	80	80	1.0000000
NODE_15391_length_724_cov_13.065600	215	295	0	80	80	1.0000000
NODE_15391_length_724_cov_13.065600	268	347	0	79	79	1.0000000
NODE_15393_length_724_cov_10.358400	257	337	3	12	80	0.1500000
NODE_15393_length_724_cov_10.358400	257	337	5	19	80	0.2375000
NODE_15393_length_724_cov_10.358400	257	337	6	21	80	0.2625000
NODE_15393_length_724_cov_10.358400	257	337	9	28	80	0.3500000
NODE_15393_length_724_cov_10.358400	310	385	7	18	75	0.2400000
NODE_15393_length_724_cov_10.358400	310	385	8	16	75	0.2133333
NODE_15393_length_724_cov_10.358400	310	385	9	30	75	0.4000000
NODE_15393_length_724_cov_10.358400	310	385	10	11	75	0.1466667
NODE_15396_length_724_cov_6.451200	151	231	0	37	80	0.4625000
NODE_15396_length_724_cov_6.451200	151	231	1	12	80	0.1500000
NODE_15396_length_724_cov_6.451200	151	231	2	31	80	0.3875000
NODE_15396_length_724_cov_6.451200	202	282	2	80	80	1.0000000
NODE_15397_length_724_cov_5.921600	165	213	0	48	48	1.0000000
NODE_15399_length_724_cov_5.028800	416	469	0	53	53	1.0000000
NODE_15399_length_724_cov_5.028800	488	526	0	38	38	1.0000000
NODE_15403_length_724_cov_3.315200	166	246	0	80	80	1.0000000
NODE_15403_length_724_cov_3.315200	219	299	0	80	80	1.0000000
NODE_15442_length_723_cov_81.453526	205	285	31	2	80	0.0250000
NODE_15442_length_723_cov_81.453526	205	285	32	9	80	0.1125000
NODE_15442_length_723_cov_81.453526	205	285	33	2	80	0.0250000
NODE_15442_length_723_cov_81.453526	205	285	35	6	80	0.0750000
NODE_15442_length_723_cov_81.453526	205	285	36	11	80	0.1375000
NODE_15442_length_723_cov_81.453526	205	285	38	3	80	0.0375000
NODE_15442_length_723_cov_81.453526	205	285	41	4	80	0.0500000
NODE_15442_length_723_cov_81.453526	205	285	42	1	80	0.0125000
NODE_15442_length_723_cov_81.453526	205	285	43	2	80	0.0250000
NODE_15442_length_723_cov_81.453526	205	285	46	6	80	0.0750000
NODE_15442_length_723_cov_81.453526	205	285	47	13	80	0.1625000
NODE_15442_length_723_cov_81.453526	205	285	48	1	80	0.0125000
NODE_15442_length_723_cov_81.453526	205	285	49	2	80	0.0250000
NODE_15442_length_723_cov_81.453526	205	285	50	3	80	0.0375000
NODE_15442_length_723_cov_81.453526	205	285	51	1	80	0.0125000
NODE_15442_length_723_cov_81.453526	205	285	53	1	80	0.0125000
NODE_15442_length_723_cov_81.453526	205	285	55	1	80	0.0125000
NODE_15442_length_723_cov_81.453526	205	285	63	2	80	0.0250000
NODE_15442_length_723_cov_81.453526	205	285	64	1	80	0.0125000
NODE_15442_length_723_cov_81.453526	205	285	68	1	80	0.0125000
NODE_15442_length_723_cov_81.453526	205	285	70	8	80	0.1000000
NODE_15442_length_723_cov_81.453526	258	338	46	6	80	0.0750000
NODE_15442_length_723_cov_81.453526	258	338	47	2	80	0.0250000
NODE_15442_length_723_cov_81.453526	258	338	48	1	80	0.0125000
NODE_15442_length_723_cov_81.453526	258	338	49	2	80	0.0250000
NODE_15442_length_723_cov_81.453526	258	338	50	1	80	0.0125000
NODE_15442_length_723_cov_81.453526	258	338	51	1	80	0.0125000
NODE_15442_length_723_cov_81.453526	258	338	53	1	80	0.0125000
NODE_15442_length_723_cov_81.453526	258	338	55	1	80	0.0125000
NODE_15442_length_723_cov_81.453526	258	338	63	2	80	0.0250000
NODE_15442_length_723_cov_81.453526	258	338	64	1	80	0.0125000
NODE_15442_length_723_cov_81.453526	258	338	68	7	80	0.0875000
NODE_15442_length_723_cov_81.453526	258	338	69	13	80	0.1625000
NODE_15442_length_723_cov_81.453526	258	338	70	11	80	0.1375000
NODE_15442_length_723_cov_81.453526	258	338	75	10	80	0.1250000
NODE_15442_length_723_cov_81.453526	258	338	76	6	80	0.0750000
NODE_15442_length_723_cov_81.453526	258	338	77	1	80	0.0125000
NODE_15442_length_723_cov_81.453526	258	338	78	1	80	0.0125000
NODE_15442_length_723_cov_81.453526	258	338	82	2	80	0.0250000
NODE_15442_length_723_cov_81.453526	258	338	83	9	80	0.1125000
NODE_15442_length_723_cov_81.453526	258	338	84	1	80	0.0125000
NODE_15442_length_723_cov_81.453526	258	338	86	1	80	0.0125000
NODE_15443_length_723_cov_33.075321	254	329	2	63	75	0.8400000
NODE_15443_length_723_cov_33.075321	254	329	4	12	75	0.1600000
NODE_15443_length_723_cov_33.075321	307	387	2	80	80	1.0000000
NODE_15444_length_723_cov_25.410256	291	371	0	80	80	1.0000000
NODE_15444_length_723_cov_25.410256	344	424	0	80	80	1.0000000
NODE_15445_length_723_cov_18.097756	233	313	5	6	80	0.0750000
NODE_15445_length_723_cov_18.097756	233	313	6	74	80	0.9250000
NODE_15445_length_723_cov_18.097756	286	351	6	65	65	1.0000000
NODE_15446_length_723_cov_14.113782	311	391	2	50	80	0.6250000
NODE_15446_length_723_cov_14.113782	311	391	4	30	80	0.3750000
NODE_15446_length_723_cov_14.113782	364	444	0	4	80	0.0500000
NODE_15446_length_723_cov_14.113782	364	444	2	76	80	0.9500000
NODE_15447_length_723_cov_11.634615	299	379	2	28	80	0.3500000
NODE_15447_length_723_cov_11.634615	299	379	3	52	80	0.6500000
NODE_15447_length_723_cov_11.634615	352	432	2	2	80	0.0250000
NODE_15447_length_723_cov_11.634615	352	432	3	78	80	0.9750000
NODE_15448_length_723_cov_8.342949	357	437	3	13	80	0.1625000
NODE_15448_length_723_cov_8.342949	357	437	4	31	80	0.3875000
NODE_15448_length_723_cov_8.342949	357	437	5	36	80	0.4500000
NODE_15448_length_723_cov_8.342949	410	490	2	21	80	0.2625000
NODE_15448_length_723_cov_8.342949	410	490	3	33	80	0.4125000
NODE_15448_length_723_cov_8.342949	410	490	5	26	80	0.3250000
NODE_15455_length_723_cov_2.711538	379	422	0	43	43	1.0000000
NODE_15459_length_723_cov_2.573718	383	413	0	30	30	1.0000000
NODE_15495_length_722_cov_19.182986	180	260	2	61	80	0.7625000
NODE_15495_length_722_cov_19.182986	180	260	4	19	80	0.2375000
NODE_15495_length_722_cov_19.182986	233	313	2	8	80	0.1000000
NODE_15495_length_722_cov_19.182986	233	313	4	72	80	0.9000000
NODE_15496_length_722_cov_13.582665	192	272	11	31	80	0.3875000
NODE_15496_length_722_cov_13.582665	192	272	12	17	80	0.2125000
NODE_15496_length_722_cov_13.582665	192	272	13	4	80	0.0500000
NODE_15496_length_722_cov_13.582665	192	272	17	1	80	0.0125000
NODE_15496_length_722_cov_13.582665	192	272	18	27	80	0.3375000
NODE_15496_length_722_cov_13.582665	245	326	10	3	81	0.0370370
NODE_15496_length_722_cov_13.582665	245	326	12	20	81	0.2469136
NODE_15496_length_722_cov_13.582665	245	326	15	2	81	0.0246914
NODE_15496_length_722_cov_13.582665	245	326	18	56	81	0.6913580
NODE_15497_length_722_cov_9.202247	347	427	1	50	80	0.6250000
NODE_15497_length_722_cov_9.202247	347	427	2	30	80	0.3750000
NODE_15497_length_722_cov_9.202247	400	480	0	19	80	0.2375000
NODE_15497_length_722_cov_9.202247	400	480	1	61	80	0.7625000
NODE_15500_length_722_cov_6.707865	343	423	1	48	80	0.6000000
NODE_15500_length_722_cov_6.707865	343	423	2	32	80	0.4000000
NODE_15500_length_722_cov_6.707865	396	476	2	80	80	1.0000000
NODE_15504_length_722_cov_4.985554	332	393	1	61	61	1.0000000
NODE_15508_length_722_cov_3.977528	217	297	0	80	80	1.0000000
NODE_15508_length_722_cov_3.977528	270	350	0	80	80	1.0000000
NODE_15553_length_721_cov_105.927653	425	505	10	2	80	0.0250000
NODE_15553_length_721_cov_105.927653	425	505	13	7	80	0.0875000
NODE_15553_length_721_cov_105.927653	425	505	14	24	80	0.3000000
NODE_15553_length_721_cov_105.927653	425	505	15	14	80	0.1750000
NODE_15553_length_721_cov_105.927653	425	505	17	1	80	0.0125000
NODE_15553_length_721_cov_105.927653	425	505	18	8	80	0.1000000
NODE_15553_length_721_cov_105.927653	425	505	19	8	80	0.1000000
NODE_15553_length_721_cov_105.927653	425	505	20	6	80	0.0750000
NODE_15553_length_721_cov_105.927653	425	505	22	10	80	0.1250000
NODE_15553_length_721_cov_105.927653	478	558	18	3	80	0.0375000
NODE_15553_length_721_cov_105.927653	478	558	19	9	80	0.1125000
NODE_15553_length_721_cov_105.927653	478	558	20	7	80	0.0875000
NODE_15553_length_721_cov_105.927653	478	558	22	25	80	0.3125000
NODE_15553_length_721_cov_105.927653	478	558	23	5	80	0.0625000
NODE_15553_length_721_cov_105.927653	478	558	24	31	80	0.3875000
NODE_15554_length_721_cov_49.660772	304	384	20	8	80	0.1000000
NODE_15554_length_721_cov_49.660772	304	384	22	17	80	0.2125000
NODE_15554_length_721_cov_49.660772	304	384	23	12	80	0.1500000
NODE_15554_length_721_cov_49.660772	304	384	24	29	80	0.3625000
NODE_15554_length_721_cov_49.660772	304	384	25	14	80	0.1750000
NODE_15554_length_721_cov_49.660772	357	437	12	3	80	0.0375000
NODE_15554_length_721_cov_49.660772	357	437	13	4	80	0.0500000
NODE_15554_length_721_cov_49.660772	357	437	14	8	80	0.1000000
NODE_15554_length_721_cov_49.660772	357	437	15	4	80	0.0500000
NODE_15554_length_721_cov_49.660772	357	437	16	3	80	0.0375000
NODE_15554_length_721_cov_49.660772	357	437	17	12	80	0.1500000
NODE_15554_length_721_cov_49.660772	357	437	20	27	80	0.3375000
NODE_15554_length_721_cov_49.660772	357	437	22	1	80	0.0125000
NODE_15554_length_721_cov_49.660772	357	437	23	10	80	0.1250000
NODE_15554_length_721_cov_49.660772	357	437	24	4	80	0.0500000
NODE_15554_length_721_cov_49.660772	357	437	25	4	80	0.0500000
NODE_15555_length_721_cov_46.991961	341	421	13	6	80	0.0750000
NODE_15555_length_721_cov_46.991961	341	421	15	1	80	0.0125000
NODE_15555_length_721_cov_46.991961	341	421	16	13	80	0.1625000
NODE_15555_length_721_cov_46.991961	341	421	19	8	80	0.1000000
NODE_15555_length_721_cov_46.991961	341	421	20	6	80	0.0750000
NODE_15555_length_721_cov_46.991961	341	421	21	3	80	0.0375000
NODE_15555_length_721_cov_46.991961	341	421	22	17	80	0.2125000
NODE_15555_length_721_cov_46.991961	341	421	25	26	80	0.3250000
NODE_15555_length_721_cov_46.991961	394	474	14	2	80	0.0250000
NODE_15555_length_721_cov_46.991961	394	474	16	1	80	0.0125000
NODE_15555_length_721_cov_46.991961	394	474	17	2	80	0.0250000
NODE_15555_length_721_cov_46.991961	394	474	20	1	80	0.0125000
NODE_15555_length_721_cov_46.991961	394	474	21	9	80	0.1125000
NODE_15555_length_721_cov_46.991961	394	474	22	10	80	0.1250000
NODE_15555_length_721_cov_46.991961	394	474	23	4	80	0.0500000
NODE_15555_length_721_cov_46.991961	394	474	24	25	80	0.3125000
NODE_15555_length_721_cov_46.991961	394	474	25	26	80	0.3250000
NODE_15556_length_721_cov_38.864952	208	288	15	10	80	0.1250000
NODE_15556_length_721_cov_38.864952	208	288	16	10	80	0.1250000
NODE_15556_length_721_cov_38.864952	208	288	17	20	80	0.2500000
NODE_15556_length_721_cov_38.864952	208	288	18	33	80	0.4125000
NODE_15556_length_721_cov_38.864952	208	288	19	7	80	0.0875000
NODE_15556_length_721_cov_38.864952	269	341	9	12	72	0.1666667
NODE_15556_length_721_cov_38.864952	269	341	12	5	72	0.0694444
NODE_15556_length_721_cov_38.864952	269	341	13	3	72	0.0416667
NODE_15556_length_721_cov_38.864952	269	341	16	33	72	0.4583333
NODE_15556_length_721_cov_38.864952	269	341	18	19	72	0.2638889
NODE_15556_length_721_cov_38.864952	337	417	4	21	80	0.2625000
NODE_15556_length_721_cov_38.864952	337	417	5	23	80	0.2875000
NODE_15556_length_721_cov_38.864952	337	417	7	15	80	0.1875000
NODE_15556_length_721_cov_38.864952	337	417	8	16	80	0.2000000
NODE_15556_length_721_cov_38.864952	337	417	9	5	80	0.0625000
NODE_15556_length_721_cov_38.864952	390	467	4	56	77	0.7272727
NODE_15556_length_721_cov_38.864952	390	467	5	21	77	0.2727273
NODE_15557_length_721_cov_29.016077	192	272	6	4	80	0.0500000
NODE_15557_length_721_cov_29.016077	192	272	12	21	80	0.2625000
NODE_15557_length_721_cov_29.016077	192	272	13	3	80	0.0375000
NODE_15557_length_721_cov_29.016077	192	272	14	29	80	0.3625000
NODE_15557_length_721_cov_29.016077	192	272	15	23	80	0.2875000
NODE_15557_length_721_cov_29.016077	251	325	12	66	74	0.8918919
NODE_15557_length_721_cov_29.016077	251	325	13	8	74	0.1081081
NODE_15558_length_721_cov_26.196141	398	478	2	29	80	0.3625000
NODE_15558_length_721_cov_26.196141	398	478	3	1	80	0.0125000
NODE_15558_length_721_cov_26.196141	398	478	4	50	80	0.6250000
NODE_15558_length_721_cov_26.196141	451	531	2	4	80	0.0500000
NODE_15558_length_721_cov_26.196141	451	531	3	1	80	0.0125000
NODE_15558_length_721_cov_26.196141	451	531	4	75	80	0.9375000
NODE_15560_length_721_cov_20.054662	178	258	3	6	80	0.0750000
NODE_15560_length_721_cov_20.054662	178	258	5	24	80	0.3000000
NODE_15560_length_721_cov_20.054662	178	258	6	33	80	0.4125000
NODE_15560_length_721_cov_20.054662	178	258	7	17	80	0.2125000
NODE_15560_length_721_cov_20.054662	231	311	5	72	80	0.9000000
NODE_15560_length_721_cov_20.054662	231	311	6	8	80	0.1000000
NODE_15561_length_721_cov_13.670418	263	343	1	25	80	0.3125000
NODE_15561_length_721_cov_13.670418	263	343	2	55	80	0.6875000
NODE_15561_length_721_cov_13.670418	316	396	1	29	80	0.3625000
NODE_15561_length_721_cov_13.670418	316	396	2	51	80	0.6375000
NODE_15562_length_721_cov_13.652733	268	350	2	82	82	1.0000000
NODE_15562_length_721_cov_13.652733	321	403	0	6	82	0.0731707
NODE_15562_length_721_cov_13.652733	321	403	2	76	82	0.9268293
NODE_15563_length_721_cov_13.120579	312	392	8	11	80	0.1375000
NODE_15563_length_721_cov_13.120579	312	392	9	16	80	0.2000000
NODE_15563_length_721_cov_13.120579	312	392	10	19	80	0.2375000
NODE_15563_length_721_cov_13.120579	312	392	12	1	80	0.0125000
NODE_15563_length_721_cov_13.120579	312	392	14	30	80	0.3750000
NODE_15563_length_721_cov_13.120579	312	392	15	3	80	0.0375000
NODE_15563_length_721_cov_13.120579	365	445	9	9	80	0.1125000
NODE_15563_length_721_cov_13.120579	365	445	13	2	80	0.0250000
NODE_15563_length_721_cov_13.120579	365	445	14	66	80	0.8250000
NODE_15563_length_721_cov_13.120579	365	445	15	3	80	0.0375000
NODE_15572_length_721_cov_4.491961	210	280	0	70	70	1.0000000
NODE_15572_length_721_cov_4.491961	253	333	0	80	80	1.0000000
NODE_15572_length_721_cov_4.491961	470	521	0	51	51	1.0000000
NODE_15608_length_720_cov_17.449275	267	347	0	74	80	0.9250000
NODE_15608_length_720_cov_17.449275	267	347	2	6	80	0.0750000
NODE_15608_length_720_cov_17.449275	320	400	0	80	80	1.0000000
NODE_15609_length_720_cov_14.814815	261	341	2	54	80	0.6750000
NODE_15609_length_720_cov_14.814815	261	341	4	26	80	0.3250000
NODE_15609_length_720_cov_14.814815	314	394	2	1	80	0.0125000
NODE_15609_length_720_cov_14.814815	314	394	4	39	80	0.4875000
NODE_15609_length_720_cov_14.814815	314	394	6	40	80	0.5000000
NODE_15610_length_720_cov_14.107890	290	370	14	15	80	0.1875000
NODE_15610_length_720_cov_14.107890	290	370	15	24	80	0.3000000
NODE_15610_length_720_cov_14.107890	290	370	16	16	80	0.2000000
NODE_15610_length_720_cov_14.107890	290	370	17	25	80	0.3125000
NODE_15610_length_720_cov_14.107890	343	423	6	1	80	0.0125000
NODE_15610_length_720_cov_14.107890	343	423	7	1	80	0.0125000
NODE_15610_length_720_cov_14.107890	343	423	8	39	80	0.4875000
NODE_15610_length_720_cov_14.107890	343	423	13	11	80	0.1375000
NODE_15610_length_720_cov_14.107890	343	423	14	16	80	0.2000000
NODE_15610_length_720_cov_14.107890	343	423	16	6	80	0.0750000
NODE_15610_length_720_cov_14.107890	343	423	17	6	80	0.0750000
NODE_15612_length_720_cov_12.924316	314	394	1	1	80	0.0125000
NODE_15612_length_720_cov_12.924316	314	394	2	79	80	0.9875000
NODE_15612_length_720_cov_12.924316	367	447	0	7	80	0.0875000
NODE_15612_length_720_cov_12.924316	367	447	1	47	80	0.5875000
NODE_15612_length_720_cov_12.924316	367	447	2	26	80	0.3250000
NODE_15614_length_720_cov_10.389694	435	515	9	2	80	0.0250000
NODE_15614_length_720_cov_10.389694	435	515	12	10	80	0.1250000
NODE_15614_length_720_cov_10.389694	435	515	14	1	80	0.0125000
NODE_15614_length_720_cov_10.389694	435	515	16	13	80	0.1625000
NODE_15614_length_720_cov_10.389694	435	515	17	54	80	0.6750000
NODE_15614_length_720_cov_10.389694	488	568	11	19	80	0.2375000
NODE_15614_length_720_cov_10.389694	488	568	12	15	80	0.1875000
NODE_15614_length_720_cov_10.389694	488	568	14	1	80	0.0125000
NODE_15614_length_720_cov_10.389694	488	568	16	8	80	0.1000000
NODE_15614_length_720_cov_10.389694	488	568	17	29	80	0.3625000
NODE_15614_length_720_cov_10.389694	488	568	18	8	80	0.1000000
NODE_15620_length_720_cov_5.278583	309	389	7	10	80	0.1250000
NODE_15620_length_720_cov_5.278583	309	389	8	12	80	0.1500000
NODE_15620_length_720_cov_5.278583	309	389	9	11	80	0.1375000
NODE_15620_length_720_cov_5.278583	309	389	10	9	80	0.1125000
NODE_15620_length_720_cov_5.278583	309	389	11	38	80	0.4750000
NODE_15620_length_720_cov_5.278583	362	442	6	16	80	0.2000000
NODE_15620_length_720_cov_5.278583	362	442	8	3	80	0.0375000
NODE_15620_length_720_cov_5.278583	362	442	9	5	80	0.0625000
NODE_15620_length_720_cov_5.278583	362	442	10	3	80	0.0375000
NODE_15620_length_720_cov_5.278583	362	442	11	53	80	0.6625000
NODE_15624_length_720_cov_3.792271	157	235	1	37	78	0.4743590
NODE_15624_length_720_cov_3.792271	157	235	4	41	78	0.5256410
NODE_15624_length_720_cov_3.792271	215	265	4	50	50	1.0000000
NODE_15658_length_719_cov_30.256452	279	359	7	5	80	0.0625000
NODE_15658_length_719_cov_30.256452	279	359	8	9	80	0.1125000
NODE_15658_length_719_cov_30.256452	279	359	9	1	80	0.0125000
NODE_15658_length_719_cov_30.256452	279	359	10	62	80	0.7750000
NODE_15658_length_719_cov_30.256452	279	359	11	3	80	0.0375000
NODE_15658_length_719_cov_30.256452	332	412	9	36	80	0.4500000
NODE_15658_length_719_cov_30.256452	332	412	10	41	80	0.5125000
NODE_15658_length_719_cov_30.256452	332	412	11	3	80	0.0375000
NODE_15659_length_719_cov_29.093548	310	390	0	80	80	1.0000000
NODE_15659_length_719_cov_29.093548	363	443	0	80	80	1.0000000
NODE_15660_length_719_cov_10.988710	195	275	10	37	80	0.4625000
NODE_15660_length_719_cov_10.988710	195	275	11	30	80	0.3750000
NODE_15660_length_719_cov_10.988710	195	275	12	13	80	0.1625000
NODE_15660_length_719_cov_10.988710	248	328	11	32	80	0.4000000
NODE_15660_length_719_cov_10.988710	248	328	12	13	80	0.1625000
NODE_15660_length_719_cov_10.988710	248	328	13	35	80	0.4375000
NODE_15661_length_719_cov_10.837097	259	339	2	24	80	0.3000000
NODE_15661_length_719_cov_10.837097	259	339	3	54	80	0.6750000
NODE_15661_length_719_cov_10.837097	259	339	4	2	80	0.0250000
NODE_15661_length_719_cov_10.837097	312	392	2	9	80	0.1125000
NODE_15661_length_719_cov_10.837097	312	392	3	33	80	0.4125000
NODE_15661_length_719_cov_10.837097	312	392	4	38	80	0.4750000
NODE_15662_length_719_cov_7.622581	288	368	0	80	80	1.0000000
NODE_15662_length_719_cov_7.622581	341	421	0	80	80	1.0000000
NODE_15663_length_719_cov_7.570968	351	431	2	37	80	0.4625000
NODE_15663_length_719_cov_7.570968	351	431	3	43	80	0.5375000
NODE_15663_length_719_cov_7.570968	404	484	1	31	80	0.3875000
NODE_15663_length_719_cov_7.570968	404	484	3	49	80	0.6125000
NODE_15672_length_719_cov_4.264516	251	281	4	6	30	0.2000000
NODE_15672_length_719_cov_4.264516	251	281	5	1	30	0.0333333
NODE_15672_length_719_cov_4.264516	251	281	6	23	30	0.7666667
NODE_15684_length_719_cov_1.629032	88	163	2	75	75	1.0000000
NODE_15706_length_718_cov_35.382876	296	376	5	8	80	0.1000000
NODE_15706_length_718_cov_35.382876	296	376	6	71	80	0.8875000
NODE_15706_length_718_cov_35.382876	296	376	7	1	80	0.0125000
NODE_15706_length_718_cov_35.382876	296	376	5	8	80	0.1000000
NODE_15706_length_718_cov_35.382876	296	376	6	71	80	0.8875000
NODE_15706_length_718_cov_35.382876	296	376	7	1	80	0.0125000
NODE_15706_length_718_cov_35.382876	349	429	2	5	80	0.0625000
NODE_15706_length_718_cov_35.382876	349	429	3	7	80	0.0875000
NODE_15706_length_718_cov_35.382876	349	429	4	23	80	0.2875000
NODE_15706_length_718_cov_35.382876	349	429	5	7	80	0.0875000
NODE_15706_length_718_cov_35.382876	349	429	6	30	80	0.3750000
NODE_15706_length_718_cov_35.382876	349	429	7	8	80	0.1000000
NODE_15706_length_718_cov_35.382876	349	429	2	5	80	0.0625000
NODE_15706_length_718_cov_35.382876	349	429	3	7	80	0.0875000
NODE_15706_length_718_cov_35.382876	349	429	4	23	80	0.2875000
NODE_15706_length_718_cov_35.382876	349	429	5	7	80	0.0875000
NODE_15706_length_718_cov_35.382876	349	429	6	30	80	0.3750000
NODE_15706_length_718_cov_35.382876	349	429	7	8	80	0.1000000
NODE_15707_length_718_cov_24.211632	313	393	0	80	80	1.0000000
NODE_15707_length_718_cov_24.211632	366	446	0	80	80	1.0000000
NODE_15708_length_718_cov_18.300485	217	297	3	19	80	0.2375000
NODE_15708_length_718_cov_18.300485	217	297	4	7	80	0.0875000
NODE_15708_length_718_cov_18.300485	217	297	6	40	80	0.5000000
NODE_15708_length_718_cov_18.300485	217	297	10	1	80	0.0125000
NODE_15708_length_718_cov_18.300485	217	297	15	13	80	0.1625000
NODE_15708_length_718_cov_18.300485	270	350	6	13	80	0.1625000
NODE_15708_length_718_cov_18.300485	270	350	10	1	80	0.0125000
NODE_15708_length_718_cov_18.300485	270	350	13	49	80	0.6125000
NODE_15708_length_718_cov_18.300485	270	350	15	17	80	0.2125000
NODE_15709_length_718_cov_14.757674	383	463	0	31	80	0.3875000
NODE_15709_length_718_cov_14.757674	383	463	1	49	80	0.6125000
NODE_15709_length_718_cov_14.757674	436	516	1	56	80	0.7000000
NODE_15709_length_718_cov_14.757674	436	516	2	24	80	0.3000000
NODE_15710_length_718_cov_14.355412	254	334	1	18	80	0.2250000
NODE_15710_length_718_cov_14.355412	254	334	2	62	80	0.7750000
NODE_15710_length_718_cov_14.355412	307	387	2	80	80	1.0000000
NODE_15715_length_718_cov_4.804523	263	343	7	52	80	0.6500000
NODE_15715_length_718_cov_4.804523	263	343	8	28	80	0.3500000
NODE_15715_length_718_cov_4.804523	316	396	6	33	80	0.4125000
NODE_15715_length_718_cov_4.804523	316	396	7	47	80	0.5875000
NODE_15750_length_717_cov_28.377023	335	415	5	28	80	0.3500000
NODE_15750_length_717_cov_28.377023	335	415	6	46	80	0.5750000
NODE_15750_length_717_cov_28.377023	335	415	7	6	80	0.0750000
NODE_15750_length_717_cov_28.377023	388	468	4	42	80	0.5250000
NODE_15750_length_717_cov_28.377023	388	468	5	18	80	0.2250000
NODE_15750_length_717_cov_28.377023	388	468	6	14	80	0.1750000
NODE_15750_length_717_cov_28.377023	388	468	7	6	80	0.0750000
NODE_15751_length_717_cov_23.275081	162	242	11	12	80	0.1500000
NODE_15751_length_717_cov_23.275081	162	242	12	18	80	0.2250000
NODE_15751_length_717_cov_23.275081	162	242	13	18	80	0.2250000
NODE_15751_length_717_cov_23.275081	162	242	14	32	80	0.4000000
NODE_15751_length_717_cov_23.275081	215	295	12	5	80	0.0625000
NODE_15751_length_717_cov_23.275081	215	295	14	22	80	0.2750000
NODE_15751_length_717_cov_23.275081	215	295	15	4	80	0.0500000
NODE_15751_length_717_cov_23.275081	215	295	16	2	80	0.0250000
NODE_15751_length_717_cov_23.275081	215	295	18	1	80	0.0125000
NODE_15751_length_717_cov_23.275081	215	295	19	16	80	0.2000000
NODE_15751_length_717_cov_23.275081	215	295	20	30	80	0.3750000
NODE_15752_length_717_cov_18.564725	319	399	3	14	80	0.1750000
NODE_15752_length_717_cov_18.564725	319	399	4	66	80	0.8250000
NODE_15752_length_717_cov_18.564725	372	452	1	16	80	0.2000000
NODE_15752_length_717_cov_18.564725	372	452	2	7	80	0.0875000
NODE_15752_length_717_cov_18.564725	372	452	3	44	80	0.5500000
NODE_15752_length_717_cov_18.564725	372	452	4	13	80	0.1625000
NODE_15753_length_717_cov_18.389968	358	438	4	23	80	0.2875000
NODE_15753_length_717_cov_18.389968	358	438	6	13	80	0.1625000
NODE_15753_length_717_cov_18.389968	358	438	8	44	80	0.5500000
NODE_15753_length_717_cov_18.389968	411	491	4	8	80	0.1000000
NODE_15753_length_717_cov_18.389968	411	491	6	11	80	0.1375000
NODE_15753_length_717_cov_18.389968	411	491	8	61	80	0.7625000
NODE_15754_length_717_cov_17.932039	241	321	4	28	80	0.3500000
NODE_15754_length_717_cov_17.932039	241	321	6	52	80	0.6500000
NODE_15754_length_717_cov_17.932039	294	374	0	11	80	0.1375000
NODE_15754_length_717_cov_17.932039	294	374	2	21	80	0.2625000
NODE_15754_length_717_cov_17.932039	294	374	4	48	80	0.6000000
NODE_15755_length_717_cov_14.637540	298	378	4	39	80	0.4875000
NODE_15755_length_717_cov_14.637540	298	378	8	41	80	0.5125000
NODE_15755_length_717_cov_14.637540	351	431	4	39	80	0.4875000
NODE_15755_length_717_cov_14.637540	351	431	7	1	80	0.0125000
NODE_15755_length_717_cov_14.637540	351	431	8	40	80	0.5000000
NODE_15756_length_717_cov_12.279935	113	196	0	83	83	1.0000000
NODE_15756_length_717_cov_12.279935	169	249	0	80	80	1.0000000
NODE_15757_length_717_cov_10.711974	353	431	0	78	78	1.0000000
NODE_15758_length_717_cov_9.399676	331	411	6	6	80	0.0750000
NODE_15758_length_717_cov_9.399676	331	411	7	74	80	0.9250000
NODE_15758_length_717_cov_9.399676	384	464	3	6	80	0.0750000
NODE_15758_length_717_cov_9.399676	384	464	4	17	80	0.2125000
NODE_15758_length_717_cov_9.399676	384	464	5	6	80	0.0750000
NODE_15758_length_717_cov_9.399676	384	464	6	24	80	0.3000000
NODE_15758_length_717_cov_9.399676	384	464	7	27	80	0.3375000
NODE_15762_length_717_cov_5.341424	475	555	2	4	80	0.0500000
NODE_15762_length_717_cov_5.341424	475	555	3	76	80	0.9500000
NODE_15762_length_717_cov_5.341424	528	608	3	33	80	0.4125000
NODE_15762_length_717_cov_5.341424	528	608	4	47	80	0.5875000
NODE_15770_length_717_cov_3.187702	285	322	0	37	37	1.0000000
NODE_15805_length_716_cov_16.800648	430	510	1	8	80	0.1000000
NODE_15805_length_716_cov_16.800648	430	510	2	34	80	0.4250000
NODE_15805_length_716_cov_16.800648	430	510	5	28	80	0.3500000
NODE_15805_length_716_cov_16.800648	430	510	6	10	80	0.1250000
NODE_15805_length_716_cov_16.800648	483	563	0	28	80	0.3500000
NODE_15805_length_716_cov_16.800648	483	563	1	33	80	0.4125000
NODE_15805_length_716_cov_16.800648	483	563	2	19	80	0.2375000
NODE_15806_length_716_cov_12.565640	356	436	0	26	80	0.3250000
NODE_15806_length_716_cov_12.565640	356	436	2	54	80	0.6750000
NODE_15806_length_716_cov_12.565640	409	489	2	80	80	1.0000000
NODE_15807_length_716_cov_9.277147	385	465	0	80	80	1.0000000
NODE_15807_length_716_cov_9.277147	438	518	0	80	80	1.0000000
NODE_15808_length_716_cov_9.257699	302	382	1	21	80	0.2625000
NODE_15808_length_716_cov_9.257699	302	382	2	59	80	0.7375000
NODE_15808_length_716_cov_9.257699	355	435	2	80	80	1.0000000
NODE_15809_length_716_cov_6.761750	263	343	4	34	80	0.4250000
NODE_15809_length_716_cov_6.761750	263	343	5	24	80	0.3000000
NODE_15809_length_716_cov_6.761750	263	343	6	22	80	0.2750000
NODE_15809_length_716_cov_6.761750	316	396	4	80	80	1.0000000
NODE_15812_length_716_cov_4.909238	236	316	0	80	80	1.0000000
NODE_15812_length_716_cov_4.909238	289	369	0	80	80	1.0000000
NODE_15824_length_716_cov_2.068071	453	481	0	28	28	1.0000000
NODE_15853_length_715_cov_38.795455	260	340	7	14	80	0.1750000
NODE_15853_length_715_cov_38.795455	260	340	9	2	80	0.0250000
NODE_15853_length_715_cov_38.795455	260	340	10	6	80	0.0750000
NODE_15853_length_715_cov_38.795455	260	340	11	9	80	0.1125000
NODE_15853_length_715_cov_38.795455	260	340	12	1	80	0.0125000
NODE_15853_length_715_cov_38.795455	260	340	13	48	80	0.6000000
NODE_15853_length_715_cov_38.795455	313	393	10	1	80	0.0125000
NODE_15853_length_715_cov_38.795455	313	393	11	17	80	0.2125000
NODE_15853_length_715_cov_38.795455	313	393	12	12	80	0.1500000
NODE_15853_length_715_cov_38.795455	313	393	13	50	80	0.6250000
NODE_15854_length_715_cov_30.344156	316	396	6	11	80	0.1375000
NODE_15854_length_715_cov_30.344156	316	396	7	2	80	0.0250000
NODE_15854_length_715_cov_30.344156	316	396	8	67	80	0.8375000
NODE_15854_length_715_cov_30.344156	369	449	3	36	80	0.4500000
NODE_15854_length_715_cov_30.344156	369	449	4	6	80	0.0750000
NODE_15854_length_715_cov_30.344156	369	449	6	22	80	0.2750000
NODE_15854_length_715_cov_30.344156	369	449	8	16	80	0.2000000
NODE_15857_length_715_cov_11.209416	484	564	0	21	80	0.2625000
NODE_15857_length_715_cov_11.209416	484	564	2	59	80	0.7375000
NODE_15857_length_715_cov_11.209416	537	617	2	80	80	1.0000000
NODE_15858_length_715_cov_10.894481	189	242	0	53	53	1.0000000
NODE_15859_length_715_cov_10.628247	502	582	1	12	80	0.1500000
NODE_15859_length_715_cov_10.628247	502	582	2	68	80	0.8500000
NODE_15859_length_715_cov_10.628247	555	635	1	37	80	0.4625000
NODE_15859_length_715_cov_10.628247	555	635	2	43	80	0.5375000
NODE_15860_length_715_cov_8.647727	138	218	0	80	80	1.0000000
NODE_15860_length_715_cov_8.647727	191	271	0	80	80	1.0000000
NODE_15861_length_715_cov_8.412338	364	444	0	80	80	1.0000000
NODE_15861_length_715_cov_8.412338	417	497	0	80	80	1.0000000
NODE_15864_length_715_cov_5.373377	318	398	0	80	80	1.0000000
NODE_15864_length_715_cov_5.373377	371	451	0	80	80	1.0000000
NODE_15898_length_715_cov_1.271104	331	397	0	66	66	1.0000000
NODE_15910_length_714_cov_18.621138	297	377	5	12	80	0.1500000
NODE_15910_length_714_cov_18.621138	297	377	6	1	80	0.0125000
NODE_15910_length_714_cov_18.621138	297	377	7	3	80	0.0375000
NODE_15910_length_714_cov_18.621138	297	377	8	18	80	0.2250000
NODE_15910_length_714_cov_18.621138	297	377	10	17	80	0.2125000
NODE_15910_length_714_cov_18.621138	297	377	11	26	80	0.3250000
NODE_15910_length_714_cov_18.621138	297	377	12	3	80	0.0375000
NODE_15910_length_714_cov_18.621138	350	430	9	5	80	0.0625000
NODE_15910_length_714_cov_18.621138	350	430	10	1	80	0.0125000
NODE_15910_length_714_cov_18.621138	350	430	11	40	80	0.5000000
NODE_15910_length_714_cov_18.621138	350	430	12	34	80	0.4250000
NODE_15911_length_714_cov_15.468293	268	348	0	9	80	0.1125000
NODE_15911_length_714_cov_15.468293	268	348	1	20	80	0.2500000
NODE_15911_length_714_cov_15.468293	268	348	2	39	80	0.4875000
NODE_15911_length_714_cov_15.468293	268	348	3	12	80	0.1500000
NODE_15911_length_714_cov_15.468293	321	401	2	15	80	0.1875000
NODE_15911_length_714_cov_15.468293	321	401	3	15	80	0.1875000
NODE_15911_length_714_cov_15.468293	321	401	4	50	80	0.6250000
NODE_15913_length_714_cov_10.530081	218	298	0	80	80	1.0000000
NODE_15913_length_714_cov_10.530081	271	351	0	46	80	0.5750000
NODE_15913_length_714_cov_10.530081	271	351	2	34	80	0.4250000
NODE_15913_length_714_cov_10.530081	354	434	2	80	80	1.0000000
NODE_15913_length_714_cov_10.530081	407	487	0	42	80	0.5250000
NODE_15913_length_714_cov_10.530081	407	487	2	38	80	0.4750000
NODE_15914_length_714_cov_8.365854	285	365	2	9	80	0.1125000
NODE_15914_length_714_cov_8.365854	285	365	4	56	80	0.7000000
NODE_15914_length_714_cov_8.365854	285	365	5	1	80	0.0125000
NODE_15914_length_714_cov_8.365854	285	365	6	14	80	0.1750000
NODE_15914_length_714_cov_8.365854	338	418	4	65	80	0.8125000
NODE_15914_length_714_cov_8.365854	338	418	5	1	80	0.0125000
NODE_15914_length_714_cov_8.365854	338	418	6	14	80	0.1750000
NODE_15919_length_714_cov_6.993496	263	343	1	33	80	0.4125000
NODE_15919_length_714_cov_6.993496	263	343	2	47	80	0.5875000
NODE_15919_length_714_cov_6.993496	316	384	0	24	68	0.3529412
NODE_15919_length_714_cov_6.993496	316	384	1	44	68	0.6470588
NODE_15921_length_714_cov_4.224390	218	288	5	13	70	0.1857143
NODE_15921_length_714_cov_4.224390	218	288	7	1	70	0.0142857
NODE_15921_length_714_cov_4.224390	218	288	8	4	70	0.0571429
NODE_15921_length_714_cov_4.224390	218	288	10	4	70	0.0571429
NODE_15921_length_714_cov_4.224390	218	288	11	48	70	0.6857143
NODE_15921_length_714_cov_4.224390	271	351	4	1	80	0.0125000
NODE_15921_length_714_cov_4.224390	271	351	6	14	80	0.1750000
NODE_15921_length_714_cov_4.224390	271	351	7	1	80	0.0125000
NODE_15921_length_714_cov_4.224390	271	351	9	46	80	0.5750000
NODE_15921_length_714_cov_4.224390	271	351	11	18	80	0.2250000
NODE_15969_length_713_cov_19.304560	271	351	5	9	80	0.1125000
NODE_15969_length_713_cov_19.304560	271	351	6	68	80	0.8500000
NODE_15969_length_713_cov_19.304560	271	351	7	3	80	0.0375000
NODE_15969_length_713_cov_19.304560	324	404	2	15	80	0.1875000
NODE_15969_length_713_cov_19.304560	324	404	5	34	80	0.4250000
NODE_15969_length_713_cov_19.304560	324	404	6	28	80	0.3500000
NODE_15969_length_713_cov_19.304560	324	404	7	3	80	0.0375000
NODE_15970_length_713_cov_16.926710	262	342	1	32	80	0.4000000
NODE_15970_length_713_cov_16.926710	262	342	3	48	80	0.6000000
NODE_15970_length_713_cov_16.926710	315	395	3	29	80	0.3625000
NODE_15970_length_713_cov_16.926710	315	395	4	4	80	0.0500000
NODE_15970_length_713_cov_16.926710	315	395	5	47	80	0.5875000
NODE_15973_length_713_cov_7.159609	351	431	0	80	80	1.0000000
NODE_15973_length_713_cov_7.159609	404	484	0	80	80	1.0000000
NODE_15974_length_713_cov_6.723127	379	427	0	48	48	1.0000000
NODE_15975_length_713_cov_4.954397	90	171	0	12	81	0.1481481
NODE_15975_length_713_cov_4.954397	90	171	2	69	81	0.8518519
NODE_15975_length_713_cov_4.954397	144	224	2	80	80	1.0000000
NODE_15980_length_713_cov_4.302932	402	482	1	26	80	0.3250000
NODE_15980_length_713_cov_4.302932	402	482	2	54	80	0.6750000
NODE_15980_length_713_cov_4.302932	455	535	1	79	80	0.9875000
NODE_15980_length_713_cov_4.302932	455	535	2	1	80	0.0125000
NODE_16004_length_713_cov_1.939739	15	75	0	60	60	1.0000000
NODE_16010_length_713_cov_1.605863	81	161	0	80	80	1.0000000
NODE_16010_length_713_cov_1.605863	134	214	0	80	80	1.0000000
NODE_16052_length_712_cov_32.931485	289	369	3	3	80	0.0375000
NODE_16052_length_712_cov_32.931485	289	369	4	52	80	0.6500000
NODE_16052_length_712_cov_32.931485	289	369	5	13	80	0.1625000
NODE_16052_length_712_cov_32.931485	289	369	7	12	80	0.1500000
NODE_16052_length_712_cov_32.931485	342	422	3	3	80	0.0375000
NODE_16052_length_712_cov_32.931485	342	422	4	12	80	0.1500000
NODE_16052_length_712_cov_32.931485	342	422	6	12	80	0.1500000
NODE_16052_length_712_cov_32.931485	342	422	7	53	80	0.6625000
NODE_16053_length_712_cov_31.752039	185	251	2	19	66	0.2878788
NODE_16053_length_712_cov_31.752039	185	251	3	1	66	0.0151515
NODE_16053_length_712_cov_31.752039	185	251	4	12	66	0.1818182
NODE_16053_length_712_cov_31.752039	185	251	6	20	66	0.3030303
NODE_16053_length_712_cov_31.752039	185	251	8	14	66	0.2121212
NODE_16053_length_712_cov_31.752039	228	307	6	41	79	0.5189874
NODE_16053_length_712_cov_31.752039	228	307	8	38	79	0.4810127
NODE_16054_length_712_cov_22.567700	228	308	4	5	80	0.0625000
NODE_16054_length_712_cov_22.567700	228	308	6	22	80	0.2750000
NODE_16054_length_712_cov_22.567700	228	308	11	34	80	0.4250000
NODE_16054_length_712_cov_22.567700	228	308	21	1	80	0.0125000
NODE_16054_length_712_cov_22.567700	228	308	22	1	80	0.0125000
NODE_16054_length_712_cov_22.567700	228	308	23	8	80	0.1000000
NODE_16054_length_712_cov_22.567700	228	308	27	9	80	0.1125000
NODE_16054_length_712_cov_22.567700	281	361	11	8	80	0.1000000
NODE_16054_length_712_cov_22.567700	281	361	21	1	80	0.0125000
NODE_16054_length_712_cov_22.567700	281	361	22	1	80	0.0125000
NODE_16054_length_712_cov_22.567700	281	361	23	8	80	0.1000000
NODE_16054_length_712_cov_22.567700	281	361	27	37	80	0.4625000
NODE_16054_length_712_cov_22.567700	281	361	28	17	80	0.2125000
NODE_16054_length_712_cov_22.567700	281	361	29	1	80	0.0125000
NODE_16054_length_712_cov_22.567700	281	361	31	1	80	0.0125000
NODE_16054_length_712_cov_22.567700	281	361	32	6	80	0.0750000
NODE_16055_length_712_cov_19.306688	238	318	1	15	80	0.1875000
NODE_16055_length_712_cov_19.306688	238	318	2	65	80	0.8125000
NODE_16055_length_712_cov_19.306688	291	371	1	37	80	0.4625000
NODE_16055_length_712_cov_19.306688	291	371	2	43	80	0.5375000
NODE_16056_length_712_cov_14.929853	332	412	2	68	80	0.8500000
NODE_16056_length_712_cov_14.929853	332	412	3	12	80	0.1500000
NODE_16056_length_712_cov_14.929853	385	465	1	9	80	0.1125000
NODE_16056_length_712_cov_14.929853	385	465	2	71	80	0.8875000
NODE_16057_length_712_cov_14.228385	250	330	4	33	80	0.4125000
NODE_16057_length_712_cov_14.228385	250	330	5	5	80	0.0625000
NODE_16057_length_712_cov_14.228385	250	330	6	17	80	0.2125000
NODE_16057_length_712_cov_14.228385	250	330	8	25	80	0.3125000
NODE_16057_length_712_cov_14.228385	303	383	4	33	80	0.4125000
NODE_16057_length_712_cov_14.228385	303	383	5	14	80	0.1750000
NODE_16057_length_712_cov_14.228385	303	383	6	20	80	0.2500000
NODE_16057_length_712_cov_14.228385	303	383	8	13	80	0.1625000
NODE_16059_length_712_cov_9.221860	326	406	2	15	80	0.1875000
NODE_16059_length_712_cov_9.221860	326	406	3	8	80	0.1000000
NODE_16059_length_712_cov_9.221860	326	406	4	57	80	0.7125000
NODE_16059_length_712_cov_9.221860	379	463	3	47	84	0.5595238
NODE_16059_length_712_cov_9.221860	379	463	4	37	84	0.4404762
NODE_16060_length_712_cov_8.368679	331	411	4	57	80	0.7125000
NODE_16060_length_712_cov_8.368679	331	411	6	23	80	0.2875000
NODE_16060_length_712_cov_8.368679	384	464	2	8	80	0.1000000
NODE_16060_length_712_cov_8.368679	384	464	4	26	80	0.3250000
NODE_16060_length_712_cov_8.368679	384	464	6	46	80	0.5750000
NODE_16079_length_712_cov_2.350734	466	510	0	44	44	1.0000000
NODE_16118_length_711_cov_36.459150	146	223	0	77	77	1.0000000
NODE_16118_length_711_cov_36.459150	199	280	0	81	81	1.0000000
NODE_16119_length_711_cov_26.702614	460	540	8	17	80	0.2125000
NODE_16119_length_711_cov_26.702614	460	540	9	23	80	0.2875000
NODE_16119_length_711_cov_26.702614	460	540	11	40	80	0.5000000
NODE_16119_length_711_cov_26.702614	513	593	3	33	80	0.4125000
NODE_16119_length_711_cov_26.702614	513	593	4	13	80	0.1625000
NODE_16119_length_711_cov_26.702614	513	593	7	1	80	0.0125000
NODE_16119_length_711_cov_26.702614	513	593	8	5	80	0.0625000
NODE_16119_length_711_cov_26.702614	513	593	9	24	80	0.3000000
NODE_16119_length_711_cov_26.702614	513	593	11	4	80	0.0500000
NODE_16120_length_711_cov_19.632353	329	409	10	6	80	0.0750000
NODE_16120_length_711_cov_19.632353	329	409	16	35	80	0.4375000
NODE_16120_length_711_cov_19.632353	329	409	17	29	80	0.3625000
NODE_16120_length_711_cov_19.632353	329	409	18	6	80	0.0750000
NODE_16120_length_711_cov_19.632353	329	409	20	4	80	0.0500000
NODE_16120_length_711_cov_19.632353	382	462	0	1	80	0.0125000
NODE_16120_length_711_cov_19.632353	382	462	10	58	80	0.7250000
NODE_16120_length_711_cov_19.632353	382	462	17	11	80	0.1375000
NODE_16120_length_711_cov_19.632353	382	462	18	6	80	0.0750000
NODE_16120_length_711_cov_19.632353	382	462	20	4	80	0.0500000
NODE_16121_length_711_cov_19.267974	283	363	0	80	80	1.0000000
NODE_16121_length_711_cov_19.267974	336	416	0	80	80	1.0000000
NODE_16122_length_711_cov_12.813725	255	334	4	55	79	0.6962025
NODE_16122_length_711_cov_12.813725	255	334	5	8	79	0.1012658
NODE_16122_length_711_cov_12.813725	255	334	6	16	79	0.2025317
NODE_16123_length_711_cov_12.147059	314	394	0	80	80	1.0000000
NODE_16123_length_711_cov_12.147059	367	447	0	80	80	1.0000000
NODE_16124_length_711_cov_10.009804	336	415	0	24	79	0.3037975
NODE_16124_length_711_cov_10.009804	336	415	1	55	79	0.6962025
NODE_16127_length_711_cov_5.619281	276	356	2	14	80	0.1750000
NODE_16127_length_711_cov_5.619281	276	356	3	66	80	0.8250000
NODE_16127_length_711_cov_5.619281	329	409	1	3	80	0.0375000
NODE_16127_length_711_cov_5.619281	329	409	3	77	80	0.9625000
NODE_16130_length_711_cov_4.040850	165	245	2	40	80	0.5000000
NODE_16130_length_711_cov_4.040850	165	245	4	40	80	0.5000000
NODE_16130_length_711_cov_4.040850	218	298	2	22	80	0.2750000
NODE_16130_length_711_cov_4.040850	218	298	4	58	80	0.7250000
NODE_16167_length_710_cov_73.721768	626	706	0	80	80	1.0000000
NODE_16168_length_710_cov_21.772504	292	372	4	80	80	1.0000000
NODE_16168_length_710_cov_21.772504	345	425	2	38	80	0.4750000
NODE_16168_length_710_cov_21.772504	345	425	3	5	80	0.0625000
NODE_16168_length_710_cov_21.772504	345	425	4	37	80	0.4625000
NODE_16169_length_710_cov_21.597381	18	54	0	36	36	1.0000000
NODE_16170_length_710_cov_13.155483	306	386	0	80	80	1.0000000
NODE_16170_length_710_cov_13.155483	359	439	0	80	80	1.0000000
NODE_16173_length_710_cov_8.031097	316	396	0	80	80	1.0000000
NODE_16173_length_710_cov_8.031097	369	449	0	80	80	1.0000000
NODE_16175_length_710_cov_6.664484	264	344	0	80	80	1.0000000
NODE_16178_length_710_cov_5.590835	352	421	0	69	69	1.0000000
NODE_16178_length_710_cov_5.590835	394	474	0	80	80	1.0000000
NODE_16180_length_710_cov_5.356792	248	328	6	14	80	0.1750000
NODE_16180_length_710_cov_5.356792	248	328	7	66	80	0.8250000
NODE_16180_length_710_cov_5.356792	301	381	4	28	80	0.3500000
NODE_16180_length_710_cov_5.356792	301	381	6	39	80	0.4875000
NODE_16180_length_710_cov_5.356792	301	381	7	13	80	0.1625000
NODE_16233_length_709_cov_12.227869	347	427	1	1	80	0.0125000
NODE_16233_length_709_cov_12.227869	347	427	2	5	80	0.0625000
NODE_16233_length_709_cov_12.227869	347	427	4	74	80	0.9250000
NODE_16233_length_709_cov_12.227869	400	480	3	14	80	0.1750000
NODE_16233_length_709_cov_12.227869	400	480	4	33	80	0.4125000
NODE_16233_length_709_cov_12.227869	400	480	5	33	80	0.4125000
NODE_16234_length_709_cov_10.531148	279	359	2	25	80	0.3125000
NODE_16234_length_709_cov_10.531148	279	359	3	31	80	0.3875000
NODE_16234_length_709_cov_10.531148	279	359	5	24	80	0.3000000
NODE_16234_length_709_cov_10.531148	332	412	2	35	80	0.4375000
NODE_16234_length_709_cov_10.531148	332	412	3	45	80	0.5625000
NODE_16238_length_709_cov_7.181967	225	305	0	20	80	0.2500000
NODE_16238_length_709_cov_7.181967	225	305	2	60	80	0.7500000
NODE_16238_length_709_cov_7.181967	279	312	2	33	33	1.0000000
NODE_16241_length_709_cov_5.888525	239	319	2	16	80	0.2000000
NODE_16241_length_709_cov_5.888525	239	319	3	64	80	0.8000000
NODE_16241_length_709_cov_5.888525	292	372	0	4	80	0.0500000
NODE_16241_length_709_cov_5.888525	292	372	1	34	80	0.4250000
NODE_16241_length_709_cov_5.888525	292	372	2	31	80	0.3875000
NODE_16241_length_709_cov_5.888525	292	372	3	11	80	0.1375000
NODE_16294_length_708_cov_42.435140	307	387	3	1	80	0.0125000
NODE_16294_length_708_cov_42.435140	307	387	4	8	80	0.1000000
NODE_16294_length_708_cov_42.435140	307	387	5	44	80	0.5500000
NODE_16294_length_708_cov_42.435140	307	387	6	21	80	0.2625000
NODE_16294_length_708_cov_42.435140	307	387	7	3	80	0.0375000
NODE_16294_length_708_cov_42.435140	307	387	8	3	80	0.0375000
NODE_16294_length_708_cov_42.435140	360	440	6	21	80	0.2625000
NODE_16294_length_708_cov_42.435140	360	440	7	18	80	0.2250000
NODE_16294_length_708_cov_42.435140	360	440	8	9	80	0.1125000
NODE_16294_length_708_cov_42.435140	360	440	9	32	80	0.4000000
NODE_16296_length_708_cov_33.412151	235	315	3	6	80	0.0750000
NODE_16296_length_708_cov_33.412151	235	315	5	1	80	0.0125000
NODE_16296_length_708_cov_33.412151	235	315	6	30	80	0.3750000
NODE_16296_length_708_cov_33.412151	235	315	9	17	80	0.2125000
NODE_16296_length_708_cov_33.412151	235	315	10	26	80	0.3250000
NODE_16296_length_708_cov_33.412151	288	368	9	1	80	0.0125000
NODE_16296_length_708_cov_33.412151	288	368	10	53	80	0.6625000
NODE_16296_length_708_cov_33.412151	288	368	12	9	80	0.1125000
NODE_16296_length_708_cov_33.412151	288	368	13	13	80	0.1625000
NODE_16296_length_708_cov_33.412151	288	368	14	4	80	0.0500000
NODE_16297_length_708_cov_23.034483	316	396	0	80	80	1.0000000
NODE_16297_length_708_cov_23.034483	369	449	0	80	80	1.0000000
NODE_16298_length_708_cov_20.449918	254	334	1	17	80	0.2125000
NODE_16298_length_708_cov_20.449918	254	334	2	34	80	0.4250000
NODE_16298_length_708_cov_20.449918	254	334	3	16	80	0.2000000
NODE_16298_length_708_cov_20.449918	254	334	4	13	80	0.1625000
NODE_16298_length_708_cov_20.449918	307	387	3	14	80	0.1750000
NODE_16298_length_708_cov_20.449918	307	387	4	21	80	0.2625000
NODE_16298_length_708_cov_20.449918	307	387	5	31	80	0.3875000
NODE_16298_length_708_cov_20.449918	307	387	6	14	80	0.1750000
NODE_16299_length_708_cov_19.998358	238	318	4	18	80	0.2250000
NODE_16299_length_708_cov_19.998358	238	318	5	44	80	0.5500000
NODE_16299_length_708_cov_19.998358	238	318	6	7	80	0.0875000
NODE_16299_length_708_cov_19.998358	238	318	7	11	80	0.1375000
NODE_16299_length_708_cov_19.998358	291	371	4	9	80	0.1125000
NODE_16299_length_708_cov_19.998358	291	371	5	50	80	0.6250000
NODE_16299_length_708_cov_19.998358	291	371	6	12	80	0.1500000
NODE_16299_length_708_cov_19.998358	291	371	7	9	80	0.1125000
NODE_16300_length_708_cov_19.021346	366	446	1	70	80	0.8750000
NODE_16300_length_708_cov_19.021346	366	446	2	10	80	0.1250000
NODE_16300_length_708_cov_19.021346	419	499	1	47	80	0.5875000
NODE_16300_length_708_cov_19.021346	419	499	2	33	80	0.4125000
NODE_16302_length_708_cov_12.228243	181	263	0	29	82	0.3536585
NODE_16302_length_708_cov_12.228243	181	263	1	21	82	0.2560976
NODE_16302_length_708_cov_12.228243	181	263	2	11	82	0.1341463
NODE_16302_length_708_cov_12.228243	181	263	3	21	82	0.2560976
NODE_16302_length_708_cov_12.228243	188	268	0	22	80	0.2750000
NODE_16302_length_708_cov_12.228243	188	268	1	21	80	0.2625000
NODE_16302_length_708_cov_12.228243	188	268	2	11	80	0.1375000
NODE_16302_length_708_cov_12.228243	188	268	3	26	80	0.3250000
NODE_16302_length_708_cov_12.228243	236	316	2	6	80	0.0750000
NODE_16302_length_708_cov_12.228243	236	316	3	74	80	0.9250000
NODE_16302_length_708_cov_12.228243	312	392	1	11	80	0.1375000
NODE_16302_length_708_cov_12.228243	312	392	2	21	80	0.2625000
NODE_16302_length_708_cov_12.228243	312	392	3	48	80	0.6000000
NODE_16302_length_708_cov_12.228243	312	392	1	11	80	0.1375000
NODE_16302_length_708_cov_12.228243	312	392	2	21	80	0.2625000
NODE_16302_length_708_cov_12.228243	312	392	3	48	80	0.6000000
NODE_16302_length_708_cov_12.228243	365	445	0	53	80	0.6625000
NODE_16302_length_708_cov_12.228243	365	445	1	11	80	0.1375000
NODE_16302_length_708_cov_12.228243	365	445	2	16	80	0.2000000
NODE_16303_length_708_cov_11.338259	255	335	0	77	80	0.9625000
NODE_16303_length_708_cov_11.338259	255	335	1	3	80	0.0375000
NODE_16303_length_708_cov_11.338259	308	388	0	24	80	0.3000000
NODE_16303_length_708_cov_11.338259	308	388	1	56	80	0.7000000
NODE_16305_length_708_cov_9.676519	219	299	0	79	80	0.9875000
NODE_16305_length_708_cov_9.676519	219	299	1	1	80	0.0125000
NODE_16305_length_708_cov_9.676519	272	352	0	26	80	0.3250000
NODE_16305_length_708_cov_9.676519	272	352	1	22	80	0.2750000
NODE_16305_length_708_cov_9.676519	272	352	2	32	80	0.4000000
NODE_16306_length_708_cov_8.638752	324	399	4	75	75	1.0000000
NODE_16330_length_708_cov_2.699507	358	398	0	40	40	1.0000000
NODE_16370_length_707_cov_30.067434	325	405	7	5	80	0.0625000
NODE_16370_length_707_cov_30.067434	325	405	8	24	80	0.3000000
NODE_16370_length_707_cov_30.067434	325	405	9	51	80	0.6375000
NODE_16370_length_707_cov_30.067434	378	458	4	1	80	0.0125000
NODE_16370_length_707_cov_30.067434	378	458	6	18	80	0.2250000
NODE_16370_length_707_cov_30.067434	378	458	7	1	80	0.0125000
NODE_16370_length_707_cov_30.067434	378	458	8	11	80	0.1375000
NODE_16370_length_707_cov_30.067434	378	458	9	48	80	0.6000000
NODE_16370_length_707_cov_30.067434	378	458	10	1	80	0.0125000
NODE_16371_length_707_cov_26.555921	241	321	5	6	80	0.0750000
NODE_16371_length_707_cov_26.555921	241	321	8	29	80	0.3625000
NODE_16371_length_707_cov_26.555921	241	321	9	7	80	0.0875000
NODE_16371_length_707_cov_26.555921	241	321	10	6	80	0.0750000
NODE_16371_length_707_cov_26.555921	241	321	12	18	80	0.2250000
NODE_16371_length_707_cov_26.555921	241	321	13	14	80	0.1750000
NODE_16371_length_707_cov_26.555921	294	374	10	6	80	0.0750000
NODE_16371_length_707_cov_26.555921	294	374	12	24	80	0.3000000
NODE_16371_length_707_cov_26.555921	294	374	13	50	80	0.6250000
NODE_16372_length_707_cov_23.972039	322	402	0	80	80	1.0000000
NODE_16372_length_707_cov_23.972039	375	455	0	80	80	1.0000000
NODE_16373_length_707_cov_20.348684	157	237	5	6	80	0.0750000
NODE_16373_length_707_cov_20.348684	157	237	7	1	80	0.0125000
NODE_16373_length_707_cov_20.348684	157	237	8	18	80	0.2250000
NODE_16373_length_707_cov_20.348684	157	237	9	55	80	0.6875000
NODE_16373_length_707_cov_20.348684	210	281	4	32	71	0.4507042
NODE_16373_length_707_cov_20.348684	210	281	6	6	71	0.0845070
NODE_16373_length_707_cov_20.348684	210	281	8	24	71	0.3380282
NODE_16373_length_707_cov_20.348684	210	281	9	9	71	0.1267606
NODE_16374_length_707_cov_18.970395	253	333	5	7	80	0.0875000
NODE_16374_length_707_cov_18.970395	253	333	6	5	80	0.0625000
NODE_16374_length_707_cov_18.970395	253	333	7	56	80	0.7000000
NODE_16374_length_707_cov_18.970395	253	333	8	12	80	0.1500000
NODE_16374_length_707_cov_18.970395	306	386	3	7	80	0.0875000
NODE_16374_length_707_cov_18.970395	306	386	4	9	80	0.1125000
NODE_16374_length_707_cov_18.970395	306	386	5	13	80	0.1625000
NODE_16374_length_707_cov_18.970395	306	386	6	29	80	0.3625000
NODE_16374_length_707_cov_18.970395	306	386	7	10	80	0.1250000
NODE_16374_length_707_cov_18.970395	306	386	8	12	80	0.1500000
NODE_16375_length_707_cov_14.324013	302	382	2	45	80	0.5625000
NODE_16375_length_707_cov_14.324013	302	382	4	35	80	0.4375000
NODE_16375_length_707_cov_14.324013	355	435	0	14	80	0.1750000
NODE_16375_length_707_cov_14.324013	355	435	1	37	80	0.4625000
NODE_16375_length_707_cov_14.324013	355	435	2	29	80	0.3625000
NODE_16378_length_707_cov_5.062500	313	393	0	80	80	1.0000000
NODE_16441_length_706_cov_34.116969	272	352	7	30	80	0.3750000
NODE_16441_length_706_cov_34.116969	272	352	11	50	80	0.6250000
NODE_16441_length_706_cov_34.116969	325	405	4	7	80	0.0875000
NODE_16441_length_706_cov_34.116969	325	405	6	7	80	0.0875000
NODE_16441_length_706_cov_34.116969	325	405	7	4	80	0.0500000
NODE_16441_length_706_cov_34.116969	325	405	10	19	80	0.2375000
NODE_16441_length_706_cov_34.116969	325	405	11	43	80	0.5375000
NODE_16442_length_706_cov_27.220758	229	309	0	9	80	0.1125000
NODE_16442_length_706_cov_27.220758	229	309	2	44	80	0.5500000
NODE_16442_length_706_cov_27.220758	229	309	3	7	80	0.0875000
NODE_16442_length_706_cov_27.220758	229	309	5	20	80	0.2500000
NODE_16442_length_706_cov_27.220758	282	362	3	7	80	0.0875000
NODE_16442_length_706_cov_27.220758	282	362	5	26	80	0.3250000
NODE_16442_length_706_cov_27.220758	282	362	7	47	80	0.5875000
NODE_16443_length_706_cov_20.380560	264	344	2	69	80	0.8625000
NODE_16443_length_706_cov_20.380560	264	344	4	11	80	0.1375000
NODE_16443_length_706_cov_20.380560	317	397	2	51	80	0.6375000
NODE_16443_length_706_cov_20.380560	317	397	4	29	80	0.3625000
NODE_16444_length_706_cov_19.525535	289	369	0	35	80	0.4375000
NODE_16444_length_706_cov_19.525535	289	369	1	1	80	0.0125000
NODE_16444_length_706_cov_19.525535	289	369	3	21	80	0.2625000
NODE_16444_length_706_cov_19.525535	289	369	6	23	80	0.2875000
NODE_16444_length_706_cov_19.525535	342	422	3	4	80	0.0500000
NODE_16444_length_706_cov_19.525535	342	422	6	30	80	0.3750000
NODE_16444_length_706_cov_19.525535	342	422	7	46	80	0.5750000
NODE_16454_length_706_cov_3.344316	465	545	0	80	80	1.0000000
NODE_16454_length_706_cov_3.344316	518	598	0	80	80	1.0000000
NODE_16494_length_705_cov_19.211221	118	198	4	6	80	0.0750000
NODE_16494_length_705_cov_19.211221	118	198	5	1	80	0.0125000
NODE_16494_length_705_cov_19.211221	118	198	6	73	80	0.9125000
NODE_16494_length_705_cov_19.211221	171	250	6	31	79	0.3924051
NODE_16494_length_705_cov_19.211221	171	250	8	4	79	0.0506329
NODE_16494_length_705_cov_19.211221	171	250	9	44	79	0.5569620
NODE_16495_length_705_cov_16.338284	291	339	2	48	48	1.0000000
NODE_16495_length_705_cov_16.338284	336	406	0	16	70	0.2285714
NODE_16495_length_705_cov_16.338284	336	406	2	54	70	0.7714286
NODE_16496_length_705_cov_14.354785	209	289	4	38	80	0.4750000
NODE_16496_length_705_cov_14.354785	209	289	5	1	80	0.0125000
NODE_16496_length_705_cov_14.354785	209	289	6	41	80	0.5125000
NODE_16496_length_705_cov_14.354785	262	342	1	2	80	0.0250000
NODE_16496_length_705_cov_14.354785	262	342	2	12	80	0.1500000
NODE_16496_length_705_cov_14.354785	262	342	4	66	80	0.8250000
NODE_16497_length_705_cov_12.231023	293	373	1	17	80	0.2125000
NODE_16497_length_705_cov_12.231023	293	373	2	10	80	0.1250000
NODE_16497_length_705_cov_12.231023	293	373	3	8	80	0.1000000
NODE_16497_length_705_cov_12.231023	293	373	5	9	80	0.1125000
NODE_16497_length_705_cov_12.231023	293	373	6	17	80	0.2125000
NODE_16497_length_705_cov_12.231023	293	373	7	12	80	0.1500000
NODE_16497_length_705_cov_12.231023	293	373	8	7	80	0.0875000
NODE_16497_length_705_cov_12.231023	346	426	6	8	80	0.1000000
NODE_16497_length_705_cov_12.231023	346	426	7	12	80	0.1500000
NODE_16497_length_705_cov_12.231023	346	426	8	14	80	0.1750000
NODE_16497_length_705_cov_12.231023	346	426	9	5	80	0.0625000
NODE_16497_length_705_cov_12.231023	346	426	10	37	80	0.4625000
NODE_16497_length_705_cov_12.231023	346	426	11	4	80	0.0500000
NODE_16498_length_705_cov_11.836634	390	470	2	65	80	0.8125000
NODE_16498_length_705_cov_11.836634	390	470	3	15	80	0.1875000
NODE_16498_length_705_cov_11.836634	443	523	1	32	80	0.4000000
NODE_16498_length_705_cov_11.836634	443	523	2	48	80	0.6000000
NODE_16499_length_705_cov_10.049505	382	479	2	97	97	1.0000000
NODE_16499_length_705_cov_10.049505	452	532	0	43	80	0.5375000
NODE_16499_length_705_cov_10.049505	452	532	2	37	80	0.4625000
NODE_16507_length_705_cov_4.275578	358	438	0	80	80	1.0000000
NODE_16507_length_705_cov_4.275578	411	491	0	80	80	1.0000000
NODE_16509_length_705_cov_4.018152	306	364	0	58	58	1.0000000
NODE_16509_length_705_cov_4.018152	337	410	0	73	73	1.0000000
NODE_16511_length_705_cov_3.620462	253	315	4	1	62	0.0161290
NODE_16511_length_705_cov_3.620462	253	315	6	13	62	0.2096774
NODE_16511_length_705_cov_3.620462	253	315	10	48	62	0.7741935
NODE_16511_length_705_cov_3.620462	308	368	4	54	60	0.9000000
NODE_16511_length_705_cov_3.620462	308	368	6	6	60	0.1000000
NODE_16527_length_705_cov_1.607261	462	531	0	69	69	1.0000000
NODE_16549_length_705_cov_0.529703	33	97	0	64	64	1.0000000
NODE_16549_length_705_cov_0.529703	86	150	0	64	64	1.0000000
NODE_16550_length_704_cov_18.256198	295	375	3	12	80	0.1500000
NODE_16550_length_704_cov_18.256198	295	375	4	48	80	0.6000000
NODE_16550_length_704_cov_18.256198	295	375	5	9	80	0.1125000
NODE_16550_length_704_cov_18.256198	295	375	6	11	80	0.1375000
NODE_16550_length_704_cov_18.256198	348	428	2	35	80	0.4375000
NODE_16550_length_704_cov_18.256198	348	428	3	21	80	0.2625000
NODE_16550_length_704_cov_18.256198	348	428	4	24	80	0.3000000
NODE_16552_length_704_cov_16.662810	264	344	0	80	80	1.0000000
NODE_16552_length_704_cov_16.662810	317	397	0	80	80	1.0000000
NODE_16553_length_704_cov_12.641322	294	374	0	8	80	0.1000000
NODE_16553_length_704_cov_12.641322	294	374	1	31	80	0.3875000
NODE_16553_length_704_cov_12.641322	294	374	4	1	80	0.0125000
NODE_16553_length_704_cov_12.641322	294	374	5	12	80	0.1500000
NODE_16553_length_704_cov_12.641322	294	374	6	28	80	0.3500000
NODE_16553_length_704_cov_12.641322	347	427	5	23	80	0.2875000
NODE_16553_length_704_cov_12.641322	347	427	6	57	80	0.7125000
NODE_16557_length_704_cov_5.603306	440	498	0	58	58	1.0000000
NODE_16564_length_704_cov_3.535537	303	383	0	80	80	1.0000000
NODE_16564_length_704_cov_3.535537	369	436	0	67	67	1.0000000
NODE_16578_length_704_cov_1.963636	345	425	0	10	80	0.1250000
NODE_16578_length_704_cov_1.963636	345	425	1	41	80	0.5125000
NODE_16578_length_704_cov_1.963636	345	425	2	29	80	0.3625000
NODE_16578_length_704_cov_1.963636	398	478	2	80	80	1.0000000
NODE_16598_length_703_cov_44.102649	514	594	2	80	80	1.0000000
NODE_16598_length_703_cov_44.102649	567	647	0	4	80	0.0500000
NODE_16598_length_703_cov_44.102649	567	647	1	4	80	0.0500000
NODE_16598_length_703_cov_44.102649	567	647	2	72	80	0.9000000
NODE_16599_length_703_cov_33.067881	521	594	14	8	73	0.1095890
NODE_16599_length_703_cov_33.067881	521	594	20	3	73	0.0410959
NODE_16599_length_703_cov_33.067881	521	594	22	1	73	0.0136986
NODE_16599_length_703_cov_33.067881	521	594	23	16	73	0.2191781
NODE_16599_length_703_cov_33.067881	521	594	24	45	73	0.6164383
NODE_16599_length_703_cov_33.067881	561	602	14	16	41	0.3902439
NODE_16599_length_703_cov_33.067881	561	602	20	3	41	0.0731707
NODE_16599_length_703_cov_33.067881	561	602	23	15	41	0.3658537
NODE_16599_length_703_cov_33.067881	561	602	24	7	41	0.1707317
NODE_16600_length_703_cov_30.266556	312	392	9	13	80	0.1625000
NODE_16600_length_703_cov_30.266556	312	392	10	18	80	0.2250000
NODE_16600_length_703_cov_30.266556	312	392	11	30	80	0.3750000
NODE_16600_length_703_cov_30.266556	312	392	12	1	80	0.0125000
NODE_16600_length_703_cov_30.266556	312	392	13	18	80	0.2250000
NODE_16600_length_703_cov_30.266556	365	445	8	9	80	0.1125000
NODE_16600_length_703_cov_30.266556	365	445	9	11	80	0.1375000
NODE_16600_length_703_cov_30.266556	365	445	10	17	80	0.2125000
NODE_16600_length_703_cov_30.266556	365	445	11	22	80	0.2750000
NODE_16600_length_703_cov_30.266556	365	445	12	3	80	0.0375000
NODE_16600_length_703_cov_30.266556	365	445	13	18	80	0.2250000
NODE_16601_length_703_cov_17.006623	449	529	5	1	80	0.0125000
NODE_16601_length_703_cov_17.006623	449	529	6	2	80	0.0250000
NODE_16601_length_703_cov_17.006623	449	529	7	35	80	0.4375000
NODE_16601_length_703_cov_17.006623	449	529	8	40	80	0.5000000
NODE_16601_length_703_cov_17.006623	449	529	10	2	80	0.0250000
NODE_16601_length_703_cov_17.006623	502	582	6	40	80	0.5000000
NODE_16601_length_703_cov_17.006623	502	582	7	40	80	0.5000000
NODE_16602_length_703_cov_14.801325	383	463	4	37	80	0.4625000
NODE_16602_length_703_cov_14.801325	383	463	5	43	80	0.5375000
NODE_16602_length_703_cov_14.801325	436	516	0	8	80	0.1000000
NODE_16602_length_703_cov_14.801325	436	516	1	28	80	0.3500000
NODE_16602_length_703_cov_14.801325	436	516	2	1	80	0.0125000
NODE_16602_length_703_cov_14.801325	436	516	4	43	80	0.5375000
NODE_16603_length_703_cov_11.766556	308	388	6	14	80	0.1750000
NODE_16603_length_703_cov_11.766556	308	388	8	56	80	0.7000000
NODE_16603_length_703_cov_11.766556	308	388	9	10	80	0.1250000
NODE_16603_length_703_cov_11.766556	361	441	6	35	80	0.4375000
NODE_16603_length_703_cov_11.766556	361	441	8	3	80	0.0375000
NODE_16603_length_703_cov_11.766556	361	441	9	36	80	0.4500000
NODE_16603_length_703_cov_11.766556	361	441	10	5	80	0.0625000
NODE_16603_length_703_cov_11.766556	361	441	12	1	80	0.0125000
NODE_16604_length_703_cov_10.405629	213	293	3	4	80	0.0500000
NODE_16604_length_703_cov_10.405629	213	293	7	20	80	0.2500000
NODE_16604_length_703_cov_10.405629	213	293	8	56	80	0.7000000
NODE_16604_length_703_cov_10.405629	266	301	2	7	35	0.2000000
NODE_16604_length_703_cov_10.405629	266	301	3	5	35	0.1428571
NODE_16604_length_703_cov_10.405629	266	301	7	20	35	0.5714286
NODE_16604_length_703_cov_10.405629	266	301	8	3	35	0.0857143
NODE_16605_length_703_cov_6.966887	381	440	0	59	59	1.0000000
NODE_16616_length_703_cov_3.491722	256	309	2	53	53	1.0000000
NODE_16616_length_703_cov_3.491722	257	337	2	80	80	1.0000000
NODE_16616_length_703_cov_3.491722	305	362	0	16	57	0.2807018
NODE_16616_length_703_cov_3.491722	305	362	2	41	57	0.7192982
NODE_16624_length_703_cov_2.687086	216	296	0	80	80	1.0000000
NODE_16624_length_703_cov_2.687086	269	349	0	80	80	1.0000000
NODE_16663_length_702_cov_49.784411	221	299	8	48	78	0.6153846
NODE_16663_length_702_cov_49.784411	221	299	10	28	78	0.3589744
NODE_16663_length_702_cov_49.784411	221	299	11	2	78	0.0256410
NODE_16663_length_702_cov_49.784411	277	352	5	5	75	0.0666667
NODE_16663_length_702_cov_49.784411	277	352	6	21	75	0.2800000
NODE_16663_length_702_cov_49.784411	277	352	7	23	75	0.3066667
NODE_16663_length_702_cov_49.784411	277	352	8	6	75	0.0800000
NODE_16663_length_702_cov_49.784411	277	352	10	18	75	0.2400000
NODE_16663_length_702_cov_49.784411	277	352	11	2	75	0.0266667
NODE_16664_length_702_cov_26.570481	201	281	2	12	80	0.1500000
NODE_16664_length_702_cov_26.570481	201	281	5	28	80	0.3500000
NODE_16664_length_702_cov_26.570481	201	281	6	40	80	0.5000000
NODE_16664_length_702_cov_26.570481	254	334	5	34	80	0.4250000
NODE_16664_length_702_cov_26.570481	254	334	8	13	80	0.1625000
NODE_16664_length_702_cov_26.570481	254	334	9	33	80	0.4125000
NODE_16665_length_702_cov_23.971808	139	219	8	9	80	0.1125000
NODE_16665_length_702_cov_23.971808	139	219	9	45	80	0.5625000
NODE_16665_length_702_cov_23.971808	139	219	10	26	80	0.3250000
NODE_16665_length_702_cov_23.971808	192	272	3	4	80	0.0500000
NODE_16665_length_702_cov_23.971808	192	272	4	21	80	0.2625000
NODE_16665_length_702_cov_23.971808	192	272	5	2	80	0.0250000
NODE_16665_length_702_cov_23.971808	192	272	6	3	80	0.0375000
NODE_16665_length_702_cov_23.971808	192	272	9	49	80	0.6125000
NODE_16665_length_702_cov_23.971808	192	272	10	1	80	0.0125000
NODE_16665_length_702_cov_23.971808	268	348	4	52	80	0.6500000
NODE_16665_length_702_cov_23.971808	268	348	5	16	80	0.2000000
NODE_16665_length_702_cov_23.971808	268	348	6	12	80	0.1500000
NODE_16665_length_702_cov_23.971808	321	401	4	47	80	0.5875000
NODE_16665_length_702_cov_23.971808	321	401	5	33	80	0.4125000
NODE_16666_length_702_cov_23.827529	448	528	5	10	80	0.1250000
NODE_16666_length_702_cov_23.827529	448	528	6	26	80	0.3250000
NODE_16666_length_702_cov_23.827529	448	528	7	6	80	0.0750000
NODE_16666_length_702_cov_23.827529	448	528	8	38	80	0.4750000
NODE_16666_length_702_cov_23.827529	501	581	4	46	80	0.5750000
NODE_16666_length_702_cov_23.827529	501	581	6	12	80	0.1500000
NODE_16666_length_702_cov_23.827529	501	581	7	4	80	0.0500000
NODE_16666_length_702_cov_23.827529	501	581	8	18	80	0.2250000
NODE_16667_length_702_cov_14.661692	424	504	1	11	80	0.1375000
NODE_16667_length_702_cov_14.661692	424	504	2	12	80	0.1500000
NODE_16667_length_702_cov_14.661692	424	504	4	26	80	0.3250000
NODE_16667_length_702_cov_14.661692	424	504	5	31	80	0.3875000
NODE_16667_length_702_cov_14.661692	477	557	4	36	80	0.4500000
NODE_16667_length_702_cov_14.661692	477	557	5	7	80	0.0875000
NODE_16667_length_702_cov_14.661692	477	557	6	37	80	0.4625000
NODE_16668_length_702_cov_13.908789	259	304	11	18	45	0.4000000
NODE_16668_length_702_cov_13.908789	259	304	13	7	45	0.1555556
NODE_16668_length_702_cov_13.908789	259	304	14	20	45	0.4444444
NODE_16668_length_702_cov_13.908789	277	357	6	2	80	0.0250000
NODE_16668_length_702_cov_13.908789	277	357	8	6	80	0.0750000
NODE_16668_length_702_cov_13.908789	277	357	9	21	80	0.2625000
NODE_16668_length_702_cov_13.908789	277	357	11	24	80	0.3000000
NODE_16668_length_702_cov_13.908789	277	357	13	7	80	0.0875000
NODE_16668_length_702_cov_13.908789	277	357	14	20	80	0.2500000
NODE_16668_length_702_cov_13.908789	289	357	6	2	68	0.0294118
NODE_16668_length_702_cov_13.908789	289	357	8	6	68	0.0882353
NODE_16668_length_702_cov_13.908789	289	357	9	21	68	0.3088235
NODE_16668_length_702_cov_13.908789	289	357	11	24	68	0.3529412
NODE_16668_length_702_cov_13.908789	289	357	13	7	68	0.1029412
NODE_16668_length_702_cov_13.908789	289	357	14	8	68	0.1176471
NODE_16669_length_702_cov_8.502488	337	417	0	80	80	1.0000000
NODE_16669_length_702_cov_8.502488	390	470	0	80	80	1.0000000
NODE_16671_length_702_cov_6.470978	209	289	1	40	80	0.5000000
NODE_16671_length_702_cov_6.470978	209	289	2	40	80	0.5000000
NODE_16671_length_702_cov_6.470978	262	342	1	30	80	0.3750000
NODE_16671_length_702_cov_6.470978	262	342	2	50	80	0.6250000
NODE_16729_length_701_cov_38.715947	178	258	0	49	80	0.6125000
NODE_16729_length_701_cov_38.715947	178	258	1	3	80	0.0375000
NODE_16729_length_701_cov_38.715947	178	258	2	2	80	0.0250000
NODE_16729_length_701_cov_38.715947	178	258	4	19	80	0.2375000
NODE_16729_length_701_cov_38.715947	178	258	5	1	80	0.0125000
NODE_16729_length_701_cov_38.715947	178	258	6	6	80	0.0750000
NODE_16729_length_701_cov_38.715947	231	311	2	1	80	0.0125000
NODE_16729_length_701_cov_38.715947	231	311	4	19	80	0.2375000
NODE_16729_length_701_cov_38.715947	231	311	5	1	80	0.0125000
NODE_16729_length_701_cov_38.715947	231	311	6	47	80	0.5875000
NODE_16729_length_701_cov_38.715947	231	311	8	12	80	0.1500000
NODE_16729_length_701_cov_38.715947	307	387	4	5	80	0.0625000
NODE_16729_length_701_cov_38.715947	307	387	6	2	80	0.0250000
NODE_16729_length_701_cov_38.715947	307	387	7	3	80	0.0375000
NODE_16729_length_701_cov_38.715947	307	387	8	70	80	0.8750000
NODE_16729_length_701_cov_38.715947	360	440	2	38	80	0.4750000
NODE_16729_length_701_cov_38.715947	360	440	3	1	80	0.0125000
NODE_16729_length_701_cov_38.715947	360	440	4	19	80	0.2375000
NODE_16729_length_701_cov_38.715947	360	440	6	2	80	0.0250000
NODE_16729_length_701_cov_38.715947	360	440	7	3	80	0.0375000
NODE_16729_length_701_cov_38.715947	360	440	8	17	80	0.2125000
NODE_16730_length_701_cov_28.059801	432	513	11	8	81	0.0987654
NODE_16730_length_701_cov_28.059801	432	513	12	17	81	0.2098765
NODE_16730_length_701_cov_28.059801	432	513	13	24	81	0.2962963
NODE_16730_length_701_cov_28.059801	432	513	14	21	81	0.2592593
NODE_16730_length_701_cov_28.059801	432	513	15	5	81	0.0617284
NODE_16730_length_701_cov_28.059801	432	513	16	6	81	0.0740741
NODE_16730_length_701_cov_28.059801	486	566	9	2	80	0.0250000
NODE_16730_length_701_cov_28.059801	486	566	10	25	80	0.3125000
NODE_16730_length_701_cov_28.059801	486	566	14	16	80	0.2000000
NODE_16730_length_701_cov_28.059801	486	566	15	11	80	0.1375000
NODE_16730_length_701_cov_28.059801	486	566	16	17	80	0.2125000
NODE_16730_length_701_cov_28.059801	486	566	18	8	80	0.1000000
NODE_16730_length_701_cov_28.059801	486	566	19	1	80	0.0125000
NODE_16731_length_701_cov_18.387043	258	338	5	50	80	0.6250000
NODE_16731_length_701_cov_18.387043	258	338	6	30	80	0.3750000
NODE_16731_length_701_cov_18.387043	311	391	3	2	80	0.0250000
NODE_16731_length_701_cov_18.387043	311	391	4	10	80	0.1250000
NODE_16731_length_701_cov_18.387043	311	391	5	15	80	0.1875000
NODE_16731_length_701_cov_18.387043	311	391	6	28	80	0.3500000
NODE_16731_length_701_cov_18.387043	311	391	8	25	80	0.3125000
NODE_16732_length_701_cov_17.122924	295	367	0	72	72	1.0000000
NODE_16733_length_701_cov_16.114618	242	322	2	28	80	0.3500000
NODE_16733_length_701_cov_16.114618	242	322	3	35	80	0.4375000
NODE_16733_length_701_cov_16.114618	242	322	4	7	80	0.0875000
NODE_16733_length_701_cov_16.114618	242	322	5	8	80	0.1000000
NODE_16733_length_701_cov_16.114618	242	322	6	2	80	0.0250000
NODE_16733_length_701_cov_16.114618	295	375	3	10	80	0.1250000
NODE_16733_length_701_cov_16.114618	295	375	4	7	80	0.0875000
NODE_16733_length_701_cov_16.114618	295	375	5	8	80	0.1000000
NODE_16733_length_701_cov_16.114618	295	375	6	52	80	0.6500000
NODE_16733_length_701_cov_16.114618	295	375	8	3	80	0.0375000
NODE_16734_length_701_cov_15.588040	399	479	8	17	80	0.2125000
NODE_16734_length_701_cov_15.588040	399	479	9	23	80	0.2875000
NODE_16734_length_701_cov_15.588040	399	479	10	40	80	0.5000000
NODE_16734_length_701_cov_15.588040	452	532	6	4	80	0.0500000
NODE_16734_length_701_cov_15.588040	452	532	7	1	80	0.0125000
NODE_16734_length_701_cov_15.588040	452	532	8	46	80	0.5750000
NODE_16734_length_701_cov_15.588040	452	532	9	25	80	0.3125000
NODE_16734_length_701_cov_15.588040	452	532	10	4	80	0.0500000
NODE_16736_length_701_cov_11.420266	229	309	0	80	80	1.0000000
NODE_16736_length_701_cov_11.420266	282	362	0	80	80	1.0000000
NODE_16737_length_701_cov_10.411960	202	283	4	11	81	0.1358025
NODE_16737_length_701_cov_10.411960	202	283	5	7	81	0.0864198
NODE_16737_length_701_cov_10.411960	202	283	7	49	81	0.6049383
NODE_16737_length_701_cov_10.411960	202	283	8	8	81	0.0987654
NODE_16737_length_701_cov_10.411960	202	283	10	6	81	0.0740741
NODE_16737_length_701_cov_10.411960	256	336	7	13	80	0.1625000
NODE_16737_length_701_cov_10.411960	256	336	8	20	80	0.2500000
NODE_16737_length_701_cov_10.411960	256	336	9	2	80	0.0250000
NODE_16737_length_701_cov_10.411960	256	336	10	45	80	0.5625000
NODE_16738_length_701_cov_9.107973	400	480	1	80	80	1.0000000
NODE_16738_length_701_cov_9.107973	453	533	1	80	80	1.0000000
NODE_16739_length_701_cov_8.877076	283	363	0	80	80	1.0000000
NODE_16739_length_701_cov_8.877076	336	416	0	80	80	1.0000000
NODE_16740_length_701_cov_8.543189	341	421	4	17	80	0.2125000
NODE_16740_length_701_cov_8.543189	341	421	6	3	80	0.0375000
NODE_16740_length_701_cov_8.543189	341	421	7	36	80	0.4500000
NODE_16740_length_701_cov_8.543189	341	421	8	24	80	0.3000000
NODE_16740_length_701_cov_8.543189	394	474	7	62	80	0.7750000
NODE_16740_length_701_cov_8.543189	394	474	8	15	80	0.1875000
NODE_16740_length_701_cov_8.543189	394	474	9	3	80	0.0375000
NODE_16742_length_701_cov_6.317276	273	353	0	6	80	0.0750000
NODE_16742_length_701_cov_6.317276	273	353	1	74	80	0.9250000
NODE_16742_length_701_cov_6.317276	326	382	1	29	56	0.5178571
NODE_16742_length_701_cov_6.317276	326	382	2	8	56	0.1428571
NODE_16742_length_701_cov_6.317276	326	382	3	19	56	0.3392857
NODE_16747_length_701_cov_5.081395	318	374	1	56	56	1.0000000
NODE_16752_length_701_cov_3.320598	207	287	0	80	80	1.0000000
NODE_16752_length_701_cov_3.320598	260	340	0	80	80	1.0000000
NODE_16794_length_700_cov_22.241265	326	406	13	6	80	0.0750000
NODE_16794_length_700_cov_22.241265	326	406	21	11	80	0.1375000
NODE_16794_length_700_cov_22.241265	326	406	22	8	80	0.1000000
NODE_16794_length_700_cov_22.241265	326	406	23	5	80	0.0625000
NODE_16794_length_700_cov_22.241265	326	406	24	19	80	0.2375000
NODE_16794_length_700_cov_22.241265	326	406	25	26	80	0.3250000
NODE_16794_length_700_cov_22.241265	326	406	26	5	80	0.0625000
NODE_16796_length_700_cov_11.730449	294	374	10	8	80	0.1000000
NODE_16796_length_700_cov_11.730449	294	374	11	57	80	0.7125000
NODE_16796_length_700_cov_11.730449	294	374	12	1	80	0.0125000
NODE_16796_length_700_cov_11.730449	294	374	13	14	80	0.1750000
NODE_16796_length_700_cov_11.730449	347	427	6	7	80	0.0875000
NODE_16796_length_700_cov_11.730449	347	427	8	14	80	0.1750000
NODE_16796_length_700_cov_11.730449	347	427	9	19	80	0.2375000
NODE_16796_length_700_cov_11.730449	347	427	10	3	80	0.0375000
NODE_16796_length_700_cov_11.730449	347	427	11	36	80	0.4500000
NODE_16796_length_700_cov_11.730449	347	427	12	1	80	0.0125000
NODE_16800_length_700_cov_7.291181	317	397	0	80	80	1.0000000
NODE_16800_length_700_cov_7.291181	370	450	0	80	80	1.0000000
NODE_16801_length_700_cov_6.557404	353	404	0	51	51	1.0000000
NODE_16802_length_700_cov_5.475874	301	381	0	80	80	1.0000000
NODE_16802_length_700_cov_5.475874	354	434	0	80	80	1.0000000
NODE_16803_length_700_cov_3.960067	158	234	0	76	76	1.0000000
NODE_16803_length_700_cov_3.960067	209	291	0	82	82	1.0000000
NODE_16822_length_700_cov_1.517471	324	404	0	80	80	1.0000000
NODE_16822_length_700_cov_1.517471	377	457	0	80	80	1.0000000
NODE_16844_length_699_cov_18.446667	185	265	42	4	80	0.0500000
NODE_16844_length_699_cov_18.446667	185	265	44	4	80	0.0500000
NODE_16844_length_699_cov_18.446667	185	265	47	10	80	0.1250000
NODE_16844_length_699_cov_18.446667	185	265	48	7	80	0.0875000
NODE_16844_length_699_cov_18.446667	185	265	49	15	80	0.1875000
NODE_16844_length_699_cov_18.446667	185	265	50	7	80	0.0875000
NODE_16844_length_699_cov_18.446667	185	265	51	6	80	0.0750000
NODE_16844_length_699_cov_18.446667	185	265	52	5	80	0.0625000
NODE_16844_length_699_cov_18.446667	185	265	53	15	80	0.1875000
NODE_16844_length_699_cov_18.446667	185	265	56	4	80	0.0500000
NODE_16844_length_699_cov_18.446667	185	265	58	3	80	0.0375000
NODE_16844_length_699_cov_18.446667	238	318	40	5	80	0.0625000
NODE_16844_length_699_cov_18.446667	238	318	41	4	80	0.0500000
NODE_16844_length_699_cov_18.446667	238	318	42	1	80	0.0125000
NODE_16844_length_699_cov_18.446667	238	318	44	1	80	0.0125000
NODE_16844_length_699_cov_18.446667	238	318	45	2	80	0.0250000
NODE_16844_length_699_cov_18.446667	238	318	47	1	80	0.0125000
NODE_16844_length_699_cov_18.446667	238	318	48	7	80	0.0875000
NODE_16844_length_699_cov_18.446667	238	318	49	8	80	0.1000000
NODE_16844_length_699_cov_18.446667	238	318	50	1	80	0.0125000
NODE_16844_length_699_cov_18.446667	238	318	51	2	80	0.0250000
NODE_16844_length_699_cov_18.446667	238	318	52	1	80	0.0125000
NODE_16844_length_699_cov_18.446667	238	318	53	11	80	0.1375000
NODE_16844_length_699_cov_18.446667	238	318	54	7	80	0.0875000
NODE_16844_length_699_cov_18.446667	238	318	55	6	80	0.0750000
NODE_16844_length_699_cov_18.446667	238	318	56	7	80	0.0875000
NODE_16844_length_699_cov_18.446667	238	318	57	8	80	0.1000000
NODE_16844_length_699_cov_18.446667	238	318	58	8	80	0.1000000
NODE_16845_length_699_cov_18.383333	258	338	0	80	80	1.0000000
NODE_16845_length_699_cov_18.383333	311	391	0	80	80	1.0000000
NODE_16846_length_699_cov_18.103333	218	298	11	34	80	0.4250000
NODE_16846_length_699_cov_18.103333	218	298	12	20	80	0.2500000
NODE_16846_length_699_cov_18.103333	218	298	13	8	80	0.1000000
NODE_16846_length_699_cov_18.103333	218	298	14	18	80	0.2250000
NODE_16846_length_699_cov_18.103333	271	351	9	22	80	0.2750000
NODE_16846_length_699_cov_18.103333	271	351	11	58	80	0.7250000
NODE_16847_length_699_cov_15.636667	279	359	6	2	80	0.0250000
NODE_16847_length_699_cov_15.636667	279	359	7	4	80	0.0500000
NODE_16847_length_699_cov_15.636667	279	359	10	47	80	0.5875000
NODE_16847_length_699_cov_15.636667	279	359	11	16	80	0.2000000
NODE_16847_length_699_cov_15.636667	279	359	12	11	80	0.1375000
NODE_16847_length_699_cov_15.636667	332	412	9	6	80	0.0750000
NODE_16847_length_699_cov_15.636667	332	412	10	39	80	0.4875000
NODE_16847_length_699_cov_15.636667	332	412	11	34	80	0.4250000
NODE_16847_length_699_cov_15.636667	332	412	12	1	80	0.0125000
NODE_16848_length_699_cov_15.113333	313	393	1	8	80	0.1000000
NODE_16848_length_699_cov_15.113333	313	393	2	24	80	0.3000000
NODE_16848_length_699_cov_15.113333	313	393	3	48	80	0.6000000
NODE_16848_length_699_cov_15.113333	366	446	1	17	80	0.2125000
NODE_16848_length_699_cov_15.113333	366	446	2	63	80	0.7875000
NODE_16849_length_699_cov_10.070000	233	313	0	80	80	1.0000000
NODE_16849_length_699_cov_10.070000	286	366	0	80	80	1.0000000
NODE_16849_length_699_cov_10.070000	362	442	0	80	80	1.0000000
NODE_16849_length_699_cov_10.070000	415	495	0	80	80	1.0000000
NODE_16850_length_699_cov_8.083333	347	427	0	80	80	1.0000000
NODE_16850_length_699_cov_8.083333	400	480	0	80	80	1.0000000
NODE_16851_length_699_cov_7.758333	307	387	1	80	80	1.0000000
NODE_16851_length_699_cov_7.758333	360	440	1	80	80	1.0000000
NODE_16852_length_699_cov_7.713333	252	332	0	80	80	1.0000000
NODE_16852_length_699_cov_7.713333	305	385	0	80	80	1.0000000
NODE_16853_length_699_cov_7.186667	271	332	5	1	61	0.0163934
NODE_16853_length_699_cov_7.186667	271	332	10	15	61	0.2459016
NODE_16853_length_699_cov_7.186667	271	332	16	1	61	0.0163934
NODE_16853_length_699_cov_7.186667	271	332	18	9	61	0.1475410
NODE_16853_length_699_cov_7.186667	271	332	19	34	61	0.5573770
NODE_16853_length_699_cov_7.186667	271	332	20	1	61	0.0163934
NODE_16853_length_699_cov_7.186667	348	428	16	17	80	0.2125000
NODE_16853_length_699_cov_7.186667	348	428	19	7	80	0.0875000
NODE_16853_length_699_cov_7.186667	348	428	20	19	80	0.2375000
NODE_16853_length_699_cov_7.186667	348	428	21	21	80	0.2625000
NODE_16853_length_699_cov_7.186667	348	428	22	16	80	0.2000000
NODE_16857_length_699_cov_5.815000	243	316	0	38	73	0.5205479
NODE_16857_length_699_cov_5.815000	243	316	1	35	73	0.4794520
NODE_16857_length_699_cov_5.815000	293	374	1	32	81	0.3950617
NODE_16857_length_699_cov_5.815000	293	374	2	18	81	0.2222222
NODE_16857_length_699_cov_5.815000	293	374	3	31	81	0.3827161
NODE_16858_length_699_cov_5.520000	302	382	0	80	80	1.0000000
NODE_16858_length_699_cov_5.520000	355	435	0	80	80	1.0000000
NODE_16860_length_699_cov_4.051667	289	369	0	42	80	0.5250000
NODE_16860_length_699_cov_4.051667	289	369	1	9	80	0.1125000
NODE_16860_length_699_cov_4.051667	289	369	2	29	80	0.3625000
NODE_16860_length_699_cov_4.051667	342	422	2	79	80	0.9875000
NODE_16860_length_699_cov_4.051667	342	422	3	1	80	0.0125000
NODE_16868_length_699_cov_2.498333	204	284	0	80	80	1.0000000
NODE_16868_length_699_cov_2.498333	257	337	0	80	80	1.0000000
NODE_16908_length_698_cov_47.350584	321	401	30	9	80	0.1125000
NODE_16908_length_698_cov_47.350584	321	401	31	4	80	0.0500000
NODE_16908_length_698_cov_47.350584	321	401	32	3	80	0.0375000
NODE_16908_length_698_cov_47.350584	321	401	33	1	80	0.0125000
NODE_16908_length_698_cov_47.350584	321	401	36	1	80	0.0125000
NODE_16908_length_698_cov_47.350584	321	401	38	11	80	0.1375000
NODE_16908_length_698_cov_47.350584	321	401	46	1	80	0.0125000
NODE_16908_length_698_cov_47.350584	321	401	48	28	80	0.3500000
NODE_16908_length_698_cov_47.350584	321	401	49	16	80	0.2000000
NODE_16908_length_698_cov_47.350584	321	401	50	5	80	0.0625000
NODE_16908_length_698_cov_47.350584	321	401	51	1	80	0.0125000
NODE_16908_length_698_cov_47.350584	374	454	31	9	80	0.1125000
NODE_16908_length_698_cov_47.350584	374	454	33	11	80	0.1375000
NODE_16908_length_698_cov_47.350584	374	454	34	6	80	0.0750000
NODE_16908_length_698_cov_47.350584	374	454	36	2	80	0.0250000
NODE_16908_length_698_cov_47.350584	374	454	37	12	80	0.1500000
NODE_16908_length_698_cov_47.350584	374	454	38	5	80	0.0625000
NODE_16908_length_698_cov_47.350584	374	454	39	6	80	0.0750000
NODE_16908_length_698_cov_47.350584	374	454	48	7	80	0.0875000
NODE_16908_length_698_cov_47.350584	374	454	49	14	80	0.1750000
NODE_16908_length_698_cov_47.350584	374	454	50	7	80	0.0875000
NODE_16908_length_698_cov_47.350584	374	454	51	1	80	0.0125000
NODE_16909_length_698_cov_42.848080	255	335	13	80	80	1.0000000
NODE_16909_length_698_cov_42.848080	308	388	8	3	80	0.0375000
NODE_16909_length_698_cov_42.848080	308	388	10	4	80	0.0500000
NODE_16909_length_698_cov_42.848080	308	388	12	9	80	0.1125000
NODE_16909_length_698_cov_42.848080	308	388	13	43	80	0.5375000
NODE_16909_length_698_cov_42.848080	308	388	16	13	80	0.1625000
NODE_16909_length_698_cov_42.848080	308	388	18	8	80	0.1000000
NODE_16910_length_698_cov_36.697830	366	446	5	6	80	0.0750000
NODE_16910_length_698_cov_36.697830	366	446	7	2	80	0.0250000
NODE_16910_length_698_cov_36.697830	366	446	9	26	80	0.3250000
NODE_16910_length_698_cov_36.697830	366	446	13	8	80	0.1000000
NODE_16910_length_698_cov_36.697830	366	446	14	38	80	0.4750000
NODE_16910_length_698_cov_36.697830	419	484	9	16	65	0.2461538
NODE_16910_length_698_cov_36.697830	419	484	13	19	65	0.2923077
NODE_16910_length_698_cov_36.697830	419	484	14	30	65	0.4615385
NODE_16911_length_698_cov_23.874791	222	302	7	30	80	0.3750000
NODE_16911_length_698_cov_23.874791	222	302	8	8	80	0.1000000
NODE_16911_length_698_cov_23.874791	222	302	10	42	80	0.5250000
NODE_16911_length_698_cov_23.874791	275	355	6	7	80	0.0875000
NODE_16911_length_698_cov_23.874791	275	355	7	27	80	0.3375000
NODE_16911_length_698_cov_23.874791	275	355	8	46	80	0.5750000
NODE_16912_length_698_cov_7.133556	360	440	2	80	80	1.0000000
NODE_16912_length_698_cov_7.133556	413	493	0	11	80	0.1375000
NODE_16912_length_698_cov_7.133556	413	493	2	69	80	0.8625000
NODE_16913_length_698_cov_6.520868	267	347	2	80	80	1.0000000
NODE_16913_length_698_cov_6.520868	320	400	0	28	80	0.3500000
NODE_16913_length_698_cov_6.520868	320	400	2	52	80	0.6500000
NODE_16917_length_698_cov_4.762938	329	359	4	19	30	0.6333333
NODE_16917_length_698_cov_4.762938	329	359	6	11	30	0.3666667
NODE_16926_length_698_cov_2.577629	309	389	2	24	80	0.3000000
NODE_16926_length_698_cov_2.577629	309	389	3	56	80	0.7000000
NODE_16926_length_698_cov_2.577629	362	442	2	33	80	0.4125000
NODE_16926_length_698_cov_2.577629	362	442	3	47	80	0.5875000
NODE_16962_length_697_cov_16.013378	305	385	3	13	80	0.1625000
NODE_16962_length_697_cov_16.013378	305	385	4	22	80	0.2750000
NODE_16962_length_697_cov_16.013378	305	385	5	19	80	0.2375000
NODE_16962_length_697_cov_16.013378	305	385	9	26	80	0.3250000
NODE_16962_length_697_cov_16.013378	358	438	5	1	80	0.0125000
NODE_16962_length_697_cov_16.013378	358	438	7	1	80	0.0125000
NODE_16962_length_697_cov_16.013378	358	438	8	20	80	0.2500000
NODE_16962_length_697_cov_16.013378	358	438	9	58	80	0.7250000
NODE_16963_length_697_cov_14.411371	440	520	3	5	80	0.0625000
NODE_16963_length_697_cov_14.411371	440	520	4	57	80	0.7125000
NODE_16963_length_697_cov_14.411371	440	520	6	18	80	0.2250000
NODE_16963_length_697_cov_14.411371	493	573	0	6	80	0.0750000
NODE_16963_length_697_cov_14.411371	493	573	2	1	80	0.0125000
NODE_16963_length_697_cov_14.411371	493	573	3	51	80	0.6375000
NODE_16963_length_697_cov_14.411371	493	573	4	22	80	0.2750000
NODE_16964_length_697_cov_14.282609	257	354	6	27	97	0.2783505
NODE_16964_length_697_cov_14.282609	257	354	7	48	97	0.4948454
NODE_16964_length_697_cov_14.282609	257	354	10	22	97	0.2268041
NODE_16964_length_697_cov_14.282609	327	385	7	5	58	0.0862069
NODE_16964_length_697_cov_14.282609	327	385	9	30	58	0.5172414
NODE_16964_length_697_cov_14.282609	327	385	10	23	58	0.3965517
NODE_16965_length_697_cov_9.969900	360	440	0	48	80	0.6000000
NODE_16965_length_697_cov_9.969900	360	440	1	16	80	0.2000000
NODE_16965_length_697_cov_9.969900	360	440	2	16	80	0.2000000
NODE_16965_length_697_cov_9.969900	413	493	1	11	80	0.1375000
NODE_16965_length_697_cov_9.969900	413	493	2	39	80	0.4875000
NODE_16965_length_697_cov_9.969900	413	493	3	30	80	0.3750000
NODE_16968_length_697_cov_6.117057	236	316	1	36	80	0.4500000
NODE_16968_length_697_cov_6.117057	236	316	3	44	80	0.5500000
NODE_16968_length_697_cov_6.117057	289	369	3	44	80	0.5500000
NODE_16968_length_697_cov_6.117057	289	369	4	36	80	0.4500000
NODE_17025_length_696_cov_28.360134	319	399	4	20	80	0.2500000
NODE_17025_length_696_cov_28.360134	319	399	5	4	80	0.0500000
NODE_17025_length_696_cov_28.360134	319	399	6	37	80	0.4625000
NODE_17025_length_696_cov_28.360134	319	399	7	19	80	0.2375000
NODE_17025_length_696_cov_28.360134	372	452	4	73	80	0.9125000
NODE_17025_length_696_cov_28.360134	372	452	5	2	80	0.0250000
NODE_17025_length_696_cov_28.360134	372	452	6	1	80	0.0125000
NODE_17025_length_696_cov_28.360134	372	452	7	4	80	0.0500000
NODE_17026_length_696_cov_18.708543	367	447	6	25	80	0.3125000
NODE_17026_length_696_cov_18.708543	367	447	11	17	80	0.2125000
NODE_17026_length_696_cov_18.708543	367	447	13	38	80	0.4750000
NODE_17026_length_696_cov_18.708543	420	500	9	1	80	0.0125000
NODE_17026_length_696_cov_18.708543	420	500	13	79	80	0.9875000
NODE_17027_length_696_cov_18.170854	390	470	2	35	80	0.4375000
NODE_17027_length_696_cov_18.170854	390	470	4	45	80	0.5625000
NODE_17027_length_696_cov_18.170854	443	523	4	80	80	1.0000000
NODE_17028_length_696_cov_13.738693	266	346	2	70	80	0.8750000
NODE_17028_length_696_cov_13.738693	266	346	3	10	80	0.1250000
NODE_17028_length_696_cov_13.738693	319	399	1	48	80	0.6000000
NODE_17028_length_696_cov_13.738693	319	399	2	23	80	0.2875000
NODE_17028_length_696_cov_13.738693	319	399	3	9	80	0.1125000
NODE_17030_length_696_cov_10.693467	239	266	2	27	27	1.0000000
NODE_17031_length_696_cov_9.949749	248	328	2	15	80	0.1875000
NODE_17031_length_696_cov_9.949749	248	328	4	19	80	0.2375000
NODE_17031_length_696_cov_9.949749	248	328	5	46	80	0.5750000
NODE_17031_length_696_cov_9.949749	301	381	3	35	80	0.4375000
NODE_17031_length_696_cov_9.949749	301	381	5	45	80	0.5625000
NODE_17032_length_696_cov_8.658291	247	327	1	15	80	0.1875000
NODE_17032_length_696_cov_8.658291	247	327	2	65	80	0.8125000
NODE_17032_length_696_cov_8.658291	300	380	0	23	80	0.2875000
NODE_17032_length_696_cov_8.658291	300	380	1	45	80	0.5625000
NODE_17032_length_696_cov_8.658291	300	380	2	12	80	0.1500000
NODE_17032_length_696_cov_8.658291	376	456	0	1	80	0.0125000
NODE_17032_length_696_cov_8.658291	376	456	1	39	80	0.4875000
NODE_17032_length_696_cov_8.658291	376	456	2	40	80	0.5000000
NODE_17032_length_696_cov_8.658291	429	509	2	80	80	1.0000000
NODE_17068_length_696_cov_1.675042	498	543	0	45	45	1.0000000
NODE_17100_length_695_cov_24.112416	388	468	5	53	80	0.6625000
NODE_17100_length_695_cov_24.112416	388	468	6	27	80	0.3375000
NODE_17100_length_695_cov_24.112416	441	521	2	18	80	0.2250000
NODE_17100_length_695_cov_24.112416	441	521	4	14	80	0.1750000
NODE_17100_length_695_cov_24.112416	441	521	5	28	80	0.3500000
NODE_17100_length_695_cov_24.112416	441	521	6	20	80	0.2500000
NODE_17101_length_695_cov_12.152685	349	429	13	4	80	0.0500000
NODE_17101_length_695_cov_12.152685	349	429	14	5	80	0.0625000
NODE_17101_length_695_cov_12.152685	349	429	17	19	80	0.2375000
NODE_17101_length_695_cov_12.152685	349	429	18	9	80	0.1125000
NODE_17101_length_695_cov_12.152685	349	429	19	1	80	0.0125000
NODE_17101_length_695_cov_12.152685	349	429	20	34	80	0.4250000
NODE_17101_length_695_cov_12.152685	349	429	21	8	80	0.1000000
NODE_17101_length_695_cov_12.152685	402	482	16	17	80	0.2125000
NODE_17101_length_695_cov_12.152685	402	482	17	9	80	0.1125000
NODE_17101_length_695_cov_12.152685	402	482	18	45	80	0.5625000
NODE_17101_length_695_cov_12.152685	402	482	20	1	80	0.0125000
NODE_17101_length_695_cov_12.152685	402	482	21	8	80	0.1000000
NODE_17103_length_695_cov_8.466443	345	425	0	80	80	1.0000000
NODE_17103_length_695_cov_8.466443	398	478	0	80	80	1.0000000
NODE_17106_length_695_cov_5.661074	283	363	3	8	80	0.1000000
NODE_17106_length_695_cov_5.661074	283	363	4	72	80	0.9000000
NODE_17106_length_695_cov_5.661074	346	416	1	40	70	0.5714286
NODE_17106_length_695_cov_5.661074	346	416	2	10	70	0.1428571
NODE_17106_length_695_cov_5.661074	346	416	3	11	70	0.1571429
NODE_17106_length_695_cov_5.661074	346	416	4	9	70	0.1285714
NODE_17124_length_695_cov_2.050336	36	112	0	76	76	1.0000000
NODE_17161_length_694_cov_46.675630	30	110	0	80	80	1.0000000
NODE_17161_length_694_cov_46.675630	83	163	0	78	80	0.9750000
NODE_17161_length_694_cov_46.675630	83	163	1	2	80	0.0250000
NODE_17161_length_694_cov_46.675630	159	239	0	2	80	0.0250000
NODE_17161_length_694_cov_46.675630	159	239	1	67	80	0.8375000
NODE_17161_length_694_cov_46.675630	159	239	2	1	80	0.0125000
NODE_17161_length_694_cov_46.675630	159	239	3	3	80	0.0375000
NODE_17161_length_694_cov_46.675630	159	239	5	7	80	0.0875000
NODE_17161_length_694_cov_46.675630	212	292	1	16	80	0.2000000
NODE_17161_length_694_cov_46.675630	212	292	2	1	80	0.0125000
NODE_17161_length_694_cov_46.675630	212	292	3	3	80	0.0375000
NODE_17161_length_694_cov_46.675630	212	292	5	10	80	0.1250000
NODE_17161_length_694_cov_46.675630	212	292	6	50	80	0.6250000
NODE_17162_length_694_cov_12.850420	326	406	4	4	80	0.0500000
NODE_17162_length_694_cov_12.850420	326	406	9	3	80	0.0375000
NODE_17162_length_694_cov_12.850420	326	406	10	61	80	0.7625000
NODE_17162_length_694_cov_12.850420	326	406	11	12	80	0.1500000
NODE_17162_length_694_cov_12.850420	379	459	7	14	80	0.1750000
NODE_17162_length_694_cov_12.850420	379	459	9	23	80	0.2875000
NODE_17162_length_694_cov_12.850420	379	459	10	31	80	0.3875000
NODE_17162_length_694_cov_12.850420	379	459	11	12	80	0.1500000
NODE_17163_length_694_cov_7.236975	318	396	1	27	78	0.3461539
NODE_17163_length_694_cov_7.236975	318	396	2	51	78	0.6538461
NODE_17163_length_694_cov_7.236975	371	450	0	12	79	0.1518987
NODE_17163_length_694_cov_7.236975	371	450	1	67	79	0.8481013
NODE_17166_length_694_cov_5.554622	404	484	0	35	80	0.4375000
NODE_17166_length_694_cov_5.554622	404	484	1	18	80	0.2250000
NODE_17166_length_694_cov_5.554622	404	484	2	27	80	0.3375000
NODE_17166_length_694_cov_5.554622	457	537	2	80	80	1.0000000
NODE_17168_length_694_cov_5.373109	152	232	0	80	80	1.0000000
NODE_17168_length_694_cov_5.373109	205	285	0	80	80	1.0000000
NODE_17227_length_693_cov_26.616162	435	515	0	80	80	1.0000000
NODE_17227_length_693_cov_26.616162	488	568	0	80	80	1.0000000
NODE_17228_length_693_cov_23.552189	193	273	3	8	80	0.1000000
NODE_17228_length_693_cov_23.552189	193	273	4	48	80	0.6000000
NODE_17228_length_693_cov_23.552189	193	273	5	24	80	0.3000000
NODE_17228_length_693_cov_23.552189	246	326	1	13	80	0.1625000
NODE_17228_length_693_cov_23.552189	246	326	2	28	80	0.3500000
NODE_17228_length_693_cov_23.552189	246	326	4	39	80	0.4875000
NODE_17229_length_693_cov_22.848485	231	311	5	18	80	0.2250000
NODE_17229_length_693_cov_22.848485	231	311	6	62	80	0.7750000
NODE_17229_length_693_cov_22.848485	284	364	0	4	80	0.0500000
NODE_17229_length_693_cov_22.848485	284	364	2	9	80	0.1125000
NODE_17229_length_693_cov_22.848485	284	364	3	7	80	0.0875000
NODE_17229_length_693_cov_22.848485	284	364	4	27	80	0.3375000
NODE_17229_length_693_cov_22.848485	284	364	5	24	80	0.3000000
NODE_17229_length_693_cov_22.848485	284	364	6	9	80	0.1125000
NODE_17230_length_693_cov_13.616162	219	299	1	14	80	0.1750000
NODE_17230_length_693_cov_13.616162	219	299	2	41	80	0.5125000
NODE_17230_length_693_cov_13.616162	219	299	3	1	80	0.0125000
NODE_17230_length_693_cov_13.616162	219	299	4	24	80	0.3000000
NODE_17230_length_693_cov_13.616162	272	352	2	2	80	0.0250000
NODE_17230_length_693_cov_13.616162	272	352	3	34	80	0.4250000
NODE_17230_length_693_cov_13.616162	272	352	4	44	80	0.5500000
NODE_17231_length_693_cov_12.382155	305	385	2	80	80	1.0000000
NODE_17231_length_693_cov_12.382155	358	424	1	1	66	0.0151515
NODE_17231_length_693_cov_12.382155	358	424	2	65	66	0.9848485
NODE_17232_length_693_cov_10.053872	279	359	1	9	80	0.1125000
NODE_17232_length_693_cov_10.053872	279	359	3	71	80	0.8875000
NODE_17232_length_693_cov_10.053872	332	412	1	62	80	0.7750000
NODE_17232_length_693_cov_10.053872	332	412	3	18	80	0.2250000
NODE_17233_length_693_cov_9.659933	247	327	0	80	80	1.0000000
NODE_17233_length_693_cov_9.659933	300	380	0	80	80	1.0000000
NODE_17235_length_693_cov_8.077441	343	423	0	80	80	1.0000000
NODE_17235_length_693_cov_8.077441	396	476	0	80	80	1.0000000
NODE_17243_length_693_cov_3.680135	250	321	0	9	71	0.1267606
NODE_17243_length_693_cov_3.680135	250	321	2	62	71	0.8732395
NODE_17280_length_692_cov_33.416526	462	542	21	5	80	0.0625000
NODE_17280_length_692_cov_33.416526	462	542	22	1	80	0.0125000
NODE_17280_length_692_cov_33.416526	462	542	23	18	80	0.2250000
NODE_17280_length_692_cov_33.416526	462	542	24	2	80	0.0250000
NODE_17280_length_692_cov_33.416526	462	542	25	7	80	0.0875000
NODE_17280_length_692_cov_33.416526	462	542	26	7	80	0.0875000
NODE_17280_length_692_cov_33.416526	462	542	27	21	80	0.2625000
NODE_17280_length_692_cov_33.416526	462	542	28	8	80	0.1000000
NODE_17280_length_692_cov_33.416526	462	542	29	10	80	0.1250000
NODE_17280_length_692_cov_33.416526	462	542	30	1	80	0.0125000
NODE_17280_length_692_cov_33.416526	515	595	19	25	80	0.3125000
NODE_17280_length_692_cov_33.416526	515	595	22	5	80	0.0625000
NODE_17280_length_692_cov_33.416526	515	595	24	1	80	0.0125000
NODE_17280_length_692_cov_33.416526	515	595	25	3	80	0.0375000
NODE_17280_length_692_cov_33.416526	515	595	26	12	80	0.1500000
NODE_17280_length_692_cov_33.416526	515	595	27	12	80	0.1500000
NODE_17280_length_692_cov_33.416526	515	595	28	3	80	0.0375000
NODE_17280_length_692_cov_33.416526	515	595	29	18	80	0.2250000
NODE_17280_length_692_cov_33.416526	515	595	30	1	80	0.0125000
NODE_17281_length_692_cov_17.559865	291	371	1	67	80	0.8375000
NODE_17281_length_692_cov_17.559865	291	371	2	13	80	0.1625000
NODE_17282_length_692_cov_15.070826	304	375	1	71	71	1.0000000
NODE_17283_length_692_cov_13.279933	308	388	13	10	80	0.1250000
NODE_17283_length_692_cov_13.279933	308	388	14	9	80	0.1125000
NODE_17283_length_692_cov_13.279933	308	388	15	13	80	0.1625000
NODE_17283_length_692_cov_13.279933	308	388	16	39	80	0.4875000
NODE_17283_length_692_cov_13.279933	308	388	17	7	80	0.0875000
NODE_17283_length_692_cov_13.279933	308	388	18	2	80	0.0250000
NODE_17283_length_692_cov_13.279933	361	441	11	17	80	0.2125000
NODE_17283_length_692_cov_13.279933	361	441	12	20	80	0.2500000
NODE_17283_length_692_cov_13.279933	361	441	14	5	80	0.0625000
NODE_17283_length_692_cov_13.279933	361	441	15	7	80	0.0875000
NODE_17283_length_692_cov_13.279933	361	441	16	22	80	0.2750000
NODE_17283_length_692_cov_13.279933	361	441	17	7	80	0.0875000
NODE_17283_length_692_cov_13.279933	361	441	18	2	80	0.0250000
NODE_17285_length_692_cov_10.750422	317	397	2	16	80	0.2000000
NODE_17285_length_692_cov_10.750422	317	397	4	64	80	0.8000000
NODE_17287_length_692_cov_7.497470	175	255	4	9	80	0.1125000
NODE_17287_length_692_cov_7.497470	175	255	6	22	80	0.2750000
NODE_17287_length_692_cov_7.497470	175	255	8	18	80	0.2250000
NODE_17287_length_692_cov_7.497470	175	255	9	2	80	0.0250000
NODE_17287_length_692_cov_7.497470	175	255	10	29	80	0.3625000
NODE_17287_length_692_cov_7.497470	228	312	4	25	84	0.2976190
NODE_17287_length_692_cov_7.497470	228	312	5	8	84	0.0952381
NODE_17287_length_692_cov_7.497470	228	312	6	49	84	0.5833333
NODE_17287_length_692_cov_7.497470	228	312	10	2	84	0.0238095
NODE_17289_length_692_cov_7.370995	235	315	9	5	80	0.0625000
NODE_17289_length_692_cov_7.370995	235	315	10	5	80	0.0625000
NODE_17289_length_692_cov_7.370995	235	315	11	35	80	0.4375000
NODE_17289_length_692_cov_7.370995	235	315	12	24	80	0.3000000
NODE_17289_length_692_cov_7.370995	235	315	13	11	80	0.1375000
NODE_17289_length_692_cov_7.370995	288	369	4	2	81	0.0246914
NODE_17289_length_692_cov_7.370995	288	369	6	1	81	0.0123457
NODE_17289_length_692_cov_7.370995	288	369	7	26	81	0.3209876
NODE_17289_length_692_cov_7.370995	288	369	8	6	81	0.0740741
NODE_17289_length_692_cov_7.370995	288	369	9	2	81	0.0246914
NODE_17289_length_692_cov_7.370995	288	369	11	44	81	0.5432099
NODE_17328_length_692_cov_1.514334	404	484	0	80	80	1.0000000
NODE_17350_length_691_cov_115.233108	276	356	12	24	80	0.3000000
NODE_17350_length_691_cov_115.233108	276	356	16	12	80	0.1500000
NODE_17350_length_691_cov_115.233108	276	356	17	26	80	0.3250000
NODE_17350_length_691_cov_115.233108	276	356	19	2	80	0.0250000
NODE_17350_length_691_cov_115.233108	276	356	20	1	80	0.0125000
NODE_17350_length_691_cov_115.233108	276	356	21	15	80	0.1875000
NODE_17350_length_691_cov_115.233108	329	409	12	18	80	0.2250000
NODE_17350_length_691_cov_115.233108	329	409	14	5	80	0.0625000
NODE_17350_length_691_cov_115.233108	329	409	15	21	80	0.2625000
NODE_17350_length_691_cov_115.233108	329	409	16	28	80	0.3500000
NODE_17350_length_691_cov_115.233108	329	409	17	6	80	0.0750000
NODE_17350_length_691_cov_115.233108	329	409	18	1	80	0.0125000
NODE_17350_length_691_cov_115.233108	329	409	19	1	80	0.0125000
NODE_17350_length_691_cov_115.233108	405	485	12	8	80	0.1000000
NODE_17350_length_691_cov_115.233108	405	485	13	2	80	0.0250000
NODE_17350_length_691_cov_115.233108	405	485	17	7	80	0.0875000
NODE_17350_length_691_cov_115.233108	405	485	18	5	80	0.0625000
NODE_17350_length_691_cov_115.233108	405	485	19	3	80	0.0375000
NODE_17350_length_691_cov_115.233108	405	485	21	15	80	0.1875000
NODE_17350_length_691_cov_115.233108	405	485	24	11	80	0.1375000
NODE_17350_length_691_cov_115.233108	405	485	26	5	80	0.0625000
NODE_17350_length_691_cov_115.233108	405	485	28	1	80	0.0125000
NODE_17350_length_691_cov_115.233108	405	485	29	4	80	0.0500000
NODE_17350_length_691_cov_115.233108	405	485	30	3	80	0.0375000
NODE_17350_length_691_cov_115.233108	405	485	32	2	80	0.0250000
NODE_17350_length_691_cov_115.233108	405	485	33	11	80	0.1375000
NODE_17350_length_691_cov_115.233108	405	485	34	2	80	0.0250000
NODE_17350_length_691_cov_115.233108	405	485	35	1	80	0.0125000
NODE_17350_length_691_cov_115.233108	458	538	26	3	80	0.0375000
NODE_17350_length_691_cov_115.233108	458	538	28	1	80	0.0125000
NODE_17350_length_691_cov_115.233108	458	538	29	4	80	0.0500000
NODE_17350_length_691_cov_115.233108	458	538	30	3	80	0.0375000
NODE_17350_length_691_cov_115.233108	458	538	32	2	80	0.0250000
NODE_17350_length_691_cov_115.233108	458	538	33	11	80	0.1375000
NODE_17350_length_691_cov_115.233108	458	538	34	2	80	0.0250000
NODE_17350_length_691_cov_115.233108	458	538	35	3	80	0.0375000
NODE_17350_length_691_cov_115.233108	458	538	38	5	80	0.0625000
NODE_17350_length_691_cov_115.233108	458	538	39	5	80	0.0625000
NODE_17350_length_691_cov_115.233108	458	538	40	6	80	0.0750000
NODE_17350_length_691_cov_115.233108	458	538	41	11	80	0.1375000
NODE_17350_length_691_cov_115.233108	458	538	42	3	80	0.0375000
NODE_17350_length_691_cov_115.233108	458	538	43	13	80	0.1625000
NODE_17350_length_691_cov_115.233108	458	538	44	8	80	0.1000000
NODE_17351_length_691_cov_26.076014	188	268	0	59	80	0.7375000
NODE_17351_length_691_cov_26.076014	188	268	1	21	80	0.2625000
NODE_17351_length_691_cov_26.076014	241	321	0	6	80	0.0750000
NODE_17351_length_691_cov_26.076014	241	321	1	74	80	0.9250000
NODE_17352_length_691_cov_21.991554	288	368	9	21	80	0.2625000
NODE_17352_length_691_cov_21.991554	288	368	10	7	80	0.0875000
NODE_17352_length_691_cov_21.991554	288	368	11	14	80	0.1750000
NODE_17352_length_691_cov_21.991554	288	368	12	5	80	0.0625000
NODE_17352_length_691_cov_21.991554	288	368	13	20	80	0.2500000
NODE_17352_length_691_cov_21.991554	288	368	14	13	80	0.1625000
NODE_17352_length_691_cov_21.991554	341	419	8	2	78	0.0256410
NODE_17352_length_691_cov_21.991554	341	419	9	4	78	0.0512821
NODE_17352_length_691_cov_21.991554	341	419	10	17	78	0.2179487
NODE_17352_length_691_cov_21.991554	341	419	11	14	78	0.1794872
NODE_17352_length_691_cov_21.991554	341	419	12	6	78	0.0769231
NODE_17352_length_691_cov_21.991554	341	419	13	22	78	0.2820513
NODE_17352_length_691_cov_21.991554	341	419	14	13	78	0.1666667
NODE_17353_length_691_cov_14.908784	226	306	0	80	80	1.0000000
NODE_17353_length_691_cov_14.908784	279	359	0	80	80	1.0000000
NODE_17358_length_691_cov_5.670608	325	402	1	41	77	0.5324675
NODE_17358_length_691_cov_5.670608	325	402	2	36	77	0.4675325
NODE_17358_length_691_cov_5.670608	375	455	0	39	80	0.4875000
NODE_17358_length_691_cov_5.670608	375	455	1	41	80	0.5125000
NODE_17361_length_691_cov_4.866554	103	183	1	5	80	0.0625000
NODE_17361_length_691_cov_4.866554	103	183	2	29	80	0.3625000
NODE_17361_length_691_cov_4.866554	103	183	3	46	80	0.5750000
NODE_17361_length_691_cov_4.866554	156	236	2	65	80	0.8125000
NODE_17361_length_691_cov_4.866554	156	236	3	15	80	0.1875000
NODE_17367_length_691_cov_3.388514	304	384	1	26	80	0.3250000
NODE_17367_length_691_cov_3.388514	304	384	2	30	80	0.3750000
NODE_17367_length_691_cov_3.388514	304	384	3	15	80	0.1875000
NODE_17367_length_691_cov_3.388514	304	384	4	9	80	0.1125000
NODE_17367_length_691_cov_3.388514	357	437	2	3	80	0.0375000
NODE_17367_length_691_cov_3.388514	357	437	3	15	80	0.1875000
NODE_17367_length_691_cov_3.388514	357	437	4	47	80	0.5875000
NODE_17367_length_691_cov_3.388514	357	437	5	15	80	0.1875000
NODE_17415_length_690_cov_39.538071	563	612	2	12	49	0.2448980
NODE_17415_length_690_cov_39.538071	563	612	4	17	49	0.3469388
NODE_17415_length_690_cov_39.538071	563	612	5	1	49	0.0204082
NODE_17415_length_690_cov_39.538071	563	612	6	5	49	0.1020408
NODE_17415_length_690_cov_39.538071	563	612	7	7	49	0.1428571
NODE_17415_length_690_cov_39.538071	563	612	10	7	49	0.1428571
NODE_17415_length_690_cov_39.538071	598	678	0	56	80	0.7000000
NODE_17415_length_690_cov_39.538071	598	678	1	8	80	0.1000000
NODE_17415_length_690_cov_39.538071	598	678	2	14	80	0.1750000
NODE_17415_length_690_cov_39.538071	598	678	4	2	80	0.0250000
NODE_17415_length_690_cov_39.538071	651	690	0	39	39	1.0000000
NODE_17417_length_690_cov_30.336717	319	394	0	3	75	0.0400000
NODE_17417_length_690_cov_30.336717	319	394	2	59	75	0.7866667
NODE_17417_length_690_cov_30.336717	319	394	3	13	75	0.1733333
NODE_17417_length_690_cov_30.336717	372	453	2	9	81	0.1111111
NODE_17417_length_690_cov_30.336717	372	453	3	19	81	0.2345679
NODE_17417_length_690_cov_30.336717	372	453	5	53	81	0.6543210
NODE_17417_length_690_cov_30.336717	449	529	3	57	80	0.7125000
NODE_17417_length_690_cov_30.336717	449	529	5	23	80	0.2875000
NODE_17417_length_690_cov_30.336717	502	582	1	32	80	0.4000000
NODE_17417_length_690_cov_30.336717	502	582	3	46	80	0.5750000
NODE_17417_length_690_cov_30.336717	502	582	4	2	80	0.0250000
NODE_17418_length_690_cov_26.888325	270	350	6	1	80	0.0125000
NODE_17418_length_690_cov_26.888325	270	350	7	22	80	0.2750000
NODE_17418_length_690_cov_26.888325	270	350	8	13	80	0.1625000
NODE_17418_length_690_cov_26.888325	270	350	9	36	80	0.4500000
NODE_17418_length_690_cov_26.888325	270	350	11	8	80	0.1000000
NODE_17418_length_690_cov_26.888325	323	403	9	19	80	0.2375000
NODE_17418_length_690_cov_26.888325	323	403	10	1	80	0.0125000
NODE_17418_length_690_cov_26.888325	323	403	11	9	80	0.1125000
NODE_17418_length_690_cov_26.888325	323	403	12	29	80	0.3625000
NODE_17418_length_690_cov_26.888325	323	403	13	22	80	0.2750000
NODE_17419_length_690_cov_23.360406	131	211	6	42	80	0.5250000
NODE_17419_length_690_cov_23.360406	131	211	7	15	80	0.1875000
NODE_17419_length_690_cov_23.360406	131	211	8	8	80	0.1000000
NODE_17419_length_690_cov_23.360406	131	211	10	2	80	0.0250000
NODE_17419_length_690_cov_23.360406	131	211	11	13	80	0.1625000
NODE_17419_length_690_cov_23.360406	188	264	7	5	76	0.0657895
NODE_17419_length_690_cov_23.360406	188	264	8	3	76	0.0394737
NODE_17419_length_690_cov_23.360406	188	264	10	2	76	0.0263158
NODE_17419_length_690_cov_23.360406	188	264	11	32	76	0.4210526
NODE_17419_length_690_cov_23.360406	188	264	12	1	76	0.0131579
NODE_17419_length_690_cov_23.360406	188	264	13	22	76	0.2894737
NODE_17419_length_690_cov_23.360406	188	264	14	7	76	0.0921053
NODE_17419_length_690_cov_23.360406	188	264	15	4	76	0.0526316
NODE_17420_length_690_cov_18.737733	316	396	2	57	80	0.7125000
NODE_17420_length_690_cov_18.737733	316	396	3	11	80	0.1375000
NODE_17420_length_690_cov_18.737733	316	396	4	12	80	0.1500000
NODE_17420_length_690_cov_18.737733	369	449	2	5	80	0.0625000
NODE_17420_length_690_cov_18.737733	369	449	3	22	80	0.2750000
NODE_17420_length_690_cov_18.737733	369	449	4	53	80	0.6625000
NODE_17421_length_690_cov_16.593909	364	444	4	9	80	0.1125000
NODE_17421_length_690_cov_16.593909	364	444	6	23	80	0.2875000
NODE_17421_length_690_cov_16.593909	364	444	7	4	80	0.0500000
NODE_17421_length_690_cov_16.593909	364	444	8	24	80	0.3000000
NODE_17421_length_690_cov_16.593909	364	444	9	20	80	0.2500000
NODE_17421_length_690_cov_16.593909	417	497	2	25	80	0.3125000
NODE_17421_length_690_cov_16.593909	417	497	3	9	80	0.1125000
NODE_17421_length_690_cov_16.593909	417	497	4	28	80	0.3500000
NODE_17421_length_690_cov_16.593909	417	497	6	18	80	0.2250000
NODE_17422_length_690_cov_12.896785	320	400	1	12	80	0.1500000
NODE_17422_length_690_cov_12.896785	320	400	2	17	80	0.2125000
NODE_17422_length_690_cov_12.896785	320	400	3	51	80	0.6375000
NODE_17422_length_690_cov_12.896785	373	453	2	27	80	0.3375000
NODE_17422_length_690_cov_12.896785	373	453	3	53	80	0.6625000
NODE_17423_length_690_cov_10.818951	349	429	7	3	80	0.0375000
NODE_17423_length_690_cov_10.818951	349	429	8	6	80	0.0750000
NODE_17423_length_690_cov_10.818951	349	429	9	7	80	0.0875000
NODE_17423_length_690_cov_10.818951	349	429	10	6	80	0.0750000
NODE_17423_length_690_cov_10.818951	349	429	11	47	80	0.5875000
NODE_17423_length_690_cov_10.818951	349	429	12	11	80	0.1375000
NODE_17424_length_690_cov_7.015228	273	353	0	80	80	1.0000000
NODE_17424_length_690_cov_7.015228	326	406	0	80	80	1.0000000
NODE_17429_length_690_cov_4.793570	316	365	1	6	49	0.1224490
NODE_17429_length_690_cov_4.793570	316	365	3	33	49	0.6734694
NODE_17429_length_690_cov_4.793570	316	365	5	10	49	0.2040816
NODE_17430_length_690_cov_4.717428	316	396	3	47	80	0.5875000
NODE_17430_length_690_cov_4.717428	316	396	4	33	80	0.4125000
NODE_17430_length_690_cov_4.717428	369	449	1	24	80	0.3000000
NODE_17430_length_690_cov_4.717428	369	449	2	28	80	0.3500000
NODE_17430_length_690_cov_4.717428	369	449	3	28	80	0.3500000
NODE_17484_length_689_cov_45.984746	244	322	35	30	78	0.3846154
NODE_17484_length_689_cov_45.984746	244	322	37	21	78	0.2692308
NODE_17484_length_689_cov_45.984746	244	322	38	6	78	0.0769231
NODE_17484_length_689_cov_45.984746	244	322	47	4	78	0.0512821
NODE_17484_length_689_cov_45.984746	244	322	52	17	78	0.2179487
NODE_17484_length_689_cov_45.984746	297	377	35	6	80	0.0750000
NODE_17484_length_689_cov_45.984746	297	377	36	20	80	0.2500000
NODE_17484_length_689_cov_45.984746	297	377	37	1	80	0.0125000
NODE_17484_length_689_cov_45.984746	297	377	38	4	80	0.0500000
NODE_17484_length_689_cov_45.984746	297	377	47	4	80	0.0500000
NODE_17484_length_689_cov_45.984746	297	377	50	2	80	0.0250000
NODE_17484_length_689_cov_45.984746	297	377	51	18	80	0.2250000
NODE_17484_length_689_cov_45.984746	297	377	52	25	80	0.3125000
NODE_17485_length_689_cov_35.705085	436	516	4	13	80	0.1625000
NODE_17485_length_689_cov_35.705085	436	516	5	10	80	0.1250000
NODE_17485_length_689_cov_35.705085	436	516	6	10	80	0.1250000
NODE_17485_length_689_cov_35.705085	436	516	7	1	80	0.0125000
NODE_17485_length_689_cov_35.705085	436	516	8	46	80	0.5750000
NODE_17485_length_689_cov_35.705085	489	569	7	17	80	0.2125000
NODE_17485_length_689_cov_35.705085	489	569	8	63	80	0.7875000
NODE_17486_length_689_cov_25.372881	211	291	26	22	80	0.2750000
NODE_17486_length_689_cov_25.372881	211	291	27	15	80	0.1875000
NODE_17486_length_689_cov_25.372881	211	291	28	2	80	0.0250000
NODE_17486_length_689_cov_25.372881	211	291	29	3	80	0.0375000
NODE_17486_length_689_cov_25.372881	211	291	30	5	80	0.0625000
NODE_17486_length_689_cov_25.372881	211	291	31	27	80	0.3375000
NODE_17486_length_689_cov_25.372881	211	291	32	6	80	0.0750000
NODE_17486_length_689_cov_25.372881	264	344	7	12	80	0.1500000
NODE_17486_length_689_cov_25.372881	264	344	8	8	80	0.1000000
NODE_17486_length_689_cov_25.372881	264	344	20	2	80	0.0250000
NODE_17486_length_689_cov_25.372881	264	344	21	2	80	0.0250000
NODE_17486_length_689_cov_25.372881	264	344	22	1	80	0.0125000
NODE_17486_length_689_cov_25.372881	264	344	23	6	80	0.0750000
NODE_17486_length_689_cov_25.372881	264	344	24	10	80	0.1250000
NODE_17486_length_689_cov_25.372881	264	344	30	5	80	0.0625000
NODE_17486_length_689_cov_25.372881	264	344	31	21	80	0.2625000
NODE_17486_length_689_cov_25.372881	264	344	32	13	80	0.1625000
NODE_17487_length_689_cov_20.138983	319	399	0	80	80	1.0000000
NODE_17487_length_689_cov_20.138983	372	452	0	80	80	1.0000000
NODE_17488_length_689_cov_14.377966	351	431	1	49	80	0.6125000
NODE_17488_length_689_cov_14.377966	351	431	2	31	80	0.3875000
NODE_17488_length_689_cov_14.377966	404	484	1	67	80	0.8375000
NODE_17488_length_689_cov_14.377966	404	484	2	13	80	0.1625000
NODE_17489_length_689_cov_9.477966	201	281	2	61	80	0.7625000
NODE_17489_length_689_cov_9.477966	201	281	5	19	80	0.2375000
NODE_17489_length_689_cov_9.477966	254	334	2	8	80	0.1000000
NODE_17489_length_689_cov_9.477966	254	334	3	38	80	0.4750000
NODE_17489_length_689_cov_9.477966	254	334	5	34	80	0.4250000
NODE_17491_length_689_cov_7.367797	122	207	4	5	85	0.0588235
NODE_17491_length_689_cov_7.367797	122	207	5	1	85	0.0117647
NODE_17491_length_689_cov_7.367797	122	207	6	79	85	0.9294118
NODE_17492_length_689_cov_6.649153	242	322	9	6	80	0.0750000
NODE_17492_length_689_cov_6.649153	242	322	11	74	80	0.9250000
NODE_17492_length_689_cov_6.649153	295	375	0	11	80	0.1375000
NODE_17492_length_689_cov_6.649153	295	375	1	4	80	0.0500000
NODE_17492_length_689_cov_6.649153	295	375	5	1	80	0.0125000
NODE_17492_length_689_cov_6.649153	295	375	6	28	80	0.3500000
NODE_17492_length_689_cov_6.649153	295	375	7	9	80	0.1125000
NODE_17492_length_689_cov_6.649153	295	375	9	6	80	0.0750000
NODE_17492_length_689_cov_6.649153	295	375	11	21	80	0.2625000
NODE_17504_length_689_cov_2.788136	128	208	1	59	80	0.7375000
NODE_17504_length_689_cov_2.788136	128	208	2	21	80	0.2625000
NODE_17504_length_689_cov_2.788136	181	261	1	80	80	1.0000000
NODE_17548_length_688_cov_52.256367	198	278	3	10	80	0.1250000
NODE_17548_length_688_cov_52.256367	198	278	5	4	80	0.0500000
NODE_17548_length_688_cov_52.256367	198	278	6	14	80	0.1750000
NODE_17548_length_688_cov_52.256367	198	278	7	21	80	0.2625000
NODE_17548_length_688_cov_52.256367	198	278	8	10	80	0.1250000
NODE_17548_length_688_cov_52.256367	198	278	9	6	80	0.0750000
NODE_17548_length_688_cov_52.256367	198	278	10	5	80	0.0625000
NODE_17548_length_688_cov_52.256367	198	278	12	10	80	0.1250000
NODE_17548_length_688_cov_52.256367	251	331	8	8	80	0.1000000
NODE_17548_length_688_cov_52.256367	251	331	9	4	80	0.0500000
NODE_17548_length_688_cov_52.256367	251	331	10	5	80	0.0625000
NODE_17548_length_688_cov_52.256367	251	331	12	60	80	0.7500000
NODE_17548_length_688_cov_52.256367	251	331	13	3	80	0.0375000
NODE_17549_length_688_cov_37.563667	373	453	9	12	80	0.1500000
NODE_17549_length_688_cov_37.563667	373	453	11	19	80	0.2375000
NODE_17549_length_688_cov_37.563667	373	453	12	44	80	0.5500000
NODE_17549_length_688_cov_37.563667	373	453	13	5	80	0.0625000
NODE_17549_length_688_cov_37.563667	426	506	7	27	80	0.3375000
NODE_17549_length_688_cov_37.563667	426	506	8	2	80	0.0250000
NODE_17549_length_688_cov_37.563667	426	506	9	36	80	0.4500000
NODE_17549_length_688_cov_37.563667	426	506	12	15	80	0.1875000
NODE_17549_length_688_cov_37.563667	514	594	3	9	80	0.1125000
NODE_17549_length_688_cov_37.563667	514	594	4	49	80	0.6125000
NODE_17549_length_688_cov_37.563667	514	594	5	15	80	0.1875000
NODE_17549_length_688_cov_37.563667	514	594	6	3	80	0.0375000
NODE_17549_length_688_cov_37.563667	514	594	9	4	80	0.0500000
NODE_17549_length_688_cov_37.563667	514	594	3	9	80	0.1125000
NODE_17549_length_688_cov_37.563667	514	594	4	49	80	0.6125000
NODE_17549_length_688_cov_37.563667	514	594	5	15	80	0.1875000
NODE_17549_length_688_cov_37.563667	514	594	6	3	80	0.0375000
NODE_17549_length_688_cov_37.563667	514	594	9	4	80	0.0500000
NODE_17549_length_688_cov_37.563667	514	584	3	9	70	0.1285714
NODE_17549_length_688_cov_37.563667	514	584	4	39	70	0.5571429
NODE_17549_length_688_cov_37.563667	514	584	5	15	70	0.2142857
NODE_17549_length_688_cov_37.563667	514	584	6	3	70	0.0428571
NODE_17549_length_688_cov_37.563667	514	584	9	4	70	0.0571429
NODE_17549_length_688_cov_37.563667	567	647	4	80	80	1.0000000
NODE_17549_length_688_cov_37.563667	567	646	4	79	79	1.0000000
NODE_17550_length_688_cov_33.898132	373	453	6	4	80	0.0500000
NODE_17550_length_688_cov_33.898132	373	453	8	1	80	0.0125000
NODE_17550_length_688_cov_33.898132	373	453	10	1	80	0.0125000
NODE_17550_length_688_cov_33.898132	373	453	11	44	80	0.5500000
NODE_17550_length_688_cov_33.898132	373	453	13	30	80	0.3750000
NODE_17550_length_688_cov_33.898132	426	506	0	7	80	0.0875000
NODE_17550_length_688_cov_33.898132	426	506	1	5	80	0.0625000
NODE_17550_length_688_cov_33.898132	426	506	3	20	80	0.2500000
NODE_17550_length_688_cov_33.898132	426	506	4	3	80	0.0375000
NODE_17550_length_688_cov_33.898132	426	506	5	8	80	0.1000000
NODE_17550_length_688_cov_33.898132	426	506	6	14	80	0.1750000
NODE_17550_length_688_cov_33.898132	426	506	8	1	80	0.0125000
NODE_17550_length_688_cov_33.898132	426	506	10	1	80	0.0125000
NODE_17550_length_688_cov_33.898132	426	506	11	21	80	0.2625000
NODE_17551_length_688_cov_26.769100	457	537	6	19	80	0.2375000
NODE_17551_length_688_cov_26.769100	457	537	7	2	80	0.0250000
NODE_17551_length_688_cov_26.769100	457	537	8	59	80	0.7375000
NODE_17551_length_688_cov_26.769100	510	590	3	13	80	0.1625000
NODE_17551_length_688_cov_26.769100	510	590	4	19	80	0.2375000
NODE_17551_length_688_cov_26.769100	510	590	5	19	80	0.2375000
NODE_17551_length_688_cov_26.769100	510	590	6	21	80	0.2625000
NODE_17551_length_688_cov_26.769100	510	590	7	1	80	0.0125000
NODE_17551_length_688_cov_26.769100	510	590	8	7	80	0.0875000
NODE_17552_length_688_cov_22.517827	332	412	29	6	80	0.0750000
NODE_17552_length_688_cov_22.517827	332	412	30	11	80	0.1375000
NODE_17552_length_688_cov_22.517827	332	412	31	44	80	0.5500000
NODE_17552_length_688_cov_22.517827	332	412	32	19	80	0.2375000
NODE_17552_length_688_cov_22.517827	385	465	20	24	80	0.3000000
NODE_17552_length_688_cov_22.517827	385	465	21	1	80	0.0125000
NODE_17552_length_688_cov_22.517827	385	465	23	1	80	0.0125000
NODE_17552_length_688_cov_22.517827	385	465	25	8	80	0.1000000
NODE_17552_length_688_cov_22.517827	385	465	26	3	80	0.0375000
NODE_17552_length_688_cov_22.517827	385	465	27	1	80	0.0125000
NODE_17552_length_688_cov_22.517827	385	465	28	1	80	0.0125000
NODE_17552_length_688_cov_22.517827	385	465	29	2	80	0.0250000
NODE_17552_length_688_cov_22.517827	385	465	30	1	80	0.0125000
NODE_17552_length_688_cov_22.517827	385	465	31	25	80	0.3125000
NODE_17552_length_688_cov_22.517827	385	465	32	13	80	0.1625000
NODE_17553_length_688_cov_16.796265	225	305	1	19	80	0.2375000
NODE_17553_length_688_cov_16.796265	225	305	2	61	80	0.7625000
NODE_17553_length_688_cov_16.796265	278	358	0	32	80	0.4000000
NODE_17553_length_688_cov_16.796265	278	358	1	40	80	0.5000000
NODE_17553_length_688_cov_16.796265	278	358	2	8	80	0.1000000
NODE_17555_length_688_cov_13.758913	378	458	3	63	80	0.7875000
NODE_17555_length_688_cov_13.758913	378	458	4	17	80	0.2125000
NODE_17555_length_688_cov_13.758913	431	511	1	32	80	0.4000000
NODE_17555_length_688_cov_13.758913	431	511	2	15	80	0.1875000
NODE_17555_length_688_cov_13.758913	431	511	3	33	80	0.4125000
NODE_17556_length_688_cov_12.511036	330	410	0	80	80	1.0000000
NODE_17556_length_688_cov_12.511036	383	463	0	80	80	1.0000000
NODE_17561_length_688_cov_5.446520	366	414	0	24	48	0.5000000
NODE_17561_length_688_cov_5.446520	366	414	2	24	48	0.5000000
NODE_17567_length_688_cov_3.692699	265	345	0	80	80	1.0000000
NODE_17567_length_688_cov_3.692699	322	380	0	58	58	1.0000000
NODE_17621_length_687_cov_50.214286	430	510	4	10	80	0.1250000
NODE_17621_length_687_cov_50.214286	430	510	5	11	80	0.1375000
NODE_17621_length_687_cov_50.214286	430	510	6	59	80	0.7375000
NODE_17621_length_687_cov_50.214286	483	563	5	48	80	0.6000000
NODE_17621_length_687_cov_50.214286	483	563	6	32	80	0.4000000
NODE_17622_length_687_cov_32.564626	204	284	4	80	80	1.0000000
NODE_17622_length_687_cov_32.564626	257	337	0	43	80	0.5375000
NODE_17622_length_687_cov_32.564626	257	337	2	1	80	0.0125000
NODE_17622_length_687_cov_32.564626	257	337	4	36	80	0.4500000
NODE_17623_length_687_cov_22.365646	231	311	5	2	80	0.0250000
NODE_17623_length_687_cov_22.365646	231	311	6	37	80	0.4625000
NODE_17623_length_687_cov_22.365646	231	311	7	41	80	0.5125000
NODE_17623_length_687_cov_22.365646	284	364	1	19	80	0.2375000
NODE_17623_length_687_cov_22.365646	284	364	2	7	80	0.0875000
NODE_17623_length_687_cov_22.365646	284	364	3	23	80	0.2875000
NODE_17623_length_687_cov_22.365646	284	364	5	6	80	0.0750000
NODE_17623_length_687_cov_22.365646	284	364	6	14	80	0.1750000
NODE_17623_length_687_cov_22.365646	284	364	7	11	80	0.1375000
NODE_17626_length_687_cov_11.943878	233	313	2	80	80	1.0000000
NODE_17626_length_687_cov_11.943878	286	366	0	37	80	0.4625000
NODE_17626_length_687_cov_11.943878	286	366	2	43	80	0.5375000
NODE_17627_length_687_cov_7.865646	311	391	0	80	80	1.0000000
NODE_17627_length_687_cov_7.865646	364	444	0	80	80	1.0000000
NODE_17628_length_687_cov_7.353741	286	366	0	80	80	1.0000000
NODE_17628_length_687_cov_7.353741	339	419	0	80	80	1.0000000
NODE_17631_length_687_cov_5.903061	369	449	0	80	80	1.0000000
NODE_17631_length_687_cov_5.903061	422	502	0	80	80	1.0000000
NODE_17695_length_686_cov_34.642249	355	440	12	12	85	0.1411765
NODE_17695_length_686_cov_34.642249	355	440	13	17	85	0.2000000
NODE_17695_length_686_cov_34.642249	355	440	14	20	85	0.2352941
NODE_17695_length_686_cov_34.642249	355	440	15	18	85	0.2117647
NODE_17695_length_686_cov_34.642249	355	440	16	18	85	0.2117647
NODE_17695_length_686_cov_34.642249	413	493	9	11	80	0.1375000
NODE_17695_length_686_cov_34.642249	413	493	10	18	80	0.2250000
NODE_17695_length_686_cov_34.642249	413	493	11	5	80	0.0625000
NODE_17695_length_686_cov_34.642249	413	493	13	14	80	0.1750000
NODE_17695_length_686_cov_34.642249	413	493	14	7	80	0.0875000
NODE_17695_length_686_cov_34.642249	413	493	15	7	80	0.0875000
NODE_17695_length_686_cov_34.642249	413	493	16	18	80	0.2250000
NODE_17697_length_686_cov_26.357751	413	493	9	20	80	0.2500000
NODE_17697_length_686_cov_26.357751	413	493	10	15	80	0.1875000
NODE_17697_length_686_cov_26.357751	413	493	11	9	80	0.1125000
NODE_17697_length_686_cov_26.357751	413	493	12	36	80	0.4500000
NODE_17697_length_686_cov_26.357751	466	546	10	9	80	0.1125000
NODE_17697_length_686_cov_26.357751	466	546	11	14	80	0.1750000
NODE_17697_length_686_cov_26.357751	466	546	12	15	80	0.1875000
NODE_17697_length_686_cov_26.357751	466	546	14	42	80	0.5250000
NODE_17698_length_686_cov_16.715503	400	480	1	66	80	0.8250000
NODE_17698_length_686_cov_16.715503	400	480	2	14	80	0.1750000
NODE_17698_length_686_cov_16.715503	453	533	1	13	80	0.1625000
NODE_17698_length_686_cov_16.715503	453	533	2	67	80	0.8375000
NODE_17757_length_685_cov_8.769625	178	258	1	80	80	1.0000000
NODE_17757_length_685_cov_8.769625	222	250	1	28	28	1.0000000
NODE_17757_length_685_cov_8.769625	231	311	1	66	80	0.8250000
NODE_17757_length_685_cov_8.769625	231	311	2	14	80	0.1750000
NODE_17764_length_685_cov_4.447099	249	329	0	1	80	0.0125000
NODE_17764_length_685_cov_4.447099	249	329	2	14	80	0.1750000
NODE_17764_length_685_cov_4.447099	249	329	3	65	80	0.8125000
NODE_17764_length_685_cov_4.447099	302	382	3	46	80	0.5750000
NODE_17764_length_685_cov_4.447099	302	382	4	34	80	0.4250000
NODE_17768_length_685_cov_3.556314	338	418	0	80	80	1.0000000
NODE_17768_length_685_cov_3.556314	391	471	0	80	80	1.0000000
NODE_17821_length_684_cov_7.521368	189	269	0	25	80	0.3125000
NODE_17821_length_684_cov_7.521368	189	269	1	1	80	0.0125000
NODE_17821_length_684_cov_7.521368	189	269	2	35	80	0.4375000
NODE_17821_length_684_cov_7.521368	189	269	3	19	80	0.2375000
NODE_17821_length_684_cov_7.521368	242	322	2	8	80	0.1000000
NODE_17821_length_684_cov_7.521368	242	322	3	31	80	0.3875000
NODE_17821_length_684_cov_7.521368	242	322	4	37	80	0.4625000
NODE_17821_length_684_cov_7.521368	242	322	5	4	80	0.0500000
NODE_17832_length_684_cov_3.639316	306	386	0	80	80	1.0000000
NODE_17832_length_684_cov_3.639316	359	439	0	80	80	1.0000000
NODE_17866_length_683_cov_27.493151	346	426	4	21	80	0.2625000
NODE_17866_length_683_cov_27.493151	346	426	5	59	80	0.7375000
NODE_17866_length_683_cov_27.493151	399	479	5	45	80	0.5625000
NODE_17866_length_683_cov_27.493151	399	479	6	35	80	0.4375000
NODE_17867_length_683_cov_12.880137	242	321	2	3	79	0.0379747
NODE_17867_length_683_cov_12.880137	242	321	3	23	79	0.2911392
NODE_17867_length_683_cov_12.880137	242	321	4	53	79	0.6708861
NODE_17868_length_683_cov_11.772260	218	274	1	1	56	0.0178571
NODE_17868_length_683_cov_11.772260	218	274	2	35	56	0.6250000
NODE_17868_length_683_cov_11.772260	218	274	3	20	56	0.3571429
NODE_17868_length_683_cov_11.772260	247	333	2	37	86	0.4302326
NODE_17868_length_683_cov_11.772260	247	333	3	49	86	0.5697674
NODE_17869_length_683_cov_9.936644	435	515	0	80	80	1.0000000
NODE_17869_length_683_cov_9.936644	488	568	0	80	80	1.0000000
NODE_17871_length_683_cov_9.017123	296	364	3	31	68	0.4558823
NODE_17871_length_683_cov_9.017123	296	364	4	37	68	0.5441176
NODE_17871_length_683_cov_9.017123	337	417	1	24	80	0.3000000
NODE_17871_length_683_cov_9.017123	337	417	2	7	80	0.0875000
NODE_17871_length_683_cov_9.017123	337	417	3	49	80	0.6125000
NODE_17873_length_683_cov_6.797945	359	415	1	12	56	0.2142857
NODE_17873_length_683_cov_6.797945	359	415	2	36	56	0.6428571
NODE_17873_length_683_cov_6.797945	359	415	3	8	56	0.1428571
NODE_17884_length_683_cov_3.176370	113	186	0	73	73	1.0000000
NODE_17947_length_682_cov_33.516295	423	503	10	2	80	0.0250000
NODE_17947_length_682_cov_33.516295	423	503	11	1	80	0.0125000
NODE_17947_length_682_cov_33.516295	423	503	13	1	80	0.0125000
NODE_17947_length_682_cov_33.516295	423	503	14	57	80	0.7125000
NODE_17947_length_682_cov_33.516295	423	503	15	7	80	0.0875000
NODE_17947_length_682_cov_33.516295	423	503	16	12	80	0.1500000
NODE_17947_length_682_cov_33.516295	476	556	2	6	80	0.0750000
NODE_17947_length_682_cov_33.516295	476	556	4	20	80	0.2500000
NODE_17947_length_682_cov_33.516295	476	556	5	10	80	0.1250000
NODE_17947_length_682_cov_33.516295	476	556	6	7	80	0.0875000
NODE_17947_length_682_cov_33.516295	476	556	7	3	80	0.0375000
NODE_17947_length_682_cov_33.516295	476	556	8	1	80	0.0125000
NODE_17947_length_682_cov_33.516295	476	556	10	8	80	0.1000000
NODE_17947_length_682_cov_33.516295	476	556	11	1	80	0.0125000
NODE_17947_length_682_cov_33.516295	476	556	13	1	80	0.0125000
NODE_17947_length_682_cov_33.516295	476	556	14	23	80	0.2875000
NODE_17948_length_682_cov_27.022298	479	559	4	80	80	1.0000000
NODE_17948_length_682_cov_27.022298	532	612	3	6	80	0.0750000
NODE_17948_length_682_cov_27.022298	532	612	4	74	80	0.9250000
NODE_17949_length_682_cov_19.612350	434	514	0	25	80	0.3125000
NODE_17949_length_682_cov_19.612350	434	514	3	55	80	0.6875000
NODE_17949_length_682_cov_19.612350	487	567	0	78	80	0.9750000
NODE_17949_length_682_cov_19.612350	487	567	3	2	80	0.0250000
NODE_17950_length_682_cov_16.620926	261	341	4	29	80	0.3625000
NODE_17950_length_682_cov_16.620926	261	341	5	10	80	0.1250000
NODE_17950_length_682_cov_16.620926	261	341	6	34	80	0.4250000
NODE_17950_length_682_cov_16.620926	261	341	8	7	80	0.0875000
NODE_17950_length_682_cov_16.620926	314	394	6	30	80	0.3750000
NODE_17950_length_682_cov_16.620926	314	394	8	50	80	0.6250000
NODE_17951_length_682_cov_13.735849	251	331	3	30	80	0.3750000
NODE_17951_length_682_cov_13.735849	251	331	4	35	80	0.4375000
NODE_17951_length_682_cov_13.735849	251	331	5	15	80	0.1875000
NODE_17951_length_682_cov_13.735849	304	384	3	13	80	0.1625000
NODE_17951_length_682_cov_13.735849	304	384	4	60	80	0.7500000
NODE_17951_length_682_cov_13.735849	304	384	5	7	80	0.0875000
NODE_17952_length_682_cov_12.835334	228	308	0	80	80	1.0000000
NODE_17952_length_682_cov_12.835334	281	361	0	80	80	1.0000000
NODE_17956_length_682_cov_7.504288	224	304	2	28	80	0.3500000
NODE_17956_length_682_cov_7.504288	224	304	4	52	80	0.6500000
NODE_17956_length_682_cov_7.504288	277	357	4	60	80	0.7500000
NODE_17956_length_682_cov_7.504288	277	357	5	9	80	0.1125000
NODE_17956_length_682_cov_7.504288	277	357	6	11	80	0.1375000
NODE_17960_length_682_cov_5.102916	314	351	0	37	37	1.0000000
NODE_17963_length_682_cov_4.579760	152	232	0	80	80	1.0000000
NODE_17963_length_682_cov_4.579760	205	285	0	80	80	1.0000000
NODE_17967_length_682_cov_4.006861	317	397	2	80	80	1.0000000
NODE_17967_length_682_cov_4.006861	370	450	2	38	80	0.4750000
NODE_17967_length_682_cov_4.006861	370	450	3	23	80	0.2875000
NODE_17967_length_682_cov_4.006861	370	450	4	19	80	0.2375000
NODE_17968_length_682_cov_3.859348	160	240	2	21	80	0.2625000
NODE_17968_length_682_cov_3.859348	160	240	4	59	80	0.7375000
NODE_17968_length_682_cov_3.859348	213	293	0	47	80	0.5875000
NODE_17968_length_682_cov_3.859348	213	293	2	27	80	0.3375000
NODE_17968_length_682_cov_3.859348	213	293	4	6	80	0.0750000
NODE_18010_length_681_cov_51.810997	181	261	14	7	80	0.0875000
NODE_18010_length_681_cov_51.810997	181	261	18	2	80	0.0250000
NODE_18010_length_681_cov_51.810997	181	261	20	10	80	0.1250000
NODE_18010_length_681_cov_51.810997	181	261	22	6	80	0.0750000
NODE_18010_length_681_cov_51.810997	181	261	23	6	80	0.0750000
NODE_18010_length_681_cov_51.810997	181	261	24	7	80	0.0875000
NODE_18010_length_681_cov_51.810997	181	261	25	32	80	0.4000000
NODE_18010_length_681_cov_51.810997	181	261	26	10	80	0.1250000
NODE_18010_length_681_cov_51.810997	234	316	4	1	82	0.0121951
NODE_18010_length_681_cov_51.810997	234	316	6	14	82	0.1707317
NODE_18010_length_681_cov_51.810997	234	316	13	15	82	0.1829268
NODE_18010_length_681_cov_51.810997	234	316	14	32	82	0.3902439
NODE_18010_length_681_cov_51.810997	234	316	18	2	82	0.0243902
NODE_18010_length_681_cov_51.810997	234	316	20	6	82	0.0731707
NODE_18010_length_681_cov_51.810997	234	316	24	1	82	0.0121951
NODE_18010_length_681_cov_51.810997	234	316	25	4	82	0.0487805
NODE_18010_length_681_cov_51.810997	234	316	26	7	82	0.0853659
NODE_18011_length_681_cov_32.128866	347	427	2	3	80	0.0375000
NODE_18011_length_681_cov_32.128866	347	427	3	24	80	0.3000000
NODE_18011_length_681_cov_32.128866	347	427	6	13	80	0.1625000
NODE_18011_length_681_cov_32.128866	347	427	7	40	80	0.5000000
NODE_18011_length_681_cov_32.128866	400	475	5	16	75	0.2133333
NODE_18011_length_681_cov_32.128866	400	475	6	19	75	0.2533333
NODE_18011_length_681_cov_32.128866	400	475	7	40	75	0.5333334
NODE_18012_length_681_cov_19.079038	282	362	0	45	80	0.5625000
NODE_18012_length_681_cov_19.079038	282	362	1	8	80	0.1000000
NODE_18012_length_681_cov_19.079038	282	362	2	27	80	0.3375000
NODE_18012_length_681_cov_19.079038	335	415	2	80	80	1.0000000
NODE_18013_length_681_cov_17.053265	294	374	1	10	80	0.1250000
NODE_18013_length_681_cov_17.053265	294	374	2	70	80	0.8750000
NODE_18013_length_681_cov_17.053265	347	427	1	26	80	0.3250000
NODE_18013_length_681_cov_17.053265	347	427	2	54	80	0.6750000
NODE_18014_length_681_cov_11.183849	306	386	0	80	80	1.0000000
NODE_18014_length_681_cov_11.183849	359	439	0	80	80	1.0000000
NODE_18015_length_681_cov_8.065292	236	316	0	80	80	1.0000000
NODE_18015_length_681_cov_8.065292	289	369	0	80	80	1.0000000
NODE_18017_length_681_cov_6.888316	344	424	2	80	80	1.0000000
NODE_18017_length_681_cov_6.888316	397	477	0	30	80	0.3750000
NODE_18017_length_681_cov_6.888316	397	477	1	13	80	0.1625000
NODE_18017_length_681_cov_6.888316	397	477	2	37	80	0.4625000
NODE_18080_length_680_cov_35.695353	348	428	11	7	80	0.0875000
NODE_18080_length_680_cov_35.695353	348	428	13	2	80	0.0250000
NODE_18080_length_680_cov_35.695353	348	428	14	3	80	0.0375000
NODE_18080_length_680_cov_35.695353	348	428	15	3	80	0.0375000
NODE_18080_length_680_cov_35.695353	348	428	16	2	80	0.0250000
NODE_18080_length_680_cov_35.695353	348	428	17	34	80	0.4250000
NODE_18080_length_680_cov_35.695353	348	428	18	29	80	0.3625000
NODE_18080_length_680_cov_35.695353	401	481	14	6	80	0.0750000
NODE_18080_length_680_cov_35.695353	401	481	15	6	80	0.0750000
NODE_18080_length_680_cov_35.695353	401	481	16	4	80	0.0500000
NODE_18080_length_680_cov_35.695353	401	481	17	5	80	0.0625000
NODE_18080_length_680_cov_35.695353	401	481	18	24	80	0.3000000
NODE_18080_length_680_cov_35.695353	401	481	19	6	80	0.0750000
NODE_18080_length_680_cov_35.695353	401	481	20	20	80	0.2500000
NODE_18080_length_680_cov_35.695353	401	481	22	9	80	0.1125000
NODE_18081_length_680_cov_17.500861	296	376	0	80	80	1.0000000
NODE_18081_length_680_cov_17.500861	349	429	0	80	80	1.0000000
NODE_18082_length_680_cov_16.685026	260	340	5	24	80	0.3000000
NODE_18082_length_680_cov_16.685026	260	340	6	3	80	0.0375000
NODE_18082_length_680_cov_16.685026	260	340	8	11	80	0.1375000
NODE_18082_length_680_cov_16.685026	260	340	10	9	80	0.1125000
NODE_18082_length_680_cov_16.685026	260	340	11	27	80	0.3375000
NODE_18082_length_680_cov_16.685026	260	340	13	6	80	0.0750000
NODE_18082_length_680_cov_16.685026	313	393	11	49	80	0.6125000
NODE_18082_length_680_cov_16.685026	313	393	12	17	80	0.2125000
NODE_18082_length_680_cov_16.685026	313	393	13	14	80	0.1750000
NODE_18083_length_680_cov_15.345955	332	412	6	50	80	0.6250000
NODE_18083_length_680_cov_15.345955	332	412	8	27	80	0.3375000
NODE_18083_length_680_cov_15.345955	332	412	9	3	80	0.0375000
NODE_18083_length_680_cov_15.345955	385	465	2	8	80	0.1000000
NODE_18083_length_680_cov_15.345955	385	465	3	39	80	0.4875000
NODE_18083_length_680_cov_15.345955	385	465	6	33	80	0.4125000
NODE_18089_length_680_cov_3.858864	458	538	0	80	80	1.0000000
NODE_18107_length_680_cov_1.879518	236	256	0	20	20	1.0000000
NODE_18146_length_679_cov_52.046552	367	447	10	29	80	0.3625000
NODE_18146_length_679_cov_52.046552	367	447	12	6	80	0.0750000
NODE_18146_length_679_cov_52.046552	367	447	13	6	80	0.0750000
NODE_18146_length_679_cov_52.046552	367	447	14	21	80	0.2625000
NODE_18146_length_679_cov_52.046552	367	447	16	9	80	0.1125000
NODE_18146_length_679_cov_52.046552	367	447	17	9	80	0.1125000
NODE_18146_length_679_cov_52.046552	420	500	14	9	80	0.1125000
NODE_18146_length_679_cov_52.046552	420	500	16	38	80	0.4750000
NODE_18146_length_679_cov_52.046552	420	500	17	33	80	0.4125000
NODE_18147_length_679_cov_40.353448	179	259	0	14	80	0.1750000
NODE_18147_length_679_cov_40.353448	179	259	2	66	80	0.8250000
NODE_18147_length_679_cov_40.353448	232	312	0	30	80	0.3750000
NODE_18147_length_679_cov_40.353448	232	312	2	50	80	0.6250000
NODE_18148_length_679_cov_38.144828	364	428	9	6	64	0.0937500
NODE_18148_length_679_cov_38.144828	364	428	10	1	64	0.0156250
NODE_18148_length_679_cov_38.144828	364	428	11	25	64	0.3906250
NODE_18148_length_679_cov_38.144828	364	428	12	32	64	0.5000000
NODE_18148_length_679_cov_38.144828	401	481	8	41	80	0.5125000
NODE_18148_length_679_cov_38.144828	401	481	12	39	80	0.4875000
NODE_18149_length_679_cov_17.134483	277	357	5	80	80	1.0000000
NODE_18149_length_679_cov_17.134483	330	410	1	2	80	0.0250000
NODE_18149_length_679_cov_17.134483	330	410	2	19	80	0.2375000
NODE_18149_length_679_cov_17.134483	330	410	4	2	80	0.0250000
NODE_18149_length_679_cov_17.134483	330	410	5	57	80	0.7125000
NODE_18150_length_679_cov_15.046552	310	375	0	65	65	1.0000000
NODE_18151_length_679_cov_12.586207	247	327	5	52	80	0.6500000
NODE_18151_length_679_cov_12.586207	247	327	6	28	80	0.3500000
NODE_18151_length_679_cov_12.586207	303	381	2	3	78	0.0384615
NODE_18151_length_679_cov_12.586207	303	381	3	8	78	0.1025641
NODE_18151_length_679_cov_12.586207	303	381	4	9	78	0.1153846
NODE_18151_length_679_cov_12.586207	303	381	5	15	78	0.1923077
NODE_18151_length_679_cov_12.586207	303	381	6	43	78	0.5512820
NODE_18152_length_679_cov_12.282759	337	417	4	80	80	1.0000000
NODE_18152_length_679_cov_12.282759	390	470	2	42	80	0.5250000
NODE_18152_length_679_cov_12.282759	390	470	4	38	80	0.4750000
NODE_18153_length_679_cov_11.532759	205	285	0	80	80	1.0000000
NODE_18153_length_679_cov_11.532759	258	338	0	80	80	1.0000000
NODE_18155_length_679_cov_8.043103	269	341	2	33	72	0.4583333
NODE_18155_length_679_cov_8.043103	269	341	3	39	72	0.5416667
NODE_18155_length_679_cov_8.043103	314	394	2	41	80	0.5125000
NODE_18155_length_679_cov_8.043103	314	394	3	39	80	0.4875000
NODE_18156_length_679_cov_7.267241	191	271	0	80	80	1.0000000
NODE_18156_length_679_cov_7.267241	244	324	0	80	80	1.0000000
NODE_18162_length_679_cov_5.391379	279	331	0	52	52	1.0000000
NODE_18164_length_679_cov_3.813793	10	69	0	59	59	1.0000000
NODE_18164_length_679_cov_3.813793	48	122	0	69	74	0.9324324
NODE_18164_length_679_cov_3.813793	48	122	1	5	74	0.0675676
NODE_18217_length_678_cov_38.910190	252	332	6	78	80	0.9750000
NODE_18217_length_678_cov_38.910190	252	332	7	2	80	0.0250000
NODE_18217_length_678_cov_38.910190	305	385	4	31	80	0.3875000
NODE_18217_length_678_cov_38.910190	305	385	5	18	80	0.2250000
NODE_18217_length_678_cov_38.910190	305	385	6	26	80	0.3250000
NODE_18217_length_678_cov_38.910190	305	385	7	5	80	0.0625000
NODE_18217_length_678_cov_38.910190	381	461	2	14	80	0.1750000
NODE_18217_length_678_cov_38.910190	381	461	3	22	80	0.2750000
NODE_18217_length_678_cov_38.910190	381	461	4	38	80	0.4750000
NODE_18217_length_678_cov_38.910190	381	461	5	6	80	0.0750000
NODE_18217_length_678_cov_38.910190	434	514	3	34	80	0.4250000
NODE_18217_length_678_cov_38.910190	434	514	4	46	80	0.5750000
NODE_18218_length_678_cov_20.663212	243	323	2	27	80	0.3375000
NODE_18218_length_678_cov_20.663212	243	323	3	32	80	0.4000000
NODE_18218_length_678_cov_20.663212	243	323	4	21	80	0.2625000
NODE_18218_length_678_cov_20.663212	296	376	1	30	80	0.3750000
NODE_18218_length_678_cov_20.663212	296	376	2	50	80	0.6250000
NODE_18219_length_678_cov_12.081174	243	323	3	6	80	0.0750000
NODE_18219_length_678_cov_12.081174	243	323	4	6	80	0.0750000
NODE_18219_length_678_cov_12.081174	243	323	6	38	80	0.4750000
NODE_18219_length_678_cov_12.081174	243	323	8	7	80	0.0875000
NODE_18219_length_678_cov_12.081174	243	323	10	23	80	0.2875000
NODE_18219_length_678_cov_12.081174	296	376	8	4	80	0.0500000
NODE_18219_length_678_cov_12.081174	296	376	10	38	80	0.4750000
NODE_18219_length_678_cov_12.081174	296	376	13	38	80	0.4750000
NODE_18224_length_678_cov_6.559585	195	264	1	3	69	0.0434783
NODE_18224_length_678_cov_6.559585	195	264	2	52	69	0.7536232
NODE_18224_length_678_cov_6.559585	195	264	3	14	69	0.2028985
NODE_18224_length_678_cov_6.559585	237	317	2	53	80	0.6625000
NODE_18224_length_678_cov_6.559585	237	317	3	27	80	0.3375000
NODE_18228_length_678_cov_4.462867	133	213	5	21	80	0.2625000
NODE_18228_length_678_cov_4.462867	133	213	15	59	80	0.7375000
NODE_18228_length_678_cov_4.462867	186	266	10	34	80	0.4250000
NODE_18228_length_678_cov_4.462867	186	266	15	46	80	0.5750000
NODE_18239_length_678_cov_2.716753	351	431	0	35	80	0.4375000
NODE_18239_length_678_cov_2.716753	351	431	1	39	80	0.4875000
NODE_18239_length_678_cov_2.716753	351	431	2	6	80	0.0750000
NODE_18239_length_678_cov_2.716753	404	484	1	21	80	0.2625000
NODE_18239_length_678_cov_2.716753	404	484	2	59	80	0.7375000
NODE_18289_length_677_cov_22.235294	274	354	15	9	80	0.1125000
NODE_18289_length_677_cov_22.235294	274	354	16	22	80	0.2750000
NODE_18289_length_677_cov_22.235294	274	354	17	3	80	0.0375000
NODE_18289_length_677_cov_22.235294	274	354	18	2	80	0.0250000
NODE_18289_length_677_cov_22.235294	274	354	19	30	80	0.3750000
NODE_18289_length_677_cov_22.235294	274	354	21	14	80	0.1750000
NODE_18289_length_677_cov_22.235294	327	407	7	12	80	0.1500000
NODE_18289_length_677_cov_22.235294	327	407	8	3	80	0.0375000
NODE_18289_length_677_cov_22.235294	327	407	10	1	80	0.0125000
NODE_18289_length_677_cov_22.235294	327	407	15	32	80	0.4000000
NODE_18289_length_677_cov_22.235294	327	407	16	9	80	0.1125000
NODE_18289_length_677_cov_22.235294	327	407	17	13	80	0.1625000
NODE_18289_length_677_cov_22.235294	327	407	19	10	80	0.1250000
NODE_18290_length_677_cov_16.410035	124	206	8	37	82	0.4512195
NODE_18290_length_677_cov_16.410035	124	206	9	45	82	0.5487805
NODE_18290_length_677_cov_16.410035	177	261	2	12	84	0.1428571
NODE_18290_length_677_cov_16.410035	177	261	3	4	84	0.0476190
NODE_18290_length_677_cov_16.410035	177	261	4	2	84	0.0238095
NODE_18290_length_677_cov_16.410035	177	261	6	37	84	0.4404762
NODE_18290_length_677_cov_16.410035	177	261	9	29	84	0.3452381
NODE_18291_length_677_cov_11.031142	393	473	0	80	80	1.0000000
NODE_18291_length_677_cov_11.031142	446	526	0	80	80	1.0000000
NODE_18292_length_677_cov_10.129758	258	338	0	9	80	0.1125000
NODE_18292_length_677_cov_10.129758	258	338	1	34	80	0.4250000
NODE_18292_length_677_cov_10.129758	258	338	2	37	80	0.4625000
NODE_18292_length_677_cov_10.129758	311	391	2	80	80	1.0000000
NODE_18295_length_677_cov_6.660900	217	297	2	5	80	0.0625000
NODE_18295_length_677_cov_6.660900	217	297	3	32	80	0.4000000
NODE_18295_length_677_cov_6.660900	217	297	7	43	80	0.5375000
NODE_18297_length_677_cov_5.228374	366	446	0	80	80	1.0000000
NODE_18312_length_677_cov_2.306228	230	278	0	48	48	1.0000000
NODE_18329_length_677_cov_1.709343	369	449	0	80	80	1.0000000
NODE_18329_length_677_cov_1.709343	422	502	0	80	80	1.0000000
NODE_18368_length_676_cov_66.473137	286	366	5	1	80	0.0125000
NODE_18368_length_676_cov_66.473137	286	366	7	70	80	0.8750000
NODE_18368_length_676_cov_66.473137	286	366	8	9	80	0.1125000
NODE_18368_length_676_cov_66.473137	339	419	5	18	80	0.2250000
NODE_18368_length_676_cov_66.473137	339	419	7	17	80	0.2125000
NODE_18368_length_676_cov_66.473137	339	419	8	9	80	0.1125000
NODE_18368_length_676_cov_66.473137	339	419	11	8	80	0.1000000
NODE_18368_length_676_cov_66.473137	339	419	12	2	80	0.0250000
NODE_18368_length_676_cov_66.473137	339	419	13	1	80	0.0125000
NODE_18368_length_676_cov_66.473137	339	419	14	20	80	0.2500000
NODE_18368_length_676_cov_66.473137	339	419	15	5	80	0.0625000
NODE_18368_length_676_cov_66.473137	383	419	11	8	36	0.2222222
NODE_18368_length_676_cov_66.473137	383	419	12	2	36	0.0555556
NODE_18368_length_676_cov_66.473137	383	419	13	1	36	0.0277778
NODE_18368_length_676_cov_66.473137	383	419	14	20	36	0.5555556
NODE_18368_length_676_cov_66.473137	383	419	15	5	36	0.1388889
NODE_18368_length_676_cov_66.473137	383	419	11	8	36	0.2222222
NODE_18368_length_676_cov_66.473137	383	419	12	2	36	0.0555556
NODE_18368_length_676_cov_66.473137	383	419	13	1	36	0.0277778
NODE_18368_length_676_cov_66.473137	383	419	14	20	36	0.5555556
NODE_18368_length_676_cov_66.473137	383	419	15	5	36	0.1388889
NODE_18368_length_676_cov_66.473137	398	419	11	8	21	0.3809524
NODE_18368_length_676_cov_66.473137	398	419	14	8	21	0.3809524
NODE_18368_length_676_cov_66.473137	398	419	15	5	21	0.2380952
NODE_18369_length_676_cov_14.429809	259	330	1	71	71	1.0000000
NODE_18370_length_676_cov_13.882149	292	372	1	3	80	0.0375000
NODE_18370_length_676_cov_13.882149	292	372	2	77	80	0.9625000
NODE_18370_length_676_cov_13.882149	345	425	1	56	80	0.7000000
NODE_18370_length_676_cov_13.882149	345	425	2	24	80	0.3000000
NODE_18374_length_676_cov_7.225303	363	443	4	31	80	0.3875000
NODE_18374_length_676_cov_7.225303	363	443	5	19	80	0.2375000
NODE_18374_length_676_cov_7.225303	363	443	6	30	80	0.3750000
NODE_18374_length_676_cov_7.225303	416	496	3	4	80	0.0500000
NODE_18374_length_676_cov_7.225303	416	496	4	28	80	0.3500000
NODE_18374_length_676_cov_7.225303	416	496	5	37	80	0.4625000
NODE_18374_length_676_cov_7.225303	416	496	6	11	80	0.1375000
NODE_18375_length_676_cov_6.740035	373	433	0	60	60	1.0000000
NODE_18375_length_676_cov_6.740035	406	486	0	80	80	1.0000000
NODE_18378_length_676_cov_4.658579	167	240	2	73	73	1.0000000
NODE_18397_length_676_cov_2.292894	146	226	0	2	80	0.0250000
NODE_18397_length_676_cov_2.292894	146	226	3	8	80	0.1000000
NODE_18397_length_676_cov_2.292894	146	226	4	21	80	0.2625000
NODE_18397_length_676_cov_2.292894	146	226	5	43	80	0.5375000
NODE_18397_length_676_cov_2.292894	146	226	8	6	80	0.0750000
NODE_18401_length_676_cov_2.157712	175	226	0	51	51	1.0000000
NODE_18417_length_676_cov_1.547660	133	164	0	31	31	1.0000000
NODE_18447_length_675_cov_27.574653	190	270	14	31	80	0.3875000
NODE_18447_length_675_cov_27.574653	190	270	16	20	80	0.2500000
NODE_18447_length_675_cov_27.574653	190	270	17	13	80	0.1625000
NODE_18447_length_675_cov_27.574653	190	270	18	12	80	0.1500000
NODE_18447_length_675_cov_27.574653	190	270	19	1	80	0.0125000
NODE_18447_length_675_cov_27.574653	190	270	20	3	80	0.0375000
NODE_18447_length_675_cov_27.574653	243	323	14	13	80	0.1625000
NODE_18447_length_675_cov_27.574653	243	323	15	15	80	0.1875000
NODE_18447_length_675_cov_27.574653	243	323	16	9	80	0.1125000
NODE_18447_length_675_cov_27.574653	243	323	17	6	80	0.0750000
NODE_18447_length_675_cov_27.574653	243	323	18	9	80	0.1125000
NODE_18447_length_675_cov_27.574653	243	323	19	27	80	0.3375000
NODE_18447_length_675_cov_27.574653	243	323	20	1	80	0.0125000
NODE_18448_length_675_cov_11.895833	336	416	1	6	80	0.0750000
NODE_18448_length_675_cov_11.895833	336	416	2	74	80	0.9250000
NODE_18448_length_675_cov_11.895833	389	469	1	28	80	0.3500000
NODE_18448_length_675_cov_11.895833	389	469	2	52	80	0.6500000
NODE_18449_length_675_cov_8.157986	414	494	1	76	80	0.9500000
NODE_18449_length_675_cov_8.157986	414	494	2	4	80	0.0500000
NODE_18449_length_675_cov_8.157986	467	547	0	14	80	0.1750000
NODE_18449_length_675_cov_8.157986	467	547	1	66	80	0.8250000
NODE_18450_length_675_cov_8.026042	320	400	0	80	80	1.0000000
NODE_18450_length_675_cov_8.026042	373	453	0	80	80	1.0000000
NODE_18451_length_675_cov_7.277778	317	397	0	10	80	0.1250000
NODE_18451_length_675_cov_7.277778	317	397	1	6	80	0.0750000
NODE_18451_length_675_cov_7.277778	317	397	2	64	80	0.8000000
NODE_18455_length_675_cov_5.666667	142	222	0	80	80	1.0000000
NODE_18455_length_675_cov_5.666667	195	275	0	80	80	1.0000000
NODE_18464_length_675_cov_2.751736	67	122	1	55	55	1.0000000
NODE_18467_length_675_cov_2.623264	251	289	0	38	38	1.0000000
NODE_18467_length_675_cov_2.623264	279	343	0	64	64	1.0000000
NODE_18467_length_675_cov_2.623264	432	494	0	62	62	1.0000000
NODE_18515_length_674_cov_38.401739	225	305	2	38	80	0.4750000
NODE_18515_length_674_cov_38.401739	225	305	3	2	80	0.0250000
NODE_18515_length_674_cov_38.401739	225	305	5	40	80	0.5000000
NODE_18515_length_674_cov_38.401739	278	358	3	39	80	0.4875000
NODE_18515_length_674_cov_38.401739	278	358	5	41	80	0.5125000
NODE_18516_length_674_cov_30.215652	519	599	13	19	80	0.2375000
NODE_18516_length_674_cov_30.215652	519	599	14	28	80	0.3500000
NODE_18516_length_674_cov_30.215652	519	599	15	21	80	0.2625000
NODE_18516_length_674_cov_30.215652	519	599	16	12	80	0.1500000
NODE_18516_length_674_cov_30.215652	572	602	13	16	30	0.5333334
NODE_18516_length_674_cov_30.215652	572	602	14	10	30	0.3333333
NODE_18516_length_674_cov_30.215652	572	602	15	4	30	0.1333333
NODE_18517_length_674_cov_19.636522	283	363	3	11	80	0.1375000
NODE_18517_length_674_cov_19.636522	283	363	4	13	80	0.1625000
NODE_18517_length_674_cov_19.636522	283	363	5	31	80	0.3875000
NODE_18517_length_674_cov_19.636522	283	363	6	6	80	0.0750000
NODE_18517_length_674_cov_19.636522	283	363	7	4	80	0.0500000
NODE_18517_length_674_cov_19.636522	283	363	8	15	80	0.1875000
NODE_18517_length_674_cov_19.636522	336	416	4	2	80	0.0250000
NODE_18517_length_674_cov_19.636522	336	416	6	6	80	0.0750000
NODE_18517_length_674_cov_19.636522	336	416	7	4	80	0.0500000
NODE_18517_length_674_cov_19.636522	336	416	8	44	80	0.5500000
NODE_18517_length_674_cov_19.636522	336	416	9	24	80	0.3000000
NODE_18518_length_674_cov_19.436522	81	161	3	61	80	0.7625000
NODE_18518_length_674_cov_19.436522	81	161	4	7	80	0.0875000
NODE_18518_length_674_cov_19.436522	81	161	5	7	80	0.0875000
NODE_18518_length_674_cov_19.436522	81	161	6	1	80	0.0125000
NODE_18518_length_674_cov_19.436522	81	161	8	4	80	0.0500000
NODE_18518_length_674_cov_19.436522	134	214	3	8	80	0.1000000
NODE_18518_length_674_cov_19.436522	134	214	4	7	80	0.0875000
NODE_18518_length_674_cov_19.436522	134	214	5	11	80	0.1375000
NODE_18518_length_674_cov_19.436522	134	214	6	18	80	0.2250000
NODE_18518_length_674_cov_19.436522	134	214	8	36	80	0.4500000
NODE_18519_length_674_cov_16.819130	185	265	6	17	80	0.2125000
NODE_18519_length_674_cov_16.819130	185	265	7	4	80	0.0500000
NODE_18519_length_674_cov_16.819130	185	265	8	9	80	0.1125000
NODE_18519_length_674_cov_16.819130	185	265	9	50	80	0.6250000
NODE_18519_length_674_cov_16.819130	238	318	3	16	80	0.2000000
NODE_18519_length_674_cov_16.819130	238	318	4	13	80	0.1625000
NODE_18519_length_674_cov_16.819130	238	318	6	41	80	0.5125000
NODE_18519_length_674_cov_16.819130	238	318	9	10	80	0.1250000
NODE_18520_length_674_cov_14.733913	169	249	6	37	80	0.4625000
NODE_18520_length_674_cov_14.733913	169	249	7	18	80	0.2250000
NODE_18520_length_674_cov_14.733913	169	249	9	24	80	0.3000000
NODE_18520_length_674_cov_14.733913	169	249	10	1	80	0.0125000
NODE_18520_length_674_cov_14.733913	222	302	7	2	80	0.0250000
NODE_18520_length_674_cov_14.733913	222	302	9	24	80	0.3000000
NODE_18520_length_674_cov_14.733913	222	302	10	1	80	0.0125000
NODE_18520_length_674_cov_14.733913	222	302	11	21	80	0.2625000
NODE_18520_length_674_cov_14.733913	222	302	12	12	80	0.1500000
NODE_18520_length_674_cov_14.733913	222	302	13	20	80	0.2500000
NODE_18524_length_674_cov_7.086957	357	437	0	80	80	1.0000000
NODE_18524_length_674_cov_7.086957	410	490	0	80	80	1.0000000
NODE_18528_length_674_cov_4.808696	262	342	0	80	80	1.0000000
NODE_18528_length_674_cov_4.808696	315	395	0	80	80	1.0000000
NODE_18592_length_673_cov_47.109756	405	485	5	6	80	0.0750000
NODE_18592_length_673_cov_47.109756	405	485	9	23	80	0.2875000
NODE_18592_length_673_cov_47.109756	405	485	10	46	80	0.5750000
NODE_18592_length_673_cov_47.109756	405	485	11	5	80	0.0625000
NODE_18592_length_673_cov_47.109756	458	538	9	19	80	0.2375000
NODE_18592_length_673_cov_47.109756	458	538	10	18	80	0.2250000
NODE_18592_length_673_cov_47.109756	458	538	13	38	80	0.4750000
NODE_18592_length_673_cov_47.109756	458	538	15	5	80	0.0625000
NODE_18593_length_673_cov_20.548780	214	294	6	8	80	0.1000000
NODE_18593_length_673_cov_20.548780	214	294	8	30	80	0.3750000
NODE_18593_length_673_cov_20.548780	214	294	10	13	80	0.1625000
NODE_18593_length_673_cov_20.548780	214	294	13	1	80	0.0125000
NODE_18593_length_673_cov_20.548780	214	294	14	8	80	0.1000000
NODE_18593_length_673_cov_20.548780	214	294	15	7	80	0.0875000
NODE_18593_length_673_cov_20.548780	214	294	16	13	80	0.1625000
NODE_18593_length_673_cov_20.548780	267	347	6	8	80	0.1000000
NODE_18593_length_673_cov_20.548780	267	347	8	18	80	0.2250000
NODE_18593_length_673_cov_20.548780	267	347	10	44	80	0.5500000
NODE_18593_length_673_cov_20.548780	267	347	12	10	80	0.1250000
NODE_18596_length_673_cov_8.306620	337	426	0	89	89	1.0000000
NODE_18607_length_673_cov_3.041812	196	276	1	29	80	0.3625000
NODE_18607_length_673_cov_3.041812	196	276	2	30	80	0.3750000
NODE_18607_length_673_cov_3.041812	196	276	3	15	80	0.1875000
NODE_18607_length_673_cov_3.041812	196	276	4	6	80	0.0750000
NODE_18607_length_673_cov_3.041812	249	329	2	6	80	0.0750000
NODE_18607_length_673_cov_3.041812	249	329	3	35	80	0.4375000
NODE_18607_length_673_cov_3.041812	249	329	4	39	80	0.4875000
NODE_18660_length_672_cov_15.380454	282	362	0	80	80	1.0000000
NODE_18660_length_672_cov_15.380454	335	415	0	80	80	1.0000000
NODE_18661_length_672_cov_9.902269	328	408	1	19	80	0.2375000
NODE_18661_length_672_cov_9.902269	328	408	2	23	80	0.2875000
NODE_18661_length_672_cov_9.902269	328	408	3	34	80	0.4250000
NODE_18661_length_672_cov_9.902269	328	408	4	4	80	0.0500000
NODE_18661_length_672_cov_9.902269	381	461	3	23	80	0.2875000
NODE_18661_length_672_cov_9.902269	381	461	4	57	80	0.7125000
NODE_18662_length_672_cov_9.462478	309	389	2	80	80	1.0000000
NODE_18662_length_672_cov_9.462478	362	442	0	16	80	0.2000000
NODE_18662_length_672_cov_9.462478	362	442	1	15	80	0.1875000
NODE_18662_length_672_cov_9.462478	362	442	2	49	80	0.6125000
NODE_18666_length_672_cov_6.516579	354	434	0	80	80	1.0000000
NODE_18666_length_672_cov_6.516579	407	487	0	80	80	1.0000000
NODE_18668_length_672_cov_6.108202	135	215	0	59	80	0.7375000
NODE_18668_length_672_cov_6.108202	135	215	1	21	80	0.2625000
NODE_18668_length_672_cov_6.108202	188	268	0	6	80	0.0750000
NODE_18668_length_672_cov_6.108202	188	268	1	74	80	0.9250000
NODE_18670_length_672_cov_4.949389	115	152	3	37	37	1.0000000
NODE_18670_length_672_cov_4.949389	125	205	1	1	80	0.0125000
NODE_18670_length_672_cov_4.949389	125	205	2	35	80	0.4375000
NODE_18670_length_672_cov_4.949389	125	205	3	44	80	0.5500000
NODE_18670_length_672_cov_4.949389	278	326	0	48	48	1.0000000
NODE_18672_length_672_cov_4.753927	378	450	0	72	72	1.0000000
NODE_18704_length_672_cov_1.713787	340	401	0	61	61	1.0000000
NODE_18742_length_671_cov_28.874126	306	387	6	30	81	0.3703704
NODE_18742_length_671_cov_28.874126	306	387	8	25	81	0.3086420
NODE_18742_length_671_cov_28.874126	306	387	9	26	81	0.3209876
NODE_18742_length_671_cov_28.874126	360	440	6	2	80	0.0250000
NODE_18742_length_671_cov_28.874126	360	440	7	5	80	0.0625000
NODE_18742_length_671_cov_28.874126	360	440	8	39	80	0.4875000
NODE_18742_length_671_cov_28.874126	360	440	9	24	80	0.3000000
NODE_18742_length_671_cov_28.874126	360	440	10	10	80	0.1250000
NODE_18744_length_671_cov_18.526224	294	333	1	37	39	0.9487180
NODE_18744_length_671_cov_18.526224	294	333	6	2	39	0.0512821
NODE_18744_length_671_cov_18.526224	331	404	6	73	73	1.0000000
NODE_18744_length_671_cov_18.526224	331	351	6	20	20	1.0000000
NODE_18745_length_671_cov_16.094406	417	497	4	12	80	0.1500000
NODE_18745_length_671_cov_16.094406	417	497	5	25	80	0.3125000
NODE_18745_length_671_cov_16.094406	417	497	6	13	80	0.1625000
NODE_18745_length_671_cov_16.094406	417	497	8	30	80	0.3750000
NODE_18745_length_671_cov_16.094406	470	550	7	20	80	0.2500000
NODE_18745_length_671_cov_16.094406	470	550	8	60	80	0.7500000
NODE_18746_length_671_cov_11.756993	337	417	1	47	80	0.5875000
NODE_18746_length_671_cov_11.756993	337	417	2	33	80	0.4125000
NODE_18746_length_671_cov_11.756993	390	470	1	24	80	0.3000000
NODE_18746_length_671_cov_11.756993	390	470	2	4	80	0.0500000
NODE_18746_length_671_cov_11.756993	390	470	3	52	80	0.6500000
NODE_18747_length_671_cov_9.237762	305	382	0	77	77	1.0000000
NODE_18748_length_671_cov_8.491259	298	379	2	3	81	0.0370370
NODE_18748_length_671_cov_8.491259	298	379	4	4	81	0.0493827
NODE_18748_length_671_cov_8.491259	298	379	5	15	81	0.1851852
NODE_18748_length_671_cov_8.491259	298	379	6	28	81	0.3456790
NODE_18748_length_671_cov_8.491259	298	379	7	31	81	0.3827161
NODE_18748_length_671_cov_8.491259	352	430	6	78	78	1.0000000
NODE_18749_length_671_cov_8.241259	97	128	0	31	31	1.0000000
NODE_18752_length_671_cov_7.201049	368	448	0	80	80	1.0000000
NODE_18752_length_671_cov_7.201049	421	501	0	80	80	1.0000000
NODE_18753_length_671_cov_5.680070	370	450	0	80	80	1.0000000
NODE_18753_length_671_cov_5.680070	423	503	0	80	80	1.0000000
NODE_18754_length_671_cov_4.769231	362	414	0	52	52	1.0000000
NODE_18760_length_671_cov_3.804196	360	440	0	80	80	1.0000000
NODE_18812_length_670_cov_21.017513	443	523	6	1	80	0.0125000
NODE_18812_length_670_cov_21.017513	443	523	7	23	80	0.2875000
NODE_18812_length_670_cov_21.017513	443	523	9	11	80	0.1375000
NODE_18812_length_670_cov_21.017513	443	523	10	28	80	0.3500000
NODE_18812_length_670_cov_21.017513	443	523	11	17	80	0.2125000
NODE_18812_length_670_cov_21.017513	496	576	4	18	80	0.2250000
NODE_18812_length_670_cov_21.017513	496	576	6	14	80	0.1750000
NODE_18812_length_670_cov_21.017513	496	576	7	45	80	0.5625000
NODE_18812_length_670_cov_21.017513	496	576	9	3	80	0.0375000
NODE_18813_length_670_cov_20.346760	372	452	5	5	80	0.0625000
NODE_18813_length_670_cov_20.346760	372	452	7	28	80	0.3500000
NODE_18813_length_670_cov_20.346760	372	452	8	1	80	0.0125000
NODE_18813_length_670_cov_20.346760	372	452	9	2	80	0.0250000
NODE_18813_length_670_cov_20.346760	372	452	10	5	80	0.0625000
NODE_18813_length_670_cov_20.346760	372	452	11	13	80	0.1625000
NODE_18813_length_670_cov_20.346760	372	452	13	5	80	0.0625000
NODE_18813_length_670_cov_20.346760	372	452	14	2	80	0.0250000
NODE_18813_length_670_cov_20.346760	372	452	15	14	80	0.1750000
NODE_18813_length_670_cov_20.346760	372	452	16	5	80	0.0625000
NODE_18813_length_670_cov_20.346760	425	505	11	13	80	0.1625000
NODE_18813_length_670_cov_20.346760	425	505	12	14	80	0.1750000
NODE_18813_length_670_cov_20.346760	425	505	13	5	80	0.0625000
NODE_18813_length_670_cov_20.346760	425	505	14	2	80	0.0250000
NODE_18813_length_670_cov_20.346760	425	505	15	31	80	0.3875000
NODE_18813_length_670_cov_20.346760	425	505	16	15	80	0.1875000
NODE_18814_length_670_cov_15.728546	157	237	4	20	80	0.2500000
NODE_18814_length_670_cov_15.728546	157	237	8	44	80	0.5500000
NODE_18814_length_670_cov_15.728546	157	237	9	16	80	0.2000000
NODE_18814_length_670_cov_15.728546	210	290	8	36	80	0.4500000
NODE_18814_length_670_cov_15.728546	210	290	9	44	80	0.5500000
NODE_18814_length_670_cov_15.728546	286	366	3	30	80	0.3750000
NODE_18814_length_670_cov_15.728546	286	366	4	9	80	0.1125000
NODE_18814_length_670_cov_15.728546	286	366	8	21	80	0.2625000
NODE_18814_length_670_cov_15.728546	286	366	9	20	80	0.2500000
NODE_18814_length_670_cov_15.728546	339	419	0	23	80	0.2875000
NODE_18814_length_670_cov_15.728546	339	419	1	24	80	0.3000000
NODE_18814_length_670_cov_15.728546	339	419	3	33	80	0.4125000
NODE_18818_length_670_cov_6.499124	390	470	2	80	80	1.0000000
NODE_18834_length_670_cov_3.099825	159	217	0	58	58	1.0000000
NODE_18838_length_670_cov_2.700525	252	332	0	17	80	0.2125000
NODE_18838_length_670_cov_2.700525	252	332	2	63	80	0.7875000
NODE_18838_length_670_cov_2.700525	305	385	0	63	80	0.7875000
NODE_18838_length_670_cov_2.700525	305	385	2	17	80	0.2125000
NODE_18883_length_669_cov_13.307018	432	512	2	5	80	0.0625000
NODE_18883_length_669_cov_13.307018	432	512	3	2	80	0.0250000
NODE_18883_length_669_cov_13.307018	432	512	4	1	80	0.0125000
NODE_18883_length_669_cov_13.307018	432	512	7	7	80	0.0875000
NODE_18883_length_669_cov_13.307018	432	512	8	2	80	0.0250000
NODE_18883_length_669_cov_13.307018	432	512	9	63	80	0.7875000
NODE_18883_length_669_cov_13.307018	485	565	1	48	80	0.6000000
NODE_18883_length_669_cov_13.307018	485	565	2	10	80	0.1250000
NODE_18883_length_669_cov_13.307018	485	565	3	2	80	0.0250000
NODE_18883_length_669_cov_13.307018	485	565	4	1	80	0.0125000
NODE_18883_length_669_cov_13.307018	485	565	7	7	80	0.0875000
NODE_18883_length_669_cov_13.307018	485	565	9	12	80	0.1500000
NODE_18886_length_669_cov_6.921053	245	325	0	80	80	1.0000000
NODE_18886_length_669_cov_6.921053	298	370	0	72	72	1.0000000
NODE_18901_length_669_cov_3.633333	277	347	0	70	70	1.0000000
NODE_18909_length_669_cov_2.361404	434	490	0	23	56	0.4107143
NODE_18909_length_669_cov_2.361404	434	490	1	33	56	0.5892857
NODE_18958_length_668_cov_23.131810	275	355	2	7	80	0.0875000
NODE_18958_length_668_cov_23.131810	275	355	4	73	80	0.9125000
NODE_18958_length_668_cov_23.131810	328	408	4	72	80	0.9000000
NODE_18958_length_668_cov_23.131810	328	408	6	8	80	0.1000000
NODE_18959_length_668_cov_14.978910	324	404	0	57	80	0.7125000
NODE_18959_length_668_cov_14.978910	324	404	1	23	80	0.2875000
NODE_18959_length_668_cov_14.978910	377	457	0	4	80	0.0500000
NODE_18959_length_668_cov_14.978910	377	457	1	33	80	0.4125000
NODE_18959_length_668_cov_14.978910	377	457	2	43	80	0.5375000
NODE_18962_length_668_cov_11.184534	187	267	3	9	80	0.1125000
NODE_18962_length_668_cov_11.184534	187	267	4	24	80	0.3000000
NODE_18962_length_668_cov_11.184534	187	267	5	47	80	0.5875000
NODE_18962_length_668_cov_11.184534	240	320	4	34	80	0.4250000
NODE_18962_length_668_cov_11.184534	240	320	5	46	80	0.5750000
NODE_18963_length_668_cov_10.548330	211	291	0	80	80	1.0000000
NODE_18963_length_668_cov_10.548330	264	344	0	80	80	1.0000000
NODE_18964_length_668_cov_10.370826	226	308	3	32	82	0.3902439
NODE_18964_length_668_cov_10.370826	226	308	4	5	82	0.0609756
NODE_18964_length_668_cov_10.370826	226	308	6	34	82	0.4146341
NODE_18964_length_668_cov_10.370826	226	308	8	11	82	0.1341463
NODE_18964_length_668_cov_10.370826	279	361	6	22	82	0.2682927
NODE_18964_length_668_cov_10.370826	279	361	8	60	82	0.7317073
NODE_18965_length_668_cov_10.223199	238	318	3	43	80	0.5375000
NODE_18965_length_668_cov_10.223199	238	318	6	37	80	0.4625000
NODE_18965_length_668_cov_10.223199	291	371	3	4	80	0.0500000
NODE_18965_length_668_cov_10.223199	291	371	6	76	80	0.9500000
NODE_18967_length_668_cov_9.340949	310	390	0	63	80	0.7875000
NODE_18967_length_668_cov_9.340949	310	390	1	17	80	0.2125000
NODE_18967_length_668_cov_9.340949	363	443	0	10	80	0.1250000
NODE_18967_length_668_cov_9.340949	363	443	1	41	80	0.5125000
NODE_18967_length_668_cov_9.340949	363	443	2	29	80	0.3625000
NODE_18975_length_668_cov_4.077329	304	384	2	5	80	0.0625000
NODE_18975_length_668_cov_4.077329	304	384	4	22	80	0.2750000
NODE_18975_length_668_cov_4.077329	304	384	5	42	80	0.5250000
NODE_18975_length_668_cov_4.077329	304	384	6	11	80	0.1375000
NODE_18975_length_668_cov_4.077329	338	367	5	29	29	1.0000000
NODE_18975_length_668_cov_4.077329	358	427	4	10	69	0.1449275
NODE_18975_length_668_cov_4.077329	358	427	5	15	69	0.2173913
NODE_18975_length_668_cov_4.077329	358	427	6	44	69	0.6376812
NODE_19032_length_667_cov_33.848592	168	248	3	4	80	0.0500000
NODE_19032_length_667_cov_33.848592	168	248	5	18	80	0.2250000
NODE_19032_length_667_cov_33.848592	168	248	7	58	80	0.7250000
NODE_19032_length_667_cov_33.848592	221	301	4	27	80	0.3375000
NODE_19032_length_667_cov_33.848592	221	301	6	21	80	0.2625000
NODE_19032_length_667_cov_33.848592	221	301	7	32	80	0.4000000
NODE_19033_length_667_cov_21.218310	270	350	4	1	80	0.0125000
NODE_19033_length_667_cov_21.218310	270	350	6	47	80	0.5875000
NODE_19033_length_667_cov_21.218310	270	350	7	5	80	0.0625000
NODE_19033_length_667_cov_21.218310	270	350	8	27	80	0.3375000
NODE_19033_length_667_cov_21.218310	323	403	5	20	80	0.2500000
NODE_19033_length_667_cov_21.218310	323	403	6	21	80	0.2625000
NODE_19033_length_667_cov_21.218310	323	403	7	17	80	0.2125000
NODE_19033_length_667_cov_21.218310	323	403	8	22	80	0.2750000
NODE_19034_length_667_cov_19.204225	258	338	0	80	80	1.0000000
NODE_19034_length_667_cov_19.204225	311	391	0	80	80	1.0000000
NODE_19036_length_667_cov_8.264085	299	379	2	80	80	1.0000000
NODE_19036_length_667_cov_8.264085	352	432	0	27	80	0.3375000
NODE_19036_length_667_cov_8.264085	352	432	2	53	80	0.6625000
NODE_19037_length_667_cov_8.248239	76	156	1	80	80	1.0000000
NODE_19037_length_667_cov_8.248239	129	209	0	30	80	0.3750000
NODE_19037_length_667_cov_8.248239	129	209	1	50	80	0.6250000
NODE_19038_length_667_cov_8.207746	257	323	0	66	66	1.0000000
NODE_19038_length_667_cov_8.207746	296	376	0	80	80	1.0000000
NODE_19039_length_667_cov_7.232394	357	437	1	35	80	0.4375000
NODE_19039_length_667_cov_7.232394	357	437	3	36	80	0.4500000
NODE_19039_length_667_cov_7.232394	357	437	4	1	80	0.0125000
NODE_19039_length_667_cov_7.232394	357	437	5	8	80	0.1000000
NODE_19039_length_667_cov_7.232394	410	490	3	18	80	0.2250000
NODE_19039_length_667_cov_7.232394	410	490	4	1	80	0.0125000
NODE_19039_length_667_cov_7.232394	410	490	5	20	80	0.2500000
NODE_19039_length_667_cov_7.232394	410	490	6	24	80	0.3000000
NODE_19039_length_667_cov_7.232394	410	490	7	17	80	0.2125000
NODE_19042_length_667_cov_4.941901	199	279	0	80	80	1.0000000
NODE_19042_length_667_cov_4.941901	252	332	0	80	80	1.0000000
NODE_19053_length_667_cov_3.404930	501	536	0	35	35	1.0000000
NODE_19053_length_667_cov_3.404930	503	533	0	30	30	1.0000000
NODE_19100_length_666_cov_24.811287	179	254	1	24	75	0.3200000
NODE_19100_length_666_cov_24.811287	179	254	2	18	75	0.2400000
NODE_19100_length_666_cov_24.811287	179	254	7	26	75	0.3466667
NODE_19100_length_666_cov_24.811287	179	254	13	7	75	0.0933333
NODE_19100_length_666_cov_24.811287	182	254	1	24	72	0.3333333
NODE_19100_length_666_cov_24.811287	182	254	2	15	72	0.2083333
NODE_19100_length_666_cov_24.811287	182	254	7	26	72	0.3611111
NODE_19100_length_666_cov_24.811287	182	254	13	7	72	0.0972222
NODE_19100_length_666_cov_24.811287	227	307	7	20	80	0.2500000
NODE_19100_length_666_cov_24.811287	227	307	13	31	80	0.3875000
NODE_19100_length_666_cov_24.811287	227	307	14	1	80	0.0125000
NODE_19100_length_666_cov_24.811287	227	307	17	5	80	0.0625000
NODE_19100_length_666_cov_24.811287	227	307	18	16	80	0.2000000
NODE_19100_length_666_cov_24.811287	227	307	19	7	80	0.0875000
NODE_19100_length_666_cov_24.811287	227	307	7	20	80	0.2500000
NODE_19100_length_666_cov_24.811287	227	307	13	31	80	0.3875000
NODE_19100_length_666_cov_24.811287	227	307	14	1	80	0.0125000
NODE_19100_length_666_cov_24.811287	227	307	17	5	80	0.0625000
NODE_19100_length_666_cov_24.811287	227	307	18	16	80	0.2000000
NODE_19100_length_666_cov_24.811287	227	307	19	7	80	0.0875000
NODE_19100_length_666_cov_24.811287	303	383	19	8	80	0.1000000
NODE_19100_length_666_cov_24.811287	303	383	20	7	80	0.0875000
NODE_19100_length_666_cov_24.811287	303	383	24	1	80	0.0125000
NODE_19100_length_666_cov_24.811287	303	383	26	12	80	0.1500000
NODE_19100_length_666_cov_24.811287	303	383	27	2	80	0.0250000
NODE_19100_length_666_cov_24.811287	303	383	30	12	80	0.1500000
NODE_19100_length_666_cov_24.811287	303	383	34	1	80	0.0125000
NODE_19100_length_666_cov_24.811287	303	383	35	34	80	0.4250000
NODE_19100_length_666_cov_24.811287	303	383	36	3	80	0.0375000
NODE_19100_length_666_cov_24.811287	356	436	18	8	80	0.1000000
NODE_19100_length_666_cov_24.811287	356	436	24	31	80	0.3875000
NODE_19100_length_666_cov_24.811287	356	436	30	26	80	0.3250000
NODE_19100_length_666_cov_24.811287	356	436	35	12	80	0.1500000
NODE_19100_length_666_cov_24.811287	356	436	36	3	80	0.0375000
NODE_19102_length_666_cov_20.114638	172	252	0	62	80	0.7750000
NODE_19102_length_666_cov_20.114638	172	252	4	18	80	0.2250000
NODE_19102_length_666_cov_20.114638	225	305	0	9	80	0.1125000
NODE_19102_length_666_cov_20.114638	225	305	4	62	80	0.7750000
NODE_19102_length_666_cov_20.114638	225	305	5	1	80	0.0125000
NODE_19102_length_666_cov_20.114638	225	305	8	8	80	0.1000000
NODE_19103_length_666_cov_16.813051	220	286	4	66	66	1.0000000
NODE_19103_length_666_cov_16.813051	259	344	1	20	85	0.2352941
NODE_19103_length_666_cov_16.813051	259	344	3	24	85	0.2823530
NODE_19103_length_666_cov_16.813051	259	344	4	41	85	0.4823529
NODE_19104_length_666_cov_15.384480	306	386	0	28	80	0.3500000
NODE_19104_length_666_cov_15.384480	306	386	1	52	80	0.6500000
NODE_19104_length_666_cov_15.384480	359	439	1	80	80	1.0000000
NODE_19105_length_666_cov_14.195767	485	565	5	23	80	0.2875000
NODE_19105_length_666_cov_14.195767	485	565	8	57	80	0.7125000
NODE_19105_length_666_cov_14.195767	538	618	5	24	80	0.3000000
NODE_19105_length_666_cov_14.195767	538	618	8	56	80	0.7000000
NODE_19108_length_666_cov_7.770723	226	306	0	44	80	0.5500000
NODE_19108_length_666_cov_7.770723	226	306	3	36	80	0.4500000
NODE_19108_length_666_cov_7.770723	279	359	3	80	80	1.0000000
NODE_19163_length_665_cov_28.786219	391	471	0	80	80	1.0000000
NODE_19163_length_665_cov_28.786219	444	524	0	80	80	1.0000000
NODE_19164_length_665_cov_21.740283	311	391	3	1	80	0.0125000
NODE_19164_length_665_cov_21.740283	311	391	4	39	80	0.4875000
NODE_19164_length_665_cov_21.740283	311	391	6	37	80	0.4625000
NODE_19164_length_665_cov_21.740283	311	391	7	3	80	0.0375000
NODE_19164_length_665_cov_21.740283	364	444	1	36	80	0.4500000
NODE_19164_length_665_cov_21.740283	364	444	3	7	80	0.0875000
NODE_19164_length_665_cov_21.740283	364	444	4	37	80	0.4625000
NODE_19165_length_665_cov_15.904594	390	470	6	25	80	0.3125000
NODE_19165_length_665_cov_15.904594	390	470	7	40	80	0.5000000
NODE_19165_length_665_cov_15.904594	390	470	8	1	80	0.0125000
NODE_19165_length_665_cov_15.904594	390	470	9	6	80	0.0750000
NODE_19165_length_665_cov_15.904594	390	470	11	2	80	0.0250000
NODE_19165_length_665_cov_15.904594	390	470	13	6	80	0.0750000
NODE_19165_length_665_cov_15.904594	443	523	7	21	80	0.2625000
NODE_19165_length_665_cov_15.904594	443	523	12	20	80	0.2500000
NODE_19165_length_665_cov_15.904594	443	523	13	32	80	0.4000000
NODE_19165_length_665_cov_15.904594	443	523	14	1	80	0.0125000
NODE_19165_length_665_cov_15.904594	443	523	15	1	80	0.0125000
NODE_19165_length_665_cov_15.904594	443	523	16	5	80	0.0625000
NODE_19224_length_664_cov_27.208850	259	339	0	80	80	1.0000000
NODE_19224_length_664_cov_27.208850	345	404	0	59	59	1.0000000
NODE_19225_length_664_cov_16.116814	241	321	10	14	80	0.1750000
NODE_19225_length_664_cov_16.116814	241	321	12	6	80	0.0750000
NODE_19225_length_664_cov_16.116814	241	321	13	14	80	0.1750000
NODE_19225_length_664_cov_16.116814	241	321	14	1	80	0.0125000
NODE_19225_length_664_cov_16.116814	241	321	15	16	80	0.2000000
NODE_19225_length_664_cov_16.116814	241	321	16	8	80	0.1000000
NODE_19225_length_664_cov_16.116814	241	321	17	21	80	0.2625000
NODE_19225_length_664_cov_16.116814	294	374	11	4	80	0.0500000
NODE_19225_length_664_cov_16.116814	294	374	12	21	80	0.2625000
NODE_19225_length_664_cov_16.116814	294	374	13	12	80	0.1500000
NODE_19225_length_664_cov_16.116814	294	374	14	3	80	0.0375000
NODE_19225_length_664_cov_16.116814	294	374	15	6	80	0.0750000
NODE_19225_length_664_cov_16.116814	294	374	16	15	80	0.1875000
NODE_19225_length_664_cov_16.116814	294	374	17	19	80	0.2375000
NODE_19227_length_664_cov_14.185841	332	412	0	8	80	0.1000000
NODE_19227_length_664_cov_14.185841	332	412	5	49	80	0.6125000
NODE_19227_length_664_cov_14.185841	332	412	10	23	80	0.2875000
NODE_19227_length_664_cov_14.185841	385	465	0	61	80	0.7625000
NODE_19227_length_664_cov_14.185841	385	465	5	19	80	0.2375000
NODE_19228_length_664_cov_12.256637	325	405	0	80	80	1.0000000
NODE_19228_length_664_cov_12.256637	378	454	0	76	76	1.0000000
NODE_19229_length_664_cov_8.378761	252	332	4	22	80	0.2750000
NODE_19229_length_664_cov_8.378761	252	332	5	24	80	0.3000000
NODE_19229_length_664_cov_8.378761	252	332	6	34	80	0.4250000
NODE_19229_length_664_cov_8.378761	305	385	1	1	80	0.0125000
NODE_19229_length_664_cov_8.378761	305	385	2	14	80	0.1750000
NODE_19229_length_664_cov_8.378761	305	385	3	16	80	0.2000000
NODE_19229_length_664_cov_8.378761	305	385	4	44	80	0.5500000
NODE_19229_length_664_cov_8.378761	305	385	6	5	80	0.0625000
NODE_19229_length_664_cov_8.378761	381	461	2	35	80	0.4375000
NODE_19229_length_664_cov_8.378761	381	461	3	45	80	0.5625000
NODE_19229_length_664_cov_8.378761	434	514	2	80	80	1.0000000
NODE_19254_length_664_cov_1.922124	393	434	0	41	41	1.0000000
NODE_19298_length_663_cov_26.601064	398	478	10	7	80	0.0875000
NODE_19298_length_663_cov_26.601064	398	478	11	34	80	0.4250000
NODE_19298_length_663_cov_26.601064	398	478	12	10	80	0.1250000
NODE_19298_length_663_cov_26.601064	398	478	13	16	80	0.2000000
NODE_19298_length_663_cov_26.601064	398	478	14	7	80	0.0875000
NODE_19298_length_663_cov_26.601064	398	478	15	6	80	0.0750000
NODE_19298_length_663_cov_26.601064	451	531	2	7	80	0.0875000
NODE_19298_length_663_cov_26.601064	451	531	3	22	80	0.2750000
NODE_19298_length_663_cov_26.601064	451	531	5	6	80	0.0750000
NODE_19298_length_663_cov_26.601064	451	531	6	2	80	0.0250000
NODE_19298_length_663_cov_26.601064	451	531	7	7	80	0.0875000
NODE_19298_length_663_cov_26.601064	451	531	8	6	80	0.0750000
NODE_19298_length_663_cov_26.601064	451	531	9	2	80	0.0250000
NODE_19298_length_663_cov_26.601064	451	531	10	8	80	0.1000000
NODE_19298_length_663_cov_26.601064	451	531	11	20	80	0.2500000
NODE_19299_length_663_cov_16.948582	368	448	4	6	80	0.0750000
NODE_19299_length_663_cov_16.948582	368	448	7	3	80	0.0375000
NODE_19299_length_663_cov_16.948582	368	448	8	47	80	0.5875000
NODE_19299_length_663_cov_16.948582	368	448	11	24	80	0.3000000
NODE_19299_length_663_cov_16.948582	421	501	0	53	80	0.6625000
NODE_19299_length_663_cov_16.948582	421	501	4	6	80	0.0750000
NODE_19299_length_663_cov_16.948582	421	501	7	3	80	0.0375000
NODE_19299_length_663_cov_16.948582	421	501	8	18	80	0.2250000
NODE_19300_length_663_cov_16.225177	118	198	0	19	80	0.2375000
NODE_19300_length_663_cov_16.225177	118	198	2	8	80	0.1000000
NODE_19300_length_663_cov_16.225177	118	198	3	53	80	0.6625000
NODE_19300_length_663_cov_16.225177	171	251	3	49	80	0.6125000
NODE_19300_length_663_cov_16.225177	171	251	4	31	80	0.3875000
NODE_19302_length_663_cov_13.748227	277	357	5	80	80	1.0000000
NODE_19302_length_663_cov_13.748227	330	410	1	3	80	0.0375000
NODE_19302_length_663_cov_13.748227	330	410	2	26	80	0.3250000
NODE_19302_length_663_cov_13.748227	330	410	3	11	80	0.1375000
NODE_19302_length_663_cov_13.748227	330	410	4	10	80	0.1250000
NODE_19302_length_663_cov_13.748227	330	410	5	30	80	0.3750000
NODE_19303_length_663_cov_10.377660	300	380	0	80	80	1.0000000
NODE_19304_length_663_cov_9.549645	199	279	1	36	80	0.4500000
NODE_19304_length_663_cov_9.549645	199	279	3	26	80	0.3250000
NODE_19304_length_663_cov_9.549645	199	279	4	18	80	0.2250000
NODE_19304_length_663_cov_9.549645	252	332	3	66	80	0.8250000
NODE_19304_length_663_cov_9.549645	252	332	4	14	80	0.1750000
NODE_19305_length_663_cov_7.397163	151	231	0	80	80	1.0000000
NODE_19305_length_663_cov_7.397163	204	284	0	80	80	1.0000000
NODE_19307_length_663_cov_5.081560	317	397	0	80	80	1.0000000
NODE_19368_length_662_cov_29.218472	233	313	3	4	80	0.0500000
NODE_19368_length_662_cov_29.218472	233	313	4	40	80	0.5000000
NODE_19368_length_662_cov_29.218472	233	313	5	28	80	0.3500000
NODE_19368_length_662_cov_29.218472	233	313	6	5	80	0.0625000
NODE_19368_length_662_cov_29.218472	233	313	7	3	80	0.0375000
NODE_19368_length_662_cov_29.218472	286	366	5	24	80	0.3000000
NODE_19368_length_662_cov_29.218472	286	366	7	3	80	0.0375000
NODE_19368_length_662_cov_29.218472	286	366	8	40	80	0.5000000
NODE_19368_length_662_cov_29.218472	286	366	10	12	80	0.1500000
NODE_19368_length_662_cov_29.218472	286	366	11	1	80	0.0125000
NODE_19369_length_662_cov_18.717584	193	273	0	63	80	0.7875000
NODE_19369_length_662_cov_18.717584	193	273	1	17	80	0.2125000
NODE_19369_length_662_cov_18.717584	246	326	0	10	80	0.1250000
NODE_19369_length_662_cov_18.717584	246	326	1	31	80	0.3875000
NODE_19369_length_662_cov_18.717584	246	326	2	39	80	0.4875000
NODE_19370_length_662_cov_16.358792	258	338	3	49	80	0.6125000
NODE_19370_length_662_cov_16.358792	258	338	5	2	80	0.0250000
NODE_19370_length_662_cov_16.358792	258	338	6	29	80	0.3625000
NODE_19370_length_662_cov_16.358792	311	391	5	3	80	0.0375000
NODE_19370_length_662_cov_16.358792	311	391	6	77	80	0.9625000
NODE_19371_length_662_cov_12.845471	259	339	0	80	80	1.0000000
NODE_19371_length_662_cov_12.845471	312	392	0	80	80	1.0000000
NODE_19372_length_662_cov_12.476021	299	379	8	31	80	0.3875000
NODE_19372_length_662_cov_12.476021	299	379	9	22	80	0.2750000
NODE_19372_length_662_cov_12.476021	299	379	10	27	80	0.3375000
NODE_19372_length_662_cov_12.476021	352	432	5	9	80	0.1125000
NODE_19372_length_662_cov_12.476021	352	432	6	3	80	0.0375000
NODE_19372_length_662_cov_12.476021	352	432	7	17	80	0.2125000
NODE_19372_length_662_cov_12.476021	352	432	8	7	80	0.0875000
NODE_19372_length_662_cov_12.476021	352	432	9	9	80	0.1125000
NODE_19372_length_662_cov_12.476021	352	432	10	35	80	0.4375000
NODE_19373_length_662_cov_10.252220	239	319	0	80	80	1.0000000
NODE_19373_length_662_cov_10.252220	292	372	0	80	80	1.0000000
NODE_19376_length_662_cov_6.335702	267	347	2	80	80	1.0000000
NODE_19376_length_662_cov_6.335702	320	400	0	5	80	0.0625000
NODE_19376_length_662_cov_6.335702	320	400	2	75	80	0.9375000
NODE_19378_length_662_cov_5.738899	295	331	0	36	36	1.0000000
NODE_19378_length_662_cov_5.738899	301	322	0	21	21	1.0000000
NODE_19402_length_662_cov_1.905861	150	230	0	80	80	1.0000000
NODE_19402_length_662_cov_1.905861	203	277	0	74	74	1.0000000
NODE_19441_length_661_cov_55.176157	236	316	6	5	80	0.0625000
NODE_19441_length_661_cov_55.176157	236	316	7	34	80	0.4250000
NODE_19441_length_661_cov_55.176157	236	316	8	23	80	0.2875000
NODE_19441_length_661_cov_55.176157	236	316	9	11	80	0.1375000
NODE_19441_length_661_cov_55.176157	236	316	10	7	80	0.0875000
NODE_19441_length_661_cov_55.176157	289	369	6	33	80	0.4125000
NODE_19441_length_661_cov_55.176157	289	369	7	1	80	0.0125000
NODE_19441_length_661_cov_55.176157	289	369	8	15	80	0.1875000
NODE_19441_length_661_cov_55.176157	289	369	9	10	80	0.1250000
NODE_19441_length_661_cov_55.176157	289	369	10	21	80	0.2625000
NODE_19442_length_661_cov_38.501779	231	311	0	80	80	1.0000000
NODE_19442_length_661_cov_38.501779	284	364	0	56	80	0.7000000
NODE_19442_length_661_cov_38.501779	284	364	3	24	80	0.3000000
NODE_19442_length_661_cov_38.501779	360	440	3	11	80	0.1375000
NODE_19442_length_661_cov_38.501779	360	440	4	61	80	0.7625000
NODE_19442_length_661_cov_38.501779	360	440	6	8	80	0.1000000
NODE_19442_length_661_cov_38.501779	413	493	3	3	80	0.0375000
NODE_19442_length_661_cov_38.501779	413	493	4	19	80	0.2375000
NODE_19442_length_661_cov_38.501779	413	493	6	58	80	0.7250000
NODE_19443_length_661_cov_31.460854	128	208	3	1	80	0.0125000
NODE_19443_length_661_cov_31.460854	128	208	4	3	80	0.0375000
NODE_19443_length_661_cov_31.460854	128	208	6	2	80	0.0250000
NODE_19443_length_661_cov_31.460854	128	208	8	3	80	0.0375000
NODE_19443_length_661_cov_31.460854	128	208	9	4	80	0.0500000
NODE_19443_length_661_cov_31.460854	128	208	10	5	80	0.0625000
NODE_19443_length_661_cov_31.460854	128	208	11	7	80	0.0875000
NODE_19443_length_661_cov_31.460854	128	208	12	2	80	0.0250000
NODE_19443_length_661_cov_31.460854	128	208	13	2	80	0.0250000
NODE_19443_length_661_cov_31.460854	128	208	15	10	80	0.1250000
NODE_19443_length_661_cov_31.460854	128	208	16	2	80	0.0250000
NODE_19443_length_661_cov_31.460854	128	208	17	13	80	0.1625000
NODE_19443_length_661_cov_31.460854	128	208	18	3	80	0.0375000
NODE_19443_length_661_cov_31.460854	128	208	19	17	80	0.2125000
NODE_19443_length_661_cov_31.460854	128	208	20	6	80	0.0750000
NODE_19443_length_661_cov_31.460854	181	261	17	6	80	0.0750000
NODE_19443_length_661_cov_31.460854	181	261	19	15	80	0.1875000
NODE_19443_length_661_cov_31.460854	181	261	20	16	80	0.2000000
NODE_19443_length_661_cov_31.460854	181	261	21	15	80	0.1875000
NODE_19443_length_661_cov_31.460854	181	261	22	17	80	0.2125000
NODE_19443_length_661_cov_31.460854	181	261	23	11	80	0.1375000
NODE_19444_length_661_cov_18.960854	216	296	0	80	80	1.0000000
NODE_19444_length_661_cov_18.960854	269	349	0	80	80	1.0000000
NODE_19445_length_661_cov_16.035587	201	281	2	57	80	0.7125000
NODE_19445_length_661_cov_16.035587	201	281	3	22	80	0.2750000
NODE_19445_length_661_cov_16.035587	201	281	4	1	80	0.0125000
NODE_19445_length_661_cov_16.035587	254	334	2	4	80	0.0500000
NODE_19445_length_661_cov_16.035587	254	334	3	22	80	0.2750000
NODE_19445_length_661_cov_16.035587	254	334	4	54	80	0.6750000
NODE_19447_length_661_cov_13.005338	281	343	0	62	62	1.0000000
NODE_19447_length_661_cov_13.005338	353	433	0	80	80	1.0000000
NODE_19447_length_661_cov_13.005338	406	486	0	80	80	1.0000000
NODE_19452_length_661_cov_5.670819	374	454	2	54	80	0.6750000
NODE_19452_length_661_cov_5.670819	374	454	3	26	80	0.3250000
NODE_19452_length_661_cov_5.670819	427	507	2	24	80	0.3000000
NODE_19452_length_661_cov_5.670819	427	507	3	56	80	0.7000000
NODE_19457_length_661_cov_4.601423	319	395	1	43	76	0.5657895
NODE_19457_length_661_cov_4.601423	319	395	3	20	76	0.2631579
NODE_19457_length_661_cov_4.601423	319	395	4	13	76	0.1710526
NODE_19459_length_661_cov_3.532028	282	362	0	80	80	1.0000000
NODE_19459_length_661_cov_3.532028	335	415	0	80	80	1.0000000
NODE_19515_length_660_cov_20.741533	343	423	0	80	80	1.0000000
NODE_19515_length_660_cov_20.741533	396	476	0	80	80	1.0000000
NODE_19516_length_660_cov_15.089127	148	228	0	9	80	0.1125000
NODE_19516_length_660_cov_15.089127	148	228	2	1	80	0.0125000
NODE_19516_length_660_cov_15.089127	148	228	3	15	80	0.1875000
NODE_19516_length_660_cov_15.089127	148	228	4	24	80	0.3000000
NODE_19516_length_660_cov_15.089127	148	228	6	31	80	0.3875000
NODE_19516_length_660_cov_15.089127	201	281	6	50	80	0.6250000
NODE_19516_length_660_cov_15.089127	201	281	7	30	80	0.3750000
NODE_19518_length_660_cov_13.301248	276	356	2	19	80	0.2375000
NODE_19518_length_660_cov_13.301248	276	356	3	35	80	0.4375000
NODE_19518_length_660_cov_13.301248	276	356	4	13	80	0.1625000
NODE_19518_length_660_cov_13.301248	276	356	5	13	80	0.1625000
NODE_19518_length_660_cov_13.301248	329	409	3	1	80	0.0125000
NODE_19518_length_660_cov_13.301248	329	409	4	31	80	0.3875000
NODE_19518_length_660_cov_13.301248	329	409	5	48	80	0.6000000
NODE_19519_length_660_cov_12.393939	234	314	0	80	80	1.0000000
NODE_19519_length_660_cov_12.393939	287	367	0	80	80	1.0000000
NODE_19521_length_660_cov_11.495544	399	479	0	80	80	1.0000000
NODE_19521_length_660_cov_11.495544	452	532	0	80	80	1.0000000
NODE_19522_length_660_cov_10.522282	177	257	0	34	80	0.4250000
NODE_19522_length_660_cov_10.522282	177	257	2	45	80	0.5625000
NODE_19522_length_660_cov_10.522282	177	257	4	1	80	0.0125000
NODE_19522_length_660_cov_10.522282	230	311	2	26	81	0.3209876
NODE_19522_length_660_cov_10.522282	230	311	4	55	81	0.6790124
NODE_19524_length_660_cov_8.887701	254	325	14	2	71	0.0281690
NODE_19524_length_660_cov_8.887701	254	325	15	12	71	0.1690141
NODE_19524_length_660_cov_8.887701	254	325	16	17	71	0.2394366
NODE_19524_length_660_cov_8.887701	254	325	17	6	71	0.0845070
NODE_19524_length_660_cov_8.887701	254	325	18	8	71	0.1126761
NODE_19524_length_660_cov_8.887701	254	325	19	12	71	0.1690141
NODE_19524_length_660_cov_8.887701	254	325	20	4	71	0.0563380
NODE_19524_length_660_cov_8.887701	254	325	21	3	71	0.0422535
NODE_19524_length_660_cov_8.887701	254	325	22	7	71	0.0985916
NODE_19527_length_660_cov_7.278075	225	305	0	9	80	0.1125000
NODE_19527_length_660_cov_7.278075	225	305	4	43	80	0.5375000
NODE_19527_length_660_cov_7.278075	225	305	8	28	80	0.3500000
NODE_19527_length_660_cov_7.278075	278	358	0	62	80	0.7750000
NODE_19527_length_660_cov_7.278075	278	358	4	18	80	0.2250000
NODE_19529_length_660_cov_6.577540	350	430	0	80	80	1.0000000
NODE_19529_length_660_cov_6.577540	403	483	0	80	80	1.0000000
NODE_19549_length_660_cov_2.354724	421	470	0	49	49	1.0000000
NODE_19594_length_659_cov_43.587500	2	82	0	80	80	1.0000000
NODE_19594_length_659_cov_43.587500	55	135	0	45	80	0.5625000
NODE_19594_length_659_cov_43.587500	55	135	2	35	80	0.4375000
NODE_19594_length_659_cov_43.587500	131	211	2	30	80	0.3750000
NODE_19594_length_659_cov_43.587500	131	211	4	26	80	0.3250000
NODE_19594_length_659_cov_43.587500	131	211	7	24	80	0.3000000
NODE_19594_length_659_cov_43.587500	184	264	4	3	80	0.0375000
NODE_19594_length_659_cov_43.587500	184	264	5	14	80	0.1750000
NODE_19594_length_659_cov_43.587500	184	264	7	63	80	0.7875000
NODE_19595_length_659_cov_23.330357	236	316	1	18	80	0.2250000
NODE_19595_length_659_cov_23.330357	236	316	3	62	80	0.7750000
NODE_19595_length_659_cov_23.330357	289	369	3	53	80	0.6625000
NODE_19595_length_659_cov_23.330357	289	369	5	26	80	0.3250000
NODE_19595_length_659_cov_23.330357	289	369	6	1	80	0.0125000
NODE_19596_length_659_cov_12.775000	255	335	3	33	80	0.4125000
NODE_19596_length_659_cov_12.775000	255	335	4	47	80	0.5875000
NODE_19596_length_659_cov_12.775000	308	388	3	12	80	0.1500000
NODE_19596_length_659_cov_12.775000	308	388	4	68	80	0.8500000
NODE_19598_length_659_cov_9.683929	220	298	0	78	78	1.0000000
NODE_19598_length_659_cov_9.683929	271	351	0	80	80	1.0000000
NODE_19613_length_659_cov_3.658929	305	385	2	80	80	1.0000000
NODE_19613_length_659_cov_3.658929	358	438	1	28	80	0.3500000
NODE_19613_length_659_cov_3.658929	358	438	2	52	80	0.6500000
NODE_19678_length_658_cov_38.479428	289	369	5	2	80	0.0250000
NODE_19678_length_658_cov_38.479428	289	369	7	22	80	0.2750000
NODE_19678_length_658_cov_38.479428	289	369	9	28	80	0.3500000
NODE_19678_length_658_cov_38.479428	289	369	11	16	80	0.2000000
NODE_19678_length_658_cov_38.479428	289	369	13	12	80	0.1500000
NODE_19678_length_658_cov_38.479428	342	422	9	11	80	0.1375000
NODE_19678_length_658_cov_38.479428	342	422	10	5	80	0.0625000
NODE_19678_length_658_cov_38.479428	342	422	11	18	80	0.2250000
NODE_19678_length_658_cov_38.479428	342	422	12	23	80	0.2875000
NODE_19678_length_658_cov_38.479428	342	422	13	23	80	0.2875000
NODE_19679_length_658_cov_35.409660	242	322	2	3	80	0.0375000
NODE_19679_length_658_cov_35.409660	242	322	3	35	80	0.4375000
NODE_19679_length_658_cov_35.409660	242	322	4	1	80	0.0125000
NODE_19679_length_658_cov_35.409660	242	322	5	41	80	0.5125000
NODE_19679_length_658_cov_35.409660	295	375	3	46	80	0.5750000
NODE_19679_length_658_cov_35.409660	295	375	4	8	80	0.1000000
NODE_19679_length_658_cov_35.409660	295	375	5	26	80	0.3250000
NODE_19680_length_658_cov_20.322004	191	271	1	56	80	0.7000000
NODE_19680_length_658_cov_20.322004	191	271	2	14	80	0.1750000
NODE_19680_length_658_cov_20.322004	191	271	4	10	80	0.1250000
NODE_19680_length_658_cov_20.322004	244	321	1	3	77	0.0389610
NODE_19680_length_658_cov_20.322004	244	321	2	14	77	0.1818182
NODE_19680_length_658_cov_20.322004	244	321	3	21	77	0.2727273
NODE_19680_length_658_cov_20.322004	244	321	4	34	77	0.4415585
NODE_19680_length_658_cov_20.322004	244	321	6	5	77	0.0649351
NODE_19680_length_658_cov_20.322004	317	397	6	13	80	0.1625000
NODE_19680_length_658_cov_20.322004	317	397	7	35	80	0.4375000
NODE_19680_length_658_cov_20.322004	317	397	8	32	80	0.4000000
NODE_19680_length_658_cov_20.322004	370	449	5	2	79	0.0253165
NODE_19680_length_658_cov_20.322004	370	449	6	39	79	0.4936709
NODE_19680_length_658_cov_20.322004	370	449	7	14	79	0.1772152
NODE_19680_length_658_cov_20.322004	370	449	8	24	79	0.3037975
NODE_19681_length_658_cov_11.352415	324	404	0	80	80	1.0000000
NODE_19681_length_658_cov_11.352415	377	457	0	80	80	1.0000000
NODE_19685_length_658_cov_8.241503	227	307	0	80	80	1.0000000
NODE_19685_length_658_cov_8.241503	280	360	0	80	80	1.0000000
NODE_19689_length_658_cov_5.477639	450	530	2	80	80	1.0000000
NODE_19705_length_658_cov_2.277281	286	366	1	80	80	1.0000000
NODE_19705_length_658_cov_2.277281	339	419	0	17	80	0.2125000
NODE_19705_length_658_cov_2.277281	339	419	1	63	80	0.7875000
NODE_19750_length_657_cov_71.087814	306	372	1	2	66	0.0303030
NODE_19750_length_657_cov_71.087814	306	372	2	25	66	0.3787879
NODE_19750_length_657_cov_71.087814	306	372	3	39	66	0.5909091
NODE_19750_length_657_cov_71.087814	382	462	3	62	80	0.7750000
NODE_19750_length_657_cov_71.087814	382	462	4	18	80	0.2250000
NODE_19750_length_657_cov_71.087814	382	462	3	62	80	0.7750000
NODE_19750_length_657_cov_71.087814	382	462	4	18	80	0.2250000
NODE_19750_length_657_cov_71.087814	435	515	1	32	80	0.4000000
NODE_19750_length_657_cov_71.087814	435	515	2	19	80	0.2375000
NODE_19750_length_657_cov_71.087814	435	515	3	29	80	0.3625000
NODE_19750_length_657_cov_71.087814	440	515	1	32	75	0.4266667
NODE_19750_length_657_cov_71.087814	440	515	2	19	75	0.2533333
NODE_19750_length_657_cov_71.087814	440	515	3	24	75	0.3200000
NODE_19751_length_657_cov_67.408602	98	178	9	4	80	0.0500000
NODE_19751_length_657_cov_67.408602	98	178	18	24	80	0.3000000
NODE_19751_length_657_cov_67.408602	98	178	19	52	80	0.6500000
NODE_19751_length_657_cov_67.408602	151	231	7	14	80	0.1750000
NODE_19751_length_657_cov_67.408602	151	231	8	8	80	0.1000000
NODE_19751_length_657_cov_67.408602	151	231	9	5	80	0.0625000
NODE_19751_length_657_cov_67.408602	151	231	10	5	80	0.0625000
NODE_19751_length_657_cov_67.408602	151	231	11	2	80	0.0250000
NODE_19751_length_657_cov_67.408602	151	231	12	6	80	0.0750000
NODE_19751_length_657_cov_67.408602	151	231	13	2	80	0.0250000
NODE_19751_length_657_cov_67.408602	151	231	14	7	80	0.0875000
NODE_19751_length_657_cov_67.408602	151	231	19	31	80	0.3875000
NODE_19752_length_657_cov_15.568100	265	345	0	80	80	1.0000000
NODE_19752_length_657_cov_15.568100	341	421	0	80	80	1.0000000
NODE_19759_length_657_cov_5.161290	185	256	1	1	71	0.0140845
NODE_19759_length_657_cov_5.161290	185	256	2	27	71	0.3802817
NODE_19759_length_657_cov_5.161290	185	256	3	18	71	0.2535211
NODE_19759_length_657_cov_5.161290	185	256	4	15	71	0.2112676
NODE_19759_length_657_cov_5.161290	185	256	5	10	71	0.1408451
NODE_19759_length_657_cov_5.161290	229	309	3	2	80	0.0250000
NODE_19759_length_657_cov_5.161290	229	309	4	15	80	0.1875000
NODE_19759_length_657_cov_5.161290	229	309	5	63	80	0.7875000
NODE_19824_length_656_cov_37.023339	470	550	12	9	80	0.1125000
NODE_19824_length_656_cov_37.023339	470	550	19	19	80	0.2375000
NODE_19824_length_656_cov_37.023339	470	550	20	1	80	0.0125000
NODE_19824_length_656_cov_37.023339	470	550	21	17	80	0.2125000
NODE_19824_length_656_cov_37.023339	470	550	22	1	80	0.0125000
NODE_19824_length_656_cov_37.023339	470	550	23	4	80	0.0500000
NODE_19824_length_656_cov_37.023339	470	550	24	29	80	0.3625000
NODE_19824_length_656_cov_37.023339	523	603	10	18	80	0.2250000
NODE_19824_length_656_cov_37.023339	523	603	12	44	80	0.5500000
NODE_19824_length_656_cov_37.023339	523	603	20	1	80	0.0125000
NODE_19824_length_656_cov_37.023339	523	603	21	2	80	0.0250000
NODE_19824_length_656_cov_37.023339	523	603	24	15	80	0.1875000
NODE_19825_length_656_cov_22.804309	173	253	7	20	80	0.2500000
NODE_19825_length_656_cov_22.804309	173	253	8	1	80	0.0125000
NODE_19825_length_656_cov_22.804309	173	253	11	8	80	0.1000000
NODE_19825_length_656_cov_22.804309	173	253	13	5	80	0.0625000
NODE_19825_length_656_cov_22.804309	173	253	15	14	80	0.1750000
NODE_19825_length_656_cov_22.804309	173	253	16	20	80	0.2500000
NODE_19825_length_656_cov_22.804309	173	253	18	12	80	0.1500000
NODE_19825_length_656_cov_22.804309	226	306	14	28	80	0.3500000
NODE_19825_length_656_cov_22.804309	226	306	15	3	80	0.0375000
NODE_19825_length_656_cov_22.804309	226	306	16	15	80	0.1875000
NODE_19825_length_656_cov_22.804309	226	306	18	34	80	0.4250000
NODE_19826_length_656_cov_19.280072	345	425	0	80	80	1.0000000
NODE_19826_length_656_cov_19.280072	398	478	0	80	80	1.0000000
NODE_19827_length_656_cov_18.267504	272	352	3	51	80	0.6375000
NODE_19827_length_656_cov_18.267504	272	352	6	29	80	0.3625000
NODE_19827_length_656_cov_18.267504	325	405	3	80	80	1.0000000
NODE_19828_length_656_cov_15.928187	223	303	0	80	80	1.0000000
NODE_19829_length_656_cov_15.091562	297	377	2	5	80	0.0625000
NODE_19829_length_656_cov_15.091562	297	377	3	21	80	0.2625000
NODE_19829_length_656_cov_15.091562	297	377	4	1	80	0.0125000
NODE_19829_length_656_cov_15.091562	297	377	5	6	80	0.0750000
NODE_19829_length_656_cov_15.091562	297	377	7	25	80	0.3125000
NODE_19829_length_656_cov_15.091562	297	377	8	22	80	0.2750000
NODE_19829_length_656_cov_15.091562	350	430	7	5	80	0.0625000
NODE_19829_length_656_cov_15.091562	350	430	8	75	80	0.9375000
NODE_19830_length_656_cov_12.773788	269	349	0	22	80	0.2750000
NODE_19830_length_656_cov_12.773788	269	349	1	58	80	0.7250000
NODE_19830_length_656_cov_12.773788	322	399	1	33	77	0.4285714
NODE_19830_length_656_cov_12.773788	322	399	2	44	77	0.5714286
NODE_19831_length_656_cov_12.493716	212	292	7	6	80	0.0750000
NODE_19831_length_656_cov_12.493716	212	292	9	1	80	0.0125000
NODE_19831_length_656_cov_12.493716	212	292	10	38	80	0.4750000
NODE_19831_length_656_cov_12.493716	212	292	15	35	80	0.4375000
NODE_19831_length_656_cov_12.493716	265	345	6	38	80	0.4750000
NODE_19831_length_656_cov_12.493716	265	345	7	20	80	0.2500000
NODE_19831_length_656_cov_12.493716	265	345	10	22	80	0.2750000
NODE_19832_length_656_cov_10.946140	197	277	0	80	80	1.0000000
NODE_19832_length_656_cov_10.946140	250	330	0	80	80	1.0000000
NODE_19833_length_656_cov_9.412926	295	375	4	3	80	0.0375000
NODE_19833_length_656_cov_9.412926	295	375	5	7	80	0.0875000
NODE_19833_length_656_cov_9.412926	295	375	6	48	80	0.6000000
NODE_19833_length_656_cov_9.412926	295	375	7	1	80	0.0125000
NODE_19833_length_656_cov_9.412926	295	375	8	21	80	0.2625000
NODE_19833_length_656_cov_9.412926	348	428	5	11	80	0.1375000
NODE_19833_length_656_cov_9.412926	348	428	6	36	80	0.4500000
NODE_19833_length_656_cov_9.412926	348	428	7	1	80	0.0125000
NODE_19833_length_656_cov_9.412926	348	428	8	32	80	0.4000000
NODE_19904_length_655_cov_31.019784	212	292	5	9	80	0.1125000
NODE_19904_length_655_cov_31.019784	212	292	7	4	80	0.0500000
NODE_19904_length_655_cov_31.019784	212	292	10	3	80	0.0375000
NODE_19904_length_655_cov_31.019784	212	292	11	9	80	0.1125000
NODE_19904_length_655_cov_31.019784	212	292	12	6	80	0.0750000
NODE_19904_length_655_cov_31.019784	212	292	16	7	80	0.0875000
NODE_19904_length_655_cov_31.019784	212	292	17	19	80	0.2375000
NODE_19904_length_655_cov_31.019784	212	292	18	23	80	0.2875000
NODE_19904_length_655_cov_31.019784	265	345	17	4	80	0.0500000
NODE_19904_length_655_cov_31.019784	265	345	18	26	80	0.3250000
NODE_19904_length_655_cov_31.019784	265	345	20	16	80	0.2000000
NODE_19904_length_655_cov_31.019784	265	345	21	3	80	0.0375000
NODE_19904_length_655_cov_31.019784	265	345	22	25	80	0.3125000
NODE_19904_length_655_cov_31.019784	265	345	23	6	80	0.0750000
NODE_19907_length_655_cov_8.672662	216	296	0	43	80	0.5375000
NODE_19907_length_655_cov_8.672662	216	296	1	37	80	0.4625000
NODE_19907_length_655_cov_8.672662	269	349	1	31	80	0.3875000
NODE_19907_length_655_cov_8.672662	269	349	2	49	80	0.6125000
NODE_19908_length_655_cov_8.250000	204	234	0	30	30	1.0000000
NODE_19909_length_655_cov_7.910072	366	446	0	80	80	1.0000000
NODE_19909_length_655_cov_7.910072	419	499	0	80	80	1.0000000
NODE_19916_length_655_cov_5.478417	178	255	0	77	77	1.0000000
NODE_19916_length_655_cov_5.478417	178	221	0	43	43	1.0000000
NODE_19919_length_655_cov_5.174460	347	428	0	81	81	1.0000000
NODE_19919_length_655_cov_5.174460	401	481	0	80	80	1.0000000
NODE_19979_length_654_cov_17.086486	323	403	18	8	80	0.1000000
NODE_19979_length_654_cov_17.086486	323	403	19	6	80	0.0750000
NODE_19979_length_654_cov_17.086486	323	403	21	35	80	0.4375000
NODE_19979_length_654_cov_17.086486	323	403	22	31	80	0.3875000
NODE_19979_length_654_cov_17.086486	376	456	18	5	80	0.0625000
NODE_19979_length_654_cov_17.086486	376	456	19	17	80	0.2125000
NODE_19979_length_654_cov_17.086486	376	456	20	7	80	0.0875000
NODE_19979_length_654_cov_17.086486	376	456	21	36	80	0.4500000
NODE_19979_length_654_cov_17.086486	376	456	24	15	80	0.1875000
NODE_19980_length_654_cov_16.194595	318	398	6	49	80	0.6125000
NODE_19980_length_654_cov_16.194595	318	398	7	4	80	0.0500000
NODE_19980_length_654_cov_16.194595	318	398	8	27	80	0.3375000
NODE_19980_length_654_cov_16.194595	371	451	4	33	80	0.4125000
NODE_19980_length_654_cov_16.194595	371	451	6	47	80	0.5875000
NODE_19983_length_654_cov_5.556757	341	412	0	71	71	1.0000000
NODE_19990_length_654_cov_3.236036	105	181	2	55	76	0.7236842
NODE_19990_length_654_cov_3.236036	105	181	3	21	76	0.2763158
NODE_19990_length_654_cov_3.236036	158	236	1	44	78	0.5641026
NODE_19990_length_654_cov_3.236036	158	236	2	25	78	0.3205128
NODE_19990_length_654_cov_3.236036	158	236	3	9	78	0.1153846
NODE_19998_length_654_cov_2.549550	279	366	0	87	87	1.0000000
NODE_20013_length_654_cov_1.790991	480	560	4	33	80	0.4125000
NODE_20013_length_654_cov_1.790991	480	560	5	47	80	0.5875000
NODE_20044_length_653_cov_70.296029	277	357	18	5	80	0.0625000
NODE_20044_length_653_cov_70.296029	277	357	19	21	80	0.2625000
NODE_20044_length_653_cov_70.296029	277	357	21	6	80	0.0750000
NODE_20044_length_653_cov_70.296029	277	357	22	29	80	0.3625000
NODE_20044_length_653_cov_70.296029	277	357	23	4	80	0.0500000
NODE_20044_length_653_cov_70.296029	277	357	24	7	80	0.0875000
NODE_20044_length_653_cov_70.296029	277	357	25	5	80	0.0625000
NODE_20044_length_653_cov_70.296029	277	357	26	3	80	0.0375000
NODE_20044_length_653_cov_70.296029	330	410	16	1	80	0.0125000
NODE_20044_length_653_cov_70.296029	330	410	17	8	80	0.1000000
NODE_20044_length_653_cov_70.296029	330	410	18	23	80	0.2875000
NODE_20044_length_653_cov_70.296029	330	410	19	47	80	0.5875000
NODE_20044_length_653_cov_70.296029	330	410	26	1	80	0.0125000
NODE_20045_length_653_cov_28.072202	302	382	11	32	80	0.4000000
NODE_20045_length_653_cov_28.072202	302	382	12	7	80	0.0875000
NODE_20045_length_653_cov_28.072202	302	382	13	26	80	0.3250000
NODE_20045_length_653_cov_28.072202	302	382	15	15	80	0.1875000
NODE_20045_length_653_cov_28.072202	355	435	6	12	80	0.1500000
NODE_20045_length_653_cov_28.072202	355	435	8	24	80	0.3000000
NODE_20045_length_653_cov_28.072202	355	435	9	1	80	0.0125000
NODE_20045_length_653_cov_28.072202	355	435	10	9	80	0.1125000
NODE_20045_length_653_cov_28.072202	355	435	11	34	80	0.4250000
NODE_20046_length_653_cov_18.382671	214	294	6	50	80	0.6250000
NODE_20046_length_653_cov_18.382671	214	294	7	25	80	0.3125000
NODE_20046_length_653_cov_18.382671	214	294	9	5	80	0.0625000
NODE_20046_length_653_cov_18.382671	267	347	2	1	80	0.0125000
NODE_20046_length_653_cov_18.382671	267	347	3	4	80	0.0500000
NODE_20046_length_653_cov_18.382671	267	347	6	63	80	0.7875000
NODE_20046_length_653_cov_18.382671	267	347	7	12	80	0.1500000
NODE_20047_length_653_cov_8.821300	292	372	0	80	80	1.0000000
NODE_20047_length_653_cov_8.821300	345	425	0	80	80	1.0000000
NODE_20048_length_653_cov_8.660650	200	280	0	80	80	1.0000000
NODE_20048_length_653_cov_8.660650	253	333	0	80	80	1.0000000
NODE_20052_length_653_cov_5.777978	308	383	0	5	75	0.0666667
NODE_20052_length_653_cov_5.777978	308	383	4	68	75	0.9066667
NODE_20052_length_653_cov_5.777978	308	383	8	2	75	0.0266667
NODE_20052_length_653_cov_5.777978	361	435	4	20	74	0.2702703
NODE_20052_length_653_cov_5.777978	361	435	8	54	74	0.7297297
NODE_20054_length_653_cov_5.193141	304	356	2	52	52	1.0000000
NODE_20058_length_653_cov_4.823105	178	251	0	73	73	1.0000000
NODE_20058_length_653_cov_4.823105	178	256	0	78	78	1.0000000
NODE_20058_length_653_cov_4.823105	229	309	0	80	80	1.0000000
NODE_20058_length_653_cov_4.823105	229	309	0	80	80	1.0000000
NODE_20058_length_653_cov_4.823105	239	309	0	70	70	1.0000000
NODE_20127_length_652_cov_215.211573	185	248	8	1	63	0.0158730
NODE_20127_length_652_cov_215.211573	185	248	10	3	63	0.0476190
NODE_20127_length_652_cov_215.211573	185	248	11	18	63	0.2857143
NODE_20127_length_652_cov_215.211573	185	248	12	3	63	0.0476190
NODE_20127_length_652_cov_215.211573	185	248	13	1	63	0.0158730
NODE_20127_length_652_cov_215.211573	185	248	15	7	63	0.1111111
NODE_20127_length_652_cov_215.211573	185	248	17	1	63	0.0158730
NODE_20127_length_652_cov_215.211573	185	248	18	3	63	0.0476190
NODE_20127_length_652_cov_215.211573	185	248	19	3	63	0.0476190
NODE_20127_length_652_cov_215.211573	185	248	20	7	63	0.1111111
NODE_20127_length_652_cov_215.211573	185	248	21	1	63	0.0158730
NODE_20127_length_652_cov_215.211573	185	248	22	3	63	0.0476190
NODE_20127_length_652_cov_215.211573	185	248	23	12	63	0.1904762
NODE_20127_length_652_cov_215.211573	221	301	18	1	80	0.0125000
NODE_20127_length_652_cov_215.211573	221	301	19	3	80	0.0375000
NODE_20127_length_652_cov_215.211573	221	301	20	7	80	0.0875000
NODE_20127_length_652_cov_215.211573	221	301	21	1	80	0.0125000
NODE_20127_length_652_cov_215.211573	221	301	22	3	80	0.0375000
NODE_20127_length_652_cov_215.211573	221	301	23	21	80	0.2625000
NODE_20127_length_652_cov_215.211573	221	301	25	12	80	0.1500000
NODE_20127_length_652_cov_215.211573	221	301	26	13	80	0.1625000
NODE_20127_length_652_cov_215.211573	221	301	27	1	80	0.0125000
NODE_20127_length_652_cov_215.211573	221	301	28	2	80	0.0250000
NODE_20127_length_652_cov_215.211573	221	301	29	16	80	0.2000000
NODE_20128_length_652_cov_21.267631	299	379	12	13	80	0.1625000
NODE_20128_length_652_cov_21.267631	299	379	13	26	80	0.3250000
NODE_20128_length_652_cov_21.267631	299	379	14	26	80	0.3250000
NODE_20128_length_652_cov_21.267631	299	379	15	12	80	0.1500000
NODE_20128_length_652_cov_21.267631	299	379	16	3	80	0.0375000
NODE_20128_length_652_cov_21.267631	352	432	6	7	80	0.0875000
NODE_20128_length_652_cov_21.267631	352	432	9	8	80	0.1000000
NODE_20128_length_652_cov_21.267631	352	432	11	4	80	0.0500000
NODE_20128_length_652_cov_21.267631	352	432	12	29	80	0.3625000
NODE_20128_length_652_cov_21.267631	352	432	13	30	80	0.3750000
NODE_20128_length_652_cov_21.267631	352	432	14	2	80	0.0250000
NODE_20138_length_652_cov_4.622061	266	315	0	49	49	1.0000000
NODE_20138_length_652_cov_4.622061	288	368	0	80	80	1.0000000
NODE_20210_length_651_cov_49.981884	425	505	19	2	80	0.0250000
NODE_20210_length_651_cov_49.981884	425	505	22	9	80	0.1125000
NODE_20210_length_651_cov_49.981884	425	505	23	9	80	0.1125000
NODE_20210_length_651_cov_49.981884	425	505	24	6	80	0.0750000
NODE_20210_length_651_cov_49.981884	425	505	25	21	80	0.2625000
NODE_20210_length_651_cov_49.981884	425	505	26	22	80	0.2750000
NODE_20210_length_651_cov_49.981884	425	505	27	11	80	0.1375000
NODE_20210_length_651_cov_49.981884	425	505	19	2	80	0.0250000
NODE_20210_length_651_cov_49.981884	425	505	22	9	80	0.1125000
NODE_20210_length_651_cov_49.981884	425	505	23	9	80	0.1125000
NODE_20210_length_651_cov_49.981884	425	505	24	6	80	0.0750000
NODE_20210_length_651_cov_49.981884	425	505	25	21	80	0.2625000
NODE_20210_length_651_cov_49.981884	425	505	26	22	80	0.2750000
NODE_20210_length_651_cov_49.981884	425	505	27	11	80	0.1375000
NODE_20210_length_651_cov_49.981884	425	505	19	2	80	0.0250000
NODE_20210_length_651_cov_49.981884	425	505	22	9	80	0.1125000
NODE_20210_length_651_cov_49.981884	425	505	23	9	80	0.1125000
NODE_20210_length_651_cov_49.981884	425	505	24	6	80	0.0750000
NODE_20210_length_651_cov_49.981884	425	505	25	21	80	0.2625000
NODE_20210_length_651_cov_49.981884	425	505	26	22	80	0.2750000
NODE_20210_length_651_cov_49.981884	425	505	27	11	80	0.1375000
NODE_20210_length_651_cov_49.981884	425	505	19	2	80	0.0250000
NODE_20210_length_651_cov_49.981884	425	505	22	9	80	0.1125000
NODE_20210_length_651_cov_49.981884	425	505	23	9	80	0.1125000
NODE_20210_length_651_cov_49.981884	425	505	24	6	80	0.0750000
NODE_20210_length_651_cov_49.981884	425	505	25	21	80	0.2625000
NODE_20210_length_651_cov_49.981884	425	505	26	22	80	0.2750000
NODE_20210_length_651_cov_49.981884	425	505	27	11	80	0.1375000
NODE_20210_length_651_cov_49.981884	478	540	11	2	62	0.0322581
NODE_20210_length_651_cov_49.981884	478	540	13	1	62	0.0161290
NODE_20210_length_651_cov_49.981884	478	540	14	2	62	0.0322581
NODE_20210_length_651_cov_49.981884	478	540	15	9	62	0.1451613
NODE_20210_length_651_cov_49.981884	478	540	16	7	62	0.1129032
NODE_20210_length_651_cov_49.981884	478	540	17	9	62	0.1451613
NODE_20210_length_651_cov_49.981884	478	540	18	2	62	0.0322581
NODE_20210_length_651_cov_49.981884	478	540	19	5	62	0.0806452
NODE_20210_length_651_cov_49.981884	478	540	22	9	62	0.1451613
NODE_20210_length_651_cov_49.981884	478	540	23	9	62	0.1451613
NODE_20210_length_651_cov_49.981884	478	540	24	6	62	0.0967742
NODE_20210_length_651_cov_49.981884	478	540	25	1	62	0.0161290
NODE_20210_length_651_cov_49.981884	478	540	11	2	62	0.0322581
NODE_20210_length_651_cov_49.981884	478	540	13	1	62	0.0161290
NODE_20210_length_651_cov_49.981884	478	540	14	2	62	0.0322581
NODE_20210_length_651_cov_49.981884	478	540	15	9	62	0.1451613
NODE_20210_length_651_cov_49.981884	478	540	16	7	62	0.1129032
NODE_20210_length_651_cov_49.981884	478	540	17	9	62	0.1451613
NODE_20210_length_651_cov_49.981884	478	540	18	2	62	0.0322581
NODE_20210_length_651_cov_49.981884	478	540	19	5	62	0.0806452
NODE_20210_length_651_cov_49.981884	478	540	22	9	62	0.1451613
NODE_20210_length_651_cov_49.981884	478	540	23	9	62	0.1451613
NODE_20210_length_651_cov_49.981884	478	540	24	6	62	0.0967742
NODE_20210_length_651_cov_49.981884	478	540	25	1	62	0.0161290
NODE_20210_length_651_cov_49.981884	478	540	11	2	62	0.0322581
NODE_20210_length_651_cov_49.981884	478	540	13	1	62	0.0161290
NODE_20210_length_651_cov_49.981884	478	540	14	2	62	0.0322581
NODE_20210_length_651_cov_49.981884	478	540	15	9	62	0.1451613
NODE_20210_length_651_cov_49.981884	478	540	16	7	62	0.1129032
NODE_20210_length_651_cov_49.981884	478	540	17	9	62	0.1451613
NODE_20210_length_651_cov_49.981884	478	540	18	2	62	0.0322581
NODE_20210_length_651_cov_49.981884	478	540	19	5	62	0.0806452
NODE_20210_length_651_cov_49.981884	478	540	22	9	62	0.1451613
NODE_20210_length_651_cov_49.981884	478	540	23	9	62	0.1451613
NODE_20210_length_651_cov_49.981884	478	540	24	6	62	0.0967742
NODE_20210_length_651_cov_49.981884	478	540	25	1	62	0.0161290
NODE_20210_length_651_cov_49.981884	478	542	8	2	64	0.0312500
NODE_20210_length_651_cov_49.981884	478	542	11	2	64	0.0312500
NODE_20210_length_651_cov_49.981884	478	542	13	1	64	0.0156250
NODE_20210_length_651_cov_49.981884	478	542	14	2	64	0.0312500
NODE_20210_length_651_cov_49.981884	478	542	15	9	64	0.1406250
NODE_20210_length_651_cov_49.981884	478	542	16	7	64	0.1093750
NODE_20210_length_651_cov_49.981884	478	542	17	9	64	0.1406250
NODE_20210_length_651_cov_49.981884	478	542	18	2	64	0.0312500
NODE_20210_length_651_cov_49.981884	478	542	19	5	64	0.0781250
NODE_20210_length_651_cov_49.981884	478	542	22	9	64	0.1406250
NODE_20210_length_651_cov_49.981884	478	542	23	9	64	0.1406250
NODE_20210_length_651_cov_49.981884	478	542	24	6	64	0.0937500
NODE_20210_length_651_cov_49.981884	478	542	25	1	64	0.0156250
NODE_20211_length_651_cov_36.121377	422	502	0	45	80	0.5625000
NODE_20211_length_651_cov_36.121377	422	502	2	35	80	0.4375000
NODE_20211_length_651_cov_36.121377	475	555	2	80	80	1.0000000
NODE_20212_length_651_cov_20.045290	252	332	5	3	80	0.0375000
NODE_20212_length_651_cov_20.045290	252	332	6	8	80	0.1000000
NODE_20212_length_651_cov_20.045290	252	332	7	41	80	0.5125000
NODE_20212_length_651_cov_20.045290	252	332	8	6	80	0.0750000
NODE_20212_length_651_cov_20.045290	252	332	9	2	80	0.0250000
NODE_20212_length_651_cov_20.045290	252	332	11	20	80	0.2500000
NODE_20212_length_651_cov_20.045290	305	385	7	5	80	0.0625000
NODE_20212_length_651_cov_20.045290	305	385	8	10	80	0.1250000
NODE_20212_length_651_cov_20.045290	305	385	9	33	80	0.4125000
NODE_20212_length_651_cov_20.045290	305	385	10	7	80	0.0875000
NODE_20212_length_651_cov_20.045290	305	385	11	25	80	0.3125000
NODE_20213_length_651_cov_12.704710	264	344	3	25	80	0.3125000
NODE_20213_length_651_cov_12.704710	264	344	4	55	80	0.6875000
NODE_20213_length_651_cov_12.704710	317	397	2	10	80	0.1250000
NODE_20213_length_651_cov_12.704710	317	397	3	13	80	0.1625000
NODE_20213_length_651_cov_12.704710	317	397	4	51	80	0.6375000
NODE_20213_length_651_cov_12.704710	317	397	5	6	80	0.0750000
NODE_20214_length_651_cov_11.632246	205	285	2	55	80	0.6875000
NODE_20214_length_651_cov_11.632246	205	285	3	25	80	0.3125000
NODE_20214_length_651_cov_11.632246	258	338	2	2	80	0.0250000
NODE_20214_length_651_cov_11.632246	258	338	3	78	80	0.9750000
NODE_20215_length_651_cov_10.074275	369	449	5	4	80	0.0500000
NODE_20215_length_651_cov_10.074275	369	449	7	10	80	0.1250000
NODE_20215_length_651_cov_10.074275	369	449	8	66	80	0.8250000
NODE_20215_length_651_cov_10.074275	422	502	4	13	80	0.1625000
NODE_20215_length_651_cov_10.074275	422	502	6	12	80	0.1500000
NODE_20215_length_651_cov_10.074275	422	502	7	32	80	0.4000000
NODE_20215_length_651_cov_10.074275	422	502	8	23	80	0.2875000
NODE_20216_length_651_cov_9.699275	199	279	4	23	80	0.2875000
NODE_20216_length_651_cov_9.699275	199	279	6	57	80	0.7125000
NODE_20216_length_651_cov_9.699275	252	332	4	12	80	0.1500000
NODE_20216_length_651_cov_9.699275	252	332	6	68	80	0.8500000
NODE_20219_length_651_cov_8.309783	217	296	3	33	79	0.4177215
NODE_20219_length_651_cov_8.309783	217	296	6	46	79	0.5822785
NODE_20219_length_651_cov_8.309783	269	349	3	37	80	0.4625000
NODE_20219_length_651_cov_8.309783	269	349	6	43	80	0.5375000
NODE_20220_length_651_cov_5.621377	148	228	2	27	80	0.3375000
NODE_20220_length_651_cov_5.621377	148	228	3	20	80	0.2500000
NODE_20220_length_651_cov_5.621377	148	228	4	33	80	0.4125000
NODE_20220_length_651_cov_5.621377	201	281	2	40	80	0.5000000
NODE_20220_length_651_cov_5.621377	201	281	3	33	80	0.4125000
NODE_20220_length_651_cov_5.621377	201	281	4	7	80	0.0875000
NODE_20221_length_651_cov_5.610507	342	422	1	36	80	0.4500000
NODE_20221_length_651_cov_5.610507	342	422	2	41	80	0.5125000
NODE_20221_length_651_cov_5.610507	342	422	3	3	80	0.0375000
NODE_20221_length_651_cov_5.610507	395	475	1	3	80	0.0375000
NODE_20221_length_651_cov_5.610507	395	475	2	33	80	0.4125000
NODE_20221_length_651_cov_5.610507	395	475	3	44	80	0.5500000
NODE_20225_length_651_cov_4.246377	299	359	1	10	60	0.1666667
NODE_20225_length_651_cov_4.246377	299	359	2	11	60	0.1833333
NODE_20225_length_651_cov_4.246377	299	359	3	39	60	0.6500000
NODE_20238_length_651_cov_2.744565	340	421	0	81	81	1.0000000
NODE_20252_length_651_cov_2.016304	280	311	0	31	31	1.0000000
NODE_20292_length_650_cov_22.644283	233	313	1	52	80	0.6500000
NODE_20292_length_650_cov_22.644283	233	313	2	28	80	0.3500000
NODE_20292_length_650_cov_22.644283	286	366	1	27	80	0.3375000
NODE_20292_length_650_cov_22.644283	286	366	2	53	80	0.6625000
NODE_20293_length_650_cov_22.156080	269	349	0	80	80	1.0000000
NODE_20293_length_650_cov_22.156080	322	402	0	80	80	1.0000000
NODE_20294_length_650_cov_20.012704	186	266	3	10	80	0.1250000
NODE_20294_length_650_cov_20.012704	186	266	5	40	80	0.5000000
NODE_20294_length_650_cov_20.012704	186	266	6	30	80	0.3750000
NODE_20294_length_650_cov_20.012704	239	319	3	5	80	0.0625000
NODE_20294_length_650_cov_20.012704	239	319	4	35	80	0.4375000
NODE_20294_length_650_cov_20.012704	239	319	5	19	80	0.2375000
NODE_20294_length_650_cov_20.012704	239	319	6	21	80	0.2625000
NODE_20295_length_650_cov_17.626134	52	132	2	15	80	0.1875000
NODE_20295_length_650_cov_17.626134	52	132	3	40	80	0.5000000
NODE_20295_length_650_cov_17.626134	52	132	4	25	80	0.3125000
NODE_20295_length_650_cov_17.626134	105	185	2	20	80	0.2500000
NODE_20295_length_650_cov_17.626134	105	185	3	2	80	0.0250000
NODE_20295_length_650_cov_17.626134	105	185	4	58	80	0.7250000
NODE_20297_length_650_cov_10.687840	289	369	2	47	80	0.5875000
NODE_20297_length_650_cov_10.687840	289	369	3	11	80	0.1375000
NODE_20297_length_650_cov_10.687840	289	369	4	22	80	0.2750000
NODE_20297_length_650_cov_10.687840	342	422	2	49	80	0.6125000
NODE_20297_length_650_cov_10.687840	342	422	3	5	80	0.0625000
NODE_20297_length_650_cov_10.687840	342	422	4	26	80	0.3250000
NODE_20301_length_650_cov_6.519056	312	365	2	53	53	1.0000000
NODE_20301_length_650_cov_6.519056	338	417	2	79	79	1.0000000
NODE_20302_length_650_cov_6.159710	243	323	2	27	80	0.3375000
NODE_20302_length_650_cov_6.159710	243	323	3	53	80	0.6625000
NODE_20302_length_650_cov_6.159710	296	376	0	32	80	0.4000000
NODE_20302_length_650_cov_6.159710	296	376	2	48	80	0.6000000
NODE_20318_length_650_cov_2.488203	213	266	0	50	53	0.9433962
NODE_20318_length_650_cov_2.488203	213	266	1	3	53	0.0566038
NODE_20370_length_649_cov_20.780000	111	140	3	3	29	0.1034483
NODE_20370_length_649_cov_20.780000	111	140	5	4	29	0.1379310
NODE_20370_length_649_cov_20.780000	111	140	7	14	29	0.4827586
NODE_20370_length_649_cov_20.780000	111	140	9	4	29	0.1379310
NODE_20370_length_649_cov_20.780000	111	140	10	4	29	0.1379310
NODE_20370_length_649_cov_20.780000	111	191	3	3	80	0.0375000
NODE_20370_length_649_cov_20.780000	111	191	5	4	80	0.0500000
NODE_20370_length_649_cov_20.780000	111	191	7	14	80	0.1750000
NODE_20370_length_649_cov_20.780000	111	191	9	4	80	0.0500000
NODE_20370_length_649_cov_20.780000	111	191	10	4	80	0.0500000
NODE_20370_length_649_cov_20.780000	111	191	11	1	80	0.0125000
NODE_20370_length_649_cov_20.780000	111	191	12	1	80	0.0125000
NODE_20370_length_649_cov_20.780000	111	191	13	14	80	0.1750000
NODE_20370_length_649_cov_20.780000	111	191	14	1	80	0.0125000
NODE_20370_length_649_cov_20.780000	111	191	15	10	80	0.1250000
NODE_20370_length_649_cov_20.780000	111	191	16	23	80	0.2875000
NODE_20370_length_649_cov_20.780000	111	191	17	1	80	0.0125000
NODE_20370_length_649_cov_20.780000	138	161	10	2	23	0.0869565
NODE_20370_length_649_cov_20.780000	138	161	11	1	23	0.0434783
NODE_20370_length_649_cov_20.780000	138	161	12	1	23	0.0434783
NODE_20370_length_649_cov_20.780000	138	161	13	14	23	0.6086956
NODE_20370_length_649_cov_20.780000	138	161	14	1	23	0.0434783
NODE_20370_length_649_cov_20.780000	138	161	15	4	23	0.1739130
NODE_20370_length_649_cov_20.780000	138	214	10	2	76	0.0263158
NODE_20370_length_649_cov_20.780000	138	214	11	1	76	0.0131579
NODE_20370_length_649_cov_20.780000	138	214	12	1	76	0.0131579
NODE_20370_length_649_cov_20.780000	138	214	13	14	76	0.1842105
NODE_20370_length_649_cov_20.780000	138	214	14	1	76	0.0131579
NODE_20370_length_649_cov_20.780000	138	214	15	10	76	0.1315790
NODE_20370_length_649_cov_20.780000	138	214	16	33	76	0.4342105
NODE_20370_length_649_cov_20.780000	138	214	17	11	76	0.1447368
NODE_20370_length_649_cov_20.780000	138	214	18	3	76	0.0394737
NODE_20370_length_649_cov_20.780000	164	244	15	3	80	0.0375000
NODE_20370_length_649_cov_20.780000	164	244	16	33	80	0.4125000
NODE_20370_length_649_cov_20.780000	164	244	17	12	80	0.1500000
NODE_20370_length_649_cov_20.780000	164	244	18	32	80	0.4000000
NODE_20371_length_649_cov_17.938182	162	242	4	47	80	0.5875000
NODE_20371_length_649_cov_17.938182	162	242	5	23	80	0.2875000
NODE_20371_length_649_cov_17.938182	162	242	6	10	80	0.1250000
NODE_20371_length_649_cov_17.938182	215	295	4	23	80	0.2875000
NODE_20371_length_649_cov_17.938182	215	295	5	26	80	0.3250000
NODE_20371_length_649_cov_17.938182	215	295	6	13	80	0.1625000
NODE_20371_length_649_cov_17.938182	215	295	7	18	80	0.2250000
NODE_20372_length_649_cov_16.761818	395	475	6	36	80	0.4500000
NODE_20372_length_649_cov_16.761818	395	475	7	20	80	0.2500000
NODE_20372_length_649_cov_16.761818	395	475	8	24	80	0.3000000
NODE_20372_length_649_cov_16.761818	448	528	7	31	80	0.3875000
NODE_20372_length_649_cov_16.761818	448	528	8	49	80	0.6125000
NODE_20373_length_649_cov_15.632727	226	306	6	7	80	0.0875000
NODE_20373_length_649_cov_15.632727	226	306	10	1	80	0.0125000
NODE_20373_length_649_cov_15.632727	226	306	11	2	80	0.0250000
NODE_20373_length_649_cov_15.632727	226	306	12	37	80	0.4625000
NODE_20373_length_649_cov_15.632727	226	306	13	7	80	0.0875000
NODE_20373_length_649_cov_15.632727	226	306	14	26	80	0.3250000
NODE_20373_length_649_cov_15.632727	279	359	12	41	80	0.5125000
NODE_20373_length_649_cov_15.632727	279	359	14	13	80	0.1625000
NODE_20373_length_649_cov_15.632727	279	359	15	26	80	0.3250000
NODE_20374_length_649_cov_15.516364	329	409	3	15	80	0.1875000
NODE_20374_length_649_cov_15.516364	329	409	4	47	80	0.5875000
NODE_20374_length_649_cov_15.516364	329	409	5	18	80	0.2250000
NODE_20374_length_649_cov_15.516364	382	462	3	29	80	0.3625000
NODE_20374_length_649_cov_15.516364	382	462	4	51	80	0.6375000
NODE_20375_length_649_cov_10.374545	453	533	1	14	80	0.1750000
NODE_20375_length_649_cov_10.374545	453	533	2	66	80	0.8250000
NODE_20375_length_649_cov_10.374545	506	586	0	9	80	0.1125000
NODE_20375_length_649_cov_10.374545	506	586	1	58	80	0.7250000
NODE_20375_length_649_cov_10.374545	506	586	2	13	80	0.1625000
NODE_20382_length_649_cov_4.403636	213	293	1	28	80	0.3500000
NODE_20382_length_649_cov_4.403636	213	293	2	52	80	0.6500000
NODE_20382_length_649_cov_4.403636	266	346	1	17	80	0.2125000
NODE_20382_length_649_cov_4.403636	266	346	2	63	80	0.7875000
NODE_20454_length_648_cov_34.287796	343	423	7	14	80	0.1750000
NODE_20454_length_648_cov_34.287796	343	423	8	22	80	0.2750000
NODE_20454_length_648_cov_34.287796	343	423	9	22	80	0.2750000
NODE_20454_length_648_cov_34.287796	343	423	10	22	80	0.2750000
NODE_20454_length_648_cov_34.287796	396	476	6	45	80	0.5625000
NODE_20454_length_648_cov_34.287796	396	476	7	22	80	0.2750000
NODE_20454_length_648_cov_34.287796	396	476	8	13	80	0.1625000
NODE_20454_length_648_cov_34.287796	472	552	1	44	80	0.5500000
NODE_20454_length_648_cov_34.287796	472	552	2	32	80	0.4000000
NODE_20454_length_648_cov_34.287796	472	552	6	4	80	0.0500000
NODE_20454_length_648_cov_34.287796	525	605	0	20	80	0.2500000
NODE_20454_length_648_cov_34.287796	525	605	1	60	80	0.7500000
NODE_20455_length_648_cov_19.433515	259	339	0	36	80	0.4500000
NODE_20455_length_648_cov_19.433515	259	339	1	44	80	0.5500000
NODE_20455_length_648_cov_19.433515	312	392	0	40	80	0.5000000
NODE_20455_length_648_cov_19.433515	312	392	1	40	80	0.5000000
NODE_20457_length_648_cov_8.391621	206	286	0	80	80	1.0000000
NODE_20457_length_648_cov_8.391621	259	339	0	80	80	1.0000000
NODE_20459_length_648_cov_6.573770	293	373	0	7	80	0.0875000
NODE_20459_length_648_cov_6.573770	293	373	3	73	80	0.9125000
NODE_20459_length_648_cov_6.573770	346	426	0	24	80	0.3000000
NODE_20459_length_648_cov_6.573770	346	426	3	56	80	0.7000000
NODE_20460_length_648_cov_6.431694	285	328	0	43	43	1.0000000
NODE_20463_length_648_cov_6.085610	257	337	3	13	80	0.1625000
NODE_20463_length_648_cov_6.085610	257	337	5	14	80	0.1750000
NODE_20463_length_648_cov_6.085610	257	337	7	53	80	0.6625000
NODE_20463_length_648_cov_6.085610	310	390	7	38	80	0.4750000
NODE_20463_length_648_cov_6.085610	310	390	8	37	80	0.4625000
NODE_20463_length_648_cov_6.085610	310	390	9	2	80	0.0250000
NODE_20463_length_648_cov_6.085610	310	390	10	3	80	0.0375000
NODE_20483_length_648_cov_2.333333	19	86	0	67	67	1.0000000
NODE_20531_length_647_cov_18.489051	295	375	1	32	80	0.4000000
NODE_20531_length_647_cov_18.489051	295	375	2	26	80	0.3250000
NODE_20531_length_647_cov_18.489051	295	375	3	22	80	0.2750000
NODE_20531_length_647_cov_18.489051	348	428	0	23	80	0.2875000
NODE_20531_length_647_cov_18.489051	348	428	1	57	80	0.7125000
NODE_20532_length_647_cov_14.677007	286	366	3	10	80	0.1250000
NODE_20532_length_647_cov_14.677007	286	366	4	47	80	0.5875000
NODE_20532_length_647_cov_14.677007	286	366	5	1	80	0.0125000
NODE_20532_length_647_cov_14.677007	286	366	6	22	80	0.2750000
NODE_20532_length_647_cov_14.677007	339	419	3	19	80	0.2375000
NODE_20532_length_647_cov_14.677007	339	419	4	31	80	0.3875000
NODE_20532_length_647_cov_14.677007	339	419	5	30	80	0.3750000
NODE_20533_length_647_cov_10.895985	231	311	5	21	80	0.2625000
NODE_20533_length_647_cov_10.895985	231	311	7	16	80	0.2000000
NODE_20533_length_647_cov_10.895985	231	311	8	43	80	0.5375000
NODE_20533_length_647_cov_10.895985	284	364	5	73	80	0.9125000
NODE_20533_length_647_cov_10.895985	284	364	7	7	80	0.0875000
NODE_20534_length_647_cov_9.116788	372	452	0	11	80	0.1375000
NODE_20534_length_647_cov_9.116788	372	452	1	69	80	0.8625000
NODE_20534_length_647_cov_9.116788	425	505	1	52	80	0.6500000
NODE_20534_length_647_cov_9.116788	425	505	2	28	80	0.3500000
NODE_20536_length_647_cov_6.410584	150	221	2	71	71	1.0000000
NODE_20536_length_647_cov_6.410584	194	274	0	4	80	0.0500000
NODE_20536_length_647_cov_6.410584	194	274	1	14	80	0.1750000
NODE_20536_length_647_cov_6.410584	194	274	2	62	80	0.7750000
NODE_20539_length_647_cov_5.567518	239	319	1	27	80	0.3375000
NODE_20539_length_647_cov_5.567518	239	319	2	4	80	0.0500000
NODE_20539_length_647_cov_5.567518	239	319	3	38	80	0.4750000
NODE_20539_length_647_cov_5.567518	239	319	4	11	80	0.1375000
NODE_20539_length_647_cov_5.567518	292	355	3	16	63	0.2539683
NODE_20539_length_647_cov_5.567518	292	355	4	32	63	0.5079365
NODE_20539_length_647_cov_5.567518	292	355	5	10	63	0.1587302
NODE_20539_length_647_cov_5.567518	292	355	6	3	63	0.0476190
NODE_20539_length_647_cov_5.567518	292	355	7	2	63	0.0317460
NODE_20539_length_647_cov_5.567518	348	416	5	2	68	0.0294118
NODE_20539_length_647_cov_5.567518	348	416	6	3	68	0.0441176
NODE_20539_length_647_cov_5.567518	348	416	7	12	68	0.1764706
NODE_20539_length_647_cov_5.567518	348	416	8	37	68	0.5441176
NODE_20539_length_647_cov_5.567518	348	416	9	14	68	0.2058824
NODE_20539_length_647_cov_5.567518	401	469	5	11	68	0.1617647
NODE_20539_length_647_cov_5.567518	401	469	6	38	68	0.5588235
NODE_20539_length_647_cov_5.567518	401	469	7	4	68	0.0588235
NODE_20539_length_647_cov_5.567518	401	469	8	15	68	0.2205882
NODE_20544_length_647_cov_3.775547	356	399	0	43	43	1.0000000
NODE_20550_length_647_cov_2.678832	239	319	2	80	80	1.0000000
NODE_20550_length_647_cov_2.678832	292	372	2	80	80	1.0000000
NODE_20561_length_647_cov_1.937956	254	304	1	50	50	1.0000000
NODE_20607_length_646_cov_56.226691	267	347	8	6	80	0.0750000
NODE_20607_length_646_cov_56.226691	267	347	9	33	80	0.4125000
NODE_20607_length_646_cov_56.226691	267	347	10	21	80	0.2625000
NODE_20607_length_646_cov_56.226691	267	347	11	20	80	0.2500000
NODE_20607_length_646_cov_56.226691	320	400	5	7	80	0.0875000
NODE_20607_length_646_cov_56.226691	320	400	7	4	80	0.0500000
NODE_20607_length_646_cov_56.226691	320	400	8	40	80	0.5000000
NODE_20607_length_646_cov_56.226691	320	400	9	29	80	0.3625000
NODE_20608_length_646_cov_23.747715	76	153	3	7	77	0.0909091
NODE_20608_length_646_cov_23.747715	76	153	5	70	77	0.9090909
NODE_20608_length_646_cov_23.747715	129	209	5	33	80	0.4125000
NODE_20608_length_646_cov_23.747715	129	209	6	1	80	0.0125000
NODE_20608_length_646_cov_23.747715	129	209	7	1	80	0.0125000
NODE_20608_length_646_cov_23.747715	129	209	9	42	80	0.5250000
NODE_20608_length_646_cov_23.747715	129	209	11	3	80	0.0375000
NODE_20609_length_646_cov_22.740402	326	406	0	80	80	1.0000000
NODE_20609_length_646_cov_22.740402	379	459	0	80	80	1.0000000
NODE_20610_length_646_cov_15.160878	363	443	5	20	80	0.2500000
NODE_20610_length_646_cov_15.160878	363	443	6	5	80	0.0625000
NODE_20610_length_646_cov_15.160878	363	443	7	40	80	0.5000000
NODE_20610_length_646_cov_15.160878	363	443	8	15	80	0.1875000
NODE_20610_length_646_cov_15.160878	416	496	1	3	80	0.0375000
NODE_20610_length_646_cov_15.160878	416	496	2	13	80	0.1625000
NODE_20610_length_646_cov_15.160878	416	496	3	32	80	0.4000000
NODE_20610_length_646_cov_15.160878	416	496	4	1	80	0.0125000
NODE_20610_length_646_cov_15.160878	416	496	5	24	80	0.3000000
NODE_20610_length_646_cov_15.160878	416	496	6	5	80	0.0625000
NODE_20610_length_646_cov_15.160878	416	496	7	2	80	0.0250000
NODE_20611_length_646_cov_9.429616	309	389	2	19	80	0.2375000
NODE_20611_length_646_cov_9.429616	309	389	3	8	80	0.1000000
NODE_20611_length_646_cov_9.429616	309	389	4	22	80	0.2750000
NODE_20611_length_646_cov_9.429616	309	389	6	8	80	0.1000000
NODE_20611_length_646_cov_9.429616	309	389	7	23	80	0.2875000
NODE_20611_length_646_cov_9.429616	362	442	6	6	80	0.0750000
NODE_20611_length_646_cov_9.429616	362	442	7	73	80	0.9125000
NODE_20611_length_646_cov_9.429616	362	442	8	1	80	0.0125000
NODE_20612_length_646_cov_9.246801	149	221	0	72	72	1.0000000
NODE_20613_length_646_cov_7.539305	227	307	0	80	80	1.0000000
NODE_20613_length_646_cov_7.539305	280	360	0	80	80	1.0000000
NODE_20614_length_646_cov_6.756856	236	316	0	80	80	1.0000000
NODE_20614_length_646_cov_6.756856	289	369	0	80	80	1.0000000
NODE_20615_length_646_cov_6.480804	373	437	2	64	64	1.0000000
NODE_20615_length_646_cov_6.480804	410	490	0	12	80	0.1500000
NODE_20615_length_646_cov_6.480804	410	490	2	68	80	0.8500000
NODE_20616_length_646_cov_6.396709	194	274	0	80	80	1.0000000
NODE_20616_length_646_cov_6.396709	254	327	0	73	73	1.0000000
NODE_20619_length_646_cov_4.652651	265	345	1	80	80	1.0000000
NODE_20623_length_646_cov_4.122486	401	452	0	51	51	1.0000000
NODE_20688_length_645_cov_95.882784	179	259	24	6	80	0.0750000
NODE_20688_length_645_cov_95.882784	179	259	25	2	80	0.0250000
NODE_20688_length_645_cov_95.882784	179	259	26	5	80	0.0625000
NODE_20688_length_645_cov_95.882784	179	259	27	6	80	0.0750000
NODE_20688_length_645_cov_95.882784	179	259	28	21	80	0.2625000
NODE_20688_length_645_cov_95.882784	179	259	29	12	80	0.1500000
NODE_20688_length_645_cov_95.882784	179	259	31	4	80	0.0500000
NODE_20688_length_645_cov_95.882784	179	259	32	5	80	0.0625000
NODE_20688_length_645_cov_95.882784	179	259	35	5	80	0.0625000
NODE_20688_length_645_cov_95.882784	179	259	36	7	80	0.0875000
NODE_20688_length_645_cov_95.882784	179	259	41	7	80	0.0875000
NODE_20688_length_645_cov_95.882784	232	312	21	1	80	0.0125000
NODE_20688_length_645_cov_95.882784	232	312	23	28	80	0.3500000
NODE_20688_length_645_cov_95.882784	232	312	24	6	80	0.0750000
NODE_20688_length_645_cov_95.882784	232	312	25	8	80	0.1000000
NODE_20688_length_645_cov_95.882784	232	312	27	7	80	0.0875000
NODE_20688_length_645_cov_95.882784	232	312	28	30	80	0.3750000
NODE_20689_length_645_cov_12.985348	343	423	3	7	80	0.0875000
NODE_20689_length_645_cov_12.985348	343	423	4	73	80	0.9125000
NODE_20689_length_645_cov_12.985348	396	476	0	4	80	0.0500000
NODE_20689_length_645_cov_12.985348	396	476	2	46	80	0.5750000
NODE_20689_length_645_cov_12.985348	396	476	3	10	80	0.1250000
NODE_20689_length_645_cov_12.985348	396	476	4	20	80	0.2500000
NODE_20691_length_645_cov_9.228938	254	334	2	49	80	0.6125000
NODE_20691_length_645_cov_9.228938	254	334	4	31	80	0.3875000
NODE_20691_length_645_cov_9.228938	307	387	0	19	80	0.2375000
NODE_20691_length_645_cov_9.228938	307	387	2	61	80	0.7625000
NODE_20692_length_645_cov_9.172161	293	373	0	80	80	1.0000000
NODE_20692_length_645_cov_9.172161	346	426	0	80	80	1.0000000
NODE_20697_length_645_cov_5.609890	461	541	1	34	80	0.4250000
NODE_20697_length_645_cov_5.609890	461	541	2	46	80	0.5750000
NODE_20697_length_645_cov_5.609890	514	594	0	38	80	0.4750000
NODE_20697_length_645_cov_5.609890	514	594	1	42	80	0.5250000
NODE_20698_length_645_cov_4.743590	237	317	3	20	80	0.2500000
NODE_20698_length_645_cov_4.743590	237	317	5	9	80	0.1125000
NODE_20698_length_645_cov_4.743590	237	317	6	10	80	0.1250000
NODE_20698_length_645_cov_4.743590	237	317	7	41	80	0.5125000
NODE_20698_length_645_cov_4.743590	290	370	3	73	80	0.9125000
NODE_20698_length_645_cov_4.743590	290	370	7	7	80	0.0875000
NODE_20716_length_645_cov_2.177656	373	416	0	43	43	1.0000000
NODE_20762_length_644_cov_59.286239	323	401	8	27	78	0.3461539
NODE_20762_length_644_cov_59.286239	323	401	9	14	78	0.1794872
NODE_20762_length_644_cov_59.286239	323	401	10	37	78	0.4743590
NODE_20763_length_644_cov_27.577982	63	143	2	59	80	0.7375000
NODE_20763_length_644_cov_27.577982	63	143	3	21	80	0.2625000
NODE_20763_length_644_cov_27.577982	116	196	1	16	80	0.2000000
NODE_20763_length_644_cov_27.577982	116	196	2	6	80	0.0750000
NODE_20763_length_644_cov_27.577982	116	196	3	58	80	0.7250000
NODE_20765_length_644_cov_10.073394	284	364	0	29	80	0.3625000
NODE_20765_length_644_cov_10.073394	284	364	2	32	80	0.4000000
NODE_20765_length_644_cov_10.073394	284	364	3	4	80	0.0500000
NODE_20765_length_644_cov_10.073394	284	364	4	15	80	0.1875000
NODE_20765_length_644_cov_10.073394	337	417	2	8	80	0.1000000
NODE_20765_length_644_cov_10.073394	337	417	3	4	80	0.0500000
NODE_20765_length_644_cov_10.073394	337	417	4	68	80	0.8500000
NODE_20845_length_643_cov_27.562500	201	281	10	8	80	0.1000000
NODE_20845_length_643_cov_27.562500	201	281	11	6	80	0.0750000
NODE_20845_length_643_cov_27.562500	201	281	15	37	80	0.4625000
NODE_20845_length_643_cov_27.562500	201	281	17	22	80	0.2750000
NODE_20845_length_643_cov_27.562500	201	281	18	6	80	0.0750000
NODE_20845_length_643_cov_27.562500	201	281	19	1	80	0.0125000
NODE_20845_length_643_cov_27.562500	254	334	10	15	80	0.1875000
NODE_20845_length_643_cov_27.562500	254	334	11	25	80	0.3125000
NODE_20845_length_643_cov_27.562500	254	334	12	18	80	0.2250000
NODE_20845_length_643_cov_27.562500	254	334	13	8	80	0.1000000
NODE_20845_length_643_cov_27.562500	254	334	14	1	80	0.0125000
NODE_20845_length_643_cov_27.562500	254	334	17	6	80	0.0750000
NODE_20845_length_643_cov_27.562500	254	334	18	6	80	0.0750000
NODE_20845_length_643_cov_27.562500	254	334	19	1	80	0.0125000
NODE_20845_length_643_cov_27.562500	330	410	9	9	80	0.1125000
NODE_20845_length_643_cov_27.562500	330	410	10	24	80	0.3000000
NODE_20845_length_643_cov_27.562500	330	410	12	47	80	0.5875000
NODE_20845_length_643_cov_27.562500	383	463	6	6	80	0.0750000
NODE_20845_length_643_cov_27.562500	383	463	7	19	80	0.2375000
NODE_20845_length_643_cov_27.562500	383	463	8	22	80	0.2750000
NODE_20845_length_643_cov_27.562500	383	463	9	6	80	0.0750000
NODE_20845_length_643_cov_27.562500	383	463	10	24	80	0.3000000
NODE_20845_length_643_cov_27.562500	383	463	12	3	80	0.0375000
NODE_20846_length_643_cov_12.895221	203	283	0	9	80	0.1125000
NODE_20846_length_643_cov_12.895221	203	283	2	71	80	0.8875000
NODE_20846_length_643_cov_12.895221	256	336	2	80	80	1.0000000
NODE_20847_length_643_cov_10.501838	280	360	0	80	80	1.0000000
NODE_20847_length_643_cov_10.501838	333	413	0	80	80	1.0000000
NODE_20848_length_643_cov_9.136029	307	385	2	78	78	1.0000000
NODE_20848_length_643_cov_9.136029	358	438	1	46	80	0.5750000
NODE_20848_length_643_cov_9.136029	358	438	2	34	80	0.4250000
NODE_20849_length_643_cov_8.264706	202	282	2	80	80	1.0000000
NODE_20849_length_643_cov_8.264706	255	335	0	6	80	0.0750000
NODE_20849_length_643_cov_8.264706	255	335	1	9	80	0.1125000
NODE_20849_length_643_cov_8.264706	255	335	2	65	80	0.8125000
NODE_20851_length_643_cov_7.137868	173	253	1	80	80	1.0000000
NODE_20851_length_643_cov_7.137868	226	306	1	80	80	1.0000000
NODE_20855_length_643_cov_5.851103	255	335	6	51	80	0.6375000
NODE_20855_length_643_cov_5.851103	255	335	8	29	80	0.3625000
NODE_20855_length_643_cov_5.851103	308	388	2	1	80	0.0125000
NODE_20855_length_643_cov_5.851103	308	388	3	37	80	0.4625000
NODE_20855_length_643_cov_5.851103	308	388	4	3	80	0.0375000
NODE_20855_length_643_cov_5.851103	308	388	6	8	80	0.1000000
NODE_20855_length_643_cov_5.851103	308	388	8	31	80	0.3875000
NODE_20869_length_643_cov_3.121324	283	348	0	65	65	1.0000000
NODE_20872_length_643_cov_2.806985	387	451	0	64	64	1.0000000
NODE_20942_length_642_cov_36.309392	156	236	1	5	80	0.0625000
NODE_20942_length_642_cov_36.309392	156	236	2	70	80	0.8750000
NODE_20942_length_642_cov_36.309392	156	236	3	5	80	0.0625000
NODE_20942_length_642_cov_36.309392	209	289	2	22	80	0.2750000
NODE_20942_length_642_cov_36.309392	209	289	3	58	80	0.7250000
NODE_20943_length_642_cov_27.046041	154	234	3	76	80	0.9500000
NODE_20943_length_642_cov_27.046041	154	234	4	4	80	0.0500000
NODE_20943_length_642_cov_27.046041	207	287	0	40	80	0.5000000
NODE_20943_length_642_cov_27.046041	207	287	3	40	80	0.5000000
NODE_20944_length_642_cov_26.290976	209	289	1	80	80	1.0000000
NODE_20944_length_642_cov_26.290976	262	342	0	42	80	0.5250000
NODE_20944_length_642_cov_26.290976	262	342	1	38	80	0.4750000
NODE_20945_length_642_cov_11.651934	309	389	0	80	80	1.0000000
NODE_20945_length_642_cov_11.651934	362	442	0	80	80	1.0000000
NODE_20947_length_642_cov_6.692449	453	533	0	80	80	1.0000000
NODE_20947_length_642_cov_6.692449	506	586	0	80	80	1.0000000
NODE_20951_length_642_cov_5.933702	260	340	0	80	80	1.0000000
NODE_20951_length_642_cov_5.933702	313	391	0	78	78	1.0000000
NODE_20967_length_642_cov_2.823204	115	158	1	43	43	1.0000000
NODE_20967_length_642_cov_2.823204	245	300	1	55	55	1.0000000
NODE_20967_length_642_cov_2.823204	329	410	0	81	81	1.0000000
NODE_20991_length_642_cov_1.357274	0	75	0	71	75	0.9466667
NODE_20991_length_642_cov_1.357274	0	75	1	4	75	0.0533333
NODE_21018_length_641_cov_38.675277	284	345	0	61	61	1.0000000
NODE_21018_length_641_cov_38.675277	318	369	0	51	51	1.0000000
NODE_21019_length_641_cov_15.271218	260	340	3	4	80	0.0500000
NODE_21019_length_641_cov_15.271218	260	340	4	9	80	0.1125000
NODE_21019_length_641_cov_15.271218	260	340	5	67	80	0.8375000
NODE_21019_length_641_cov_15.271218	313	393	5	45	80	0.5625000
NODE_21019_length_641_cov_15.271218	313	393	6	35	80	0.4375000
NODE_21021_length_641_cov_12.584871	363	443	1	2	80	0.0250000
NODE_21021_length_641_cov_12.584871	363	443	2	13	80	0.1625000
NODE_21021_length_641_cov_12.584871	363	443	3	54	80	0.6750000
NODE_21021_length_641_cov_12.584871	363	443	4	11	80	0.1375000
NODE_21021_length_641_cov_12.584871	416	496	3	41	80	0.5125000
NODE_21021_length_641_cov_12.584871	416	496	4	39	80	0.4875000
NODE_21022_length_641_cov_11.125461	38	118	0	80	80	1.0000000
NODE_21022_length_641_cov_11.125461	91	171	0	80	80	1.0000000
NODE_21025_length_641_cov_7.719557	84	138	3	54	54	1.0000000
NODE_21025_length_641_cov_7.719557	113	193	3	73	80	0.9125000
NODE_21025_length_641_cov_7.719557	113	193	6	7	80	0.0875000
NODE_21026_length_641_cov_7.675277	232	312	2	80	80	1.0000000
NODE_21026_length_641_cov_7.675277	285	365	2	80	80	1.0000000
NODE_21027_length_641_cov_7.675277	255	335	5	18	80	0.2250000
NODE_21027_length_641_cov_7.675277	255	335	11	30	80	0.3750000
NODE_21027_length_641_cov_7.675277	255	335	12	32	80	0.4000000
NODE_21027_length_641_cov_7.675277	308	388	9	35	80	0.4375000
NODE_21027_length_641_cov_7.675277	308	388	11	45	80	0.5625000
NODE_21028_length_641_cov_7.627306	262	342	0	80	80	1.0000000
NODE_21028_length_641_cov_7.627306	315	395	0	80	80	1.0000000
NODE_21029_length_641_cov_7.282288	247	300	2	16	53	0.3018868
NODE_21029_length_641_cov_7.282288	247	300	3	17	53	0.3207547
NODE_21029_length_641_cov_7.282288	247	300	4	20	53	0.3773585
NODE_21031_length_641_cov_5.029520	138	218	3	80	80	1.0000000
NODE_21031_length_641_cov_5.029520	191	271	0	13	80	0.1625000
NODE_21031_length_641_cov_5.029520	191	271	3	67	80	0.8375000
NODE_21034_length_641_cov_4.701107	238	282	0	44	44	1.0000000
NODE_21109_length_640_cov_39.676525	524	597	0	27	73	0.3698630
NODE_21109_length_640_cov_39.676525	524	597	2	46	73	0.6301370
NODE_21109_length_640_cov_39.676525	564	605	0	35	41	0.8536586
NODE_21109_length_640_cov_39.676525	564	605	2	6	41	0.1463415
NODE_21110_length_640_cov_19.578558	273	353	3	45	80	0.5625000
NODE_21110_length_640_cov_19.578558	273	353	4	35	80	0.4375000
NODE_21110_length_640_cov_19.578558	326	406	2	16	80	0.2000000
NODE_21110_length_640_cov_19.578558	326	406	3	64	80	0.8000000
NODE_21111_length_640_cov_15.717190	178	258	2	11	80	0.1375000
NODE_21111_length_640_cov_15.717190	178	258	3	41	80	0.5125000
NODE_21111_length_640_cov_15.717190	178	258	4	28	80	0.3500000
NODE_21111_length_640_cov_15.717190	231	311	0	8	80	0.1000000
NODE_21111_length_640_cov_15.717190	231	311	2	56	80	0.7000000
NODE_21111_length_640_cov_15.717190	231	311	4	16	80	0.2000000
NODE_21112_length_640_cov_15.338262	319	399	6	16	80	0.2000000
NODE_21112_length_640_cov_15.338262	319	399	8	39	80	0.4875000
NODE_21112_length_640_cov_15.338262	319	399	12	25	80	0.3125000
NODE_21112_length_640_cov_15.338262	372	452	6	13	80	0.1625000
NODE_21112_length_640_cov_15.338262	372	452	8	2	80	0.0250000
NODE_21112_length_640_cov_15.338262	372	452	10	39	80	0.4875000
NODE_21112_length_640_cov_15.338262	372	452	12	26	80	0.3250000
NODE_21113_length_640_cov_9.523105	20	43	0	23	23	1.0000000
NODE_21118_length_640_cov_5.123845	272	335	3	27	63	0.4285714
NODE_21118_length_640_cov_5.123845	272	335	4	36	63	0.5714286
NODE_21121_length_640_cov_4.410351	254	334	0	38	80	0.4750000
NODE_21121_length_640_cov_4.410351	254	334	1	1	80	0.0125000
NODE_21121_length_640_cov_4.410351	254	334	2	41	80	0.5125000
NODE_21121_length_640_cov_4.410351	307	387	2	80	80	1.0000000
NODE_21129_length_640_cov_3.406654	244	324	0	80	80	1.0000000
NODE_21140_length_640_cov_2.316081	21	57	0	36	36	1.0000000
NODE_21190_length_639_cov_58.092593	302	377	30	9	75	0.1200000
NODE_21190_length_639_cov_58.092593	302	377	31	21	75	0.2800000
NODE_21190_length_639_cov_58.092593	302	377	32	4	75	0.0533333
NODE_21190_length_639_cov_58.092593	302	377	33	18	75	0.2400000
NODE_21190_length_639_cov_58.092593	302	377	34	22	75	0.2933333
NODE_21190_length_639_cov_58.092593	302	377	35	1	75	0.0133333
NODE_21190_length_639_cov_58.092593	350	430	16	1	80	0.0125000
NODE_21190_length_639_cov_58.092593	350	430	18	2	80	0.0250000
NODE_21190_length_639_cov_58.092593	350	430	19	8	80	0.1000000
NODE_21190_length_639_cov_58.092593	350	430	20	2	80	0.0250000
NODE_21190_length_639_cov_58.092593	350	430	22	8	80	0.1000000
NODE_21190_length_639_cov_58.092593	350	430	24	3	80	0.0375000
NODE_21190_length_639_cov_58.092593	350	430	26	3	80	0.0375000
NODE_21190_length_639_cov_58.092593	350	430	28	10	80	0.1250000
NODE_21190_length_639_cov_58.092593	350	430	29	1	80	0.0125000
NODE_21190_length_639_cov_58.092593	350	430	30	5	80	0.0625000
NODE_21190_length_639_cov_58.092593	350	430	31	5	80	0.0625000
NODE_21190_length_639_cov_58.092593	350	430	33	9	80	0.1125000
NODE_21190_length_639_cov_58.092593	350	430	34	23	80	0.2875000
NODE_21191_length_639_cov_32.951852	213	293	18	2	80	0.0250000
NODE_21191_length_639_cov_32.951852	213	293	19	23	80	0.2875000
NODE_21191_length_639_cov_32.951852	213	293	20	14	80	0.1750000
NODE_21191_length_639_cov_32.951852	213	293	21	31	80	0.3875000
NODE_21191_length_639_cov_32.951852	213	293	22	6	80	0.0750000
NODE_21191_length_639_cov_32.951852	213	293	23	4	80	0.0500000
NODE_21191_length_639_cov_32.951852	266	346	8	4	80	0.0500000
NODE_21191_length_639_cov_32.951852	266	346	9	8	80	0.1000000
NODE_21191_length_639_cov_32.951852	266	346	13	2	80	0.0250000
NODE_21191_length_639_cov_32.951852	266	346	15	5	80	0.0625000
NODE_21191_length_639_cov_32.951852	266	346	17	3	80	0.0375000
NODE_21191_length_639_cov_32.951852	266	346	18	26	80	0.3250000
NODE_21191_length_639_cov_32.951852	266	346	19	11	80	0.1375000
NODE_21191_length_639_cov_32.951852	266	346	20	5	80	0.0625000
NODE_21191_length_639_cov_32.951852	266	346	21	16	80	0.2000000
NODE_21192_length_639_cov_24.564815	290	370	4	21	80	0.2625000
NODE_21192_length_639_cov_24.564815	290	370	5	47	80	0.5875000
NODE_21192_length_639_cov_24.564815	290	370	6	5	80	0.0625000
NODE_21192_length_639_cov_24.564815	290	370	9	7	80	0.0875000
NODE_21192_length_639_cov_24.564815	343	423	0	33	80	0.4125000
NODE_21192_length_639_cov_24.564815	343	423	3	10	80	0.1250000
NODE_21192_length_639_cov_24.564815	343	423	4	31	80	0.3875000
NODE_21192_length_639_cov_24.564815	343	423	5	6	80	0.0750000
NODE_21193_length_639_cov_14.448148	288	368	1	32	80	0.4000000
NODE_21193_length_639_cov_14.448148	288	368	2	48	80	0.6000000
NODE_21193_length_639_cov_14.448148	341	421	0	12	80	0.1500000
NODE_21193_length_639_cov_14.448148	341	421	1	68	80	0.8500000
NODE_21195_length_639_cov_9.001852	265	345	4	16	80	0.2000000
NODE_21195_length_639_cov_9.001852	265	345	6	38	80	0.4750000
NODE_21195_length_639_cov_9.001852	265	345	7	8	80	0.1000000
NODE_21195_length_639_cov_9.001852	265	345	8	4	80	0.0500000
NODE_21195_length_639_cov_9.001852	265	345	9	14	80	0.1750000
NODE_21195_length_639_cov_9.001852	318	398	6	25	80	0.3125000
NODE_21195_length_639_cov_9.001852	318	398	7	37	80	0.4625000
NODE_21195_length_639_cov_9.001852	318	398	8	4	80	0.0500000
NODE_21195_length_639_cov_9.001852	318	398	9	14	80	0.1750000
NODE_21197_length_639_cov_8.444444	161	241	1	56	80	0.7000000
NODE_21197_length_639_cov_8.444444	161	241	2	24	80	0.3000000
NODE_21197_length_639_cov_8.444444	214	294	1	73	80	0.9125000
NODE_21197_length_639_cov_8.444444	214	294	2	7	80	0.0875000
NODE_21202_length_639_cov_6.283333	157	176	1	19	19	1.0000000
NODE_21207_length_639_cov_4.188889	258	335	0	77	77	1.0000000
NODE_21207_length_639_cov_4.188889	308	354	0	46	46	1.0000000
NODE_21213_length_639_cov_3.448148	126	206	0	80	80	1.0000000
NODE_21213_length_639_cov_3.448148	179	259	0	80	80	1.0000000
NODE_21223_length_639_cov_2.683333	256	288	0	32	32	1.0000000
NODE_21224_length_639_cov_2.555556	189	240	0	51	51	1.0000000
NODE_21225_length_639_cov_2.477778	562	635	0	73	73	1.0000000
NODE_21265_length_639_cov_1.179630	542	564	0	22	22	1.0000000
NODE_21269_length_639_cov_1.051852	404	455	0	51	51	1.0000000
NODE_21278_length_638_cov_13.018553	273	353	2	80	80	1.0000000
NODE_21278_length_638_cov_13.018553	326	406	0	4	80	0.0500000
NODE_21278_length_638_cov_13.018553	326	406	1	48	80	0.6000000
NODE_21278_length_638_cov_13.018553	326	406	2	28	80	0.3500000
NODE_21279_length_638_cov_12.656772	343	423	2	80	80	1.0000000
NODE_21279_length_638_cov_12.656772	396	476	0	47	80	0.5875000
NODE_21279_length_638_cov_12.656772	396	476	2	33	80	0.4125000
NODE_21280_length_638_cov_11.877551	298	378	10	11	80	0.1375000
NODE_21280_length_638_cov_11.877551	298	378	11	1	80	0.0125000
NODE_21280_length_638_cov_11.877551	298	378	13	46	80	0.5750000
NODE_21280_length_638_cov_11.877551	298	378	15	11	80	0.1375000
NODE_21280_length_638_cov_11.877551	298	378	18	10	80	0.1250000
NODE_21280_length_638_cov_11.877551	298	378	19	1	80	0.0125000
NODE_21280_length_638_cov_11.877551	351	431	13	16	80	0.2000000
NODE_21280_length_638_cov_11.877551	351	431	15	1	80	0.0125000
NODE_21280_length_638_cov_11.877551	351	431	16	1	80	0.0125000
NODE_21280_length_638_cov_11.877551	351	431	17	18	80	0.2250000
NODE_21280_length_638_cov_11.877551	351	431	18	13	80	0.1625000
NODE_21280_length_638_cov_11.877551	351	431	19	31	80	0.3875000
NODE_21281_length_638_cov_8.779221	330	408	2	4	78	0.0512821
NODE_21281_length_638_cov_8.779221	330	408	4	74	78	0.9487180
NODE_21281_length_638_cov_8.779221	383	461	2	51	78	0.6538461
NODE_21281_length_638_cov_8.779221	383	461	4	27	78	0.3461539
NODE_21284_length_638_cov_5.543599	315	395	0	80	80	1.0000000
NODE_21290_length_638_cov_3.966605	307	387	0	80	80	1.0000000
NODE_21301_length_638_cov_2.786642	157	208	0	51	51	1.0000000
NODE_21301_length_638_cov_2.786642	181	261	0	80	80	1.0000000
NODE_21364_length_637_cov_67.157993	285	365	6	22	80	0.2750000
NODE_21364_length_637_cov_67.157993	285	365	7	12	80	0.1500000
NODE_21364_length_637_cov_67.157993	285	365	8	14	80	0.1750000
NODE_21364_length_637_cov_67.157993	285	365	10	7	80	0.0875000
NODE_21364_length_637_cov_67.157993	285	365	13	24	80	0.3000000
NODE_21364_length_637_cov_67.157993	285	365	14	1	80	0.0125000
NODE_21364_length_637_cov_67.157993	338	418	10	2	80	0.0250000
NODE_21364_length_637_cov_67.157993	338	418	12	3	80	0.0375000
NODE_21364_length_637_cov_67.157993	338	418	13	37	80	0.4625000
NODE_21364_length_637_cov_67.157993	338	418	14	15	80	0.1875000
NODE_21364_length_637_cov_67.157993	338	418	16	21	80	0.2625000
NODE_21364_length_637_cov_67.157993	338	418	17	2	80	0.0250000
NODE_21364_length_637_cov_67.157993	414	494	8	4	80	0.0500000
NODE_21364_length_637_cov_67.157993	414	494	11	7	80	0.0875000
NODE_21364_length_637_cov_67.157993	414	494	13	12	80	0.1500000
NODE_21364_length_637_cov_67.157993	414	494	14	12	80	0.1500000
NODE_21364_length_637_cov_67.157993	414	494	15	29	80	0.3625000
NODE_21364_length_637_cov_67.157993	414	494	16	10	80	0.1250000
NODE_21364_length_637_cov_67.157993	414	494	17	6	80	0.0750000
NODE_21364_length_637_cov_67.157993	467	547	3	2	80	0.0250000
NODE_21364_length_637_cov_67.157993	467	547	5	14	80	0.1750000
NODE_21364_length_637_cov_67.157993	467	547	6	2	80	0.0250000
NODE_21364_length_637_cov_67.157993	467	547	7	19	80	0.2375000
NODE_21364_length_637_cov_67.157993	467	547	8	20	80	0.2500000
NODE_21364_length_637_cov_67.157993	467	547	11	7	80	0.0875000
NODE_21364_length_637_cov_67.157993	467	547	13	9	80	0.1125000
NODE_21364_length_637_cov_67.157993	467	547	14	7	80	0.0875000
NODE_21365_length_637_cov_63.029740	195	275	15	24	80	0.3000000
NODE_21365_length_637_cov_63.029740	195	275	34	56	80	0.7000000
NODE_21365_length_637_cov_63.029740	248	328	0	48	80	0.6000000
NODE_21365_length_637_cov_63.029740	248	328	14	1	80	0.0125000
NODE_21365_length_637_cov_63.029740	248	328	15	28	80	0.3500000
NODE_21365_length_637_cov_63.029740	248	328	34	3	80	0.0375000
NODE_21366_length_637_cov_44.923792	53	133	0	80	80	1.0000000
NODE_21366_length_637_cov_44.923792	54	133	0	79	79	1.0000000
NODE_21366_length_637_cov_44.923792	106	186	0	38	80	0.4750000
NODE_21366_length_637_cov_44.923792	106	186	2	25	80	0.3125000
NODE_21366_length_637_cov_44.923792	106	186	4	17	80	0.2125000
NODE_21366_length_637_cov_44.923792	106	186	0	38	80	0.4750000
NODE_21366_length_637_cov_44.923792	106	186	2	25	80	0.3125000
NODE_21366_length_637_cov_44.923792	106	186	4	17	80	0.2125000
NODE_21366_length_637_cov_44.923792	182	262	4	10	80	0.1250000
NODE_21366_length_637_cov_44.923792	182	262	5	70	80	0.8750000
NODE_21366_length_637_cov_44.923792	235	315	3	21	80	0.2625000
NODE_21366_length_637_cov_44.923792	235	315	5	59	80	0.7375000
NODE_21367_length_637_cov_44.193309	193	273	6	72	80	0.9000000
NODE_21367_length_637_cov_44.193309	193	273	7	1	80	0.0125000
NODE_21367_length_637_cov_44.193309	193	273	8	1	80	0.0125000
NODE_21367_length_637_cov_44.193309	193	273	10	1	80	0.0125000
NODE_21367_length_637_cov_44.193309	193	273	11	1	80	0.0125000
NODE_21367_length_637_cov_44.193309	193	273	21	4	80	0.0500000
NODE_21367_length_637_cov_44.193309	246	326	6	19	80	0.2375000
NODE_21367_length_637_cov_44.193309	246	326	7	1	80	0.0125000
NODE_21367_length_637_cov_44.193309	246	326	8	1	80	0.0125000
NODE_21367_length_637_cov_44.193309	246	326	10	1	80	0.0125000
NODE_21367_length_637_cov_44.193309	246	326	11	1	80	0.0125000
NODE_21367_length_637_cov_44.193309	246	326	15	6	80	0.0750000
NODE_21367_length_637_cov_44.193309	246	326	21	51	80	0.6375000
NODE_21368_length_637_cov_37.855019	215	295	51	3	80	0.0375000
NODE_21368_length_637_cov_37.855019	215	295	52	14	80	0.1750000
NODE_21368_length_637_cov_37.855019	215	295	54	8	80	0.1000000
NODE_21368_length_637_cov_37.855019	215	295	58	6	80	0.0750000
NODE_21368_length_637_cov_37.855019	215	295	59	1	80	0.0125000
NODE_21368_length_637_cov_37.855019	215	295	61	20	80	0.2500000
NODE_21368_length_637_cov_37.855019	215	295	62	3	80	0.0375000
NODE_21368_length_637_cov_37.855019	215	295	63	14	80	0.1750000
NODE_21368_length_637_cov_37.855019	215	295	64	4	80	0.0500000
NODE_21368_length_637_cov_37.855019	215	295	66	1	80	0.0125000
NODE_21368_length_637_cov_37.855019	215	295	67	1	80	0.0125000
NODE_21368_length_637_cov_37.855019	215	295	68	4	80	0.0500000
NODE_21368_length_637_cov_37.855019	215	295	72	1	80	0.0125000
NODE_21368_length_637_cov_37.855019	268	347	35	2	79	0.0253165
NODE_21368_length_637_cov_37.855019	268	347	37	2	79	0.0253165
NODE_21368_length_637_cov_37.855019	268	347	39	3	79	0.0379747
NODE_21368_length_637_cov_37.855019	268	347	42	5	79	0.0632911
NODE_21368_length_637_cov_37.855019	268	347	44	7	79	0.0886076
NODE_21368_length_637_cov_37.855019	268	347	46	1	79	0.0126582
NODE_21368_length_637_cov_37.855019	268	347	47	1	79	0.0126582
NODE_21368_length_637_cov_37.855019	268	347	54	7	79	0.0886076
NODE_21368_length_637_cov_37.855019	268	347	55	2	79	0.0253165
NODE_21368_length_637_cov_37.855019	268	347	58	2	79	0.0253165
NODE_21368_length_637_cov_37.855019	268	347	59	3	79	0.0379747
NODE_21368_length_637_cov_37.855019	268	347	60	3	79	0.0379747
NODE_21368_length_637_cov_37.855019	268	347	61	8	79	0.1012658
NODE_21368_length_637_cov_37.855019	268	347	62	1	79	0.0126582
NODE_21368_length_637_cov_37.855019	268	347	63	5	79	0.0632911
NODE_21368_length_637_cov_37.855019	268	347	64	4	79	0.0506329
NODE_21368_length_637_cov_37.855019	268	347	66	1	79	0.0126582
NODE_21368_length_637_cov_37.855019	268	347	67	2	79	0.0253165
NODE_21368_length_637_cov_37.855019	268	347	68	15	79	0.1898734
NODE_21368_length_637_cov_37.855019	268	347	69	1	79	0.0126582
NODE_21368_length_637_cov_37.855019	268	347	72	4	79	0.0506329
NODE_21369_length_637_cov_33.957249	332	412	10	13	80	0.1625000
NODE_21369_length_637_cov_33.957249	332	412	12	10	80	0.1250000
NODE_21369_length_637_cov_33.957249	332	412	13	14	80	0.1750000
NODE_21369_length_637_cov_33.957249	332	412	14	21	80	0.2625000
NODE_21369_length_637_cov_33.957249	332	412	16	22	80	0.2750000
NODE_21369_length_637_cov_33.957249	385	465	12	3	80	0.0375000
NODE_21369_length_637_cov_33.957249	385	465	13	2	80	0.0250000
NODE_21369_length_637_cov_33.957249	385	465	14	22	80	0.2750000
NODE_21369_length_637_cov_33.957249	385	465	16	36	80	0.4500000
NODE_21369_length_637_cov_33.957249	385	465	17	3	80	0.0375000
NODE_21369_length_637_cov_33.957249	385	465	18	2	80	0.0250000
NODE_21369_length_637_cov_33.957249	385	465	19	3	80	0.0375000
NODE_21369_length_637_cov_33.957249	385	465	20	9	80	0.1125000
NODE_21370_length_637_cov_23.682156	275	355	2	80	80	1.0000000
NODE_21370_length_637_cov_23.682156	328	408	0	31	80	0.3875000
NODE_21370_length_637_cov_23.682156	328	408	2	49	80	0.6125000
NODE_21371_length_637_cov_19.676580	267	347	5	12	80	0.1500000
NODE_21371_length_637_cov_19.676580	267	347	6	12	80	0.1500000
NODE_21371_length_637_cov_19.676580	267	347	7	12	80	0.1500000
NODE_21371_length_637_cov_19.676580	267	347	14	9	80	0.1125000
NODE_21371_length_637_cov_19.676580	267	347	17	35	80	0.4375000
NODE_21371_length_637_cov_19.676580	320	400	17	27	80	0.3375000
NODE_21371_length_637_cov_19.676580	320	400	18	21	80	0.2625000
NODE_21371_length_637_cov_19.676580	320	400	20	5	80	0.0625000
NODE_21371_length_637_cov_19.676580	320	400	21	27	80	0.3375000
NODE_21373_length_637_cov_9.182156	226	276	1	50	50	1.0000000
NODE_21373_length_637_cov_9.182156	312	357	0	45	45	1.0000000
NODE_21374_length_637_cov_9.078067	276	357	0	2	81	0.0246914
NODE_21374_length_637_cov_9.078067	276	357	1	79	81	0.9753087
NODE_21374_length_637_cov_9.078067	330	410	1	80	80	1.0000000
NODE_21375_length_637_cov_8.566914	235	315	0	80	80	1.0000000
NODE_21375_length_637_cov_8.566914	288	368	0	80	80	1.0000000
NODE_21378_length_637_cov_6.652416	337	415	1	6	78	0.0769231
NODE_21378_length_637_cov_6.652416	337	415	3	72	78	0.9230769
NODE_21378_length_637_cov_6.652416	390	472	2	19	82	0.2317073
NODE_21378_length_637_cov_6.652416	390	472	3	63	82	0.7682927
NODE_21385_length_637_cov_4.522305	284	364	0	80	80	1.0000000
NODE_21385_length_637_cov_4.522305	337	417	0	80	80	1.0000000
NODE_21389_length_637_cov_4.131970	292	370	0	78	78	1.0000000
NODE_21389_length_637_cov_4.131970	343	423	0	80	80	1.0000000
NODE_21457_length_636_cov_19.938547	214	294	4	1	80	0.0125000
NODE_21457_length_636_cov_19.938547	214	294	5	20	80	0.2500000
NODE_21457_length_636_cov_19.938547	214	294	6	26	80	0.3250000
NODE_21457_length_636_cov_19.938547	214	294	7	22	80	0.2750000
NODE_21457_length_636_cov_19.938547	214	294	8	11	80	0.1375000
NODE_21457_length_636_cov_19.938547	267	347	3	8	80	0.1000000
NODE_21457_length_636_cov_19.938547	267	347	5	9	80	0.1125000
NODE_21457_length_636_cov_19.938547	267	347	6	62	80	0.7750000
NODE_21457_length_636_cov_19.938547	267	347	7	1	80	0.0125000
NODE_21458_length_636_cov_12.283054	295	375	1	80	80	1.0000000
NODE_21458_length_636_cov_12.283054	348	428	0	33	80	0.4125000
NODE_21458_length_636_cov_12.283054	348	428	1	47	80	0.5875000
NODE_21460_length_636_cov_8.312849	346	413	0	39	67	0.5820895
NODE_21460_length_636_cov_8.312849	346	413	1	28	67	0.4179105
NODE_21460_length_636_cov_8.312849	399	479	1	25	80	0.3125000
NODE_21460_length_636_cov_8.312849	399	479	2	55	80	0.6875000
NODE_21467_length_636_cov_4.324022	185	251	0	66	66	1.0000000
NODE_21467_length_636_cov_4.324022	224	266	0	42	42	1.0000000
NODE_21467_length_636_cov_4.324022	224	264	0	40	40	1.0000000
NODE_21539_length_635_cov_45.483209	195	239	5	12	44	0.2727273
NODE_21539_length_635_cov_45.483209	195	239	6	29	44	0.6590909
NODE_21539_length_635_cov_45.483209	195	239	7	2	44	0.0454545
NODE_21539_length_635_cov_45.483209	195	239	8	1	44	0.0227273
NODE_21539_length_635_cov_45.483209	225	268	6	13	43	0.3023256
NODE_21539_length_635_cov_45.483209	225	268	8	30	43	0.6976744
NODE_21539_length_635_cov_45.483209	248	298	4	16	50	0.3200000
NODE_21539_length_635_cov_45.483209	248	298	7	5	50	0.1000000
NODE_21539_length_635_cov_45.483209	248	298	8	29	50	0.5800000
NODE_21541_length_635_cov_23.895522	179	259	5	21	80	0.2625000
NODE_21541_length_635_cov_23.895522	179	259	6	11	80	0.1375000
NODE_21541_length_635_cov_23.895522	179	259	8	14	80	0.1750000
NODE_21541_length_635_cov_23.895522	179	259	9	34	80	0.4250000
NODE_21541_length_635_cov_23.895522	232	312	8	43	80	0.5375000
NODE_21541_length_635_cov_23.895522	232	312	9	18	80	0.2250000
NODE_21541_length_635_cov_23.895522	232	312	10	7	80	0.0875000
NODE_21541_length_635_cov_23.895522	232	312	11	12	80	0.1500000
NODE_21543_length_635_cov_14.772388	48	128	0	20	80	0.2500000
NODE_21543_length_635_cov_14.772388	48	128	2	16	80	0.2000000
NODE_21543_length_635_cov_14.772388	48	128	3	1	80	0.0125000
NODE_21543_length_635_cov_14.772388	48	128	4	43	80	0.5375000
NODE_21543_length_635_cov_14.772388	101	181	4	80	80	1.0000000
NODE_21549_length_635_cov_6.180970	276	356	0	80	80	1.0000000
NODE_21549_length_635_cov_6.180970	329	409	0	33	80	0.4125000
NODE_21549_length_635_cov_6.180970	329	409	1	47	80	0.5875000
NODE_21554_length_635_cov_4.421642	442	522	0	80	80	1.0000000
NODE_21560_length_635_cov_2.985075	296	376	3	1	80	0.0125000
NODE_21560_length_635_cov_2.985075	296	376	6	3	80	0.0375000
NODE_21560_length_635_cov_2.985075	296	376	7	65	80	0.8125000
NODE_21560_length_635_cov_2.985075	296	376	10	11	80	0.1375000
NODE_21625_length_634_cov_53.315888	349	429	12	6	80	0.0750000
NODE_21625_length_634_cov_53.315888	349	429	14	13	80	0.1625000
NODE_21625_length_634_cov_53.315888	349	429	15	13	80	0.1625000
NODE_21625_length_634_cov_53.315888	349	429	16	13	80	0.1625000
NODE_21625_length_634_cov_53.315888	349	429	17	14	80	0.1750000
NODE_21625_length_634_cov_53.315888	349	429	18	7	80	0.0875000
NODE_21625_length_634_cov_53.315888	349	429	19	14	80	0.1750000
NODE_21625_length_634_cov_53.315888	402	482	12	32	80	0.4000000
NODE_21625_length_634_cov_53.315888	402	482	14	9	80	0.1125000
NODE_21625_length_634_cov_53.315888	402	482	15	25	80	0.3125000
NODE_21625_length_634_cov_53.315888	402	482	16	10	80	0.1250000
NODE_21625_length_634_cov_53.315888	402	482	18	4	80	0.0500000
NODE_21626_length_634_cov_28.530841	156	236	12	5	80	0.0625000
NODE_21626_length_634_cov_28.530841	156	236	14	24	80	0.3000000
NODE_21626_length_634_cov_28.530841	156	236	15	5	80	0.0625000
NODE_21626_length_634_cov_28.530841	156	236	18	26	80	0.3250000
NODE_21626_length_634_cov_28.530841	156	236	20	20	80	0.2500000
NODE_21626_length_634_cov_28.530841	209	289	10	13	80	0.1625000
NODE_21626_length_634_cov_28.530841	209	289	11	4	80	0.0500000
NODE_21626_length_634_cov_28.530841	209	289	14	5	80	0.0625000
NODE_21626_length_634_cov_28.530841	209	289	16	1	80	0.0125000
NODE_21626_length_634_cov_28.530841	209	289	18	9	80	0.1125000
NODE_21626_length_634_cov_28.530841	209	289	20	48	80	0.6000000
NODE_21627_length_634_cov_19.117757	151	229	0	78	78	1.0000000
NODE_21627_length_634_cov_19.117757	204	268	0	64	64	1.0000000
NODE_21628_length_634_cov_18.762617	84	164	4	6	80	0.0750000
NODE_21628_length_634_cov_18.762617	84	164	6	3	80	0.0375000
NODE_21628_length_634_cov_18.762617	84	164	7	10	80	0.1250000
NODE_21628_length_634_cov_18.762617	84	164	8	61	80	0.7625000
NODE_21628_length_634_cov_18.762617	137	217	4	5	80	0.0625000
NODE_21628_length_634_cov_18.762617	137	217	5	24	80	0.3000000
NODE_21628_length_634_cov_18.762617	137	217	8	51	80	0.6375000
NODE_21629_length_634_cov_18.136449	162	242	5	1	80	0.0125000
NODE_21629_length_634_cov_18.136449	162	242	6	35	80	0.4375000
NODE_21629_length_634_cov_18.136449	162	242	8	44	80	0.5500000
NODE_21629_length_634_cov_18.136449	215	295	5	34	80	0.4250000
NODE_21629_length_634_cov_18.136449	215	295	6	9	80	0.1125000
NODE_21629_length_634_cov_18.136449	215	295	7	17	80	0.2125000
NODE_21629_length_634_cov_18.136449	215	295	8	20	80	0.2500000
NODE_21635_length_634_cov_9.988785	508	553	0	45	45	1.0000000
NODE_21636_length_634_cov_9.381308	267	353	0	86	86	1.0000000
NODE_21636_length_634_cov_9.381308	324	404	0	80	80	1.0000000
NODE_21651_length_634_cov_3.702804	460	532	0	72	72	1.0000000
NODE_21720_length_633_cov_30.076779	180	214	0	34	34	1.0000000
NODE_21720_length_633_cov_30.076779	187	267	0	80	80	1.0000000
NODE_21720_length_633_cov_30.076779	263	343	0	7	80	0.0875000
NODE_21720_length_633_cov_30.076779	263	343	6	73	80	0.9125000
NODE_21720_length_633_cov_30.076779	316	396	1	11	80	0.1375000
NODE_21720_length_633_cov_30.076779	316	396	2	3	80	0.0375000
NODE_21720_length_633_cov_30.076779	316	396	4	1	80	0.0125000
NODE_21720_length_633_cov_30.076779	316	396	5	2	80	0.0250000
NODE_21720_length_633_cov_30.076779	316	396	6	63	80	0.7875000
NODE_21721_length_633_cov_17.595506	282	362	0	80	80	1.0000000
NODE_21721_length_633_cov_17.595506	335	415	0	80	80	1.0000000
NODE_21722_length_633_cov_17.327715	228	308	0	9	80	0.1125000
NODE_21722_length_633_cov_17.327715	228	308	1	18	80	0.2250000
NODE_21722_length_633_cov_17.327715	228	308	2	53	80	0.6625000
NODE_21722_length_633_cov_17.327715	281	361	2	80	80	1.0000000
NODE_21723_length_633_cov_9.689139	79	147	0	68	68	1.0000000
NODE_21729_length_633_cov_7.018727	309	389	2	80	80	1.0000000
NODE_21729_length_633_cov_7.018727	362	442	0	8	80	0.1000000
NODE_21729_length_633_cov_7.018727	362	442	2	72	80	0.9000000
NODE_21755_length_633_cov_2.644195	166	240	0	74	74	1.0000000
NODE_21816_length_632_cov_25.425891	332	412	3	13	80	0.1625000
NODE_21816_length_632_cov_25.425891	332	412	5	1	80	0.0125000
NODE_21816_length_632_cov_25.425891	332	412	6	11	80	0.1375000
NODE_21816_length_632_cov_25.425891	332	412	8	46	80	0.5750000
NODE_21816_length_632_cov_25.425891	332	412	9	6	80	0.0750000
NODE_21816_length_632_cov_25.425891	332	412	10	3	80	0.0375000
NODE_21816_length_632_cov_25.425891	385	465	1	23	80	0.2875000
NODE_21816_length_632_cov_25.425891	385	465	3	43	80	0.5375000
NODE_21816_length_632_cov_25.425891	385	465	5	1	80	0.0125000
NODE_21816_length_632_cov_25.425891	385	465	6	11	80	0.1375000
NODE_21816_length_632_cov_25.425891	385	465	8	2	80	0.0250000
NODE_21817_length_632_cov_21.613508	243	323	6	68	80	0.8500000
NODE_21817_length_632_cov_21.613508	243	323	7	12	80	0.1500000
NODE_21817_length_632_cov_21.613508	296	376	1	38	80	0.4750000
NODE_21817_length_632_cov_21.613508	296	376	6	15	80	0.1875000
NODE_21817_length_632_cov_21.613508	296	376	7	27	80	0.3375000
NODE_21818_length_632_cov_16.465291	293	373	0	80	80	1.0000000
NODE_21818_length_632_cov_16.465291	346	426	0	80	80	1.0000000
NODE_21819_length_632_cov_13.260788	232	312	5	4	80	0.0500000
NODE_21819_length_632_cov_13.260788	232	312	6	42	80	0.5250000
NODE_21819_length_632_cov_13.260788	232	312	7	34	80	0.4250000
NODE_21819_length_632_cov_13.260788	285	365	3	15	80	0.1875000
NODE_21819_length_632_cov_13.260788	285	365	4	22	80	0.2750000
NODE_21819_length_632_cov_13.260788	285	365	5	5	80	0.0625000
NODE_21819_length_632_cov_13.260788	285	365	6	18	80	0.2250000
NODE_21819_length_632_cov_13.260788	285	365	7	20	80	0.2500000
NODE_21821_length_632_cov_9.106942	188	268	0	80	80	1.0000000
NODE_21821_length_632_cov_9.106942	241	321	0	80	80	1.0000000
NODE_21834_length_632_cov_4.135084	229	309	3	76	80	0.9500000
NODE_21834_length_632_cov_4.135084	229	309	5	4	80	0.0500000
NODE_21834_length_632_cov_4.135084	282	359	3	23	77	0.2987013
NODE_21834_length_632_cov_4.135084	282	359	5	54	77	0.7012987
NODE_21841_length_632_cov_2.939962	216	274	0	58	58	1.0000000
NODE_21841_length_632_cov_2.939962	247	327	0	80	80	1.0000000
NODE_21848_length_632_cov_2.330206	57	76	0	19	19	1.0000000
NODE_21912_length_631_cov_31.469925	321	396	15	21	75	0.2800000
NODE_21912_length_631_cov_31.469925	321	396	16	6	75	0.0800000
NODE_21912_length_631_cov_31.469925	321	396	17	24	75	0.3200000
NODE_21912_length_631_cov_31.469925	321	396	18	2	75	0.0266667
NODE_21912_length_631_cov_31.469925	321	396	19	22	75	0.2933333
NODE_21912_length_631_cov_31.469925	369	449	9	3	80	0.0375000
NODE_21912_length_631_cov_31.469925	369	449	10	1	80	0.0125000
NODE_21912_length_631_cov_31.469925	369	449	11	11	80	0.1375000
NODE_21912_length_631_cov_31.469925	369	449	13	30	80	0.3750000
NODE_21912_length_631_cov_31.469925	369	449	14	8	80	0.1000000
NODE_21912_length_631_cov_31.469925	369	449	15	21	80	0.2625000
NODE_21912_length_631_cov_31.469925	369	449	17	3	80	0.0375000
NODE_21912_length_631_cov_31.469925	369	449	19	3	80	0.0375000
NODE_21913_length_631_cov_26.453008	383	463	0	80	80	1.0000000
NODE_21913_length_631_cov_26.453008	436	516	0	80	80	1.0000000
NODE_21917_length_631_cov_8.374060	318	398	3	3	80	0.0375000
NODE_21917_length_631_cov_8.374060	318	398	4	77	80	0.9625000
NODE_21917_length_631_cov_8.374060	371	451	1	33	80	0.4125000
NODE_21917_length_631_cov_8.374060	371	451	3	23	80	0.2875000
NODE_21917_length_631_cov_8.374060	371	451	4	24	80	0.3000000
NODE_21924_length_631_cov_5.507519	335	386	0	51	51	1.0000000
NODE_21927_length_631_cov_5.227444	443	523	1	15	80	0.1875000
NODE_21927_length_631_cov_5.227444	443	523	2	65	80	0.8125000
NODE_21927_length_631_cov_5.227444	496	576	2	80	80	1.0000000
NODE_21942_length_631_cov_2.926692	307	354	0	47	47	1.0000000
NODE_21983_length_631_cov_1.383459	248	267	0	19	19	1.0000000
NODE_22011_length_630_cov_41.728814	6	86	7	14	80	0.1750000
NODE_22011_length_630_cov_41.728814	6	86	11	1	80	0.0125000
NODE_22011_length_630_cov_41.728814	6	86	12	4	80	0.0500000
NODE_22011_length_630_cov_41.728814	6	86	13	13	80	0.1625000
NODE_22011_length_630_cov_41.728814	6	86	14	3	80	0.0375000
NODE_22011_length_630_cov_41.728814	6	86	17	27	80	0.3375000
NODE_22011_length_630_cov_41.728814	6	86	18	14	80	0.1750000
NODE_22011_length_630_cov_41.728814	6	86	19	2	80	0.0250000
NODE_22011_length_630_cov_41.728814	6	86	20	1	80	0.0125000
NODE_22011_length_630_cov_41.728814	6	86	21	1	80	0.0125000
NODE_22011_length_630_cov_41.728814	59	139	17	9	80	0.1125000
NODE_22011_length_630_cov_41.728814	59	139	18	14	80	0.1750000
NODE_22011_length_630_cov_41.728814	59	139	19	5	80	0.0625000
NODE_22011_length_630_cov_41.728814	59	139	20	1	80	0.0125000
NODE_22011_length_630_cov_41.728814	59	139	21	12	80	0.1500000
NODE_22011_length_630_cov_41.728814	59	139	22	33	80	0.4125000
NODE_22011_length_630_cov_41.728814	59	139	23	6	80	0.0750000
NODE_22012_length_630_cov_24.856874	421	501	6	4	80	0.0500000
NODE_22012_length_630_cov_24.856874	421	501	8	3	80	0.0375000
NODE_22012_length_630_cov_24.856874	421	501	9	6	80	0.0750000
NODE_22012_length_630_cov_24.856874	421	501	10	17	80	0.2125000
NODE_22012_length_630_cov_24.856874	421	501	11	15	80	0.1875000
NODE_22012_length_630_cov_24.856874	421	501	12	9	80	0.1125000
NODE_22012_length_630_cov_24.856874	421	501	13	17	80	0.2125000
NODE_22012_length_630_cov_24.856874	421	501	14	9	80	0.1125000
NODE_22012_length_630_cov_24.856874	474	554	6	10	80	0.1250000
NODE_22012_length_630_cov_24.856874	474	554	8	46	80	0.5750000
NODE_22012_length_630_cov_24.856874	474	554	9	6	80	0.0750000
NODE_22012_length_630_cov_24.856874	474	554	13	17	80	0.2125000
NODE_22012_length_630_cov_24.856874	474	554	14	1	80	0.0125000
NODE_22013_length_630_cov_14.323917	196	276	5	14	80	0.1750000
NODE_22013_length_630_cov_14.323917	196	276	6	9	80	0.1125000
NODE_22013_length_630_cov_14.323917	196	276	7	15	80	0.1875000
NODE_22013_length_630_cov_14.323917	196	276	9	26	80	0.3250000
NODE_22013_length_630_cov_14.323917	196	276	10	16	80	0.2000000
NODE_22013_length_630_cov_14.323917	249	329	7	1	80	0.0125000
NODE_22013_length_630_cov_14.323917	249	329	8	2	80	0.0250000
NODE_22013_length_630_cov_14.323917	249	329	9	22	80	0.2750000
NODE_22013_length_630_cov_14.323917	249	329	10	55	80	0.6875000
NODE_22014_length_630_cov_9.964218	284	364	0	80	80	1.0000000
NODE_22014_length_630_cov_9.964218	337	417	0	80	80	1.0000000
NODE_22086_length_629_cov_38.271698	288	368	8	8	80	0.1000000
NODE_22086_length_629_cov_38.271698	288	368	9	72	80	0.9000000
NODE_22086_length_629_cov_38.271698	341	421	5	20	80	0.2500000
NODE_22086_length_629_cov_38.271698	341	421	6	6	80	0.0750000
NODE_22086_length_629_cov_38.271698	341	421	7	9	80	0.1125000
NODE_22086_length_629_cov_38.271698	341	421	8	8	80	0.1000000
NODE_22086_length_629_cov_38.271698	341	421	9	37	80	0.4625000
NODE_22087_length_629_cov_27.556604	212	292	8	8	80	0.1000000
NODE_22087_length_629_cov_27.556604	212	292	9	15	80	0.1875000
NODE_22087_length_629_cov_27.556604	212	292	10	20	80	0.2500000
NODE_22087_length_629_cov_27.556604	212	292	11	11	80	0.1375000
NODE_22087_length_629_cov_27.556604	212	292	12	6	80	0.0750000
NODE_22087_length_629_cov_27.556604	212	292	13	1	80	0.0125000
NODE_22087_length_629_cov_27.556604	212	292	14	19	80	0.2375000
NODE_22087_length_629_cov_27.556604	265	345	7	1	80	0.0125000
NODE_22087_length_629_cov_27.556604	265	345	10	9	80	0.1125000
NODE_22087_length_629_cov_27.556604	265	345	11	5	80	0.0625000
NODE_22087_length_629_cov_27.556604	265	345	12	6	80	0.0750000
NODE_22087_length_629_cov_27.556604	265	345	13	4	80	0.0500000
NODE_22087_length_629_cov_27.556604	265	345	14	55	80	0.6875000
NODE_22088_length_629_cov_24.150943	356	436	9	64	80	0.8000000
NODE_22088_length_629_cov_24.150943	356	436	10	15	80	0.1875000
NODE_22088_length_629_cov_24.150943	356	436	11	1	80	0.0125000
NODE_22088_length_629_cov_24.150943	409	489	5	9	80	0.1125000
NODE_22088_length_629_cov_24.150943	409	489	7	13	80	0.1625000
NODE_22088_length_629_cov_24.150943	409	489	9	18	80	0.2250000
NODE_22088_length_629_cov_24.150943	409	489	10	40	80	0.5000000
NODE_22091_length_629_cov_13.641509	176	256	11	20	80	0.2500000
NODE_22091_length_629_cov_13.641509	176	256	12	3	80	0.0375000
NODE_22091_length_629_cov_13.641509	176	256	13	29	80	0.3625000
NODE_22091_length_629_cov_13.641509	176	256	16	24	80	0.3000000
NODE_22091_length_629_cov_13.641509	176	256	18	4	80	0.0500000
NODE_22091_length_629_cov_13.641509	229	309	15	18	80	0.2250000
NODE_22091_length_629_cov_13.641509	229	309	16	26	80	0.3250000
NODE_22091_length_629_cov_13.641509	229	309	17	5	80	0.0625000
NODE_22091_length_629_cov_13.641509	229	309	18	25	80	0.3125000
NODE_22091_length_629_cov_13.641509	229	309	20	6	80	0.0750000
NODE_22101_length_629_cov_4.264151	362	442	5	19	80	0.2375000
NODE_22101_length_629_cov_4.264151	362	442	7	61	80	0.7625000
NODE_22188_length_628_cov_5.015123	210	274	6	13	64	0.2031250
NODE_22188_length_628_cov_5.015123	210	274	7	4	64	0.0625000
NODE_22188_length_628_cov_5.015123	210	274	8	47	64	0.7343750
NODE_22257_length_627_cov_24.500000	217	297	12	1	80	0.0125000
NODE_22257_length_627_cov_24.500000	217	297	13	18	80	0.2250000
NODE_22257_length_627_cov_24.500000	217	297	14	8	80	0.1000000
NODE_22257_length_627_cov_24.500000	217	297	15	13	80	0.1625000
NODE_22257_length_627_cov_24.500000	217	297	16	4	80	0.0500000
NODE_22257_length_627_cov_24.500000	217	297	17	9	80	0.1125000
NODE_22257_length_627_cov_24.500000	217	297	18	27	80	0.3375000
NODE_22257_length_627_cov_24.500000	270	350	10	14	80	0.1750000
NODE_22257_length_627_cov_24.500000	270	350	11	16	80	0.2000000
NODE_22257_length_627_cov_24.500000	270	350	12	2	80	0.0250000
NODE_22257_length_627_cov_24.500000	270	350	13	12	80	0.1500000
NODE_22257_length_627_cov_24.500000	270	350	14	18	80	0.2250000
NODE_22257_length_627_cov_24.500000	270	350	15	3	80	0.0375000
NODE_22257_length_627_cov_24.500000	270	350	16	4	80	0.0500000
NODE_22257_length_627_cov_24.500000	270	350	18	11	80	0.1375000
NODE_22258_length_627_cov_20.395833	84	164	3	28	80	0.3500000
NODE_22258_length_627_cov_20.395833	84	164	4	9	80	0.1125000
NODE_22258_length_627_cov_20.395833	84	164	5	5	80	0.0625000
NODE_22258_length_627_cov_20.395833	84	164	7	38	80	0.4750000
NODE_22258_length_627_cov_20.395833	137	217	5	30	80	0.3750000
NODE_22258_length_627_cov_20.395833	137	217	6	2	80	0.0250000
NODE_22258_length_627_cov_20.395833	137	217	7	48	80	0.6000000
NODE_22259_length_627_cov_19.676136	308	388	8	5	80	0.0625000
NODE_22259_length_627_cov_19.676136	308	388	9	19	80	0.2375000
NODE_22259_length_627_cov_19.676136	308	388	10	3	80	0.0375000
NODE_22259_length_627_cov_19.676136	308	388	11	17	80	0.2125000
NODE_22259_length_627_cov_19.676136	308	388	13	36	80	0.4500000
NODE_22259_length_627_cov_19.676136	361	441	6	8	80	0.1000000
NODE_22259_length_627_cov_19.676136	361	441	7	5	80	0.0625000
NODE_22259_length_627_cov_19.676136	361	441	8	10	80	0.1250000
NODE_22259_length_627_cov_19.676136	361	441	9	3	80	0.0375000
NODE_22259_length_627_cov_19.676136	361	441	10	5	80	0.0625000
NODE_22259_length_627_cov_19.676136	361	441	11	4	80	0.0500000
NODE_22259_length_627_cov_19.676136	361	441	13	45	80	0.5625000
NODE_22260_length_627_cov_17.634470	264	296	0	13	32	0.4062500
NODE_22260_length_627_cov_17.634470	264	296	3	2	32	0.0625000
NODE_22260_length_627_cov_17.634470	264	296	5	1	32	0.0312500
NODE_22260_length_627_cov_17.634470	264	296	10	1	32	0.0312500
NODE_22260_length_627_cov_17.634470	264	296	11	2	32	0.0625000
NODE_22260_length_627_cov_17.634470	264	296	12	13	32	0.4062500
NODE_22260_length_627_cov_17.634470	360	385	0	25	25	1.0000000
NODE_22260_length_627_cov_17.634470	365	385	0	20	20	1.0000000
NODE_22260_length_627_cov_17.634470	385	424	0	39	39	1.0000000
NODE_22267_length_627_cov_5.634470	298	346	0	48	48	1.0000000
NODE_22274_length_627_cov_4.517045	323	403	0	8	80	0.1000000
NODE_22274_length_627_cov_4.517045	323	403	3	49	80	0.6125000
NODE_22274_length_627_cov_4.517045	323	403	5	12	80	0.1500000
NODE_22274_length_627_cov_4.517045	323	403	6	11	80	0.1375000
NODE_22274_length_627_cov_4.517045	376	456	0	61	80	0.7625000
NODE_22274_length_627_cov_4.517045	376	456	3	19	80	0.2375000
NODE_22357_length_626_cov_24.184061	140	220	7	36	80	0.4500000
NODE_22357_length_626_cov_24.184061	140	220	9	20	80	0.2500000
NODE_22357_length_626_cov_24.184061	140	220	10	7	80	0.0875000
NODE_22357_length_626_cov_24.184061	140	220	11	13	80	0.1625000
NODE_22357_length_626_cov_24.184061	140	220	13	4	80	0.0500000
NODE_22357_length_626_cov_24.184061	193	273	9	16	80	0.2000000
NODE_22357_length_626_cov_24.184061	193	273	10	10	80	0.1250000
NODE_22357_length_626_cov_24.184061	193	273	11	13	80	0.1625000
NODE_22357_length_626_cov_24.184061	193	273	12	1	80	0.0125000
NODE_22357_length_626_cov_24.184061	193	273	13	39	80	0.4875000
NODE_22357_length_626_cov_24.184061	193	273	14	1	80	0.0125000
NODE_22358_length_626_cov_21.189753	342	419	0	26	77	0.3376623
NODE_22358_length_626_cov_21.189753	342	419	2	21	77	0.2727273
NODE_22358_length_626_cov_21.189753	342	419	3	30	77	0.3896104
NODE_22358_length_626_cov_21.189753	342	419	0	26	77	0.3376623
NODE_22358_length_626_cov_21.189753	342	419	2	21	77	0.2727273
NODE_22358_length_626_cov_21.189753	342	419	3	30	77	0.3896104
NODE_22358_length_626_cov_21.189753	392	453	0	60	61	0.9836066
NODE_22358_length_626_cov_21.189753	392	453	2	1	61	0.0163934
NODE_22364_length_626_cov_7.100569	236	311	0	9	75	0.1200000
NODE_22364_length_626_cov_7.100569	236	311	1	51	75	0.6800000
NODE_22364_length_626_cov_7.100569	236	311	2	15	75	0.2000000
NODE_22364_length_626_cov_7.100569	284	364	0	62	80	0.7750000
NODE_22364_length_626_cov_7.100569	284	364	1	18	80	0.2250000
NODE_22366_length_626_cov_6.296015	193	273	6	23	80	0.2875000
NODE_22366_length_626_cov_6.296015	193	273	7	4	80	0.0500000
NODE_22366_length_626_cov_6.296015	193	273	8	28	80	0.3500000
NODE_22366_length_626_cov_6.296015	193	273	11	25	80	0.3125000
NODE_22366_length_626_cov_6.296015	246	326	6	20	80	0.2500000
NODE_22366_length_626_cov_6.296015	246	326	8	5	80	0.0625000
NODE_22366_length_626_cov_6.296015	246	326	11	55	80	0.6875000
NODE_22367_length_626_cov_6.163188	257	337	1	6	80	0.0750000
NODE_22367_length_626_cov_6.163188	257	337	2	74	80	0.9250000
NODE_22367_length_626_cov_6.163188	310	390	2	80	80	1.0000000
NODE_22438_length_625_cov_33.100760	239	319	0	80	80	1.0000000
NODE_22438_length_625_cov_33.100760	292	372	0	67	80	0.8375000
NODE_22438_length_625_cov_33.100760	292	372	2	13	80	0.1625000
NODE_22438_length_625_cov_33.100760	368	448	2	63	80	0.7875000
NODE_22438_length_625_cov_33.100760	368	448	4	17	80	0.2125000
NODE_22438_length_625_cov_33.100760	421	501	2	10	80	0.1250000
NODE_22438_length_625_cov_33.100760	421	501	4	70	80	0.8750000
NODE_22439_length_625_cov_21.062738	267	347	4	9	80	0.1125000
NODE_22439_length_625_cov_21.062738	267	347	5	2	80	0.0250000
NODE_22439_length_625_cov_21.062738	267	347	7	65	80	0.8125000
NODE_22439_length_625_cov_21.062738	267	347	8	4	80	0.0500000
NODE_22439_length_625_cov_21.062738	320	400	4	27	80	0.3375000
NODE_22439_length_625_cov_21.062738	320	400	6	7	80	0.0875000
NODE_22439_length_625_cov_21.062738	320	400	7	23	80	0.2875000
NODE_22439_length_625_cov_21.062738	320	400	8	23	80	0.2875000
NODE_22440_length_625_cov_14.237643	28	108	2	3	80	0.0375000
NODE_22440_length_625_cov_14.237643	28	108	5	77	80	0.9625000
NODE_22440_length_625_cov_14.237643	81	161	5	46	80	0.5750000
NODE_22440_length_625_cov_14.237643	81	161	7	22	80	0.2750000
NODE_22440_length_625_cov_14.237643	81	161	10	12	80	0.1500000
NODE_22441_length_625_cov_14.207224	358	438	2	25	80	0.3125000
NODE_22441_length_625_cov_14.207224	358	438	5	14	80	0.1750000
NODE_22441_length_625_cov_14.207224	358	438	6	28	80	0.3500000
NODE_22441_length_625_cov_14.207224	358	438	7	13	80	0.1625000
NODE_22441_length_625_cov_14.207224	411	491	5	67	80	0.8375000
NODE_22441_length_625_cov_14.207224	411	491	6	13	80	0.1625000
NODE_22455_length_625_cov_4.157795	548	600	0	52	52	1.0000000
NODE_22466_length_625_cov_2.929658	118	198	4	71	80	0.8875000
NODE_22466_length_625_cov_2.929658	118	198	8	9	80	0.1125000
NODE_22466_length_625_cov_2.929658	171	251	4	80	80	1.0000000
NODE_22491_length_625_cov_1.570342	471	502	0	31	31	1.0000000
NODE_22542_length_624_cov_9.598095	77	126	0	49	49	1.0000000
NODE_22542_length_624_cov_9.598095	103	183	0	80	80	1.0000000
NODE_22544_length_624_cov_8.485714	271	351	1	2	80	0.0250000
NODE_22544_length_624_cov_8.485714	271	351	2	70	80	0.8750000
NODE_22544_length_624_cov_8.485714	271	351	3	8	80	0.1000000
NODE_22544_length_624_cov_8.485714	324	404	2	72	80	0.9000000
NODE_22544_length_624_cov_8.485714	324	404	3	8	80	0.1000000
NODE_22546_length_624_cov_6.691429	386	466	0	12	80	0.1500000
NODE_22546_length_624_cov_6.691429	386	466	1	68	80	0.8500000
NODE_22546_length_624_cov_6.691429	439	519	1	56	80	0.7000000
NODE_22546_length_624_cov_6.691429	439	519	2	24	80	0.3000000
NODE_22547_length_624_cov_5.592381	312	387	0	75	75	1.0000000
NODE_22551_length_624_cov_4.638095	328	388	0	60	60	1.0000000
NODE_22642_length_623_cov_41.877863	419	499	10	22	80	0.2750000
NODE_22642_length_623_cov_41.877863	419	499	11	20	80	0.2500000
NODE_22642_length_623_cov_41.877863	419	499	13	38	80	0.4750000
NODE_22642_length_623_cov_41.877863	472	552	0	2	80	0.0250000
NODE_22642_length_623_cov_41.877863	472	552	2	5	80	0.0625000
NODE_22642_length_623_cov_41.877863	472	552	4	2	80	0.0250000
NODE_22642_length_623_cov_41.877863	472	552	5	14	80	0.1750000
NODE_22642_length_623_cov_41.877863	472	552	6	15	80	0.1875000
NODE_22642_length_623_cov_41.877863	472	552	8	13	80	0.1625000
NODE_22642_length_623_cov_41.877863	472	552	10	24	80	0.3000000
NODE_22642_length_623_cov_41.877863	472	552	13	5	80	0.0625000
NODE_22643_length_623_cov_31.875954	148	228	8	4	80	0.0500000
NODE_22643_length_623_cov_31.875954	148	228	9	13	80	0.1625000
NODE_22643_length_623_cov_31.875954	148	228	10	11	80	0.1375000
NODE_22643_length_623_cov_31.875954	148	228	12	27	80	0.3375000
NODE_22643_length_623_cov_31.875954	148	228	13	13	80	0.1625000
NODE_22643_length_623_cov_31.875954	148	228	14	12	80	0.1500000
NODE_22643_length_623_cov_31.875954	201	281	7	1	80	0.0125000
NODE_22643_length_623_cov_31.875954	201	281	8	5	80	0.0625000
NODE_22643_length_623_cov_31.875954	201	281	9	3	80	0.0375000
NODE_22643_length_623_cov_31.875954	201	281	10	6	80	0.0750000
NODE_22643_length_623_cov_31.875954	201	281	11	17	80	0.2125000
NODE_22643_length_623_cov_31.875954	201	281	12	2	80	0.0250000
NODE_22643_length_623_cov_31.875954	201	281	13	26	80	0.3250000
NODE_22643_length_623_cov_31.875954	201	281	14	20	80	0.2500000
NODE_22644_length_623_cov_31.192748	313	393	6	2	80	0.0250000
NODE_22644_length_623_cov_31.192748	313	393	7	3	80	0.0375000
NODE_22644_length_623_cov_31.192748	313	393	13	18	80	0.2250000
NODE_22644_length_623_cov_31.192748	313	393	14	14	80	0.1750000
NODE_22644_length_623_cov_31.192748	313	393	15	43	80	0.5375000
NODE_22644_length_623_cov_31.192748	366	446	1	9	80	0.1125000
NODE_22644_length_623_cov_31.192748	366	446	2	9	80	0.1125000
NODE_22644_length_623_cov_31.192748	366	446	5	17	80	0.2125000
NODE_22644_length_623_cov_31.192748	366	446	6	20	80	0.2500000
NODE_22644_length_623_cov_31.192748	366	446	7	3	80	0.0375000
NODE_22644_length_623_cov_31.192748	366	446	13	18	80	0.2250000
NODE_22644_length_623_cov_31.192748	366	446	14	4	80	0.0500000
NODE_22645_length_623_cov_20.187023	287	367	7	21	80	0.2625000
NODE_22645_length_623_cov_20.187023	287	367	8	59	80	0.7375000
NODE_22645_length_623_cov_20.187023	340	420	0	9	80	0.1125000
NODE_22645_length_623_cov_20.187023	340	420	2	27	80	0.3375000
NODE_22645_length_623_cov_20.187023	340	420	4	6	80	0.0750000
NODE_22645_length_623_cov_20.187023	340	420	7	32	80	0.4000000
NODE_22645_length_623_cov_20.187023	340	420	8	6	80	0.0750000
NODE_22646_length_623_cov_12.045802	377	457	0	20	80	0.2500000
NODE_22646_length_623_cov_12.045802	377	457	2	43	80	0.5375000
NODE_22646_length_623_cov_12.045802	377	457	4	17	80	0.2125000
NODE_22646_length_623_cov_12.045802	430	510	0	73	80	0.9125000
NODE_22646_length_623_cov_12.045802	430	510	2	7	80	0.0875000
NODE_22668_length_623_cov_2.891221	457	535	0	78	78	1.0000000
NODE_22725_length_622_cov_19.042065	368	448	10	5	80	0.0625000
NODE_22725_length_622_cov_19.042065	368	448	11	15	80	0.1875000
NODE_22725_length_622_cov_19.042065	368	448	12	4	80	0.0500000
NODE_22725_length_622_cov_19.042065	368	448	13	29	80	0.3625000
NODE_22725_length_622_cov_19.042065	368	448	15	27	80	0.3375000
NODE_22725_length_622_cov_19.042065	421	501	8	4	80	0.0500000
NODE_22725_length_622_cov_19.042065	421	501	11	28	80	0.3500000
NODE_22725_length_622_cov_19.042065	421	501	12	9	80	0.1125000
NODE_22725_length_622_cov_19.042065	421	501	15	33	80	0.4125000
NODE_22725_length_622_cov_19.042065	421	501	16	5	80	0.0625000
NODE_22725_length_622_cov_19.042065	421	501	17	1	80	0.0125000
NODE_22726_length_622_cov_13.470363	109	189	5	5	80	0.0625000
NODE_22726_length_622_cov_13.470363	109	189	6	1	80	0.0125000
NODE_22726_length_622_cov_13.470363	109	189	7	19	80	0.2375000
NODE_22726_length_622_cov_13.470363	109	189	8	5	80	0.0625000
NODE_22726_length_622_cov_13.470363	109	189	9	24	80	0.3000000
NODE_22726_length_622_cov_13.470363	109	189	16	26	80	0.3250000
NODE_22726_length_622_cov_13.470363	162	242	9	1	80	0.0125000
NODE_22726_length_622_cov_13.470363	162	242	13	1	80	0.0125000
NODE_22726_length_622_cov_13.470363	162	242	15	15	80	0.1875000
NODE_22726_length_622_cov_13.470363	162	242	16	56	80	0.7000000
NODE_22726_length_622_cov_13.470363	162	242	17	7	80	0.0875000
NODE_22752_length_622_cov_2.407266	94	170	0	33	76	0.4342105
NODE_22752_length_622_cov_2.407266	94	170	1	10	76	0.1315790
NODE_22752_length_622_cov_2.407266	94	170	2	33	76	0.4342105
NODE_22796_length_622_cov_1.353728	346	376	0	30	30	1.0000000
NODE_22819_length_621_cov_46.247126	0	52	2	9	52	0.1730769
NODE_22819_length_621_cov_46.247126	0	52	4	43	52	0.8269231
NODE_22819_length_621_cov_46.247126	25	105	4	80	80	1.0000000
NODE_22819_length_621_cov_46.247126	101	181	0	22	80	0.2750000
NODE_22819_length_621_cov_46.247126	101	181	2	9	80	0.1125000
NODE_22819_length_621_cov_46.247126	101	181	3	37	80	0.4625000
NODE_22819_length_621_cov_46.247126	101	181	4	12	80	0.1500000
NODE_22819_length_621_cov_46.247126	154	234	0	75	80	0.9375000
NODE_22819_length_621_cov_46.247126	154	234	2	5	80	0.0625000
NODE_22820_length_621_cov_45.764368	344	424	8	10	80	0.1250000
NODE_22820_length_621_cov_45.764368	344	424	9	2	80	0.0250000
NODE_22820_length_621_cov_45.764368	344	424	10	23	80	0.2875000
NODE_22820_length_621_cov_45.764368	344	424	11	13	80	0.1625000
NODE_22820_length_621_cov_45.764368	344	424	12	14	80	0.1750000
NODE_22820_length_621_cov_45.764368	344	424	13	2	80	0.0250000
NODE_22820_length_621_cov_45.764368	344	424	14	7	80	0.0875000
NODE_22820_length_621_cov_45.764368	344	424	15	9	80	0.1125000
NODE_22820_length_621_cov_45.764368	397	477	10	2	80	0.0250000
NODE_22820_length_621_cov_45.764368	397	477	12	51	80	0.6375000
NODE_22820_length_621_cov_45.764368	397	477	13	12	80	0.1500000
NODE_22820_length_621_cov_45.764368	397	477	14	6	80	0.0750000
NODE_22820_length_621_cov_45.764368	397	477	15	9	80	0.1125000
NODE_22821_length_621_cov_35.147510	393	473	2	16	80	0.2000000
NODE_22821_length_621_cov_35.147510	393	473	3	64	80	0.8000000
NODE_22821_length_621_cov_35.147510	446	526	1	36	80	0.4500000
NODE_22821_length_621_cov_35.147510	446	526	2	28	80	0.3500000
NODE_22821_length_621_cov_35.147510	446	526	3	16	80	0.2000000
NODE_22822_length_621_cov_13.842912	231	311	6	26	80	0.3250000
NODE_22822_length_621_cov_13.842912	231	311	8	4	80	0.0500000
NODE_22822_length_621_cov_13.842912	231	311	10	50	80	0.6250000
NODE_22822_length_621_cov_13.842912	284	364	6	12	80	0.1500000
NODE_22822_length_621_cov_13.842912	284	364	7	1	80	0.0125000
NODE_22822_length_621_cov_13.842912	284	364	10	67	80	0.8375000
NODE_22825_length_621_cov_6.279693	376	406	0	30	30	1.0000000
NODE_22845_length_621_cov_2.645594	367	426	0	59	59	1.0000000
NODE_22914_length_620_cov_23.913628	433	513	5	4	80	0.0500000
NODE_22914_length_620_cov_23.913628	433	513	6	2	80	0.0250000
NODE_22914_length_620_cov_23.913628	433	513	7	6	80	0.0750000
NODE_22914_length_620_cov_23.913628	433	513	8	11	80	0.1375000
NODE_22914_length_620_cov_23.913628	433	513	9	49	80	0.6125000
NODE_22914_length_620_cov_23.913628	433	513	10	8	80	0.1000000
NODE_22914_length_620_cov_23.913628	486	566	7	2	80	0.0250000
NODE_22914_length_620_cov_23.913628	486	566	8	36	80	0.4500000
NODE_22914_length_620_cov_23.913628	486	566	9	42	80	0.5250000
NODE_22915_length_620_cov_9.222649	186	266	1	50	80	0.6250000
NODE_22915_length_620_cov_9.222649	186	266	2	30	80	0.3750000
NODE_22915_length_620_cov_9.222649	239	319	0	52	80	0.6500000
NODE_22915_length_620_cov_9.222649	239	319	1	28	80	0.3500000
NODE_22919_length_620_cov_7.804223	57	137	0	80	80	1.0000000
NODE_22919_length_620_cov_7.804223	110	190	0	80	80	1.0000000
NODE_22920_length_620_cov_6.909789	199	279	0	6	80	0.0750000
NODE_22920_length_620_cov_6.909789	199	279	1	45	80	0.5625000
NODE_22920_length_620_cov_6.909789	199	279	2	29	80	0.3625000
NODE_22920_length_620_cov_6.909789	252	332	2	80	80	1.0000000
NODE_22930_length_620_cov_4.560461	309	347	5	38	38	1.0000000
NODE_22930_length_620_cov_4.560461	395	421	1	11	26	0.4230769
NODE_22930_length_620_cov_4.560461	395	421	2	9	26	0.3461539
NODE_22930_length_620_cov_4.560461	395	421	3	6	26	0.2307692
NODE_22930_length_620_cov_4.560461	395	451	1	13	56	0.2321429
NODE_22930_length_620_cov_4.560461	395	451	2	37	56	0.6607143
NODE_22930_length_620_cov_4.560461	395	451	3	6	56	0.1071429
NODE_23031_length_619_cov_26.309615	118	198	0	80	80	1.0000000
NODE_23031_length_619_cov_26.309615	171	251	0	80	80	1.0000000
NODE_23033_length_619_cov_10.417308	427	487	2	60	60	1.0000000
NODE_23034_length_619_cov_7.944231	213	293	4	19	80	0.2375000
NODE_23034_length_619_cov_7.944231	213	293	6	61	80	0.7625000
NODE_23034_length_619_cov_7.944231	266	346	0	16	80	0.2000000
NODE_23034_length_619_cov_7.944231	266	346	1	1	80	0.0125000
NODE_23034_length_619_cov_7.944231	266	346	2	10	80	0.1250000
NODE_23034_length_619_cov_7.944231	266	346	3	1	80	0.0125000
NODE_23034_length_619_cov_7.944231	266	346	4	44	80	0.5500000
NODE_23034_length_619_cov_7.944231	266	346	6	8	80	0.1000000
NODE_23135_length_618_cov_14.477842	223	299	1	14	76	0.1842105
NODE_23135_length_618_cov_14.477842	223	299	2	27	76	0.3552631
NODE_23135_length_618_cov_14.477842	223	299	6	35	76	0.4605263
NODE_23135_length_618_cov_14.477842	223	299	1	14	76	0.1842105
NODE_23135_length_618_cov_14.477842	223	299	2	27	76	0.3552631
NODE_23135_length_618_cov_14.477842	223	299	6	35	76	0.4605263
NODE_23135_length_618_cov_14.477842	276	337	6	61	61	1.0000000
NODE_23136_length_618_cov_13.840077	377	457	0	80	80	1.0000000
NODE_23136_length_618_cov_13.840077	430	510	0	80	80	1.0000000
NODE_23137_length_618_cov_12.048170	348	428	0	80	80	1.0000000
NODE_23137_length_618_cov_12.048170	401	481	0	80	80	1.0000000
NODE_23138_length_618_cov_8.799615	353	433	0	80	80	1.0000000
NODE_23138_length_618_cov_8.799615	406	486	0	80	80	1.0000000
NODE_23147_length_618_cov_3.793834	412	478	0	66	66	1.0000000
NODE_23148_length_618_cov_3.761079	305	385	2	80	80	1.0000000
NODE_23252_length_617_cov_29.565637	378	458	13	8	80	0.1000000
NODE_23252_length_617_cov_29.565637	378	458	14	41	80	0.5125000
NODE_23252_length_617_cov_29.565637	378	458	15	5	80	0.0625000
NODE_23252_length_617_cov_29.565637	378	458	16	26	80	0.3250000
NODE_23252_length_617_cov_29.565637	431	511	7	22	80	0.2750000
NODE_23252_length_617_cov_29.565637	431	511	8	9	80	0.1125000
NODE_23252_length_617_cov_29.565637	431	511	10	5	80	0.0625000
NODE_23252_length_617_cov_29.565637	431	511	12	16	80	0.2000000
NODE_23252_length_617_cov_29.565637	431	511	13	5	80	0.0625000
NODE_23252_length_617_cov_29.565637	431	511	14	17	80	0.2125000
NODE_23252_length_617_cov_29.565637	431	511	16	6	80	0.0750000
NODE_23253_length_617_cov_16.781853	253	333	0	80	80	1.0000000
NODE_23253_length_617_cov_16.781853	306	386	0	80	80	1.0000000
NODE_23254_length_617_cov_9.175676	373	453	1	70	80	0.8750000
NODE_23254_length_617_cov_9.175676	373	453	2	10	80	0.1250000
NODE_23254_length_617_cov_9.175676	426	506	1	80	80	1.0000000
NODE_23255_length_617_cov_8.774131	320	406	0	56	86	0.6511628
NODE_23255_length_617_cov_8.774131	320	406	1	30	86	0.3488372
NODE_23255_length_617_cov_8.774131	379	458	1	79	79	1.0000000
NODE_23257_length_617_cov_8.416988	359	439	1	19	80	0.2375000
NODE_23257_length_617_cov_8.416988	359	439	2	61	80	0.7625000
NODE_23257_length_617_cov_8.416988	412	492	1	6	80	0.0750000
NODE_23257_length_617_cov_8.416988	412	492	2	74	80	0.9250000
NODE_23259_length_617_cov_7.683398	197	275	0	78	78	1.0000000
NODE_23259_length_617_cov_7.683398	250	330	0	80	80	1.0000000
NODE_23263_length_617_cov_5.330116	288	360	0	72	72	1.0000000
NODE_23263_length_617_cov_5.330116	333	413	0	80	80	1.0000000
NODE_23302_length_617_cov_1.967181	384	430	0	46	46	1.0000000
NODE_23311_length_617_cov_1.847490	273	344	0	71	71	1.0000000
NODE_23331_length_617_cov_1.322394	269	318	0	49	49	1.0000000
NODE_23365_length_616_cov_15.914894	292	370	0	9	78	0.1153846
NODE_23365_length_616_cov_15.914894	292	370	1	33	78	0.4230769
NODE_23365_length_616_cov_15.914894	292	370	2	36	78	0.4615385
NODE_23365_length_616_cov_15.914894	343	423	0	62	80	0.7750000
NODE_23365_length_616_cov_15.914894	343	423	1	18	80	0.2250000
NODE_23366_length_616_cov_14.276596	191	271	0	80	80	1.0000000
NODE_23366_length_616_cov_14.276596	244	319	0	75	75	1.0000000
NODE_23366_length_616_cov_14.276596	368	448	1	13	80	0.1625000
NODE_23366_length_616_cov_14.276596	368	448	2	67	80	0.8375000
NODE_23367_length_616_cov_12.119923	273	353	1	42	80	0.5250000
NODE_23367_length_616_cov_12.119923	273	353	3	10	80	0.1250000
NODE_23367_length_616_cov_12.119923	273	353	4	28	80	0.3500000
NODE_23367_length_616_cov_12.119923	326	406	0	49	80	0.6125000
NODE_23367_length_616_cov_12.119923	326	406	1	31	80	0.3875000
NODE_23373_length_616_cov_6.379110	305	385	0	80	80	1.0000000
NODE_23373_length_616_cov_6.379110	358	438	0	80	80	1.0000000
NODE_23381_length_616_cov_4.441006	286	350	1	23	64	0.3593750
NODE_23381_length_616_cov_4.441006	286	350	3	41	64	0.6406250
NODE_23381_length_616_cov_4.441006	286	306	3	20	20	1.0000000
NODE_23400_length_616_cov_2.541586	375	415	1	40	40	1.0000000
NODE_23430_length_616_cov_1.491296	105	183	0	8	78	0.1025641
NODE_23430_length_616_cov_1.491296	105	183	2	70	78	0.8974359
NODE_23474_length_615_cov_27.519380	302	382	9	41	80	0.5125000
NODE_23474_length_615_cov_27.519380	302	382	10	27	80	0.3375000
NODE_23474_length_615_cov_27.519380	302	382	13	12	80	0.1500000
NODE_23474_length_615_cov_27.519380	355	435	6	2	80	0.0250000
NODE_23474_length_615_cov_27.519380	355	435	8	41	80	0.5125000
NODE_23474_length_615_cov_27.519380	355	435	9	37	80	0.4625000
NODE_23475_length_615_cov_17.792636	239	319	0	80	80	1.0000000
NODE_23475_length_615_cov_17.792636	292	372	0	80	80	1.0000000
NODE_23477_length_615_cov_11.835271	240	320	0	80	80	1.0000000
NODE_23477_length_615_cov_11.835271	293	373	0	80	80	1.0000000
NODE_23478_length_615_cov_8.591085	287	367	0	80	80	1.0000000
NODE_23478_length_615_cov_8.591085	340	420	0	80	80	1.0000000
NODE_23513_length_615_cov_2.461240	429	509	0	80	80	1.0000000
NODE_23513_length_615_cov_2.461240	482	562	0	80	80	1.0000000
NODE_23516_length_615_cov_2.379845	405	467	0	62	62	1.0000000
NODE_23516_length_615_cov_2.379845	440	520	0	80	80	1.0000000
NODE_23517_length_615_cov_2.294574	205	268	0	63	63	1.0000000
NODE_23554_length_615_cov_1.122093	255	335	0	80	80	1.0000000
NODE_23566_length_615_cov_0.887597	561	582	0	21	21	1.0000000
NODE_23575_length_614_cov_17.772816	257	337	4	80	80	1.0000000
NODE_23575_length_614_cov_17.772816	310	390	0	34	80	0.4250000
NODE_23575_length_614_cov_17.772816	310	390	4	46	80	0.5750000
NODE_23576_length_614_cov_10.706796	425	505	2	80	80	1.0000000
NODE_23576_length_614_cov_10.706796	478	558	0	37	80	0.4625000
NODE_23576_length_614_cov_10.706796	478	558	2	43	80	0.5375000
NODE_23578_length_614_cov_8.545631	193	273	1	80	80	1.0000000
NODE_23578_length_614_cov_8.545631	246	326	1	80	80	1.0000000
NODE_23604_length_614_cov_2.450485	315	393	0	78	78	1.0000000
NODE_23604_length_614_cov_2.450485	355	383	0	28	28	1.0000000
NODE_23604_length_614_cov_2.450485	368	448	0	80	80	1.0000000
NODE_23604_length_614_cov_2.450485	379	448	0	69	69	1.0000000
NODE_23662_length_613_cov_18.075875	211	291	6	5	80	0.0625000
NODE_23662_length_613_cov_18.075875	211	291	7	42	80	0.5250000
NODE_23662_length_613_cov_18.075875	211	291	10	25	80	0.3125000
NODE_23662_length_613_cov_18.075875	211	291	11	1	80	0.0125000
NODE_23662_length_613_cov_18.075875	211	291	12	7	80	0.0875000
NODE_23662_length_613_cov_18.075875	264	344	1	7	80	0.0875000
NODE_23662_length_613_cov_18.075875	264	344	4	27	80	0.3375000
NODE_23662_length_613_cov_18.075875	264	344	6	24	80	0.3000000
NODE_23662_length_613_cov_18.075875	264	344	7	22	80	0.2750000
NODE_23663_length_613_cov_16.118677	283	363	0	63	80	0.7875000
NODE_23663_length_613_cov_16.118677	283	363	2	1	80	0.0125000
NODE_23663_length_613_cov_16.118677	283	363	3	16	80	0.2000000
NODE_23663_length_613_cov_16.118677	336	416	0	10	80	0.1250000
NODE_23663_length_613_cov_16.118677	336	416	2	1	80	0.0125000
NODE_23663_length_613_cov_16.118677	336	416	3	69	80	0.8625000
NODE_23665_length_613_cov_12.883268	155	235	0	46	80	0.5750000
NODE_23665_length_613_cov_12.883268	155	235	1	34	80	0.4250000
NODE_23665_length_613_cov_12.883268	208	288	1	30	80	0.3750000
NODE_23665_length_613_cov_12.883268	208	288	2	50	80	0.6250000
NODE_23674_length_613_cov_3.857977	167	247	0	80	80	1.0000000
NODE_23674_length_613_cov_3.857977	220	300	0	80	80	1.0000000
NODE_23771_length_612_cov_24.023392	173	253	5	21	80	0.2625000
NODE_23771_length_612_cov_24.023392	173	253	6	59	80	0.7375000
NODE_23771_length_612_cov_24.023392	226	306	2	36	80	0.4500000
NODE_23771_length_612_cov_24.023392	226	306	3	9	80	0.1125000
NODE_23771_length_612_cov_24.023392	226	306	5	29	80	0.3625000
NODE_23771_length_612_cov_24.023392	226	306	6	6	80	0.0750000
NODE_23772_length_612_cov_23.846004	141	221	12	47	80	0.5875000
NODE_23772_length_612_cov_23.846004	141	221	13	33	80	0.4125000
NODE_23772_length_612_cov_23.846004	194	274	10	3	80	0.0375000
NODE_23772_length_612_cov_23.846004	194	274	11	1	80	0.0125000
NODE_23772_length_612_cov_23.846004	194	274	12	36	80	0.4500000
NODE_23772_length_612_cov_23.846004	194	274	13	23	80	0.2875000
NODE_23772_length_612_cov_23.846004	194	274	14	17	80	0.2125000
NODE_23773_length_612_cov_12.448343	244	324	1	12	80	0.1500000
NODE_23773_length_612_cov_12.448343	244	324	2	68	80	0.8500000
NODE_23773_length_612_cov_12.448343	297	377	1	65	80	0.8125000
NODE_23773_length_612_cov_12.448343	297	377	2	15	80	0.1875000
NODE_23774_length_612_cov_12.068226	267	347	1	17	80	0.2125000
NODE_23774_length_612_cov_12.068226	267	347	2	29	80	0.3625000
NODE_23774_length_612_cov_12.068226	267	347	3	34	80	0.4250000
NODE_23774_length_612_cov_12.068226	320	400	0	50	80	0.6250000
NODE_23774_length_612_cov_12.068226	320	400	1	20	80	0.2500000
NODE_23774_length_612_cov_12.068226	320	400	2	10	80	0.1250000
NODE_23779_length_612_cov_6.393762	242	322	0	80	80	1.0000000
NODE_23779_length_612_cov_6.393762	295	375	0	80	80	1.0000000
NODE_23814_length_612_cov_1.904483	288	354	0	66	66	1.0000000
NODE_23869_length_611_cov_38.705078	132	212	0	80	80	1.0000000
NODE_23869_length_611_cov_38.705078	185	262	0	77	77	1.0000000
NODE_23869_length_611_cov_38.705078	185	262	0	77	77	1.0000000
NODE_23871_length_611_cov_12.669922	264	344	2	47	80	0.5875000
NODE_23871_length_611_cov_12.669922	264	344	3	27	80	0.3375000
NODE_23871_length_611_cov_12.669922	264	344	4	1	80	0.0125000
NODE_23871_length_611_cov_12.669922	264	344	6	5	80	0.0625000
NODE_23871_length_611_cov_12.669922	317	397	3	39	80	0.4875000
NODE_23871_length_611_cov_12.669922	317	397	4	22	80	0.2750000
NODE_23871_length_611_cov_12.669922	317	397	6	19	80	0.2375000
NODE_23880_length_611_cov_4.943359	27	107	2	80	80	1.0000000
NODE_23880_length_611_cov_4.943359	80	137	2	57	57	1.0000000
NODE_23880_length_611_cov_4.943359	143	209	0	66	66	1.0000000
NODE_23880_length_611_cov_4.943359	182	262	0	80	80	1.0000000
NODE_23894_length_611_cov_3.294922	271	300	0	25	29	0.8620690
NODE_23894_length_611_cov_3.294922	271	300	1	4	29	0.1379310
NODE_23894_length_611_cov_3.294922	434	469	0	35	35	1.0000000
NODE_23897_length_611_cov_3.162109	313	342	0	29	29	1.0000000
NODE_23973_length_610_cov_20.673190	87	167	0	9	80	0.1125000
NODE_23973_length_610_cov_20.673190	87	167	1	1	80	0.0125000
NODE_23973_length_610_cov_20.673190	87	167	3	70	80	0.8750000
NODE_23973_length_610_cov_20.673190	140	220	3	28	80	0.3500000
NODE_23973_length_610_cov_20.673190	140	220	4	52	80	0.6500000
NODE_23974_length_610_cov_10.191781	250	330	0	80	80	1.0000000
NODE_23974_length_610_cov_10.191781	303	383	0	80	80	1.0000000
NODE_23980_length_610_cov_4.998043	129	181	0	52	52	1.0000000
NODE_23980_length_610_cov_4.998043	182	234	0	52	52	1.0000000
NODE_23989_length_610_cov_3.479452	215	267	0	52	52	1.0000000
NODE_24059_length_609_cov_21.117647	80	160	18	9	80	0.1125000
NODE_24059_length_609_cov_21.117647	80	160	19	1	80	0.0125000
NODE_24059_length_609_cov_21.117647	80	160	27	21	80	0.2625000
NODE_24059_length_609_cov_21.117647	80	160	28	2	80	0.0250000
NODE_24059_length_609_cov_21.117647	80	160	29	1	80	0.0125000
NODE_24059_length_609_cov_21.117647	80	160	30	46	80	0.5750000
NODE_24059_length_609_cov_21.117647	133	213	13	1	80	0.0125000
NODE_24059_length_609_cov_21.117647	133	213	17	1	80	0.0125000
NODE_24059_length_609_cov_21.117647	133	213	18	3	80	0.0375000
NODE_24059_length_609_cov_21.117647	133	213	20	11	80	0.1375000
NODE_24059_length_609_cov_21.117647	133	213	21	5	80	0.0625000
NODE_24059_length_609_cov_21.117647	133	213	22	3	80	0.0375000
NODE_24059_length_609_cov_21.117647	133	213	26	26	80	0.3250000
NODE_24059_length_609_cov_21.117647	133	213	27	24	80	0.3000000
NODE_24059_length_609_cov_21.117647	133	213	28	2	80	0.0250000
NODE_24059_length_609_cov_21.117647	133	213	29	1	80	0.0125000
NODE_24059_length_609_cov_21.117647	133	213	30	3	80	0.0375000
NODE_24060_length_609_cov_11.300000	218	298	5	80	80	1.0000000
NODE_24060_length_609_cov_11.300000	271	351	2	8	80	0.1000000
NODE_24060_length_609_cov_11.300000	271	351	3	22	80	0.2750000
NODE_24060_length_609_cov_11.300000	271	351	4	8	80	0.1000000
NODE_24060_length_609_cov_11.300000	271	351	5	42	80	0.5250000
NODE_24061_length_609_cov_10.778431	239	319	3	17	80	0.2125000
NODE_24061_length_609_cov_10.778431	239	319	4	38	80	0.4750000
NODE_24061_length_609_cov_10.778431	239	319	5	11	80	0.1375000
NODE_24061_length_609_cov_10.778431	239	319	8	14	80	0.1750000
NODE_24061_length_609_cov_10.778431	292	372	4	2	80	0.0250000
NODE_24061_length_609_cov_10.778431	292	372	5	11	80	0.1375000
NODE_24061_length_609_cov_10.778431	292	372	8	67	80	0.8375000
NODE_24062_length_609_cov_10.298039	340	420	1	72	80	0.9000000
NODE_24062_length_609_cov_10.298039	340	420	2	8	80	0.1000000
NODE_24062_length_609_cov_10.298039	393	473	1	80	80	1.0000000
NODE_24062_length_609_cov_10.298039	469	537	0	30	68	0.4411765
NODE_24062_length_609_cov_10.298039	469	537	1	38	68	0.5588235
NODE_24063_length_609_cov_10.270588	217	297	0	3	80	0.0375000
NODE_24063_length_609_cov_10.270588	217	297	1	77	80	0.9625000
NODE_24063_length_609_cov_10.270588	270	353	0	29	83	0.3493976
NODE_24063_length_609_cov_10.270588	270	353	1	54	83	0.6506024
NODE_24064_length_609_cov_8.345098	408	488	6	80	80	1.0000000
NODE_24064_length_609_cov_8.345098	461	515	1	2	54	0.0370370
NODE_24064_length_609_cov_8.345098	461	515	2	2	54	0.0370370
NODE_24064_length_609_cov_8.345098	461	515	4	8	54	0.1481481
NODE_24064_length_609_cov_8.345098	461	515	5	11	54	0.2037037
NODE_24064_length_609_cov_8.345098	461	515	6	31	54	0.5740741
NODE_24064_length_609_cov_8.345098	537	566	0	16	29	0.5517241
NODE_24064_length_609_cov_8.345098	537	566	1	13	29	0.4482759
NODE_24066_length_609_cov_6.054902	219	299	2	80	80	1.0000000
NODE_24066_length_609_cov_6.054902	272	352	0	45	80	0.5625000
NODE_24066_length_609_cov_6.054902	272	352	2	35	80	0.4375000
NODE_24067_length_609_cov_5.986275	219	299	1	79	80	0.9875000
NODE_24067_length_609_cov_5.986275	219	299	2	1	80	0.0125000
NODE_24067_length_609_cov_5.986275	272	352	1	80	80	1.0000000
NODE_24160_length_608_cov_76.257367	300	380	26	2	80	0.0250000
NODE_24160_length_608_cov_76.257367	300	380	27	1	80	0.0125000
NODE_24160_length_608_cov_76.257367	300	380	28	4	80	0.0500000
NODE_24160_length_608_cov_76.257367	300	380	30	2	80	0.0250000
NODE_24160_length_608_cov_76.257367	300	380	31	4	80	0.0500000
NODE_24160_length_608_cov_76.257367	300	380	32	6	80	0.0750000
NODE_24160_length_608_cov_76.257367	300	380	34	3	80	0.0375000
NODE_24160_length_608_cov_76.257367	300	380	35	12	80	0.1500000
NODE_24160_length_608_cov_76.257367	300	380	36	45	80	0.5625000
NODE_24160_length_608_cov_76.257367	300	380	37	1	80	0.0125000
NODE_24160_length_608_cov_76.257367	353	433	14	6	80	0.0750000
NODE_24160_length_608_cov_76.257367	353	433	15	16	80	0.2000000
NODE_24160_length_608_cov_76.257367	353	433	23	16	80	0.2000000
NODE_24160_length_608_cov_76.257367	353	433	29	1	80	0.0125000
NODE_24160_length_608_cov_76.257367	353	433	30	12	80	0.1500000
NODE_24160_length_608_cov_76.257367	353	433	31	6	80	0.0750000
NODE_24160_length_608_cov_76.257367	353	433	32	6	80	0.0750000
NODE_24160_length_608_cov_76.257367	353	433	34	3	80	0.0375000
NODE_24160_length_608_cov_76.257367	353	433	35	1	80	0.0125000
NODE_24160_length_608_cov_76.257367	353	433	36	13	80	0.1625000
NODE_24161_length_608_cov_13.271120	252	332	1	28	80	0.3500000
NODE_24161_length_608_cov_13.271120	252	332	2	25	80	0.3125000
NODE_24161_length_608_cov_13.271120	252	332	4	10	80	0.1250000
NODE_24161_length_608_cov_13.271120	252	332	5	16	80	0.2000000
NODE_24161_length_608_cov_13.271120	252	332	6	1	80	0.0125000
NODE_24161_length_608_cov_13.271120	305	385	4	10	80	0.1250000
NODE_24161_length_608_cov_13.271120	305	385	5	16	80	0.2000000
NODE_24161_length_608_cov_13.271120	305	385	6	54	80	0.6750000
NODE_24162_length_608_cov_11.583497	63	139	1	32	76	0.4210526
NODE_24162_length_608_cov_11.583497	63	139	2	8	76	0.1052632
NODE_24162_length_608_cov_11.583497	63	139	3	36	76	0.4736842
NODE_24162_length_608_cov_11.583497	112	192	3	80	80	1.0000000
NODE_24164_length_608_cov_8.076621	53	133	2	80	80	1.0000000
NODE_24164_length_608_cov_8.076621	106	186	0	48	80	0.6000000
NODE_24164_length_608_cov_8.076621	106	186	2	32	80	0.4000000
NODE_24165_length_608_cov_7.994106	279	326	0	47	47	1.0000000
NODE_24165_length_608_cov_7.994106	348	373	0	25	25	1.0000000
NODE_24166_length_608_cov_7.939096	247	277	0	30	30	1.0000000
NODE_24177_length_608_cov_3.829077	313	393	0	80	80	1.0000000
NODE_24177_length_608_cov_3.829077	366	446	0	80	80	1.0000000
NODE_24251_length_608_cov_1.064833	472	512	0	40	40	1.0000000
NODE_24281_length_607_cov_61.316929	347	427	9	14	80	0.1750000
NODE_24281_length_607_cov_61.316929	347	427	10	17	80	0.2125000
NODE_24281_length_607_cov_61.316929	347	427	11	3	80	0.0375000
NODE_24281_length_607_cov_61.316929	347	427	12	16	80	0.2000000
NODE_24281_length_607_cov_61.316929	347	427	13	30	80	0.3750000
NODE_24281_length_607_cov_61.316929	347	427	9	14	80	0.1750000
NODE_24281_length_607_cov_61.316929	347	427	10	17	80	0.2125000
NODE_24281_length_607_cov_61.316929	347	427	11	3	80	0.0375000
NODE_24281_length_607_cov_61.316929	347	427	12	16	80	0.2000000
NODE_24281_length_607_cov_61.316929	347	427	13	30	80	0.3750000
NODE_24281_length_607_cov_61.316929	347	427	9	14	80	0.1750000
NODE_24281_length_607_cov_61.316929	347	427	10	17	80	0.2125000
NODE_24281_length_607_cov_61.316929	347	427	11	3	80	0.0375000
NODE_24281_length_607_cov_61.316929	347	427	12	16	80	0.2000000
NODE_24281_length_607_cov_61.316929	347	427	13	30	80	0.3750000
NODE_24281_length_607_cov_61.316929	364	427	10	14	63	0.2222222
NODE_24281_length_607_cov_61.316929	364	427	11	3	63	0.0476190
NODE_24281_length_607_cov_61.316929	364	427	12	16	63	0.2539683
NODE_24281_length_607_cov_61.316929	364	427	13	30	63	0.4761905
NODE_24281_length_607_cov_61.316929	400	480	9	11	80	0.1375000
NODE_24281_length_607_cov_61.316929	400	480	10	15	80	0.1875000
NODE_24281_length_607_cov_61.316929	400	480	13	34	80	0.4250000
NODE_24281_length_607_cov_61.316929	400	480	14	15	80	0.1875000
NODE_24281_length_607_cov_61.316929	400	480	15	5	80	0.0625000
NODE_24281_length_607_cov_61.316929	400	480	9	11	80	0.1375000
NODE_24281_length_607_cov_61.316929	400	480	10	15	80	0.1875000
NODE_24281_length_607_cov_61.316929	400	480	13	34	80	0.4250000
NODE_24281_length_607_cov_61.316929	400	480	14	15	80	0.1875000
NODE_24281_length_607_cov_61.316929	400	480	15	5	80	0.0625000
NODE_24281_length_607_cov_61.316929	400	480	9	11	80	0.1375000
NODE_24281_length_607_cov_61.316929	400	480	10	15	80	0.1875000
NODE_24281_length_607_cov_61.316929	400	480	13	34	80	0.4250000
NODE_24281_length_607_cov_61.316929	400	480	14	15	80	0.1875000
NODE_24281_length_607_cov_61.316929	400	480	15	5	80	0.0625000
NODE_24281_length_607_cov_61.316929	400	480	9	11	80	0.1375000
NODE_24281_length_607_cov_61.316929	400	480	10	15	80	0.1875000
NODE_24281_length_607_cov_61.316929	400	480	13	34	80	0.4250000
NODE_24281_length_607_cov_61.316929	400	480	14	15	80	0.1875000
NODE_24281_length_607_cov_61.316929	400	480	15	5	80	0.0625000
NODE_24281_length_607_cov_61.316929	476	556	4	8	80	0.1000000
NODE_24281_length_607_cov_61.316929	476	556	5	16	80	0.2000000
NODE_24281_length_607_cov_61.316929	476	556	6	4	80	0.0500000
NODE_24281_length_607_cov_61.316929	476	556	7	17	80	0.2125000
NODE_24281_length_607_cov_61.316929	476	556	8	6	80	0.0750000
NODE_24281_length_607_cov_61.316929	476	556	10	29	80	0.3625000
NODE_24281_length_607_cov_61.316929	476	556	4	8	80	0.1000000
NODE_24281_length_607_cov_61.316929	476	556	5	16	80	0.2000000
NODE_24281_length_607_cov_61.316929	476	556	6	4	80	0.0500000
NODE_24281_length_607_cov_61.316929	476	556	7	17	80	0.2125000
NODE_24281_length_607_cov_61.316929	476	556	8	6	80	0.0750000
NODE_24281_length_607_cov_61.316929	476	556	10	29	80	0.3625000
NODE_24281_length_607_cov_61.316929	476	556	4	8	80	0.1000000
NODE_24281_length_607_cov_61.316929	476	556	5	16	80	0.2000000
NODE_24281_length_607_cov_61.316929	476	556	6	4	80	0.0500000
NODE_24281_length_607_cov_61.316929	476	556	7	17	80	0.2125000
NODE_24281_length_607_cov_61.316929	476	556	8	6	80	0.0750000
NODE_24281_length_607_cov_61.316929	476	556	10	29	80	0.3625000
NODE_24281_length_607_cov_61.316929	529	595	3	12	66	0.1818182
NODE_24281_length_607_cov_61.316929	529	595	4	35	66	0.5303030
NODE_24281_length_607_cov_61.316929	529	595	5	16	66	0.2424242
NODE_24281_length_607_cov_61.316929	529	595	6	3	66	0.0454545
NODE_24281_length_607_cov_61.316929	529	607	1	4	78	0.0512821
NODE_24281_length_607_cov_61.316929	529	607	2	5	78	0.0641026
NODE_24281_length_607_cov_61.316929	529	607	3	15	78	0.1923077
NODE_24281_length_607_cov_61.316929	529	607	4	35	78	0.4487180
NODE_24281_length_607_cov_61.316929	529	607	5	16	78	0.2051282
NODE_24281_length_607_cov_61.316929	529	607	6	3	78	0.0384615
NODE_24281_length_607_cov_61.316929	529	600	2	2	71	0.0281690
NODE_24281_length_607_cov_61.316929	529	600	3	15	71	0.2112676
NODE_24281_length_607_cov_61.316929	529	600	4	35	71	0.4929577
NODE_24281_length_607_cov_61.316929	529	600	5	16	71	0.2253521
NODE_24281_length_607_cov_61.316929	529	600	6	3	71	0.0422535
NODE_24281_length_607_cov_61.316929	534	607	1	4	73	0.0547945
NODE_24281_length_607_cov_61.316929	534	607	2	5	73	0.0684932
NODE_24281_length_607_cov_61.316929	534	607	3	15	73	0.2054795
NODE_24281_length_607_cov_61.316929	534	607	4	35	73	0.4794520
NODE_24281_length_607_cov_61.316929	534	607	5	14	73	0.1917808
NODE_24282_length_607_cov_16.852362	383	463	6	2	80	0.0250000
NODE_24282_length_607_cov_16.852362	383	463	7	32	80	0.4000000
NODE_24282_length_607_cov_16.852362	383	463	8	42	80	0.5250000
NODE_24282_length_607_cov_16.852362	383	463	9	4	80	0.0500000
NODE_24282_length_607_cov_16.852362	436	516	4	7	80	0.0875000
NODE_24282_length_607_cov_16.852362	436	516	5	4	80	0.0500000
NODE_24282_length_607_cov_16.852362	436	516	6	39	80	0.4875000
NODE_24282_length_607_cov_16.852362	436	516	7	2	80	0.0250000
NODE_24282_length_607_cov_16.852362	436	516	8	28	80	0.3500000
NODE_24283_length_607_cov_12.889764	67	147	1	80	80	1.0000000
NODE_24283_length_607_cov_12.889764	120	200	0	45	80	0.5625000
NODE_24283_length_607_cov_12.889764	120	200	1	35	80	0.4375000
NODE_24284_length_607_cov_11.023622	122	202	0	14	80	0.1750000
NODE_24284_length_607_cov_11.023622	122	202	1	19	80	0.2375000
NODE_24284_length_607_cov_11.023622	122	202	3	35	80	0.4375000
NODE_24284_length_607_cov_11.023622	122	202	4	12	80	0.1500000
NODE_24284_length_607_cov_11.023622	175	255	3	15	80	0.1875000
NODE_24284_length_607_cov_11.023622	175	255	4	65	80	0.8125000
NODE_24285_length_607_cov_10.690945	199	279	2	7	80	0.0875000
NODE_24285_length_607_cov_10.690945	199	279	4	17	80	0.2125000
NODE_24285_length_607_cov_10.690945	199	279	6	50	80	0.6250000
NODE_24285_length_607_cov_10.690945	199	279	8	6	80	0.0750000
NODE_24285_length_607_cov_10.690945	252	332	6	41	80	0.5125000
NODE_24285_length_607_cov_10.690945	252	332	7	2	80	0.0250000
NODE_24285_length_607_cov_10.690945	252	332	8	37	80	0.4625000
NODE_24290_length_607_cov_5.818898	301	386	0	85	85	1.0000000
NODE_24291_length_607_cov_5.771654	278	358	1	15	80	0.1875000
NODE_24291_length_607_cov_5.771654	278	358	2	65	80	0.8125000
NODE_24291_length_607_cov_5.771654	331	411	2	80	80	1.0000000
NODE_24295_length_607_cov_4.816929	282	362	0	19	80	0.2375000
NODE_24295_length_607_cov_4.816929	282	362	2	61	80	0.7625000
NODE_24295_length_607_cov_4.816929	335	415	2	80	80	1.0000000
NODE_24300_length_607_cov_4.015748	295	354	0	59	59	1.0000000
NODE_24310_length_607_cov_3.088583	107	158	0	51	51	1.0000000
NODE_24331_length_607_cov_1.791339	204	247	0	43	43	1.0000000
NODE_24400_length_606_cov_42.264300	182	262	26	20	80	0.2500000
NODE_24400_length_606_cov_42.264300	182	262	28	6	80	0.0750000
NODE_24400_length_606_cov_42.264300	182	262	29	39	80	0.4875000
NODE_24400_length_606_cov_42.264300	182	262	30	6	80	0.0750000
NODE_24400_length_606_cov_42.264300	182	262	32	6	80	0.0750000
NODE_24400_length_606_cov_42.264300	182	262	33	3	80	0.0375000
NODE_24400_length_606_cov_42.264300	235	315	28	10	80	0.1250000
NODE_24400_length_606_cov_42.264300	235	315	29	34	80	0.4250000
NODE_24400_length_606_cov_42.264300	235	315	30	22	80	0.2750000
NODE_24400_length_606_cov_42.264300	235	315	31	12	80	0.1500000
NODE_24400_length_606_cov_42.264300	235	315	33	2	80	0.0250000
NODE_24402_length_606_cov_26.341223	371	451	13	1	80	0.0125000
NODE_24402_length_606_cov_26.341223	371	451	14	30	80	0.3750000
NODE_24402_length_606_cov_26.341223	371	451	15	25	80	0.3125000
NODE_24402_length_606_cov_26.341223	371	451	16	24	80	0.3000000
NODE_24402_length_606_cov_26.341223	424	504	5	1	80	0.0125000
NODE_24402_length_606_cov_26.341223	424	504	7	11	80	0.1375000
NODE_24402_length_606_cov_26.341223	424	504	8	6	80	0.0750000
NODE_24402_length_606_cov_26.341223	424	504	9	4	80	0.0500000
NODE_24402_length_606_cov_26.341223	424	504	10	16	80	0.2000000
NODE_24402_length_606_cov_26.341223	424	504	11	14	80	0.1750000
NODE_24402_length_606_cov_26.341223	424	504	14	28	80	0.3500000
NODE_24403_length_606_cov_14.895464	308	388	2	4	80	0.0500000
NODE_24403_length_606_cov_14.895464	308	388	3	59	80	0.7375000
NODE_24403_length_606_cov_14.895464	308	388	4	17	80	0.2125000
NODE_24403_length_606_cov_14.895464	361	441	2	43	80	0.5375000
NODE_24403_length_606_cov_14.895464	361	441	3	37	80	0.4625000
NODE_24406_length_606_cov_7.934911	412	492	0	4	80	0.0500000
NODE_24406_length_606_cov_7.934911	412	492	2	76	80	0.9500000
NODE_24406_length_606_cov_7.934911	465	545	2	80	80	1.0000000
NODE_24407_length_606_cov_7.481262	250	330	5	6	80	0.0750000
NODE_24407_length_606_cov_7.481262	250	330	6	9	80	0.1125000
NODE_24407_length_606_cov_7.481262	250	330	8	34	80	0.4250000
NODE_24407_length_606_cov_7.481262	250	330	9	4	80	0.0500000
NODE_24407_length_606_cov_7.481262	250	330	10	5	80	0.0625000
NODE_24407_length_606_cov_7.481262	250	330	11	22	80	0.2750000
NODE_24407_length_606_cov_7.481262	303	383	9	1	80	0.0125000
NODE_24407_length_606_cov_7.481262	303	383	10	5	80	0.0625000
NODE_24407_length_606_cov_7.481262	303	383	11	66	80	0.8250000
NODE_24407_length_606_cov_7.481262	303	383	12	8	80	0.1000000
NODE_24409_length_606_cov_6.842209	139	219	1	21	80	0.2625000
NODE_24409_length_606_cov_6.842209	139	219	2	59	80	0.7375000
NODE_24409_length_606_cov_6.842209	192	272	0	17	80	0.2125000
NODE_24409_length_606_cov_6.842209	192	272	1	57	80	0.7125000
NODE_24409_length_606_cov_6.842209	192	272	2	6	80	0.0750000
NODE_24428_length_606_cov_3.384615	156	206	0	50	50	1.0000000
NODE_24433_length_606_cov_2.670611	113	193	0	34	80	0.4250000
NODE_24433_length_606_cov_2.670611	113	193	1	46	80	0.5750000
NODE_24525_length_605_cov_63.343874	7	83	0	52	76	0.6842105
NODE_24525_length_605_cov_63.343874	7	83	1	2	76	0.0263158
NODE_24525_length_605_cov_63.343874	7	83	2	22	76	0.2894737
NODE_24525_length_605_cov_63.343874	12	83	0	47	71	0.6619718
NODE_24525_length_605_cov_63.343874	12	83	1	2	71	0.0281690
NODE_24525_length_605_cov_63.343874	12	83	2	22	71	0.3098592
NODE_24525_length_605_cov_63.343874	17	83	0	42	66	0.6363636
NODE_24525_length_605_cov_63.343874	17	83	1	2	66	0.0303030
NODE_24525_length_605_cov_63.343874	17	83	2	22	66	0.3333333
NODE_24525_length_605_cov_63.343874	56	136	0	3	80	0.0375000
NODE_24525_length_605_cov_63.343874	56	136	1	2	80	0.0250000
NODE_24525_length_605_cov_63.343874	56	136	2	22	80	0.2750000
NODE_24525_length_605_cov_63.343874	56	136	3	53	80	0.6625000
NODE_24525_length_605_cov_63.343874	56	136	0	3	80	0.0375000
NODE_24525_length_605_cov_63.343874	56	136	1	2	80	0.0250000
NODE_24525_length_605_cov_63.343874	56	136	2	22	80	0.2750000
NODE_24525_length_605_cov_63.343874	56	136	3	53	80	0.6625000
NODE_24525_length_605_cov_63.343874	56	136	0	3	80	0.0375000
NODE_24525_length_605_cov_63.343874	56	136	1	2	80	0.0250000
NODE_24525_length_605_cov_63.343874	56	136	2	22	80	0.2750000
NODE_24525_length_605_cov_63.343874	56	136	3	53	80	0.6625000
NODE_24525_length_605_cov_63.343874	132	212	3	9	80	0.1125000
NODE_24525_length_605_cov_63.343874	132	212	4	18	80	0.2250000
NODE_24525_length_605_cov_63.343874	132	212	5	29	80	0.3625000
NODE_24525_length_605_cov_63.343874	132	212	6	24	80	0.3000000
NODE_24525_length_605_cov_63.343874	132	212	3	9	80	0.1125000
NODE_24525_length_605_cov_63.343874	132	212	4	18	80	0.2250000
NODE_24525_length_605_cov_63.343874	132	212	5	29	80	0.3625000
NODE_24525_length_605_cov_63.343874	132	212	6	24	80	0.3000000
NODE_24525_length_605_cov_63.343874	132	210	3	9	78	0.1153846
NODE_24525_length_605_cov_63.343874	132	210	4	17	78	0.2179487
NODE_24525_length_605_cov_63.343874	132	210	5	28	78	0.3589744
NODE_24525_length_605_cov_63.343874	132	210	6	24	78	0.3076923
NODE_24525_length_605_cov_63.343874	132	212	3	9	80	0.1125000
NODE_24525_length_605_cov_63.343874	132	212	4	18	80	0.2250000
NODE_24525_length_605_cov_63.343874	132	212	5	29	80	0.3625000
NODE_24525_length_605_cov_63.343874	132	212	6	24	80	0.3000000
NODE_24525_length_605_cov_63.343874	132	212	3	9	80	0.1125000
NODE_24525_length_605_cov_63.343874	132	212	4	18	80	0.2250000
NODE_24525_length_605_cov_63.343874	132	212	5	29	80	0.3625000
NODE_24525_length_605_cov_63.343874	132	212	6	24	80	0.3000000
NODE_24525_length_605_cov_63.343874	185	265	3	32	80	0.4000000
NODE_24525_length_605_cov_63.343874	185	265	4	22	80	0.2750000
NODE_24525_length_605_cov_63.343874	185	265	5	2	80	0.0250000
NODE_24525_length_605_cov_63.343874	185	265	6	24	80	0.3000000
NODE_24526_length_605_cov_48.191700	298	374	15	12	76	0.1578947
NODE_24526_length_605_cov_48.191700	298	374	20	2	76	0.0263158
NODE_24526_length_605_cov_48.191700	298	374	21	48	76	0.6315789
NODE_24526_length_605_cov_48.191700	298	374	22	2	76	0.0263158
NODE_24526_length_605_cov_48.191700	298	374	23	6	76	0.0789474
NODE_24526_length_605_cov_48.191700	298	374	24	6	76	0.0789474
NODE_24526_length_605_cov_48.191700	347	427	12	51	80	0.6375000
NODE_24526_length_605_cov_48.191700	347	427	15	14	80	0.1750000
NODE_24526_length_605_cov_48.191700	347	427	21	15	80	0.1875000
NODE_24528_length_605_cov_33.328063	57	137	3	18	80	0.2250000
NODE_24528_length_605_cov_33.328063	57	137	4	1	80	0.0125000
NODE_24528_length_605_cov_33.328063	57	137	5	1	80	0.0125000
NODE_24528_length_605_cov_33.328063	57	137	6	10	80	0.1250000
NODE_24528_length_605_cov_33.328063	57	137	9	7	80	0.0875000
NODE_24528_length_605_cov_33.328063	57	137	12	1	80	0.0125000
NODE_24528_length_605_cov_33.328063	57	137	14	10	80	0.1250000
NODE_24528_length_605_cov_33.328063	57	137	15	12	80	0.1500000
NODE_24528_length_605_cov_33.328063	57	137	16	2	80	0.0250000
NODE_24528_length_605_cov_33.328063	57	137	17	2	80	0.0250000
NODE_24528_length_605_cov_33.328063	57	137	19	4	80	0.0500000
NODE_24528_length_605_cov_33.328063	57	137	20	7	80	0.0875000
NODE_24528_length_605_cov_33.328063	57	137	21	5	80	0.0625000
NODE_24528_length_605_cov_33.328063	140	175	20	17	35	0.4857143
NODE_24528_length_605_cov_33.328063	140	175	21	4	35	0.1142857
NODE_24528_length_605_cov_33.328063	140	175	22	7	35	0.2000000
NODE_24528_length_605_cov_33.328063	140	175	23	7	35	0.2000000
NODE_24529_length_605_cov_26.717391	353	433	6	15	80	0.1875000
NODE_24529_length_605_cov_26.717391	353	433	7	3	80	0.0375000
NODE_24529_length_605_cov_26.717391	353	433	8	11	80	0.1375000
NODE_24529_length_605_cov_26.717391	353	433	11	44	80	0.5500000
NODE_24529_length_605_cov_26.717391	353	433	14	7	80	0.0875000
NODE_24529_length_605_cov_26.717391	406	486	8	8	80	0.1000000
NODE_24529_length_605_cov_26.717391	406	486	11	72	80	0.9000000
NODE_24530_length_605_cov_17.677866	215	295	0	80	80	1.0000000
NODE_24530_length_605_cov_17.677866	268	348	0	80	80	1.0000000
NODE_24531_length_605_cov_15.225296	144	224	4	12	80	0.1500000
NODE_24531_length_605_cov_15.225296	144	224	5	14	80	0.1750000
NODE_24531_length_605_cov_15.225296	144	224	6	54	80	0.6750000
NODE_24531_length_605_cov_15.225296	197	277	2	36	80	0.4500000
NODE_24531_length_605_cov_15.225296	197	277	3	4	80	0.0500000
NODE_24531_length_605_cov_15.225296	197	277	5	27	80	0.3375000
NODE_24531_length_605_cov_15.225296	197	277	6	13	80	0.1625000
NODE_24532_length_605_cov_14.990119	136	216	0	80	80	1.0000000
NODE_24532_length_605_cov_14.990119	189	269	0	80	80	1.0000000
NODE_24533_length_605_cov_10.835968	103	183	2	80	80	1.0000000
NODE_24533_length_605_cov_10.835968	156	236	1	32	80	0.4000000
NODE_24533_length_605_cov_10.835968	156	236	2	48	80	0.6000000
NODE_24534_length_605_cov_9.169960	306	377	1	22	71	0.3098592
NODE_24534_length_605_cov_9.169960	306	377	2	17	71	0.2394366
NODE_24534_length_605_cov_9.169960	306	377	3	32	71	0.4507042
NODE_24534_length_605_cov_9.169960	359	432	2	66	73	0.9041096
NODE_24534_length_605_cov_9.169960	359	432	3	7	73	0.0958904
NODE_24546_length_605_cov_4.308300	159	239	0	31	80	0.3875000
NODE_24546_length_605_cov_4.308300	159	239	1	49	80	0.6125000
NODE_24546_length_605_cov_4.308300	271	338	2	67	67	1.0000000
NODE_24546_length_605_cov_4.308300	275	350	2	75	75	1.0000000
NODE_24546_length_605_cov_4.308300	315	372	0	5	57	0.0877193
NODE_24546_length_605_cov_4.308300	315	372	2	52	57	0.9122807
NODE_24546_length_605_cov_4.308300	328	373	0	6	45	0.1333333
NODE_24546_length_605_cov_4.308300	328	373	2	39	45	0.8666667
NODE_24558_length_605_cov_3.120553	216	287	0	71	71	1.0000000
NODE_24561_length_605_cov_2.909091	408	487	4	50	79	0.6329114
NODE_24561_length_605_cov_2.909091	408	487	6	21	79	0.2658228
NODE_24561_length_605_cov_2.909091	408	487	7	8	79	0.1012658
NODE_24577_length_605_cov_1.897233	230	273	0	43	43	1.0000000
NODE_24603_length_605_cov_1.339921	168	210	0	42	42	1.0000000
NODE_24636_length_604_cov_30.411881	93	173	8	35	80	0.4375000
NODE_24636_length_604_cov_30.411881	93	173	9	20	80	0.2500000
NODE_24636_length_604_cov_30.411881	93	173	10	25	80	0.3125000
NODE_24636_length_604_cov_30.411881	146	226	6	21	80	0.2625000
NODE_24636_length_604_cov_30.411881	146	226	7	24	80	0.3000000
NODE_24636_length_604_cov_30.411881	146	226	8	8	80	0.1000000
NODE_24636_length_604_cov_30.411881	146	226	9	16	80	0.2000000
NODE_24636_length_604_cov_30.411881	146	226	10	11	80	0.1375000
NODE_24637_length_604_cov_20.099010	414	494	1	30	80	0.3750000
NODE_24637_length_604_cov_20.099010	414	494	2	4	80	0.0500000
NODE_24637_length_604_cov_20.099010	414	494	4	2	80	0.0250000
NODE_24637_length_604_cov_20.099010	414	494	5	35	80	0.4375000
NODE_24637_length_604_cov_20.099010	414	494	6	9	80	0.1125000
NODE_24637_length_604_cov_20.099010	467	547	5	18	80	0.2250000
NODE_24637_length_604_cov_20.099010	467	547	6	62	80	0.7750000
NODE_24639_length_604_cov_10.291089	184	264	0	80	80	1.0000000
NODE_24639_length_604_cov_10.291089	237	317	0	80	80	1.0000000
NODE_24646_length_604_cov_6.033663	265	345	1	42	80	0.5250000
NODE_24646_length_604_cov_6.033663	265	345	2	38	80	0.4750000
NODE_24646_length_604_cov_6.033663	318	397	0	40	79	0.5063291
NODE_24646_length_604_cov_6.033663	318	397	1	39	79	0.4936709
NODE_24654_length_604_cov_4.316832	40	106	2	58	66	0.8787879
NODE_24654_length_604_cov_4.316832	40	106	4	8	66	0.1212121
NODE_24654_length_604_cov_4.316832	377	435	2	58	58	1.0000000
NODE_24692_length_604_cov_1.805941	299	380	1	56	81	0.6913580
NODE_24692_length_604_cov_1.805941	299	380	8	21	81	0.2592593
NODE_24692_length_604_cov_1.805941	299	380	9	4	81	0.0493827
NODE_24692_length_604_cov_1.805941	353	433	1	2	80	0.0250000
NODE_24692_length_604_cov_1.805941	353	433	6	13	80	0.1625000
NODE_24692_length_604_cov_1.805941	353	433	8	21	80	0.2625000
NODE_24692_length_604_cov_1.805941	353	433	9	13	80	0.1625000
NODE_24692_length_604_cov_1.805941	353	433	10	31	80	0.3875000
NODE_24732_length_603_cov_18.761905	108	188	2	80	80	1.0000000
NODE_24732_length_603_cov_18.761905	161	241	2	35	80	0.4375000
NODE_24732_length_603_cov_18.761905	161	241	3	2	80	0.0250000
NODE_24732_length_603_cov_18.761905	161	241	4	43	80	0.5375000
NODE_24734_length_603_cov_8.996032	163	243	1	62	80	0.7750000
NODE_24734_length_603_cov_8.996032	163	243	2	8	80	0.1000000
NODE_24734_length_603_cov_8.996032	163	243	3	10	80	0.1250000
NODE_24734_length_603_cov_8.996032	216	296	1	9	80	0.1125000
NODE_24734_length_603_cov_8.996032	216	296	2	8	80	0.1000000
NODE_24734_length_603_cov_8.996032	216	296	3	48	80	0.6000000
NODE_24734_length_603_cov_8.996032	216	296	4	15	80	0.1875000
NODE_24735_length_603_cov_8.970238	413	493	1	18	80	0.2250000
NODE_24735_length_603_cov_8.970238	413	493	2	62	80	0.7750000
NODE_24736_length_603_cov_7.212302	324	404	2	37	80	0.4625000
NODE_24736_length_603_cov_7.212302	324	404	3	43	80	0.5375000
NODE_24736_length_603_cov_7.212302	377	457	0	16	80	0.2000000
NODE_24736_length_603_cov_7.212302	377	457	1	14	80	0.1750000
NODE_24736_length_603_cov_7.212302	377	457	2	50	80	0.6250000
NODE_24739_length_603_cov_5.831349	351	385	0	34	34	1.0000000
NODE_24744_length_603_cov_4.744048	103	183	0	80	80	1.0000000
NODE_24744_length_603_cov_4.744048	156	236	0	80	80	1.0000000
NODE_24748_length_603_cov_4.115079	219	259	0	40	40	1.0000000
NODE_24755_length_603_cov_3.269841	186	223	0	37	37	1.0000000
NODE_24755_length_603_cov_3.269841	196	276	0	80	80	1.0000000
NODE_24755_length_603_cov_3.269841	367	441	0	74	74	1.0000000
NODE_24843_length_602_cov_33.208748	106	186	18	3	80	0.0375000
NODE_24843_length_602_cov_33.208748	106	186	19	3	80	0.0375000
NODE_24843_length_602_cov_33.208748	106	186	20	6	80	0.0750000
NODE_24843_length_602_cov_33.208748	106	186	21	1	80	0.0125000
NODE_24843_length_602_cov_33.208748	106	186	22	3	80	0.0375000
NODE_24843_length_602_cov_33.208748	106	186	24	17	80	0.2125000
NODE_24843_length_602_cov_33.208748	106	186	26	9	80	0.1125000
NODE_24843_length_602_cov_33.208748	106	186	27	2	80	0.0250000
NODE_24843_length_602_cov_33.208748	106	186	28	16	80	0.2000000
NODE_24843_length_602_cov_33.208748	106	186	29	1	80	0.0125000
NODE_24843_length_602_cov_33.208748	106	186	30	11	80	0.1375000
NODE_24843_length_602_cov_33.208748	106	186	31	8	80	0.1000000
NODE_24843_length_602_cov_33.208748	159	239	24	20	80	0.2500000
NODE_24843_length_602_cov_33.208748	159	239	25	2	80	0.0250000
NODE_24843_length_602_cov_33.208748	159	239	26	16	80	0.2000000
NODE_24843_length_602_cov_33.208748	159	239	27	16	80	0.2000000
NODE_24843_length_602_cov_33.208748	159	239	28	6	80	0.0750000
NODE_24843_length_602_cov_33.208748	159	239	29	1	80	0.0125000
NODE_24843_length_602_cov_33.208748	159	239	30	11	80	0.1375000
NODE_24843_length_602_cov_33.208748	159	239	31	8	80	0.1000000
NODE_24844_length_602_cov_28.922465	319	399	13	12	80	0.1500000
NODE_24844_length_602_cov_28.922465	319	399	14	5	80	0.0625000
NODE_24844_length_602_cov_28.922465	319	399	15	5	80	0.0625000
NODE_24844_length_602_cov_28.922465	319	399	16	4	80	0.0500000
NODE_24844_length_602_cov_28.922465	319	399	18	18	80	0.2250000
NODE_24844_length_602_cov_28.922465	319	399	19	2	80	0.0250000
NODE_24844_length_602_cov_28.922465	319	399	20	3	80	0.0375000
NODE_24844_length_602_cov_28.922465	319	399	21	31	80	0.3875000
NODE_24844_length_602_cov_28.922465	372	452	16	9	80	0.1125000
NODE_24844_length_602_cov_28.922465	372	452	17	3	80	0.0375000
NODE_24844_length_602_cov_28.922465	372	452	18	5	80	0.0625000
NODE_24844_length_602_cov_28.922465	372	452	19	1	80	0.0125000
NODE_24844_length_602_cov_28.922465	372	452	20	23	80	0.2875000
NODE_24844_length_602_cov_28.922465	372	452	21	35	80	0.4375000
NODE_24844_length_602_cov_28.922465	372	452	22	4	80	0.0500000
NODE_24846_length_602_cov_10.930417	248	328	0	44	80	0.5500000
NODE_24846_length_602_cov_10.930417	248	328	1	36	80	0.4500000
NODE_24846_length_602_cov_10.930417	301	381	0	55	80	0.6875000
NODE_24846_length_602_cov_10.930417	301	381	1	25	80	0.3125000
NODE_24847_length_602_cov_10.447316	148	207	2	15	59	0.2542373
NODE_24847_length_602_cov_10.447316	148	207	4	6	59	0.1016949
NODE_24847_length_602_cov_10.447316	148	207	5	17	59	0.2881356
NODE_24847_length_602_cov_10.447316	148	207	6	21	59	0.3559322
NODE_24847_length_602_cov_10.447316	181	207	5	5	26	0.1923077
NODE_24847_length_602_cov_10.447316	181	207	6	21	26	0.8076923
NODE_24847_length_602_cov_10.447316	259	291	6	32	32	1.0000000
NODE_24851_length_602_cov_7.787276	544	565	0	21	21	1.0000000
NODE_24875_length_602_cov_3.332008	157	239	0	19	82	0.2317073
NODE_24875_length_602_cov_3.332008	157	239	2	63	82	0.7682927
NODE_24957_length_601_cov_14.952191	183	263	0	80	80	1.0000000
NODE_24957_length_601_cov_14.952191	236	316	0	80	80	1.0000000
NODE_24958_length_601_cov_14.747012	324	404	0	80	80	1.0000000
NODE_24958_length_601_cov_14.747012	377	457	0	80	80	1.0000000
NODE_24959_length_601_cov_11.561753	226	306	2	80	80	1.0000000
NODE_24959_length_601_cov_11.561753	279	359	0	41	80	0.5125000
NODE_24959_length_601_cov_11.561753	279	359	2	39	80	0.4875000
NODE_24960_length_601_cov_10.826693	320	388	5	33	68	0.4852941
NODE_24960_length_601_cov_10.826693	320	388	6	2	68	0.0294118
NODE_24960_length_601_cov_10.826693	320	388	8	33	68	0.4852941
NODE_24961_length_601_cov_10.392430	243	323	0	80	80	1.0000000
NODE_24961_length_601_cov_10.392430	296	375	0	79	79	1.0000000
NODE_24965_length_601_cov_7.037849	236	316	1	80	80	1.0000000
NODE_24965_length_601_cov_7.037849	289	369	0	51	80	0.6375000
NODE_24965_length_601_cov_7.037849	289	369	1	29	80	0.3625000
NODE_24969_length_601_cov_5.798805	290	361	0	15	71	0.2112676
NODE_24969_length_601_cov_5.798805	290	361	5	56	71	0.7887324
NODE_24970_length_601_cov_5.657371	228	308	0	80	80	1.0000000
NODE_24973_length_601_cov_5.039841	395	462	1	60	67	0.8955224
NODE_24973_length_601_cov_5.039841	395	462	2	7	67	0.1044776
NODE_24975_length_601_cov_4.735060	184	247	0	63	63	1.0000000
NODE_24995_length_601_cov_2.599602	371	430	0	59	59	1.0000000
NODE_24995_length_601_cov_2.599602	441	494	0	53	53	1.0000000
NODE_25090_length_600_cov_6.341317	125	147	7	22	22	1.0000000
NODE_25103_length_600_cov_3.754491	142	222	2	80	80	1.0000000
NODE_25126_length_600_cov_2.081836	282	328	0	46	46	1.0000000
NODE_25141_length_600_cov_1.728543	381	423	0	42	42	1.0000000
NODE_25190_length_599_cov_36.488000	25	105	0	80	80	1.0000000
NODE_25191_length_599_cov_27.870000	255	335	20	14	80	0.1750000
NODE_25191_length_599_cov_27.870000	255	335	21	5	80	0.0625000
NODE_25191_length_599_cov_27.870000	255	335	22	21	80	0.2625000
NODE_25191_length_599_cov_27.870000	255	335	23	7	80	0.0875000
NODE_25191_length_599_cov_27.870000	255	335	25	10	80	0.1250000
NODE_25191_length_599_cov_27.870000	255	335	28	23	80	0.2875000
NODE_25191_length_599_cov_27.870000	308	388	11	8	80	0.1000000
NODE_25191_length_599_cov_27.870000	308	388	12	9	80	0.1125000
NODE_25191_length_599_cov_27.870000	308	388	13	5	80	0.0625000
NODE_25191_length_599_cov_27.870000	308	388	15	7	80	0.0875000
NODE_25191_length_599_cov_27.870000	308	388	16	10	80	0.1250000
NODE_25191_length_599_cov_27.870000	308	388	17	3	80	0.0375000
NODE_25191_length_599_cov_27.870000	308	388	18	6	80	0.0750000
NODE_25191_length_599_cov_27.870000	308	388	20	19	80	0.2375000
NODE_25191_length_599_cov_27.870000	308	388	21	5	80	0.0625000
NODE_25191_length_599_cov_27.870000	308	388	22	8	80	0.1000000
NODE_25192_length_599_cov_22.640000	229	309	8	80	80	1.0000000
NODE_25192_length_599_cov_22.640000	229	309	8	80	80	1.0000000
NODE_25192_length_599_cov_22.640000	229	309	8	80	80	1.0000000
NODE_25192_length_599_cov_22.640000	229	309	8	80	80	1.0000000
NODE_25192_length_599_cov_22.640000	229	309	8	80	80	1.0000000
NODE_25192_length_599_cov_22.640000	282	362	8	63	80	0.7875000
NODE_25192_length_599_cov_22.640000	282	362	13	17	80	0.2125000
NODE_25192_length_599_cov_22.640000	282	362	8	63	80	0.7875000
NODE_25192_length_599_cov_22.640000	282	362	13	17	80	0.2125000
NODE_25192_length_599_cov_22.640000	282	353	8	63	71	0.8873239
NODE_25192_length_599_cov_22.640000	282	353	13	8	71	0.1126761
NODE_25192_length_599_cov_22.640000	285	355	8	60	70	0.8571429
NODE_25192_length_599_cov_22.640000	285	355	13	10	70	0.1428571
NODE_25192_length_599_cov_22.640000	287	362	8	58	75	0.7733333
NODE_25192_length_599_cov_22.640000	287	362	13	17	75	0.2266667
NODE_25193_length_599_cov_14.618000	279	359	0	80	80	1.0000000
NODE_25193_length_599_cov_14.618000	332	412	0	80	80	1.0000000
NODE_25195_length_599_cov_10.308000	245	325	2	10	80	0.1250000
NODE_25195_length_599_cov_10.308000	245	325	4	70	80	0.8750000
NODE_25195_length_599_cov_10.308000	298	378	1	15	80	0.1875000
NODE_25195_length_599_cov_10.308000	298	378	2	48	80	0.6000000
NODE_25195_length_599_cov_10.308000	298	378	4	17	80	0.2125000
NODE_25196_length_599_cov_9.224000	160	240	5	15	80	0.1875000
NODE_25196_length_599_cov_9.224000	160	240	6	60	80	0.7500000
NODE_25196_length_599_cov_9.224000	160	240	8	5	80	0.0625000
NODE_25196_length_599_cov_9.224000	213	297	6	22	84	0.2619048
NODE_25196_length_599_cov_9.224000	213	297	8	62	84	0.7380952
NODE_25201_length_599_cov_5.536000	58	112	0	17	54	0.3148148
NODE_25201_length_599_cov_5.536000	58	112	3	37	54	0.6851852
NODE_25208_length_599_cov_3.810000	271	334	0	63	63	1.0000000
NODE_25208_length_599_cov_3.810000	324	390	0	66	66	1.0000000
NODE_25211_length_599_cov_3.598000	238	318	3	8	80	0.1000000
NODE_25211_length_599_cov_3.598000	238	318	4	55	80	0.6875000
NODE_25211_length_599_cov_3.598000	238	318	5	17	80	0.2125000
NODE_25211_length_599_cov_3.598000	291	371	4	10	80	0.1250000
NODE_25211_length_599_cov_3.598000	291	371	5	39	80	0.4875000
NODE_25211_length_599_cov_3.598000	291	371	7	31	80	0.3875000
NODE_25308_length_598_cov_54.450902	264	344	7	3	80	0.0375000
NODE_25308_length_598_cov_54.450902	264	344	9	8	80	0.1000000
NODE_25308_length_598_cov_54.450902	264	344	10	16	80	0.2000000
NODE_25308_length_598_cov_54.450902	264	344	12	17	80	0.2125000
NODE_25308_length_598_cov_54.450902	264	344	13	13	80	0.1625000
NODE_25308_length_598_cov_54.450902	264	344	14	11	80	0.1375000
NODE_25308_length_598_cov_54.450902	264	344	15	12	80	0.1500000
NODE_25308_length_598_cov_54.450902	317	397	10	3	80	0.0375000
NODE_25308_length_598_cov_54.450902	317	397	11	1	80	0.0125000
NODE_25308_length_598_cov_54.450902	317	397	12	19	80	0.2375000
NODE_25308_length_598_cov_54.450902	317	397	13	7	80	0.0875000
NODE_25308_length_598_cov_54.450902	317	397	14	50	80	0.6250000
NODE_25309_length_598_cov_8.326653	204	284	13	32	80	0.4000000
NODE_25309_length_598_cov_8.326653	204	284	15	1	80	0.0125000
NODE_25309_length_598_cov_8.326653	204	284	18	1	80	0.0125000
NODE_25309_length_598_cov_8.326653	204	284	21	5	80	0.0625000
NODE_25309_length_598_cov_8.326653	204	284	23	8	80	0.1000000
NODE_25309_length_598_cov_8.326653	204	284	24	1	80	0.0125000
NODE_25309_length_598_cov_8.326653	204	284	25	1	80	0.0125000
NODE_25309_length_598_cov_8.326653	204	284	26	31	80	0.3875000
NODE_25309_length_598_cov_8.326653	257	337	13	65	80	0.8125000
NODE_25309_length_598_cov_8.326653	257	337	26	15	80	0.1875000
NODE_25316_length_598_cov_5.623246	169	240	4	71	71	1.0000000
NODE_25320_length_598_cov_4.929860	73	153	1	36	80	0.4500000
NODE_25320_length_598_cov_4.929860	73	153	4	9	80	0.1125000
NODE_25320_length_598_cov_4.929860	73	153	5	35	80	0.4375000
NODE_25320_length_598_cov_4.929860	126	206	5	49	80	0.6125000
NODE_25320_length_598_cov_4.929860	126	206	7	1	80	0.0125000
NODE_25320_length_598_cov_4.929860	126	206	8	30	80	0.3750000
NODE_25421_length_597_cov_15.142570	197	277	0	80	80	1.0000000
NODE_25421_length_597_cov_15.142570	250	330	0	80	80	1.0000000
NODE_25422_length_597_cov_12.387550	118	198	0	3	80	0.0375000
NODE_25422_length_597_cov_12.387550	118	198	1	19	80	0.2375000
NODE_25422_length_597_cov_12.387550	118	198	2	58	80	0.7250000
NODE_25422_length_597_cov_12.387550	171	251	2	80	80	1.0000000
NODE_25423_length_597_cov_7.016064	213	293	4	6	80	0.0750000
NODE_25423_length_597_cov_7.016064	213	293	5	10	80	0.1250000
NODE_25423_length_597_cov_7.016064	213	293	6	30	80	0.3750000
NODE_25423_length_597_cov_7.016064	213	293	11	34	80	0.4250000
NODE_25423_length_597_cov_7.016064	266	346	7	9	80	0.1125000
NODE_25423_length_597_cov_7.016064	266	346	8	8	80	0.1000000
NODE_25423_length_597_cov_7.016064	266	346	9	19	80	0.2375000
NODE_25423_length_597_cov_7.016064	266	346	11	44	80	0.5500000
NODE_25426_length_597_cov_6.212851	374	449	2	32	75	0.4266667
NODE_25426_length_597_cov_6.212851	374	449	4	42	75	0.5600000
NODE_25426_length_597_cov_6.212851	374	449	6	1	75	0.0133333
NODE_25434_length_597_cov_4.273092	368	448	5	66	80	0.8250000
NODE_25434_length_597_cov_4.273092	368	448	7	14	80	0.1750000
NODE_25434_length_597_cov_4.273092	421	507	2	20	86	0.2325581
NODE_25434_length_597_cov_4.273092	421	507	4	1	86	0.0116279
NODE_25434_length_597_cov_4.273092	421	507	5	65	86	0.7558140
NODE_25464_length_597_cov_2.162651	92	172	0	80	80	1.0000000
NODE_25464_length_597_cov_2.162651	145	225	0	80	80	1.0000000
NODE_25467_length_597_cov_2.096386	440	509	0	69	69	1.0000000
NODE_25469_length_597_cov_1.977912	392	472	0	80	80	1.0000000
NODE_25469_length_597_cov_1.977912	437	494	0	57	57	1.0000000
NODE_25469_length_597_cov_1.977912	445	525	0	80	80	1.0000000
NODE_25552_length_596_cov_32.293763	221	301	0	44	80	0.5500000
NODE_25552_length_596_cov_32.293763	221	301	2	36	80	0.4500000
NODE_25552_length_596_cov_32.293763	274	354	2	80	80	1.0000000
NODE_25552_length_596_cov_32.293763	351	406	2	55	55	1.0000000
NODE_25552_length_596_cov_32.293763	381	459	0	44	78	0.5641026
NODE_25552_length_596_cov_32.293763	381	459	2	34	78	0.4358974
NODE_25553_length_596_cov_26.891348	199	279	5	14	80	0.1750000
NODE_25553_length_596_cov_26.891348	199	279	7	66	80	0.8250000
NODE_25553_length_596_cov_26.891348	252	332	4	6	80	0.0750000
NODE_25553_length_596_cov_26.891348	252	332	5	8	80	0.1000000
NODE_25553_length_596_cov_26.891348	252	332	6	22	80	0.2750000
NODE_25553_length_596_cov_26.891348	252	332	7	44	80	0.5500000
NODE_25554_length_596_cov_17.082495	179	259	9	21	80	0.2625000
NODE_25554_length_596_cov_17.082495	179	259	11	1	80	0.0125000
NODE_25554_length_596_cov_17.082495	179	259	12	27	80	0.3375000
NODE_25554_length_596_cov_17.082495	179	259	13	31	80	0.3875000
NODE_25554_length_596_cov_17.082495	232	312	11	28	80	0.3500000
NODE_25554_length_596_cov_17.082495	232	312	12	11	80	0.1375000
NODE_25554_length_596_cov_17.082495	232	312	13	26	80	0.3250000
NODE_25554_length_596_cov_17.082495	232	312	14	11	80	0.1375000
NODE_25554_length_596_cov_17.082495	232	312	17	1	80	0.0125000
NODE_25554_length_596_cov_17.082495	232	312	18	3	80	0.0375000
NODE_25555_length_596_cov_10.372233	354	434	0	80	80	1.0000000
NODE_25555_length_596_cov_10.372233	407	487	0	80	80	1.0000000
NODE_25557_length_596_cov_6.955734	142	222	0	80	80	1.0000000
NODE_25558_length_596_cov_6.225352	242	322	1	24	80	0.3000000
NODE_25558_length_596_cov_6.225352	242	322	2	56	80	0.7000000
NODE_25558_length_596_cov_6.225352	308	375	0	24	67	0.3582090
NODE_25558_length_596_cov_6.225352	308	375	1	43	67	0.6417910
NODE_25567_length_596_cov_4.197183	369	444	0	29	75	0.3866667
NODE_25567_length_596_cov_4.197183	369	444	1	46	75	0.6133333
NODE_25593_length_596_cov_2.066398	534	583	0	49	49	1.0000000
NODE_25666_length_595_cov_52.532258	248	328	6	3	80	0.0375000
NODE_25666_length_595_cov_52.532258	248	328	8	1	80	0.0125000
NODE_25666_length_595_cov_52.532258	248	328	10	16	80	0.2000000
NODE_25666_length_595_cov_52.532258	248	328	12	3	80	0.0375000
NODE_25666_length_595_cov_52.532258	248	328	13	1	80	0.0125000
NODE_25666_length_595_cov_52.532258	248	328	16	2	80	0.0250000
NODE_25666_length_595_cov_52.532258	248	328	17	5	80	0.0625000
NODE_25666_length_595_cov_52.532258	248	328	18	24	80	0.3000000
NODE_25666_length_595_cov_52.532258	248	328	19	14	80	0.1750000
NODE_25666_length_595_cov_52.532258	248	328	20	10	80	0.1250000
NODE_25666_length_595_cov_52.532258	248	328	21	1	80	0.0125000
NODE_25666_length_595_cov_52.532258	301	381	16	3	80	0.0375000
NODE_25666_length_595_cov_52.532258	301	381	17	10	80	0.1250000
NODE_25666_length_595_cov_52.532258	301	381	18	26	80	0.3250000
NODE_25666_length_595_cov_52.532258	301	381	19	2	80	0.0250000
NODE_25666_length_595_cov_52.532258	301	381	20	14	80	0.1750000
NODE_25666_length_595_cov_52.532258	301	381	21	3	80	0.0375000
NODE_25666_length_595_cov_52.532258	301	381	22	22	80	0.2750000
NODE_25667_length_595_cov_38.584677	122	202	5	17	80	0.2125000
NODE_25667_length_595_cov_38.584677	122	202	7	1	80	0.0125000
NODE_25667_length_595_cov_38.584677	122	202	8	5	80	0.0625000
NODE_25667_length_595_cov_38.584677	122	202	9	26	80	0.3250000
NODE_25667_length_595_cov_38.584677	122	202	10	8	80	0.1000000
NODE_25667_length_595_cov_38.584677	122	202	11	20	80	0.2500000
NODE_25667_length_595_cov_38.584677	122	202	12	1	80	0.0125000
NODE_25667_length_595_cov_38.584677	122	202	15	2	80	0.0250000
NODE_25667_length_595_cov_38.584677	175	255	9	9	80	0.1125000
NODE_25667_length_595_cov_38.584677	175	255	10	7	80	0.0875000
NODE_25667_length_595_cov_38.584677	175	255	11	8	80	0.1000000
NODE_25667_length_595_cov_38.584677	175	255	12	1	80	0.0125000
NODE_25667_length_595_cov_38.584677	175	255	14	30	80	0.3750000
NODE_25667_length_595_cov_38.584677	175	255	15	25	80	0.3125000
NODE_25669_length_595_cov_10.576613	323	403	0	16	80	0.2000000
NODE_25669_length_595_cov_10.576613	323	403	1	8	80	0.1000000
NODE_25669_length_595_cov_10.576613	323	403	2	56	80	0.7000000
NODE_25669_length_595_cov_10.576613	376	456	2	52	80	0.6500000
NODE_25669_length_595_cov_10.576613	376	456	3	8	80	0.1000000
NODE_25669_length_595_cov_10.576613	376	456	4	20	80	0.2500000
NODE_25672_length_595_cov_7.917339	342	415	0	73	73	1.0000000
NODE_25672_length_595_cov_7.917339	388	438	0	50	50	1.0000000
NODE_25702_length_595_cov_2.792339	178	258	0	80	80	1.0000000
NODE_25702_length_595_cov_2.792339	231	311	0	80	80	1.0000000
NODE_25807_length_594_cov_34.157576	283	363	0	2	80	0.0250000
NODE_25807_length_594_cov_34.157576	283	363	2	78	80	0.9750000
NODE_25807_length_594_cov_34.157576	336	416	0	32	80	0.4000000
NODE_25807_length_594_cov_34.157576	336	416	2	48	80	0.6000000
NODE_25811_length_594_cov_8.933333	258	338	0	24	80	0.3000000
NODE_25811_length_594_cov_8.933333	258	338	1	52	80	0.6500000
NODE_25811_length_594_cov_8.933333	258	338	2	4	80	0.0500000
NODE_25811_length_594_cov_8.933333	311	389	0	75	78	0.9615384
NODE_25811_length_594_cov_8.933333	311	389	1	3	78	0.0384615
NODE_25815_length_594_cov_5.759596	82	118	1	13	36	0.3611111
NODE_25815_length_594_cov_5.759596	82	118	2	23	36	0.6388889
NODE_25815_length_594_cov_5.759596	114	194	2	80	80	1.0000000
NODE_25815_length_594_cov_5.759596	167	242	1	17	75	0.2266667
NODE_25815_length_594_cov_5.759596	167	242	2	58	75	0.7733333
NODE_25825_length_594_cov_3.913131	275	355	0	9	80	0.1125000
NODE_25825_length_594_cov_3.913131	275	355	1	53	80	0.6625000
NODE_25825_length_594_cov_3.913131	275	355	2	18	80	0.2250000
NODE_25844_length_594_cov_2.470707	209	247	0	38	38	1.0000000
NODE_25919_length_594_cov_0.698990	33	73	0	40	40	1.0000000
NODE_25928_length_593_cov_124.985830	247	285	2	4	38	0.1052632
NODE_25928_length_593_cov_124.985830	247	285	3	19	38	0.5000000
NODE_25928_length_593_cov_124.985830	247	285	4	15	38	0.3947369
NODE_25929_length_593_cov_36.161943	150	230	8	6	80	0.0750000
NODE_25929_length_593_cov_36.161943	150	230	10	1	80	0.0125000
NODE_25929_length_593_cov_36.161943	150	230	11	4	80	0.0500000
NODE_25929_length_593_cov_36.161943	150	230	12	3	80	0.0375000
NODE_25929_length_593_cov_36.161943	150	230	13	15	80	0.1875000
NODE_25929_length_593_cov_36.161943	150	230	14	24	80	0.3000000
NODE_25929_length_593_cov_36.161943	150	230	15	17	80	0.2125000
NODE_25929_length_593_cov_36.161943	150	230	16	10	80	0.1250000
NODE_25929_length_593_cov_36.161943	203	283	14	40	80	0.5000000
NODE_25929_length_593_cov_36.161943	203	283	15	19	80	0.2375000
NODE_25929_length_593_cov_36.161943	203	283	16	19	80	0.2375000
NODE_25929_length_593_cov_36.161943	203	283	17	2	80	0.0250000
NODE_25930_length_593_cov_14.979757	219	299	0	80	80	1.0000000
NODE_25930_length_593_cov_14.979757	272	352	0	80	80	1.0000000
NODE_25931_length_593_cov_11.018219	324	404	1	75	80	0.9375000
NODE_25931_length_593_cov_11.018219	324	404	2	5	80	0.0625000
NODE_25931_length_593_cov_11.018219	377	457	0	22	80	0.2750000
NODE_25931_length_593_cov_11.018219	377	457	1	58	80	0.7250000
NODE_25946_length_593_cov_3.232794	210	273	0	63	63	1.0000000
NODE_25946_length_593_cov_3.232794	263	326	0	63	63	1.0000000
NODE_25996_length_593_cov_1.261134	227	249	0	22	22	1.0000000
NODE_26033_length_592_cov_18.908722	163	243	3	7	80	0.0875000
NODE_26033_length_592_cov_18.908722	163	243	4	4	80	0.0500000
NODE_26033_length_592_cov_18.908722	163	243	7	40	80	0.5000000
NODE_26033_length_592_cov_18.908722	163	243	8	29	80	0.3625000
NODE_26033_length_592_cov_18.908722	230	296	7	64	66	0.9696970
NODE_26033_length_592_cov_18.908722	230	296	8	2	66	0.0303030
NODE_26034_length_592_cov_7.531440	232	312	0	80	80	1.0000000
NODE_26034_length_592_cov_7.531440	285	361	0	76	76	1.0000000
NODE_26035_length_592_cov_7.000000	77	157	5	2	80	0.0250000
NODE_26035_length_592_cov_7.000000	77	157	6	3	80	0.0375000
NODE_26035_length_592_cov_7.000000	77	157	7	51	80	0.6375000
NODE_26035_length_592_cov_7.000000	77	157	9	2	80	0.0250000
NODE_26035_length_592_cov_7.000000	77	157	10	22	80	0.2750000
NODE_26035_length_592_cov_7.000000	130	210	7	3	80	0.0375000
NODE_26035_length_592_cov_7.000000	130	210	9	2	80	0.0250000
NODE_26035_length_592_cov_7.000000	130	210	10	75	80	0.9375000
NODE_26040_length_592_cov_5.036511	270	349	2	1	79	0.0126582
NODE_26040_length_592_cov_5.036511	270	349	3	78	79	0.9873418
NODE_26041_length_592_cov_5.024341	205	285	0	80	80	1.0000000
NODE_26041_length_592_cov_5.024341	258	309	0	30	51	0.5882353
NODE_26041_length_592_cov_5.024341	258	309	2	21	51	0.4117647
NODE_26062_length_592_cov_2.866126	61	127	1	66	66	1.0000000
NODE_26069_length_592_cov_2.361055	476	526	0	50	50	1.0000000
NODE_26142_length_591_cov_11.286585	245	325	2	80	80	1.0000000
NODE_26142_length_591_cov_11.286585	298	378	0	25	80	0.3125000
NODE_26142_length_591_cov_11.286585	298	378	2	55	80	0.6875000
NODE_26143_length_591_cov_9.432927	241	321	0	80	80	1.0000000
NODE_26143_length_591_cov_9.432927	294	374	0	80	80	1.0000000
NODE_26184_length_591_cov_2.365854	396	476	1	80	80	1.0000000
NODE_26184_length_591_cov_2.365854	449	529	0	34	80	0.4250000
NODE_26184_length_591_cov_2.365854	449	529	1	46	80	0.5750000
NODE_26272_length_590_cov_29.661914	26	106	0	25	80	0.3125000
NODE_26272_length_590_cov_29.661914	26	106	1	44	80	0.5500000
NODE_26272_length_590_cov_29.661914	26	106	4	7	80	0.0875000
NODE_26272_length_590_cov_29.661914	26	106	5	4	80	0.0500000
NODE_26272_length_590_cov_29.661914	79	159	1	16	80	0.2000000
NODE_26272_length_590_cov_29.661914	79	159	4	7	80	0.0875000
NODE_26272_length_590_cov_29.661914	79	159	5	57	80	0.7125000
NODE_26272_length_590_cov_29.661914	155	235	5	5	80	0.0625000
NODE_26272_length_590_cov_29.661914	155	235	6	16	80	0.2000000
NODE_26272_length_590_cov_29.661914	155	235	7	2	80	0.0250000
NODE_26272_length_590_cov_29.661914	155	235	8	34	80	0.4250000
NODE_26272_length_590_cov_29.661914	155	235	9	23	80	0.2875000
NODE_26272_length_590_cov_29.661914	208	288	4	36	80	0.4500000
NODE_26272_length_590_cov_29.661914	208	288	5	7	80	0.0875000
NODE_26272_length_590_cov_29.661914	208	288	8	37	80	0.4625000
NODE_26273_length_590_cov_21.360489	178	258	5	17	80	0.2125000
NODE_26273_length_590_cov_21.360489	178	258	6	37	80	0.4625000
NODE_26273_length_590_cov_21.360489	178	258	7	14	80	0.1750000
NODE_26273_length_590_cov_21.360489	178	258	8	7	80	0.0875000
NODE_26273_length_590_cov_21.360489	178	258	10	5	80	0.0625000
NODE_26273_length_590_cov_21.360489	231	311	4	43	80	0.5375000
NODE_26273_length_590_cov_21.360489	231	311	5	3	80	0.0375000
NODE_26273_length_590_cov_21.360489	231	311	6	33	80	0.4125000
NODE_26273_length_590_cov_21.360489	231	311	7	1	80	0.0125000
NODE_26274_length_590_cov_18.395112	161	241	3	60	80	0.7500000
NODE_26274_length_590_cov_18.395112	161	241	4	10	80	0.1250000
NODE_26274_length_590_cov_18.395112	161	241	5	10	80	0.1250000
NODE_26274_length_590_cov_18.395112	214	294	2	3	80	0.0375000
NODE_26274_length_590_cov_18.395112	214	294	3	20	80	0.2500000
NODE_26274_length_590_cov_18.395112	214	294	4	19	80	0.2375000
NODE_26274_length_590_cov_18.395112	214	294	5	38	80	0.4750000
NODE_26275_length_590_cov_17.376782	238	318	4	48	80	0.6000000
NODE_26275_length_590_cov_17.376782	238	318	6	32	80	0.4000000
NODE_26275_length_590_cov_17.376782	291	371	1	48	80	0.6000000
NODE_26275_length_590_cov_17.376782	291	371	3	3	80	0.0375000
NODE_26275_length_590_cov_17.376782	291	371	4	29	80	0.3625000
NODE_26279_length_590_cov_6.205703	262	333	0	38	71	0.5352113
NODE_26279_length_590_cov_6.205703	262	333	2	1	71	0.0140845
NODE_26279_length_590_cov_6.205703	262	333	3	1	71	0.0140845
NODE_26279_length_590_cov_6.205703	262	333	4	31	71	0.4366197
NODE_26283_length_590_cov_5.319756	224	304	7	1	80	0.0125000
NODE_26283_length_590_cov_5.319756	224	304	8	37	80	0.4625000
NODE_26283_length_590_cov_5.319756	224	304	10	42	80	0.5250000
NODE_26283_length_590_cov_5.319756	277	357	6	1	80	0.0125000
NODE_26283_length_590_cov_5.319756	277	357	8	40	80	0.5000000
NODE_26283_length_590_cov_5.319756	277	357	10	39	80	0.4875000
NODE_26366_length_590_cov_0.971487	0	32	0	32	32	1.0000000
NODE_26390_length_589_cov_15.810204	384	464	0	2	80	0.0250000
NODE_26390_length_589_cov_15.810204	384	464	2	74	80	0.9250000
NODE_26390_length_589_cov_15.810204	384	464	4	4	80	0.0500000
NODE_26390_length_589_cov_15.810204	437	517	0	55	80	0.6875000
NODE_26390_length_589_cov_15.810204	437	517	2	25	80	0.3125000
NODE_26391_length_589_cov_13.855102	320	400	8	9	80	0.1125000
NODE_26391_length_589_cov_13.855102	320	400	9	39	80	0.4875000
NODE_26391_length_589_cov_13.855102	320	400	10	32	80	0.4000000
NODE_26391_length_589_cov_13.855102	373	453	3	4	80	0.0500000
NODE_26391_length_589_cov_13.855102	373	453	5	3	80	0.0375000
NODE_26391_length_589_cov_13.855102	373	453	6	20	80	0.2500000
NODE_26391_length_589_cov_13.855102	373	453	7	15	80	0.1875000
NODE_26391_length_589_cov_13.855102	373	453	8	3	80	0.0375000
NODE_26391_length_589_cov_13.855102	373	453	9	8	80	0.1000000
NODE_26391_length_589_cov_13.855102	373	453	10	27	80	0.3375000
NODE_26395_length_589_cov_6.297959	186	266	0	40	80	0.5000000
NODE_26395_length_589_cov_6.297959	186	266	2	40	80	0.5000000
NODE_26395_length_589_cov_6.297959	239	319	2	80	80	1.0000000
NODE_26430_length_589_cov_2.320408	431	511	0	80	80	1.0000000
NODE_26515_length_588_cov_49.936605	264	341	2	37	77	0.4805195
NODE_26515_length_588_cov_49.936605	264	341	4	5	77	0.0649351
NODE_26515_length_588_cov_49.936605	264	341	6	1	77	0.0129870
NODE_26515_length_588_cov_49.936605	264	341	7	34	77	0.4415585
NODE_26515_length_588_cov_49.936605	314	394	7	80	80	1.0000000
NODE_26516_length_588_cov_33.691207	273	353	7	15	80	0.1875000
NODE_26516_length_588_cov_33.691207	273	353	8	3	80	0.0375000
NODE_26516_length_588_cov_33.691207	273	353	9	10	80	0.1250000
NODE_26516_length_588_cov_33.691207	273	353	10	2	80	0.0250000
NODE_26516_length_588_cov_33.691207	273	353	11	20	80	0.2500000
NODE_26516_length_588_cov_33.691207	273	353	12	17	80	0.2125000
NODE_26516_length_588_cov_33.691207	273	353	13	13	80	0.1625000
NODE_26516_length_588_cov_33.691207	326	406	11	12	80	0.1500000
NODE_26516_length_588_cov_33.691207	326	406	12	37	80	0.4625000
NODE_26516_length_588_cov_33.691207	326	406	13	25	80	0.3125000
NODE_26516_length_588_cov_33.691207	326	406	14	6	80	0.0750000
NODE_26517_length_588_cov_16.564417	245	325	5	34	80	0.4250000
NODE_26517_length_588_cov_16.564417	245	325	6	18	80	0.2250000
NODE_26517_length_588_cov_16.564417	245	325	8	2	80	0.0250000
NODE_26517_length_588_cov_16.564417	245	325	9	26	80	0.3250000
NODE_26517_length_588_cov_16.564417	298	378	0	12	80	0.1500000
NODE_26517_length_588_cov_16.564417	298	378	1	29	80	0.3625000
NODE_26517_length_588_cov_16.564417	298	378	5	39	80	0.4875000
NODE_26518_length_588_cov_14.595092	266	346	6	80	80	1.0000000
NODE_26518_length_588_cov_14.595092	319	399	0	9	80	0.1125000
NODE_26518_length_588_cov_14.595092	319	399	3	1	80	0.0125000
NODE_26518_length_588_cov_14.595092	319	399	4	15	80	0.1875000
NODE_26518_length_588_cov_14.595092	319	399	6	55	80	0.6875000
NODE_26522_length_588_cov_7.439673	155	235	0	80	80	1.0000000
NODE_26522_length_588_cov_7.439673	208	288	0	63	80	0.7875000
NODE_26522_length_588_cov_7.439673	208	288	1	17	80	0.2125000
NODE_26523_length_588_cov_7.094070	191	263	0	72	72	1.0000000
NODE_26523_length_588_cov_7.094070	244	310	0	66	66	1.0000000
NODE_26523_length_588_cov_7.094070	439	519	0	80	80	1.0000000
NODE_26523_length_588_cov_7.094070	492	572	0	80	80	1.0000000
NODE_26534_length_588_cov_4.167689	65	122	0	57	57	1.0000000
NODE_26634_length_587_cov_39.782787	123	203	2	1	80	0.0125000
NODE_26634_length_587_cov_39.782787	123	203	3	22	80	0.2750000
NODE_26634_length_587_cov_39.782787	123	203	4	23	80	0.2875000
NODE_26634_length_587_cov_39.782787	123	203	5	10	80	0.1250000
NODE_26634_length_587_cov_39.782787	123	203	6	24	80	0.3000000
NODE_26634_length_587_cov_39.782787	176	256	2	1	80	0.0125000
NODE_26634_length_587_cov_39.782787	176	256	3	22	80	0.2750000
NODE_26634_length_587_cov_39.782787	176	256	4	33	80	0.4125000
NODE_26634_length_587_cov_39.782787	176	256	5	10	80	0.1250000
NODE_26634_length_587_cov_39.782787	176	256	6	14	80	0.1750000
NODE_26634_length_587_cov_39.782787	252	332	4	26	80	0.3250000
NODE_26634_length_587_cov_39.782787	252	332	5	51	80	0.6375000
NODE_26634_length_587_cov_39.782787	252	332	6	3	80	0.0375000
NODE_26634_length_587_cov_39.782787	305	385	3	3	80	0.0375000
NODE_26634_length_587_cov_39.782787	305	385	4	30	80	0.3750000
NODE_26634_length_587_cov_39.782787	305	385	5	38	80	0.4750000
NODE_26634_length_587_cov_39.782787	305	385	6	9	80	0.1125000
NODE_26635_length_587_cov_31.807377	141	221	6	2	80	0.0250000
NODE_26635_length_587_cov_31.807377	141	221	7	37	80	0.4625000
NODE_26635_length_587_cov_31.807377	141	221	8	1	80	0.0125000
NODE_26635_length_587_cov_31.807377	141	221	9	40	80	0.5000000
NODE_26635_length_587_cov_31.807377	194	274	3	3	80	0.0375000
NODE_26635_length_587_cov_31.807377	194	274	5	7	80	0.0875000
NODE_26635_length_587_cov_31.807377	194	274	6	3	80	0.0375000
NODE_26635_length_587_cov_31.807377	194	274	7	4	80	0.0500000
NODE_26635_length_587_cov_31.807377	194	274	8	22	80	0.2750000
NODE_26635_length_587_cov_31.807377	194	274	9	41	80	0.5125000
NODE_26636_length_587_cov_12.629098	219	299	2	80	80	1.0000000
NODE_26636_length_587_cov_12.629098	272	352	0	24	80	0.3000000
NODE_26636_length_587_cov_12.629098	272	352	1	3	80	0.0375000
NODE_26636_length_587_cov_12.629098	272	352	2	53	80	0.6625000
NODE_26639_length_587_cov_9.067623	203	283	1	70	80	0.8750000
NODE_26639_length_587_cov_9.067623	203	283	2	10	80	0.1250000
NODE_26639_length_587_cov_9.067623	256	336	0	47	80	0.5875000
NODE_26639_length_587_cov_9.067623	256	336	1	33	80	0.4125000
NODE_26640_length_587_cov_8.411885	253	311	0	12	58	0.2068966
NODE_26640_length_587_cov_8.411885	253	311	1	46	58	0.7931035
NODE_26656_length_587_cov_3.231557	201	256	1	55	55	1.0000000
NODE_26665_length_587_cov_2.850410	255	288	2	33	33	1.0000000
NODE_26749_length_586_cov_37.843943	268	348	0	80	80	1.0000000
NODE_26749_length_586_cov_37.843943	321	401	0	80	80	1.0000000
NODE_26749_length_586_cov_37.843943	397	477	0	80	80	1.0000000
NODE_26749_length_586_cov_37.843943	450	531	0	81	81	1.0000000
NODE_26750_length_586_cov_12.831622	186	266	5	19	80	0.2375000
NODE_26750_length_586_cov_12.831622	186	266	6	40	80	0.5000000
NODE_26750_length_586_cov_12.831622	186	266	7	7	80	0.0875000
NODE_26750_length_586_cov_12.831622	186	266	10	8	80	0.1000000
NODE_26750_length_586_cov_12.831622	186	266	11	6	80	0.0750000
NODE_26750_length_586_cov_12.831622	239	319	6	6	80	0.0750000
NODE_26750_length_586_cov_12.831622	239	319	7	7	80	0.0875000
NODE_26750_length_586_cov_12.831622	239	319	8	1	80	0.0125000
NODE_26750_length_586_cov_12.831622	239	319	10	8	80	0.1000000
NODE_26750_length_586_cov_12.831622	239	319	11	26	80	0.3250000
NODE_26750_length_586_cov_12.831622	239	319	12	12	80	0.1500000
NODE_26750_length_586_cov_12.831622	239	319	13	20	80	0.2500000
NODE_26752_length_586_cov_11.264887	108	188	0	80	80	1.0000000
NODE_26752_length_586_cov_11.264887	161	241	0	80	80	1.0000000
NODE_26754_length_586_cov_9.624230	299	360	0	61	61	1.0000000
NODE_26754_length_586_cov_9.624230	299	360	0	61	61	1.0000000
NODE_26754_length_586_cov_9.624230	299	360	0	61	61	1.0000000
NODE_26754_length_586_cov_9.624230	301	360	0	59	59	1.0000000
NODE_26756_length_586_cov_8.591376	273	353	0	80	80	1.0000000
NODE_26756_length_586_cov_8.591376	326	406	0	80	80	1.0000000
NODE_26758_length_586_cov_6.135524	334	375	0	41	41	1.0000000
NODE_26758_length_586_cov_6.135524	334	375	0	41	41	1.0000000
NODE_26760_length_586_cov_5.634497	150	230	0	80	80	1.0000000
NODE_26760_length_586_cov_5.634497	203	283	0	80	80	1.0000000
NODE_26765_length_586_cov_4.626283	296	362	0	66	66	1.0000000
NODE_26765_length_586_cov_4.626283	453	533	1	2	80	0.0250000
NODE_26765_length_586_cov_4.626283	453	533	2	78	80	0.9750000
NODE_26885_length_585_cov_112.094650	456	536	27	7	80	0.0875000
NODE_26885_length_585_cov_112.094650	456	536	31	10	80	0.1250000
NODE_26885_length_585_cov_112.094650	456	536	32	11	80	0.1375000
NODE_26885_length_585_cov_112.094650	456	536	33	8	80	0.1000000
NODE_26885_length_585_cov_112.094650	456	536	34	36	80	0.4500000
NODE_26885_length_585_cov_112.094650	456	536	35	8	80	0.1000000
NODE_26885_length_585_cov_112.094650	509	585	3	1	76	0.0131579
NODE_26885_length_585_cov_112.094650	509	585	4	12	76	0.1578947
NODE_26885_length_585_cov_112.094650	509	585	5	16	76	0.2105263
NODE_26885_length_585_cov_112.094650	509	585	10	13	76	0.1710526
NODE_26885_length_585_cov_112.094650	509	585	11	7	76	0.0921053
NODE_26885_length_585_cov_112.094650	509	585	27	7	76	0.0921053
NODE_26885_length_585_cov_112.094650	509	585	31	10	76	0.1315790
NODE_26885_length_585_cov_112.094650	509	585	32	10	76	0.1315790
NODE_26886_length_585_cov_23.872428	168	248	9	16	80	0.2000000
NODE_26886_length_585_cov_23.872428	168	248	11	29	80	0.3625000
NODE_26886_length_585_cov_23.872428	168	248	12	1	80	0.0125000
NODE_26886_length_585_cov_23.872428	168	248	13	5	80	0.0625000
NODE_26886_length_585_cov_23.872428	168	248	14	2	80	0.0250000
NODE_26886_length_585_cov_23.872428	168	248	15	27	80	0.3375000
NODE_26886_length_585_cov_23.872428	222	301	9	26	79	0.3291139
NODE_26886_length_585_cov_23.872428	222	301	11	11	79	0.1392405
NODE_26886_length_585_cov_23.872428	222	301	12	16	79	0.2025317
NODE_26886_length_585_cov_23.872428	222	301	13	1	79	0.0126582
NODE_26886_length_585_cov_23.872428	222	301	14	2	79	0.0253165
NODE_26886_length_585_cov_23.872428	222	301	15	23	79	0.2911392
NODE_26887_length_585_cov_18.981481	360	440	0	14	80	0.1750000
NODE_26887_length_585_cov_18.981481	360	440	2	66	80	0.8250000
NODE_26887_length_585_cov_18.981481	413	493	2	80	80	1.0000000
NODE_26888_length_585_cov_13.967078	323	387	0	64	64	1.0000000
NODE_26889_length_585_cov_10.555556	229	309	0	80	80	1.0000000
NODE_26889_length_585_cov_10.555556	282	362	0	80	80	1.0000000
NODE_26891_length_585_cov_9.216049	233	313	3	13	80	0.1625000
NODE_26891_length_585_cov_9.216049	233	313	4	67	80	0.8375000
NODE_26891_length_585_cov_9.216049	286	366	3	45	80	0.5625000
NODE_26891_length_585_cov_9.216049	286	366	4	20	80	0.2500000
NODE_26891_length_585_cov_9.216049	286	366	5	15	80	0.1875000
NODE_26894_length_585_cov_8.090535	292	372	0	80	80	1.0000000
NODE_26894_length_585_cov_8.090535	345	425	0	80	80	1.0000000
NODE_26895_length_585_cov_8.018519	339	381	0	42	42	1.0000000
NODE_26895_length_585_cov_8.018519	354	419	0	65	65	1.0000000
NODE_26900_length_585_cov_4.954733	147	227	0	80	80	1.0000000
NODE_26912_length_585_cov_3.751029	288	368	0	80	80	1.0000000
NODE_26912_length_585_cov_3.751029	341	421	0	80	80	1.0000000
NODE_27019_length_584_cov_21.657732	57	137	3	34	80	0.4250000
NODE_27019_length_584_cov_21.657732	57	137	6	46	80	0.5750000
NODE_27019_length_584_cov_21.657732	110	190	6	35	80	0.4375000
NODE_27019_length_584_cov_21.657732	110	190	7	45	80	0.5625000
NODE_27020_length_584_cov_11.915464	280	360	5	57	80	0.7125000
NODE_27020_length_584_cov_11.915464	280	360	6	9	80	0.1125000
NODE_27020_length_584_cov_11.915464	280	360	7	14	80	0.1750000
NODE_27020_length_584_cov_11.915464	333	413	5	73	80	0.9125000
NODE_27020_length_584_cov_11.915464	333	413	6	7	80	0.0875000
NODE_27021_length_584_cov_11.197938	217	297	2	80	80	1.0000000
NODE_27021_length_584_cov_11.197938	270	350	2	72	80	0.9000000
NODE_27021_length_584_cov_11.197938	270	350	3	1	80	0.0125000
NODE_27021_length_584_cov_11.197938	270	350	4	7	80	0.0875000
NODE_27022_length_584_cov_9.824742	375	441	0	66	66	1.0000000
NODE_27022_length_584_cov_9.824742	375	441	0	66	66	1.0000000
NODE_27023_length_584_cov_9.160825	369	449	4	22	80	0.2750000
NODE_27023_length_584_cov_9.160825	369	449	5	27	80	0.3375000
NODE_27023_length_584_cov_9.160825	369	449	6	31	80	0.3875000
NODE_27023_length_584_cov_9.160825	422	502	2	45	80	0.5625000
NODE_27023_length_584_cov_9.160825	422	502	4	26	80	0.3250000
NODE_27023_length_584_cov_9.160825	422	502	5	9	80	0.1125000
NODE_27023_length_584_cov_9.160825	422	502	2	45	80	0.5625000
NODE_27023_length_584_cov_9.160825	422	502	4	26	80	0.3250000
NODE_27023_length_584_cov_9.160825	422	502	5	9	80	0.1125000
NODE_27026_length_584_cov_7.736082	51	131	5	1	80	0.0125000
NODE_27026_length_584_cov_7.736082	51	131	6	2	80	0.0250000
NODE_27026_length_584_cov_7.736082	51	131	8	77	80	0.9625000
NODE_27026_length_584_cov_7.736082	104	184	4	19	80	0.2375000
NODE_27026_length_584_cov_7.736082	104	184	5	2	80	0.0250000
NODE_27026_length_584_cov_7.736082	104	184	6	2	80	0.0250000
NODE_27026_length_584_cov_7.736082	104	184	7	26	80	0.3250000
NODE_27026_length_584_cov_7.736082	104	184	8	31	80	0.3875000
NODE_27031_length_584_cov_7.113402	213	293	0	28	80	0.3500000
NODE_27031_length_584_cov_7.113402	213	293	2	52	80	0.6500000
NODE_27031_length_584_cov_7.113402	266	346	2	80	80	1.0000000
NODE_27035_length_584_cov_5.843299	281	341	1	2	60	0.0333333
NODE_27035_length_584_cov_5.843299	281	341	2	58	60	0.9666666
NODE_27039_length_584_cov_5.032990	240	320	0	22	80	0.2750000
NODE_27039_length_584_cov_5.032990	240	320	1	18	80	0.2250000
NODE_27039_length_584_cov_5.032990	240	320	2	40	80	0.5000000
NODE_27039_length_584_cov_5.032990	293	373	2	80	80	1.0000000
NODE_27061_length_584_cov_2.707216	186	257	0	71	71	1.0000000
NODE_27147_length_583_cov_7.973140	232	312	1	28	80	0.3500000
NODE_27147_length_583_cov_7.973140	232	312	2	52	80	0.6500000
NODE_27147_length_583_cov_7.973140	285	365	0	33	80	0.4125000
NODE_27147_length_583_cov_7.973140	285	365	1	47	80	0.5875000
NODE_27148_length_583_cov_6.731405	328	408	10	34	80	0.4250000
NODE_27148_length_583_cov_6.731405	328	408	11	7	80	0.0875000
NODE_27148_length_583_cov_6.731405	328	408	12	19	80	0.2375000
NODE_27148_length_583_cov_6.731405	328	408	14	20	80	0.2500000
NODE_27148_length_583_cov_6.731405	381	461	7	7	80	0.0875000
NODE_27148_length_583_cov_6.731405	381	461	8	39	80	0.4875000
NODE_27148_length_583_cov_6.731405	381	461	9	1	80	0.0125000
NODE_27148_length_583_cov_6.731405	381	461	10	33	80	0.4125000
NODE_27149_length_583_cov_6.363636	161	231	0	70	70	1.0000000
NODE_27152_length_583_cov_5.766529	132	186	0	54	54	1.0000000
NODE_27263_length_583_cov_0.762397	9	50	0	41	41	1.0000000
NODE_27278_length_582_cov_74.269151	295	375	7	15	80	0.1875000
NODE_27278_length_582_cov_74.269151	295	375	8	12	80	0.1500000
NODE_27278_length_582_cov_74.269151	295	375	10	20	80	0.2500000
NODE_27278_length_582_cov_74.269151	295	375	11	1	80	0.0125000
NODE_27278_length_582_cov_74.269151	295	375	12	19	80	0.2375000
NODE_27278_length_582_cov_74.269151	295	375	13	11	80	0.1375000
NODE_27278_length_582_cov_74.269151	295	375	14	2	80	0.0250000
NODE_27278_length_582_cov_74.269151	348	428	11	15	80	0.1875000
NODE_27278_length_582_cov_74.269151	348	428	12	32	80	0.4000000
NODE_27278_length_582_cov_74.269151	348	428	13	31	80	0.3875000
NODE_27278_length_582_cov_74.269151	348	428	14	2	80	0.0250000
NODE_27279_length_582_cov_53.093168	11	91	0	33	80	0.4125000
NODE_27279_length_582_cov_53.093168	11	91	1	31	80	0.3875000
NODE_27279_length_582_cov_53.093168	11	91	3	3	80	0.0375000
NODE_27279_length_582_cov_53.093168	11	91	4	13	80	0.1625000
NODE_27279_length_582_cov_53.093168	64	144	1	11	80	0.1375000
NODE_27279_length_582_cov_53.093168	64	144	3	3	80	0.0375000
NODE_27279_length_582_cov_53.093168	64	144	4	24	80	0.3000000
NODE_27279_length_582_cov_53.093168	64	144	6	42	80	0.5250000
NODE_27279_length_582_cov_53.093168	140	220	5	23	80	0.2875000
NODE_27279_length_582_cov_53.093168	140	220	6	57	80	0.7125000
NODE_27279_length_582_cov_53.093168	193	273	0	18	80	0.2250000
NODE_27279_length_582_cov_53.093168	193	273	2	24	80	0.3000000
NODE_27279_length_582_cov_53.093168	193	273	3	3	80	0.0375000
NODE_27279_length_582_cov_53.093168	193	273	5	31	80	0.3875000
NODE_27279_length_582_cov_53.093168	193	273	6	4	80	0.0500000
NODE_27280_length_582_cov_47.393375	345	425	14	15	80	0.1875000
NODE_27280_length_582_cov_47.393375	345	425	16	51	80	0.6375000
NODE_27280_length_582_cov_47.393375	345	425	19	14	80	0.1750000
NODE_27280_length_582_cov_47.393375	398	478	14	13	80	0.1625000
NODE_27280_length_582_cov_47.393375	398	478	15	34	80	0.4250000
NODE_27280_length_582_cov_47.393375	398	478	16	29	80	0.3625000
NODE_27280_length_582_cov_47.393375	398	478	17	4	80	0.0500000
NODE_27281_length_582_cov_16.358178	297	377	2	59	80	0.7375000
NODE_27281_length_582_cov_16.358178	297	377	3	1	80	0.0125000
NODE_27281_length_582_cov_16.358178	297	377	4	20	80	0.2500000
NODE_27281_length_582_cov_16.358178	350	431	2	6	81	0.0740741
NODE_27281_length_582_cov_16.358178	350	431	3	1	81	0.0123457
NODE_27281_length_582_cov_16.358178	350	431	4	74	81	0.9135802
NODE_27282_length_582_cov_14.107660	128	208	3	80	80	1.0000000
NODE_27282_length_582_cov_14.107660	181	261	0	25	80	0.3125000
NODE_27282_length_582_cov_14.107660	181	261	3	55	80	0.6875000
NODE_27283_length_582_cov_7.923395	208	287	5	4	79	0.0506329
NODE_27283_length_582_cov_7.923395	208	287	6	16	79	0.2025317
NODE_27283_length_582_cov_7.923395	208	287	7	59	79	0.7468355
NODE_27283_length_582_cov_7.923395	262	340	2	24	78	0.3076923
NODE_27283_length_582_cov_7.923395	262	340	3	2	78	0.0256410
NODE_27283_length_582_cov_7.923395	262	340	5	16	78	0.2051282
NODE_27283_length_582_cov_7.923395	262	340	7	36	78	0.4615385
NODE_27284_length_582_cov_7.722567	216	296	0	80	80	1.0000000
NODE_27284_length_582_cov_7.722567	269	349	0	80	80	1.0000000
NODE_27289_length_582_cov_4.956522	294	325	3	31	31	1.0000000
NODE_27295_length_582_cov_4.308489	151	192	0	41	41	1.0000000
NODE_27297_length_582_cov_3.838509	223	299	0	76	76	1.0000000
NODE_27297_length_582_cov_3.838509	272	354	0	82	82	1.0000000
NODE_27350_length_582_cov_1.650104	375	450	0	75	75	1.0000000
NODE_27405_length_581_cov_16.890041	244	316	1	35	72	0.4861111
NODE_27405_length_581_cov_16.890041	244	316	2	37	72	0.5138889
NODE_27413_length_581_cov_6.340249	262	342	0	80	80	1.0000000
NODE_27413_length_581_cov_6.340249	315	395	0	80	80	1.0000000
NODE_27416_length_581_cov_5.827801	122	192	0	70	70	1.0000000
NODE_27420_length_581_cov_5.072614	392	466	0	74	74	1.0000000
NODE_27420_length_581_cov_5.072614	424	444	0	20	20	1.0000000
NODE_27464_length_581_cov_1.881743	474	538	0	64	64	1.0000000
NODE_27541_length_580_cov_39.353430	358	438	4	11	80	0.1375000
NODE_27541_length_580_cov_39.353430	358	438	6	5	80	0.0625000
NODE_27541_length_580_cov_39.353430	358	438	7	43	80	0.5375000
NODE_27541_length_580_cov_39.353430	358	438	8	11	80	0.1375000
NODE_27541_length_580_cov_39.353430	358	438	9	4	80	0.0500000
NODE_27541_length_580_cov_39.353430	358	438	10	6	80	0.0750000
NODE_27541_length_580_cov_39.353430	411	491	5	9	80	0.1125000
NODE_27541_length_580_cov_39.353430	411	491	7	47	80	0.5875000
NODE_27541_length_580_cov_39.353430	411	491	8	14	80	0.1750000
NODE_27541_length_580_cov_39.353430	411	491	9	4	80	0.0500000
NODE_27541_length_580_cov_39.353430	411	491	10	6	80	0.0750000
NODE_27541_length_580_cov_39.353430	487	567	3	3	80	0.0375000
NODE_27541_length_580_cov_39.353430	487	567	5	45	80	0.5625000
NODE_27541_length_580_cov_39.353430	487	567	7	32	80	0.4000000
NODE_27541_length_580_cov_39.353430	487	567	3	3	80	0.0375000
NODE_27541_length_580_cov_39.353430	487	567	5	45	80	0.5625000
NODE_27541_length_580_cov_39.353430	487	567	7	32	80	0.4000000
NODE_27541_length_580_cov_39.353430	487	567	3	3	80	0.0375000
NODE_27541_length_580_cov_39.353430	487	567	5	45	80	0.5625000
NODE_27541_length_580_cov_39.353430	487	567	7	32	80	0.4000000
NODE_27541_length_580_cov_39.353430	487	567	3	3	80	0.0375000
NODE_27541_length_580_cov_39.353430	487	567	5	45	80	0.5625000
NODE_27541_length_580_cov_39.353430	487	567	7	32	80	0.4000000
NODE_27541_length_580_cov_39.353430	487	567	3	3	80	0.0375000
NODE_27541_length_580_cov_39.353430	487	567	5	45	80	0.5625000
NODE_27541_length_580_cov_39.353430	487	567	7	32	80	0.4000000
NODE_27541_length_580_cov_39.353430	487	567	3	3	80	0.0375000
NODE_27541_length_580_cov_39.353430	487	567	5	45	80	0.5625000
NODE_27541_length_580_cov_39.353430	487	567	7	32	80	0.4000000
NODE_27544_length_580_cov_8.925156	198	238	0	40	40	1.0000000
NODE_27544_length_580_cov_8.925156	258	338	0	67	80	0.8375000
NODE_27544_length_580_cov_8.925156	258	338	5	13	80	0.1625000
NODE_27545_length_580_cov_8.634096	197	277	0	51	80	0.6375000
NODE_27545_length_580_cov_8.634096	197	277	1	29	80	0.3625000
NODE_27545_length_580_cov_8.634096	250	330	0	80	80	1.0000000
NODE_27551_length_580_cov_6.291060	356	398	0	42	42	1.0000000
NODE_27554_length_580_cov_5.494802	110	190	6	61	80	0.7625000
NODE_27554_length_580_cov_5.494802	110	190	7	19	80	0.2375000
NODE_27554_length_580_cov_5.494802	163	243	6	8	80	0.1000000
NODE_27554_length_580_cov_5.494802	163	243	7	66	80	0.8250000
NODE_27554_length_580_cov_5.494802	163	243	8	6	80	0.0750000
NODE_27559_length_580_cov_4.563410	231	292	0	61	61	1.0000000
NODE_27559_length_580_cov_4.563410	322	357	0	35	35	1.0000000
NODE_27590_length_580_cov_2.264033	215	277	0	62	62	1.0000000
NODE_27597_length_580_cov_2.116424	265	345	2	80	80	1.0000000
NODE_27659_length_579_cov_24.231250	159	239	7	1	80	0.0125000
NODE_27659_length_579_cov_24.231250	159	239	8	19	80	0.2375000
NODE_27659_length_579_cov_24.231250	159	239	9	12	80	0.1500000
NODE_27659_length_579_cov_24.231250	159	239	10	43	80	0.5375000
NODE_27659_length_579_cov_24.231250	159	239	11	5	80	0.0625000
NODE_27659_length_579_cov_24.231250	212	287	4	10	75	0.1333333
NODE_27659_length_579_cov_24.231250	212	287	6	1	75	0.0133333
NODE_27659_length_579_cov_24.231250	212	287	7	38	75	0.5066667
NODE_27659_length_579_cov_24.231250	212	287	8	19	75	0.2533333
NODE_27659_length_579_cov_24.231250	212	287	10	7	75	0.0933333
NODE_27660_length_579_cov_12.602083	246	326	3	53	80	0.6625000
NODE_27660_length_579_cov_12.602083	246	326	4	27	80	0.3375000
NODE_27660_length_579_cov_12.602083	299	377	3	11	78	0.1410256
NODE_27660_length_579_cov_12.602083	299	377	4	67	78	0.8589743
NODE_27663_length_579_cov_9.195833	254	334	1	69	80	0.8625000
NODE_27663_length_579_cov_9.195833	254	334	2	11	80	0.1375000
NODE_27663_length_579_cov_9.195833	307	387	1	30	80	0.3750000
NODE_27663_length_579_cov_9.195833	307	387	2	50	80	0.6250000
NODE_27663_length_579_cov_9.195833	383	463	1	80	80	1.0000000
NODE_27664_length_579_cov_6.600000	169	249	0	80	80	1.0000000
NODE_27664_length_579_cov_6.600000	222	302	0	54	80	0.6750000
NODE_27664_length_579_cov_6.600000	222	302	1	26	80	0.3250000
NODE_27667_length_579_cov_5.956250	225	295	0	2	70	0.0285714
NODE_27667_length_579_cov_5.956250	225	295	2	68	70	0.9714286
NODE_27667_length_579_cov_5.956250	279	316	0	23	37	0.6216216
NODE_27667_length_579_cov_5.956250	279	316	2	14	37	0.3783784
NODE_27674_length_579_cov_4.850000	105	185	0	18	80	0.2250000
NODE_27674_length_579_cov_4.850000	105	185	1	50	80	0.6250000
NODE_27674_length_579_cov_4.850000	105	185	2	12	80	0.1500000
NODE_27674_length_579_cov_4.850000	158	238	1	15	80	0.1875000
NODE_27674_length_579_cov_4.850000	158	238	2	65	80	0.8125000
NODE_27688_length_579_cov_3.291667	290	343	0	53	53	1.0000000
NODE_27695_length_579_cov_2.420833	251	331	0	80	80	1.0000000
NODE_27695_length_579_cov_2.420833	304	384	0	80	80	1.0000000
NODE_27724_length_579_cov_1.435417	463	497	0	34	34	1.0000000
NODE_27781_length_578_cov_70.192067	100	180	0	45	80	0.5625000
NODE_27781_length_578_cov_70.192067	100	180	1	35	80	0.4375000
NODE_27781_length_578_cov_70.192067	153	233	1	59	80	0.7375000
NODE_27781_length_578_cov_70.192067	153	233	2	21	80	0.2625000
NODE_27782_length_578_cov_51.676409	129	209	9	2	80	0.0250000
NODE_27782_length_578_cov_51.676409	129	209	14	7	80	0.0875000
NODE_27782_length_578_cov_51.676409	129	209	15	45	80	0.5625000
NODE_27782_length_578_cov_51.676409	129	209	16	26	80	0.3250000
NODE_27782_length_578_cov_51.676409	182	262	12	2	80	0.0250000
NODE_27782_length_578_cov_51.676409	182	262	13	6	80	0.0750000
NODE_27782_length_578_cov_51.676409	182	262	14	2	80	0.0250000
NODE_27782_length_578_cov_51.676409	182	262	15	37	80	0.4625000
NODE_27782_length_578_cov_51.676409	182	262	16	12	80	0.1500000
NODE_27782_length_578_cov_51.676409	182	262	17	1	80	0.0125000
NODE_27782_length_578_cov_51.676409	182	262	18	20	80	0.2500000
NODE_27783_length_578_cov_32.152401	310	390	14	5	80	0.0625000
NODE_27783_length_578_cov_32.152401	310	390	15	54	80	0.6750000
NODE_27783_length_578_cov_32.152401	310	390	16	4	80	0.0500000
NODE_27783_length_578_cov_32.152401	310	390	17	4	80	0.0500000
NODE_27783_length_578_cov_32.152401	310	390	18	13	80	0.1625000
NODE_27783_length_578_cov_32.152401	363	443	8	23	80	0.2875000
NODE_27783_length_578_cov_32.152401	363	443	9	10	80	0.1250000
NODE_27783_length_578_cov_32.152401	363	443	12	15	80	0.1875000
NODE_27783_length_578_cov_32.152401	363	443	13	3	80	0.0375000
NODE_27783_length_578_cov_32.152401	363	443	14	6	80	0.0750000
NODE_27783_length_578_cov_32.152401	363	443	15	23	80	0.2875000
NODE_27784_length_578_cov_30.484342	215	295	2	43	80	0.5375000
NODE_27784_length_578_cov_30.484342	215	295	3	28	80	0.3500000
NODE_27784_length_578_cov_30.484342	215	295	4	9	80	0.1125000
NODE_27784_length_578_cov_30.484342	268	348	1	21	80	0.2625000
NODE_27784_length_578_cov_30.484342	268	348	2	21	80	0.2625000
NODE_27784_length_578_cov_30.484342	268	348	3	38	80	0.4750000
NODE_27785_length_578_cov_15.983299	213	265	1	52	52	1.0000000
NODE_27786_length_578_cov_14.968685	147	227	0	41	80	0.5125000
NODE_27786_length_578_cov_14.968685	147	227	1	22	80	0.2750000
NODE_27786_length_578_cov_14.968685	147	227	2	17	80	0.2125000
NODE_27786_length_578_cov_14.968685	200	280	1	10	80	0.1250000
NODE_27786_length_578_cov_14.968685	200	280	2	70	80	0.8750000
NODE_27787_length_578_cov_9.567850	273	328	3	18	55	0.3272727
NODE_27787_length_578_cov_9.567850	273	328	4	37	55	0.6727273
NODE_27792_length_578_cov_6.670146	273	353	1	36	80	0.4500000
NODE_27792_length_578_cov_6.670146	273	353	4	44	80	0.5500000
NODE_27792_length_578_cov_6.670146	326	406	3	4	80	0.0500000
NODE_27792_length_578_cov_6.670146	326	406	4	76	80	0.9500000
NODE_27793_length_578_cov_6.465553	320	400	0	8	80	0.1000000
NODE_27793_length_578_cov_6.465553	320	400	4	8	80	0.1000000
NODE_27793_length_578_cov_6.465553	320	400	5	40	80	0.5000000
NODE_27793_length_578_cov_6.465553	320	400	6	24	80	0.3000000
NODE_27793_length_578_cov_6.465553	373	453	5	34	80	0.4250000
NODE_27793_length_578_cov_6.465553	373	453	6	46	80	0.5750000
NODE_27863_length_578_cov_1.480167	185	265	0	80	80	1.0000000
NODE_27863_length_578_cov_1.480167	238	318	0	80	80	1.0000000
NODE_27935_length_577_cov_11.638075	312	392	0	80	80	1.0000000
NODE_27942_length_577_cov_4.912134	218	249	3	26	31	0.8387097
NODE_27942_length_577_cov_4.912134	218	249	4	5	31	0.1612903
NODE_27942_length_577_cov_4.912134	301	330	1	12	29	0.4137931
NODE_27942_length_577_cov_4.912134	301	330	2	17	29	0.5862069
NODE_27961_length_577_cov_2.970711	78	126	0	48	48	1.0000000
NODE_27968_length_577_cov_2.631799	169	253	0	84	84	1.0000000
NODE_27968_length_577_cov_2.631799	226	269	0	43	43	1.0000000
NODE_28003_length_577_cov_1.468619	71	146	0	75	75	1.0000000
NODE_28003_length_577_cov_1.468619	119	199	0	80	80	1.0000000
NODE_28058_length_576_cov_10.903564	194	274	2	8	80	0.1000000
NODE_28058_length_576_cov_10.903564	194	274	3	24	80	0.3000000
NODE_28058_length_576_cov_10.903564	194	274	4	48	80	0.6000000
NODE_28059_length_576_cov_9.039832	271	351	0	80	80	1.0000000
NODE_28059_length_576_cov_9.039832	324	404	0	80	80	1.0000000
NODE_28060_length_576_cov_8.490566	338	418	6	14	80	0.1750000
NODE_28060_length_576_cov_8.490566	338	418	7	38	80	0.4750000
NODE_28060_length_576_cov_8.490566	338	418	8	6	80	0.0750000
NODE_28060_length_576_cov_8.490566	338	418	9	22	80	0.2750000
NODE_28060_length_576_cov_8.490566	391	471	5	50	80	0.6250000
NODE_28060_length_576_cov_8.490566	391	471	6	7	80	0.0875000
NODE_28060_length_576_cov_8.490566	391	471	8	4	80	0.0500000
NODE_28060_length_576_cov_8.490566	391	471	9	19	80	0.2375000
NODE_28061_length_576_cov_7.002096	157	237	0	69	80	0.8625000
NODE_28061_length_576_cov_7.002096	157	237	1	11	80	0.1375000
NODE_28061_length_576_cov_7.002096	210	290	0	16	80	0.2000000
NODE_28061_length_576_cov_7.002096	210	290	1	64	80	0.8000000
NODE_28076_length_576_cov_3.322851	118	183	0	65	65	1.0000000
NODE_28102_length_576_cov_1.964361	148	228	0	16	80	0.2000000
NODE_28102_length_576_cov_1.964361	148	228	1	36	80	0.4500000
NODE_28102_length_576_cov_1.964361	148	228	2	28	80	0.3500000
NODE_28102_length_576_cov_1.964361	201	281	2	80	80	1.0000000
NODE_28104_length_576_cov_1.951782	159	239	1	67	80	0.8375000
NODE_28104_length_576_cov_1.951782	159	239	2	13	80	0.1625000
NODE_28104_length_576_cov_1.951782	212	292	1	14	80	0.1750000
NODE_28104_length_576_cov_1.951782	212	292	2	66	80	0.8250000
NODE_28116_length_576_cov_1.584906	381	455	0	27	74	0.3648649
NODE_28116_length_576_cov_1.584906	381	455	2	47	74	0.6351351
NODE_28179_length_575_cov_15.319328	319	399	6	51	80	0.6375000
NODE_28179_length_575_cov_15.319328	319	399	7	10	80	0.1250000
NODE_28179_length_575_cov_15.319328	319	399	8	10	80	0.1250000
NODE_28179_length_575_cov_15.319328	319	399	9	9	80	0.1125000
NODE_28179_length_575_cov_15.319328	372	452	6	8	80	0.1000000
NODE_28179_length_575_cov_15.319328	372	452	8	63	80	0.7875000
NODE_28179_length_575_cov_15.319328	372	452	9	9	80	0.1125000
NODE_28181_length_575_cov_8.254202	286	366	1	8	80	0.1000000
NODE_28181_length_575_cov_8.254202	286	366	2	17	80	0.2125000
NODE_28181_length_575_cov_8.254202	286	366	3	16	80	0.2000000
NODE_28181_length_575_cov_8.254202	286	366	4	39	80	0.4875000
NODE_28181_length_575_cov_8.254202	339	419	3	32	80	0.4000000
NODE_28181_length_575_cov_8.254202	339	419	4	48	80	0.6000000
NODE_28182_length_575_cov_7.558824	300	380	0	80	80	1.0000000
NODE_28313_length_574_cov_6.282105	185	265	3	80	80	1.0000000
NODE_28313_length_574_cov_6.282105	238	318	0	36	80	0.4500000
NODE_28313_length_574_cov_6.282105	238	318	3	44	80	0.5500000
NODE_28330_length_574_cov_2.993684	215	234	1	19	19	1.0000000
NODE_28438_length_573_cov_53.668776	393	473	30	14	80	0.1750000
NODE_28438_length_573_cov_53.668776	393	473	31	53	80	0.6625000
NODE_28438_length_573_cov_53.668776	393	473	32	13	80	0.1625000
NODE_28438_length_573_cov_53.668776	446	526	9	2	80	0.0250000
NODE_28438_length_573_cov_53.668776	446	526	10	7	80	0.0875000
NODE_28438_length_573_cov_53.668776	446	526	11	1	80	0.0125000
NODE_28438_length_573_cov_53.668776	446	526	23	2	80	0.0250000
NODE_28438_length_573_cov_53.668776	446	526	24	6	80	0.0750000
NODE_28438_length_573_cov_53.668776	446	526	26	8	80	0.1000000
NODE_28438_length_573_cov_53.668776	446	526	29	19	80	0.2375000
NODE_28438_length_573_cov_53.668776	446	526	30	22	80	0.2750000
NODE_28438_length_573_cov_53.668776	446	526	31	13	80	0.1625000
NODE_28439_length_573_cov_30.658228	451	531	0	80	80	1.0000000
NODE_28440_length_573_cov_30.116034	435	515	6	12	80	0.1500000
NODE_28440_length_573_cov_30.116034	435	515	7	7	80	0.0875000
NODE_28440_length_573_cov_30.116034	435	515	8	49	80	0.6125000
NODE_28440_length_573_cov_30.116034	435	515	10	1	80	0.0125000
NODE_28440_length_573_cov_30.116034	435	515	11	11	80	0.1375000
NODE_28440_length_573_cov_30.116034	488	568	1	2	80	0.0250000
NODE_28440_length_573_cov_30.116034	488	568	2	18	80	0.2250000
NODE_28440_length_573_cov_30.116034	488	568	5	6	80	0.0750000
NODE_28440_length_573_cov_30.116034	488	568	6	39	80	0.4875000
NODE_28440_length_573_cov_30.116034	488	568	7	7	80	0.0875000
NODE_28440_length_573_cov_30.116034	488	568	8	8	80	0.1000000
NODE_28441_length_573_cov_24.234177	210	290	13	3	80	0.0375000
NODE_28441_length_573_cov_24.234177	210	290	15	2	80	0.0250000
NODE_28441_length_573_cov_24.234177	210	290	18	12	80	0.1500000
NODE_28441_length_573_cov_24.234177	210	290	19	1	80	0.0125000
NODE_28441_length_573_cov_24.234177	210	290	20	25	80	0.3125000
NODE_28441_length_573_cov_24.234177	210	290	21	32	80	0.4000000
NODE_28441_length_573_cov_24.234177	210	290	23	5	80	0.0625000
NODE_28441_length_573_cov_24.234177	263	343	11	25	80	0.3125000
NODE_28441_length_573_cov_24.234177	263	343	12	1	80	0.0125000
NODE_28441_length_573_cov_24.234177	263	343	13	5	80	0.0625000
NODE_28441_length_573_cov_24.234177	263	343	21	49	80	0.6125000
NODE_28442_length_573_cov_13.464135	278	358	7	24	80	0.3000000
NODE_28442_length_573_cov_13.464135	278	358	9	10	80	0.1250000
NODE_28442_length_573_cov_13.464135	278	358	10	11	80	0.1375000
NODE_28442_length_573_cov_13.464135	278	358	12	3	80	0.0375000
NODE_28442_length_573_cov_13.464135	278	358	13	20	80	0.2500000
NODE_28442_length_573_cov_13.464135	278	358	15	12	80	0.1500000
NODE_28442_length_573_cov_13.464135	331	411	13	73	80	0.9125000
NODE_28442_length_573_cov_13.464135	331	411	15	7	80	0.0875000
NODE_28443_length_573_cov_8.761603	124	204	3	3	80	0.0375000
NODE_28443_length_573_cov_8.761603	124	204	4	24	80	0.3000000
NODE_28443_length_573_cov_8.761603	124	204	7	4	80	0.0500000
NODE_28443_length_573_cov_8.761603	124	204	9	49	80	0.6125000
NODE_28443_length_573_cov_8.761603	177	257	6	5	80	0.0625000
NODE_28443_length_573_cov_8.761603	177	257	7	11	80	0.1375000
NODE_28443_length_573_cov_8.761603	177	257	9	40	80	0.5000000
NODE_28443_length_573_cov_8.761603	177	257	10	2	80	0.0250000
NODE_28443_length_573_cov_8.761603	177	257	11	8	80	0.1000000
NODE_28443_length_573_cov_8.761603	177	257	12	14	80	0.1750000
NODE_28456_length_573_cov_3.364979	365	398	5	33	33	1.0000000
NODE_28565_length_572_cov_17.530655	312	392	6	19	80	0.2375000
NODE_28565_length_572_cov_17.530655	312	392	7	61	80	0.7625000
NODE_28565_length_572_cov_17.530655	365	445	1	4	80	0.0500000
NODE_28565_length_572_cov_17.530655	365	445	3	7	80	0.0875000
NODE_28565_length_572_cov_17.530655	365	445	4	8	80	0.1000000
NODE_28565_length_572_cov_17.530655	365	445	5	24	80	0.3000000
NODE_28565_length_572_cov_17.530655	365	445	6	16	80	0.2000000
NODE_28565_length_572_cov_17.530655	365	445	7	21	80	0.2625000
NODE_28567_length_572_cov_8.059197	250	321	11	8	71	0.1126761
NODE_28567_length_572_cov_8.059197	250	321	13	1	71	0.0140845
NODE_28567_length_572_cov_8.059197	250	321	14	3	71	0.0422535
NODE_28567_length_572_cov_8.059197	250	321	15	20	71	0.2816902
NODE_28567_length_572_cov_8.059197	250	321	16	39	71	0.5492958
NODE_28568_length_572_cov_7.873150	134	214	0	80	80	1.0000000
NODE_28568_length_572_cov_7.873150	187	267	0	80	80	1.0000000
NODE_28570_length_572_cov_6.706131	365	445	0	80	80	1.0000000
NODE_28570_length_572_cov_6.706131	418	498	0	80	80	1.0000000
NODE_28573_length_572_cov_5.625793	137	217	0	36	80	0.4500000
NODE_28573_length_572_cov_5.625793	137	217	2	44	80	0.5500000
NODE_28573_length_572_cov_5.625793	190	270	2	80	80	1.0000000
NODE_28574_length_572_cov_5.617336	331	401	0	33	70	0.4714286
NODE_28574_length_572_cov_5.617336	331	401	2	37	70	0.5285714
NODE_28578_length_572_cov_4.596195	212	288	0	76	76	1.0000000
NODE_28578_length_572_cov_4.596195	261	341	0	80	80	1.0000000
NODE_28585_length_572_cov_3.843552	210	290	8	24	80	0.3000000
NODE_28585_length_572_cov_3.843552	210	290	11	34	80	0.4250000
NODE_28585_length_572_cov_3.843552	210	290	12	14	80	0.1750000
NODE_28585_length_572_cov_3.843552	210	290	13	8	80	0.1000000
NODE_28585_length_572_cov_3.843552	263	343	6	31	80	0.3875000
NODE_28585_length_572_cov_3.843552	263	343	7	1	80	0.0125000
NODE_28585_length_572_cov_3.843552	263	343	8	38	80	0.4750000
NODE_28585_length_572_cov_3.843552	263	343	9	7	80	0.0875000
NODE_28585_length_572_cov_3.843552	263	343	12	3	80	0.0375000
NODE_28621_length_572_cov_2.319239	357	431	0	74	74	1.0000000
NODE_28621_length_572_cov_2.319239	410	478	0	68	68	1.0000000
NODE_28625_length_572_cov_2.107822	184	254	0	70	70	1.0000000
NODE_28625_length_572_cov_2.107822	415	493	0	78	78	1.0000000
NODE_28631_length_572_cov_1.947146	327	363	0	36	36	1.0000000
NODE_28631_length_572_cov_1.947146	328	354	0	26	26	1.0000000
NODE_28700_length_571_cov_14.262712	237	317	3	39	80	0.4875000
NODE_28700_length_571_cov_14.262712	237	317	4	41	80	0.5125000
NODE_28700_length_571_cov_14.262712	290	370	1	31	80	0.3875000
NODE_28700_length_571_cov_14.262712	290	370	2	20	80	0.2500000
NODE_28700_length_571_cov_14.262712	290	370	3	29	80	0.3625000
NODE_28717_length_571_cov_4.033898	154	234	0	80	80	1.0000000
NODE_28717_length_571_cov_4.033898	207	273	0	66	66	1.0000000
NODE_28809_length_570_cov_28.269639	487	559	8	12	72	0.1666667
NODE_28809_length_570_cov_28.269639	487	559	11	60	72	0.8333333
NODE_28812_length_570_cov_10.161359	167	247	1	80	80	1.0000000
NODE_28812_length_570_cov_10.161359	220	256	1	36	36	1.0000000
NODE_28819_length_570_cov_5.010616	179	216	0	37	37	1.0000000
NODE_28819_length_570_cov_5.010616	189	269	0	80	80	1.0000000
NODE_28828_length_570_cov_3.898089	236	316	4	6	80	0.0750000
NODE_28828_length_570_cov_3.898089	236	316	6	74	80	0.9250000
NODE_28828_length_570_cov_3.898089	289	369	3	30	80	0.3750000
NODE_28828_length_570_cov_3.898089	289	369	4	29	80	0.3625000
NODE_28828_length_570_cov_3.898089	289	369	6	21	80	0.2625000
NODE_28840_length_570_cov_2.938429	202	280	1	78	78	1.0000000
NODE_28840_length_570_cov_2.938429	262	333	0	32	71	0.4507042
NODE_28840_length_570_cov_2.938429	262	333	1	39	71	0.5492958
NODE_28842_length_570_cov_2.891720	204	260	1	44	56	0.7857143
NODE_28842_length_570_cov_2.891720	204	260	2	12	56	0.2142857
NODE_28950_length_569_cov_20.559574	275	355	12	65	80	0.8125000
NODE_28950_length_569_cov_20.559574	275	355	19	15	80	0.1875000
NODE_28950_length_569_cov_20.559574	328	408	7	17	80	0.2125000
NODE_28950_length_569_cov_20.559574	328	408	12	63	80	0.7875000
NODE_28951_length_569_cov_15.282979	272	352	0	80	80	1.0000000
NODE_28951_length_569_cov_15.282979	325	405	0	80	80	1.0000000
NODE_28952_length_569_cov_11.023404	280	360	1	1	80	0.0125000
NODE_28952_length_569_cov_11.023404	280	360	2	39	80	0.4875000
NODE_28952_length_569_cov_11.023404	280	360	8	40	80	0.5000000
NODE_28952_length_569_cov_11.023404	333	413	7	13	80	0.1625000
NODE_28952_length_569_cov_11.023404	333	413	8	67	80	0.8375000
NODE_28953_length_569_cov_9.310638	231	277	2	4	46	0.0869565
NODE_28953_length_569_cov_9.310638	231	277	3	33	46	0.7173913
NODE_28953_length_569_cov_9.310638	231	277	4	9	46	0.1956522
NODE_28956_length_569_cov_6.989362	258	338	0	80	80	1.0000000
NODE_28956_length_569_cov_6.989362	294	329	0	35	35	1.0000000
NODE_28956_length_569_cov_6.989362	296	338	0	42	42	1.0000000
NODE_28957_length_569_cov_6.978723	264	344	2	15	80	0.1875000
NODE_28957_length_569_cov_6.978723	264	344	5	31	80	0.3875000
NODE_28957_length_569_cov_6.978723	264	344	6	34	80	0.4250000
NODE_28957_length_569_cov_6.978723	317	397	5	80	80	1.0000000
NODE_28960_length_569_cov_6.434043	228	308	0	6	80	0.0750000
NODE_28960_length_569_cov_6.434043	228	308	1	64	80	0.8000000
NODE_28960_length_569_cov_6.434043	228	308	3	10	80	0.1250000
NODE_28973_length_569_cov_3.353191	340	419	0	79	79	1.0000000
NODE_28981_length_569_cov_3.027660	277	348	0	71	71	1.0000000
NODE_29072_length_568_cov_59.729211	124	204	1	10	80	0.1250000
NODE_29072_length_568_cov_59.729211	124	204	2	70	80	0.8750000
NODE_29072_length_568_cov_59.729211	177	257	0	50	80	0.6250000
NODE_29072_length_568_cov_59.729211	177	257	1	13	80	0.1625000
NODE_29072_length_568_cov_59.729211	177	257	2	17	80	0.2125000
NODE_29075_length_568_cov_7.763326	215	294	0	79	79	1.0000000
NODE_29075_length_568_cov_7.763326	267	347	0	80	80	1.0000000
NODE_29078_length_568_cov_6.257996	397	471	0	74	74	1.0000000
NODE_29091_length_568_cov_3.748401	170	236	0	66	66	1.0000000
NODE_29091_length_568_cov_3.748401	262	311	0	49	49	1.0000000
NODE_29133_length_568_cov_1.769723	192	233	0	41	41	1.0000000
NODE_29160_length_568_cov_1.358209	355	432	0	77	77	1.0000000
NODE_29182_length_568_cov_1.038380	195	275	0	80	80	1.0000000
NODE_29216_length_567_cov_21.155983	347	427	2	29	80	0.3625000
NODE_29216_length_567_cov_21.155983	347	427	4	43	80	0.5375000
NODE_29216_length_567_cov_21.155983	347	427	6	8	80	0.1000000
NODE_29216_length_567_cov_21.155983	400	480	4	19	80	0.2375000
NODE_29216_length_567_cov_21.155983	400	480	6	61	80	0.7625000
NODE_29217_length_567_cov_18.292735	367	447	3	2	80	0.0250000
NODE_29217_length_567_cov_18.292735	367	447	4	1	80	0.0125000
NODE_29217_length_567_cov_18.292735	367	447	5	3	80	0.0375000
NODE_29217_length_567_cov_18.292735	367	447	8	22	80	0.2750000
NODE_29217_length_567_cov_18.292735	367	447	9	52	80	0.6500000
NODE_29217_length_567_cov_18.292735	420	500	1	10	80	0.1250000
NODE_29217_length_567_cov_18.292735	420	500	2	28	80	0.3500000
NODE_29217_length_567_cov_18.292735	420	500	3	17	80	0.2125000
NODE_29217_length_567_cov_18.292735	420	500	4	1	80	0.0125000
NODE_29217_length_567_cov_18.292735	420	500	5	3	80	0.0375000
NODE_29217_length_567_cov_18.292735	420	500	8	7	80	0.0875000
NODE_29217_length_567_cov_18.292735	420	500	9	14	80	0.1750000
NODE_29218_length_567_cov_17.579060	259	339	0	80	80	1.0000000
NODE_29218_length_567_cov_17.579060	312	392	0	80	80	1.0000000
NODE_29220_length_567_cov_15.457265	276	356	1	1	80	0.0125000
NODE_29220_length_567_cov_15.457265	276	356	2	59	80	0.7375000
NODE_29220_length_567_cov_15.457265	276	356	3	20	80	0.2500000
NODE_29220_length_567_cov_15.457265	329	409	2	7	80	0.0875000
NODE_29220_length_567_cov_15.457265	329	409	3	34	80	0.4250000
NODE_29220_length_567_cov_15.457265	329	409	4	39	80	0.4875000
NODE_29221_length_567_cov_14.393162	270	350	0	80	80	1.0000000
NODE_29221_length_567_cov_14.393162	323	403	0	80	80	1.0000000
NODE_29225_length_567_cov_6.611111	356	436	0	80	80	1.0000000
NODE_29225_length_567_cov_6.611111	409	489	0	80	80	1.0000000
NODE_29245_length_567_cov_2.884615	204	284	0	80	80	1.0000000
NODE_29245_length_567_cov_2.884615	204	254	0	50	50	1.0000000
NODE_29245_length_567_cov_2.884615	266	297	0	31	31	1.0000000
NODE_29363_length_566_cov_47.747323	157	237	10	21	80	0.2625000
NODE_29363_length_566_cov_47.747323	157	237	12	1	80	0.0125000
NODE_29363_length_566_cov_47.747323	157	237	13	28	80	0.3500000
NODE_29363_length_566_cov_47.747323	157	237	16	2	80	0.0250000
NODE_29363_length_566_cov_47.747323	157	237	17	15	80	0.1875000
NODE_29363_length_566_cov_47.747323	157	237	20	2	80	0.0250000
NODE_29363_length_566_cov_47.747323	157	237	22	11	80	0.1375000
NODE_29363_length_566_cov_47.747323	210	290	17	14	80	0.1750000
NODE_29363_length_566_cov_47.747323	210	290	20	6	80	0.0750000
NODE_29363_length_566_cov_47.747323	210	290	21	29	80	0.3625000
NODE_29363_length_566_cov_47.747323	210	290	22	19	80	0.2375000
NODE_29363_length_566_cov_47.747323	210	290	24	9	80	0.1125000
NODE_29363_length_566_cov_47.747323	210	290	26	3	80	0.0375000
NODE_29364_length_566_cov_44.824411	14	94	0	16	80	0.2000000
NODE_29364_length_566_cov_44.824411	14	94	2	28	80	0.3500000
NODE_29364_length_566_cov_44.824411	14	94	4	14	80	0.1750000
NODE_29364_length_566_cov_44.824411	14	94	5	22	80	0.2750000
NODE_29364_length_566_cov_44.824411	15	94	0	15	79	0.1898734
NODE_29364_length_566_cov_44.824411	15	94	2	28	79	0.3544304
NODE_29364_length_566_cov_44.824411	15	94	4	14	79	0.1772152
NODE_29364_length_566_cov_44.824411	15	94	5	22	79	0.2784810
NODE_29364_length_566_cov_44.824411	67	147	4	5	80	0.0625000
NODE_29364_length_566_cov_44.824411	67	147	5	41	80	0.5125000
NODE_29364_length_566_cov_44.824411	67	147	7	19	80	0.2375000
NODE_29364_length_566_cov_44.824411	67	147	9	5	80	0.0625000
NODE_29364_length_566_cov_44.824411	67	147	10	4	80	0.0500000
NODE_29364_length_566_cov_44.824411	67	147	12	6	80	0.0750000
NODE_29364_length_566_cov_44.824411	67	147	4	5	80	0.0625000
NODE_29364_length_566_cov_44.824411	67	147	5	41	80	0.5125000
NODE_29364_length_566_cov_44.824411	67	147	7	19	80	0.2375000
NODE_29364_length_566_cov_44.824411	67	147	9	5	80	0.0625000
NODE_29364_length_566_cov_44.824411	67	147	10	4	80	0.0500000
NODE_29364_length_566_cov_44.824411	67	147	12	6	80	0.0750000
NODE_29364_length_566_cov_44.824411	77	147	5	36	70	0.5142857
NODE_29364_length_566_cov_44.824411	77	147	7	19	70	0.2714286
NODE_29364_length_566_cov_44.824411	77	147	9	5	70	0.0714286
NODE_29364_length_566_cov_44.824411	77	147	10	4	70	0.0571429
NODE_29364_length_566_cov_44.824411	77	147	12	6	70	0.0857143
NODE_29364_length_566_cov_44.824411	143	223	8	30	80	0.3750000
NODE_29364_length_566_cov_44.824411	143	223	9	1	80	0.0125000
NODE_29364_length_566_cov_44.824411	143	223	10	35	80	0.4375000
NODE_29364_length_566_cov_44.824411	143	223	12	14	80	0.1750000
NODE_29364_length_566_cov_44.824411	196	276	7	13	80	0.1625000
NODE_29364_length_566_cov_44.824411	196	276	9	41	80	0.5125000
NODE_29364_length_566_cov_44.824411	196	276	10	26	80	0.3250000
NODE_29367_length_566_cov_18.494647	344	424	2	2	80	0.0250000
NODE_29367_length_566_cov_18.494647	344	424	3	16	80	0.2000000
NODE_29367_length_566_cov_18.494647	344	424	4	37	80	0.4625000
NODE_29367_length_566_cov_18.494647	344	424	5	25	80	0.3125000
NODE_29367_length_566_cov_18.494647	397	477	3	2	80	0.0250000
NODE_29367_length_566_cov_18.494647	397	477	5	78	80	0.9750000
NODE_29368_length_566_cov_17.537473	324	404	2	80	80	1.0000000
NODE_29368_length_566_cov_17.537473	377	457	0	7	80	0.0875000
NODE_29368_length_566_cov_17.537473	377	457	2	73	80	0.9125000
NODE_29369_length_566_cov_13.019272	157	237	4	48	80	0.6000000
NODE_29369_length_566_cov_13.019272	157	237	5	2	80	0.0250000
NODE_29369_length_566_cov_13.019272	157	237	6	30	80	0.3750000
NODE_29369_length_566_cov_13.019272	210	290	4	45	80	0.5625000
NODE_29369_length_566_cov_13.019272	210	290	6	35	80	0.4375000
NODE_29371_length_566_cov_9.513919	191	279	2	54	88	0.6136364
NODE_29371_length_566_cov_9.513919	191	279	3	34	88	0.3863636
NODE_29371_length_566_cov_9.513919	252	332	2	37	80	0.4625000
NODE_29371_length_566_cov_9.513919	252	332	3	43	80	0.5375000
NODE_29397_length_566_cov_3.239829	292	334	0	42	42	1.0000000
NODE_29397_length_566_cov_3.239829	351	375	0	24	24	1.0000000
NODE_29437_length_566_cov_1.698073	432	481	0	49	49	1.0000000
NODE_29472_length_566_cov_0.957173	378	405	0	27	27	1.0000000
NODE_29503_length_565_cov_10.508584	202	280	0	45	78	0.5769231
NODE_29503_length_565_cov_10.508584	202	280	1	33	78	0.4230769
NODE_29503_length_565_cov_10.508584	253	334	1	45	81	0.5555556
NODE_29503_length_565_cov_10.508584	253	334	2	36	81	0.4444444
NODE_29509_length_565_cov_7.560086	170	246	2	40	76	0.5263158
NODE_29509_length_565_cov_7.560086	170	246	3	23	76	0.3026316
NODE_29509_length_565_cov_7.560086	170	246	9	13	76	0.1710526
NODE_29520_length_565_cov_4.045064	231	311	0	36	80	0.4500000
NODE_29520_length_565_cov_4.045064	231	311	2	44	80	0.5500000
NODE_29520_length_565_cov_4.045064	284	364	2	69	80	0.8625000
NODE_29520_length_565_cov_4.045064	284	364	4	11	80	0.1375000
NODE_29528_length_565_cov_3.399142	161	241	0	80	80	1.0000000
NODE_29528_length_565_cov_3.399142	214	294	0	80	80	1.0000000
NODE_29542_length_565_cov_2.542918	302	382	0	80	80	1.0000000
NODE_29542_length_565_cov_2.542918	355	435	0	80	80	1.0000000
NODE_29650_length_564_cov_46.901075	129	209	14	20	80	0.2500000
NODE_29650_length_564_cov_46.901075	129	209	15	24	80	0.3000000
NODE_29650_length_564_cov_46.901075	129	209	16	21	80	0.2625000
NODE_29650_length_564_cov_46.901075	129	209	17	1	80	0.0125000
NODE_29650_length_564_cov_46.901075	129	209	18	14	80	0.1750000
NODE_29650_length_564_cov_46.901075	182	262	5	20	80	0.2500000
NODE_29650_length_564_cov_46.901075	182	262	6	18	80	0.2250000
NODE_29650_length_564_cov_46.901075	182	262	9	2	80	0.0250000
NODE_29650_length_564_cov_46.901075	182	262	10	4	80	0.0500000
NODE_29650_length_564_cov_46.901075	182	262	12	6	80	0.0750000
NODE_29650_length_564_cov_46.901075	182	262	14	23	80	0.2875000
NODE_29650_length_564_cov_46.901075	182	262	16	4	80	0.0500000
NODE_29650_length_564_cov_46.901075	182	262	17	1	80	0.0125000
NODE_29650_length_564_cov_46.901075	182	262	18	2	80	0.0250000
NODE_29651_length_564_cov_13.520430	300	380	2	80	80	1.0000000
NODE_29651_length_564_cov_13.520430	353	433	0	6	80	0.0750000
NODE_29651_length_564_cov_13.520430	353	433	2	74	80	0.9250000
NODE_29653_length_564_cov_7.965591	291	332	0	41	41	1.0000000
NODE_29796_length_563_cov_24.487069	97	177	5	57	80	0.7125000
NODE_29796_length_563_cov_24.487069	97	177	6	17	80	0.2125000
NODE_29796_length_563_cov_24.487069	97	177	7	6	80	0.0750000
NODE_29796_length_563_cov_24.487069	150	230	5	4	80	0.0500000
NODE_29796_length_563_cov_24.487069	150	230	6	17	80	0.2125000
NODE_29796_length_563_cov_24.487069	150	230	7	44	80	0.5500000
NODE_29796_length_563_cov_24.487069	150	230	8	15	80	0.1875000
NODE_29800_length_563_cov_6.758621	301	367	6	66	66	1.0000000
NODE_29800_length_563_cov_6.758621	378	422	0	44	44	1.0000000
NODE_29802_length_563_cov_5.762931	48	135	2	1	87	0.0114943
NODE_29802_length_563_cov_5.762931	48	135	3	19	87	0.2183908
NODE_29802_length_563_cov_5.762931	48	135	4	59	87	0.6781609
NODE_29802_length_563_cov_5.762931	48	135	5	8	87	0.0919540
NODE_29802_length_563_cov_5.762931	108	188	4	80	80	1.0000000
NODE_29808_length_563_cov_4.176724	197	277	1	80	80	1.0000000
NODE_29808_length_563_cov_4.176724	250	330	1	80	80	1.0000000
NODE_29809_length_563_cov_4.155172	273	315	0	42	42	1.0000000
NODE_29809_length_563_cov_4.155172	288	358	0	70	70	1.0000000
NODE_29925_length_562_cov_31.194384	47	127	1	2	80	0.0250000
NODE_29925_length_562_cov_31.194384	47	127	2	7	80	0.0875000
NODE_29925_length_562_cov_31.194384	47	127	3	25	80	0.3125000
NODE_29925_length_562_cov_31.194384	47	127	4	8	80	0.1000000
NODE_29925_length_562_cov_31.194384	47	127	5	16	80	0.2000000
NODE_29925_length_562_cov_31.194384	47	127	6	2	80	0.0250000
NODE_29925_length_562_cov_31.194384	47	127	7	20	80	0.2500000
NODE_29925_length_562_cov_31.194384	100	180	5	5	80	0.0625000
NODE_29925_length_562_cov_31.194384	100	180	6	2	80	0.0250000
NODE_29925_length_562_cov_31.194384	100	180	7	33	80	0.4125000
NODE_29925_length_562_cov_31.194384	100	180	8	40	80	0.5000000
NODE_29926_length_562_cov_29.857451	33	113	0	49	80	0.6125000
NODE_29926_length_562_cov_29.857451	33	113	1	31	80	0.3875000
NODE_29926_length_562_cov_29.857451	86	166	1	52	80	0.6500000
NODE_29926_length_562_cov_29.857451	86	166	2	28	80	0.3500000
NODE_29927_length_562_cov_23.194384	245	325	6	8	80	0.1000000
NODE_29927_length_562_cov_23.194384	245	325	7	72	80	0.9000000
NODE_29927_length_562_cov_23.194384	298	378	5	24	80	0.3000000
NODE_29927_length_562_cov_23.194384	298	378	6	14	80	0.1750000
NODE_29927_length_562_cov_23.194384	298	378	7	42	80	0.5250000
NODE_29930_length_562_cov_10.304536	271	321	2	28	50	0.5600000
NODE_29930_length_562_cov_10.304536	271	321	3	22	50	0.4400000
NODE_29931_length_562_cov_9.131749	265	346	0	81	81	1.0000000
NODE_29931_length_562_cov_9.131749	319	399	0	80	80	1.0000000
NODE_29960_length_562_cov_2.961123	350	398	4	31	48	0.6458333
NODE_29960_length_562_cov_2.961123	350	398	5	17	48	0.3541667
NODE_30083_length_561_cov_18.049784	54	134	2	34	80	0.4250000
NODE_30083_length_561_cov_18.049784	54	134	3	12	80	0.1500000
NODE_30083_length_561_cov_18.049784	54	134	5	34	80	0.4250000
NODE_30083_length_561_cov_18.049784	107	187	3	26	80	0.3250000
NODE_30083_length_561_cov_18.049784	107	187	4	1	80	0.0125000
NODE_30083_length_561_cov_18.049784	107	187	5	53	80	0.6625000
NODE_30087_length_561_cov_5.348485	208	274	0	66	66	1.0000000
NODE_30105_length_561_cov_2.787879	216	285	0	69	69	1.0000000
NODE_30120_length_561_cov_2.233766	339	419	3	76	80	0.9500000
NODE_30120_length_561_cov_2.233766	339	419	6	4	80	0.0500000
NODE_30120_length_561_cov_2.233766	391	445	3	54	54	1.0000000
NODE_30120_length_561_cov_2.233766	392	438	3	46	46	1.0000000
NODE_30133_length_561_cov_1.803030	258	334	4	30	76	0.3947369
NODE_30133_length_561_cov_1.803030	258	334	7	39	76	0.5131579
NODE_30133_length_561_cov_1.803030	258	334	8	7	76	0.0921053
NODE_30224_length_560_cov_41.433839	67	147	6	10	80	0.1250000
NODE_30224_length_560_cov_41.433839	67	147	7	6	80	0.0750000
NODE_30224_length_560_cov_41.433839	67	147	8	64	80	0.8000000
NODE_30224_length_560_cov_41.433839	120	200	4	11	80	0.1375000
NODE_30224_length_560_cov_41.433839	120	200	5	10	80	0.1250000
NODE_30224_length_560_cov_41.433839	120	200	6	20	80	0.2500000
NODE_30224_length_560_cov_41.433839	120	200	8	39	80	0.4875000
NODE_30225_length_560_cov_35.993492	366	446	4	17	80	0.2125000
NODE_30225_length_560_cov_35.993492	366	446	5	47	80	0.5875000
NODE_30225_length_560_cov_35.993492	366	446	8	1	80	0.0125000
NODE_30225_length_560_cov_35.993492	366	446	9	15	80	0.1875000
NODE_30225_length_560_cov_35.993492	419	499	0	50	80	0.6250000
NODE_30225_length_560_cov_35.993492	419	499	4	20	80	0.2500000
NODE_30225_length_560_cov_35.993492	419	499	5	10	80	0.1250000
NODE_30226_length_560_cov_20.433839	342	422	9	22	80	0.2750000
NODE_30226_length_560_cov_20.433839	342	422	10	37	80	0.4625000
NODE_30226_length_560_cov_20.433839	342	422	11	21	80	0.2625000
NODE_30226_length_560_cov_20.433839	395	475	6	25	80	0.3125000
NODE_30226_length_560_cov_20.433839	395	475	7	21	80	0.2625000
NODE_30226_length_560_cov_20.433839	395	475	9	23	80	0.2875000
NODE_30226_length_560_cov_20.433839	395	475	10	10	80	0.1250000
NODE_30226_length_560_cov_20.433839	395	475	11	1	80	0.0125000
NODE_30227_length_560_cov_13.850325	274	327	1	42	53	0.7924528
NODE_30227_length_560_cov_13.850325	274	327	2	11	53	0.2075472
NODE_30228_length_560_cov_12.075922	233	314	0	35	81	0.4320988
NODE_30228_length_560_cov_12.075922	233	314	1	46	81	0.5679013
NODE_30229_length_560_cov_8.594360	263	343	0	7	80	0.0875000
NODE_30229_length_560_cov_8.594360	263	343	1	73	80	0.9125000
NODE_30229_length_560_cov_8.594360	316	396	0	60	80	0.7500000
NODE_30229_length_560_cov_8.594360	316	396	1	20	80	0.2500000
NODE_30237_length_560_cov_5.227766	264	328	0	64	64	1.0000000
NODE_30238_length_560_cov_5.056399	299	379	0	80	80	1.0000000
NODE_30238_length_560_cov_5.056399	352	432	0	80	80	1.0000000
NODE_30244_length_560_cov_4.518438	156	236	0	80	80	1.0000000
NODE_30281_length_560_cov_2.154013	204	275	0	71	71	1.0000000
NODE_30281_length_560_cov_2.154013	255	335	0	80	80	1.0000000
NODE_30288_length_560_cov_2.017354	52	114	0	62	62	1.0000000
NODE_30363_length_559_cov_37.526087	289	370	0	51	81	0.6296296
NODE_30363_length_559_cov_37.526087	289	370	2	30	81	0.3703704
NODE_30363_length_559_cov_37.526087	343	423	2	48	80	0.6000000
NODE_30363_length_559_cov_37.526087	343	423	4	32	80	0.4000000
NODE_30363_length_559_cov_37.526087	419	500	2	10	81	0.1234568
NODE_30363_length_559_cov_37.526087	419	500	4	71	81	0.8765432
NODE_30363_length_559_cov_37.526087	473	553	0	12	80	0.1500000
NODE_30363_length_559_cov_37.526087	473	553	2	51	80	0.6375000
NODE_30363_length_559_cov_37.526087	473	553	4	17	80	0.2125000
NODE_30365_length_559_cov_19.126087	388	468	3	20	80	0.2500000
NODE_30365_length_559_cov_19.126087	388	468	4	60	80	0.7500000
NODE_30365_length_559_cov_19.126087	441	521	1	4	80	0.0500000
NODE_30365_length_559_cov_19.126087	441	521	2	5	80	0.0625000
NODE_30365_length_559_cov_19.126087	441	521	4	71	80	0.8875000
NODE_30366_length_559_cov_12.489130	262	341	0	7	79	0.0886076
NODE_30366_length_559_cov_12.489130	262	341	1	72	79	0.9113924
NODE_30366_length_559_cov_12.489130	316	394	0	25	78	0.3205128
NODE_30366_length_559_cov_12.489130	316	394	1	53	78	0.6794872
NODE_30370_length_559_cov_6.530435	283	363	3	46	80	0.5750000
NODE_30370_length_559_cov_6.530435	283	363	4	20	80	0.2500000
NODE_30370_length_559_cov_6.530435	283	363	5	14	80	0.1750000
NODE_30377_length_559_cov_4.930435	112	192	0	80	80	1.0000000
NODE_30377_length_559_cov_4.930435	165	244	0	79	79	1.0000000
NODE_30419_length_559_cov_1.776087	395	433	3	36	38	0.9473684
NODE_30419_length_559_cov_1.776087	395	433	4	2	38	0.0526316
NODE_30480_length_558_cov_13.102397	297	364	0	63	67	0.9402985
NODE_30480_length_558_cov_13.102397	297	364	1	4	67	0.0597015
NODE_30482_length_558_cov_9.309368	369	449	3	80	80	1.0000000
NODE_30482_length_558_cov_9.309368	422	502	1	22	80	0.2750000
NODE_30482_length_558_cov_9.309368	422	502	3	58	80	0.7250000
NODE_30489_length_558_cov_5.921569	304	361	0	57	57	1.0000000
NODE_30493_length_558_cov_4.801743	197	266	0	69	69	1.0000000
NODE_30493_length_558_cov_4.801743	197	277	0	80	80	1.0000000
NODE_30493_length_558_cov_4.801743	250	330	0	80	80	1.0000000
NODE_30493_length_558_cov_4.801743	250	330	0	80	80	1.0000000
NODE_30495_length_558_cov_4.570806	188	244	2	56	56	1.0000000
NODE_30536_length_558_cov_2.259259	236	294	0	58	58	1.0000000
NODE_30536_length_558_cov_2.259259	267	347	0	80	80	1.0000000
NODE_30568_length_558_cov_1.544662	403	483	0	80	80	1.0000000
NODE_30568_length_558_cov_1.544662	456	536	0	80	80	1.0000000
NODE_30623_length_557_cov_9.141921	255	335	0	80	80	1.0000000
NODE_30623_length_557_cov_9.141921	308	388	0	80	80	1.0000000
NODE_30626_length_557_cov_7.316594	210	290	1	57	80	0.7125000
NODE_30626_length_557_cov_7.316594	210	290	2	23	80	0.2875000
NODE_30626_length_557_cov_7.316594	263	341	1	29	78	0.3717949
NODE_30626_length_557_cov_7.316594	263	341	2	5	78	0.0641026
NODE_30626_length_557_cov_7.316594	263	341	3	2	78	0.0256410
NODE_30626_length_557_cov_7.316594	263	341	7	21	78	0.2692308
NODE_30626_length_557_cov_7.316594	263	341	8	21	78	0.2692308
NODE_30636_length_557_cov_4.259825	185	267	0	82	82	1.0000000
NODE_30646_length_557_cov_3.794760	131	188	0	57	57	1.0000000
NODE_30646_length_557_cov_3.794760	139	219	0	80	80	1.0000000
NODE_30650_length_557_cov_3.517467	246	325	0	79	79	1.0000000
NODE_30650_length_557_cov_3.517467	298	378	0	80	80	1.0000000
NODE_30652_length_557_cov_3.390830	366	395	0	29	29	1.0000000
NODE_30792_length_556_cov_37.258206	122	202	0	80	80	1.0000000
NODE_30792_length_556_cov_37.258206	175	255	0	80	80	1.0000000
NODE_30793_length_556_cov_15.266958	360	440	4	80	80	1.0000000
NODE_30793_length_556_cov_15.266958	413	493	1	7	80	0.0875000
NODE_30793_length_556_cov_15.266958	413	493	2	9	80	0.1125000
NODE_30793_length_556_cov_15.266958	413	493	3	12	80	0.1500000
NODE_30793_length_556_cov_15.266958	413	493	4	52	80	0.6500000
NODE_30794_length_556_cov_12.781182	341	421	2	3	80	0.0375000
NODE_30794_length_556_cov_12.781182	341	421	4	77	80	0.9625000
NODE_30794_length_556_cov_12.781182	394	474	0	15	80	0.1875000
NODE_30794_length_556_cov_12.781182	394	474	2	21	80	0.2625000
NODE_30794_length_556_cov_12.781182	394	474	4	44	80	0.5500000
NODE_30795_length_556_cov_11.131291	304	384	1	57	80	0.7125000
NODE_30795_length_556_cov_11.131291	304	384	2	23	80	0.2875000
NODE_30795_length_556_cov_11.131291	357	437	0	37	80	0.4625000
NODE_30795_length_556_cov_11.131291	357	437	1	43	80	0.5375000
NODE_30797_length_556_cov_7.168490	163	243	0	80	80	1.0000000
NODE_30797_length_556_cov_7.168490	216	296	0	80	80	1.0000000
NODE_30798_length_556_cov_7.089716	325	379	1	33	54	0.6111111
NODE_30798_length_556_cov_7.089716	325	379	2	21	54	0.3888889
NODE_30801_length_556_cov_6.505470	232	312	2	50	80	0.6250000
NODE_30801_length_556_cov_6.505470	232	312	3	30	80	0.3750000
NODE_30801_length_556_cov_6.505470	285	365	1	3	80	0.0375000
NODE_30801_length_556_cov_6.505470	285	365	2	7	80	0.0875000
NODE_30801_length_556_cov_6.505470	285	365	3	45	80	0.5625000
NODE_30801_length_556_cov_6.505470	285	365	4	25	80	0.3125000
NODE_30802_length_556_cov_6.496718	140	179	1	7	39	0.1794872
NODE_30802_length_556_cov_6.496718	140	179	2	28	39	0.7179487
NODE_30802_length_556_cov_6.496718	140	179	3	4	39	0.1025641
NODE_30802_length_556_cov_6.496718	226	255	2	29	29	1.0000000
NODE_30809_length_556_cov_4.457330	197	277	2	80	80	1.0000000
NODE_30818_length_556_cov_3.761488	234	307	0	73	73	1.0000000
NODE_30930_length_555_cov_20.949561	322	402	6	16	80	0.2000000
NODE_30930_length_555_cov_20.949561	322	402	7	64	80	0.8000000
NODE_30930_length_555_cov_20.949561	375	455	5	23	80	0.2875000
NODE_30930_length_555_cov_20.949561	375	455	6	46	80	0.5750000
NODE_30930_length_555_cov_20.949561	375	455	7	11	80	0.1375000
NODE_30931_length_555_cov_16.822368	268	348	2	19	80	0.2375000
NODE_30931_length_555_cov_16.822368	268	348	4	27	80	0.3375000
NODE_30931_length_555_cov_16.822368	268	348	5	16	80	0.2000000
NODE_30931_length_555_cov_16.822368	268	348	6	18	80	0.2250000
NODE_30931_length_555_cov_16.822368	321	401	4	75	80	0.9375000
NODE_30931_length_555_cov_16.822368	321	401	6	5	80	0.0625000
NODE_30933_length_555_cov_9.912281	313	393	0	80	80	1.0000000
NODE_30935_length_555_cov_8.057018	277	357	0	80	80	1.0000000
NODE_30935_length_555_cov_8.057018	330	410	0	80	80	1.0000000
NODE_30938_length_555_cov_6.778509	62	92	0	30	30	1.0000000
NODE_30986_length_555_cov_2.177632	208	288	0	80	80	1.0000000
NODE_30986_length_555_cov_2.177632	261	329	0	68	68	1.0000000
NODE_31092_length_554_cov_11.942857	118	198	4	27	80	0.3375000
NODE_31092_length_554_cov_11.942857	118	198	5	53	80	0.6625000
NODE_31092_length_554_cov_11.942857	171	251	3	50	80	0.6250000
NODE_31092_length_554_cov_11.942857	171	251	4	30	80	0.3750000
NODE_31096_length_554_cov_8.426374	242	322	1	38	80	0.4750000
NODE_31096_length_554_cov_8.426374	242	322	2	42	80	0.5250000
NODE_31096_length_554_cov_8.426374	295	375	0	30	80	0.3750000
NODE_31096_length_554_cov_8.426374	295	375	1	50	80	0.6250000
NODE_31101_length_554_cov_6.116484	264	344	3	69	80	0.8625000
NODE_31101_length_554_cov_6.116484	264	344	4	11	80	0.1375000
NODE_31101_length_554_cov_6.116484	317	393	1	11	76	0.1447368
NODE_31101_length_554_cov_6.116484	317	393	2	17	76	0.2236842
NODE_31101_length_554_cov_6.116484	317	393	3	48	76	0.6315789
NODE_31115_length_554_cov_3.586813	207	286	0	79	79	1.0000000
NODE_31240_length_553_cov_42.017621	197	277	9	17	80	0.2125000
NODE_31240_length_553_cov_42.017621	197	277	10	10	80	0.1250000
NODE_31240_length_553_cov_42.017621	197	277	11	33	80	0.4125000
NODE_31240_length_553_cov_42.017621	197	277	12	20	80	0.2500000
NODE_31240_length_553_cov_42.017621	250	330	9	23	80	0.2875000
NODE_31240_length_553_cov_42.017621	250	330	10	13	80	0.1625000
NODE_31240_length_553_cov_42.017621	250	330	11	27	80	0.3375000
NODE_31240_length_553_cov_42.017621	250	330	12	17	80	0.2125000
NODE_31241_length_553_cov_28.944934	333	413	5	26	80	0.3250000
NODE_31241_length_553_cov_28.944934	333	413	6	13	80	0.1625000
NODE_31241_length_553_cov_28.944934	333	413	7	22	80	0.2750000
NODE_31241_length_553_cov_28.944934	333	413	8	19	80	0.2375000
NODE_31241_length_553_cov_28.944934	386	466	3	9	80	0.1125000
NODE_31241_length_553_cov_28.944934	386	466	4	2	80	0.0250000
NODE_31241_length_553_cov_28.944934	386	466	5	3	80	0.0375000
NODE_31241_length_553_cov_28.944934	386	466	6	52	80	0.6500000
NODE_31241_length_553_cov_28.944934	386	466	7	1	80	0.0125000
NODE_31241_length_553_cov_28.944934	386	466	8	13	80	0.1625000
NODE_31242_length_553_cov_12.176211	242	322	4	44	80	0.5500000
NODE_31242_length_553_cov_12.176211	242	322	5	36	80	0.4500000
NODE_31242_length_553_cov_12.176211	295	375	2	11	80	0.1375000
NODE_31242_length_553_cov_12.176211	295	375	3	24	80	0.3000000
NODE_31242_length_553_cov_12.176211	295	375	5	45	80	0.5625000
NODE_31244_length_553_cov_9.876652	232	312	2	16	80	0.2000000
NODE_31244_length_553_cov_9.876652	232	312	3	20	80	0.2500000
NODE_31244_length_553_cov_9.876652	232	312	4	44	80	0.5500000
NODE_31244_length_553_cov_9.876652	285	365	2	69	80	0.8625000
NODE_31244_length_553_cov_9.876652	285	365	4	11	80	0.1375000
NODE_31246_length_553_cov_9.306167	207	287	2	31	80	0.3875000
NODE_31246_length_553_cov_9.306167	207	287	3	49	80	0.6125000
NODE_31246_length_553_cov_9.306167	207	287	2	31	80	0.3875000
NODE_31246_length_553_cov_9.306167	207	287	3	49	80	0.6125000
NODE_31246_length_553_cov_9.306167	260	340	2	80	80	1.0000000
NODE_31259_length_553_cov_3.729075	36	93	0	57	57	1.0000000
NODE_31259_length_553_cov_3.729075	89	146	0	57	57	1.0000000
NODE_31266_length_553_cov_3.310573	226	293	0	67	67	1.0000000
NODE_31279_length_553_cov_2.678414	102	180	0	78	78	1.0000000
NODE_31279_length_553_cov_2.678414	248	275	0	27	27	1.0000000
NODE_31295_length_553_cov_1.958150	416	462	0	16	46	0.3478261
NODE_31295_length_553_cov_1.958150	416	462	1	30	46	0.6521739
NODE_31295_length_553_cov_1.958150	469	515	0	46	46	1.0000000
NODE_31377_length_552_cov_92.070640	298	378	9	80	80	1.0000000
NODE_31377_length_552_cov_92.070640	298	378	9	80	80	1.0000000
NODE_31377_length_552_cov_92.070640	374	454	8	12	80	0.1500000
NODE_31377_length_552_cov_92.070640	374	454	9	53	80	0.6625000
NODE_31377_length_552_cov_92.070640	374	454	12	1	80	0.0125000
NODE_31377_length_552_cov_92.070640	374	454	17	14	80	0.1750000
NODE_31377_length_552_cov_92.070640	374	454	8	12	80	0.1500000
NODE_31377_length_552_cov_92.070640	374	454	9	53	80	0.6625000
NODE_31377_length_552_cov_92.070640	374	454	12	1	80	0.0125000
NODE_31377_length_552_cov_92.070640	374	454	17	14	80	0.1750000
NODE_31377_length_552_cov_92.070640	374	454	8	12	80	0.1500000
NODE_31377_length_552_cov_92.070640	374	454	9	53	80	0.6625000
NODE_31377_length_552_cov_92.070640	374	454	12	1	80	0.0125000
NODE_31377_length_552_cov_92.070640	374	454	17	14	80	0.1750000
NODE_31377_length_552_cov_92.070640	374	454	8	12	80	0.1500000
NODE_31377_length_552_cov_92.070640	374	454	9	53	80	0.6625000
NODE_31377_length_552_cov_92.070640	374	454	12	1	80	0.0125000
NODE_31377_length_552_cov_92.070640	374	454	17	14	80	0.1750000
NODE_31377_length_552_cov_92.070640	374	450	8	12	76	0.1578947
NODE_31377_length_552_cov_92.070640	374	450	9	49	76	0.6447368
NODE_31377_length_552_cov_92.070640	374	450	12	1	76	0.0131579
NODE_31377_length_552_cov_92.070640	374	450	17	14	76	0.1842105
NODE_31377_length_552_cov_92.070640	427	507	8	12	80	0.1500000
NODE_31377_length_552_cov_92.070640	427	507	9	67	80	0.8375000
NODE_31377_length_552_cov_92.070640	427	507	17	1	80	0.0125000
NODE_31377_length_552_cov_92.070640	427	507	8	12	80	0.1500000
NODE_31377_length_552_cov_92.070640	427	507	9	67	80	0.8375000
NODE_31377_length_552_cov_92.070640	427	507	17	1	80	0.0125000
NODE_31377_length_552_cov_92.070640	427	498	8	12	71	0.1690141
NODE_31377_length_552_cov_92.070640	427	498	9	58	71	0.8169014
NODE_31377_length_552_cov_92.070640	427	498	17	1	71	0.0140845
NODE_31377_length_552_cov_92.070640	430	500	8	10	70	0.1428571
NODE_31377_length_552_cov_92.070640	430	500	9	60	70	0.8571429
NODE_31377_length_552_cov_92.070640	432	507	8	8	75	0.1066667
NODE_31377_length_552_cov_92.070640	432	507	9	67	75	0.8933333
NODE_31378_length_552_cov_20.432671	151	231	0	80	80	1.0000000
NODE_31378_length_552_cov_20.432671	204	284	0	80	80	1.0000000
NODE_31379_length_552_cov_18.075055	257	333	6	76	76	1.0000000
NODE_31380_length_552_cov_13.331126	214	294	0	80	80	1.0000000
NODE_31380_length_552_cov_13.331126	267	347	0	80	80	1.0000000
NODE_31381_length_552_cov_12.774834	360	440	1	42	80	0.5250000
NODE_31381_length_552_cov_12.774834	360	440	5	37	80	0.4625000
NODE_31381_length_552_cov_12.774834	360	440	6	1	80	0.0125000
NODE_31381_length_552_cov_12.774834	413	493	3	9	80	0.1125000
NODE_31381_length_552_cov_12.774834	413	493	5	71	80	0.8875000
NODE_31384_length_552_cov_8.883002	310	390	4	33	80	0.4125000
NODE_31384_length_552_cov_8.883002	310	390	5	47	80	0.5875000
NODE_31384_length_552_cov_8.883002	363	443	0	8	80	0.1000000
NODE_31384_length_552_cov_8.883002	363	443	3	14	80	0.1750000
NODE_31384_length_552_cov_8.883002	363	443	4	58	80	0.7250000
NODE_31385_length_552_cov_6.916115	206	281	0	75	75	1.0000000
NODE_31538_length_551_cov_34.070796	324	406	0	82	82	1.0000000
NODE_31538_length_551_cov_34.070796	379	444	0	65	65	1.0000000
NODE_31541_length_551_cov_10.252212	164	244	0	20	80	0.2500000
NODE_31541_length_551_cov_10.252212	164	244	3	60	80	0.7500000
NODE_31541_length_551_cov_10.252212	217	297	3	80	80	1.0000000
NODE_31543_length_551_cov_8.075221	363	406	0	21	43	0.4883721
NODE_31543_length_551_cov_8.075221	363	406	1	6	43	0.1395349
NODE_31543_length_551_cov_8.075221	363	406	2	16	43	0.3720930
NODE_31547_length_551_cov_5.668142	213	293	0	80	80	1.0000000
NODE_31547_length_551_cov_5.668142	266	346	0	80	80	1.0000000
NODE_31552_length_551_cov_4.212389	171	242	0	71	71	1.0000000
NODE_31552_length_551_cov_4.212389	215	263	0	48	48	1.0000000
NODE_31563_length_551_cov_3.307522	227	307	2	80	80	1.0000000
NODE_31563_length_551_cov_3.307522	280	360	1	51	80	0.6375000
NODE_31563_length_551_cov_3.307522	280	360	2	29	80	0.3625000
NODE_31693_length_550_cov_17.308204	101	181	5	66	80	0.8250000
NODE_31693_length_550_cov_17.308204	101	181	6	13	80	0.1625000
NODE_31693_length_550_cov_17.308204	101	181	7	1	80	0.0125000
NODE_31693_length_550_cov_17.308204	154	234	4	14	80	0.1750000
NODE_31693_length_550_cov_17.308204	154	234	5	37	80	0.4625000
NODE_31693_length_550_cov_17.308204	154	234	6	13	80	0.1625000
NODE_31693_length_550_cov_17.308204	154	234	7	16	80	0.2000000
NODE_31700_length_550_cov_5.580931	286	329	2	43	43	1.0000000
NODE_31701_length_550_cov_5.490022	458	500	0	42	42	1.0000000
NODE_31701_length_550_cov_5.490022	459	523	0	64	64	1.0000000
NODE_31703_length_550_cov_5.243902	194	274	0	80	80	1.0000000
NODE_31703_length_550_cov_5.243902	247	327	0	80	80	1.0000000
NODE_31706_length_550_cov_4.815965	184	264	1	60	80	0.7500000
NODE_31706_length_550_cov_4.815965	184	264	2	20	80	0.2500000
NODE_31726_length_550_cov_3.252772	308	388	2	80	80	1.0000000
NODE_31756_length_550_cov_1.864745	189	259	0	70	70	1.0000000
NODE_31756_length_550_cov_1.864745	189	258	0	69	69	1.0000000
NODE_31847_length_549_cov_31.826667	216	292	8	24	76	0.3157895
NODE_31847_length_549_cov_31.826667	216	292	9	52	76	0.6842105
NODE_31847_length_549_cov_31.826667	267	331	2	2	64	0.0312500
NODE_31847_length_549_cov_31.826667	267	331	5	11	64	0.1718750
NODE_31847_length_549_cov_31.826667	267	331	6	21	64	0.3281250
NODE_31847_length_549_cov_31.826667	267	331	8	29	64	0.4531250
NODE_31847_length_549_cov_31.826667	267	331	9	1	64	0.0156250
NODE_31848_length_549_cov_14.124444	174	263	3	14	89	0.1573034
NODE_31848_length_549_cov_14.124444	174	263	4	27	89	0.3033708
NODE_31848_length_549_cov_14.124444	174	263	5	13	89	0.1460674
NODE_31848_length_549_cov_14.124444	174	263	6	35	89	0.3932584
NODE_31848_length_549_cov_14.124444	242	315	3	9	73	0.1232877
NODE_31848_length_549_cov_14.124444	242	315	4	8	73	0.1095890
NODE_31848_length_549_cov_14.124444	242	315	5	28	73	0.3835616
NODE_31848_length_549_cov_14.124444	242	315	6	28	73	0.3835616
NODE_31857_length_549_cov_5.375556	181	257	6	24	76	0.3157895
NODE_31857_length_549_cov_5.375556	181	257	7	2	76	0.0263158
NODE_31857_length_549_cov_5.375556	181	257	8	16	76	0.2105263
NODE_31857_length_549_cov_5.375556	181	257	9	15	76	0.1973684
NODE_31857_length_549_cov_5.375556	181	257	10	19	76	0.2500000
NODE_31859_length_549_cov_4.933333	260	340	2	14	80	0.1750000
NODE_31859_length_549_cov_4.933333	260	340	4	66	80	0.8250000
NODE_31864_length_549_cov_4.537778	345	430	0	85	85	1.0000000
NODE_31864_length_549_cov_4.537778	403	483	0	80	80	1.0000000
NODE_31865_length_549_cov_4.124444	406	486	1	75	80	0.9375000
NODE_31865_length_549_cov_4.124444	406	486	2	5	80	0.0625000
NODE_31866_length_549_cov_3.931111	182	219	0	37	37	1.0000000
NODE_31868_length_549_cov_3.893333	287	367	0	9	80	0.1125000
NODE_31868_length_549_cov_3.893333	287	367	1	53	80	0.6625000
NODE_31868_length_549_cov_3.893333	287	367	2	18	80	0.2250000
NODE_31868_length_549_cov_3.893333	340	420	1	9	80	0.1125000
NODE_31868_length_549_cov_3.893333	340	420	2	21	80	0.2625000
NODE_31868_length_549_cov_3.893333	340	420	3	50	80	0.6250000
NODE_31887_length_549_cov_2.673333	282	343	0	61	61	1.0000000
NODE_31890_length_549_cov_2.622222	144	220	0	76	76	1.0000000
NODE_32013_length_548_cov_13.962138	285	371	2	12	86	0.1395349
NODE_32013_length_548_cov_13.962138	285	371	4	44	86	0.5116279
NODE_32013_length_548_cov_13.962138	285	371	5	19	86	0.2209302
NODE_32013_length_548_cov_13.962138	285	371	6	11	86	0.1279070
NODE_32013_length_548_cov_13.962138	344	424	1	25	80	0.3125000
NODE_32013_length_548_cov_13.962138	344	424	2	40	80	0.5000000
NODE_32013_length_548_cov_13.962138	344	424	4	15	80	0.1875000
NODE_32022_length_548_cov_4.683742	261	336	6	75	75	1.0000000
NODE_32023_length_548_cov_4.670379	140	182	0	42	42	1.0000000
NODE_32023_length_548_cov_4.670379	282	311	0	29	29	1.0000000
NODE_32023_length_548_cov_4.670379	410	455	0	45	45	1.0000000
NODE_32029_length_548_cov_3.630290	111	177	0	66	66	1.0000000
NODE_32039_length_548_cov_3.080178	142	191	0	49	49	1.0000000
NODE_32180_length_547_cov_23.982143	243	323	0	80	80	1.0000000
NODE_32180_length_547_cov_23.982143	243	323	0	80	80	1.0000000
NODE_32180_length_547_cov_23.982143	252	323	0	71	71	1.0000000
NODE_32181_length_547_cov_23.555804	42	122	1	11	80	0.1375000
NODE_32181_length_547_cov_23.555804	42	122	3	18	80	0.2250000
NODE_32181_length_547_cov_23.555804	42	122	5	2	80	0.0250000
NODE_32181_length_547_cov_23.555804	42	122	6	16	80	0.2000000
NODE_32181_length_547_cov_23.555804	42	122	8	25	80	0.3125000
NODE_32181_length_547_cov_23.555804	42	122	9	8	80	0.1000000
NODE_32181_length_547_cov_23.555804	95	175	8	19	80	0.2375000
NODE_32181_length_547_cov_23.555804	95	175	9	24	80	0.3000000
NODE_32181_length_547_cov_23.555804	95	175	10	21	80	0.2625000
NODE_32181_length_547_cov_23.555804	95	175	12	16	80	0.2000000
NODE_32183_length_547_cov_12.819196	190	270	1	72	80	0.9000000
NODE_32183_length_547_cov_12.819196	190	270	2	8	80	0.1000000
NODE_32195_length_547_cov_5.207589	290	370	0	80	80	1.0000000
NODE_32195_length_547_cov_5.207589	343	423	0	30	80	0.3750000
NODE_32195_length_547_cov_5.207589	343	423	1	25	80	0.3125000
NODE_32195_length_547_cov_5.207589	343	423	2	25	80	0.3125000
NODE_32197_length_547_cov_4.975446	411	488	0	77	77	1.0000000
NODE_32197_length_547_cov_4.975446	461	542	0	81	81	1.0000000
NODE_32199_length_547_cov_4.683036	451	492	0	41	41	1.0000000
NODE_32204_length_547_cov_4.138393	97	175	0	78	78	1.0000000
NODE_32204_length_547_cov_4.138393	151	228	0	77	77	1.0000000
NODE_32206_length_547_cov_4.026786	136	216	2	9	80	0.1125000
NODE_32206_length_547_cov_4.026786	136	216	3	9	80	0.1125000
NODE_32206_length_547_cov_4.026786	136	216	4	58	80	0.7250000
NODE_32206_length_547_cov_4.026786	136	216	5	4	80	0.0500000
NODE_32206_length_547_cov_4.026786	189	269	3	62	80	0.7750000
NODE_32206_length_547_cov_4.026786	189	269	4	14	80	0.1750000
NODE_32206_length_547_cov_4.026786	189	269	5	4	80	0.0500000
NODE_32215_length_547_cov_3.468750	219	299	0	80	80	1.0000000
NODE_32222_length_547_cov_2.901786	304	384	0	80	80	1.0000000
NODE_32347_length_546_cov_17.733781	159	239	26	1	80	0.0125000
NODE_32347_length_546_cov_17.733781	159	239	35	1	80	0.0125000
NODE_32347_length_546_cov_17.733781	159	239	36	1	80	0.0125000
NODE_32347_length_546_cov_17.733781	159	239	37	7	80	0.0875000
NODE_32347_length_546_cov_17.733781	159	239	38	23	80	0.2875000
NODE_32347_length_546_cov_17.733781	159	239	39	1	80	0.0125000
NODE_32347_length_546_cov_17.733781	159	239	40	2	80	0.0250000
NODE_32347_length_546_cov_17.733781	159	239	45	6	80	0.0750000
NODE_32347_length_546_cov_17.733781	159	239	47	2	80	0.0250000
NODE_32347_length_546_cov_17.733781	159	239	48	3	80	0.0375000
NODE_32347_length_546_cov_17.733781	159	239	49	7	80	0.0875000
NODE_32347_length_546_cov_17.733781	159	239	50	3	80	0.0375000
NODE_32347_length_546_cov_17.733781	159	239	53	4	80	0.0500000
NODE_32347_length_546_cov_17.733781	159	239	54	4	80	0.0500000
NODE_32347_length_546_cov_17.733781	159	239	55	2	80	0.0250000
NODE_32347_length_546_cov_17.733781	159	239	57	3	80	0.0375000
NODE_32347_length_546_cov_17.733781	159	239	58	10	80	0.1250000
NODE_32347_length_546_cov_17.733781	212	293	12	7	81	0.0864198
NODE_32347_length_546_cov_17.733781	212	293	15	4	81	0.0493827
NODE_32347_length_546_cov_17.733781	212	293	16	1	81	0.0123457
NODE_32347_length_546_cov_17.733781	212	293	19	3	81	0.0370370
NODE_32347_length_546_cov_17.733781	212	293	23	5	81	0.0617284
NODE_32347_length_546_cov_17.733781	212	293	24	2	81	0.0246914
NODE_32347_length_546_cov_17.733781	212	293	25	1	81	0.0123457
NODE_32347_length_546_cov_17.733781	212	293	26	3	81	0.0370370
NODE_32347_length_546_cov_17.733781	212	293	27	1	81	0.0123457
NODE_32347_length_546_cov_17.733781	212	293	29	1	81	0.0123457
NODE_32347_length_546_cov_17.733781	212	293	32	4	81	0.0493827
NODE_32347_length_546_cov_17.733781	212	293	34	3	81	0.0370370
NODE_32347_length_546_cov_17.733781	212	293	35	18	81	0.2222222
NODE_32347_length_546_cov_17.733781	212	293	36	1	81	0.0123457
NODE_32347_length_546_cov_17.733781	212	293	37	3	81	0.0370370
NODE_32347_length_546_cov_17.733781	212	293	38	23	81	0.2839506
NODE_32347_length_546_cov_17.733781	212	293	39	1	81	0.0123457
NODE_32348_length_546_cov_16.275168	272	352	2	80	80	1.0000000
NODE_32348_length_546_cov_16.275168	325	405	1	24	80	0.3000000
NODE_32348_length_546_cov_16.275168	325	405	2	56	80	0.7000000
NODE_32349_length_546_cov_8.201342	179	259	2	13	80	0.1625000
NODE_32349_length_546_cov_8.201342	179	259	3	42	80	0.5250000
NODE_32349_length_546_cov_8.201342	179	259	4	25	80	0.3125000
NODE_32351_length_546_cov_7.454139	241	321	1	5	80	0.0625000
NODE_32351_length_546_cov_7.454139	241	321	2	75	80	0.9375000
NODE_32351_length_546_cov_7.454139	294	374	1	41	80	0.5125000
NODE_32351_length_546_cov_7.454139	294	374	2	39	80	0.4875000
NODE_32380_length_546_cov_3.192394	171	251	0	80	80	1.0000000
NODE_32510_length_545_cov_31.524664	38	118	1	8	80	0.1000000
NODE_32510_length_545_cov_31.524664	38	118	2	14	80	0.1750000
NODE_32510_length_545_cov_31.524664	38	118	5	14	80	0.1750000
NODE_32510_length_545_cov_31.524664	38	118	6	14	80	0.1750000
NODE_32510_length_545_cov_31.524664	38	118	7	18	80	0.2250000
NODE_32510_length_545_cov_31.524664	38	118	8	3	80	0.0375000
NODE_32510_length_545_cov_31.524664	38	118	10	9	80	0.1125000
NODE_32510_length_545_cov_31.524664	91	171	7	15	80	0.1875000
NODE_32510_length_545_cov_31.524664	91	171	8	3	80	0.0375000
NODE_32510_length_545_cov_31.524664	91	171	10	30	80	0.3750000
NODE_32510_length_545_cov_31.524664	91	171	13	32	80	0.4000000
NODE_32517_length_545_cov_5.524664	268	348	3	35	80	0.4375000
NODE_32517_length_545_cov_5.524664	268	348	4	18	80	0.2250000
NODE_32517_length_545_cov_5.524664	268	348	5	27	80	0.3375000
NODE_32525_length_545_cov_3.885650	137	217	0	80	80	1.0000000
NODE_32571_length_545_cov_2.013453	246	318	0	72	72	1.0000000
NODE_32599_length_545_cov_1.450673	130	179	0	49	49	1.0000000
NODE_32616_length_545_cov_1.179372	431	469	0	38	38	1.0000000
NODE_32673_length_544_cov_37.705618	258	338	0	80	80	1.0000000
NODE_32673_length_544_cov_37.705618	311	391	0	80	80	1.0000000
NODE_32674_length_544_cov_33.847191	189	269	0	80	80	1.0000000
NODE_32674_length_544_cov_33.847191	242	327	0	85	85	1.0000000
NODE_32675_length_544_cov_19.467416	251	331	2	44	80	0.5500000
NODE_32675_length_544_cov_19.467416	251	331	3	36	80	0.4500000
NODE_32675_length_544_cov_19.467416	304	384	1	3	80	0.0375000
NODE_32675_length_544_cov_19.467416	304	384	2	10	80	0.1250000
NODE_32675_length_544_cov_19.467416	304	384	3	67	80	0.8375000
NODE_32676_length_544_cov_16.775281	163	243	4	9	80	0.1125000
NODE_32676_length_544_cov_16.775281	163	243	8	48	80	0.6000000
NODE_32676_length_544_cov_16.775281	163	243	9	1	80	0.0125000
NODE_32676_length_544_cov_16.775281	163	243	10	5	80	0.0625000
NODE_32676_length_544_cov_16.775281	163	243	11	14	80	0.1750000
NODE_32676_length_544_cov_16.775281	163	243	12	3	80	0.0375000
NODE_32676_length_544_cov_16.775281	216	296	8	80	80	1.0000000
NODE_32677_length_544_cov_8.943820	81	161	0	80	80	1.0000000
NODE_32677_length_544_cov_8.943820	134	214	0	80	80	1.0000000
NODE_32678_length_544_cov_8.537079	283	363	4	8	80	0.1000000
NODE_32678_length_544_cov_8.537079	283	363	5	63	80	0.7875000
NODE_32678_length_544_cov_8.537079	283	363	7	9	80	0.1125000
NODE_32678_length_544_cov_8.537079	336	416	1	8	80	0.1000000
NODE_32678_length_544_cov_8.537079	336	416	2	3	80	0.0375000
NODE_32678_length_544_cov_8.537079	336	416	5	69	80	0.8625000
NODE_32680_length_544_cov_8.440449	209	289	2	4	80	0.0500000
NODE_32680_length_544_cov_8.440449	209	289	4	76	80	0.9500000
NODE_32680_length_544_cov_8.440449	262	342	2	42	80	0.5250000
NODE_32680_length_544_cov_8.440449	262	342	4	38	80	0.4750000
NODE_32681_length_544_cov_7.604494	332	412	3	39	80	0.4875000
NODE_32681_length_544_cov_7.604494	332	412	4	41	80	0.5125000
NODE_32681_length_544_cov_7.604494	385	465	2	25	80	0.3125000
NODE_32681_length_544_cov_7.604494	385	465	3	13	80	0.1625000
NODE_32681_length_544_cov_7.604494	385	465	4	42	80	0.5250000
NODE_32684_length_544_cov_6.000000	461	513	1	52	52	1.0000000
NODE_32830_length_543_cov_38.790541	116	196	13	3	80	0.0375000
NODE_32830_length_543_cov_38.790541	116	196	14	14	80	0.1750000
NODE_32830_length_543_cov_38.790541	116	196	15	6	80	0.0750000
NODE_32830_length_543_cov_38.790541	116	196	16	5	80	0.0625000
NODE_32830_length_543_cov_38.790541	116	196	17	19	80	0.2375000
NODE_32830_length_543_cov_38.790541	116	196	19	6	80	0.0750000
NODE_32830_length_543_cov_38.790541	116	196	20	5	80	0.0625000
NODE_32830_length_543_cov_38.790541	116	196	21	18	80	0.2250000
NODE_32830_length_543_cov_38.790541	116	196	22	4	80	0.0500000
NODE_32830_length_543_cov_38.790541	169	249	15	2	80	0.0250000
NODE_32830_length_543_cov_38.790541	169	249	16	8	80	0.1000000
NODE_32830_length_543_cov_38.790541	169	249	17	13	80	0.1625000
NODE_32830_length_543_cov_38.790541	169	249	18	6	80	0.0750000
NODE_32830_length_543_cov_38.790541	169	249	19	4	80	0.0500000
NODE_32830_length_543_cov_38.790541	169	249	20	6	80	0.0750000
NODE_32830_length_543_cov_38.790541	169	249	21	29	80	0.3625000
NODE_32830_length_543_cov_38.790541	169	249	22	12	80	0.1500000
NODE_32831_length_543_cov_31.713964	193	273	19	2	80	0.0250000
NODE_32831_length_543_cov_31.713964	193	273	21	3	80	0.0375000
NODE_32831_length_543_cov_31.713964	193	273	22	11	80	0.1375000
NODE_32831_length_543_cov_31.713964	193	273	23	13	80	0.1625000
NODE_32831_length_543_cov_31.713964	193	273	24	13	80	0.1625000
NODE_32831_length_543_cov_31.713964	193	273	25	21	80	0.2625000
NODE_32831_length_543_cov_31.713964	193	273	26	17	80	0.2125000
NODE_32831_length_543_cov_31.713964	246	326	19	26	80	0.3250000
NODE_32831_length_543_cov_31.713964	246	326	20	7	80	0.0875000
NODE_32831_length_543_cov_31.713964	246	326	21	7	80	0.0875000
NODE_32831_length_543_cov_31.713964	246	326	22	24	80	0.3000000
NODE_32831_length_543_cov_31.713964	246	326	23	11	80	0.1375000
NODE_32831_length_543_cov_31.713964	246	326	24	5	80	0.0625000
NODE_32832_length_543_cov_13.689189	118	198	3	1	80	0.0125000
NODE_32832_length_543_cov_13.689189	118	198	5	57	80	0.7125000
NODE_32832_length_543_cov_13.689189	118	198	6	17	80	0.2125000
NODE_32832_length_543_cov_13.689189	118	198	7	5	80	0.0625000
NODE_32832_length_543_cov_13.689189	171	251	5	5	80	0.0625000
NODE_32832_length_543_cov_13.689189	171	251	6	38	80	0.4750000
NODE_32832_length_543_cov_13.689189	171	251	7	5	80	0.0625000
NODE_32832_length_543_cov_13.689189	171	251	8	32	80	0.4000000
NODE_32833_length_543_cov_10.601351	271	351	0	80	80	1.0000000
NODE_32833_length_543_cov_10.601351	324	404	0	80	80	1.0000000
NODE_32833_length_543_cov_10.601351	400	480	0	80	80	1.0000000
NODE_32833_length_543_cov_10.601351	453	533	0	80	80	1.0000000
NODE_32834_length_543_cov_9.202703	291	341	1	50	50	1.0000000
NODE_32834_length_543_cov_9.202703	347	384	0	31	37	0.8378378
NODE_32834_length_543_cov_9.202703	347	384	1	6	37	0.1621622
NODE_32835_length_543_cov_7.722973	300	378	6	72	78	0.9230769
NODE_32835_length_543_cov_7.722973	300	378	7	6	78	0.0769231
NODE_32835_length_543_cov_7.722973	351	431	1	8	80	0.1000000
NODE_32835_length_543_cov_7.722973	351	431	2	11	80	0.1375000
NODE_32835_length_543_cov_7.722973	351	431	3	3	80	0.0375000
NODE_32835_length_543_cov_7.722973	351	431	5	8	80	0.1000000
NODE_32835_length_543_cov_7.722973	351	431	6	38	80	0.4750000
NODE_32835_length_543_cov_7.722973	351	431	7	12	80	0.1500000
NODE_32836_length_543_cov_6.815315	181	260	0	79	79	1.0000000
NODE_32845_length_543_cov_4.704955	145	225	0	80	80	1.0000000
NODE_32845_length_543_cov_4.704955	198	275	0	77	77	1.0000000
NODE_32864_length_543_cov_3.301802	247	312	1	25	65	0.3846154
NODE_32864_length_543_cov_3.301802	247	312	2	40	65	0.6153846
NODE_32875_length_543_cov_2.635135	253	316	0	63	63	1.0000000
NODE_32875_length_543_cov_2.635135	293	373	0	80	80	1.0000000
NODE_33002_length_543_cov_0.682432	98	178	0	80	80	1.0000000
NODE_33012_length_542_cov_57.370203	287	367	14	5	80	0.0625000
NODE_33012_length_542_cov_57.370203	287	367	19	17	80	0.2125000
NODE_33012_length_542_cov_57.370203	287	367	20	58	80	0.7250000
NODE_33012_length_542_cov_57.370203	340	378	17	1	38	0.0263158
NODE_33012_length_542_cov_57.370203	340	378	19	27	38	0.7105263
NODE_33012_length_542_cov_57.370203	340	378	20	10	38	0.2631579
NODE_33014_length_542_cov_11.616253	277	357	3	23	80	0.2875000
NODE_33014_length_542_cov_11.616253	277	357	4	57	80	0.7125000
NODE_33014_length_542_cov_11.616253	330	410	1	33	80	0.4125000
NODE_33014_length_542_cov_11.616253	330	410	2	10	80	0.1250000
NODE_33014_length_542_cov_11.616253	330	410	3	33	80	0.4125000
NODE_33014_length_542_cov_11.616253	330	410	4	4	80	0.0500000
NODE_33015_length_542_cov_9.988713	253	333	0	15	80	0.1875000
NODE_33015_length_542_cov_9.988713	253	333	1	65	80	0.8125000
NODE_33015_length_542_cov_9.988713	306	386	0	68	80	0.8500000
NODE_33015_length_542_cov_9.988713	306	386	1	12	80	0.1500000
NODE_33018_length_542_cov_7.934537	215	295	3	46	80	0.5750000
NODE_33018_length_542_cov_7.934537	215	295	5	34	80	0.4250000
NODE_33018_length_542_cov_7.934537	268	348	5	30	80	0.3750000
NODE_33018_length_542_cov_7.934537	268	348	6	15	80	0.1875000
NODE_33018_length_542_cov_7.934537	268	348	8	2	80	0.0250000
NODE_33018_length_542_cov_7.934537	268	348	10	1	80	0.0125000
NODE_33018_length_542_cov_7.934537	268	348	11	32	80	0.4000000
NODE_33020_length_542_cov_7.266366	159	239	2	21	80	0.2625000
NODE_33020_length_542_cov_7.266366	159	239	3	59	80	0.7375000
NODE_33021_length_542_cov_7.069977	230	304	4	74	74	1.0000000
NODE_33021_length_542_cov_7.069977	284	362	0	31	78	0.3974359
NODE_33021_length_542_cov_7.069977	284	362	2	6	78	0.0769231
NODE_33021_length_542_cov_7.069977	284	362	4	41	78	0.5256410
NODE_33025_length_542_cov_4.783296	237	267	0	30	30	1.0000000
NODE_33035_length_542_cov_3.882619	275	303	0	28	28	1.0000000
NODE_33040_length_542_cov_3.600451	82	131	0	49	49	1.0000000
NODE_33188_length_541_cov_22.463801	247	327	4	13	80	0.1625000
NODE_33188_length_541_cov_22.463801	247	327	5	6	80	0.0750000
NODE_33188_length_541_cov_22.463801	247	327	6	2	80	0.0250000
NODE_33188_length_541_cov_22.463801	247	327	7	4	80	0.0500000
NODE_33188_length_541_cov_22.463801	247	327	8	55	80	0.6875000
NODE_33188_length_541_cov_22.463801	300	380	3	43	80	0.5375000
NODE_33188_length_541_cov_22.463801	300	380	4	23	80	0.2875000
NODE_33188_length_541_cov_22.463801	300	380	8	14	80	0.1750000
NODE_33190_length_541_cov_11.070136	60	140	0	80	80	1.0000000
NODE_33190_length_541_cov_11.070136	113	193	0	80	80	1.0000000
NODE_33204_length_541_cov_3.690045	179	250	0	71	71	1.0000000
NODE_33300_length_541_cov_1.187783	352	400	0	48	48	1.0000000
NODE_33359_length_540_cov_78.353741	219	299	4	11	80	0.1375000
NODE_33359_length_540_cov_78.353741	219	299	5	69	80	0.8625000
NODE_33359_length_540_cov_78.353741	272	352	4	64	80	0.8000000
NODE_33359_length_540_cov_78.353741	272	352	5	16	80	0.2000000
NODE_33360_length_540_cov_33.473923	59	139	2	41	80	0.5125000
NODE_33360_length_540_cov_33.473923	59	139	4	39	80	0.4875000
NODE_33360_length_540_cov_33.473923	112	192	2	16	80	0.2000000
NODE_33360_length_540_cov_33.473923	112	192	4	64	80	0.8000000
NODE_33361_length_540_cov_20.380952	97	177	5	12	80	0.1500000
NODE_33361_length_540_cov_20.380952	97	177	7	15	80	0.1875000
NODE_33361_length_540_cov_20.380952	97	177	8	42	80	0.5250000
NODE_33361_length_540_cov_20.380952	97	177	10	11	80	0.1375000
NODE_33361_length_540_cov_20.380952	150	230	8	26	80	0.3250000
NODE_33361_length_540_cov_20.380952	150	230	9	10	80	0.1250000
NODE_33361_length_540_cov_20.380952	150	230	10	41	80	0.5125000
NODE_33361_length_540_cov_20.380952	150	230	11	3	80	0.0375000
NODE_33362_length_540_cov_12.657596	248	328	1	38	80	0.4750000
NODE_33362_length_540_cov_12.657596	248	328	2	42	80	0.5250000
NODE_33362_length_540_cov_12.657596	301	381	1	32	80	0.4000000
NODE_33362_length_540_cov_12.657596	301	381	2	48	80	0.6000000
NODE_33363_length_540_cov_11.111111	180	260	0	6	80	0.0750000
NODE_33363_length_540_cov_11.111111	180	260	1	74	80	0.9250000
NODE_33363_length_540_cov_11.111111	233	313	0	59	80	0.7375000
NODE_33363_length_540_cov_11.111111	233	313	1	21	80	0.2625000
NODE_33365_length_540_cov_6.328798	260	340	4	11	80	0.1375000
NODE_33365_length_540_cov_6.328798	260	340	5	46	80	0.5750000
NODE_33365_length_540_cov_6.328798	260	340	6	23	80	0.2875000
NODE_33365_length_540_cov_6.328798	313	393	0	20	80	0.2500000
NODE_33365_length_540_cov_6.328798	313	393	2	28	80	0.3500000
NODE_33365_length_540_cov_6.328798	313	393	3	1	80	0.0125000
NODE_33365_length_540_cov_6.328798	313	393	4	15	80	0.1875000
NODE_33365_length_540_cov_6.328798	313	393	5	16	80	0.2000000
NODE_33382_length_540_cov_3.587302	351	411	0	60	60	1.0000000
NODE_33503_length_539_cov_1023.604545	264	344	159	1	80	0.0125000
NODE_33503_length_539_cov_1023.604545	264	344	160	3	80	0.0375000
NODE_33503_length_539_cov_1023.604545	264	344	161	2	80	0.0250000
NODE_33503_length_539_cov_1023.604545	264	344	162	4	80	0.0500000
NODE_33503_length_539_cov_1023.604545	264	344	166	1	80	0.0125000
NODE_33503_length_539_cov_1023.604545	264	344	167	1	80	0.0125000
NODE_33503_length_539_cov_1023.604545	264	344	168	1	80	0.0125000
NODE_33503_length_539_cov_1023.604545	264	344	170	1	80	0.0125000
NODE_33503_length_539_cov_1023.604545	264	344	171	2	80	0.0250000
NODE_33503_length_539_cov_1023.604545	264	344	172	4	80	0.0500000
NODE_33503_length_539_cov_1023.604545	264	344	173	1	80	0.0125000
NODE_33503_length_539_cov_1023.604545	264	344	174	8	80	0.1000000
NODE_33503_length_539_cov_1023.604545	264	344	175	5	80	0.0625000
NODE_33503_length_539_cov_1023.604545	264	344	176	4	80	0.0500000
NODE_33503_length_539_cov_1023.604545	264	344	177	2	80	0.0250000
NODE_33503_length_539_cov_1023.604545	264	344	178	2	80	0.0250000
NODE_33503_length_539_cov_1023.604545	264	344	179	5	80	0.0625000
NODE_33503_length_539_cov_1023.604545	264	344	181	1	80	0.0125000
NODE_33503_length_539_cov_1023.604545	264	344	184	1	80	0.0125000
NODE_33503_length_539_cov_1023.604545	264	344	185	2	80	0.0250000
NODE_33503_length_539_cov_1023.604545	264	344	190	1	80	0.0125000
NODE_33503_length_539_cov_1023.604545	264	344	191	1	80	0.0125000
NODE_33503_length_539_cov_1023.604545	264	344	195	1	80	0.0125000
NODE_33503_length_539_cov_1023.604545	264	344	196	1	80	0.0125000
NODE_33503_length_539_cov_1023.604545	264	344	199	1	80	0.0125000
NODE_33503_length_539_cov_1023.604545	264	344	201	1	80	0.0125000
NODE_33503_length_539_cov_1023.604545	264	344	207	2	80	0.0250000
NODE_33503_length_539_cov_1023.604545	264	344	208	2	80	0.0250000
NODE_33503_length_539_cov_1023.604545	264	344	209	5	80	0.0625000
NODE_33503_length_539_cov_1023.604545	264	344	210	2	80	0.0250000
NODE_33503_length_539_cov_1023.604545	264	344	211	2	80	0.0250000
NODE_33503_length_539_cov_1023.604545	264	344	212	2	80	0.0250000
NODE_33503_length_539_cov_1023.604545	264	344	213	1	80	0.0125000
NODE_33503_length_539_cov_1023.604545	264	344	215	1	80	0.0125000
NODE_33503_length_539_cov_1023.604545	264	344	216	3	80	0.0375000
NODE_33503_length_539_cov_1023.604545	264	344	217	3	80	0.0375000
NODE_33503_length_539_cov_1023.604545	317	397	195	1	80	0.0125000
NODE_33503_length_539_cov_1023.604545	317	397	196	1	80	0.0125000
NODE_33503_length_539_cov_1023.604545	317	397	199	1	80	0.0125000
NODE_33503_length_539_cov_1023.604545	317	397	201	1	80	0.0125000
NODE_33503_length_539_cov_1023.604545	317	397	205	1	80	0.0125000
NODE_33503_length_539_cov_1023.604545	317	397	206	2	80	0.0250000
NODE_33503_length_539_cov_1023.604545	317	397	207	5	80	0.0625000
NODE_33503_length_539_cov_1023.604545	317	397	208	6	80	0.0750000
NODE_33503_length_539_cov_1023.604545	317	397	209	7	80	0.0875000
NODE_33503_length_539_cov_1023.604545	317	397	210	4	80	0.0500000
NODE_33503_length_539_cov_1023.604545	317	397	211	2	80	0.0250000
NODE_33503_length_539_cov_1023.604545	317	397	212	7	80	0.0875000
NODE_33503_length_539_cov_1023.604545	317	397	213	4	80	0.0500000
NODE_33503_length_539_cov_1023.604545	317	397	214	2	80	0.0250000
NODE_33503_length_539_cov_1023.604545	317	397	215	6	80	0.0750000
NODE_33503_length_539_cov_1023.604545	317	397	216	9	80	0.1125000
NODE_33503_length_539_cov_1023.604545	317	397	217	5	80	0.0625000
NODE_33503_length_539_cov_1023.604545	317	397	218	9	80	0.1125000
NODE_33503_length_539_cov_1023.604545	317	397	219	2	80	0.0250000
NODE_33503_length_539_cov_1023.604545	317	397	220	5	80	0.0625000
NODE_33504_length_539_cov_99.579545	478	539	4	47	61	0.7704918
NODE_33504_length_539_cov_99.579545	478	539	5	14	61	0.2295082
NODE_33505_length_539_cov_15.247727	217	297	2	7	80	0.0875000
NODE_33505_length_539_cov_15.247727	217	297	4	4	80	0.0500000
NODE_33505_length_539_cov_15.247727	217	297	5	29	80	0.3625000
NODE_33505_length_539_cov_15.247727	217	297	7	20	80	0.2500000
NODE_33505_length_539_cov_15.247727	217	297	8	20	80	0.2500000
NODE_33505_length_539_cov_15.247727	270	350	6	43	80	0.5375000
NODE_33505_length_539_cov_15.247727	270	350	7	7	80	0.0875000
NODE_33505_length_539_cov_15.247727	270	350	8	30	80	0.3750000
NODE_33506_length_539_cov_14.172727	278	350	0	72	72	1.0000000
NODE_33507_length_539_cov_13.154545	118	198	0	80	80	1.0000000
NODE_33507_length_539_cov_13.154545	171	251	0	80	80	1.0000000
NODE_33508_length_539_cov_10.811364	48	128	0	80	80	1.0000000
NODE_33508_length_539_cov_10.811364	101	181	0	80	80	1.0000000
NODE_33509_length_539_cov_9.563636	201	277	0	13	76	0.1710526
NODE_33509_length_539_cov_9.563636	201	277	1	47	76	0.6184211
NODE_33509_length_539_cov_9.563636	201	277	2	16	76	0.2105263
NODE_33510_length_539_cov_7.934091	311	369	1	18	58	0.3103448
NODE_33510_length_539_cov_7.934091	311	369	2	40	58	0.6896552
NODE_33510_length_539_cov_7.934091	342	422	2	80	80	1.0000000
NODE_33517_length_539_cov_5.740909	251	319	0	45	68	0.6617647
NODE_33517_length_539_cov_5.740909	251	319	1	19	68	0.2794118
NODE_33517_length_539_cov_5.740909	251	319	2	4	68	0.0588235
NODE_33517_length_539_cov_5.740909	301	372	1	14	71	0.1971831
NODE_33517_length_539_cov_5.740909	301	372	2	10	71	0.1408451
NODE_33517_length_539_cov_5.740909	301	372	3	47	71	0.6619718
NODE_33533_length_539_cov_3.627273	80	157	0	77	77	1.0000000
NODE_33533_length_539_cov_3.627273	130	175	0	45	45	1.0000000
NODE_33569_length_539_cov_2.143182	325	371	1	10	46	0.2173913
NODE_33569_length_539_cov_2.143182	325	371	2	1	46	0.0217391
NODE_33569_length_539_cov_2.143182	325	371	3	35	46	0.7608696
NODE_33595_length_539_cov_1.618182	408	456	0	48	48	1.0000000
NODE_33623_length_539_cov_1.129545	97	134	0	37	37	1.0000000
NODE_33669_length_538_cov_23.193622	171	256	6	85	85	1.0000000
NODE_33669_length_538_cov_23.193622	225	305	0	17	80	0.2125000
NODE_33669_length_538_cov_23.193622	225	305	2	3	80	0.0375000
NODE_33669_length_538_cov_23.193622	225	305	3	1	80	0.0125000
NODE_33669_length_538_cov_23.193622	225	305	5	2	80	0.0250000
NODE_33669_length_538_cov_23.193622	225	305	6	57	80	0.7125000
NODE_33672_length_538_cov_7.378132	145	225	3	80	80	1.0000000
NODE_33672_length_538_cov_7.378132	198	278	0	25	80	0.3125000
NODE_33672_length_538_cov_7.378132	198	278	1	25	80	0.3125000
NODE_33672_length_538_cov_7.378132	198	278	3	30	80	0.3750000
NODE_33683_length_538_cov_4.496583	277	357	0	80	80	1.0000000
NODE_33683_length_538_cov_4.496583	330	410	0	80	80	1.0000000
NODE_33687_length_538_cov_3.753986	251	309	2	11	58	0.1896552
NODE_33687_length_538_cov_3.753986	251	309	5	1	58	0.0172414
NODE_33687_length_538_cov_3.753986	251	309	6	2	58	0.0344828
NODE_33687_length_538_cov_3.753986	251	309	7	44	58	0.7586207
NODE_33713_length_538_cov_2.239180	256	338	0	82	82	1.0000000
NODE_33814_length_538_cov_0.822323	397	477	0	80	80	1.0000000
NODE_33852_length_537_cov_13.031963	258	309	2	51	51	1.0000000
NODE_33854_length_537_cov_9.552511	198	278	2	36	80	0.4500000
NODE_33854_length_537_cov_9.552511	198	278	3	29	80	0.3625000
NODE_33854_length_537_cov_9.552511	198	278	4	15	80	0.1875000
NODE_33854_length_537_cov_9.552511	251	332	2	65	81	0.8024691
NODE_33854_length_537_cov_9.552511	251	332	3	16	81	0.1975309
NODE_33960_length_537_cov_1.244292	107	187	0	80	80	1.0000000
NODE_34029_length_536_cov_87.622426	430	462	15	32	32	1.0000000
NODE_34030_length_536_cov_11.629291	119	199	0	80	80	1.0000000
NODE_34030_length_536_cov_11.629291	172	252	0	80	80	1.0000000
NODE_34032_length_536_cov_6.613272	286	372	0	86	86	1.0000000
NODE_34035_length_536_cov_5.810069	191	271	0	80	80	1.0000000
NODE_34035_length_536_cov_5.810069	244	324	0	80	80	1.0000000
NODE_34035_length_536_cov_5.810069	374	404	0	30	30	1.0000000
NODE_34039_length_536_cov_4.729977	202	245	0	43	43	1.0000000
NODE_34057_length_536_cov_3.297483	86	126	0	40	40	1.0000000
NODE_34068_length_536_cov_2.796339	223	280	0	57	57	1.0000000
NODE_34094_length_536_cov_1.956522	181	230	0	2	49	0.0408163
NODE_34094_length_536_cov_1.956522	181	230	1	6	49	0.1224490
NODE_34094_length_536_cov_1.956522	181	230	2	41	49	0.8367347
NODE_34095_length_536_cov_1.951945	203	284	0	22	81	0.2716049
NODE_34095_length_536_cov_1.951945	203	284	1	59	81	0.7283950
NODE_34095_length_536_cov_1.951945	306	368	1	62	62	1.0000000
NODE_34209_length_535_cov_32.277523	158	238	2	8	80	0.1000000
NODE_34209_length_535_cov_32.277523	158	238	3	24	80	0.3000000
NODE_34209_length_535_cov_32.277523	158	238	4	48	80	0.6000000
NODE_34209_length_535_cov_32.277523	211	291	1	12	80	0.1500000
NODE_34209_length_535_cov_32.277523	211	291	2	49	80	0.6125000
NODE_34209_length_535_cov_32.277523	211	291	3	1	80	0.0125000
NODE_34209_length_535_cov_32.277523	211	291	4	18	80	0.2250000
NODE_34215_length_535_cov_5.910550	110	162	0	52	52	1.0000000
NODE_34229_length_535_cov_3.795872	217	297	1	10	80	0.1250000
NODE_34229_length_535_cov_3.795872	217	297	3	9	80	0.1125000
NODE_34229_length_535_cov_3.795872	217	297	4	61	80	0.7625000
NODE_34375_length_534_cov_54.331034	435	498	0	58	63	0.9206349
NODE_34375_length_534_cov_54.331034	435	498	1	5	63	0.0793651
NODE_34375_length_534_cov_54.331034	471	534	0	63	63	1.0000000
NODE_34377_length_534_cov_15.462069	460	534	4	74	74	1.0000000
NODE_34377_length_534_cov_15.462069	512	534	4	22	22	1.0000000
NODE_34378_length_534_cov_10.308046	268	348	0	20	80	0.2500000
NODE_34378_length_534_cov_10.308046	268	348	1	60	80	0.7500000
NODE_34378_length_534_cov_10.308046	321	401	1	80	80	1.0000000
NODE_34380_length_534_cov_9.041379	204	284	2	8	80	0.1000000
NODE_34380_length_534_cov_9.041379	204	284	3	30	80	0.3750000
NODE_34380_length_534_cov_9.041379	204	284	4	39	80	0.4875000
NODE_34380_length_534_cov_9.041379	204	284	5	3	80	0.0375000
NODE_34380_length_534_cov_9.041379	257	332	3	66	75	0.8800000
NODE_34380_length_534_cov_9.041379	257	332	4	9	75	0.1200000
NODE_34383_length_534_cov_6.958621	273	303	0	30	30	1.0000000
NODE_34392_length_534_cov_5.022989	291	371	0	40	80	0.5000000
NODE_34392_length_534_cov_5.022989	291	371	1	20	80	0.2500000
NODE_34392_length_534_cov_5.022989	291	371	2	20	80	0.2500000
NODE_34402_length_534_cov_3.873563	110	190	0	80	80	1.0000000
NODE_34409_length_534_cov_3.202299	221	301	0	80	80	1.0000000
NODE_34411_length_534_cov_3.158621	171	200	0	29	29	1.0000000
NODE_34418_length_534_cov_3.002299	175	219	2	44	44	1.0000000
NODE_34489_length_534_cov_1.344828	475	518	0	43	43	1.0000000
NODE_34494_length_534_cov_1.291954	273	336	3	56	63	0.8888889
NODE_34494_length_534_cov_1.291954	273	336	6	7	63	0.1111111
NODE_34511_length_534_cov_1.160920	227	264	0	37	37	1.0000000
NODE_34570_length_533_cov_13.956221	216	296	2	14	80	0.1750000
NODE_34570_length_533_cov_13.956221	216	296	4	66	80	0.8250000
NODE_34570_length_533_cov_13.956221	269	349	1	8	80	0.1000000
NODE_34570_length_533_cov_13.956221	269	349	3	6	80	0.0750000
NODE_34570_length_533_cov_13.956221	269	349	4	66	80	0.8250000
NODE_34575_length_533_cov_8.207373	244	322	0	78	78	1.0000000
NODE_34576_length_533_cov_8.023041	230	310	1	10	80	0.1250000
NODE_34576_length_533_cov_8.023041	230	310	2	70	80	0.8750000
NODE_34576_length_533_cov_8.023041	283	364	1	7	81	0.0864198
NODE_34576_length_533_cov_8.023041	283	364	2	74	81	0.9135802
NODE_34585_length_533_cov_5.170507	308	369	1	61	61	1.0000000
NODE_34588_length_533_cov_4.988479	229	309	1	37	80	0.4625000
NODE_34588_length_533_cov_4.988479	229	309	2	43	80	0.5375000
NODE_34588_length_533_cov_4.988479	282	362	1	37	80	0.4625000
NODE_34588_length_533_cov_4.988479	282	362	2	43	80	0.5375000
NODE_34600_length_533_cov_3.638249	201	265	0	6	64	0.0937500
NODE_34600_length_533_cov_3.638249	201	265	1	58	64	0.9062500
NODE_34603_length_533_cov_3.511521	138	218	0	80	80	1.0000000
NODE_34615_length_533_cov_3.073733	294	340	0	46	46	1.0000000
NODE_34617_length_533_cov_3.052995	256	304	3	14	48	0.2916667
NODE_34617_length_533_cov_3.052995	256	304	4	32	48	0.6666667
NODE_34617_length_533_cov_3.052995	256	304	6	2	48	0.0416667
NODE_34631_length_533_cov_2.366359	229	311	0	82	82	1.0000000
NODE_34635_length_533_cov_2.288018	468	490	0	22	22	1.0000000
NODE_34767_length_532_cov_73.279446	0	64	0	64	64	1.0000000
NODE_34768_length_532_cov_23.055427	168	248	1	80	80	1.0000000
NODE_34768_length_532_cov_23.055427	221	301	1	80	80	1.0000000
NODE_34769_length_532_cov_22.778291	256	336	10	4	80	0.0500000
NODE_34769_length_532_cov_22.778291	256	336	11	39	80	0.4875000
NODE_34769_length_532_cov_22.778291	256	336	12	37	80	0.4625000
NODE_34769_length_532_cov_22.778291	309	389	11	48	80	0.6000000
NODE_34769_length_532_cov_22.778291	309	389	12	22	80	0.2750000
NODE_34769_length_532_cov_22.778291	309	389	13	2	80	0.0250000
NODE_34769_length_532_cov_22.778291	309	389	14	8	80	0.1000000
NODE_34770_length_532_cov_13.279446	85	165	3	19	80	0.2375000
NODE_34770_length_532_cov_13.279446	85	165	5	22	80	0.2750000
NODE_34770_length_532_cov_13.279446	85	165	6	39	80	0.4875000
NODE_34770_length_532_cov_13.279446	138	218	1	14	80	0.1750000
NODE_34770_length_532_cov_13.279446	138	218	3	5	80	0.0625000
NODE_34770_length_532_cov_13.279446	138	218	5	21	80	0.2625000
NODE_34770_length_532_cov_13.279446	138	218	6	40	80	0.5000000
NODE_34774_length_532_cov_7.591224	171	235	0	64	64	1.0000000
NODE_34774_length_532_cov_7.591224	172	235	0	63	63	1.0000000
NODE_34774_length_532_cov_7.591224	173	226	0	53	53	1.0000000
NODE_34774_length_532_cov_7.591224	173	228	0	55	55	1.0000000
NODE_34774_length_532_cov_7.591224	208	282	0	43	74	0.5810811
NODE_34774_length_532_cov_7.591224	208	282	1	31	74	0.4189189
NODE_34774_length_532_cov_7.591224	208	282	0	43	74	0.5810811
NODE_34774_length_532_cov_7.591224	208	282	1	31	74	0.4189189
NODE_34774_length_532_cov_7.591224	208	282	0	43	74	0.5810811
NODE_34774_length_532_cov_7.591224	208	282	1	31	74	0.4189189
NODE_34774_length_532_cov_7.591224	208	282	0	43	74	0.5810811
NODE_34774_length_532_cov_7.591224	208	282	1	31	74	0.4189189
NODE_34788_length_532_cov_4.524249	84	151	0	67	67	1.0000000
NODE_34788_length_532_cov_4.524249	137	218	0	81	81	1.0000000
NODE_34838_length_532_cov_1.866051	263	309	0	46	46	1.0000000
NODE_34845_length_532_cov_1.757506	126	146	0	20	20	1.0000000
NODE_34948_length_531_cov_35.539352	7	45	2	5	38	0.1315790
NODE_34948_length_531_cov_35.539352	7	45	3	33	38	0.8684211
NODE_34948_length_531_cov_35.539352	18	98	3	31	80	0.3875000
NODE_34948_length_531_cov_35.539352	18	98	4	23	80	0.2875000
NODE_34948_length_531_cov_35.539352	18	98	5	7	80	0.0875000
NODE_34948_length_531_cov_35.539352	18	98	6	5	80	0.0625000
NODE_34948_length_531_cov_35.539352	18	98	7	14	80	0.1750000
NODE_34949_length_531_cov_13.162037	129	209	1	9	80	0.1125000
NODE_34949_length_531_cov_13.162037	129	209	2	71	80	0.8875000
NODE_34949_length_531_cov_13.162037	182	251	1	14	69	0.2028985
NODE_34949_length_531_cov_13.162037	182	251	2	55	69	0.7971014
NODE_34953_length_531_cov_6.821759	242	322	0	80	80	1.0000000
NODE_34953_length_531_cov_6.821759	295	375	0	80	80	1.0000000
NODE_34958_length_531_cov_5.261574	261	336	1	75	75	1.0000000
NODE_34958_length_531_cov_5.261574	309	362	1	53	53	1.0000000
NODE_34963_length_531_cov_4.527778	177	255	0	47	78	0.6025641
NODE_34963_length_531_cov_4.527778	177	255	4	31	78	0.3974359
NODE_34965_length_531_cov_4.319444	283	363	6	25	80	0.3125000
NODE_34965_length_531_cov_4.319444	283	363	9	55	80	0.6875000
NODE_34965_length_531_cov_4.319444	336	416	6	78	80	0.9750000
NODE_34965_length_531_cov_4.319444	336	416	9	2	80	0.0250000
NODE_34979_length_531_cov_3.488426	238	318	0	80	80	1.0000000
NODE_34979_length_531_cov_3.488426	291	371	0	80	80	1.0000000
NODE_34980_length_531_cov_3.375000	153	207	0	13	54	0.2407407
NODE_34980_length_531_cov_3.375000	153	207	1	21	54	0.3888889
NODE_34980_length_531_cov_3.375000	153	207	2	20	54	0.3703704
NODE_34980_length_531_cov_3.375000	180	260	1	7	80	0.0875000
NODE_34980_length_531_cov_3.375000	180	260	2	73	80	0.9125000
NODE_34986_length_531_cov_3.111111	243	323	3	24	80	0.3000000
NODE_34986_length_531_cov_3.111111	243	323	4	56	80	0.7000000
NODE_34986_length_531_cov_3.111111	296	376	2	41	80	0.5125000
NODE_34986_length_531_cov_3.111111	296	376	4	39	80	0.4875000
NODE_35008_length_531_cov_2.201389	302	373	0	71	71	1.0000000
NODE_35008_length_531_cov_2.201389	350	426	0	76	76	1.0000000
NODE_35141_length_530_cov_30.605568	250	330	7	5	80	0.0625000
NODE_35141_length_530_cov_30.605568	250	330	8	16	80	0.2000000
NODE_35141_length_530_cov_30.605568	250	330	9	8	80	0.1000000
NODE_35141_length_530_cov_30.605568	250	330	10	8	80	0.1000000
NODE_35141_length_530_cov_30.605568	250	330	11	3	80	0.0375000
NODE_35141_length_530_cov_30.605568	250	330	13	6	80	0.0750000
NODE_35141_length_530_cov_30.605568	250	330	14	31	80	0.3875000
NODE_35141_length_530_cov_30.605568	250	330	15	3	80	0.0375000
NODE_35141_length_530_cov_30.605568	303	383	13	3	80	0.0375000
NODE_35141_length_530_cov_30.605568	303	383	14	24	80	0.3000000
NODE_35141_length_530_cov_30.605568	303	383	15	3	80	0.0375000
NODE_35141_length_530_cov_30.605568	303	383	16	2	80	0.0250000
NODE_35141_length_530_cov_30.605568	303	383	17	3	80	0.0375000
NODE_35141_length_530_cov_30.605568	303	383	18	36	80	0.4500000
NODE_35141_length_530_cov_30.605568	303	383	19	9	80	0.1125000
NODE_35142_length_530_cov_16.937355	404	484	0	80	80	1.0000000
NODE_35142_length_530_cov_16.937355	457	530	0	73	73	1.0000000
NODE_35143_length_530_cov_9.902552	273	353	0	80	80	1.0000000
NODE_35143_length_530_cov_9.902552	326	406	0	80	80	1.0000000
NODE_35144_length_530_cov_7.928074	46	126	0	80	80	1.0000000
NODE_35144_length_530_cov_7.928074	99	179	0	80	80	1.0000000
NODE_35150_length_530_cov_4.647332	188	268	0	80	80	1.0000000
NODE_35150_length_530_cov_4.647332	241	321	0	80	80	1.0000000
NODE_35154_length_530_cov_4.389791	162	242	1	80	80	1.0000000
NODE_35159_length_530_cov_4.046404	76	111	0	35	35	1.0000000
NODE_35319_length_529_cov_38.983721	140	220	6	21	80	0.2625000
NODE_35319_length_529_cov_38.983721	140	220	7	34	80	0.4250000
NODE_35319_length_529_cov_38.983721	140	220	8	23	80	0.2875000
NODE_35319_length_529_cov_38.983721	140	220	9	2	80	0.0250000
NODE_35320_length_529_cov_18.223256	189	269	21	29	80	0.3625000
NODE_35320_length_529_cov_18.223256	189	269	24	6	80	0.0750000
NODE_35320_length_529_cov_18.223256	189	269	25	5	80	0.0625000
NODE_35320_length_529_cov_18.223256	189	269	30	40	80	0.5000000
NODE_35320_length_529_cov_18.223256	242	322	20	2	80	0.0250000
NODE_35320_length_529_cov_18.223256	242	322	30	37	80	0.4625000
NODE_35320_length_529_cov_18.223256	242	322	31	1	80	0.0125000
NODE_35320_length_529_cov_18.223256	242	322	32	13	80	0.1625000
NODE_35320_length_529_cov_18.223256	242	322	33	18	80	0.2250000
NODE_35320_length_529_cov_18.223256	242	322	34	3	80	0.0375000
NODE_35320_length_529_cov_18.223256	242	322	35	1	80	0.0125000
NODE_35320_length_529_cov_18.223256	242	322	36	5	80	0.0625000
NODE_35321_length_529_cov_17.009302	358	438	9	16	80	0.2000000
NODE_35321_length_529_cov_17.009302	358	438	16	40	80	0.5000000
NODE_35321_length_529_cov_17.009302	358	438	17	24	80	0.3000000
NODE_35321_length_529_cov_17.009302	411	491	0	12	80	0.1500000
NODE_35321_length_529_cov_17.009302	411	491	9	57	80	0.7125000
NODE_35321_length_529_cov_17.009302	411	491	16	1	80	0.0125000
NODE_35321_length_529_cov_17.009302	411	491	17	10	80	0.1250000
NODE_35331_length_529_cov_6.195349	211	291	0	80	80	1.0000000
NODE_35331_length_529_cov_6.195349	264	322	0	58	58	1.0000000
NODE_35336_length_529_cov_5.176744	139	207	1	12	68	0.1764706
NODE_35336_length_529_cov_5.176744	139	207	2	7	68	0.1029412
NODE_35336_length_529_cov_5.176744	139	207	3	49	68	0.7205882
NODE_35336_length_529_cov_5.176744	185	260	3	46	75	0.6133333
NODE_35336_length_529_cov_5.176744	185	260	4	29	75	0.3866667
NODE_35364_length_529_cov_2.883721	223	281	0	58	58	1.0000000
NODE_35374_length_529_cov_2.660465	89	168	0	79	79	1.0000000
NODE_35375_length_529_cov_2.595349	278	321	1	43	43	1.0000000
NODE_35384_length_529_cov_2.272093	247	313	0	66	66	1.0000000
NODE_35427_length_529_cov_1.597674	289	332	0	43	43	1.0000000
NODE_35521_length_528_cov_25.808858	233	313	2	14	80	0.1750000
NODE_35521_length_528_cov_25.808858	233	313	4	18	80	0.2250000
NODE_35521_length_528_cov_25.808858	233	313	6	48	80	0.6000000
NODE_35521_length_528_cov_25.808858	286	366	2	28	80	0.3500000
NODE_35521_length_528_cov_25.808858	286	366	4	19	80	0.2375000
NODE_35521_length_528_cov_25.808858	286	366	6	33	80	0.4125000
NODE_35522_length_528_cov_17.331002	219	299	1	11	80	0.1375000
NODE_35522_length_528_cov_17.331002	219	299	2	23	80	0.2875000
NODE_35522_length_528_cov_17.331002	219	299	3	13	80	0.1625000
NODE_35522_length_528_cov_17.331002	219	299	4	33	80	0.4125000
NODE_35522_length_528_cov_17.331002	272	352	4	80	80	1.0000000
NODE_35523_length_528_cov_16.165501	262	342	1	47	80	0.5875000
NODE_35523_length_528_cov_16.165501	262	342	2	21	80	0.2625000
NODE_35523_length_528_cov_16.165501	262	342	3	1	80	0.0125000
NODE_35523_length_528_cov_16.165501	262	342	4	11	80	0.1375000
NODE_35523_length_528_cov_16.165501	315	395	0	25	80	0.3125000
NODE_35523_length_528_cov_16.165501	315	395	1	55	80	0.6875000
NODE_35529_length_528_cov_5.776224	204	284	0	80	80	1.0000000
NODE_35529_length_528_cov_5.776224	257	337	0	80	80	1.0000000
NODE_35542_length_528_cov_4.016317	235	315	0	80	80	1.0000000
NODE_35542_length_528_cov_4.016317	288	368	0	80	80	1.0000000
NODE_35545_length_528_cov_3.799534	144	192	0	48	48	1.0000000
NODE_35561_length_528_cov_2.902098	252	305	0	53	53	1.0000000
NODE_35575_length_528_cov_2.324009	137	188	0	18	51	0.3529412
NODE_35575_length_528_cov_2.324009	137	188	1	33	51	0.6470588
NODE_35575_length_528_cov_2.324009	161	241	1	80	80	1.0000000
NODE_35597_length_528_cov_1.755245	268	348	0	80	80	1.0000000
NODE_35597_length_528_cov_1.755245	321	401	0	80	80	1.0000000
NODE_35687_length_527_cov_19.247664	306	386	2	43	80	0.5375000
NODE_35687_length_527_cov_19.247664	306	386	4	37	80	0.4625000
NODE_35687_length_527_cov_19.247664	359	439	2	61	80	0.7625000
NODE_35687_length_527_cov_19.247664	359	439	4	19	80	0.2375000
NODE_35688_length_527_cov_15.974299	250	349	0	87	99	0.8787879
NODE_35688_length_527_cov_15.974299	250	349	1	12	99	0.1212121
NODE_35688_length_527_cov_15.974299	322	402	0	80	80	1.0000000
NODE_35691_length_527_cov_8.221963	235	315	0	9	80	0.1125000
NODE_35691_length_527_cov_8.221963	235	315	1	28	80	0.3500000
NODE_35691_length_527_cov_8.221963	235	315	2	43	80	0.5375000
NODE_35691_length_527_cov_8.221963	288	368	2	80	80	1.0000000
NODE_35693_length_527_cov_7.200935	190	270	0	80	80	1.0000000
NODE_35693_length_527_cov_7.200935	243	346	0	103	103	1.0000000
NODE_35693_length_527_cov_7.200935	342	422	0	37	80	0.4625000
NODE_35693_length_527_cov_7.200935	342	422	1	43	80	0.5375000
NODE_35693_length_527_cov_7.200935	395	475	1	80	80	1.0000000
NODE_35696_length_527_cov_6.862150	279	359	0	80	80	1.0000000
NODE_35697_length_527_cov_6.046729	155	235	0	9	80	0.1125000
NODE_35697_length_527_cov_6.046729	155	235	2	71	80	0.8875000
NODE_35697_length_527_cov_6.046729	208	288	2	80	80	1.0000000
NODE_35736_length_527_cov_2.238318	226	306	0	80	80	1.0000000
NODE_35858_length_526_cov_50.866511	169	242	0	73	73	1.0000000
NODE_35858_length_526_cov_50.866511	215	295	0	80	80	1.0000000
NODE_35858_length_526_cov_50.866511	291	371	0	80	80	1.0000000
NODE_35858_length_526_cov_50.866511	344	424	0	80	80	1.0000000
NODE_35860_length_526_cov_26.395785	315	395	16	11	80	0.1375000
NODE_35860_length_526_cov_26.395785	315	395	21	11	80	0.1375000
NODE_35860_length_526_cov_26.395785	315	395	22	1	80	0.0125000
NODE_35860_length_526_cov_26.395785	315	395	23	57	80	0.7125000
NODE_35860_length_526_cov_26.395785	368	448	9	14	80	0.1750000
NODE_35860_length_526_cov_26.395785	368	448	10	1	80	0.0125000
NODE_35860_length_526_cov_26.395785	368	448	11	9	80	0.1125000
NODE_35860_length_526_cov_26.395785	368	448	13	2	80	0.0250000
NODE_35860_length_526_cov_26.395785	368	448	15	6	80	0.0750000
NODE_35860_length_526_cov_26.395785	368	448	21	30	80	0.3750000
NODE_35860_length_526_cov_26.395785	368	448	22	1	80	0.0125000
NODE_35860_length_526_cov_26.395785	368	448	23	17	80	0.2125000
NODE_35861_length_526_cov_16.611241	305	385	3	32	80	0.4000000
NODE_35861_length_526_cov_16.611241	305	385	4	35	80	0.4375000
NODE_35861_length_526_cov_16.611241	305	385	6	13	80	0.1625000
NODE_35861_length_526_cov_16.611241	358	438	4	14	80	0.1750000
NODE_35861_length_526_cov_16.611241	358	438	6	66	80	0.8250000
NODE_35866_length_526_cov_6.215457	303	351	0	48	48	1.0000000
NODE_35877_length_526_cov_3.936768	118	142	0	15	24	0.6250000
NODE_35877_length_526_cov_3.936768	118	142	1	9	24	0.3750000
NODE_35877_length_526_cov_3.936768	118	163	0	15	45	0.3333333
NODE_35877_length_526_cov_3.936768	118	163	1	30	45	0.6666667
NODE_35901_length_526_cov_2.466042	138	184	0	46	46	1.0000000
NODE_36055_length_525_cov_33.910798	98	178	0	50	80	0.6250000
NODE_36055_length_525_cov_33.910798	98	178	1	7	80	0.0875000
NODE_36055_length_525_cov_33.910798	98	178	2	23	80	0.2875000
NODE_36055_length_525_cov_33.910798	151	231	0	80	80	1.0000000
NODE_36055_length_525_cov_33.910798	159	231	0	72	72	1.0000000
NODE_36058_length_525_cov_8.788732	175	255	0	80	80	1.0000000
NODE_36058_length_525_cov_8.788732	228	308	0	80	80	1.0000000
NODE_36059_length_525_cov_7.880282	242	285	1	21	43	0.4883721
NODE_36059_length_525_cov_7.880282	242	285	2	22	43	0.5116279
NODE_36098_length_525_cov_2.417840	229	306	0	77	77	1.0000000
NODE_36230_length_524_cov_21.649412	262	342	14	8	80	0.1000000
NODE_36230_length_524_cov_21.649412	262	342	16	46	80	0.5750000
NODE_36230_length_524_cov_21.649412	262	342	19	4	80	0.0500000
NODE_36230_length_524_cov_21.649412	262	342	21	6	80	0.0750000
NODE_36230_length_524_cov_21.649412	262	342	22	8	80	0.1000000
NODE_36230_length_524_cov_21.649412	262	342	23	8	80	0.1000000
NODE_36230_length_524_cov_21.649412	315	395	16	1	80	0.0125000
NODE_36230_length_524_cov_21.649412	315	395	17	14	80	0.1750000
NODE_36230_length_524_cov_21.649412	315	395	19	4	80	0.0500000
NODE_36230_length_524_cov_21.649412	315	395	20	2	80	0.0250000
NODE_36230_length_524_cov_21.649412	315	395	21	6	80	0.0750000
NODE_36230_length_524_cov_21.649412	315	395	22	8	80	0.1000000
NODE_36230_length_524_cov_21.649412	315	395	23	45	80	0.5625000
NODE_36231_length_524_cov_14.131765	136	201	0	65	65	1.0000000
NODE_36232_length_524_cov_10.392941	237	317	3	21	80	0.2625000
NODE_36232_length_524_cov_10.392941	237	317	4	7	80	0.0875000
NODE_36232_length_524_cov_10.392941	237	317	5	22	80	0.2750000
NODE_36232_length_524_cov_10.392941	237	317	6	30	80	0.3750000
NODE_36232_length_524_cov_10.392941	290	370	4	60	80	0.7500000
NODE_36232_length_524_cov_10.392941	290	370	6	20	80	0.2500000
NODE_36262_length_524_cov_3.221176	195	272	0	77	77	1.0000000
NODE_36262_length_524_cov_3.221176	253	324	0	71	71	1.0000000
NODE_36264_length_524_cov_3.148235	317	397	0	80	80	1.0000000
NODE_36410_length_523_cov_113.438679	0	48	1	12	48	0.2500000
NODE_36410_length_523_cov_113.438679	0	48	3	12	48	0.2500000
NODE_36410_length_523_cov_113.438679	0	48	4	1	48	0.0208333
NODE_36410_length_523_cov_113.438679	0	48	5	8	48	0.1666667
NODE_36410_length_523_cov_113.438679	0	48	6	14	48	0.2916667
NODE_36410_length_523_cov_113.438679	0	48	9	1	48	0.0208333
NODE_36410_length_523_cov_113.438679	14	69	3	10	55	0.1818182
NODE_36410_length_523_cov_113.438679	14	69	4	1	55	0.0181818
NODE_36410_length_523_cov_113.438679	14	69	5	8	55	0.1454545
NODE_36410_length_523_cov_113.438679	14	69	6	14	55	0.2545455
NODE_36410_length_523_cov_113.438679	14	69	9	21	55	0.3818182
NODE_36410_length_523_cov_113.438679	14	69	10	1	55	0.0181818
NODE_36410_length_523_cov_113.438679	25	101	5	8	76	0.1052632
NODE_36410_length_523_cov_113.438679	25	101	6	14	76	0.1842105
NODE_36410_length_523_cov_113.438679	25	101	9	21	76	0.2763158
NODE_36410_length_523_cov_113.438679	25	101	10	15	76	0.1973684
NODE_36410_length_523_cov_113.438679	25	101	11	3	76	0.0394737
NODE_36410_length_523_cov_113.438679	25	101	16	11	76	0.1447368
NODE_36410_length_523_cov_113.438679	25	101	17	4	76	0.0526316
NODE_36410_length_523_cov_113.438679	105	181	19	3	76	0.0394737
NODE_36410_length_523_cov_113.438679	105	181	21	2	76	0.0263158
NODE_36410_length_523_cov_113.438679	105	181	23	2	76	0.0263158
NODE_36410_length_523_cov_113.438679	105	181	24	22	76	0.2894737
NODE_36410_length_523_cov_113.438679	105	181	25	4	76	0.0526316
NODE_36410_length_523_cov_113.438679	105	181	26	33	76	0.4342105
NODE_36410_length_523_cov_113.438679	105	181	27	2	76	0.0263158
NODE_36410_length_523_cov_113.438679	105	181	28	6	76	0.0789474
NODE_36410_length_523_cov_113.438679	105	181	29	2	76	0.0263158
NODE_36410_length_523_cov_113.438679	154	234	24	2	80	0.0250000
NODE_36410_length_523_cov_113.438679	154	234	25	12	80	0.1500000
NODE_36410_length_523_cov_113.438679	154	234	26	32	80	0.4000000
NODE_36410_length_523_cov_113.438679	154	234	27	14	80	0.1750000
NODE_36410_length_523_cov_113.438679	154	234	28	6	80	0.0750000
NODE_36410_length_523_cov_113.438679	154	234	29	3	80	0.0375000
NODE_36410_length_523_cov_113.438679	154	234	30	11	80	0.1375000
NODE_36410_length_523_cov_113.438679	312	355	12	13	43	0.3023256
NODE_36410_length_523_cov_113.438679	312	355	13	13	43	0.3023256
NODE_36410_length_523_cov_113.438679	312	355	14	4	43	0.0930233
NODE_36410_length_523_cov_113.438679	312	355	15	3	43	0.0697674
NODE_36410_length_523_cov_113.438679	312	355	16	10	43	0.2325581
NODE_36412_length_523_cov_64.695755	35	115	1	3	80	0.0375000
NODE_36412_length_523_cov_64.695755	35	115	2	77	80	0.9625000
NODE_36412_length_523_cov_64.695755	88	168	2	80	80	1.0000000
NODE_36414_length_523_cov_20.724057	235	315	5	9	80	0.1125000
NODE_36414_length_523_cov_20.724057	235	315	6	37	80	0.4625000
NODE_36414_length_523_cov_20.724057	235	315	7	8	80	0.1000000
NODE_36414_length_523_cov_20.724057	235	315	8	26	80	0.3250000
NODE_36414_length_523_cov_20.724057	288	368	7	36	80	0.4500000
NODE_36414_length_523_cov_20.724057	288	368	8	37	80	0.4625000
NODE_36414_length_523_cov_20.724057	288	368	9	7	80	0.0875000
NODE_36415_length_523_cov_18.500000	164	244	2	80	80	1.0000000
NODE_36415_length_523_cov_18.500000	217	297	0	26	80	0.3250000
NODE_36415_length_523_cov_18.500000	217	297	1	17	80	0.2125000
NODE_36415_length_523_cov_18.500000	217	297	2	37	80	0.4625000
NODE_36416_length_523_cov_15.216981	62	142	0	8	80	0.1000000
NODE_36416_length_523_cov_15.216981	62	142	1	62	80	0.7750000
NODE_36416_length_523_cov_15.216981	62	142	2	10	80	0.1250000
NODE_36416_length_523_cov_15.216981	115	195	1	17	80	0.2125000
NODE_36416_length_523_cov_15.216981	115	195	2	63	80	0.7875000
NODE_36417_length_523_cov_10.575472	157	183	2	26	26	1.0000000
NODE_36418_length_523_cov_9.962264	212	292	0	80	80	1.0000000
NODE_36418_length_523_cov_9.962264	265	345	0	80	80	1.0000000
NODE_36427_length_523_cov_4.943396	108	188	4	45	80	0.5625000
NODE_36427_length_523_cov_4.943396	108	188	5	8	80	0.1000000
NODE_36427_length_523_cov_4.943396	108	188	6	27	80	0.3375000
NODE_36427_length_523_cov_4.943396	161	241	2	10	80	0.1250000
NODE_36427_length_523_cov_4.943396	161	241	5	17	80	0.2125000
NODE_36427_length_523_cov_4.943396	161	241	6	53	80	0.6625000
NODE_36429_length_523_cov_4.787736	110	141	0	31	31	1.0000000
NODE_36429_length_523_cov_4.787736	131	194	0	63	63	1.0000000
NODE_36439_length_523_cov_3.792453	139	219	0	80	80	1.0000000
NODE_36439_length_523_cov_3.792453	192	272	0	80	80	1.0000000
NODE_36481_length_523_cov_2.259434	337	372	0	35	35	1.0000000
NODE_36490_length_523_cov_2.096698	307	351	0	41	44	0.9318182
NODE_36490_length_523_cov_2.096698	307	351	1	3	44	0.0681818
NODE_36518_length_523_cov_1.700472	176	195	0	5	19	0.2631579
NODE_36518_length_523_cov_1.700472	176	195	1	14	19	0.7368421
NODE_36632_length_522_cov_33.579196	55	135	7	52	80	0.6500000
NODE_36632_length_522_cov_33.579196	55	135	8	14	80	0.1750000
NODE_36632_length_522_cov_33.579196	55	135	9	14	80	0.1750000
NODE_36632_length_522_cov_33.579196	108	188	8	44	80	0.5500000
NODE_36632_length_522_cov_33.579196	108	188	9	13	80	0.1625000
NODE_36632_length_522_cov_33.579196	108	188	12	2	80	0.0250000
NODE_36632_length_522_cov_33.579196	108	188	13	13	80	0.1625000
NODE_36632_length_522_cov_33.579196	108	188	15	8	80	0.1000000
NODE_36634_length_522_cov_12.851064	266	342	0	76	76	1.0000000
NODE_36634_length_522_cov_12.851064	319	395	0	76	76	1.0000000
NODE_36637_length_522_cov_7.349882	212	283	0	5	71	0.0704225
NODE_36637_length_522_cov_7.349882	212	283	2	66	71	0.9295775
NODE_36637_length_522_cov_7.349882	400	469	0	69	69	1.0000000
NODE_36670_length_522_cov_2.933806	178	258	0	80	80	1.0000000
NODE_36670_length_522_cov_2.933806	231	311	0	80	80	1.0000000
NODE_36676_length_522_cov_2.661939	187	241	0	19	54	0.3518519
NODE_36676_length_522_cov_2.661939	187	241	2	23	54	0.4259259
NODE_36676_length_522_cov_2.661939	187	241	4	12	54	0.2222222
NODE_36820_length_521_cov_9.303318	106	186	1	59	80	0.7375000
NODE_36820_length_521_cov_9.303318	106	186	2	21	80	0.2625000
NODE_36820_length_521_cov_9.303318	159	239	1	6	80	0.0750000
NODE_36820_length_521_cov_9.303318	159	239	2	74	80	0.9250000
NODE_36832_length_521_cov_4.971564	218	298	0	80	80	1.0000000
NODE_36832_length_521_cov_4.971564	271	351	0	80	80	1.0000000
NODE_36845_length_521_cov_3.504739	113	191	0	78	78	1.0000000
NODE_36845_length_521_cov_3.504739	164	205	0	41	41	1.0000000
NODE_36848_length_521_cov_3.324645	158	244	0	49	86	0.5697674
NODE_36848_length_521_cov_3.324645	158	244	2	37	86	0.4302326
NODE_36848_length_521_cov_3.324645	217	280	2	63	63	1.0000000
NODE_36916_length_521_cov_1.613744	165	227	0	62	62	1.0000000
NODE_37036_length_520_cov_50.676960	0	75	0	75	75	1.0000000
NODE_37036_length_520_cov_50.676960	48	128	0	51	80	0.6375000
NODE_37036_length_520_cov_50.676960	48	128	2	25	80	0.3125000
NODE_37036_length_520_cov_50.676960	48	128	3	4	80	0.0500000
NODE_37036_length_520_cov_50.676960	124	204	3	35	80	0.4375000
NODE_37036_length_520_cov_50.676960	124	204	4	1	80	0.0125000
NODE_37036_length_520_cov_50.676960	124	204	5	9	80	0.1125000
NODE_37036_length_520_cov_50.676960	124	204	6	35	80	0.4375000
NODE_37036_length_520_cov_50.676960	177	257	4	8	80	0.1000000
NODE_37036_length_520_cov_50.676960	177	257	6	72	80	0.9000000
NODE_37037_length_520_cov_43.294537	10	90	0	80	80	1.0000000
NODE_37037_length_520_cov_43.294537	10	90	0	80	80	1.0000000
NODE_37037_length_520_cov_43.294537	10	90	0	80	80	1.0000000
NODE_37037_length_520_cov_43.294537	10	90	0	80	80	1.0000000
NODE_37037_length_520_cov_43.294537	10	90	0	80	80	1.0000000
NODE_37037_length_520_cov_43.294537	10	90	0	80	80	1.0000000
NODE_37037_length_520_cov_43.294537	63	129	0	66	66	1.0000000
NODE_37037_length_520_cov_43.294537	63	142	0	79	79	1.0000000
NODE_37037_length_520_cov_43.294537	63	143	0	80	80	1.0000000
NODE_37037_length_520_cov_43.294537	63	133	0	70	70	1.0000000
NODE_37037_length_520_cov_43.294537	66	133	0	67	67	1.0000000
NODE_37037_length_520_cov_43.294537	68	143	0	75	75	1.0000000
NODE_37038_length_520_cov_29.427553	224	304	4	17	80	0.2125000
NODE_37038_length_520_cov_29.427553	224	304	8	12	80	0.1500000
NODE_37038_length_520_cov_29.427553	224	304	10	1	80	0.0125000
NODE_37038_length_520_cov_29.427553	224	304	11	28	80	0.3500000
NODE_37038_length_520_cov_29.427553	224	304	14	22	80	0.2750000
NODE_37038_length_520_cov_29.427553	277	357	10	54	80	0.6750000
NODE_37038_length_520_cov_29.427553	277	357	11	4	80	0.0500000
NODE_37038_length_520_cov_29.427553	277	357	14	22	80	0.2750000
NODE_37038_length_520_cov_29.427553	353	433	0	2	80	0.0250000
NODE_37038_length_520_cov_29.427553	353	433	3	28	80	0.3500000
NODE_37038_length_520_cov_29.427553	353	433	6	12	80	0.1500000
NODE_37038_length_520_cov_29.427553	353	433	9	1	80	0.0125000
NODE_37038_length_520_cov_29.427553	353	433	10	37	80	0.4625000
NODE_37038_length_520_cov_29.427553	406	486	0	55	80	0.6875000
NODE_37038_length_520_cov_29.427553	406	486	3	25	80	0.3125000
NODE_37039_length_520_cov_14.365796	103	183	2	80	80	1.0000000
NODE_37039_length_520_cov_14.365796	156	237	0	2	81	0.0246914
NODE_37039_length_520_cov_14.365796	156	237	2	79	81	0.9753087
NODE_37059_length_520_cov_4.121140	79	159	0	5	80	0.0625000
NODE_37059_length_520_cov_4.121140	79	159	1	74	80	0.9250000
NODE_37059_length_520_cov_4.121140	79	159	2	1	80	0.0125000
NODE_37059_length_520_cov_4.121140	132	212	1	26	80	0.3250000
NODE_37059_length_520_cov_4.121140	132	212	2	54	80	0.6750000
NODE_37063_length_520_cov_3.900238	203	233	0	30	30	1.0000000
NODE_37235_length_519_cov_42.842857	8	88	0	7	80	0.0875000
NODE_37235_length_519_cov_42.842857	8	88	1	35	80	0.4375000
NODE_37235_length_519_cov_42.842857	8	88	2	2	80	0.0250000
NODE_37235_length_519_cov_42.842857	8	88	4	20	80	0.2500000
NODE_37235_length_519_cov_42.842857	8	88	6	16	80	0.2000000
NODE_37235_length_519_cov_42.842857	61	139	4	11	78	0.1410256
NODE_37235_length_519_cov_42.842857	61	139	6	17	78	0.2179487
NODE_37235_length_519_cov_42.842857	61	139	7	50	78	0.6410257
NODE_37236_length_519_cov_19.269048	284	363	2	3	79	0.0379747
NODE_37236_length_519_cov_19.269048	284	363	3	24	79	0.3037975
NODE_37236_length_519_cov_19.269048	284	363	4	18	79	0.2278481
NODE_37236_length_519_cov_19.269048	284	363	5	18	79	0.2278481
NODE_37236_length_519_cov_19.269048	284	363	6	12	79	0.1518987
NODE_37236_length_519_cov_19.269048	284	363	8	4	79	0.0506329
NODE_37236_length_519_cov_19.269048	336	416	5	11	80	0.1375000
NODE_37236_length_519_cov_19.269048	336	416	6	12	80	0.1500000
NODE_37236_length_519_cov_19.269048	336	416	8	57	80	0.7125000
NODE_37237_length_519_cov_8.500000	195	267	0	72	72	1.0000000
NODE_37245_length_519_cov_5.169048	282	346	0	64	64	1.0000000
NODE_37290_length_519_cov_2.783333	174	235	1	61	61	1.0000000
NODE_37349_length_519_cov_1.538095	147	213	0	66	66	1.0000000
NODE_37447_length_518_cov_40.026253	385	465	20	5	80	0.0625000
NODE_37447_length_518_cov_40.026253	385	465	21	9	80	0.1125000
NODE_37447_length_518_cov_40.026253	385	465	22	17	80	0.2125000
NODE_37447_length_518_cov_40.026253	385	465	23	49	80	0.6125000
NODE_37447_length_518_cov_40.026253	438	518	1	4	80	0.0500000
NODE_37447_length_518_cov_40.026253	438	518	2	3	80	0.0375000
NODE_37447_length_518_cov_40.026253	438	518	3	5	80	0.0625000
NODE_37447_length_518_cov_40.026253	438	518	4	30	80	0.3750000
NODE_37447_length_518_cov_40.026253	438	518	5	5	80	0.0625000
NODE_37447_length_518_cov_40.026253	438	518	7	1	80	0.0125000
NODE_37447_length_518_cov_40.026253	438	518	18	1	80	0.0125000
NODE_37447_length_518_cov_40.026253	438	518	20	9	80	0.1125000
NODE_37447_length_518_cov_40.026253	438	518	21	9	80	0.1125000
NODE_37447_length_518_cov_40.026253	438	518	22	13	80	0.1625000
NODE_37449_length_518_cov_12.083532	144	224	4	10	80	0.1250000
NODE_37449_length_518_cov_12.083532	144	224	5	70	80	0.8750000
NODE_37449_length_518_cov_12.083532	197	277	0	21	80	0.2625000
NODE_37449_length_518_cov_12.083532	197	277	1	22	80	0.2750000
NODE_37449_length_518_cov_12.083532	197	277	2	2	80	0.0250000
NODE_37449_length_518_cov_12.083532	197	277	4	18	80	0.2250000
NODE_37449_length_518_cov_12.083532	197	277	5	17	80	0.2125000
NODE_37449_length_518_cov_12.083532	407	481	0	74	74	1.0000000
NODE_37449_length_518_cov_12.083532	454	518	0	64	64	1.0000000
NODE_37450_length_518_cov_11.467780	171	200	1	29	29	1.0000000
NODE_37450_length_518_cov_11.467780	253	320	1	5	67	0.0746269
NODE_37450_length_518_cov_11.467780	253	320	2	24	67	0.3582090
NODE_37450_length_518_cov_11.467780	253	320	3	38	67	0.5671642
NODE_37450_length_518_cov_11.467780	253	282	1	5	29	0.1724138
NODE_37450_length_518_cov_11.467780	253	282	3	24	29	0.8275862
NODE_37454_length_518_cov_7.441527	188	273	0	85	85	1.0000000
NODE_37461_length_518_cov_5.563246	315	366	0	4	51	0.0784314
NODE_37461_length_518_cov_5.563246	315	366	2	47	51	0.9215686
NODE_37461_length_518_cov_5.563246	339	383	0	21	44	0.4772727
NODE_37461_length_518_cov_5.563246	339	383	2	23	44	0.5227273
NODE_37465_length_518_cov_4.732697	214	276	0	62	62	1.0000000
NODE_37465_length_518_cov_4.732697	350	430	0	80	80	1.0000000
NODE_37479_length_518_cov_3.503580	291	333	5	10	42	0.2380952
NODE_37479_length_518_cov_3.503580	291	333	6	32	42	0.7619048
NODE_37479_length_518_cov_3.503580	306	363	4	11	57	0.1929825
NODE_37479_length_518_cov_3.503580	306	363	5	27	57	0.4736842
NODE_37479_length_518_cov_3.503580	306	363	6	19	57	0.3333333
NODE_37483_length_518_cov_3.136038	269	338	0	69	69	1.0000000
NODE_37483_length_518_cov_3.136038	269	348	0	79	79	1.0000000
NODE_37483_length_518_cov_3.136038	269	349	0	80	80	1.0000000
NODE_37483_length_518_cov_3.136038	322	402	0	80	80	1.0000000
NODE_37483_length_518_cov_3.136038	322	364	0	42	42	1.0000000
NODE_37483_length_518_cov_3.136038	322	368	0	46	46	1.0000000
NODE_37483_length_518_cov_3.136038	331	366	0	35	35	1.0000000
NODE_37637_length_517_cov_55.267943	177	257	4	80	80	1.0000000
NODE_37637_length_517_cov_55.267943	230	310	0	49	80	0.6125000
NODE_37637_length_517_cov_55.267943	230	310	4	31	80	0.3875000
NODE_37639_length_517_cov_30.863636	0	72	0	20	72	0.2777778
NODE_37639_length_517_cov_30.863636	0	72	1	41	72	0.5694444
NODE_37639_length_517_cov_30.863636	0	72	3	11	72	0.1527778
NODE_37639_length_517_cov_30.863636	0	72	0	20	72	0.2777778
NODE_37639_length_517_cov_30.863636	0	72	1	41	72	0.5694444
NODE_37639_length_517_cov_30.863636	0	72	3	11	72	0.1527778
NODE_37639_length_517_cov_30.863636	45	125	1	16	80	0.2000000
NODE_37639_length_517_cov_30.863636	45	125	3	64	80	0.8000000
NODE_37639_length_517_cov_30.863636	45	99	1	16	54	0.2962963
NODE_37639_length_517_cov_30.863636	45	99	3	38	54	0.7037037
NODE_37641_length_517_cov_12.258373	305	385	1	80	80	1.0000000
NODE_37641_length_517_cov_12.258373	358	438	0	14	80	0.1750000
NODE_37641_length_517_cov_12.258373	358	438	1	66	80	0.8250000
NODE_37643_length_517_cov_7.131579	100	152	0	52	52	1.0000000
NODE_37662_length_517_cov_4.492823	140	220	0	80	80	1.0000000
NODE_37662_length_517_cov_4.492823	193	273	0	80	80	1.0000000
NODE_37697_length_517_cov_2.437799	331	388	0	57	57	1.0000000
NODE_37850_length_516_cov_17.570743	147	227	2	19	80	0.2375000
NODE_37850_length_516_cov_17.570743	147	227	8	1	80	0.0125000
NODE_37850_length_516_cov_17.570743	147	227	9	4	80	0.0500000
NODE_37850_length_516_cov_17.570743	147	227	10	56	80	0.7000000
NODE_37850_length_516_cov_17.570743	200	280	0	10	80	0.1250000
NODE_37850_length_516_cov_17.570743	200	280	1	32	80	0.4000000
NODE_37850_length_516_cov_17.570743	200	280	2	30	80	0.3750000
NODE_37850_length_516_cov_17.570743	200	280	8	1	80	0.0125000
NODE_37850_length_516_cov_17.570743	200	280	9	4	80	0.0500000
NODE_37850_length_516_cov_17.570743	200	280	10	3	80	0.0375000
NODE_37861_length_516_cov_5.268585	402	448	0	46	46	1.0000000
NODE_37862_length_516_cov_5.067146	114	194	1	62	80	0.7750000
NODE_37862_length_516_cov_5.067146	114	194	2	18	80	0.2250000
NODE_37862_length_516_cov_5.067146	167	247	1	80	80	1.0000000
NODE_37864_length_516_cov_4.788969	156	236	0	80	80	1.0000000
NODE_37864_length_516_cov_4.788969	209	277	0	68	68	1.0000000
NODE_37881_length_516_cov_3.167866	48	93	3	1	45	0.0222222
NODE_37881_length_516_cov_3.167866	48	93	7	44	45	0.9777778
NODE_37881_length_516_cov_3.167866	103	177	2	8	74	0.1081081
NODE_37881_length_516_cov_3.167866	103	177	5	21	74	0.2837838
NODE_37881_length_516_cov_3.167866	103	177	7	44	74	0.5945946
NODE_37881_length_516_cov_3.167866	103	177	8	1	74	0.0135135
NODE_38044_length_515_cov_69.442308	177	257	13	29	80	0.3625000
NODE_38044_length_515_cov_69.442308	177	257	14	51	80	0.6375000
NODE_38044_length_515_cov_69.442308	177	257	13	29	80	0.3625000
NODE_38044_length_515_cov_69.442308	177	257	14	51	80	0.6375000
NODE_38044_length_515_cov_69.442308	177	257	13	29	80	0.3625000
NODE_38044_length_515_cov_69.442308	177	257	14	51	80	0.6375000
NODE_38044_length_515_cov_69.442308	230	291	10	10	61	0.1639344
NODE_38044_length_515_cov_69.442308	230	291	11	18	61	0.2950820
NODE_38044_length_515_cov_69.442308	230	291	13	18	61	0.2950820
NODE_38044_length_515_cov_69.442308	230	291	14	10	61	0.1639344
NODE_38044_length_515_cov_69.442308	230	291	16	1	61	0.0163934
NODE_38044_length_515_cov_69.442308	230	291	18	4	61	0.0655738
NODE_38044_length_515_cov_69.442308	230	308	10	14	78	0.1794872
NODE_38044_length_515_cov_69.442308	230	308	11	20	78	0.2564103
NODE_38044_length_515_cov_69.442308	230	308	12	11	78	0.1410256
NODE_38044_length_515_cov_69.442308	230	308	13	18	78	0.2307692
NODE_38044_length_515_cov_69.442308	230	308	14	10	78	0.1282051
NODE_38044_length_515_cov_69.442308	230	308	16	1	78	0.0128205
NODE_38044_length_515_cov_69.442308	230	308	18	4	78	0.0512821
NODE_38044_length_515_cov_69.442308	235	308	10	14	73	0.1917808
NODE_38044_length_515_cov_69.442308	235	308	11	20	73	0.2739726
NODE_38044_length_515_cov_69.442308	235	308	12	11	73	0.1506849
NODE_38044_length_515_cov_69.442308	235	308	13	18	73	0.2465753
NODE_38044_length_515_cov_69.442308	235	308	14	5	73	0.0684932
NODE_38044_length_515_cov_69.442308	235	308	16	1	73	0.0136986
NODE_38044_length_515_cov_69.442308	235	308	18	4	73	0.0547945
NODE_38045_length_515_cov_13.271635	168	248	0	80	80	1.0000000
NODE_38045_length_515_cov_13.271635	221	301	0	80	80	1.0000000
NODE_38048_length_515_cov_8.314904	213	290	6	27	77	0.3506494
NODE_38048_length_515_cov_8.314904	213	290	8	7	77	0.0909091
NODE_38048_length_515_cov_8.314904	213	290	9	43	77	0.5584416
NODE_38054_length_515_cov_5.487981	317	402	1	42	85	0.4941176
NODE_38054_length_515_cov_5.487981	317	402	2	43	85	0.5058824
NODE_38242_length_514_cov_26.910843	170	250	1	18	80	0.2250000
NODE_38242_length_514_cov_26.910843	170	250	2	62	80	0.7750000
NODE_38242_length_514_cov_26.910843	223	303	1	18	80	0.2250000
NODE_38242_length_514_cov_26.910843	223	303	2	62	80	0.7750000
NODE_38243_length_514_cov_12.775904	85	149	0	64	64	1.0000000
NODE_38243_length_514_cov_12.775904	123	202	0	79	79	1.0000000
NODE_38244_length_514_cov_11.156627	124	204	1	67	80	0.8375000
NODE_38244_length_514_cov_11.156627	124	204	2	13	80	0.1625000
NODE_38244_length_514_cov_11.156627	177	257	1	14	80	0.1750000
NODE_38244_length_514_cov_11.156627	177	257	2	66	80	0.8250000
NODE_38253_length_514_cov_5.802410	165	217	0	52	52	1.0000000
NODE_38253_length_514_cov_5.802410	190	270	0	80	80	1.0000000
NODE_38254_length_514_cov_5.554217	192	272	0	80	80	1.0000000
NODE_38254_length_514_cov_5.554217	294	340	0	46	46	1.0000000
NODE_38257_length_514_cov_5.322892	230	260	0	30	30	1.0000000
NODE_38262_length_514_cov_4.337349	220	300	0	15	80	0.1875000
NODE_38262_length_514_cov_4.337349	220	300	1	65	80	0.8125000
NODE_38286_length_514_cov_3.012048	264	328	0	64	64	1.0000000
NODE_38432_length_513_cov_14.613527	118	198	0	21	80	0.2625000
NODE_38432_length_513_cov_14.613527	118	198	2	50	80	0.6250000
NODE_38432_length_513_cov_14.613527	118	198	3	9	80	0.1125000
NODE_38432_length_513_cov_14.613527	171	251	2	21	80	0.2625000
NODE_38432_length_513_cov_14.613527	171	251	3	59	80	0.7375000
NODE_38433_length_513_cov_9.898551	253	333	4	6	80	0.0750000
NODE_38433_length_513_cov_9.898551	253	333	5	11	80	0.1375000
NODE_38433_length_513_cov_9.898551	253	333	7	11	80	0.1375000
NODE_38433_length_513_cov_9.898551	253	333	8	52	80	0.6500000
NODE_38433_length_513_cov_9.898551	306	386	4	16	80	0.2000000
NODE_38433_length_513_cov_9.898551	306	386	5	25	80	0.3125000
NODE_38433_length_513_cov_9.898551	306	386	8	39	80	0.4875000
NODE_38434_length_513_cov_9.164251	185	265	9	6	80	0.0750000
NODE_38434_length_513_cov_9.164251	185	265	10	20	80	0.2500000
NODE_38434_length_513_cov_9.164251	185	265	16	3	80	0.0375000
NODE_38434_length_513_cov_9.164251	185	265	19	8	80	0.1000000
NODE_38434_length_513_cov_9.164251	185	265	20	12	80	0.1500000
NODE_38434_length_513_cov_9.164251	185	265	21	14	80	0.1750000
NODE_38434_length_513_cov_9.164251	185	265	23	17	80	0.2125000
NODE_38434_length_513_cov_9.164251	238	318	19	5	80	0.0625000
NODE_38434_length_513_cov_9.164251	238	318	20	12	80	0.1500000
NODE_38434_length_513_cov_9.164251	238	318	21	23	80	0.2875000
NODE_38434_length_513_cov_9.164251	238	318	23	1	80	0.0125000
NODE_38434_length_513_cov_9.164251	238	318	24	39	80	0.4875000
NODE_38441_length_513_cov_6.123188	284	364	1	59	80	0.7375000
NODE_38441_length_513_cov_6.123188	284	364	2	21	80	0.2625000
NODE_38441_length_513_cov_6.123188	337	417	1	70	80	0.8750000
NODE_38441_length_513_cov_6.123188	337	417	2	10	80	0.1250000
NODE_38460_length_513_cov_3.456522	283	350	1	67	67	1.0000000
NODE_38460_length_513_cov_3.456522	336	398	0	28	62	0.4516129
NODE_38460_length_513_cov_3.456522	336	398	1	34	62	0.5483871
NODE_38482_length_513_cov_2.309179	134	174	3	33	40	0.8250000
NODE_38482_length_513_cov_2.309179	134	174	4	7	40	0.1750000
NODE_38482_length_513_cov_2.309179	170	223	2	49	53	0.9245283
NODE_38482_length_513_cov_2.309179	170	223	3	4	53	0.0754717
NODE_38482_length_513_cov_2.309179	238	285	0	46	47	0.9787234
NODE_38482_length_513_cov_2.309179	238	285	1	1	47	0.0212766
NODE_38515_length_513_cov_1.671498	427	476	0	49	49	1.0000000
NODE_38646_length_512_cov_45.070218	34	114	4	6	80	0.0750000
NODE_38646_length_512_cov_45.070218	34	114	6	15	80	0.1875000
NODE_38646_length_512_cov_45.070218	34	114	8	59	80	0.7375000
NODE_38646_length_512_cov_45.070218	87	167	6	4	80	0.0500000
NODE_38646_length_512_cov_45.070218	87	167	8	76	80	0.9500000
NODE_38647_length_512_cov_39.639225	323	404	10	2	81	0.0246914
NODE_38647_length_512_cov_39.639225	323	404	12	10	81	0.1234568
NODE_38647_length_512_cov_39.639225	323	404	15	11	81	0.1358025
NODE_38647_length_512_cov_39.639225	323	404	16	4	81	0.0493827
NODE_38647_length_512_cov_39.639225	323	404	17	5	81	0.0617284
NODE_38647_length_512_cov_39.639225	323	404	18	30	81	0.3703704
NODE_38647_length_512_cov_39.639225	323	404	19	19	81	0.2345679
NODE_38647_length_512_cov_39.639225	377	457	12	7	80	0.0875000
NODE_38647_length_512_cov_39.639225	377	457	13	4	80	0.0500000
NODE_38647_length_512_cov_39.639225	377	457	14	7	80	0.0875000
NODE_38647_length_512_cov_39.639225	377	457	16	5	80	0.0625000
NODE_38647_length_512_cov_39.639225	377	457	17	33	80	0.4125000
NODE_38647_length_512_cov_39.639225	377	457	18	13	80	0.1625000
NODE_38647_length_512_cov_39.639225	377	457	19	11	80	0.1375000
NODE_38648_length_512_cov_8.581114	192	256	0	7	64	0.1093750
NODE_38648_length_512_cov_8.581114	192	256	1	57	64	0.8906250
NODE_38661_length_512_cov_4.869249	327	407	3	13	80	0.1625000
NODE_38661_length_512_cov_4.869249	327	407	4	67	80	0.8375000
NODE_38661_length_512_cov_4.869249	380	460	3	1	80	0.0125000
NODE_38661_length_512_cov_4.869249	380	460	4	79	80	0.9875000
NODE_38668_length_512_cov_4.157385	161	204	0	43	43	1.0000000
NODE_38668_length_512_cov_4.157385	178	257	0	79	79	1.0000000
NODE_38677_length_512_cov_3.435835	138	218	0	32	80	0.4000000
NODE_38677_length_512_cov_3.435835	138	218	1	48	80	0.6000000
NODE_38677_length_512_cov_3.435835	191	271	1	80	80	1.0000000
NODE_38693_length_512_cov_2.888620	320	400	0	41	80	0.5125000
NODE_38693_length_512_cov_2.888620	320	400	1	20	80	0.2500000
NODE_38693_length_512_cov_2.888620	320	400	2	12	80	0.1500000
NODE_38693_length_512_cov_2.888620	320	400	4	7	80	0.0875000
NODE_38768_length_512_cov_1.341404	198	269	0	71	71	1.0000000
NODE_38866_length_511_cov_9.796117	251	331	0	30	80	0.3750000
NODE_38866_length_511_cov_9.796117	251	331	2	50	80	0.6250000
NODE_38866_length_511_cov_9.796117	304	370	2	66	66	1.0000000
NODE_38869_length_511_cov_8.873786	239	319	0	80	80	1.0000000
NODE_38869_length_511_cov_8.873786	292	356	0	48	64	0.7500000
NODE_38869_length_511_cov_8.873786	292	356	1	16	64	0.2500000
NODE_38870_length_511_cov_8.434466	232	312	0	80	80	1.0000000
NODE_38870_length_511_cov_8.434466	285	366	0	81	81	1.0000000
NODE_38872_length_511_cov_7.519417	157	237	5	24	80	0.3000000
NODE_38872_length_511_cov_7.519417	157	237	6	15	80	0.1875000
NODE_38872_length_511_cov_7.519417	157	237	7	38	80	0.4750000
NODE_38872_length_511_cov_7.519417	157	237	8	3	80	0.0375000
NODE_38872_length_511_cov_7.519417	210	290	4	11	80	0.1375000
NODE_38872_length_511_cov_7.519417	210	290	5	7	80	0.0875000
NODE_38872_length_511_cov_7.519417	210	290	7	35	80	0.4375000
NODE_38872_length_511_cov_7.519417	210	290	8	27	80	0.3375000
NODE_38877_length_511_cov_5.762136	102	179	1	62	77	0.8051948
NODE_38877_length_511_cov_5.762136	102	179	2	1	77	0.0129870
NODE_38877_length_511_cov_5.762136	102	179	3	14	77	0.1818182
NODE_38877_length_511_cov_5.762136	155	230	1	9	75	0.1200000
NODE_38877_length_511_cov_5.762136	155	230	2	19	75	0.2533333
NODE_38877_length_511_cov_5.762136	155	230	3	33	75	0.4400000
NODE_38877_length_511_cov_5.762136	155	230	4	14	75	0.1866667
NODE_38878_length_511_cov_5.655340	133	213	2	80	80	1.0000000
NODE_38878_length_511_cov_5.655340	186	266	0	33	80	0.4125000
NODE_38878_length_511_cov_5.655340	186	266	2	47	80	0.5875000
NODE_38911_length_511_cov_2.978155	219	255	0	36	36	1.0000000
NODE_39013_length_511_cov_1.225728	99	127	0	28	28	1.0000000
NODE_39092_length_511_cov_0.708738	98	146	0	48	48	1.0000000
NODE_39105_length_510_cov_18.206813	334	414	5	3	80	0.0375000
NODE_39105_length_510_cov_18.206813	334	414	6	26	80	0.3250000
NODE_39105_length_510_cov_18.206813	334	414	7	1	80	0.0125000
NODE_39105_length_510_cov_18.206813	334	414	8	3	80	0.0375000
NODE_39105_length_510_cov_18.206813	334	414	9	35	80	0.4375000
NODE_39105_length_510_cov_18.206813	334	414	10	12	80	0.1500000
NODE_39105_length_510_cov_18.206813	387	467	5	22	80	0.2750000
NODE_39105_length_510_cov_18.206813	387	467	6	45	80	0.5625000
NODE_39105_length_510_cov_18.206813	387	467	7	1	80	0.0125000
NODE_39105_length_510_cov_18.206813	387	467	8	1	80	0.0125000
NODE_39105_length_510_cov_18.206813	387	467	9	11	80	0.1375000
NODE_39110_length_510_cov_8.017032	211	291	1	37	80	0.4625000
NODE_39110_length_510_cov_8.017032	211	291	2	43	80	0.5375000
NODE_39110_length_510_cov_8.017032	264	344	1	80	80	1.0000000
NODE_39110_length_510_cov_8.017032	391	413	0	22	22	1.0000000
NODE_39112_length_510_cov_6.476886	208	251	2	10	43	0.2325581
NODE_39112_length_510_cov_6.476886	208	251	4	33	43	0.7674419
NODE_39115_length_510_cov_6.133820	149	200	0	51	51	1.0000000
NODE_39122_length_510_cov_4.313869	32	106	0	74	74	1.0000000
NODE_39131_length_510_cov_3.435523	149	213	0	64	64	1.0000000
NODE_39131_length_510_cov_3.435523	191	249	0	58	58	1.0000000
NODE_39293_length_509_cov_13.378049	160	240	21	3	80	0.0375000
NODE_39293_length_509_cov_13.378049	160	240	22	13	80	0.1625000
NODE_39293_length_509_cov_13.378049	160	240	24	3	80	0.0375000
NODE_39293_length_509_cov_13.378049	160	240	25	1	80	0.0125000
NODE_39293_length_509_cov_13.378049	160	240	26	1	80	0.0125000
NODE_39293_length_509_cov_13.378049	160	240	27	3	80	0.0375000
NODE_39293_length_509_cov_13.378049	160	240	28	1	80	0.0125000
NODE_39293_length_509_cov_13.378049	160	240	29	4	80	0.0500000
NODE_39293_length_509_cov_13.378049	160	240	30	7	80	0.0875000
NODE_39293_length_509_cov_13.378049	160	240	33	9	80	0.1125000
NODE_39293_length_509_cov_13.378049	160	240	36	2	80	0.0250000
NODE_39293_length_509_cov_13.378049	160	240	41	6	80	0.0750000
NODE_39293_length_509_cov_13.378049	160	240	42	3	80	0.0375000
NODE_39293_length_509_cov_13.378049	160	240	43	1	80	0.0125000
NODE_39293_length_509_cov_13.378049	160	240	45	5	80	0.0625000
NODE_39293_length_509_cov_13.378049	160	240	46	5	80	0.0625000
NODE_39293_length_509_cov_13.378049	160	240	47	4	80	0.0500000
NODE_39293_length_509_cov_13.378049	160	240	48	9	80	0.1125000
NODE_39293_length_509_cov_13.378049	213	294	14	8	81	0.0987654
NODE_39293_length_509_cov_13.378049	213	294	16	5	81	0.0617284
NODE_39293_length_509_cov_13.378049	213	294	17	1	81	0.0123457
NODE_39293_length_509_cov_13.378049	213	294	18	23	81	0.2839506
NODE_39293_length_509_cov_13.378049	213	294	33	26	81	0.3209876
NODE_39293_length_509_cov_13.378049	213	294	46	5	81	0.0617284
NODE_39293_length_509_cov_13.378049	213	294	47	4	81	0.0493827
NODE_39293_length_509_cov_13.378049	213	294	48	9	81	0.1111111
NODE_39302_length_509_cov_5.190244	203	283	0	1	80	0.0125000
NODE_39302_length_509_cov_5.190244	203	283	1	49	80	0.6125000
NODE_39302_length_509_cov_5.190244	203	283	2	30	80	0.3750000
NODE_39302_length_509_cov_5.190244	256	336	2	80	80	1.0000000
NODE_39309_length_509_cov_4.478049	221	301	0	80	80	1.0000000
NODE_39309_length_509_cov_4.478049	274	354	0	80	80	1.0000000
NODE_39311_length_509_cov_4.451220	203	283	0	80	80	1.0000000
NODE_39322_length_509_cov_3.443902	133	185	0	52	52	1.0000000
NODE_39326_length_509_cov_3.207317	367	445	0	78	78	1.0000000
NODE_39337_length_509_cov_2.853659	194	274	0	80	80	1.0000000
NODE_39480_length_509_cov_0.809756	229	272	0	43	43	1.0000000
NODE_39506_length_508_cov_22.009780	440	508	15	22	68	0.3235294
NODE_39506_length_508_cov_22.009780	440	508	17	45	68	0.6617647
NODE_39506_length_508_cov_22.009780	440	508	21	1	68	0.0147059
NODE_39512_length_508_cov_5.158924	248	284	0	36	36	1.0000000
NODE_39539_length_508_cov_2.662592	165	244	2	16	79	0.2025317
NODE_39539_length_508_cov_2.662592	165	244	3	63	79	0.7974684
NODE_39698_length_507_cov_32.286765	0	61	0	44	61	0.7213115
NODE_39698_length_507_cov_32.286765	0	61	1	17	61	0.2786885
NODE_39698_length_507_cov_32.286765	53	97	1	26	44	0.5909091
NODE_39698_length_507_cov_32.286765	53	97	2	18	44	0.4090909
NODE_39701_length_507_cov_7.553922	203	283	0	80	80	1.0000000
NODE_39709_length_507_cov_5.154412	296	362	1	52	66	0.7878788
NODE_39709_length_507_cov_5.154412	296	362	2	14	66	0.2121212
NODE_39714_length_507_cov_4.710784	248	328	2	80	80	1.0000000
NODE_39714_length_507_cov_4.710784	308	379	0	24	71	0.3380282
NODE_39714_length_507_cov_4.710784	308	379	1	6	71	0.0845070
NODE_39714_length_507_cov_4.710784	308	379	2	41	71	0.5774648
NODE_39728_length_507_cov_3.649510	80	109	0	29	29	1.0000000
NODE_39728_length_507_cov_3.649510	184	266	4	82	82	1.0000000
NODE_39728_length_507_cov_3.649510	189	273	4	84	84	1.0000000
NODE_39728_length_507_cov_3.649510	207	266	4	59	59	1.0000000
NODE_39747_length_507_cov_2.754902	345	425	0	80	80	1.0000000
NODE_39747_length_507_cov_2.754902	428	463	0	35	35	1.0000000
NODE_39918_length_506_cov_31.987715	71	156	1	21	85	0.2470588
NODE_39918_length_506_cov_31.987715	71	156	2	64	85	0.7529412
NODE_39918_length_506_cov_31.987715	71	156	1	21	85	0.2470588
NODE_39918_length_506_cov_31.987715	71	156	2	64	85	0.7529412
NODE_39918_length_506_cov_31.987715	71	156	1	21	85	0.2470588
NODE_39918_length_506_cov_31.987715	71	156	2	64	85	0.7529412
NODE_39918_length_506_cov_31.987715	129	209	1	2	80	0.0250000
NODE_39918_length_506_cov_31.987715	129	209	2	78	80	0.9750000
NODE_39919_length_506_cov_15.877150	210	279	5	8	69	0.1159420
NODE_39919_length_506_cov_15.877150	210	279	6	12	69	0.1739130
NODE_39919_length_506_cov_15.877150	210	279	7	11	69	0.1594203
NODE_39919_length_506_cov_15.877150	210	279	9	1	69	0.0144928
NODE_39919_length_506_cov_15.877150	210	279	18	37	69	0.5362319
NODE_39920_length_506_cov_15.461916	334	414	13	7	80	0.0875000
NODE_39920_length_506_cov_15.461916	334	414	15	5	80	0.0625000
NODE_39920_length_506_cov_15.461916	334	414	16	33	80	0.4125000
NODE_39920_length_506_cov_15.461916	334	414	19	10	80	0.1250000
NODE_39920_length_506_cov_15.461916	334	414	21	25	80	0.3125000
NODE_39920_length_506_cov_15.461916	387	467	6	15	80	0.1875000
NODE_39920_length_506_cov_15.461916	387	467	9	18	80	0.2250000
NODE_39920_length_506_cov_15.461916	387	467	10	20	80	0.2500000
NODE_39920_length_506_cov_15.461916	387	467	13	7	80	0.0875000
NODE_39920_length_506_cov_15.461916	387	467	15	5	80	0.0625000
NODE_39920_length_506_cov_15.461916	387	467	16	15	80	0.1875000
NODE_39921_length_506_cov_9.749386	197	276	0	79	79	1.0000000
NODE_39921_length_506_cov_9.749386	249	329	0	80	80	1.0000000
NODE_39947_length_506_cov_3.122850	218	298	2	80	80	1.0000000
NODE_39947_length_506_cov_3.122850	271	351	1	12	80	0.1500000
NODE_39947_length_506_cov_3.122850	271	351	2	68	80	0.8500000
NODE_39951_length_506_cov_2.894349	190	270	0	80	80	1.0000000
NODE_40133_length_505_cov_35.541872	373	453	7	10	80	0.1250000
NODE_40133_length_505_cov_35.541872	373	453	8	9	80	0.1125000
NODE_40133_length_505_cov_35.541872	373	453	9	45	80	0.5625000
NODE_40133_length_505_cov_35.541872	373	453	10	16	80	0.2000000
NODE_40135_length_505_cov_10.339901	30	110	0	80	80	1.0000000
NODE_40135_length_505_cov_10.339901	83	163	0	80	80	1.0000000
NODE_40158_length_505_cov_3.554187	225	305	0	80	80	1.0000000
NODE_40158_length_505_cov_3.554187	278	358	0	80	80	1.0000000
NODE_40160_length_505_cov_3.403941	207	287	0	80	80	1.0000000
NODE_40175_length_505_cov_2.975369	162	227	0	10	65	0.1538462
NODE_40175_length_505_cov_2.975369	162	227	1	6	65	0.0923077
NODE_40175_length_505_cov_2.975369	162	227	2	49	65	0.7538462
NODE_40222_length_505_cov_1.864532	55	126	0	71	71	1.0000000
NODE_40368_length_504_cov_115.891358	122	202	47	2	80	0.0250000
NODE_40368_length_504_cov_115.891358	122	202	48	5	80	0.0625000
NODE_40368_length_504_cov_115.891358	122	202	49	2	80	0.0250000
NODE_40368_length_504_cov_115.891358	122	202	50	6	80	0.0750000
NODE_40368_length_504_cov_115.891358	122	202	51	8	80	0.1000000
NODE_40368_length_504_cov_115.891358	122	202	52	8	80	0.1000000
NODE_40368_length_504_cov_115.891358	122	202	53	2	80	0.0250000
NODE_40368_length_504_cov_115.891358	122	202	54	5	80	0.0625000
NODE_40368_length_504_cov_115.891358	122	202	55	8	80	0.1000000
NODE_40368_length_504_cov_115.891358	122	202	58	1	80	0.0125000
NODE_40368_length_504_cov_115.891358	122	202	59	9	80	0.1125000
NODE_40368_length_504_cov_115.891358	122	202	60	9	80	0.1125000
NODE_40368_length_504_cov_115.891358	122	202	61	2	80	0.0250000
NODE_40368_length_504_cov_115.891358	122	202	62	4	80	0.0500000
NODE_40368_length_504_cov_115.891358	122	202	65	9	80	0.1125000
NODE_40368_length_504_cov_115.891358	175	255	47	2	80	0.0250000
NODE_40368_length_504_cov_115.891358	175	255	48	5	80	0.0625000
NODE_40368_length_504_cov_115.891358	175	255	52	7	80	0.0875000
NODE_40368_length_504_cov_115.891358	175	255	53	2	80	0.0250000
NODE_40368_length_504_cov_115.891358	175	255	54	8	80	0.1000000
NODE_40368_length_504_cov_115.891358	175	255	55	17	80	0.2125000
NODE_40368_length_504_cov_115.891358	175	255	56	3	80	0.0375000
NODE_40368_length_504_cov_115.891358	175	255	57	13	80	0.1625000
NODE_40368_length_504_cov_115.891358	175	255	58	9	80	0.1125000
NODE_40368_length_504_cov_115.891358	175	255	59	4	80	0.0500000
NODE_40368_length_504_cov_115.891358	175	255	60	5	80	0.0625000
NODE_40368_length_504_cov_115.891358	175	255	61	5	80	0.0625000
NODE_40369_length_504_cov_33.360494	28	108	10	27	80	0.3375000
NODE_40369_length_504_cov_33.360494	28	108	11	53	80	0.6625000
NODE_40369_length_504_cov_33.360494	81	161	9	2	80	0.0250000
NODE_40369_length_504_cov_33.360494	81	161	10	8	80	0.1000000
NODE_40369_length_504_cov_33.360494	81	161	11	34	80	0.4250000
NODE_40369_length_504_cov_33.360494	81	161	12	1	80	0.0125000
NODE_40369_length_504_cov_33.360494	81	161	13	35	80	0.4375000
NODE_40370_length_504_cov_15.669136	176	256	2	17	80	0.2125000
NODE_40370_length_504_cov_15.669136	176	256	3	63	80	0.7875000
NODE_40370_length_504_cov_15.669136	229	309	2	48	80	0.6000000
NODE_40370_length_504_cov_15.669136	229	309	3	32	80	0.4000000
NODE_40371_length_504_cov_13.202469	134	215	6	9	81	0.1111111
NODE_40371_length_504_cov_13.202469	134	215	8	10	81	0.1234568
NODE_40371_length_504_cov_13.202469	134	215	9	23	81	0.2839506
NODE_40371_length_504_cov_13.202469	134	215	10	12	81	0.1481481
NODE_40371_length_504_cov_13.202469	134	215	11	25	81	0.3086420
NODE_40371_length_504_cov_13.202469	134	215	12	2	81	0.0246914
NODE_40371_length_504_cov_13.202469	188	268	6	7	80	0.0875000
NODE_40371_length_504_cov_13.202469	188	268	7	7	80	0.0875000
NODE_40371_length_504_cov_13.202469	188	268	8	27	80	0.3375000
NODE_40371_length_504_cov_13.202469	188	268	10	24	80	0.3000000
NODE_40371_length_504_cov_13.202469	188	268	11	13	80	0.1625000
NODE_40371_length_504_cov_13.202469	188	268	12	2	80	0.0250000
NODE_40377_length_504_cov_6.770370	55	135	1	26	80	0.3250000
NODE_40377_length_504_cov_6.770370	55	135	2	50	80	0.6250000
NODE_40377_length_504_cov_6.770370	55	135	3	4	80	0.0500000
NODE_40377_length_504_cov_6.770370	108	188	2	76	80	0.9500000
NODE_40377_length_504_cov_6.770370	108	188	3	4	80	0.0500000
NODE_40427_length_504_cov_2.234568	359	407	0	10	48	0.2083333
NODE_40427_length_504_cov_2.234568	359	407	2	38	48	0.7916667
NODE_40428_length_504_cov_2.227160	307	370	0	63	63	1.0000000
NODE_40434_length_504_cov_2.116049	245	325	0	80	80	1.0000000
NODE_40434_length_504_cov_2.116049	298	378	0	80	80	1.0000000
NODE_40446_length_504_cov_1.925926	196	262	0	66	66	1.0000000
NODE_40601_length_503_cov_11.356436	268	348	2	1	80	0.0125000
NODE_40601_length_503_cov_11.356436	268	348	4	79	80	0.9875000
NODE_40601_length_503_cov_11.356436	321	401	2	15	80	0.1875000
NODE_40601_length_503_cov_11.356436	321	401	4	51	80	0.6375000
NODE_40601_length_503_cov_11.356436	321	401	5	2	80	0.0250000
NODE_40601_length_503_cov_11.356436	321	401	6	12	80	0.1500000
NODE_40615_length_503_cov_5.537129	314	381	1	67	67	1.0000000
NODE_40645_length_503_cov_3.012376	264	285	0	21	21	1.0000000
NODE_40652_length_503_cov_2.757426	266	334	8	5	68	0.0735294
NODE_40652_length_503_cov_2.757426	266	334	12	63	68	0.9264706
NODE_40652_length_503_cov_2.757426	307	387	7	14	80	0.1750000
NODE_40652_length_503_cov_2.757426	307	387	11	22	80	0.2750000
NODE_40652_length_503_cov_2.757426	307	387	12	44	80	0.5500000
NODE_40655_length_503_cov_2.705446	158	237	0	79	79	1.0000000
NODE_40655_length_503_cov_2.705446	211	291	0	80	80	1.0000000
NODE_40656_length_503_cov_2.705446	251	331	0	80	80	1.0000000
NODE_40656_length_503_cov_2.705446	251	321	0	70	70	1.0000000
NODE_40656_length_503_cov_2.705446	330	384	0	54	54	1.0000000
NODE_40656_length_503_cov_2.705446	338	384	0	46	46	1.0000000
NODE_40664_length_503_cov_2.584158	95	163	0	68	68	1.0000000
NODE_40857_length_502_cov_45.292804	353	433	2	28	80	0.3500000
NODE_40857_length_502_cov_45.292804	353	433	3	16	80	0.2000000
NODE_40857_length_502_cov_45.292804	353	433	4	9	80	0.1125000
NODE_40857_length_502_cov_45.292804	353	433	5	27	80	0.3375000
NODE_40864_length_502_cov_5.980149	305	381	6	5	76	0.0657895
NODE_40864_length_502_cov_5.980149	305	381	7	16	76	0.2105263
NODE_40864_length_502_cov_5.980149	305	381	9	22	76	0.2894737
NODE_40864_length_502_cov_5.980149	305	381	10	33	76	0.4342105
NODE_41070_length_501_cov_208.708955	288	350	33	11	62	0.1774193
NODE_41070_length_501_cov_208.708955	288	350	34	1	62	0.0161290
NODE_41070_length_501_cov_208.708955	288	350	36	2	62	0.0322581
NODE_41070_length_501_cov_208.708955	288	350	38	13	62	0.2096774
NODE_41070_length_501_cov_208.708955	288	350	39	3	62	0.0483871
NODE_41070_length_501_cov_208.708955	288	350	40	4	62	0.0645161
NODE_41070_length_501_cov_208.708955	288	350	41	1	62	0.0161290
NODE_41070_length_501_cov_208.708955	288	350	42	10	62	0.1612903
NODE_41070_length_501_cov_208.708955	288	350	43	1	62	0.0161290
NODE_41070_length_501_cov_208.708955	288	350	44	5	62	0.0806452
NODE_41070_length_501_cov_208.708955	288	350	45	10	62	0.1612903
NODE_41070_length_501_cov_208.708955	288	350	47	1	62	0.0161290
NODE_41070_length_501_cov_208.708955	327	413	26	9	86	0.1046512
NODE_41070_length_501_cov_208.708955	327	413	27	1	86	0.0116279
NODE_41070_length_501_cov_208.708955	327	413	28	1	86	0.0116279
NODE_41070_length_501_cov_208.708955	327	413	29	1	86	0.0116279
NODE_41070_length_501_cov_208.708955	327	413	30	1	86	0.0116279
NODE_41070_length_501_cov_208.708955	327	413	32	2	86	0.0232558
NODE_41070_length_501_cov_208.708955	327	413	38	8	86	0.0930233
NODE_41070_length_501_cov_208.708955	327	413	39	8	86	0.0930233
NODE_41070_length_501_cov_208.708955	327	413	41	1	86	0.0116279
NODE_41070_length_501_cov_208.708955	327	413	42	8	86	0.0930233
NODE_41070_length_501_cov_208.708955	327	413	43	17	86	0.1976744
NODE_41070_length_501_cov_208.708955	327	413	44	11	86	0.1279070
NODE_41070_length_501_cov_208.708955	327	413	45	17	86	0.1976744
NODE_41070_length_501_cov_208.708955	327	413	47	1	86	0.0116279
NODE_41071_length_501_cov_29.126866	23	103	0	80	80	1.0000000
NODE_41071_length_501_cov_29.126866	76	156	0	80	80	1.0000000
NODE_41072_length_501_cov_23.736318	85	165	10	14	80	0.1750000
NODE_41072_length_501_cov_23.736318	85	165	11	63	80	0.7875000
NODE_41072_length_501_cov_23.736318	85	165	12	1	80	0.0125000
NODE_41072_length_501_cov_23.736318	85	165	13	2	80	0.0250000
NODE_41072_length_501_cov_23.736318	138	218	6	9	80	0.1125000
NODE_41072_length_501_cov_23.736318	138	218	7	17	80	0.2125000
NODE_41072_length_501_cov_23.736318	138	218	8	15	80	0.1875000
NODE_41072_length_501_cov_23.736318	138	218	9	2	80	0.0250000
NODE_41072_length_501_cov_23.736318	138	218	10	4	80	0.0500000
NODE_41072_length_501_cov_23.736318	138	218	11	33	80	0.4125000
NODE_41075_length_501_cov_7.820896	270	350	0	78	80	0.9750000
NODE_41075_length_501_cov_7.820896	270	350	1	2	80	0.0250000
NODE_41075_length_501_cov_7.820896	323	403	0	25	80	0.3125000
NODE_41075_length_501_cov_7.820896	323	403	1	55	80	0.6875000
NODE_41080_length_501_cov_6.437811	309	389	6	35	80	0.4375000
NODE_41080_length_501_cov_6.437811	309	389	7	15	80	0.1875000
NODE_41080_length_501_cov_6.437811	309	389	8	21	80	0.2625000
NODE_41080_length_501_cov_6.437811	309	389	9	9	80	0.1125000
NODE_41097_length_501_cov_3.656716	289	312	0	23	23	1.0000000
NODE_41097_length_501_cov_3.656716	355	420	0	65	65	1.0000000
NODE_41103_length_501_cov_3.477612	329	409	0	80	80	1.0000000
NODE_41109_length_501_cov_3.134328	266	345	0	79	79	1.0000000
NODE_41308_length_500_cov_77.895262	456	500	0	44	44	1.0000000
NODE_41309_length_500_cov_35.805486	326	406	0	7	80	0.0875000
NODE_41309_length_500_cov_35.805486	326	406	1	20	80	0.2500000
NODE_41309_length_500_cov_35.805486	326	406	2	45	80	0.5625000
NODE_41309_length_500_cov_35.805486	326	406	3	3	80	0.0375000
NODE_41309_length_500_cov_35.805486	326	406	4	5	80	0.0625000
NODE_41309_length_500_cov_35.805486	379	459	0	60	80	0.7500000
NODE_41309_length_500_cov_35.805486	379	459	1	20	80	0.2500000
NODE_41310_length_500_cov_13.084788	160	221	5	10	61	0.1639344
NODE_41310_length_500_cov_13.084788	160	221	6	4	61	0.0655738
NODE_41310_length_500_cov_13.084788	160	221	7	32	61	0.5245901
NODE_41310_length_500_cov_13.084788	160	221	8	15	61	0.2459016
NODE_41311_length_500_cov_12.650873	215	295	6	11	80	0.1375000
NODE_41311_length_500_cov_12.650873	215	295	7	67	80	0.8375000
NODE_41311_length_500_cov_12.650873	215	295	8	2	80	0.0250000
NODE_41311_length_500_cov_12.650873	268	348	4	11	80	0.1375000
NODE_41311_length_500_cov_12.650873	268	348	5	2	80	0.0250000
NODE_41311_length_500_cov_12.650873	268	348	6	25	80	0.3125000
NODE_41311_length_500_cov_12.650873	268	348	7	42	80	0.5250000
NODE_41312_length_500_cov_12.009975	203	268	11	20	65	0.3076923
NODE_41312_length_500_cov_12.009975	203	268	12	7	65	0.1076923
NODE_41312_length_500_cov_12.009975	203	268	13	7	65	0.1076923
NODE_41312_length_500_cov_12.009975	203	268	15	31	65	0.4769231
NODE_41312_length_500_cov_12.009975	241	321	8	13	80	0.1625000
NODE_41312_length_500_cov_12.009975	241	321	9	2	80	0.0250000
NODE_41312_length_500_cov_12.009975	241	321	10	5	80	0.0625000
NODE_41312_length_500_cov_12.009975	241	321	11	23	80	0.2875000
NODE_41312_length_500_cov_12.009975	241	321	12	3	80	0.0375000
NODE_41312_length_500_cov_12.009975	241	321	14	4	80	0.0500000
NODE_41312_length_500_cov_12.009975	241	321	15	30	80	0.3750000
NODE_41325_length_500_cov_4.653367	224	295	0	71	71	1.0000000
NODE_41415_length_500_cov_1.650873	355	435	0	80	80	1.0000000
NODE_41415_length_500_cov_1.650873	408	488	0	80	80	1.0000000
NODE_41462_length_500_cov_1.231920	169	212	2	3	43	0.0697674
NODE_41462_length_500_cov_1.231920	169	212	3	39	43	0.9069768
NODE_41462_length_500_cov_1.231920	169	212	4	1	43	0.0232558
NODE_41542_length_499_cov_358.730000	425	492	5	6	67	0.0895522
NODE_41542_length_499_cov_358.730000	425	492	6	9	67	0.1343284
NODE_41542_length_499_cov_358.730000	425	492	7	7	67	0.1044776
NODE_41542_length_499_cov_358.730000	425	492	8	1	67	0.0149254
NODE_41542_length_499_cov_358.730000	425	492	9	1	67	0.0149254
NODE_41542_length_499_cov_358.730000	425	492	10	1	67	0.0149254
NODE_41542_length_499_cov_358.730000	425	492	11	6	67	0.0895522
NODE_41542_length_499_cov_358.730000	425	492	12	3	67	0.0447761
NODE_41542_length_499_cov_358.730000	425	492	13	4	67	0.0597015
NODE_41542_length_499_cov_358.730000	425	492	14	2	67	0.0298507
NODE_41542_length_499_cov_358.730000	425	492	17	2	67	0.0298507
NODE_41542_length_499_cov_358.730000	425	492	18	1	67	0.0149254
NODE_41542_length_499_cov_358.730000	425	492	19	1	67	0.0149254
NODE_41542_length_499_cov_358.730000	425	492	20	1	67	0.0149254
NODE_41542_length_499_cov_358.730000	425	492	22	2	67	0.0298507
NODE_41542_length_499_cov_358.730000	425	492	24	4	67	0.0597015
NODE_41542_length_499_cov_358.730000	425	492	25	3	67	0.0447761
NODE_41542_length_499_cov_358.730000	425	492	26	5	67	0.0746269
NODE_41542_length_499_cov_358.730000	425	492	27	5	67	0.0746269
NODE_41542_length_499_cov_358.730000	425	492	31	3	67	0.0447761
NODE_41543_length_499_cov_21.135000	52	132	0	80	80	1.0000000
NODE_41543_length_499_cov_21.135000	105	185	0	80	80	1.0000000
NODE_41544_length_499_cov_11.917500	50	130	0	80	80	1.0000000
NODE_41544_length_499_cov_11.917500	103	183	0	80	80	1.0000000
NODE_41549_length_499_cov_5.007500	0	54	0	54	54	1.0000000
NODE_41563_length_499_cov_3.482500	307	336	0	29	29	1.0000000
NODE_41594_length_499_cov_2.420000	198	247	0	49	49	1.0000000
NODE_41662_length_499_cov_1.445000	311	372	0	61	61	1.0000000
NODE_41770_length_498_cov_31.704261	12	92	0	80	80	1.0000000
NODE_41770_length_498_cov_31.704261	65	145	0	80	80	1.0000000
NODE_41775_length_498_cov_7.002506	256	336	0	10	80	0.1250000
NODE_41775_length_498_cov_7.002506	256	336	2	70	80	0.8750000
NODE_41780_length_498_cov_5.759398	217	247	0	30	30	1.0000000
NODE_41814_length_498_cov_3.075188	225	262	0	37	37	1.0000000
NODE_41814_length_498_cov_3.075188	246	324	0	78	78	1.0000000
NODE_42016_length_497_cov_44.105528	169	249	11	17	80	0.2125000
NODE_42016_length_497_cov_44.105528	169	249	12	3	80	0.0375000
NODE_42016_length_497_cov_44.105528	169	249	14	12	80	0.1500000
NODE_42016_length_497_cov_44.105528	169	249	15	7	80	0.0875000
NODE_42016_length_497_cov_44.105528	169	249	16	24	80	0.3000000
NODE_42016_length_497_cov_44.105528	169	249	18	17	80	0.2125000
NODE_42016_length_497_cov_44.105528	222	302	12	3	80	0.0375000
NODE_42016_length_497_cov_44.105528	222	302	14	12	80	0.1500000
NODE_42016_length_497_cov_44.105528	222	302	15	11	80	0.1375000
NODE_42016_length_497_cov_44.105528	222	302	16	30	80	0.3750000
NODE_42016_length_497_cov_44.105528	222	302	17	24	80	0.3000000
NODE_42017_length_497_cov_10.145729	85	165	0	20	80	0.2500000
NODE_42017_length_497_cov_10.145729	85	165	1	7	80	0.0875000
NODE_42017_length_497_cov_10.145729	85	165	2	10	80	0.1250000
NODE_42017_length_497_cov_10.145729	85	165	3	43	80	0.5375000
NODE_42017_length_497_cov_10.145729	138	226	3	29	88	0.3295455
NODE_42017_length_497_cov_10.145729	138	226	4	59	88	0.6704546
NODE_42024_length_497_cov_6.618090	231	304	0	73	73	1.0000000
NODE_42024_length_497_cov_6.618090	284	364	0	80	80	1.0000000
NODE_42065_length_497_cov_2.889447	109	189	2	16	80	0.2000000
NODE_42065_length_497_cov_2.889447	109	189	3	56	80	0.7000000
NODE_42065_length_497_cov_2.889447	109	189	4	8	80	0.1000000
NODE_42065_length_497_cov_2.889447	162	242	2	69	80	0.8625000
NODE_42065_length_497_cov_2.889447	162	242	3	11	80	0.1375000
NODE_42071_length_497_cov_2.623116	302	368	0	66	66	1.0000000
NODE_42071_length_497_cov_2.623116	355	406	0	51	51	1.0000000
NODE_42100_length_497_cov_1.909548	106	186	0	46	80	0.5750000
NODE_42100_length_497_cov_1.909548	106	186	2	34	80	0.4250000
NODE_42100_length_497_cov_1.909548	159	240	2	81	81	1.0000000
NODE_42100_length_497_cov_1.909548	262	324	0	37	62	0.5967742
NODE_42100_length_497_cov_1.909548	262	324	2	25	62	0.4032258
NODE_42131_length_497_cov_1.500000	259	339	0	80	80	1.0000000
NODE_42136_length_497_cov_1.404523	211	263	0	37	52	0.7115384
NODE_42136_length_497_cov_1.404523	211	263	1	15	52	0.2884615
NODE_42279_length_496_cov_5.619647	239	269	0	30	30	1.0000000
NODE_42281_length_496_cov_5.392947	103	168	7	3	65	0.0461538
NODE_42281_length_496_cov_5.392947	103	168	10	46	65	0.7076923
NODE_42281_length_496_cov_5.392947	103	168	14	16	65	0.2461538
NODE_42281_length_496_cov_5.392947	141	221	7	20	80	0.2500000
NODE_42281_length_496_cov_5.392947	141	221	10	60	80	0.7500000
NODE_42281_length_496_cov_5.392947	217	295	0	38	78	0.4871795
NODE_42281_length_496_cov_5.392947	217	295	3	1	78	0.0128205
NODE_42281_length_496_cov_5.392947	217	295	6	1	78	0.0128205
NODE_42281_length_496_cov_5.392947	217	295	7	38	78	0.4871795
NODE_42281_length_496_cov_5.392947	270	295	0	25	25	1.0000000
NODE_42287_length_496_cov_4.397985	388	467	0	79	79	1.0000000
NODE_42288_length_496_cov_4.193955	235	315	0	4	80	0.0500000
NODE_42288_length_496_cov_4.193955	235	315	1	76	80	0.9500000
NODE_42297_length_496_cov_3.531486	192	273	0	81	81	1.0000000
NODE_42297_length_496_cov_3.531486	245	325	0	80	80	1.0000000
NODE_42298_length_496_cov_3.377834	252	332	0	80	80	1.0000000
NODE_42298_length_496_cov_3.377834	305	383	0	78	78	1.0000000
NODE_42316_length_496_cov_2.659950	203	251	0	48	48	1.0000000
NODE_42328_length_496_cov_2.445844	95	165	0	70	70	1.0000000
NODE_42328_length_496_cov_2.445844	148	228	0	80	80	1.0000000
NODE_42333_length_496_cov_2.214106	299	359	2	60	60	1.0000000
NODE_42415_length_496_cov_1.395466	273	317	0	44	44	1.0000000
NODE_42461_length_496_cov_0.979849	214	294	0	8	80	0.1000000
NODE_42461_length_496_cov_0.979849	214	294	1	72	80	0.9000000
NODE_42525_length_495_cov_34.888889	209	264	1	55	55	1.0000000
NODE_42526_length_495_cov_12.800505	268	348	6	51	80	0.6375000
NODE_42526_length_495_cov_12.800505	268	348	8	29	80	0.3625000
NODE_42526_length_495_cov_12.800505	321	401	2	14	80	0.1750000
NODE_42526_length_495_cov_12.800505	321	401	3	8	80	0.1000000
NODE_42526_length_495_cov_12.800505	321	401	4	20	80	0.2500000
NODE_42526_length_495_cov_12.800505	321	401	5	1	80	0.0125000
NODE_42526_length_495_cov_12.800505	321	401	6	34	80	0.4250000
NODE_42526_length_495_cov_12.800505	321	401	8	3	80	0.0375000
NODE_42529_length_495_cov_7.080808	386	416	0	30	30	1.0000000
NODE_42548_length_495_cov_3.868687	218	298	1	12	80	0.1500000
NODE_42548_length_495_cov_3.868687	218	298	2	68	80	0.8500000
NODE_42736_length_495_cov_0.792929	274	309	0	35	35	1.0000000
NODE_42773_length_494_cov_20.096203	182	262	8	1	80	0.0125000
NODE_42773_length_494_cov_20.096203	182	262	9	34	80	0.4250000
NODE_42773_length_494_cov_20.096203	182	262	11	8	80	0.1000000
NODE_42773_length_494_cov_20.096203	182	262	14	7	80	0.0875000
NODE_42773_length_494_cov_20.096203	182	262	16	1	80	0.0125000
NODE_42773_length_494_cov_20.096203	182	262	17	22	80	0.2750000
NODE_42773_length_494_cov_20.096203	182	262	20	7	80	0.0875000
NODE_42773_length_494_cov_20.096203	235	315	17	20	80	0.2500000
NODE_42773_length_494_cov_20.096203	235	315	20	39	80	0.4875000
NODE_42773_length_494_cov_20.096203	235	315	22	8	80	0.1000000
NODE_42773_length_494_cov_20.096203	235	315	23	6	80	0.0750000
NODE_42773_length_494_cov_20.096203	235	315	24	7	80	0.0875000
NODE_42778_length_494_cov_7.498734	187	240	0	53	53	1.0000000
NODE_42788_length_494_cov_4.283544	255	332	0	77	77	1.0000000
NODE_42804_length_494_cov_3.496203	209	276	1	50	67	0.7462686
NODE_42804_length_494_cov_3.496203	209	276	2	17	67	0.2537313
NODE_42812_length_494_cov_3.032911	385	432	0	47	47	1.0000000
NODE_42816_length_494_cov_2.908861	189	269	5	14	80	0.1750000
NODE_42816_length_494_cov_2.908861	189	269	7	40	80	0.5000000
NODE_42816_length_494_cov_2.908861	189	269	8	26	80	0.3250000
NODE_42822_length_494_cov_2.777215	145	188	0	43	43	1.0000000
NODE_42834_length_494_cov_2.531646	371	430	1	2	59	0.0338983
NODE_42834_length_494_cov_2.531646	371	430	2	57	59	0.9661017
NODE_42834_length_494_cov_2.531646	428	494	0	50	66	0.7575758
NODE_42834_length_494_cov_2.531646	428	494	1	16	66	0.2424242
NODE_43021_length_493_cov_34.946701	140	220	6	2	80	0.0250000
NODE_43021_length_493_cov_34.946701	140	220	11	9	80	0.1125000
NODE_43021_length_493_cov_34.946701	140	220	13	6	80	0.0750000
NODE_43021_length_493_cov_34.946701	140	220	14	1	80	0.0125000
NODE_43021_length_493_cov_34.946701	140	220	15	6	80	0.0750000
NODE_43021_length_493_cov_34.946701	140	220	16	14	80	0.1750000
NODE_43021_length_493_cov_34.946701	140	220	17	36	80	0.4500000
NODE_43021_length_493_cov_34.946701	140	220	18	1	80	0.0125000
NODE_43021_length_493_cov_34.946701	140	220	24	5	80	0.0625000
NODE_43021_length_493_cov_34.946701	193	265	2	19	72	0.2638889
NODE_43021_length_493_cov_34.946701	193	265	4	2	72	0.0277778
NODE_43021_length_493_cov_34.946701	193	265	5	6	72	0.0833333
NODE_43021_length_493_cov_34.946701	193	265	6	20	72	0.2777778
NODE_43021_length_493_cov_34.946701	193	265	11	9	72	0.1250000
NODE_43021_length_493_cov_34.946701	193	265	13	6	72	0.0833333
NODE_43021_length_493_cov_34.946701	193	265	14	1	72	0.0138889
NODE_43021_length_493_cov_34.946701	193	265	15	6	72	0.0833333
NODE_43021_length_493_cov_34.946701	193	265	16	3	72	0.0416667
NODE_43022_length_493_cov_12.451777	173	253	0	80	80	1.0000000
NODE_43022_length_493_cov_12.451777	226	306	0	80	80	1.0000000
NODE_43025_length_493_cov_8.540609	116	146	2	30	30	1.0000000
NODE_43025_length_493_cov_8.540609	119	199	2	55	80	0.6875000
NODE_43025_length_493_cov_8.540609	119	199	3	1	80	0.0125000
NODE_43025_length_493_cov_8.540609	119	199	4	24	80	0.3000000
NODE_43031_length_493_cov_6.144670	300	380	0	80	80	1.0000000
NODE_43031_length_493_cov_6.144670	353	433	0	80	80	1.0000000
NODE_43046_length_493_cov_3.840102	178	258	0	80	80	1.0000000
NODE_43046_length_493_cov_3.840102	231	311	0	80	80	1.0000000
NODE_43125_length_493_cov_1.588832	126	206	0	80	80	1.0000000
NODE_43125_length_493_cov_1.588832	179	259	0	80	80	1.0000000
NODE_43261_length_492_cov_5.488550	117	197	0	80	80	1.0000000
NODE_43261_length_492_cov_5.488550	170	250	0	80	80	1.0000000
NODE_43270_length_492_cov_4.445293	158	234	0	76	76	1.0000000
NODE_43270_length_492_cov_4.445293	207	285	0	78	78	1.0000000
NODE_43273_length_492_cov_4.244275	272	315	0	43	43	1.0000000
NODE_43293_length_492_cov_3.297710	113	193	0	3	80	0.0375000
NODE_43293_length_492_cov_3.297710	113	193	1	77	80	0.9625000
NODE_43528_length_491_cov_17.196429	138	218	2	3	80	0.0375000
NODE_43528_length_491_cov_17.196429	138	218	3	17	80	0.2125000
NODE_43528_length_491_cov_17.196429	138	218	4	9	80	0.1125000
NODE_43528_length_491_cov_17.196429	138	218	5	2	80	0.0250000
NODE_43528_length_491_cov_17.196429	138	218	10	9	80	0.1125000
NODE_43528_length_491_cov_17.196429	138	218	11	37	80	0.4625000
NODE_43528_length_491_cov_17.196429	138	218	13	3	80	0.0375000
NODE_43528_length_491_cov_17.196429	191	271	3	7	80	0.0875000
NODE_43528_length_491_cov_17.196429	191	271	4	9	80	0.1125000
NODE_43528_length_491_cov_17.196429	191	271	5	2	80	0.0250000
NODE_43528_length_491_cov_17.196429	191	271	10	32	80	0.4000000
NODE_43528_length_491_cov_17.196429	191	271	11	17	80	0.2125000
NODE_43528_length_491_cov_17.196429	191	271	12	13	80	0.1625000
NODE_43529_length_491_cov_17.193878	77	157	0	33	80	0.4125000
NODE_43529_length_491_cov_17.193878	77	157	1	47	80	0.5875000
NODE_43529_length_491_cov_17.193878	130	210	1	33	80	0.4125000
NODE_43529_length_491_cov_17.193878	130	210	2	47	80	0.5875000
NODE_43535_length_491_cov_5.505102	215	284	0	69	69	1.0000000
NODE_43535_length_491_cov_5.505102	215	295	0	80	80	1.0000000
NODE_43535_length_491_cov_5.505102	268	348	0	80	80	1.0000000
NODE_43536_length_491_cov_5.477041	169	222	0	53	53	1.0000000
NODE_43546_length_491_cov_4.176020	383	449	0	66	66	1.0000000
NODE_43546_length_491_cov_4.176020	422	476	0	54	54	1.0000000
NODE_43570_length_491_cov_2.887755	348	428	0	80	80	1.0000000
NODE_43570_length_491_cov_2.887755	401	472	0	71	71	1.0000000
NODE_43575_length_491_cov_2.693878	239	316	0	77	77	1.0000000
NODE_43744_length_490_cov_10.058824	192	272	0	80	80	1.0000000
NODE_43744_length_490_cov_10.058824	245	325	0	80	80	1.0000000
NODE_43748_length_490_cov_6.652174	304	363	1	2	59	0.0338983
NODE_43748_length_490_cov_6.652174	304	363	2	57	59	0.9661017
NODE_43816_length_490_cov_2.212276	241	300	0	59	59	1.0000000
NODE_43816_length_490_cov_2.212276	280	358	0	78	78	1.0000000
NODE_43886_length_490_cov_1.360614	97	159	0	62	62	1.0000000
NODE_43886_length_490_cov_1.360614	132	212	0	80	80	1.0000000
NODE_43993_length_489_cov_55.992308	50	130	1	4	80	0.0500000
NODE_43993_length_489_cov_55.992308	50	130	4	1	80	0.0125000
NODE_43993_length_489_cov_55.992308	50	130	7	4	80	0.0500000
NODE_43993_length_489_cov_55.992308	50	130	9	27	80	0.3375000
NODE_43993_length_489_cov_55.992308	50	130	10	31	80	0.3875000
NODE_43993_length_489_cov_55.992308	50	130	11	7	80	0.0875000
NODE_43993_length_489_cov_55.992308	50	130	15	2	80	0.0250000
NODE_43993_length_489_cov_55.992308	50	130	17	4	80	0.0500000
NODE_43993_length_489_cov_55.992308	103	183	10	14	80	0.1750000
NODE_43993_length_489_cov_55.992308	103	183	11	7	80	0.0875000
NODE_43993_length_489_cov_55.992308	103	183	15	2	80	0.0250000
NODE_43993_length_489_cov_55.992308	103	183	17	27	80	0.3375000
NODE_43993_length_489_cov_55.992308	103	183	18	30	80	0.3750000
NODE_43993_length_489_cov_55.992308	179	259	8	18	80	0.2250000
NODE_43993_length_489_cov_55.992308	179	259	9	27	80	0.3375000
NODE_43993_length_489_cov_55.992308	179	259	10	5	80	0.0625000
NODE_43993_length_489_cov_55.992308	179	259	11	4	80	0.0500000
NODE_43993_length_489_cov_55.992308	179	259	13	1	80	0.0125000
NODE_43993_length_489_cov_55.992308	179	259	17	5	80	0.0625000
NODE_43993_length_489_cov_55.992308	179	259	18	20	80	0.2500000
NODE_43993_length_489_cov_55.992308	232	312	2	9	80	0.1125000
NODE_43993_length_489_cov_55.992308	232	312	3	27	80	0.3375000
NODE_43993_length_489_cov_55.992308	232	312	5	2	80	0.0250000
NODE_43993_length_489_cov_55.992308	232	312	8	19	80	0.2375000
NODE_43993_length_489_cov_55.992308	232	312	9	10	80	0.1250000
NODE_43993_length_489_cov_55.992308	232	312	10	13	80	0.1625000
NODE_43994_length_489_cov_31.707692	299	384	8	32	85	0.3764706
NODE_43994_length_489_cov_31.707692	299	384	10	53	85	0.6235294
NODE_43994_length_489_cov_31.707692	299	384	8	32	85	0.3764706
NODE_43994_length_489_cov_31.707692	299	384	10	53	85	0.6235294
NODE_43996_length_489_cov_13.661538	227	307	4	18	80	0.2250000
NODE_43996_length_489_cov_13.661538	227	307	5	7	80	0.0875000
NODE_43996_length_489_cov_13.661538	227	307	7	55	80	0.6875000
NODE_43996_length_489_cov_13.661538	280	358	1	19	78	0.2435897
NODE_43996_length_489_cov_13.661538	280	358	3	20	78	0.2564103
NODE_43996_length_489_cov_13.661538	280	358	4	22	78	0.2820513
NODE_43996_length_489_cov_13.661538	280	358	5	15	78	0.1923077
NODE_43996_length_489_cov_13.661538	280	358	7	2	78	0.0256410
NODE_43997_length_489_cov_12.017949	214	294	5	6	80	0.0750000
NODE_43997_length_489_cov_12.017949	214	294	6	27	80	0.3375000
NODE_43997_length_489_cov_12.017949	214	294	7	40	80	0.5000000
NODE_43997_length_489_cov_12.017949	214	294	8	1	80	0.0125000
NODE_43997_length_489_cov_12.017949	214	294	9	6	80	0.0750000
NODE_43997_length_489_cov_12.017949	267	347	4	27	80	0.3375000
NODE_43997_length_489_cov_12.017949	267	347	6	53	80	0.6625000
NODE_43998_length_489_cov_10.774359	262	304	0	42	42	1.0000000
NODE_44001_length_489_cov_8.094872	141	221	4	9	80	0.1125000
NODE_44001_length_489_cov_8.094872	141	221	5	6	80	0.0750000
NODE_44001_length_489_cov_8.094872	141	221	6	65	80	0.8125000
NODE_44001_length_489_cov_8.094872	194	247	2	7	53	0.1320755
NODE_44001_length_489_cov_8.094872	194	247	4	4	53	0.0754717
NODE_44001_length_489_cov_8.094872	194	247	5	1	53	0.0188679
NODE_44001_length_489_cov_8.094872	194	247	6	41	53	0.7735849
NODE_44007_length_489_cov_5.284615	176	256	0	80	80	1.0000000
NODE_44007_length_489_cov_5.284615	229	309	0	80	80	1.0000000
NODE_44096_length_489_cov_1.646154	234	278	0	44	44	1.0000000
NODE_44105_length_489_cov_1.574359	351	391	1	6	40	0.1500000
NODE_44105_length_489_cov_1.574359	351	391	2	34	40	0.8500000
NODE_44105_length_489_cov_1.574359	351	383	2	32	32	1.0000000
NODE_44105_length_489_cov_1.574359	365	445	1	60	80	0.7500000
NODE_44105_length_489_cov_1.574359	365	445	2	20	80	0.2500000
NODE_44105_length_489_cov_1.574359	365	445	1	60	80	0.7500000
NODE_44105_length_489_cov_1.574359	365	445	2	20	80	0.2500000
NODE_44105_length_489_cov_1.574359	366	445	1	60	79	0.7594936
NODE_44105_length_489_cov_1.574359	366	445	2	19	79	0.2405063
NODE_44231_length_488_cov_15.406170	235	313	0	78	78	1.0000000
NODE_44231_length_488_cov_15.406170	286	367	0	81	81	1.0000000
NODE_44234_length_488_cov_8.416452	210	290	1	6	80	0.0750000
NODE_44234_length_488_cov_8.416452	210	290	2	74	80	0.9250000
NODE_44234_length_488_cov_8.416452	263	343	1	9	80	0.1125000
NODE_44234_length_488_cov_8.416452	263	343	2	71	80	0.8875000
NODE_44240_length_488_cov_6.084833	254	302	0	48	48	1.0000000
NODE_44243_length_488_cov_5.434447	210	279	1	59	69	0.8550724
NODE_44243_length_488_cov_5.434447	210	279	2	10	69	0.1449275
NODE_44243_length_488_cov_5.434447	265	300	1	4	35	0.1142857
NODE_44243_length_488_cov_5.434447	265	300	2	31	35	0.8857143
NODE_44263_length_488_cov_3.431877	212	248	0	36	36	1.0000000
NODE_44264_length_488_cov_3.424165	320	367	0	32	47	0.6808510
NODE_44264_length_488_cov_3.424165	320	367	2	15	47	0.3191489
NODE_44264_length_488_cov_3.424165	320	378	0	32	58	0.5517241
NODE_44264_length_488_cov_3.424165	320	378	2	26	58	0.4482759
NODE_44264_length_488_cov_3.424165	351	393	0	1	42	0.0238095
NODE_44264_length_488_cov_3.424165	351	393	2	31	42	0.7380952
NODE_44264_length_488_cov_3.424165	351	393	3	1	42	0.0238095
NODE_44264_length_488_cov_3.424165	351	393	4	9	42	0.2142857
NODE_44264_length_488_cov_3.424165	360	395	2	23	35	0.6571429
NODE_44264_length_488_cov_3.424165	360	395	3	1	35	0.0285714
NODE_44264_length_488_cov_3.424165	360	395	4	11	35	0.3142857
NODE_44274_length_488_cov_2.850900	276	356	0	80	80	1.0000000
NODE_44376_length_488_cov_1.562982	31	67	0	36	36	1.0000000
NODE_44496_length_487_cov_7.028351	278	358	0	80	80	1.0000000
NODE_44498_length_487_cov_6.804124	242	313	0	71	71	1.0000000
NODE_44498_length_487_cov_6.804124	286	366	0	80	80	1.0000000
NODE_44500_length_487_cov_5.917526	140	220	0	80	80	1.0000000
NODE_44500_length_487_cov_5.917526	193	273	0	80	80	1.0000000
NODE_44520_length_487_cov_3.296392	235	315	0	48	80	0.6000000
NODE_44520_length_487_cov_3.296392	235	315	1	14	80	0.1750000
NODE_44520_length_487_cov_3.296392	235	315	2	18	80	0.2250000
NODE_44521_length_487_cov_3.237113	301	363	2	22	62	0.3548387
NODE_44521_length_487_cov_3.237113	301	363	4	40	62	0.6451613
NODE_44525_length_487_cov_3.074742	214	294	2	80	80	1.0000000
NODE_44723_length_486_cov_6.609819	206	286	0	80	80	1.0000000
NODE_44728_length_486_cov_5.428941	147	227	0	80	80	1.0000000
NODE_44754_length_486_cov_3.072351	131	211	0	80	80	1.0000000
NODE_44754_length_486_cov_3.072351	190	235	0	45	45	1.0000000
NODE_44769_length_486_cov_2.581395	156	236	0	80	80	1.0000000
NODE_44769_length_486_cov_2.581395	209	289	0	80	80	1.0000000
NODE_44781_length_486_cov_2.343669	189	230	0	41	41	1.0000000
NODE_44781_length_486_cov_2.343669	242	306	0	64	64	1.0000000
NODE_44959_length_485_cov_29.505181	270	350	0	80	80	1.0000000
NODE_44959_length_485_cov_29.505181	323	403	0	80	80	1.0000000
NODE_44959_length_485_cov_29.505181	399	479	0	80	80	1.0000000
NODE_44960_length_485_cov_10.450777	67	153	0	86	86	1.0000000
NODE_44960_length_485_cov_10.450777	133	206	0	73	73	1.0000000
NODE_44965_length_485_cov_5.922280	196	273	0	64	77	0.8311688
NODE_44965_length_485_cov_5.922280	196	273	2	13	77	0.1688312
NODE_44965_length_485_cov_5.922280	246	326	0	14	80	0.1750000
NODE_44965_length_485_cov_5.922280	246	326	2	66	80	0.8250000
NODE_44966_length_485_cov_5.818653	279	359	0	80	80	1.0000000
NODE_44966_length_485_cov_5.818653	332	412	0	80	80	1.0000000
NODE_44968_length_485_cov_5.670984	321	396	0	75	75	1.0000000
NODE_44992_length_485_cov_3.518135	162	210	0	48	48	1.0000000
NODE_45005_length_485_cov_2.790155	193	253	0	60	60	1.0000000
NODE_45021_length_485_cov_2.427461	170	249	0	79	79	1.0000000
NODE_45100_length_485_cov_1.264249	232	251	0	19	19	1.0000000
NODE_45193_length_484_cov_33.384416	92	172	2	56	80	0.7000000
NODE_45193_length_484_cov_33.384416	92	172	4	24	80	0.3000000
NODE_45193_length_484_cov_33.384416	145	225	2	4	80	0.0500000
NODE_45193_length_484_cov_33.384416	145	225	4	76	80	0.9500000
NODE_45195_length_484_cov_9.111688	136	216	0	18	80	0.2250000
NODE_45195_length_484_cov_9.111688	136	216	1	62	80	0.7750000
NODE_45195_length_484_cov_9.111688	189	270	1	72	81	0.8888889
NODE_45195_length_484_cov_9.111688	189	270	2	9	81	0.1111111
NODE_45196_length_484_cov_8.353247	165	244	1	48	79	0.6075949
NODE_45196_length_484_cov_8.353247	165	244	2	31	79	0.3924051
NODE_45196_length_484_cov_8.353247	217	297	1	49	80	0.6125000
NODE_45196_length_484_cov_8.353247	217	297	2	31	80	0.3875000
NODE_45197_length_484_cov_8.119481	108	188	0	80	80	1.0000000
NODE_45197_length_484_cov_8.119481	161	241	0	80	80	1.0000000
NODE_45200_length_484_cov_7.703896	208	288	0	80	80	1.0000000
NODE_45200_length_484_cov_7.703896	261	341	0	80	80	1.0000000
NODE_45202_length_484_cov_7.153247	230	292	0	62	62	1.0000000
NODE_45204_length_484_cov_6.594805	221	301	0	7	80	0.0875000
NODE_45204_length_484_cov_6.594805	221	301	4	57	80	0.7125000
NODE_45204_length_484_cov_6.594805	221	301	8	16	80	0.2000000
NODE_45204_length_484_cov_6.594805	274	354	4	11	80	0.1375000
NODE_45204_length_484_cov_6.594805	274	354	8	69	80	0.8625000
NODE_45218_length_484_cov_4.044156	267	347	0	80	80	1.0000000
NODE_45218_length_484_cov_4.044156	342	396	0	54	54	1.0000000
NODE_45225_length_484_cov_3.787013	287	331	0	44	44	1.0000000
NODE_45225_length_484_cov_3.787013	307	386	0	79	79	1.0000000
NODE_45225_length_484_cov_3.787013	317	386	0	69	69	1.0000000
NODE_45276_length_484_cov_2.254545	79	132	0	53	53	1.0000000
NODE_45352_length_484_cov_1.322078	429	477	0	48	48	1.0000000
NODE_45353_length_484_cov_1.314286	431	472	0	41	41	1.0000000
NODE_45459_length_483_cov_40.815104	396	473	2	14	77	0.1818182
NODE_45459_length_483_cov_40.815104	396	473	7	3	77	0.0389610
NODE_45459_length_483_cov_40.815104	396	473	9	39	77	0.5064935
NODE_45459_length_483_cov_40.815104	396	473	10	21	77	0.2727273
NODE_45459_length_483_cov_40.815104	396	473	2	14	77	0.1818182
NODE_45459_length_483_cov_40.815104	396	473	7	3	77	0.0389610
NODE_45459_length_483_cov_40.815104	396	473	9	39	77	0.5064935
NODE_45459_length_483_cov_40.815104	396	473	10	21	77	0.2727273
NODE_45473_length_483_cov_5.289062	124	185	0	61	61	1.0000000
NODE_45494_length_483_cov_4.114583	226	306	0	11	80	0.1375000
NODE_45494_length_483_cov_4.114583	226	306	1	69	80	0.8625000
NODE_45494_length_483_cov_4.114583	226	305	0	11	79	0.1392405
NODE_45494_length_483_cov_4.114583	226	305	1	68	79	0.8607595
NODE_45494_length_483_cov_4.114583	226	306	0	11	80	0.1375000
NODE_45494_length_483_cov_4.114583	226	306	1	69	80	0.8625000
NODE_45494_length_483_cov_4.114583	226	306	0	11	80	0.1375000
NODE_45494_length_483_cov_4.114583	226	306	1	69	80	0.8625000
NODE_45494_length_483_cov_4.114583	279	359	1	80	80	1.0000000
NODE_45494_length_483_cov_4.114583	279	325	1	46	46	1.0000000
NODE_45494_length_483_cov_4.114583	297	323	1	26	26	1.0000000
NODE_45495_length_483_cov_4.046875	68	117	0	49	49	1.0000000
NODE_45495_length_483_cov_4.046875	184	250	1	3	66	0.0454545
NODE_45495_length_483_cov_4.046875	184	250	2	63	66	0.9545454
NODE_45635_length_483_cov_1.205729	249	291	0	42	42	1.0000000
NODE_45725_length_482_cov_37.900783	72	152	11	2	80	0.0250000
NODE_45725_length_482_cov_37.900783	72	152	12	28	80	0.3500000
NODE_45725_length_482_cov_37.900783	72	152	13	50	80	0.6250000
NODE_45725_length_482_cov_37.900783	125	205	5	4	80	0.0500000
NODE_45725_length_482_cov_37.900783	125	205	6	13	80	0.1625000
NODE_45725_length_482_cov_37.900783	125	205	7	3	80	0.0375000
NODE_45725_length_482_cov_37.900783	125	205	9	3	80	0.0375000
NODE_45725_length_482_cov_37.900783	125	205	10	26	80	0.3250000
NODE_45725_length_482_cov_37.900783	125	205	13	31	80	0.3875000
NODE_45728_length_482_cov_10.545692	233	297	0	64	64	1.0000000
NODE_45729_length_482_cov_9.342037	281	333	2	52	52	1.0000000
NODE_45730_length_482_cov_8.190601	247	311	0	64	64	1.0000000
NODE_45730_length_482_cov_8.190601	284	355	0	71	71	1.0000000
NODE_45734_length_482_cov_6.002611	112	192	0	80	80	1.0000000
NODE_45734_length_482_cov_6.002611	165	245	0	80	80	1.0000000
NODE_45735_length_482_cov_5.953003	315	395	0	80	80	1.0000000
NODE_45735_length_482_cov_5.953003	368	441	0	73	73	1.0000000
NODE_45748_length_482_cov_4.530026	20	85	0	65	65	1.0000000
NODE_45759_length_482_cov_3.791123	278	358	0	80	80	1.0000000
NODE_45759_length_482_cov_3.791123	331	411	0	80	80	1.0000000
NODE_45842_length_482_cov_1.647520	382	446	0	64	64	1.0000000
NODE_45842_length_482_cov_1.647520	435	482	0	47	47	1.0000000
NODE_45994_length_481_cov_50.623037	154	234	0	4	80	0.0500000
NODE_45994_length_481_cov_50.623037	154	234	1	16	80	0.2000000
NODE_45994_length_481_cov_50.623037	154	234	3	60	80	0.7500000
NODE_45994_length_481_cov_50.623037	207	287	2	6	80	0.0750000
NODE_45994_length_481_cov_50.623037	207	287	3	50	80	0.6250000
NODE_45994_length_481_cov_50.623037	207	287	4	24	80	0.3000000
NODE_45995_length_481_cov_30.939791	149	198	0	49	49	1.0000000
NODE_45995_length_481_cov_30.939791	171	235	0	64	64	1.0000000
NODE_45995_length_481_cov_30.939791	171	235	0	64	64	1.0000000
NODE_45996_length_481_cov_30.183246	0	41	0	41	41	1.0000000
NODE_45996_length_481_cov_30.183246	0	39	0	39	39	1.0000000
NODE_45996_length_481_cov_30.183246	0	44	0	44	44	1.0000000
NODE_45996_length_481_cov_30.183246	0	44	0	44	44	1.0000000
NODE_45996_length_481_cov_30.183246	0	44	0	44	44	1.0000000
NODE_45996_length_481_cov_30.183246	0	44	0	44	44	1.0000000
NODE_45996_length_481_cov_30.183246	17	97	0	80	80	1.0000000
NODE_45996_length_481_cov_30.183246	17	97	0	80	80	1.0000000
NODE_45996_length_481_cov_30.183246	17	97	0	80	80	1.0000000
NODE_45996_length_481_cov_30.183246	17	97	0	80	80	1.0000000
NODE_45996_length_481_cov_30.183246	17	97	0	80	80	1.0000000
NODE_45996_length_481_cov_30.183246	17	97	0	80	80	1.0000000
NODE_45997_length_481_cov_12.709424	250	330	2	11	80	0.1375000
NODE_45997_length_481_cov_12.709424	250	330	3	69	80	0.8625000
NODE_45997_length_481_cov_12.709424	303	383	2	27	80	0.3375000
NODE_45997_length_481_cov_12.709424	303	383	3	53	80	0.6625000
NODE_46037_length_481_cov_3.002618	197	277	0	80	80	1.0000000
NODE_46064_length_481_cov_2.261780	271	351	0	80	80	1.0000000
NODE_46256_length_480_cov_22.346457	318	398	1	63	80	0.7875000
NODE_46256_length_480_cov_22.346457	318	398	2	17	80	0.2125000
NODE_46256_length_480_cov_22.346457	371	451	0	42	80	0.5250000
NODE_46256_length_480_cov_22.346457	371	451	1	38	80	0.4750000
NODE_46257_length_480_cov_16.488189	252	332	0	16	80	0.2000000
NODE_46257_length_480_cov_16.488189	252	332	2	64	80	0.8000000
NODE_46257_length_480_cov_16.488189	305	385	2	80	80	1.0000000
NODE_46258_length_480_cov_12.874016	164	234	0	70	70	1.0000000
NODE_46258_length_480_cov_12.874016	207	273	0	66	66	1.0000000
NODE_46260_length_480_cov_11.879265	170	250	4	70	80	0.8750000
NODE_46260_length_480_cov_11.879265	170	250	6	10	80	0.1250000
NODE_46260_length_480_cov_11.879265	223	303	0	8	80	0.1000000
NODE_46260_length_480_cov_11.879265	223	303	1	39	80	0.4875000
NODE_46260_length_480_cov_11.879265	223	303	4	33	80	0.4125000
NODE_46261_length_480_cov_8.774278	114	143	0	29	29	1.0000000
NODE_46261_length_480_cov_8.774278	165	245	1	31	80	0.3875000
NODE_46261_length_480_cov_8.774278	165	245	2	49	80	0.6125000
NODE_46261_length_480_cov_8.774278	218	298	2	80	80	1.0000000
NODE_46261_length_480_cov_8.774278	385	428	0	43	43	1.0000000
NODE_46271_length_480_cov_5.671916	231	302	0	12	71	0.1690141
NODE_46271_length_480_cov_5.671916	231	302	1	59	71	0.8309859
NODE_46283_length_480_cov_4.354331	126	187	0	61	61	1.0000000
NODE_46283_length_480_cov_4.354331	218	298	0	80	80	1.0000000
NODE_46445_length_480_cov_1.152231	142	216	0	74	74	1.0000000
NODE_46470_length_480_cov_0.973753	31	71	0	40	40	1.0000000
NODE_46533_length_479_cov_28.205263	308	388	4	3	80	0.0375000
NODE_46533_length_479_cov_28.205263	308	388	6	16	80	0.2000000
NODE_46533_length_479_cov_28.205263	308	388	7	61	80	0.7625000
NODE_46533_length_479_cov_28.205263	361	441	4	23	80	0.2875000
NODE_46533_length_479_cov_28.205263	361	441	5	7	80	0.0875000
NODE_46533_length_479_cov_28.205263	361	441	6	9	80	0.1125000
NODE_46533_length_479_cov_28.205263	361	441	7	41	80	0.5125000
NODE_46534_length_479_cov_23.944737	189	269	5	44	80	0.5500000
NODE_46534_length_479_cov_23.944737	189	269	7	33	80	0.4125000
NODE_46534_length_479_cov_23.944737	189	269	8	3	80	0.0375000
NODE_46534_length_479_cov_23.944737	242	322	4	1	80	0.0125000
NODE_46534_length_479_cov_23.944737	242	322	7	79	80	0.9875000
NODE_46554_length_479_cov_4.942105	283	363	0	80	80	1.0000000
NODE_46554_length_479_cov_4.942105	336	416	0	80	80	1.0000000
NODE_46574_length_479_cov_3.494737	217	279	0	62	62	1.0000000
NODE_46574_length_479_cov_3.494737	272	332	0	60	60	1.0000000
NODE_46611_length_479_cov_2.281579	219	265	0	10	46	0.2173913
NODE_46611_length_479_cov_2.281579	219	265	1	23	46	0.5000000
NODE_46611_length_479_cov_2.281579	219	265	2	13	46	0.2826087
NODE_46638_length_479_cov_1.839474	376	431	0	55	55	1.0000000
NODE_46654_length_479_cov_1.710526	203	265	0	62	62	1.0000000
NODE_46654_length_479_cov_1.710526	248	318	0	70	70	1.0000000
NODE_46828_length_478_cov_336.139842	153	233	65	6	80	0.0750000
NODE_46828_length_478_cov_336.139842	153	233	66	4	80	0.0500000
NODE_46828_length_478_cov_336.139842	153	233	67	2	80	0.0250000
NODE_46828_length_478_cov_336.139842	153	233	68	10	80	0.1250000
NODE_46828_length_478_cov_336.139842	153	233	69	11	80	0.1375000
NODE_46828_length_478_cov_336.139842	153	233	70	2	80	0.0250000
NODE_46828_length_478_cov_336.139842	153	233	71	3	80	0.0375000
NODE_46828_length_478_cov_336.139842	153	233	72	4	80	0.0500000
NODE_46828_length_478_cov_336.139842	153	233	75	4	80	0.0500000
NODE_46828_length_478_cov_336.139842	153	233	76	2	80	0.0250000
NODE_46828_length_478_cov_336.139842	153	233	77	1	80	0.0125000
NODE_46828_length_478_cov_336.139842	153	233	80	4	80	0.0500000
NODE_46828_length_478_cov_336.139842	153	233	81	1	80	0.0125000
NODE_46828_length_478_cov_336.139842	153	233	82	2	80	0.0250000
NODE_46828_length_478_cov_336.139842	153	233	83	5	80	0.0625000
NODE_46828_length_478_cov_336.139842	153	233	85	1	80	0.0125000
NODE_46828_length_478_cov_336.139842	153	233	86	10	80	0.1250000
NODE_46828_length_478_cov_336.139842	153	233	88	2	80	0.0250000
NODE_46828_length_478_cov_336.139842	153	233	89	2	80	0.0250000
NODE_46828_length_478_cov_336.139842	153	233	90	4	80	0.0500000
NODE_46828_length_478_cov_336.139842	206	286	60	5	80	0.0625000
NODE_46828_length_478_cov_336.139842	206	286	61	1	80	0.0125000
NODE_46828_length_478_cov_336.139842	206	286	63	3	80	0.0375000
NODE_46828_length_478_cov_336.139842	206	286	65	1	80	0.0125000
NODE_46828_length_478_cov_336.139842	206	286	67	3	80	0.0375000
NODE_46828_length_478_cov_336.139842	206	286	68	2	80	0.0250000
NODE_46828_length_478_cov_336.139842	206	286	69	1	80	0.0125000
NODE_46828_length_478_cov_336.139842	206	286	70	1	80	0.0125000
NODE_46828_length_478_cov_336.139842	206	286	71	1	80	0.0125000
NODE_46828_length_478_cov_336.139842	206	286	72	1	80	0.0125000
NODE_46828_length_478_cov_336.139842	206	286	75	2	80	0.0250000
NODE_46828_length_478_cov_336.139842	206	286	79	1	80	0.0125000
NODE_46828_length_478_cov_336.139842	206	286	80	4	80	0.0500000
NODE_46828_length_478_cov_336.139842	206	286	81	9	80	0.1125000
NODE_46828_length_478_cov_336.139842	206	286	82	2	80	0.0250000
NODE_46828_length_478_cov_336.139842	206	286	83	7	80	0.0875000
NODE_46828_length_478_cov_336.139842	206	286	84	2	80	0.0250000
NODE_46828_length_478_cov_336.139842	206	286	85	2	80	0.0250000
NODE_46828_length_478_cov_336.139842	206	286	86	14	80	0.1750000
NODE_46828_length_478_cov_336.139842	206	286	87	2	80	0.0250000
NODE_46828_length_478_cov_336.139842	206	286	88	6	80	0.0750000
NODE_46828_length_478_cov_336.139842	206	286	89	6	80	0.0750000
NODE_46828_length_478_cov_336.139842	206	286	90	4	80	0.0500000
NODE_46846_length_478_cov_4.448549	150	230	0	80	80	1.0000000
NODE_46846_length_478_cov_4.448549	203	284	0	81	81	1.0000000
NODE_46874_length_478_cov_2.627968	228	278	0	50	50	1.0000000
NODE_47128_length_477_cov_36.230159	225	305	4	25	80	0.3125000
NODE_47128_length_477_cov_36.230159	225	305	6	3	80	0.0375000
NODE_47128_length_477_cov_36.230159	225	305	7	1	80	0.0125000
NODE_47128_length_477_cov_36.230159	225	305	8	13	80	0.1625000
NODE_47128_length_477_cov_36.230159	225	305	10	32	80	0.4000000
NODE_47128_length_477_cov_36.230159	225	305	12	6	80	0.0750000
NODE_47128_length_477_cov_36.230159	278	358	9	1	80	0.0125000
NODE_47128_length_477_cov_36.230159	278	358	10	71	80	0.8875000
NODE_47128_length_477_cov_36.230159	278	358	12	8	80	0.1000000
NODE_47129_length_477_cov_33.111111	307	387	8	14	80	0.1750000
NODE_47129_length_477_cov_33.111111	307	387	10	10	80	0.1250000
NODE_47129_length_477_cov_33.111111	307	387	11	41	80	0.5125000
NODE_47129_length_477_cov_33.111111	307	387	13	15	80	0.1875000
NODE_47129_length_477_cov_33.111111	360	440	2	16	80	0.2000000
NODE_47129_length_477_cov_33.111111	360	440	3	4	80	0.0500000
NODE_47129_length_477_cov_33.111111	360	440	7	7	80	0.0875000
NODE_47129_length_477_cov_33.111111	360	440	8	40	80	0.5000000
NODE_47129_length_477_cov_33.111111	360	440	10	10	80	0.1250000
NODE_47129_length_477_cov_33.111111	360	440	11	3	80	0.0375000
NODE_47133_length_477_cov_11.235450	119	199	0	80	80	1.0000000
NODE_47133_length_477_cov_11.235450	172	247	0	75	75	1.0000000
NODE_47135_length_477_cov_9.359788	221	301	6	66	80	0.8250000
NODE_47135_length_477_cov_9.359788	221	301	7	5	80	0.0625000
NODE_47135_length_477_cov_9.359788	221	301	8	9	80	0.1125000
NODE_47135_length_477_cov_9.359788	274	354	1	2	80	0.0250000
NODE_47135_length_477_cov_9.359788	274	354	2	4	80	0.0500000
NODE_47135_length_477_cov_9.359788	274	354	3	28	80	0.3500000
NODE_47135_length_477_cov_9.359788	274	354	4	12	80	0.1500000
NODE_47135_length_477_cov_9.359788	274	354	6	34	80	0.4250000
NODE_47139_length_477_cov_7.436508	230	304	0	74	74	1.0000000
NODE_47140_length_477_cov_7.433862	43	123	0	47	80	0.5875000
NODE_47140_length_477_cov_7.433862	43	123	2	6	80	0.0750000
NODE_47140_length_477_cov_7.433862	43	123	3	27	80	0.3375000
NODE_47140_length_477_cov_7.433862	96	176	3	56	80	0.7000000
NODE_47140_length_477_cov_7.433862	96	176	4	24	80	0.3000000
NODE_47143_length_477_cov_6.846561	163	243	0	80	80	1.0000000
NODE_47143_length_477_cov_6.846561	216	296	0	80	80	1.0000000
NODE_47147_length_477_cov_5.677249	150	228	0	78	78	1.0000000
NODE_47148_length_477_cov_5.084656	227	288	1	61	61	1.0000000
NODE_47253_length_477_cov_1.629630	115	171	0	56	56	1.0000000
NODE_47253_length_477_cov_1.629630	167	224	0	57	57	1.0000000
NODE_47375_length_477_cov_0.859788	445	477	0	32	32	1.0000000
NODE_47427_length_476_cov_7.533156	221	301	0	80	80	1.0000000
NODE_47427_length_476_cov_7.533156	274	354	0	80	80	1.0000000
NODE_47529_length_476_cov_1.618037	385	444	0	59	59	1.0000000
NODE_47601_length_476_cov_1.129973	15	34	0	19	19	1.0000000
NODE_47620_length_476_cov_1.037135	180	243	0	63	63	1.0000000
NODE_47620_length_476_cov_1.037135	237	296	0	59	59	1.0000000
NODE_47693_length_475_cov_34.460106	270	350	3	80	80	1.0000000
NODE_47693_length_475_cov_34.460106	323	403	0	35	80	0.4375000
NODE_47693_length_475_cov_34.460106	323	403	3	45	80	0.5625000
NODE_47694_length_475_cov_30.087766	273	353	4	11	80	0.1375000
NODE_47694_length_475_cov_30.087766	273	353	15	2	80	0.0250000
NODE_47694_length_475_cov_30.087766	273	353	16	4	80	0.0500000
NODE_47694_length_475_cov_30.087766	273	353	22	18	80	0.2250000
NODE_47694_length_475_cov_30.087766	273	353	23	15	80	0.1875000
NODE_47694_length_475_cov_30.087766	273	353	24	30	80	0.3750000
NODE_47694_length_475_cov_30.087766	326	406	20	9	80	0.1125000
NODE_47694_length_475_cov_30.087766	326	406	21	5	80	0.0625000
NODE_47694_length_475_cov_30.087766	326	406	23	12	80	0.1500000
NODE_47694_length_475_cov_30.087766	326	406	24	54	80	0.6750000
NODE_47695_length_475_cov_10.247340	42	122	0	80	80	1.0000000
NODE_47701_length_475_cov_8.393617	9	89	0	80	80	1.0000000
NODE_47701_length_475_cov_8.393617	62	142	0	80	80	1.0000000
NODE_47828_length_475_cov_1.531915	272	352	0	80	80	1.0000000
NODE_47839_length_475_cov_1.457447	50	93	0	43	43	1.0000000
NODE_47979_length_474_cov_49.453333	392	472	7	11	80	0.1375000
NODE_47979_length_474_cov_49.453333	392	472	8	20	80	0.2500000
NODE_47979_length_474_cov_49.453333	392	472	9	1	80	0.0125000
NODE_47979_length_474_cov_49.453333	392	472	10	4	80	0.0500000
NODE_47979_length_474_cov_49.453333	392	472	11	3	80	0.0375000
NODE_47979_length_474_cov_49.453333	392	472	12	9	80	0.1125000
NODE_47979_length_474_cov_49.453333	392	472	13	4	80	0.0500000
NODE_47979_length_474_cov_49.453333	392	472	14	2	80	0.0250000
NODE_47979_length_474_cov_49.453333	392	472	15	8	80	0.1000000
NODE_47979_length_474_cov_49.453333	392	472	16	16	80	0.2000000
NODE_47979_length_474_cov_49.453333	392	472	17	2	80	0.0250000
NODE_47979_length_474_cov_49.453333	445	474	7	13	29	0.4482759
NODE_47979_length_474_cov_49.453333	445	474	8	16	29	0.5517241
NODE_47981_length_474_cov_24.930667	287	367	1	20	80	0.2500000
NODE_47981_length_474_cov_24.930667	287	367	2	3	80	0.0375000
NODE_47981_length_474_cov_24.930667	287	367	3	57	80	0.7125000
NODE_47981_length_474_cov_24.930667	340	420	0	21	80	0.2625000
NODE_47981_length_474_cov_24.930667	340	420	2	20	80	0.2500000
NODE_47981_length_474_cov_24.930667	340	420	3	39	80	0.4875000
NODE_47982_length_474_cov_15.952000	258	338	0	80	80	1.0000000
NODE_47982_length_474_cov_15.952000	311	391	0	80	80	1.0000000
NODE_48003_length_474_cov_3.986667	172	252	0	80	80	1.0000000
NODE_48015_length_474_cov_3.496000	163	243	0	52	80	0.6500000
NODE_48015_length_474_cov_3.496000	163	243	1	28	80	0.3500000
NODE_48038_length_474_cov_2.784000	259	300	0	41	41	1.0000000
NODE_48116_length_474_cov_1.538667	41	62	0	21	21	1.0000000
NODE_48181_length_474_cov_1.085333	0	50	0	50	50	1.0000000
NODE_48184_length_474_cov_1.056000	95	133	0	38	38	1.0000000
NODE_48266_length_473_cov_82.374332	123	203	42	1	80	0.0125000
NODE_48266_length_473_cov_82.374332	123	203	43	3	80	0.0375000
NODE_48266_length_473_cov_82.374332	123	203	44	8	80	0.1000000
NODE_48266_length_473_cov_82.374332	123	203	51	7	80	0.0875000
NODE_48266_length_473_cov_82.374332	123	203	53	3	80	0.0375000
NODE_48266_length_473_cov_82.374332	123	203	54	1	80	0.0125000
NODE_48266_length_473_cov_82.374332	123	203	57	1	80	0.0125000
NODE_48266_length_473_cov_82.374332	123	203	58	1	80	0.0125000
NODE_48266_length_473_cov_82.374332	123	203	63	8	80	0.1000000
NODE_48266_length_473_cov_82.374332	123	203	66	6	80	0.0750000
NODE_48266_length_473_cov_82.374332	123	203	67	1	80	0.0125000
NODE_48266_length_473_cov_82.374332	123	203	68	25	80	0.3125000
NODE_48266_length_473_cov_82.374332	123	203	69	4	80	0.0500000
NODE_48266_length_473_cov_82.374332	123	203	76	2	80	0.0250000
NODE_48266_length_473_cov_82.374332	123	203	78	2	80	0.0250000
NODE_48266_length_473_cov_82.374332	123	203	79	7	80	0.0875000
NODE_48266_length_473_cov_82.374332	176	256	36	30	80	0.3750000
NODE_48266_length_473_cov_82.374332	176	256	37	6	80	0.0750000
NODE_48266_length_473_cov_82.374332	176	256	39	1	80	0.0125000
NODE_48266_length_473_cov_82.374332	176	256	40	6	80	0.0750000
NODE_48266_length_473_cov_82.374332	176	256	41	2	80	0.0250000
NODE_48266_length_473_cov_82.374332	176	256	42	1	80	0.0125000
NODE_48266_length_473_cov_82.374332	176	256	43	3	80	0.0375000
NODE_48266_length_473_cov_82.374332	176	256	44	8	80	0.1000000
NODE_48266_length_473_cov_82.374332	176	256	48	1	80	0.0125000
NODE_48266_length_473_cov_82.374332	176	256	49	4	80	0.0500000
NODE_48266_length_473_cov_82.374332	176	256	50	1	80	0.0125000
NODE_48266_length_473_cov_82.374332	176	256	51	9	80	0.1125000
NODE_48266_length_473_cov_82.374332	176	256	53	3	80	0.0375000
NODE_48266_length_473_cov_82.374332	176	256	54	1	80	0.0125000
NODE_48266_length_473_cov_82.374332	176	256	57	1	80	0.0125000
NODE_48266_length_473_cov_82.374332	176	256	58	1	80	0.0125000
NODE_48266_length_473_cov_82.374332	176	256	76	1	80	0.0125000
NODE_48266_length_473_cov_82.374332	176	256	78	1	80	0.0125000
NODE_48267_length_473_cov_54.882353	199	279	0	80	80	1.0000000
NODE_48267_length_473_cov_54.882353	252	332	0	80	80	1.0000000
NODE_48268_length_473_cov_48.997326	119	194	0	6	75	0.0800000
NODE_48268_length_473_cov_48.997326	119	194	3	1	75	0.0133333
NODE_48268_length_473_cov_48.997326	119	194	4	68	75	0.9066667
NODE_48268_length_473_cov_48.997326	119	194	0	6	75	0.0800000
NODE_48268_length_473_cov_48.997326	119	194	3	1	75	0.0133333
NODE_48268_length_473_cov_48.997326	119	194	4	68	75	0.9066667
NODE_48268_length_473_cov_48.997326	167	247	4	51	80	0.6375000
NODE_48268_length_473_cov_48.997326	167	247	5	29	80	0.3625000
NODE_48269_length_473_cov_30.679144	174	254	0	80	80	1.0000000
NODE_48269_length_473_cov_30.679144	226	307	0	81	81	1.0000000
NODE_48269_length_473_cov_30.679144	227	307	0	80	80	1.0000000
NODE_48270_length_473_cov_24.967914	295	370	4	20	75	0.2666667
NODE_48270_length_473_cov_24.967914	295	370	5	11	75	0.1466667
NODE_48270_length_473_cov_24.967914	295	370	9	44	75	0.5866666
NODE_48270_length_473_cov_24.967914	343	423	5	64	80	0.8000000
NODE_48270_length_473_cov_24.967914	343	423	9	16	80	0.2000000
NODE_48271_length_473_cov_18.540107	168	248	4	80	80	1.0000000
NODE_48271_length_473_cov_18.540107	221	301	0	7	80	0.0875000
NODE_48271_length_473_cov_18.540107	221	301	4	73	80	0.9125000
NODE_48272_length_473_cov_15.871658	143	223	0	5	80	0.0625000
NODE_48272_length_473_cov_15.871658	143	223	1	75	80	0.9375000
NODE_48272_length_473_cov_15.871658	196	276	1	64	80	0.8000000
NODE_48272_length_473_cov_15.871658	196	276	2	16	80	0.2000000
NODE_48291_length_473_cov_4.363636	160	240	0	80	80	1.0000000
NODE_48291_length_473_cov_4.363636	213	293	0	80	80	1.0000000
NODE_48320_length_473_cov_2.959893	199	267	0	68	68	1.0000000
NODE_48325_length_473_cov_2.804813	207	269	0	62	62	1.0000000
NODE_48350_length_473_cov_2.251337	48	128	0	80	80	1.0000000
NODE_48350_length_473_cov_2.251337	101	181	0	80	80	1.0000000
NODE_48568_length_472_cov_50.077748	1	81	0	18	80	0.2250000
NODE_48568_length_472_cov_50.077748	1	81	1	35	80	0.4375000
NODE_48568_length_472_cov_50.077748	1	81	2	27	80	0.3375000
NODE_48568_length_472_cov_50.077748	1	81	0	18	80	0.2250000
NODE_48568_length_472_cov_50.077748	1	81	1	35	80	0.4375000
NODE_48568_length_472_cov_50.077748	1	81	2	27	80	0.3375000
NODE_48568_length_472_cov_50.077748	1	81	0	18	80	0.2250000
NODE_48568_length_472_cov_50.077748	1	81	1	35	80	0.4375000
NODE_48568_length_472_cov_50.077748	1	81	2	27	80	0.3375000
NODE_48568_length_472_cov_50.077748	1	81	0	18	80	0.2250000
NODE_48568_length_472_cov_50.077748	1	81	1	35	80	0.4375000
NODE_48568_length_472_cov_50.077748	1	81	2	27	80	0.3375000
NODE_48568_length_472_cov_50.077748	1	81	0	18	80	0.2250000
NODE_48568_length_472_cov_50.077748	1	81	1	35	80	0.4375000
NODE_48568_length_472_cov_50.077748	1	81	2	27	80	0.3375000
NODE_48568_length_472_cov_50.077748	10	81	0	9	71	0.1267606
NODE_48568_length_472_cov_50.077748	10	81	1	35	71	0.4929577
NODE_48568_length_472_cov_50.077748	10	81	2	27	71	0.3802817
NODE_48568_length_472_cov_50.077748	54	131	2	74	77	0.9610389
NODE_48568_length_472_cov_50.077748	54	131	3	3	77	0.0389610
NODE_48568_length_472_cov_50.077748	54	131	2	74	77	0.9610389
NODE_48568_length_472_cov_50.077748	54	131	3	3	77	0.0389610
NODE_48568_length_472_cov_50.077748	54	131	2	74	77	0.9610389
NODE_48568_length_472_cov_50.077748	54	131	3	3	77	0.0389610
NODE_48568_length_472_cov_50.077748	130	204	2	35	74	0.4729730
NODE_48568_length_472_cov_50.077748	130	204	3	39	74	0.5270270
NODE_48569_length_472_cov_10.469169	294	374	4	80	80	1.0000000
NODE_48569_length_472_cov_10.469169	347	427	0	33	80	0.4125000
NODE_48569_length_472_cov_10.469169	347	427	3	2	80	0.0250000
NODE_48569_length_472_cov_10.469169	347	427	4	45	80	0.5625000
NODE_48570_length_472_cov_10.195710	143	223	0	80	80	1.0000000
NODE_48570_length_472_cov_10.195710	196	276	0	80	80	1.0000000
NODE_48593_length_472_cov_4.375335	165	245	0	52	80	0.6500000
NODE_48593_length_472_cov_4.375335	165	245	2	28	80	0.3500000
NODE_48593_length_472_cov_4.375335	218	251	2	33	33	1.0000000
NODE_48614_length_472_cov_3.495979	305	349	0	44	44	1.0000000
NODE_48620_length_472_cov_3.093834	220	295	0	75	75	1.0000000
NODE_48638_length_472_cov_2.592493	431	471	0	40	40	1.0000000
NODE_48745_length_472_cov_1.294906	43	98	0	55	55	1.0000000
NODE_48745_length_472_cov_1.294906	71	151	0	80	80	1.0000000
NODE_48768_length_472_cov_1.211796	106	126	0	20	20	1.0000000
NODE_48873_length_471_cov_39.319892	119	193	1	19	74	0.2567568
NODE_48873_length_471_cov_39.319892	119	193	2	54	74	0.7297297
NODE_48873_length_471_cov_39.319892	119	193	3	1	74	0.0135135
NODE_48874_length_471_cov_24.279570	185	265	3	6	80	0.0750000
NODE_48874_length_471_cov_24.279570	185	265	4	5	80	0.0625000
NODE_48874_length_471_cov_24.279570	185	265	6	7	80	0.0875000
NODE_48874_length_471_cov_24.279570	185	265	7	62	80	0.7750000
NODE_48874_length_471_cov_24.279570	238	318	4	22	80	0.2750000
NODE_48874_length_471_cov_24.279570	238	318	5	27	80	0.3375000
NODE_48874_length_471_cov_24.279570	238	318	7	31	80	0.3875000
NODE_48875_length_471_cov_19.669355	83	163	0	80	80	1.0000000
NODE_48875_length_471_cov_19.669355	136	216	0	80	80	1.0000000
NODE_48876_length_471_cov_14.387097	198	278	0	80	80	1.0000000
NODE_48876_length_471_cov_14.387097	251	331	0	80	80	1.0000000
NODE_48881_length_471_cov_6.948925	186	213	0	27	27	1.0000000
NODE_48881_length_471_cov_6.948925	204	284	0	80	80	1.0000000
NODE_48881_length_471_cov_6.948925	244	275	0	31	31	1.0000000
NODE_48881_length_471_cov_6.948925	257	337	0	80	80	1.0000000
NODE_48881_length_471_cov_6.948925	268	337	0	69	69	1.0000000
NODE_48902_length_471_cov_3.803763	83	162	0	79	79	1.0000000
NODE_48902_length_471_cov_3.803763	135	215	0	80	80	1.0000000
NODE_48924_length_471_cov_2.954301	284	315	1	3	31	0.0967742
NODE_48924_length_471_cov_2.954301	284	315	2	28	31	0.9032258
NODE_48957_length_471_cov_2.287634	133	200	0	67	67	1.0000000
NODE_49186_length_470_cov_57.078167	184	264	2	24	80	0.3000000
NODE_49186_length_470_cov_57.078167	184	264	4	26	80	0.3250000
NODE_49186_length_470_cov_57.078167	184	264	5	30	80	0.3750000
NODE_49186_length_470_cov_57.078167	237	317	2	20	80	0.2500000
NODE_49186_length_470_cov_57.078167	237	317	4	60	80	0.7500000
NODE_49186_length_470_cov_57.078167	313	393	3	71	80	0.8875000
NODE_49186_length_470_cov_57.078167	313	393	4	9	80	0.1125000
NODE_49186_length_470_cov_57.078167	366	446	0	39	80	0.4875000
NODE_49186_length_470_cov_57.078167	366	446	3	39	80	0.4875000
NODE_49186_length_470_cov_57.078167	366	446	4	2	80	0.0250000
NODE_49187_length_470_cov_34.035040	228	308	0	80	80	1.0000000
NODE_49187_length_470_cov_34.035040	281	361	0	80	80	1.0000000
NODE_49187_length_470_cov_34.035040	357	437	0	80	80	1.0000000
NODE_49187_length_470_cov_34.035040	410	470	0	60	60	1.0000000
NODE_49188_length_470_cov_15.539084	142	222	2	80	80	1.0000000
NODE_49188_length_470_cov_15.539084	195	275	1	48	80	0.6000000
NODE_49188_length_470_cov_15.539084	195	275	2	32	80	0.4000000
NODE_49193_length_470_cov_6.070081	272	330	10	21	58	0.3620690
NODE_49193_length_470_cov_6.070081	272	330	11	3	58	0.0517241
NODE_49193_length_470_cov_6.070081	272	330	13	1	58	0.0172414
NODE_49193_length_470_cov_6.070081	272	330	14	30	58	0.5172414
NODE_49193_length_470_cov_6.070081	272	330	15	3	58	0.0517241
NODE_49193_length_470_cov_6.070081	325	383	1	1	58	0.0172414
NODE_49193_length_470_cov_6.070081	325	383	3	7	58	0.1206897
NODE_49193_length_470_cov_6.070081	325	383	5	2	58	0.0344828
NODE_49193_length_470_cov_6.070081	325	383	6	20	58	0.3448276
NODE_49193_length_470_cov_6.070081	325	383	8	8	58	0.1379310
NODE_49193_length_470_cov_6.070081	325	383	9	12	58	0.2068966
NODE_49193_length_470_cov_6.070081	325	383	10	8	58	0.1379310
NODE_49215_length_470_cov_3.735849	194	251	4	9	57	0.1578947
NODE_49215_length_470_cov_3.735849	194	251	5	48	57	0.8421053
NODE_49260_length_470_cov_2.363881	403	422	0	19	19	1.0000000
NODE_49260_length_470_cov_2.363881	403	422	0	19	19	1.0000000
NODE_49389_length_470_cov_1.142857	414	470	0	56	56	1.0000000
NODE_49502_length_469_cov_221.024324	150	228	45	2	78	0.0256410
NODE_49502_length_469_cov_221.024324	150	228	46	2	78	0.0256410
NODE_49502_length_469_cov_221.024324	150	228	47	7	78	0.0897436
NODE_49502_length_469_cov_221.024324	150	228	48	6	78	0.0769231
NODE_49502_length_469_cov_221.024324	150	228	49	13	78	0.1666667
NODE_49502_length_469_cov_221.024324	150	228	50	6	78	0.0769231
NODE_49502_length_469_cov_221.024324	150	228	51	21	78	0.2692308
NODE_49502_length_469_cov_221.024324	150	228	52	4	78	0.0512821
NODE_49502_length_469_cov_221.024324	150	228	53	1	78	0.0128205
NODE_49502_length_469_cov_221.024324	150	228	54	16	78	0.2051282
NODE_49502_length_469_cov_221.024324	150	228	45	2	78	0.0256410
NODE_49502_length_469_cov_221.024324	150	228	46	2	78	0.0256410
NODE_49502_length_469_cov_221.024324	150	228	47	7	78	0.0897436
NODE_49502_length_469_cov_221.024324	150	228	48	6	78	0.0769231
NODE_49502_length_469_cov_221.024324	150	228	49	13	78	0.1666667
NODE_49502_length_469_cov_221.024324	150	228	50	6	78	0.0769231
NODE_49502_length_469_cov_221.024324	150	228	51	21	78	0.2692308
NODE_49502_length_469_cov_221.024324	150	228	52	4	78	0.0512821
NODE_49502_length_469_cov_221.024324	150	228	53	1	78	0.0128205
NODE_49502_length_469_cov_221.024324	150	228	54	16	78	0.2051282
NODE_49502_length_469_cov_221.024324	150	219	45	2	69	0.0289855
NODE_49502_length_469_cov_221.024324	150	219	46	2	69	0.0289855
NODE_49502_length_469_cov_221.024324	150	219	47	7	69	0.1014493
NODE_49502_length_469_cov_221.024324	150	219	48	6	69	0.0869565
NODE_49502_length_469_cov_221.024324	150	219	49	4	69	0.0579710
NODE_49502_length_469_cov_221.024324	150	219	50	6	69	0.0869565
NODE_49502_length_469_cov_221.024324	150	219	51	21	69	0.3043478
NODE_49502_length_469_cov_221.024324	150	219	52	4	69	0.0579710
NODE_49502_length_469_cov_221.024324	150	219	53	1	69	0.0144928
NODE_49502_length_469_cov_221.024324	150	219	54	16	69	0.2318841
NODE_49557_length_469_cov_2.686486	263	343	0	80	80	1.0000000
NODE_49561_length_469_cov_2.521622	237	289	0	52	52	1.0000000
NODE_49579_length_469_cov_2.224324	279	331	0	52	52	1.0000000
NODE_49796_length_468_cov_8.043360	190	250	0	10	60	0.1666667
NODE_49796_length_468_cov_8.043360	190	250	1	49	60	0.8166667
NODE_49796_length_468_cov_8.043360	190	250	2	1	60	0.0166667
NODE_49796_length_468_cov_8.043360	223	303	0	63	80	0.7875000
NODE_49796_length_468_cov_8.043360	223	303	1	17	80	0.2125000
NODE_49800_length_468_cov_6.046070	152	232	0	80	80	1.0000000
NODE_49800_length_468_cov_6.046070	205	285	0	80	80	1.0000000
NODE_49801_length_468_cov_5.997290	81	161	0	80	80	1.0000000
NODE_49801_length_468_cov_5.997290	134	214	0	80	80	1.0000000
NODE_49801_length_468_cov_5.997290	210	270	0	60	60	1.0000000
NODE_49803_length_468_cov_5.872629	133	201	0	68	68	1.0000000
NODE_49807_length_468_cov_5.384824	305	356	0	10	51	0.1960784
NODE_49807_length_468_cov_5.384824	305	356	1	41	51	0.8039216
NODE_49894_length_468_cov_2.067751	45	96	0	51	51	1.0000000
NODE_49913_length_468_cov_1.891599	4	63	0	59	59	1.0000000
NODE_49928_length_468_cov_1.758808	140	218	2	78	78	1.0000000
NODE_49928_length_468_cov_1.758808	191	257	1	6	66	0.0909091
NODE_49928_length_468_cov_1.758808	191	257	2	60	66	0.9090909
NODE_49974_length_468_cov_1.390244	291	310	3	19	19	1.0000000
NODE_49974_length_468_cov_1.390244	369	405	0	36	36	1.0000000
NODE_50133_length_467_cov_14.100543	176	256	0	25	80	0.3125000
NODE_50133_length_467_cov_14.100543	176	256	1	5	80	0.0625000
NODE_50133_length_467_cov_14.100543	176	256	2	50	80	0.6250000
NODE_50134_length_467_cov_11.902174	193	236	0	43	43	1.0000000
NODE_50135_length_467_cov_10.875000	226	306	0	80	80	1.0000000
NODE_50135_length_467_cov_10.875000	279	359	0	80	80	1.0000000
NODE_50144_length_467_cov_6.625000	206	275	0	69	69	1.0000000
NODE_50144_length_467_cov_6.625000	257	328	0	71	71	1.0000000
NODE_50197_length_467_cov_2.709239	247	327	0	80	80	1.0000000
NODE_50215_length_467_cov_2.296196	284	329	0	45	45	1.0000000
NODE_50238_length_467_cov_2.027174	218	269	0	51	51	1.0000000
NODE_50252_length_467_cov_1.836957	55	118	0	63	63	1.0000000
NODE_50267_length_467_cov_1.603261	92	141	0	49	49	1.0000000
NODE_50283_length_467_cov_1.426630	135	183	0	48	48	1.0000000
NODE_50447_length_466_cov_42.839237	0	47	0	47	47	1.0000000
NODE_50447_length_466_cov_42.839237	20	100	0	80	80	1.0000000
NODE_50447_length_466_cov_42.839237	96	176	0	52	80	0.6500000
NODE_50447_length_466_cov_42.839237	96	176	2	28	80	0.3500000
NODE_50447_length_466_cov_42.839237	149	229	2	80	80	1.0000000
NODE_50448_length_466_cov_36.901907	85	165	0	27	80	0.3375000
NODE_50448_length_466_cov_36.901907	85	165	1	16	80	0.2000000
NODE_50448_length_466_cov_36.901907	85	165	2	25	80	0.3125000
NODE_50448_length_466_cov_36.901907	85	165	3	12	80	0.1500000
NODE_50448_length_466_cov_36.901907	138	218	2	15	80	0.1875000
NODE_50448_length_466_cov_36.901907	138	218	3	16	80	0.2000000
NODE_50448_length_466_cov_36.901907	138	218	4	8	80	0.1000000
NODE_50448_length_466_cov_36.901907	138	218	5	6	80	0.0750000
NODE_50448_length_466_cov_36.901907	138	218	6	35	80	0.4375000
NODE_50448_length_466_cov_36.901907	214	294	5	1	80	0.0125000
NODE_50448_length_466_cov_36.901907	214	294	6	66	80	0.8250000
NODE_50448_length_466_cov_36.901907	214	294	7	13	80	0.1625000
NODE_50448_length_466_cov_36.901907	267	347	2	24	80	0.3000000
NODE_50448_length_466_cov_36.901907	267	347	3	6	80	0.0750000
NODE_50448_length_466_cov_36.901907	267	347	4	8	80	0.1000000
NODE_50448_length_466_cov_36.901907	267	347	5	16	80	0.2000000
NODE_50448_length_466_cov_36.901907	267	347	6	22	80	0.2750000
NODE_50448_length_466_cov_36.901907	267	347	7	4	80	0.0500000
NODE_50457_length_466_cov_5.122616	275	316	0	41	41	1.0000000
NODE_50457_length_466_cov_5.122616	276	316	0	40	40	1.0000000
NODE_50457_length_466_cov_5.122616	289	338	0	49	49	1.0000000
NODE_50515_length_466_cov_2.602180	9	90	0	81	81	1.0000000
NODE_50515_length_466_cov_2.602180	312	341	0	29	29	1.0000000
NODE_50549_length_466_cov_2.108992	130	182	3	52	52	1.0000000
NODE_50562_length_466_cov_1.980926	183	265	0	82	82	1.0000000
NODE_50787_length_465_cov_13.019126	170	250	1	21	80	0.2625000
NODE_50787_length_465_cov_13.019126	170	250	2	6	80	0.0750000
NODE_50787_length_465_cov_13.019126	170	250	4	8	80	0.1000000
NODE_50787_length_465_cov_13.019126	170	250	5	24	80	0.3000000
NODE_50787_length_465_cov_13.019126	170	250	7	1	80	0.0125000
NODE_50787_length_465_cov_13.019126	170	250	8	20	80	0.2500000
NODE_50787_length_465_cov_13.019126	223	301	5	6	78	0.0769231
NODE_50787_length_465_cov_13.019126	223	301	7	1	78	0.0128205
NODE_50787_length_465_cov_13.019126	223	301	8	27	78	0.3461539
NODE_50787_length_465_cov_13.019126	223	301	9	32	78	0.4102564
NODE_50787_length_465_cov_13.019126	223	301	11	2	78	0.0256410
NODE_50787_length_465_cov_13.019126	223	301	12	10	78	0.1282051
NODE_50799_length_465_cov_5.363388	316	393	0	77	77	1.0000000
NODE_50800_length_465_cov_4.898907	376	406	0	30	30	1.0000000
NODE_50869_length_465_cov_2.366120	147	227	0	80	80	1.0000000
NODE_50869_length_465_cov_2.366120	200	271	0	71	71	1.0000000
NODE_50911_length_465_cov_1.737705	338	383	0	45	45	1.0000000
NODE_51100_length_464_cov_8.473973	209	289	2	80	80	1.0000000
NODE_51100_length_464_cov_8.473973	262	342	1	48	80	0.6000000
NODE_51100_length_464_cov_8.473973	262	342	2	27	80	0.3375000
NODE_51100_length_464_cov_8.473973	262	342	3	5	80	0.0625000
NODE_51148_length_464_cov_2.528767	136	199	0	63	63	1.0000000
NODE_51167_length_464_cov_2.134247	130	203	0	73	73	1.0000000
NODE_51186_length_464_cov_1.901370	58	138	0	80	80	1.0000000
NODE_51203_length_464_cov_1.706849	186	265	2	79	79	1.0000000
NODE_51377_length_463_cov_64.420330	375	455	1	19	80	0.2375000
NODE_51377_length_463_cov_64.420330	375	455	3	20	80	0.2500000
NODE_51377_length_463_cov_64.420330	375	455	4	1	80	0.0125000
NODE_51377_length_463_cov_64.420330	375	455	5	40	80	0.5000000
NODE_51377_length_463_cov_64.420330	375	455	1	19	80	0.2375000
NODE_51377_length_463_cov_64.420330	375	455	3	20	80	0.2500000
NODE_51377_length_463_cov_64.420330	375	455	4	1	80	0.0125000
NODE_51377_length_463_cov_64.420330	375	455	5	40	80	0.5000000
NODE_51377_length_463_cov_64.420330	375	455	1	19	80	0.2375000
NODE_51377_length_463_cov_64.420330	375	455	3	20	80	0.2500000
NODE_51377_length_463_cov_64.420330	375	455	4	1	80	0.0125000
NODE_51377_length_463_cov_64.420330	375	455	5	40	80	0.5000000
NODE_51377_length_463_cov_64.420330	375	455	1	19	80	0.2375000
NODE_51377_length_463_cov_64.420330	375	455	3	20	80	0.2500000
NODE_51377_length_463_cov_64.420330	375	455	4	1	80	0.0125000
NODE_51377_length_463_cov_64.420330	375	455	5	40	80	0.5000000
NODE_51377_length_463_cov_64.420330	375	455	1	19	80	0.2375000
NODE_51377_length_463_cov_64.420330	375	455	3	20	80	0.2500000
NODE_51377_length_463_cov_64.420330	375	455	4	1	80	0.0125000
NODE_51377_length_463_cov_64.420330	375	455	5	40	80	0.5000000
NODE_51378_length_463_cov_49.673077	0	71	0	71	71	1.0000000
NODE_51378_length_463_cov_49.673077	44	121	0	32	77	0.4155844
NODE_51378_length_463_cov_49.673077	44	121	1	3	77	0.0389610
NODE_51378_length_463_cov_49.673077	44	121	2	42	77	0.5454546
NODE_51379_length_463_cov_41.005495	8	88	0	80	80	1.0000000
NODE_51379_length_463_cov_41.005495	61	141	0	80	80	1.0000000
NODE_51380_length_463_cov_30.626374	318	398	0	5	80	0.0625000
NODE_51380_length_463_cov_30.626374	318	398	1	75	80	0.9375000
NODE_51380_length_463_cov_30.626374	371	451	1	80	80	1.0000000
NODE_51381_length_463_cov_27.475275	211	291	2	80	80	1.0000000
NODE_51381_length_463_cov_27.475275	264	344	0	10	80	0.1250000
NODE_51381_length_463_cov_27.475275	264	344	2	70	80	0.8750000
NODE_51383_length_463_cov_11.211538	304	377	1	25	73	0.3424658
NODE_51383_length_463_cov_11.211538	304	377	2	48	73	0.6575342
NODE_51383_length_463_cov_11.211538	350	430	0	15	80	0.1875000
NODE_51383_length_463_cov_11.211538	350	430	1	63	80	0.7875000
NODE_51383_length_463_cov_11.211538	350	430	2	2	80	0.0250000
NODE_51391_length_463_cov_5.711538	181	261	4	51	80	0.6375000
NODE_51391_length_463_cov_5.711538	181	261	5	29	80	0.3625000
NODE_51391_length_463_cov_5.711538	234	314	4	50	80	0.6250000
NODE_51391_length_463_cov_5.711538	234	314	5	30	80	0.3750000
NODE_51399_length_463_cov_4.398352	119	169	0	50	50	1.0000000
NODE_51402_length_463_cov_4.186813	175	233	0	15	58	0.2586207
NODE_51402_length_463_cov_4.186813	175	233	2	43	58	0.7413793
NODE_51402_length_463_cov_4.186813	206	251	2	45	45	1.0000000
NODE_51408_length_463_cov_3.846154	235	268	0	33	33	1.0000000
NODE_51421_length_463_cov_3.063187	193	248	0	55	55	1.0000000
NODE_51421_length_463_cov_3.063187	222	301	0	79	79	1.0000000
NODE_51680_length_462_cov_21.876033	93	173	2	14	80	0.1750000
NODE_51680_length_462_cov_21.876033	93	173	3	5	80	0.0625000
NODE_51680_length_462_cov_21.876033	93	173	7	10	80	0.1250000
NODE_51680_length_462_cov_21.876033	93	173	8	5	80	0.0625000
NODE_51680_length_462_cov_21.876033	93	173	9	46	80	0.5750000
NODE_51680_length_462_cov_21.876033	146	226	7	5	80	0.0625000
NODE_51680_length_462_cov_21.876033	146	226	8	31	80	0.3875000
NODE_51680_length_462_cov_21.876033	146	226	9	44	80	0.5500000
NODE_51687_length_462_cov_5.033058	93	154	0	61	61	1.0000000
NODE_51687_length_462_cov_5.033058	159	209	0	50	50	1.0000000
NODE_51699_length_462_cov_4.101928	168	246	0	11	78	0.1410256
NODE_51699_length_462_cov_4.101928	168	246	1	37	78	0.4743590
NODE_51699_length_462_cov_4.101928	168	246	3	30	78	0.3846154
NODE_51699_length_462_cov_4.101928	184	208	0	11	24	0.4583333
NODE_51699_length_462_cov_4.101928	184	208	1	13	24	0.5416667
NODE_51699_length_462_cov_4.101928	219	299	3	80	80	1.0000000
NODE_51708_length_462_cov_3.630854	149	194	0	1	45	0.0222222
NODE_51708_length_462_cov_3.630854	149	194	2	44	45	0.9777778
NODE_51720_length_462_cov_3.079890	103	147	0	44	44	1.0000000
NODE_51735_length_462_cov_2.677686	78	118	0	40	40	1.0000000
NODE_51763_length_462_cov_2.209366	18	58	0	40	40	1.0000000
NODE_51817_length_462_cov_1.570248	68	113	0	45	45	1.0000000
NODE_51995_length_461_cov_35.116022	0	79	0	79	79	1.0000000
NODE_51995_length_461_cov_35.116022	52	132	0	80	80	1.0000000
NODE_51996_length_461_cov_11.124309	77	157	8	4	80	0.0500000
NODE_51996_length_461_cov_11.124309	77	157	10	14	80	0.1750000
NODE_51996_length_461_cov_11.124309	77	157	11	23	80	0.2875000
NODE_51996_length_461_cov_11.124309	77	157	12	39	80	0.4875000
NODE_51996_length_461_cov_11.124309	130	210	6	3	80	0.0375000
NODE_51996_length_461_cov_11.124309	130	210	7	26	80	0.3250000
NODE_51996_length_461_cov_11.124309	130	210	8	12	80	0.1500000
NODE_51996_length_461_cov_11.124309	130	210	10	8	80	0.1000000
NODE_51996_length_461_cov_11.124309	130	210	12	31	80	0.3875000
NODE_52010_length_461_cov_5.361878	246	322	1	15	76	0.1973684
NODE_52010_length_461_cov_5.361878	246	322	2	61	76	0.8026316
NODE_52018_length_461_cov_4.472376	268	333	0	65	65	1.0000000
NODE_52021_length_461_cov_4.168508	159	234	0	75	75	1.0000000
NODE_52047_length_461_cov_2.892265	233	312	0	79	79	1.0000000
NODE_52073_length_461_cov_2.392265	186	223	0	37	37	1.0000000
NODE_52154_length_461_cov_1.389503	283	349	0	66	66	1.0000000
NODE_52292_length_460_cov_172.986150	0	68	7	3	68	0.0441176
NODE_52292_length_460_cov_172.986150	0	68	8	10	68	0.1470588
NODE_52292_length_460_cov_172.986150	0	68	13	2	68	0.0294118
NODE_52292_length_460_cov_172.986150	0	68	14	9	68	0.1323529
NODE_52292_length_460_cov_172.986150	0	68	15	1	68	0.0147059
NODE_52292_length_460_cov_172.986150	0	68	17	2	68	0.0294118
NODE_52292_length_460_cov_172.986150	0	68	18	5	68	0.0735294
NODE_52292_length_460_cov_172.986150	0	68	21	10	68	0.1470588
NODE_52292_length_460_cov_172.986150	0	68	23	5	68	0.0735294
NODE_52292_length_460_cov_172.986150	0	68	27	8	68	0.1176471
NODE_52292_length_460_cov_172.986150	0	68	28	13	68	0.1911765
NODE_52292_length_460_cov_172.986150	41	121	21	1	80	0.0125000
NODE_52292_length_460_cov_172.986150	41	121	23	5	80	0.0625000
NODE_52292_length_460_cov_172.986150	41	121	27	8	80	0.1000000
NODE_52292_length_460_cov_172.986150	41	121	28	24	80	0.3000000
NODE_52292_length_460_cov_172.986150	41	121	29	1	80	0.0125000
NODE_52292_length_460_cov_172.986150	41	121	30	6	80	0.0750000
NODE_52292_length_460_cov_172.986150	41	121	31	2	80	0.0250000
NODE_52292_length_460_cov_172.986150	41	121	33	3	80	0.0375000
NODE_52292_length_460_cov_172.986150	41	121	36	5	80	0.0625000
NODE_52292_length_460_cov_172.986150	41	121	37	3	80	0.0375000
NODE_52292_length_460_cov_172.986150	41	121	39	1	80	0.0125000
NODE_52292_length_460_cov_172.986150	41	121	43	4	80	0.0500000
NODE_52292_length_460_cov_172.986150	41	121	44	3	80	0.0375000
NODE_52292_length_460_cov_172.986150	41	121	45	5	80	0.0625000
NODE_52292_length_460_cov_172.986150	41	121	46	3	80	0.0375000
NODE_52292_length_460_cov_172.986150	41	121	47	3	80	0.0375000
NODE_52292_length_460_cov_172.986150	41	121	48	3	80	0.0375000
NODE_52293_length_460_cov_62.512465	9	48	1	8	39	0.2051282
NODE_52293_length_460_cov_62.512465	9	48	3	31	39	0.7948718
NODE_52294_length_460_cov_33.146814	0	47	3	47	47	1.0000000
NODE_52294_length_460_cov_33.146814	43	115	3	7	72	0.0972222
NODE_52294_length_460_cov_33.146814	43	115	4	65	72	0.9027778
NODE_52294_length_460_cov_33.146814	96	165	3	20	69	0.2898551
NODE_52294_length_460_cov_33.146814	96	165	4	27	69	0.3913043
NODE_52294_length_460_cov_33.146814	96	165	5	12	69	0.1739130
NODE_52294_length_460_cov_33.146814	96	165	6	10	69	0.1449275
NODE_52295_length_460_cov_26.049861	0	63	0	50	63	0.7936508
NODE_52295_length_460_cov_26.049861	0	63	2	7	63	0.1111111
NODE_52295_length_460_cov_26.049861	0	63	3	6	63	0.0952381
NODE_52296_length_460_cov_25.709141	246	326	0	80	80	1.0000000
NODE_52296_length_460_cov_25.709141	299	379	0	80	80	1.0000000
NODE_52297_length_460_cov_11.063712	273	353	2	1	80	0.0125000
NODE_52297_length_460_cov_11.063712	273	353	4	79	80	0.9875000
NODE_52297_length_460_cov_11.063712	326	406	2	10	80	0.1250000
NODE_52297_length_460_cov_11.063712	326	406	4	70	80	0.8750000
NODE_52303_length_460_cov_7.285319	172	250	0	78	78	1.0000000
NODE_52312_length_460_cov_5.163435	120	200	3	80	80	1.0000000
NODE_52312_length_460_cov_5.163435	173	253	1	2	80	0.0250000
NODE_52312_length_460_cov_5.163435	173	253	3	27	80	0.3375000
NODE_52312_length_460_cov_5.163435	173	253	4	51	80	0.6375000
NODE_52333_length_460_cov_3.457064	150	230	0	4	80	0.0500000
NODE_52333_length_460_cov_3.457064	150	230	1	76	80	0.9500000
NODE_52333_length_460_cov_3.457064	203	246	1	43	43	1.0000000
NODE_52339_length_460_cov_3.027701	167	230	0	63	63	1.0000000
NODE_52347_length_460_cov_2.819945	195	266	0	35	71	0.4929577
NODE_52347_length_460_cov_2.819945	195	266	2	36	71	0.5070422
NODE_52358_length_460_cov_2.626039	223	277	0	54	54	1.0000000
NODE_52612_length_459_cov_34.927778	165	239	1	15	74	0.2027027
NODE_52612_length_459_cov_34.927778	165	239	3	59	74	0.7972973
NODE_52612_length_459_cov_34.927778	212	292	1	8	80	0.1000000
NODE_52612_length_459_cov_34.927778	212	292	3	72	80	0.9000000
NODE_52617_length_459_cov_7.261111	143	189	1	46	46	1.0000000
NODE_52617_length_459_cov_7.261111	162	242	1	32	80	0.4000000
NODE_52617_length_459_cov_7.261111	162	242	2	48	80	0.6000000
NODE_52635_length_459_cov_4.127778	153	233	0	80	80	1.0000000
NODE_52685_length_459_cov_2.158333	219	285	0	15	66	0.2272727
NODE_52685_length_459_cov_2.158333	219	285	1	51	66	0.7727273
NODE_52685_length_459_cov_2.158333	283	342	1	59	59	1.0000000
NODE_52704_length_459_cov_1.722222	280	353	0	73	73	1.0000000
NODE_52920_length_458_cov_71.047354	0	51	11	14	51	0.2745098
NODE_52920_length_458_cov_71.047354	0	51	12	3	51	0.0588235
NODE_52920_length_458_cov_71.047354	0	51	13	2	51	0.0392157
NODE_52920_length_458_cov_71.047354	0	51	15	1	51	0.0196078
NODE_52920_length_458_cov_71.047354	0	51	16	2	51	0.0392157
NODE_52920_length_458_cov_71.047354	0	51	17	8	51	0.1568628
NODE_52920_length_458_cov_71.047354	0	51	19	20	51	0.3921569
NODE_52920_length_458_cov_71.047354	0	51	20	1	51	0.0196078
NODE_52920_length_458_cov_71.047354	24	104	17	6	80	0.0750000
NODE_52920_length_458_cov_71.047354	24	104	19	20	80	0.2500000
NODE_52920_length_458_cov_71.047354	24	104	20	2	80	0.0250000
NODE_52920_length_458_cov_71.047354	24	104	21	23	80	0.2875000
NODE_52920_length_458_cov_71.047354	24	104	23	10	80	0.1250000
NODE_52920_length_458_cov_71.047354	24	104	24	1	80	0.0125000
NODE_52920_length_458_cov_71.047354	24	104	27	3	80	0.0375000
NODE_52920_length_458_cov_71.047354	24	104	28	7	80	0.0875000
NODE_52920_length_458_cov_71.047354	24	104	30	8	80	0.1000000
NODE_52920_length_458_cov_71.047354	100	180	27	9	80	0.1125000
NODE_52920_length_458_cov_71.047354	100	180	28	11	80	0.1375000
NODE_52920_length_458_cov_71.047354	100	180	29	11	80	0.1375000
NODE_52920_length_458_cov_71.047354	100	180	30	11	80	0.1375000
NODE_52920_length_458_cov_71.047354	100	180	31	6	80	0.0750000
NODE_52920_length_458_cov_71.047354	100	180	32	4	80	0.0500000
NODE_52920_length_458_cov_71.047354	100	180	33	19	80	0.2375000
NODE_52920_length_458_cov_71.047354	100	180	34	9	80	0.1125000
NODE_52920_length_458_cov_71.047354	153	233	28	8	80	0.1000000
NODE_52920_length_458_cov_71.047354	153	233	29	10	80	0.1250000
NODE_52920_length_458_cov_71.047354	153	233	30	4	80	0.0500000
NODE_52920_length_458_cov_71.047354	153	233	32	1	80	0.0125000
NODE_52920_length_458_cov_71.047354	153	233	33	4	80	0.0500000
NODE_52920_length_458_cov_71.047354	153	233	34	6	80	0.0750000
NODE_52920_length_458_cov_71.047354	153	233	35	5	80	0.0625000
NODE_52920_length_458_cov_71.047354	153	233	36	2	80	0.0250000
NODE_52920_length_458_cov_71.047354	153	233	37	7	80	0.0875000
NODE_52920_length_458_cov_71.047354	153	233	38	6	80	0.0750000
NODE_52920_length_458_cov_71.047354	153	233	39	1	80	0.0125000
NODE_52920_length_458_cov_71.047354	153	233	40	9	80	0.1125000
NODE_52920_length_458_cov_71.047354	153	233	41	17	80	0.2125000
NODE_52921_length_458_cov_47.966574	151	231	1	11	80	0.1375000
NODE_52921_length_458_cov_47.966574	151	231	2	45	80	0.5625000
NODE_52921_length_458_cov_47.966574	151	231	3	4	80	0.0500000
NODE_52921_length_458_cov_47.966574	151	231	4	15	80	0.1875000
NODE_52921_length_458_cov_47.966574	151	231	5	5	80	0.0625000
NODE_52921_length_458_cov_47.966574	204	284	2	3	80	0.0375000
NODE_52921_length_458_cov_47.966574	204	284	3	4	80	0.0500000
NODE_52921_length_458_cov_47.966574	204	284	4	15	80	0.1875000
NODE_52921_length_458_cov_47.966574	204	284	5	35	80	0.4375000
NODE_52921_length_458_cov_47.966574	204	284	6	7	80	0.0875000
NODE_52921_length_458_cov_47.966574	204	284	7	16	80	0.2000000
NODE_52921_length_458_cov_47.966574	280	360	7	8	80	0.1000000
NODE_52921_length_458_cov_47.966574	280	360	8	1	80	0.0125000
NODE_52921_length_458_cov_47.966574	280	360	9	21	80	0.2625000
NODE_52921_length_458_cov_47.966574	280	360	10	50	80	0.6250000
NODE_52921_length_458_cov_47.966574	333	413	4	2	80	0.0250000
NODE_52921_length_458_cov_47.966574	333	413	5	4	80	0.0500000
NODE_52921_length_458_cov_47.966574	333	413	7	31	80	0.3875000
NODE_52921_length_458_cov_47.966574	333	413	8	15	80	0.1875000
NODE_52921_length_458_cov_47.966574	333	413	9	4	80	0.0500000
NODE_52921_length_458_cov_47.966574	333	413	10	24	80	0.3000000
NODE_52924_length_458_cov_9.935933	267	347	5	9	80	0.1125000
NODE_52924_length_458_cov_9.935933	267	347	6	5	80	0.0625000
NODE_52924_length_458_cov_9.935933	267	347	7	18	80	0.2250000
NODE_52924_length_458_cov_9.935933	267	347	8	48	80	0.6000000
NODE_52924_length_458_cov_9.935933	320	400	4	6	80	0.0750000
NODE_52924_length_458_cov_9.935933	320	400	5	30	80	0.3750000
NODE_52924_length_458_cov_9.935933	320	400	6	21	80	0.2625000
NODE_52924_length_458_cov_9.935933	320	400	7	2	80	0.0250000
NODE_52924_length_458_cov_9.935933	320	400	8	21	80	0.2625000
NODE_52929_length_458_cov_7.598886	87	167	2	80	80	1.0000000
NODE_52967_length_458_cov_3.061281	62	91	0	29	29	1.0000000
NODE_52967_length_458_cov_3.061281	185	224	0	39	39	1.0000000
NODE_52992_length_458_cov_2.454039	210	251	0	41	41	1.0000000
NODE_53107_length_458_cov_1.139276	242	289	0	47	47	1.0000000
NODE_53107_length_458_cov_1.139276	262	328	0	66	66	1.0000000
NODE_53205_length_457_cov_20.754190	123	203	7	2	80	0.0250000
NODE_53205_length_457_cov_20.754190	123	203	8	39	80	0.4875000
NODE_53205_length_457_cov_20.754190	123	203	9	25	80	0.3125000
NODE_53205_length_457_cov_20.754190	123	203	10	14	80	0.1750000
NODE_53205_length_457_cov_20.754190	176	256	8	43	80	0.5375000
NODE_53205_length_457_cov_20.754190	176	256	9	16	80	0.2000000
NODE_53205_length_457_cov_20.754190	176	256	10	21	80	0.2625000
NODE_53207_length_457_cov_13.918994	218	298	0	80	80	1.0000000
NODE_53207_length_457_cov_13.918994	218	298	0	80	80	1.0000000
NODE_53207_length_457_cov_13.918994	218	298	0	80	80	1.0000000
NODE_53207_length_457_cov_13.918994	218	298	0	80	80	1.0000000
NODE_53207_length_457_cov_13.918994	271	320	0	49	49	1.0000000
NODE_53207_length_457_cov_13.918994	271	320	0	49	49	1.0000000
NODE_53207_length_457_cov_13.918994	271	320	0	49	49	1.0000000
NODE_53216_length_457_cov_6.050279	264	326	0	62	62	1.0000000
NODE_53220_length_457_cov_5.078212	71	149	0	78	78	1.0000000
NODE_53220_length_457_cov_5.078212	122	202	0	46	80	0.5750000
NODE_53220_length_457_cov_5.078212	122	202	1	34	80	0.4250000
NODE_53225_length_457_cov_4.530726	193	273	0	80	80	1.0000000
NODE_53225_length_457_cov_4.530726	246	315	0	69	69	1.0000000
NODE_53230_length_457_cov_3.986034	192	272	4	52	80	0.6500000
NODE_53230_length_457_cov_3.986034	192	272	5	1	80	0.0125000
NODE_53230_length_457_cov_3.986034	192	272	7	24	80	0.3000000
NODE_53230_length_457_cov_3.986034	192	272	8	3	80	0.0375000
NODE_53267_length_457_cov_2.636872	117	197	0	23	80	0.2875000
NODE_53267_length_457_cov_2.636872	117	197	1	57	80	0.7125000
NODE_53462_length_457_cov_0.916201	108	188	0	80	80	1.0000000
NODE_53462_length_457_cov_0.916201	108	188	0	80	80	1.0000000
NODE_53462_length_457_cov_0.916201	161	241	0	80	80	1.0000000
NODE_53462_length_457_cov_0.916201	161	241	0	80	80	1.0000000
NODE_53512_length_456_cov_34.731092	0	63	0	63	63	1.0000000
NODE_53512_length_456_cov_34.731092	36	116	0	80	80	1.0000000
NODE_53512_length_456_cov_34.731092	112	194	0	82	82	1.0000000
NODE_53532_length_456_cov_4.582633	269	349	0	80	80	1.0000000
NODE_53533_length_456_cov_4.554622	124	206	0	13	82	0.1585366
NODE_53533_length_456_cov_4.554622	124	206	1	6	82	0.0731707
NODE_53533_length_456_cov_4.554622	124	206	2	63	82	0.7682927
NODE_53533_length_456_cov_4.554622	179	263	2	84	84	1.0000000
NODE_53546_length_456_cov_3.669468	123	186	0	63	63	1.0000000
NODE_53566_length_456_cov_2.921569	302	362	0	60	60	1.0000000
NODE_53859_length_455_cov_113.589888	137	220	7	24	83	0.2891566
NODE_53859_length_455_cov_113.589888	137	220	8	22	83	0.2650602
NODE_53859_length_455_cov_113.589888	137	220	11	28	83	0.3373494
NODE_53859_length_455_cov_113.589888	137	220	12	5	83	0.0602410
NODE_53859_length_455_cov_113.589888	137	220	13	4	83	0.0481928
NODE_53859_length_455_cov_113.589888	198	268	11	13	70	0.1857143
NODE_53859_length_455_cov_113.589888	198	268	12	14	70	0.2000000
NODE_53859_length_455_cov_113.589888	198	268	13	5	70	0.0714286
NODE_53859_length_455_cov_113.589888	198	268	14	1	70	0.0142857
NODE_53859_length_455_cov_113.589888	198	268	16	34	70	0.4857143
NODE_53859_length_455_cov_113.589888	198	268	17	2	70	0.0285714
NODE_53859_length_455_cov_113.589888	198	268	18	1	70	0.0142857
NODE_53859_length_455_cov_113.589888	269	348	14	16	79	0.2025317
NODE_53859_length_455_cov_113.589888	269	348	15	7	79	0.0886076
NODE_53859_length_455_cov_113.589888	269	348	16	24	79	0.3037975
NODE_53859_length_455_cov_113.589888	269	348	17	4	79	0.0506329
NODE_53859_length_455_cov_113.589888	269	348	18	5	79	0.0632911
NODE_53859_length_455_cov_113.589888	269	348	19	15	79	0.1898734
NODE_53859_length_455_cov_113.589888	269	348	20	8	79	0.1012658
NODE_53859_length_455_cov_113.589888	321	401	6	19	80	0.2375000
NODE_53859_length_455_cov_113.589888	321	401	8	1	80	0.0125000
NODE_53859_length_455_cov_113.589888	321	401	12	2	80	0.0250000
NODE_53859_length_455_cov_113.589888	321	401	14	18	80	0.2250000
NODE_53859_length_455_cov_113.589888	321	401	16	28	80	0.3500000
NODE_53859_length_455_cov_113.589888	321	401	19	12	80	0.1500000
NODE_53860_length_455_cov_52.941011	260	340	8	80	80	1.0000000
NODE_53860_length_455_cov_52.941011	313	393	2	15	80	0.1875000
NODE_53860_length_455_cov_52.941011	313	393	3	3	80	0.0375000
NODE_53860_length_455_cov_52.941011	313	393	4	10	80	0.1250000
NODE_53860_length_455_cov_52.941011	313	393	5	4	80	0.0500000
NODE_53860_length_455_cov_52.941011	313	393	6	16	80	0.2000000
NODE_53860_length_455_cov_52.941011	313	393	8	32	80	0.4000000
NODE_53863_length_455_cov_8.584270	250	302	0	52	52	1.0000000
NODE_53863_length_455_cov_8.584270	275	355	0	80	80	1.0000000
NODE_53864_length_455_cov_8.084270	146	226	0	80	80	1.0000000
NODE_53864_length_455_cov_8.084270	199	279	0	80	80	1.0000000
NODE_53870_length_455_cov_6.022472	122	203	2	81	81	1.0000000
NODE_53872_length_455_cov_5.140449	181	232	1	51	51	1.0000000
NODE_54512_length_453_cov_29.528249	44	124	0	80	80	1.0000000
NODE_54512_length_453_cov_29.528249	97	177	0	80	80	1.0000000
NODE_54512_length_453_cov_29.528249	173	253	0	80	80	1.0000000
NODE_54512_length_453_cov_29.528249	226	301	0	75	75	1.0000000
NODE_54513_length_453_cov_11.146893	95	140	3	45	45	1.0000000
NODE_54513_length_453_cov_11.146893	146	220	2	22	74	0.2972973
NODE_54513_length_453_cov_11.146893	146	220	3	15	74	0.2027027
NODE_54513_length_453_cov_11.146893	146	220	4	37	74	0.5000000
NODE_54517_length_453_cov_7.709040	194	252	5	58	58	1.0000000
NODE_54518_length_453_cov_7.440678	250	319	0	69	69	1.0000000
NODE_54533_length_453_cov_4.282486	190	270	0	80	80	1.0000000
NODE_54533_length_453_cov_4.282486	243	283	0	40	40	1.0000000
NODE_54566_length_453_cov_2.836158	186	266	4	80	80	1.0000000
NODE_54566_length_453_cov_2.836158	239	319	0	5	80	0.0625000
NODE_54566_length_453_cov_2.836158	239	319	1	4	80	0.0500000
NODE_54566_length_453_cov_2.836158	239	319	2	7	80	0.0875000
NODE_54566_length_453_cov_2.836158	239	319	3	25	80	0.3125000
NODE_54566_length_453_cov_2.836158	239	319	4	39	80	0.4875000
NODE_54592_length_453_cov_2.048023	139	174	1	18	35	0.5142857
NODE_54592_length_453_cov_2.048023	139	174	2	17	35	0.4857143
NODE_54600_length_453_cov_2.002825	78	98	0	20	20	1.0000000
NODE_54767_length_453_cov_0.774011	174	195	0	21	21	1.0000000
NODE_54822_length_452_cov_36.028329	0	72	0	72	72	1.0000000
NODE_54822_length_452_cov_36.028329	0	72	0	72	72	1.0000000
NODE_54822_length_452_cov_36.028329	45	99	0	54	54	1.0000000
NODE_54822_length_452_cov_36.028329	45	125	0	80	80	1.0000000
NODE_54823_length_452_cov_17.424929	29	109	0	80	80	1.0000000
NODE_54823_length_452_cov_17.424929	82	162	0	80	80	1.0000000
NODE_54844_length_452_cov_4.317280	141	200	0	59	59	1.0000000
NODE_54886_length_452_cov_2.634561	262	338	0	76	76	1.0000000
NODE_55146_length_451_cov_37.090909	230	310	11	11	80	0.1375000
NODE_55146_length_451_cov_37.090909	230	310	15	42	80	0.5250000
NODE_55146_length_451_cov_37.090909	230	310	17	3	80	0.0375000
NODE_55146_length_451_cov_37.090909	230	310	19	1	80	0.0125000
NODE_55146_length_451_cov_37.090909	230	310	20	23	80	0.2875000
NODE_55146_length_451_cov_37.090909	283	363	9	29	80	0.3625000
NODE_55146_length_451_cov_37.090909	283	363	12	11	80	0.1375000
NODE_55146_length_451_cov_37.090909	283	363	13	9	80	0.1125000
NODE_55146_length_451_cov_37.090909	283	363	17	7	80	0.0875000
NODE_55146_length_451_cov_37.090909	283	363	19	1	80	0.0125000
NODE_55146_length_451_cov_37.090909	283	363	20	23	80	0.2875000
NODE_55147_length_451_cov_16.517045	205	286	0	81	81	1.0000000
NODE_55147_length_451_cov_16.517045	259	339	0	80	80	1.0000000
NODE_55148_length_451_cov_13.153409	182	262	9	54	80	0.6750000
NODE_55148_length_451_cov_13.153409	182	262	10	7	80	0.0875000
NODE_55148_length_451_cov_13.153409	182	262	11	1	80	0.0125000
NODE_55148_length_451_cov_13.153409	182	262	12	18	80	0.2250000
NODE_55148_length_451_cov_13.153409	235	315	9	49	80	0.6125000
NODE_55148_length_451_cov_13.153409	235	315	10	28	80	0.3500000
NODE_55148_length_451_cov_13.153409	235	315	12	3	80	0.0375000
NODE_55149_length_451_cov_11.926136	141	221	6	7	80	0.0875000
NODE_55149_length_451_cov_11.926136	141	221	7	31	80	0.3875000
NODE_55149_length_451_cov_11.926136	141	221	8	31	80	0.3875000
NODE_55149_length_451_cov_11.926136	141	221	9	7	80	0.0875000
NODE_55149_length_451_cov_11.926136	141	221	10	3	80	0.0375000
NODE_55149_length_451_cov_11.926136	141	221	12	1	80	0.0125000
NODE_55149_length_451_cov_11.926136	331	411	0	4	80	0.0500000
NODE_55149_length_451_cov_11.926136	331	411	2	37	80	0.4625000
NODE_55149_length_451_cov_11.926136	331	411	5	10	80	0.1250000
NODE_55149_length_451_cov_11.926136	331	411	6	29	80	0.3625000
NODE_55154_length_451_cov_7.102273	81	143	0	62	62	1.0000000
NODE_55161_length_451_cov_5.610795	1	31	0	30	30	1.0000000
NODE_55161_length_451_cov_5.610795	60	90	0	30	30	1.0000000
NODE_55166_length_451_cov_5.065341	219	285	0	66	66	1.0000000
NODE_55166_length_451_cov_5.065341	272	322	0	50	50	1.0000000
NODE_55184_length_451_cov_3.696023	253	332	0	35	79	0.4430380
NODE_55184_length_451_cov_3.696023	253	332	1	44	79	0.5569620
NODE_55188_length_451_cov_3.406250	176	247	0	71	71	1.0000000
NODE_55188_length_451_cov_3.406250	220	300	0	80	80	1.0000000
NODE_55198_length_451_cov_3.025568	72	148	0	76	76	1.0000000
NODE_55213_length_451_cov_2.607955	84	143	1	56	59	0.9491525
NODE_55213_length_451_cov_2.607955	84	143	2	3	59	0.0508475
NODE_55213_length_451_cov_2.607955	257	326	0	36	69	0.5217391
NODE_55213_length_451_cov_2.607955	257	326	1	33	69	0.4782609
NODE_55234_length_451_cov_2.125000	156	224	0	68	68	1.0000000
NODE_55436_length_450_cov_105.723647	317	386	2	34	69	0.4927536
NODE_55436_length_450_cov_105.723647	317	386	3	35	69	0.5072464
NODE_55438_length_450_cov_27.982906	98	120	5	11	22	0.5000000
NODE_55438_length_450_cov_27.982906	98	120	6	8	22	0.3636364
NODE_55438_length_450_cov_27.982906	98	120	7	3	22	0.1363636
NODE_55438_length_450_cov_27.982906	225	305	21	6	80	0.0750000
NODE_55438_length_450_cov_27.982906	225	305	22	5	80	0.0625000
NODE_55438_length_450_cov_27.982906	225	305	23	1	80	0.0125000
NODE_55438_length_450_cov_27.982906	225	305	24	2	80	0.0250000
NODE_55438_length_450_cov_27.982906	225	305	25	3	80	0.0375000
NODE_55438_length_450_cov_27.982906	225	305	26	1	80	0.0125000
NODE_55438_length_450_cov_27.982906	225	305	27	26	80	0.3250000
NODE_55438_length_450_cov_27.982906	225	305	28	8	80	0.1000000
NODE_55438_length_450_cov_27.982906	225	305	29	23	80	0.2875000
NODE_55438_length_450_cov_27.982906	225	305	30	5	80	0.0625000
NODE_55438_length_450_cov_27.982906	278	358	11	2	80	0.0250000
NODE_55438_length_450_cov_27.982906	278	358	12	4	80	0.0500000
NODE_55438_length_450_cov_27.982906	278	358	13	9	80	0.1125000
NODE_55438_length_450_cov_27.982906	278	358	14	2	80	0.0250000
NODE_55438_length_450_cov_27.982906	278	358	15	10	80	0.1250000
NODE_55438_length_450_cov_27.982906	278	358	16	10	80	0.1250000
NODE_55438_length_450_cov_27.982906	278	358	19	12	80	0.1500000
NODE_55438_length_450_cov_27.982906	278	358	21	10	80	0.1250000
NODE_55438_length_450_cov_27.982906	278	358	22	5	80	0.0625000
NODE_55438_length_450_cov_27.982906	278	358	23	1	80	0.0125000
NODE_55438_length_450_cov_27.982906	278	358	24	2	80	0.0250000
NODE_55438_length_450_cov_27.982906	278	358	25	3	80	0.0375000
NODE_55438_length_450_cov_27.982906	278	358	26	1	80	0.0125000
NODE_55438_length_450_cov_27.982906	278	358	27	5	80	0.0625000
NODE_55438_length_450_cov_27.982906	278	358	29	4	80	0.0500000
NODE_55459_length_450_cov_3.991453	220	290	0	70	70	1.0000000
NODE_55459_length_450_cov_3.991453	223	290	0	67	67	1.0000000
NODE_55459_length_450_cov_3.991453	268	348	0	80	80	1.0000000
NODE_55459_length_450_cov_3.991453	268	348	0	80	80	1.0000000
NODE_55459_length_450_cov_3.991453	278	348	0	70	70	1.0000000
NODE_55459_length_450_cov_3.991453	344	363	0	19	19	1.0000000
NODE_55466_length_450_cov_3.717949	107	177	0	70	70	1.0000000
NODE_55483_length_450_cov_3.162393	99	157	0	58	58	1.0000000
NODE_55550_length_450_cov_1.857550	114	172	2	10	58	0.1724138
NODE_55550_length_450_cov_1.857550	114	172	4	37	58	0.6379310
NODE_55550_length_450_cov_1.857550	114	172	5	11	58	0.1896552
NODE_55560_length_450_cov_1.749288	321	376	0	55	55	1.0000000
NODE_55565_length_450_cov_1.723647	101	161	0	60	60	1.0000000
NODE_55685_length_450_cov_1.017094	116	196	0	80	80	1.0000000
NODE_55761_length_449_cov_46.882857	237	317	13	5	80	0.0625000
NODE_55761_length_449_cov_46.882857	237	317	14	1	80	0.0125000
NODE_55761_length_449_cov_46.882857	237	317	17	16	80	0.2000000
NODE_55761_length_449_cov_46.882857	237	317	18	1	80	0.0125000
NODE_55761_length_449_cov_46.882857	237	317	19	25	80	0.3125000
NODE_55761_length_449_cov_46.882857	237	317	20	4	80	0.0500000
NODE_55761_length_449_cov_46.882857	237	317	22	28	80	0.3500000
NODE_55761_length_449_cov_46.882857	290	370	0	7	80	0.0875000
NODE_55761_length_449_cov_46.882857	290	370	2	7	80	0.0875000
NODE_55761_length_449_cov_46.882857	290	370	4	7	80	0.0875000
NODE_55761_length_449_cov_46.882857	290	370	6	6	80	0.0750000
NODE_55761_length_449_cov_46.882857	290	370	8	1	80	0.0125000
NODE_55761_length_449_cov_46.882857	290	370	9	3	80	0.0375000
NODE_55761_length_449_cov_46.882857	290	370	11	7	80	0.0875000
NODE_55761_length_449_cov_46.882857	290	370	13	20	80	0.2500000
NODE_55761_length_449_cov_46.882857	290	370	14	1	80	0.0125000
NODE_55761_length_449_cov_46.882857	290	370	17	16	80	0.2000000
NODE_55761_length_449_cov_46.882857	290	370	18	1	80	0.0125000
NODE_55761_length_449_cov_46.882857	290	370	19	4	80	0.0500000
NODE_55762_length_449_cov_36.031429	238	318	12	1	80	0.0125000
NODE_55762_length_449_cov_36.031429	238	318	13	8	80	0.1000000
NODE_55762_length_449_cov_36.031429	238	318	14	21	80	0.2625000
NODE_55762_length_449_cov_36.031429	238	318	15	13	80	0.1625000
NODE_55762_length_449_cov_36.031429	238	318	16	37	80	0.4625000
NODE_55762_length_449_cov_36.031429	291	371	12	4	80	0.0500000
NODE_55762_length_449_cov_36.031429	291	371	13	21	80	0.2625000
NODE_55762_length_449_cov_36.031429	291	371	15	11	80	0.1375000
NODE_55762_length_449_cov_36.031429	291	371	16	44	80	0.5500000
NODE_55783_length_449_cov_4.594286	137	184	2	47	47	1.0000000
NODE_55794_length_449_cov_3.797143	204	284	0	27	80	0.3375000
NODE_55794_length_449_cov_3.797143	204	284	5	53	80	0.6625000
NODE_55844_length_449_cov_2.445714	346	376	0	30	30	1.0000000
NODE_56144_length_448_cov_44.664756	126	206	0	20	80	0.2500000
NODE_56144_length_448_cov_44.664756	126	206	1	60	80	0.7500000
NODE_56144_length_448_cov_44.664756	179	259	0	73	80	0.9125000
NODE_56144_length_448_cov_44.664756	179	259	1	7	80	0.0875000
NODE_56145_length_448_cov_36.148997	195	275	0	80	80	1.0000000
NODE_56145_length_448_cov_36.148997	248	328	0	80	80	1.0000000
NODE_56145_length_448_cov_36.148997	324	404	0	80	80	1.0000000
NODE_56145_length_448_cov_36.148997	377	448	0	71	71	1.0000000
NODE_56146_length_448_cov_31.816619	43	123	2	6	80	0.0750000
NODE_56146_length_448_cov_31.816619	43	123	3	54	80	0.6750000
NODE_56146_length_448_cov_31.816619	43	123	4	20	80	0.2500000
NODE_56151_length_448_cov_6.779370	197	277	1	15	80	0.1875000
NODE_56151_length_448_cov_6.779370	197	277	2	65	80	0.8125000
NODE_56151_length_448_cov_6.779370	250	313	2	63	63	1.0000000
NODE_56180_length_448_cov_3.664756	148	189	0	41	41	1.0000000
NODE_56189_length_448_cov_3.108883	242	324	2	82	82	1.0000000
NODE_56233_length_448_cov_2.263610	292	360	0	68	68	1.0000000
NODE_56518_length_447_cov_10.505747	205	234	4	12	29	0.4137931
NODE_56518_length_447_cov_10.505747	205	234	5	17	29	0.5862069
NODE_56518_length_447_cov_10.505747	267	326	1	8	59	0.1355932
NODE_56518_length_447_cov_10.505747	267	326	5	22	59	0.3728814
NODE_56518_length_447_cov_10.505747	267	326	6	29	59	0.4915254
NODE_56518_length_447_cov_10.505747	299	379	6	80	80	1.0000000
NODE_56527_length_447_cov_5.767241	176	256	0	80	80	1.0000000
NODE_56527_length_447_cov_5.767241	229	309	0	80	80	1.0000000
NODE_56539_length_447_cov_4.583333	265	289	0	24	24	1.0000000
NODE_56545_length_447_cov_4.037356	58	138	3	4	80	0.0500000
NODE_56545_length_447_cov_4.037356	58	138	4	76	80	0.9500000
NODE_56545_length_447_cov_4.037356	111	191	1	22	80	0.2750000
NODE_56545_length_447_cov_4.037356	111	191	2	11	80	0.1375000
NODE_56545_length_447_cov_4.037356	111	191	3	24	80	0.3000000
NODE_56545_length_447_cov_4.037356	111	191	4	23	80	0.2875000
NODE_56890_length_446_cov_42.527378	239	310	10	2	71	0.0281690
NODE_56890_length_446_cov_42.527378	239	310	11	15	71	0.2112676
NODE_56890_length_446_cov_42.527378	239	310	13	36	71	0.5070422
NODE_56890_length_446_cov_42.527378	239	310	14	5	71	0.0704225
NODE_56890_length_446_cov_42.527378	239	310	15	1	71	0.0140845
NODE_56890_length_446_cov_42.527378	239	310	16	11	71	0.1549296
NODE_56890_length_446_cov_42.527378	239	310	18	1	71	0.0140845
NODE_56890_length_446_cov_42.527378	359	433	12	7	74	0.0945946
NODE_56890_length_446_cov_42.527378	359	433	13	11	74	0.1486486
NODE_56890_length_446_cov_42.527378	359	433	14	11	74	0.1486486
NODE_56890_length_446_cov_42.527378	359	433	15	13	74	0.1756757
NODE_56890_length_446_cov_42.527378	359	433	16	7	74	0.0945946
NODE_56890_length_446_cov_42.527378	359	433	17	3	74	0.0405405
NODE_56890_length_446_cov_42.527378	359	433	18	22	74	0.2972973
NODE_56891_length_446_cov_12.749280	92	172	0	80	80	1.0000000
NODE_56891_length_446_cov_12.749280	145	225	0	80	80	1.0000000
NODE_56896_length_446_cov_6.902017	175	217	0	42	42	1.0000000
NODE_56902_length_446_cov_5.930836	165	245	0	80	80	1.0000000
NODE_56902_length_446_cov_5.930836	165	245	0	80	80	1.0000000
NODE_56902_length_446_cov_5.930836	165	235	0	70	70	1.0000000
NODE_56902_length_446_cov_5.930836	218	298	0	80	80	1.0000000
NODE_56902_length_446_cov_5.930836	218	297	0	79	79	1.0000000
NODE_56919_length_446_cov_3.896254	215	274	0	59	59	1.0000000
NODE_56934_length_446_cov_3.282421	130	168	0	38	38	1.0000000
NODE_56952_length_446_cov_2.775216	337	417	0	80	80	1.0000000
NODE_56995_length_446_cov_2.161383	17	97	0	80	80	1.0000000
NODE_57022_length_446_cov_1.907781	196	225	0	29	29	1.0000000
NODE_57277_length_445_cov_75.572254	108	188	3	9	80	0.1125000
NODE_57277_length_445_cov_75.572254	108	188	5	1	80	0.0125000
NODE_57277_length_445_cov_75.572254	108	188	7	20	80	0.2500000
NODE_57277_length_445_cov_75.572254	108	188	8	7	80	0.0875000
NODE_57277_length_445_cov_75.572254	108	188	9	40	80	0.5000000
NODE_57277_length_445_cov_75.572254	108	188	11	3	80	0.0375000
NODE_57277_length_445_cov_75.572254	161	241	9	24	80	0.3000000
NODE_57277_length_445_cov_75.572254	161	241	11	4	80	0.0500000
NODE_57277_length_445_cov_75.572254	161	241	12	15	80	0.1875000
NODE_57277_length_445_cov_75.572254	161	241	13	34	80	0.4250000
NODE_57277_length_445_cov_75.572254	161	241	14	3	80	0.0375000
NODE_57277_length_445_cov_75.572254	237	317	8	5	80	0.0625000
NODE_57277_length_445_cov_75.572254	237	317	9	8	80	0.1000000
NODE_57277_length_445_cov_75.572254	237	317	10	24	80	0.3000000
NODE_57277_length_445_cov_75.572254	237	317	11	13	80	0.1625000
NODE_57277_length_445_cov_75.572254	237	317	13	30	80	0.3750000
NODE_57277_length_445_cov_75.572254	290	370	5	4	80	0.0500000
NODE_57277_length_445_cov_75.572254	290	370	6	3	80	0.0375000
NODE_57277_length_445_cov_75.572254	290	370	7	18	80	0.2250000
NODE_57277_length_445_cov_75.572254	290	370	8	11	80	0.1375000
NODE_57277_length_445_cov_75.572254	290	370	9	9	80	0.1125000
NODE_57277_length_445_cov_75.572254	290	370	10	5	80	0.0625000
NODE_57277_length_445_cov_75.572254	290	370	11	30	80	0.3750000
NODE_57278_length_445_cov_33.973988	83	163	2	80	80	1.0000000
NODE_57278_length_445_cov_33.973988	136	216	2	35	80	0.4375000
NODE_57278_length_445_cov_33.973988	136	216	3	32	80	0.4000000
NODE_57278_length_445_cov_33.973988	136	216	4	13	80	0.1625000
NODE_57280_length_445_cov_9.323699	78	148	0	70	70	1.0000000
NODE_57280_length_445_cov_9.323699	121	201	0	80	80	1.0000000
NODE_57284_length_445_cov_6.439306	210	282	1	39	72	0.5416667
NODE_57284_length_445_cov_6.439306	210	282	2	33	72	0.4583333
NODE_57286_length_445_cov_5.479769	115	184	0	69	69	1.0000000
NODE_57286_length_445_cov_5.479769	157	237	0	80	80	1.0000000
NODE_57286_length_445_cov_5.479769	233	309	0	76	76	1.0000000
NODE_57286_length_445_cov_5.479769	286	309	0	23	23	1.0000000
NODE_57345_length_445_cov_2.843931	124	199	0	75	75	1.0000000
NODE_57352_length_445_cov_2.682081	202	248	10	46	46	1.0000000
NODE_57400_length_445_cov_1.884393	252	332	0	80	80	1.0000000
NODE_57409_length_445_cov_1.783237	132	203	0	71	71	1.0000000
NODE_57409_length_445_cov_1.783237	256	331	0	75	75	1.0000000
NODE_57409_length_445_cov_1.783237	256	278	0	22	22	1.0000000
NODE_57644_length_444_cov_34.075362	243	323	4	7	80	0.0875000
NODE_57644_length_444_cov_34.075362	243	323	5	9	80	0.1125000
NODE_57644_length_444_cov_34.075362	243	323	6	30	80	0.3750000
NODE_57644_length_444_cov_34.075362	243	323	7	34	80	0.4250000
NODE_57644_length_444_cov_34.075362	296	376	5	37	80	0.4625000
NODE_57644_length_444_cov_34.075362	296	376	7	43	80	0.5375000
NODE_57645_length_444_cov_22.524638	98	178	4	46	80	0.5750000
NODE_57645_length_444_cov_22.524638	98	178	5	12	80	0.1500000
NODE_57645_length_444_cov_22.524638	98	178	6	22	80	0.2750000
NODE_57645_length_444_cov_22.524638	151	231	1	20	80	0.2500000
NODE_57645_length_444_cov_22.524638	151	231	3	5	80	0.0625000
NODE_57645_length_444_cov_22.524638	151	231	4	9	80	0.1125000
NODE_57645_length_444_cov_22.524638	151	231	5	31	80	0.3875000
NODE_57645_length_444_cov_22.524638	151	231	6	15	80	0.1875000
NODE_57646_length_444_cov_16.544928	263	343	0	80	80	1.0000000
NODE_57646_length_444_cov_16.544928	316	396	0	80	80	1.0000000
NODE_57647_length_444_cov_12.684058	293	373	0	80	80	1.0000000
NODE_57647_length_444_cov_12.684058	346	426	0	80	80	1.0000000
NODE_57649_length_444_cov_9.284058	176	256	0	80	80	1.0000000
NODE_57649_length_444_cov_9.284058	229	309	0	80	80	1.0000000
NODE_57666_length_444_cov_5.159420	170	241	0	71	71	1.0000000
NODE_57668_length_444_cov_5.060870	201	245	0	44	44	1.0000000
NODE_57668_length_444_cov_5.060870	218	298	0	80	80	1.0000000
NODE_57717_length_444_cov_2.744928	73	136	0	63	63	1.0000000
NODE_57770_length_444_cov_2.028986	46	113	3	67	67	1.0000000
NODE_57770_length_444_cov_2.028986	86	166	2	18	80	0.2250000
NODE_57770_length_444_cov_2.028986	86	166	3	38	80	0.4750000
NODE_57770_length_444_cov_2.028986	86	166	4	24	80	0.3000000
NODE_57873_length_444_cov_1.234783	335	407	0	72	72	1.0000000
NODE_57892_length_444_cov_1.173913	7	87	0	80	80	1.0000000
NODE_58026_length_443_cov_71.284884	209	289	6	35	80	0.4375000
NODE_58026_length_443_cov_71.284884	209	289	7	11	80	0.1375000
NODE_58026_length_443_cov_71.284884	209	289	8	26	80	0.3250000
NODE_58026_length_443_cov_71.284884	209	289	9	1	80	0.0125000
NODE_58026_length_443_cov_71.284884	209	289	10	7	80	0.0875000
NODE_58026_length_443_cov_71.284884	262	342	6	4	80	0.0500000
NODE_58026_length_443_cov_71.284884	262	342	8	32	80	0.4000000
NODE_58026_length_443_cov_71.284884	262	342	9	27	80	0.3375000
NODE_58026_length_443_cov_71.284884	262	342	10	17	80	0.2125000
NODE_58026_length_443_cov_71.284884	338	418	5	13	80	0.1625000
NODE_58026_length_443_cov_71.284884	338	418	6	11	80	0.1375000
NODE_58026_length_443_cov_71.284884	338	418	7	40	80	0.5000000
NODE_58026_length_443_cov_71.284884	338	418	8	11	80	0.1375000
NODE_58026_length_443_cov_71.284884	338	418	9	5	80	0.0625000
NODE_58026_length_443_cov_71.284884	391	443	3	11	52	0.2115385
NODE_58026_length_443_cov_71.284884	391	443	4	1	52	0.0192308
NODE_58026_length_443_cov_71.284884	391	443	5	26	52	0.5000000
NODE_58026_length_443_cov_71.284884	391	443	6	11	52	0.2115385
NODE_58026_length_443_cov_71.284884	391	443	7	3	52	0.0576923
NODE_58027_length_443_cov_68.973837	314	394	2	46	80	0.5750000
NODE_58027_length_443_cov_68.973837	314	394	4	34	80	0.4250000
NODE_58027_length_443_cov_68.973837	367	443	0	16	76	0.2105263
NODE_58027_length_443_cov_68.973837	367	443	2	60	76	0.7894737
NODE_58028_length_443_cov_61.116279	34	114	1	29	80	0.3625000
NODE_58028_length_443_cov_61.116279	34	114	3	51	80	0.6375000
NODE_58028_length_443_cov_61.116279	87	167	3	46	80	0.5750000
NODE_58028_length_443_cov_61.116279	87	167	4	34	80	0.4250000
NODE_58041_length_443_cov_4.895349	127	207	0	5	80	0.0625000
NODE_58041_length_443_cov_4.895349	127	207	1	54	80	0.6750000
NODE_58041_length_443_cov_4.895349	127	207	2	21	80	0.2625000
NODE_58086_length_443_cov_2.581395	121	195	0	74	74	1.0000000
NODE_58088_length_443_cov_2.508721	297	347	0	50	50	1.0000000
NODE_58088_length_443_cov_2.508721	320	395	0	75	75	1.0000000
NODE_58091_length_443_cov_2.456395	114	192	0	78	78	1.0000000
NODE_58091_length_443_cov_2.456395	118	141	0	23	23	1.0000000
NODE_58237_length_443_cov_1.151163	144	224	0	80	80	1.0000000
NODE_58321_length_443_cov_0.715116	52	104	0	52	52	1.0000000
NODE_58321_length_443_cov_0.715116	105	146	0	41	41	1.0000000
NODE_58346_length_442_cov_42.956268	290	375	4	85	85	1.0000000
NODE_58346_length_442_cov_42.956268	290	375	4	85	85	1.0000000
NODE_58347_length_442_cov_24.093294	225	305	3	18	80	0.2250000
NODE_58347_length_442_cov_24.093294	225	305	4	3	80	0.0375000
NODE_58347_length_442_cov_24.093294	225	305	5	36	80	0.4500000
NODE_58347_length_442_cov_24.093294	225	305	6	23	80	0.2875000
NODE_58347_length_442_cov_24.093294	278	358	5	43	80	0.5375000
NODE_58347_length_442_cov_24.093294	278	358	6	37	80	0.4625000
NODE_58348_length_442_cov_8.956268	173	192	0	19	19	1.0000000
NODE_58361_length_442_cov_5.052478	213	293	2	55	80	0.6875000
NODE_58361_length_442_cov_5.052478	213	293	4	25	80	0.3125000
NODE_58361_length_442_cov_5.052478	266	346	0	39	80	0.4875000
NODE_58361_length_442_cov_5.052478	266	346	2	41	80	0.5125000
NODE_58376_length_442_cov_3.871720	297	372	0	75	75	1.0000000
NODE_58376_length_442_cov_3.871720	360	413	0	53	53	1.0000000
NODE_58378_length_442_cov_3.804665	211	244	0	33	33	1.0000000
NODE_58405_length_442_cov_3.206997	149	217	0	68	68	1.0000000
NODE_58438_length_442_cov_2.434402	203	274	0	71	71	1.0000000
NODE_58438_length_442_cov_2.434402	247	327	0	80	80	1.0000000
NODE_58503_length_442_cov_1.746356	95	161	0	66	66	1.0000000
NODE_58503_length_442_cov_1.746356	95	122	0	27	27	1.0000000
NODE_58759_length_441_cov_21.877193	28	108	0	6	80	0.0750000
NODE_58759_length_441_cov_21.877193	28	108	1	41	80	0.5125000
NODE_58759_length_441_cov_21.877193	28	108	2	33	80	0.4125000
NODE_58759_length_441_cov_21.877193	81	161	2	80	80	1.0000000
NODE_58760_length_441_cov_13.546784	152	232	1	80	80	1.0000000
NODE_58760_length_441_cov_13.546784	205	285	0	13	80	0.1625000
NODE_58760_length_441_cov_13.546784	205	285	1	67	80	0.8375000
NODE_58771_length_441_cov_5.710526	200	280	0	80	80	1.0000000
NODE_58771_length_441_cov_5.710526	253	333	0	80	80	1.0000000
NODE_58817_length_441_cov_3.096491	240	324	0	84	84	1.0000000
NODE_58820_length_441_cov_3.023392	105	163	0	58	58	1.0000000
NODE_58852_length_441_cov_2.438596	19	99	0	80	80	1.0000000
NODE_58852_length_441_cov_2.438596	72	126	0	54	54	1.0000000
NODE_58970_length_441_cov_1.435673	105	156	0	51	51	1.0000000
NODE_59142_length_440_cov_43.131965	122	202	6	22	80	0.2750000
NODE_59142_length_440_cov_43.131965	122	202	8	3	80	0.0375000
NODE_59142_length_440_cov_43.131965	122	202	9	26	80	0.3250000
NODE_59142_length_440_cov_43.131965	122	202	11	24	80	0.3000000
NODE_59142_length_440_cov_43.131965	122	202	14	5	80	0.0625000
NODE_59142_length_440_cov_43.131965	175	255	9	6	80	0.0750000
NODE_59142_length_440_cov_43.131965	175	255	10	4	80	0.0500000
NODE_59142_length_440_cov_43.131965	175	255	11	23	80	0.2875000
NODE_59142_length_440_cov_43.131965	175	255	13	14	80	0.1750000
NODE_59142_length_440_cov_43.131965	175	255	14	33	80	0.4125000
NODE_59142_length_440_cov_43.131965	251	331	3	25	80	0.3125000
NODE_59142_length_440_cov_43.131965	251	331	5	9	80	0.1125000
NODE_59142_length_440_cov_43.131965	251	331	6	3	80	0.0375000
NODE_59142_length_440_cov_43.131965	251	331	8	38	80	0.4750000
NODE_59142_length_440_cov_43.131965	251	331	9	5	80	0.0625000
NODE_59142_length_440_cov_43.131965	304	384	0	37	80	0.4625000
NODE_59142_length_440_cov_43.131965	304	384	3	41	80	0.5125000
NODE_59142_length_440_cov_43.131965	304	384	5	2	80	0.0250000
NODE_59143_length_440_cov_42.929619	116	196	4	41	80	0.5125000
NODE_59143_length_440_cov_42.929619	116	196	5	39	80	0.4875000
NODE_59143_length_440_cov_42.929619	169	249	5	32	80	0.4000000
NODE_59143_length_440_cov_42.929619	169	249	7	40	80	0.5000000
NODE_59143_length_440_cov_42.929619	169	249	8	8	80	0.1000000
NODE_59147_length_440_cov_8.164223	45	125	0	38	80	0.4750000
NODE_59147_length_440_cov_8.164223	45	125	1	42	80	0.5250000
NODE_59147_length_440_cov_8.164223	98	178	1	80	80	1.0000000
NODE_59157_length_440_cov_5.193548	146	210	0	64	64	1.0000000
NODE_59157_length_440_cov_5.193548	146	210	0	64	64	1.0000000
NODE_59157_length_440_cov_5.193548	146	210	0	64	64	1.0000000
NODE_59164_length_440_cov_4.595308	153	233	0	80	80	1.0000000
NODE_59164_length_440_cov_4.595308	153	180	0	27	27	1.0000000
NODE_59188_length_440_cov_3.431085	84	150	0	66	66	1.0000000
NODE_59191_length_440_cov_3.331378	139	195	2	8	56	0.1428571
NODE_59191_length_440_cov_3.331378	139	195	3	48	56	0.8571429
NODE_59517_length_439_cov_76.552941	0	68	0	5	68	0.0735294
NODE_59517_length_439_cov_76.552941	0	68	4	5	68	0.0735294
NODE_59517_length_439_cov_76.552941	0	68	5	20	68	0.2941177
NODE_59517_length_439_cov_76.552941	0	68	6	21	68	0.3088235
NODE_59517_length_439_cov_76.552941	0	68	7	2	68	0.0294118
NODE_59517_length_439_cov_76.552941	0	68	12	3	68	0.0441176
NODE_59517_length_439_cov_76.552941	0	68	21	12	68	0.1764706
NODE_59517_length_439_cov_76.552941	0	68	0	5	68	0.0735294
NODE_59517_length_439_cov_76.552941	0	68	4	5	68	0.0735294
NODE_59517_length_439_cov_76.552941	0	68	5	20	68	0.2941177
NODE_59517_length_439_cov_76.552941	0	68	6	21	68	0.3088235
NODE_59517_length_439_cov_76.552941	0	68	7	2	68	0.0294118
NODE_59517_length_439_cov_76.552941	0	68	12	3	68	0.0441176
NODE_59517_length_439_cov_76.552941	0	68	21	12	68	0.1764706
NODE_59517_length_439_cov_76.552941	0	68	0	5	68	0.0735294
NODE_59517_length_439_cov_76.552941	0	68	4	5	68	0.0735294
NODE_59517_length_439_cov_76.552941	0	68	5	20	68	0.2941177
NODE_59517_length_439_cov_76.552941	0	68	6	21	68	0.3088235
NODE_59517_length_439_cov_76.552941	0	68	7	2	68	0.0294118
NODE_59517_length_439_cov_76.552941	0	68	12	3	68	0.0441176
NODE_59517_length_439_cov_76.552941	0	68	21	12	68	0.1764706
NODE_59517_length_439_cov_76.552941	1	68	0	4	67	0.0597015
NODE_59517_length_439_cov_76.552941	1	68	4	5	67	0.0746269
NODE_59517_length_439_cov_76.552941	1	68	5	20	67	0.2985075
NODE_59517_length_439_cov_76.552941	1	68	6	21	67	0.3134328
NODE_59517_length_439_cov_76.552941	1	68	7	2	67	0.0298507
NODE_59517_length_439_cov_76.552941	1	68	12	3	67	0.0447761
NODE_59517_length_439_cov_76.552941	1	68	21	12	67	0.1791045
NODE_59517_length_439_cov_76.552941	64	144	21	9	80	0.1125000
NODE_59517_length_439_cov_76.552941	64	144	22	8	80	0.1000000
NODE_59517_length_439_cov_76.552941	64	144	23	63	80	0.7875000
NODE_59517_length_439_cov_76.552941	64	144	21	9	80	0.1125000
NODE_59517_length_439_cov_76.552941	64	144	22	8	80	0.1000000
NODE_59517_length_439_cov_76.552941	64	144	23	63	80	0.7875000
NODE_59517_length_439_cov_76.552941	117	197	19	17	80	0.2125000
NODE_59517_length_439_cov_76.552941	117	197	20	20	80	0.2500000
NODE_59517_length_439_cov_76.552941	117	197	21	5	80	0.0625000
NODE_59517_length_439_cov_76.552941	117	197	23	28	80	0.3500000
NODE_59517_length_439_cov_76.552941	117	197	25	10	80	0.1250000
NODE_59517_length_439_cov_76.552941	117	195	19	15	78	0.1923077
NODE_59517_length_439_cov_76.552941	117	195	20	20	78	0.2564103
NODE_59517_length_439_cov_76.552941	117	195	21	5	78	0.0641026
NODE_59517_length_439_cov_76.552941	117	195	23	28	78	0.3589744
NODE_59517_length_439_cov_76.552941	117	195	25	10	78	0.1282051
NODE_59533_length_439_cov_4.408824	174	238	2	11	64	0.1718750
NODE_59533_length_439_cov_4.408824	174	238	4	53	64	0.8281250
NODE_59536_length_439_cov_4.255882	258	318	0	60	60	1.0000000
NODE_59560_length_439_cov_3.011765	57	128	7	4	71	0.0563380
NODE_59560_length_439_cov_3.011765	57	128	8	9	71	0.1267606
NODE_59560_length_439_cov_3.011765	57	128	10	53	71	0.7464789
NODE_59560_length_439_cov_3.011765	57	128	11	1	71	0.0140845
NODE_59560_length_439_cov_3.011765	57	128	12	3	71	0.0422535
NODE_59560_length_439_cov_3.011765	57	128	14	1	71	0.0140845
NODE_59560_length_439_cov_3.011765	101	140	10	22	39	0.5641026
NODE_59560_length_439_cov_3.011765	101	140	11	1	39	0.0256410
NODE_59560_length_439_cov_3.011765	101	140	12	3	39	0.0769231
NODE_59560_length_439_cov_3.011765	101	140	14	13	39	0.3333333
NODE_59592_length_439_cov_2.252941	227	269	0	42	42	1.0000000
NODE_59599_length_439_cov_2.135294	116	179	3	19	63	0.3015873
NODE_59599_length_439_cov_2.135294	116	179	5	44	63	0.6984127
NODE_59617_length_439_cov_1.929412	388	439	0	51	51	1.0000000
NODE_59897_length_438_cov_29.952802	196	276	0	80	80	1.0000000
NODE_59897_length_438_cov_29.952802	249	329	0	80	80	1.0000000
NODE_59898_length_438_cov_16.330383	225	305	5	7	80	0.0875000
NODE_59898_length_438_cov_16.330383	225	305	6	57	80	0.7125000
NODE_59898_length_438_cov_16.330383	225	305	7	16	80	0.2000000
NODE_59898_length_438_cov_16.330383	278	358	3	16	80	0.2000000
NODE_59898_length_438_cov_16.330383	278	358	4	30	80	0.3750000
NODE_59898_length_438_cov_16.330383	278	358	5	14	80	0.1750000
NODE_59898_length_438_cov_16.330383	278	358	6	10	80	0.1250000
NODE_59898_length_438_cov_16.330383	278	358	7	10	80	0.1250000
NODE_59899_length_438_cov_15.436578	74	154	0	80	80	1.0000000
NODE_59899_length_438_cov_15.436578	127	207	0	80	80	1.0000000
NODE_59901_length_438_cov_9.306785	256	309	0	53	53	1.0000000
NODE_59901_length_438_cov_9.306785	282	327	0	45	45	1.0000000
NODE_59916_length_438_cov_4.808260	46	133	10	7	87	0.0804598
NODE_59916_length_438_cov_4.808260	46	133	15	16	87	0.1839080
NODE_59916_length_438_cov_4.808260	46	133	16	23	87	0.2643678
NODE_59916_length_438_cov_4.808260	46	133	19	8	87	0.0919540
NODE_59916_length_438_cov_4.808260	46	133	24	1	87	0.0114943
NODE_59916_length_438_cov_4.808260	46	133	25	2	87	0.0229885
NODE_59916_length_438_cov_4.808260	46	133	26	5	87	0.0574713
NODE_59916_length_438_cov_4.808260	46	133	27	1	87	0.0114943
NODE_59916_length_438_cov_4.808260	46	133	28	1	87	0.0114943
NODE_59916_length_438_cov_4.808260	46	133	29	23	87	0.2643678
NODE_59916_length_438_cov_4.808260	106	186	16	1	80	0.0125000
NODE_59916_length_438_cov_4.808260	106	186	17	3	80	0.0375000
NODE_59916_length_438_cov_4.808260	106	186	19	1	80	0.0125000
NODE_59916_length_438_cov_4.808260	106	186	20	1	80	0.0125000
NODE_59916_length_438_cov_4.808260	106	186	24	9	80	0.1125000
NODE_59916_length_438_cov_4.808260	106	186	26	2	80	0.0250000
NODE_59916_length_438_cov_4.808260	106	186	27	1	80	0.0125000
NODE_59916_length_438_cov_4.808260	106	186	28	22	80	0.2750000
NODE_59916_length_438_cov_4.808260	106	186	29	40	80	0.5000000
NODE_59920_length_438_cov_4.622419	135	184	0	49	49	1.0000000
NODE_59936_length_438_cov_3.651917	86	166	0	80	80	1.0000000
NODE_59936_length_438_cov_3.651917	139	219	0	80	80	1.0000000
NODE_59952_length_438_cov_3.109145	215	273	0	58	58	1.0000000
NODE_59957_length_438_cov_3.005900	175	258	0	83	83	1.0000000
NODE_60317_length_437_cov_57.260355	272	352	0	29	80	0.3625000
NODE_60317_length_437_cov_57.260355	272	352	2	51	80	0.6375000
NODE_60317_length_437_cov_57.260355	325	405	2	80	80	1.0000000
NODE_60318_length_437_cov_40.964497	0	73	0	27	73	0.3698630
NODE_60318_length_437_cov_40.964497	0	73	1	4	73	0.0547945
NODE_60318_length_437_cov_40.964497	0	73	4	4	73	0.0547945
NODE_60318_length_437_cov_40.964497	0	73	5	28	73	0.3835616
NODE_60318_length_437_cov_40.964497	0	73	6	6	73	0.0821918
NODE_60318_length_437_cov_40.964497	0	73	7	4	73	0.0547945
NODE_60318_length_437_cov_40.964497	46	126	5	17	80	0.2125000
NODE_60318_length_437_cov_40.964497	46	126	6	6	80	0.0750000
NODE_60318_length_437_cov_40.964497	46	126	7	57	80	0.7125000
NODE_60319_length_437_cov_30.843195	140	220	0	80	80	1.0000000
NODE_60319_length_437_cov_30.843195	193	273	0	80	80	1.0000000
NODE_60320_length_437_cov_14.736686	164	244	0	4	80	0.0500000
NODE_60320_length_437_cov_14.736686	164	244	1	52	80	0.6500000
NODE_60320_length_437_cov_14.736686	164	244	2	24	80	0.3000000
NODE_60320_length_437_cov_14.736686	217	297	1	3	80	0.0375000
NODE_60320_length_437_cov_14.736686	217	297	2	77	80	0.9625000
NODE_60331_length_437_cov_6.032544	249	320	0	71	71	1.0000000
NODE_60332_length_437_cov_6.020710	272	352	2	80	80	1.0000000
NODE_60332_length_437_cov_6.020710	325	405	0	34	80	0.4250000
NODE_60332_length_437_cov_6.020710	325	405	2	46	80	0.5750000
NODE_60336_length_437_cov_5.526627	129	209	0	80	80	1.0000000
NODE_60336_length_437_cov_5.526627	182	262	0	80	80	1.0000000
NODE_60348_length_437_cov_4.505917	247	327	0	80	80	1.0000000
NODE_60361_length_437_cov_3.470414	204	259	0	55	55	1.0000000
NODE_60369_length_437_cov_3.301775	95	149	10	54	54	1.0000000
NODE_60381_length_437_cov_2.911243	91	171	0	4	80	0.0500000
NODE_60381_length_437_cov_2.911243	91	171	1	76	80	0.9500000
NODE_60400_length_437_cov_2.650888	190	239	0	49	49	1.0000000
NODE_60400_length_437_cov_2.650888	212	292	0	80	80	1.0000000
NODE_60411_length_437_cov_2.514793	292	333	0	41	41	1.0000000
NODE_60509_length_437_cov_1.473373	252	324	0	72	72	1.0000000
NODE_60709_length_436_cov_125.940653	204	284	17	8	80	0.1000000
NODE_60709_length_436_cov_125.940653	204	284	18	11	80	0.1375000
NODE_60709_length_436_cov_125.940653	204	284	19	10	80	0.1250000
NODE_60709_length_436_cov_125.940653	204	284	20	12	80	0.1500000
NODE_60709_length_436_cov_125.940653	204	284	21	13	80	0.1625000
NODE_60709_length_436_cov_125.940653	204	284	22	12	80	0.1500000
NODE_60709_length_436_cov_125.940653	204	284	23	9	80	0.1125000
NODE_60709_length_436_cov_125.940653	204	284	24	5	80	0.0625000
NODE_60709_length_436_cov_125.940653	255	301	18	20	46	0.4347826
NODE_60709_length_436_cov_125.940653	255	301	19	7	46	0.1521739
NODE_60709_length_436_cov_125.940653	255	301	20	12	46	0.2608696
NODE_60709_length_436_cov_125.940653	255	301	21	7	46	0.1521739
NODE_60709_length_436_cov_125.940653	257	337	13	17	80	0.2125000
NODE_60709_length_436_cov_125.940653	257	337	14	6	80	0.0750000
NODE_60709_length_436_cov_125.940653	257	337	16	13	80	0.1625000
NODE_60709_length_436_cov_125.940653	257	337	18	18	80	0.2250000
NODE_60709_length_436_cov_125.940653	257	337	19	7	80	0.0875000
NODE_60709_length_436_cov_125.940653	257	337	20	12	80	0.1500000
NODE_60709_length_436_cov_125.940653	257	337	21	7	80	0.0875000
NODE_60709_length_436_cov_125.940653	333	413	3	32	80	0.4000000
NODE_60709_length_436_cov_125.940653	333	413	5	12	80	0.1500000
NODE_60709_length_436_cov_125.940653	333	413	6	4	80	0.0500000
NODE_60709_length_436_cov_125.940653	333	413	10	20	80	0.2500000
NODE_60709_length_436_cov_125.940653	333	413	12	4	80	0.0500000
NODE_60709_length_436_cov_125.940653	333	413	13	8	80	0.1000000
NODE_60709_length_436_cov_125.940653	386	436	0	10	50	0.2000000
NODE_60709_length_436_cov_125.940653	386	436	1	5	50	0.1000000
NODE_60709_length_436_cov_125.940653	386	436	3	35	50	0.7000000
NODE_60712_length_436_cov_45.459941	166	246	2	78	80	0.9750000
NODE_60712_length_436_cov_45.459941	166	246	4	2	80	0.0250000
NODE_60712_length_436_cov_45.459941	219	299	2	47	80	0.5875000
NODE_60712_length_436_cov_45.459941	219	299	4	33	80	0.4125000
NODE_60712_length_436_cov_45.459941	295	375	2	80	80	1.0000000
NODE_60712_length_436_cov_45.459941	348	428	0	34	80	0.4250000
NODE_60712_length_436_cov_45.459941	348	428	2	46	80	0.5750000
NODE_60713_length_436_cov_10.560831	74	154	1	35	80	0.4375000
NODE_60713_length_436_cov_10.560831	74	154	2	45	80	0.5625000
NODE_60713_length_436_cov_10.560831	127	207	2	80	80	1.0000000
NODE_60716_length_436_cov_8.317507	51	127	0	76	76	1.0000000
NODE_60716_length_436_cov_8.317507	104	182	0	78	78	1.0000000
NODE_60760_length_436_cov_3.109792	153	205	0	52	52	1.0000000
NODE_60786_length_436_cov_2.551929	182	258	0	76	76	1.0000000
NODE_60786_length_436_cov_2.551929	235	315	0	80	80	1.0000000
NODE_60934_length_436_cov_1.207715	105	181	0	76	76	1.0000000
NODE_61088_length_435_cov_17.401786	55	135	3	23	80	0.2875000
NODE_61088_length_435_cov_17.401786	55	135	4	57	80	0.7125000
NODE_61088_length_435_cov_17.401786	108	188	1	12	80	0.1500000
NODE_61088_length_435_cov_17.401786	108	188	2	31	80	0.3875000
NODE_61088_length_435_cov_17.401786	108	188	4	37	80	0.4625000
NODE_61094_length_435_cov_6.910714	113	193	0	80	80	1.0000000
NODE_61094_length_435_cov_6.910714	147	194	0	47	47	1.0000000
NODE_61094_length_435_cov_6.910714	149	184	0	35	35	1.0000000
NODE_61094_length_435_cov_6.910714	151	193	0	42	42	1.0000000
NODE_61094_length_435_cov_6.910714	166	251	0	85	85	1.0000000
NODE_61094_length_435_cov_6.910714	167	251	0	84	84	1.0000000
NODE_61102_length_435_cov_5.630952	159	217	0	58	58	1.0000000
NODE_61102_length_435_cov_5.630952	190	270	0	80	80	1.0000000
NODE_61112_length_435_cov_4.601190	271	309	0	38	38	1.0000000
NODE_61112_length_435_cov_4.601190	282	344	0	62	62	1.0000000
NODE_61122_length_435_cov_3.770833	209	240	0	31	31	1.0000000
NODE_61137_length_435_cov_2.836310	113	194	0	10	81	0.1234568
NODE_61137_length_435_cov_2.836310	113	194	2	64	81	0.7901235
NODE_61137_length_435_cov_2.836310	113	194	4	7	81	0.0864198
NODE_61357_length_435_cov_0.988095	286	322	0	36	36	1.0000000
NODE_61451_length_434_cov_136.483582	0	58	4	16	58	0.2758621
NODE_61451_length_434_cov_136.483582	0	58	5	3	58	0.0517241
NODE_61451_length_434_cov_136.483582	0	58	6	6	58	0.1034483
NODE_61451_length_434_cov_136.483582	0	58	7	4	58	0.0689655
NODE_61451_length_434_cov_136.483582	0	58	9	16	58	0.2758621
NODE_61451_length_434_cov_136.483582	0	58	12	13	58	0.2241379
NODE_61451_length_434_cov_136.483582	31	111	9	14	80	0.1750000
NODE_61451_length_434_cov_136.483582	31	111	12	14	80	0.1750000
NODE_61451_length_434_cov_136.483582	31	111	13	1	80	0.0125000
NODE_61451_length_434_cov_136.483582	31	111	14	3	80	0.0375000
NODE_61451_length_434_cov_136.483582	31	111	15	1	80	0.0125000
NODE_61451_length_434_cov_136.483582	31	111	17	9	80	0.1125000
NODE_61451_length_434_cov_136.483582	31	111	18	23	80	0.2875000
NODE_61451_length_434_cov_136.483582	31	111	19	15	80	0.1875000
NODE_61452_length_434_cov_43.214925	291	366	14	42	75	0.5600000
NODE_61452_length_434_cov_43.214925	291	366	15	33	75	0.4400000
NODE_61452_length_434_cov_43.214925	344	424	0	1	80	0.0125000
NODE_61452_length_434_cov_43.214925	344	424	1	26	80	0.3250000
NODE_61452_length_434_cov_43.214925	344	424	2	3	80	0.0375000
NODE_61452_length_434_cov_43.214925	344	424	3	1	80	0.0125000
NODE_61452_length_434_cov_43.214925	344	424	4	1	80	0.0125000
NODE_61452_length_434_cov_43.214925	344	424	5	13	80	0.1625000
NODE_61452_length_434_cov_43.214925	344	424	13	4	80	0.0500000
NODE_61452_length_434_cov_43.214925	344	424	14	31	80	0.3875000
NODE_61452_length_434_cov_43.214925	344	424	0	1	80	0.0125000
NODE_61452_length_434_cov_43.214925	344	424	1	26	80	0.3250000
NODE_61452_length_434_cov_43.214925	344	424	2	3	80	0.0375000
NODE_61452_length_434_cov_43.214925	344	424	3	1	80	0.0125000
NODE_61452_length_434_cov_43.214925	344	424	4	1	80	0.0125000
NODE_61452_length_434_cov_43.214925	344	424	5	13	80	0.1625000
NODE_61452_length_434_cov_43.214925	344	424	13	4	80	0.0500000
NODE_61452_length_434_cov_43.214925	344	424	14	31	80	0.3875000
NODE_61453_length_434_cov_22.373134	80	160	0	31	80	0.3875000
NODE_61453_length_434_cov_22.373134	80	160	2	3	80	0.0375000
NODE_61453_length_434_cov_22.373134	80	160	4	22	80	0.2750000
NODE_61453_length_434_cov_22.373134	80	160	5	24	80	0.3000000
NODE_61453_length_434_cov_22.373134	133	213	4	3	80	0.0375000
NODE_61453_length_434_cov_22.373134	133	213	5	24	80	0.3000000
NODE_61453_length_434_cov_22.373134	133	213	6	31	80	0.3875000
NODE_61453_length_434_cov_22.373134	133	213	8	22	80	0.2750000
NODE_61455_length_434_cov_11.549254	74	145	2	11	71	0.1549296
NODE_61455_length_434_cov_11.549254	74	145	3	54	71	0.7605634
NODE_61455_length_434_cov_11.549254	74	145	4	6	71	0.0845070
NODE_61455_length_434_cov_11.549254	118	198	2	23	80	0.2875000
NODE_61455_length_434_cov_11.549254	118	198	3	21	80	0.2625000
NODE_61455_length_434_cov_11.549254	118	198	4	36	80	0.4500000
NODE_61477_length_434_cov_4.125373	191	233	0	42	42	1.0000000
NODE_61477_length_434_cov_4.125373	200	235	0	35	35	1.0000000
NODE_61497_length_434_cov_3.104478	191	263	0	72	72	1.0000000
NODE_61528_length_434_cov_2.197015	129	168	0	39	39	1.0000000
NODE_61563_length_434_cov_1.883582	88	133	0	2	45	0.0444444
NODE_61563_length_434_cov_1.883582	88	133	1	4	45	0.0888889
NODE_61563_length_434_cov_1.883582	88	133	2	39	45	0.8666667
NODE_61563_length_434_cov_1.883582	141	182	2	41	41	1.0000000
NODE_61603_length_434_cov_1.626866	163	243	0	32	80	0.4000000
NODE_61603_length_434_cov_1.626866	163	243	2	48	80	0.6000000
NODE_61676_length_434_cov_1.220896	118	198	9	17	80	0.2125000
NODE_61676_length_434_cov_1.220896	118	198	10	8	80	0.1000000
NODE_61676_length_434_cov_1.220896	118	198	11	20	80	0.2500000
NODE_61676_length_434_cov_1.220896	118	198	15	19	80	0.2375000
NODE_61676_length_434_cov_1.220896	118	198	16	16	80	0.2000000
NODE_61727_length_434_cov_1.002985	245	286	0	41	41	1.0000000
NODE_61727_length_434_cov_1.002985	258	339	0	81	81	1.0000000
NODE_61826_length_433_cov_51.392216	2	82	1	6	80	0.0750000
NODE_61826_length_433_cov_51.392216	2	82	2	10	80	0.1250000
NODE_61826_length_433_cov_51.392216	2	82	4	6	80	0.0750000
NODE_61826_length_433_cov_51.392216	2	82	5	2	80	0.0250000
NODE_61826_length_433_cov_51.392216	2	82	6	56	80	0.7000000
NODE_61826_length_433_cov_51.392216	55	135	5	4	80	0.0500000
NODE_61826_length_433_cov_51.392216	55	135	6	29	80	0.3625000
NODE_61826_length_433_cov_51.392216	55	135	7	28	80	0.3500000
NODE_61826_length_433_cov_51.392216	55	135	8	19	80	0.2375000
NODE_61826_length_433_cov_51.392216	131	213	2	37	82	0.4512195
NODE_61826_length_433_cov_51.392216	131	213	3	2	82	0.0243902
NODE_61826_length_433_cov_51.392216	131	213	4	16	82	0.1951219
NODE_61826_length_433_cov_51.392216	131	213	5	27	82	0.3292683
NODE_61826_length_433_cov_51.392216	189	266	0	6	77	0.0779221
NODE_61826_length_433_cov_51.392216	189	266	1	28	77	0.3636364
NODE_61826_length_433_cov_51.392216	189	266	2	43	77	0.5584416
NODE_61827_length_433_cov_46.344311	248	328	6	80	80	1.0000000
NODE_61827_length_433_cov_46.344311	301	381	4	41	80	0.5125000
NODE_61827_length_433_cov_46.344311	301	381	6	39	80	0.4875000
NODE_61828_length_433_cov_41.808383	92	172	2	29	80	0.3625000
NODE_61828_length_433_cov_41.808383	92	172	4	8	80	0.1000000
NODE_61828_length_433_cov_41.808383	92	172	5	9	80	0.1125000
NODE_61828_length_433_cov_41.808383	92	172	6	5	80	0.0625000
NODE_61828_length_433_cov_41.808383	92	172	7	29	80	0.3625000
NODE_61828_length_433_cov_41.808383	145	225	5	5	80	0.0625000
NODE_61828_length_433_cov_41.808383	145	225	6	23	80	0.2875000
NODE_61828_length_433_cov_41.808383	145	225	7	52	80	0.6500000
NODE_61835_length_433_cov_6.227545	157	237	0	80	80	1.0000000
NODE_61836_length_433_cov_6.080838	164	244	0	80	80	1.0000000
NODE_61838_length_433_cov_5.547904	10	80	0	70	70	1.0000000
NODE_61838_length_433_cov_5.547904	51	133	0	82	82	1.0000000
NODE_61839_length_433_cov_5.476048	81	141	6	60	60	1.0000000
NODE_61855_length_433_cov_3.907186	77	107	0	30	30	1.0000000
NODE_61862_length_433_cov_3.595808	231	316	0	85	85	1.0000000
NODE_61864_length_433_cov_3.526946	107	178	0	71	71	1.0000000
NODE_61931_length_433_cov_2.137725	123	203	0	80	80	1.0000000
NODE_62258_length_432_cov_17.540541	150	230	0	80	80	1.0000000
NODE_62258_length_432_cov_17.540541	203	288	0	85	85	1.0000000
NODE_62264_length_432_cov_6.555556	52	82	0	30	30	1.0000000
NODE_62268_length_432_cov_5.720721	77	157	0	80	80	1.0000000
NODE_62268_length_432_cov_5.720721	130	202	0	72	72	1.0000000
NODE_62269_length_432_cov_5.387387	65	95	0	30	30	1.0000000
NODE_62270_length_432_cov_5.345345	271	324	0	53	53	1.0000000
NODE_62293_length_432_cov_3.678679	78	121	0	43	43	1.0000000
NODE_62304_length_432_cov_3.246246	87	128	0	41	41	1.0000000
NODE_62304_length_432_cov_3.246246	101	167	0	66	66	1.0000000
NODE_62396_length_432_cov_1.762763	4	71	0	67	67	1.0000000
NODE_62544_length_432_cov_1.027027	44	68	0	24	24	1.0000000
NODE_62650_length_431_cov_35.355422	202	284	0	82	82	1.0000000
NODE_62650_length_431_cov_35.355422	257	333	0	76	76	1.0000000
NODE_62652_length_431_cov_11.207831	185	265	0	80	80	1.0000000
NODE_62652_length_431_cov_11.207831	238	318	0	80	80	1.0000000
NODE_62657_length_431_cov_7.018072	110	190	0	20	80	0.2500000
NODE_62657_length_431_cov_7.018072	110	190	3	60	80	0.7500000
NODE_62657_length_431_cov_7.018072	163	243	3	32	80	0.4000000
NODE_62657_length_431_cov_7.018072	163	243	6	48	80	0.6000000
NODE_62661_length_431_cov_6.292169	123	203	0	80	80	1.0000000
NODE_62668_length_431_cov_5.608434	170	241	2	10	71	0.1408451
NODE_62668_length_431_cov_5.608434	170	241	4	61	71	0.8591549
NODE_62681_length_431_cov_4.250000	146	216	0	70	70	1.0000000
NODE_62684_length_431_cov_3.993976	210	290	1	32	80	0.4000000
NODE_62684_length_431_cov_3.993976	210	290	4	48	80	0.6000000
NODE_62794_length_431_cov_1.695783	76	156	0	80	80	1.0000000
NODE_62794_length_431_cov_1.695783	129	199	0	70	70	1.0000000
NODE_63043_length_430_cov_49.791541	319	399	3	51	80	0.6375000
NODE_63043_length_430_cov_49.791541	319	399	6	29	80	0.3625000
NODE_63043_length_430_cov_49.791541	372	430	0	30	58	0.5172414
NODE_63043_length_430_cov_49.791541	372	430	3	28	58	0.4827586
NODE_63044_length_430_cov_44.365559	109	189	2	28	80	0.3500000
NODE_63044_length_430_cov_44.365559	109	189	3	27	80	0.3375000
NODE_63044_length_430_cov_44.365559	109	189	4	25	80	0.3125000
NODE_63044_length_430_cov_44.365559	162	242	3	2	80	0.0250000
NODE_63044_length_430_cov_44.365559	162	242	4	78	80	0.9750000
NODE_63045_length_430_cov_16.746224	92	172	0	80	80	1.0000000
NODE_63045_length_430_cov_16.746224	145	225	0	80	80	1.0000000
NODE_63048_length_430_cov_7.737160	180	263	0	83	83	1.0000000
NODE_63050_length_430_cov_6.163142	135	197	0	62	62	1.0000000
NODE_63051_length_430_cov_5.873112	7	90	0	83	83	1.0000000
NODE_63051_length_430_cov_5.873112	60	126	0	66	66	1.0000000
NODE_63066_length_430_cov_4.323263	18	90	0	72	72	1.0000000
NODE_63161_length_430_cov_1.945619	153	233	0	80	80	1.0000000
NODE_63401_length_430_cov_0.664653	391	430	0	39	39	1.0000000
NODE_63437_length_429_cov_10.424242	78	158	0	80	80	1.0000000
NODE_63437_length_429_cov_10.424242	207	287	1	12	80	0.1500000
NODE_63437_length_429_cov_10.424242	207	287	2	31	80	0.3875000
NODE_63437_length_429_cov_10.424242	207	287	4	6	80	0.0750000
NODE_63437_length_429_cov_10.424242	207	287	5	31	80	0.3875000
NODE_63437_length_429_cov_10.424242	260	340	5	32	80	0.4000000
NODE_63437_length_429_cov_10.424242	260	340	7	28	80	0.3500000
NODE_63437_length_429_cov_10.424242	260	340	8	20	80	0.2500000
NODE_63439_length_429_cov_8.957576	213	293	0	80	80	1.0000000
NODE_63439_length_429_cov_8.957576	266	346	0	80	80	1.0000000
NODE_63441_length_429_cov_6.772727	337	366	0	29	29	1.0000000
NODE_63485_length_429_cov_3.003030	173	251	0	78	78	1.0000000
NODE_63516_length_429_cov_2.433333	220	300	0	80	80	1.0000000
NODE_63519_length_429_cov_2.360606	24	85	0	61	61	1.0000000
NODE_63527_length_429_cov_2.224242	115	195	0	80	80	1.0000000
NODE_63547_length_429_cov_2.051515	114	143	0	29	29	1.0000000
NODE_63547_length_429_cov_2.051515	286	348	0	62	62	1.0000000
NODE_63864_length_428_cov_40.449848	217	297	0	80	80	1.0000000
NODE_63864_length_428_cov_40.449848	270	350	0	80	80	1.0000000
NODE_63864_length_428_cov_40.449848	346	426	0	80	80	1.0000000
NODE_63865_length_428_cov_31.066869	249	325	0	76	76	1.0000000
NODE_63865_length_428_cov_31.066869	297	378	0	81	81	1.0000000
NODE_63866_length_428_cov_11.799392	62	142	2	80	80	1.0000000
NODE_63866_length_428_cov_11.799392	115	195	0	6	80	0.0750000
NODE_63866_length_428_cov_11.799392	115	195	2	74	80	0.9250000
NODE_63867_length_428_cov_10.595745	227	307	0	80	80	1.0000000
NODE_63870_length_428_cov_6.784195	344	374	0	30	30	1.0000000
NODE_63871_length_428_cov_6.768997	131	194	0	63	63	1.0000000
NODE_63895_length_428_cov_4.206687	224	304	0	80	80	1.0000000
NODE_63905_length_428_cov_3.525836	168	236	0	68	68	1.0000000
NODE_63905_length_428_cov_3.525836	209	244	0	35	35	1.0000000
NODE_63959_length_428_cov_2.322188	1	42	0	41	41	1.0000000
NODE_63977_length_428_cov_2.124620	228	308	0	80	80	1.0000000
NODE_64011_length_428_cov_1.848024	178	260	0	82	82	1.0000000
NODE_64027_length_428_cov_1.772036	187	255	0	68	68	1.0000000
NODE_64245_length_428_cov_0.790274	275	308	0	33	33	1.0000000
NODE_64245_length_428_cov_0.790274	276	302	0	26	26	1.0000000
NODE_64310_length_427_cov_29.628049	312	392	0	80	80	1.0000000
NODE_64310_length_427_cov_29.628049	365	427	0	62	62	1.0000000
NODE_64310_length_427_cov_29.628049	365	427	0	62	62	1.0000000
NODE_64312_length_427_cov_9.371951	184	239	0	55	55	1.0000000
NODE_64313_length_427_cov_9.359756	11	82	0	71	71	1.0000000
NODE_64313_length_427_cov_9.359756	70	149	0	79	79	1.0000000
NODE_64313_length_427_cov_9.359756	145	225	0	40	80	0.5000000
NODE_64313_length_427_cov_9.359756	145	225	1	40	80	0.5000000
NODE_64313_length_427_cov_9.359756	198	278	1	34	80	0.4250000
NODE_64313_length_427_cov_9.359756	198	278	2	46	80	0.5750000
NODE_64321_length_427_cov_5.929878	405	424	0	19	19	1.0000000
NODE_64324_length_427_cov_5.088415	257	332	0	75	75	1.0000000
NODE_64345_length_427_cov_3.884146	212	260	0	48	48	1.0000000
NODE_64383_length_427_cov_2.765244	312	363	0	51	51	1.0000000
NODE_64409_length_427_cov_2.362805	142	177	1	35	35	1.0000000
NODE_64537_length_427_cov_1.359756	56	139	0	83	83	1.0000000
NODE_64728_length_426_cov_21.837920	178	258	0	80	80	1.0000000
NODE_64729_length_426_cov_16.850153	76	156	1	80	80	1.0000000
NODE_64729_length_426_cov_16.850153	129	209	0	13	80	0.1625000
NODE_64729_length_426_cov_16.850153	129	209	1	67	80	0.8375000
NODE_64731_length_426_cov_9.033639	152	232	0	80	80	1.0000000
NODE_64731_length_426_cov_9.033639	205	285	0	80	80	1.0000000
NODE_64734_length_426_cov_8.314985	133	213	0	80	80	1.0000000
NODE_64734_length_426_cov_8.314985	186	266	0	80	80	1.0000000
NODE_64735_length_426_cov_8.278287	132	212	0	80	80	1.0000000
NODE_64735_length_426_cov_8.278287	185	265	0	80	80	1.0000000
NODE_64752_length_426_cov_4.926606	116	196	0	80	80	1.0000000
NODE_64754_length_426_cov_4.743119	119	199	1	65	80	0.8125000
NODE_64754_length_426_cov_4.743119	119	199	2	15	80	0.1875000
NODE_64754_length_426_cov_4.743119	172	252	1	80	80	1.0000000
NODE_64833_length_426_cov_2.278287	92	132	0	40	40	1.0000000
NODE_64833_length_426_cov_2.278287	139	205	0	66	66	1.0000000
NODE_64865_length_426_cov_1.896024	80	154	0	37	74	0.5000000
NODE_64865_length_426_cov_1.896024	80	154	1	37	74	0.5000000
NODE_64948_length_426_cov_1.397554	240	290	0	50	50	1.0000000
NODE_65135_length_426_cov_0.602446	127	158	0	31	31	1.0000000
NODE_65152_length_425_cov_63.938650	0	61	1	4	61	0.0655738
NODE_65152_length_425_cov_63.938650	0	61	2	2	61	0.0327869
NODE_65152_length_425_cov_63.938650	0	61	4	2	61	0.0327869
NODE_65152_length_425_cov_63.938650	0	61	6	2	61	0.0327869
NODE_65152_length_425_cov_63.938650	0	61	8	1	61	0.0163934
NODE_65152_length_425_cov_63.938650	0	61	9	2	61	0.0327869
NODE_65152_length_425_cov_63.938650	0	61	10	13	61	0.2131148
NODE_65152_length_425_cov_63.938650	0	61	11	1	61	0.0163934
NODE_65152_length_425_cov_63.938650	0	61	13	2	61	0.0327869
NODE_65152_length_425_cov_63.938650	0	61	16	27	61	0.4426230
NODE_65152_length_425_cov_63.938650	0	61	17	2	61	0.0327869
NODE_65152_length_425_cov_63.938650	0	61	19	3	61	0.0491803
NODE_65152_length_425_cov_63.938650	34	114	16	22	80	0.2750000
NODE_65152_length_425_cov_63.938650	34	114	17	2	80	0.0250000
NODE_65152_length_425_cov_63.938650	34	114	19	19	80	0.2375000
NODE_65152_length_425_cov_63.938650	34	114	20	37	80	0.4625000
NODE_65164_length_425_cov_4.877301	171	229	5	42	58	0.7241379
NODE_65164_length_425_cov_4.877301	171	229	6	16	58	0.2758621
NODE_65165_length_425_cov_4.822086	295	377	0	82	82	1.0000000
NODE_65218_length_425_cov_2.809816	38	118	0	80	80	1.0000000
NODE_65278_length_425_cov_1.935583	93	138	0	45	45	1.0000000
NODE_65278_length_425_cov_1.935583	170	225	0	55	55	1.0000000
NODE_65278_length_425_cov_1.935583	312	355	0	43	43	1.0000000
NODE_65565_length_425_cov_0.628834	104	131	0	27	27	1.0000000
NODE_65602_length_424_cov_5.295385	224	270	1	31	46	0.6739131
NODE_65602_length_424_cov_5.295385	224	270	2	15	46	0.3260870
NODE_65634_length_424_cov_3.255385	266	329	0	63	63	1.0000000
NODE_65669_length_424_cov_2.578462	403	422	0	19	19	1.0000000
NODE_65670_length_424_cov_2.578462	122	144	0	22	22	1.0000000
NODE_66111_length_423_cov_2.728395	150	229	0	79	79	1.0000000
NODE_66181_length_423_cov_1.879630	94	142	1	13	48	0.2708333
NODE_66181_length_423_cov_1.879630	94	142	2	35	48	0.7291667
NODE_66222_length_423_cov_1.580247	128	208	0	80	80	1.0000000
NODE_66258_length_423_cov_1.410494	206	286	0	80	80	1.0000000
NODE_66459_length_422_cov_12.021672	201	236	0	35	35	1.0000000
NODE_66459_length_422_cov_12.021672	247	289	0	42	42	1.0000000
NODE_66460_length_422_cov_10.712074	62	140	3	21	78	0.2692308
NODE_66460_length_422_cov_10.712074	62	140	4	21	78	0.2692308
NODE_66460_length_422_cov_10.712074	62	140	5	1	78	0.0128205
NODE_66460_length_422_cov_10.712074	62	140	6	2	78	0.0256410
NODE_66460_length_422_cov_10.712074	62	140	8	33	78	0.4230769
NODE_66460_length_422_cov_10.712074	115	195	5	13	80	0.1625000
NODE_66460_length_422_cov_10.712074	115	195	6	2	80	0.0250000
NODE_66460_length_422_cov_10.712074	115	195	8	65	80	0.8125000
NODE_66468_length_422_cov_6.281734	37	117	0	4	80	0.0500000
NODE_66468_length_422_cov_6.281734	37	117	2	76	80	0.9500000
NODE_66468_length_422_cov_6.281734	90	170	0	2	80	0.0250000
NODE_66468_length_422_cov_6.281734	90	170	2	78	80	0.9750000
NODE_66474_length_422_cov_5.266254	176	256	0	80	80	1.0000000
NODE_66485_length_422_cov_4.148607	159	224	0	65	65	1.0000000
NODE_66485_length_422_cov_4.148607	197	277	0	80	80	1.0000000
NODE_66488_length_422_cov_4.003096	146	226	0	80	80	1.0000000
NODE_66488_length_422_cov_4.003096	199	279	0	80	80	1.0000000
NODE_66512_length_422_cov_3.130031	93	173	2	80	80	1.0000000
NODE_66512_length_422_cov_3.130031	146	226	1	10	80	0.1250000
NODE_66512_length_422_cov_3.130031	146	226	2	70	80	0.8750000
NODE_66515_length_422_cov_3.077399	291	359	0	68	68	1.0000000
NODE_66550_length_422_cov_2.191950	5	24	0	19	19	1.0000000
NODE_66560_length_422_cov_2.108359	97	177	0	80	80	1.0000000
NODE_66560_length_422_cov_2.108359	150	189	0	39	39	1.0000000
NODE_66560_length_422_cov_2.108359	249	289	1	3	40	0.0750000
NODE_66560_length_422_cov_2.108359	249	289	2	37	40	0.9250000
NODE_66806_length_422_cov_0.845201	2	76	0	74	74	1.0000000
NODE_66869_length_421_cov_10.664596	178	256	0	78	78	1.0000000
NODE_66869_length_421_cov_10.664596	229	309	0	80	80	1.0000000
NODE_66874_length_421_cov_7.552795	325	407	0	80	82	0.9756098
NODE_66874_length_421_cov_7.552795	325	407	1	2	82	0.0243902
NODE_66874_length_421_cov_7.552795	380	421	0	41	41	1.0000000
NODE_66875_length_421_cov_7.431677	96	118	0	22	22	1.0000000
NODE_66883_length_421_cov_5.279503	245	310	0	65	65	1.0000000
NODE_66884_length_421_cov_5.158385	68	145	0	77	77	1.0000000
NODE_66897_length_421_cov_4.114907	221	287	0	66	66	1.0000000
NODE_66898_length_421_cov_4.102484	202	277	0	75	75	1.0000000
NODE_66899_length_421_cov_4.040373	192	272	0	80	80	1.0000000
NODE_66899_length_421_cov_4.040373	245	314	0	69	69	1.0000000
NODE_66923_length_421_cov_3.319876	0	57	0	57	57	1.0000000
NODE_66955_length_421_cov_2.708075	95	118	3	11	23	0.4782609
NODE_66955_length_421_cov_2.708075	95	118	4	12	23	0.5217391
NODE_66955_length_421_cov_2.708075	109	189	3	80	80	1.0000000
NODE_66955_length_421_cov_2.708075	248	300	0	52	52	1.0000000
NODE_67073_length_421_cov_1.559006	240	309	0	69	69	1.0000000
NODE_67073_length_421_cov_1.559006	240	310	0	70	70	1.0000000
NODE_67077_length_421_cov_1.537267	305	383	0	78	78	1.0000000
NODE_67098_length_421_cov_1.413043	254	303	0	49	49	1.0000000
NODE_67283_length_421_cov_0.633540	132	156	0	24	24	1.0000000
NODE_67317_length_420_cov_80.766355	90	170	1	7	80	0.0875000
NODE_67317_length_420_cov_80.766355	90	170	2	7	80	0.0875000
NODE_67317_length_420_cov_80.766355	90	170	4	14	80	0.1750000
NODE_67317_length_420_cov_80.766355	90	170	5	22	80	0.2750000
NODE_67317_length_420_cov_80.766355	90	170	7	2	80	0.0250000
NODE_67317_length_420_cov_80.766355	90	170	8	28	80	0.3500000
NODE_67317_length_420_cov_80.766355	143	223	8	57	80	0.7125000
NODE_67317_length_420_cov_80.766355	143	223	9	14	80	0.1750000
NODE_67317_length_420_cov_80.766355	143	223	11	9	80	0.1125000
NODE_67319_length_420_cov_51.473520	171	250	0	79	79	1.0000000
NODE_67319_length_420_cov_51.473520	223	307	0	84	84	1.0000000
NODE_67319_length_420_cov_51.473520	303	383	0	80	80	1.0000000
NODE_67319_length_420_cov_51.473520	356	420	0	64	64	1.0000000
NODE_67330_length_420_cov_5.071651	230	310	2	8	80	0.1000000
NODE_67330_length_420_cov_5.071651	230	310	4	18	80	0.2250000
NODE_67330_length_420_cov_5.071651	230	310	5	38	80	0.4750000
NODE_67330_length_420_cov_5.071651	230	310	7	12	80	0.1500000
NODE_67330_length_420_cov_5.071651	230	310	9	4	80	0.0500000
NODE_67334_length_420_cov_4.775701	177	221	0	44	44	1.0000000
NODE_67345_length_420_cov_4.037383	161	240	0	79	79	1.0000000
NODE_67358_length_420_cov_3.657321	291	373	0	82	82	1.0000000
NODE_67398_length_420_cov_2.542056	96	176	0	80	80	1.0000000
NODE_67398_length_420_cov_2.542056	148	202	0	54	54	1.0000000
NODE_67398_length_420_cov_2.542056	149	195	0	46	46	1.0000000
NODE_67414_length_420_cov_2.323988	89	108	0	19	19	1.0000000
NODE_67506_length_420_cov_1.641745	277	312	0	35	35	1.0000000
NODE_67547_length_420_cov_1.429907	15	68	1	53	53	1.0000000
NODE_67547_length_420_cov_1.429907	69	111	1	42	42	1.0000000
NODE_67770_length_419_cov_491.015625	0	67	7	1	67	0.0149254
NODE_67770_length_419_cov_491.015625	0	67	10	2	67	0.0298507
NODE_67770_length_419_cov_491.015625	0	67	12	1	67	0.0149254
NODE_67770_length_419_cov_491.015625	0	67	13	3	67	0.0447761
NODE_67770_length_419_cov_491.015625	0	67	14	14	67	0.2089552
NODE_67770_length_419_cov_491.015625	0	67	15	8	67	0.1194030
NODE_67770_length_419_cov_491.015625	0	67	18	1	67	0.0149254
NODE_67770_length_419_cov_491.015625	0	67	23	1	67	0.0149254
NODE_67770_length_419_cov_491.015625	0	67	25	6	67	0.0895522
NODE_67770_length_419_cov_491.015625	0	67	27	5	67	0.0746269
NODE_67770_length_419_cov_491.015625	0	67	32	1	67	0.0149254
NODE_67770_length_419_cov_491.015625	0	67	37	3	67	0.0447761
NODE_67770_length_419_cov_491.015625	0	67	38	1	67	0.0149254
NODE_67770_length_419_cov_491.015625	0	67	39	5	67	0.0746269
NODE_67770_length_419_cov_491.015625	0	67	40	1	67	0.0149254
NODE_67770_length_419_cov_491.015625	0	67	43	6	67	0.0895522
NODE_67770_length_419_cov_491.015625	0	67	44	3	67	0.0447761
NODE_67770_length_419_cov_491.015625	0	67	45	1	67	0.0149254
NODE_67770_length_419_cov_491.015625	0	67	47	4	67	0.0597015
NODE_67770_length_419_cov_491.015625	0	67	7	1	67	0.0149254
NODE_67770_length_419_cov_491.015625	0	67	10	2	67	0.0298507
NODE_67770_length_419_cov_491.015625	0	67	12	1	67	0.0149254
NODE_67770_length_419_cov_491.015625	0	67	13	3	67	0.0447761
NODE_67770_length_419_cov_491.015625	0	67	14	14	67	0.2089552
NODE_67770_length_419_cov_491.015625	0	67	15	8	67	0.1194030
NODE_67770_length_419_cov_491.015625	0	67	18	1	67	0.0149254
NODE_67770_length_419_cov_491.015625	0	67	23	1	67	0.0149254
NODE_67770_length_419_cov_491.015625	0	67	25	6	67	0.0895522
NODE_67770_length_419_cov_491.015625	0	67	27	5	67	0.0746269
NODE_67770_length_419_cov_491.015625	0	67	32	1	67	0.0149254
NODE_67770_length_419_cov_491.015625	0	67	37	3	67	0.0447761
NODE_67770_length_419_cov_491.015625	0	67	38	1	67	0.0149254
NODE_67770_length_419_cov_491.015625	0	67	39	5	67	0.0746269
NODE_67770_length_419_cov_491.015625	0	67	40	1	67	0.0149254
NODE_67770_length_419_cov_491.015625	0	67	43	6	67	0.0895522
NODE_67770_length_419_cov_491.015625	0	67	44	3	67	0.0447761
NODE_67770_length_419_cov_491.015625	0	67	45	1	67	0.0149254
NODE_67770_length_419_cov_491.015625	0	67	47	4	67	0.0597015
NODE_67770_length_419_cov_491.015625	0	67	7	1	67	0.0149254
NODE_67770_length_419_cov_491.015625	0	67	10	2	67	0.0298507
NODE_67770_length_419_cov_491.015625	0	67	12	1	67	0.0149254
NODE_67770_length_419_cov_491.015625	0	67	13	3	67	0.0447761
NODE_67770_length_419_cov_491.015625	0	67	14	14	67	0.2089552
NODE_67770_length_419_cov_491.015625	0	67	15	8	67	0.1194030
NODE_67770_length_419_cov_491.015625	0	67	18	1	67	0.0149254
NODE_67770_length_419_cov_491.015625	0	67	23	1	67	0.0149254
NODE_67770_length_419_cov_491.015625	0	67	25	6	67	0.0895522
NODE_67770_length_419_cov_491.015625	0	67	27	5	67	0.0746269
NODE_67770_length_419_cov_491.015625	0	67	32	1	67	0.0149254
NODE_67770_length_419_cov_491.015625	0	67	37	3	67	0.0447761
NODE_67770_length_419_cov_491.015625	0	67	38	1	67	0.0149254
NODE_67770_length_419_cov_491.015625	0	67	39	5	67	0.0746269
NODE_67770_length_419_cov_491.015625	0	67	40	1	67	0.0149254
NODE_67770_length_419_cov_491.015625	0	67	43	6	67	0.0895522
NODE_67770_length_419_cov_491.015625	0	67	44	3	67	0.0447761
NODE_67770_length_419_cov_491.015625	0	67	45	1	67	0.0149254
NODE_67770_length_419_cov_491.015625	0	67	47	4	67	0.0597015
NODE_67770_length_419_cov_491.015625	0	67	7	1	67	0.0149254
NODE_67770_length_419_cov_491.015625	0	67	10	2	67	0.0298507
NODE_67770_length_419_cov_491.015625	0	67	12	1	67	0.0149254
NODE_67770_length_419_cov_491.015625	0	67	13	3	67	0.0447761
NODE_67770_length_419_cov_491.015625	0	67	14	14	67	0.2089552
NODE_67770_length_419_cov_491.015625	0	67	15	8	67	0.1194030
NODE_67770_length_419_cov_491.015625	0	67	18	1	67	0.0149254
NODE_67770_length_419_cov_491.015625	0	67	23	1	67	0.0149254
NODE_67770_length_419_cov_491.015625	0	67	25	6	67	0.0895522
NODE_67770_length_419_cov_491.015625	0	67	27	5	67	0.0746269
NODE_67770_length_419_cov_491.015625	0	67	32	1	67	0.0149254
NODE_67770_length_419_cov_491.015625	0	67	37	3	67	0.0447761
NODE_67770_length_419_cov_491.015625	0	67	38	1	67	0.0149254
NODE_67770_length_419_cov_491.015625	0	67	39	5	67	0.0746269
NODE_67770_length_419_cov_491.015625	0	67	40	1	67	0.0149254
NODE_67770_length_419_cov_491.015625	0	67	43	6	67	0.0895522
NODE_67770_length_419_cov_491.015625	0	67	44	3	67	0.0447761
NODE_67770_length_419_cov_491.015625	0	67	45	1	67	0.0149254
NODE_67770_length_419_cov_491.015625	0	67	47	4	67	0.0597015
NODE_67770_length_419_cov_491.015625	63	143	47	8	80	0.1000000
NODE_67770_length_419_cov_491.015625	63	143	48	2	80	0.0250000
NODE_67770_length_419_cov_491.015625	63	143	49	1	80	0.0125000
NODE_67770_length_419_cov_491.015625	63	143	50	6	80	0.0750000
NODE_67770_length_419_cov_491.015625	63	143	53	1	80	0.0125000
NODE_67770_length_419_cov_491.015625	63	143	57	4	80	0.0500000
NODE_67770_length_419_cov_491.015625	63	143	60	4	80	0.0500000
NODE_67770_length_419_cov_491.015625	63	143	61	2	80	0.0250000
NODE_67770_length_419_cov_491.015625	63	143	63	1	80	0.0125000
NODE_67770_length_419_cov_491.015625	63	143	66	1	80	0.0125000
NODE_67770_length_419_cov_491.015625	63	143	68	1	80	0.0125000
NODE_67770_length_419_cov_491.015625	63	143	69	6	80	0.0750000
NODE_67770_length_419_cov_491.015625	63	143	71	2	80	0.0250000
NODE_67770_length_419_cov_491.015625	63	143	72	1	80	0.0125000
NODE_67770_length_419_cov_491.015625	63	143	73	1	80	0.0125000
NODE_67770_length_419_cov_491.015625	63	143	78	1	80	0.0125000
NODE_67770_length_419_cov_491.015625	63	143	79	2	80	0.0250000
NODE_67770_length_419_cov_491.015625	63	143	80	1	80	0.0125000
NODE_67770_length_419_cov_491.015625	63	143	82	3	80	0.0375000
NODE_67770_length_419_cov_491.015625	63	143	83	1	80	0.0125000
NODE_67770_length_419_cov_491.015625	63	143	85	1	80	0.0125000
NODE_67770_length_419_cov_491.015625	63	143	86	1	80	0.0125000
NODE_67770_length_419_cov_491.015625	63	143	88	2	80	0.0250000
NODE_67770_length_419_cov_491.015625	63	143	89	4	80	0.0500000
NODE_67770_length_419_cov_491.015625	63	143	90	3	80	0.0375000
NODE_67770_length_419_cov_491.015625	63	143	91	2	80	0.0250000
NODE_67770_length_419_cov_491.015625	63	143	93	3	80	0.0375000
NODE_67770_length_419_cov_491.015625	63	143	94	3	80	0.0375000
NODE_67770_length_419_cov_491.015625	63	143	95	1	80	0.0125000
NODE_67770_length_419_cov_491.015625	63	143	96	3	80	0.0375000
NODE_67770_length_419_cov_491.015625	63	143	100	1	80	0.0125000
NODE_67770_length_419_cov_491.015625	63	143	101	7	80	0.0875000
NODE_67770_length_419_cov_491.015625	63	143	47	8	80	0.1000000
NODE_67770_length_419_cov_491.015625	63	143	48	2	80	0.0250000
NODE_67770_length_419_cov_491.015625	63	143	49	1	80	0.0125000
NODE_67770_length_419_cov_491.015625	63	143	50	6	80	0.0750000
NODE_67770_length_419_cov_491.015625	63	143	53	1	80	0.0125000
NODE_67770_length_419_cov_491.015625	63	143	57	4	80	0.0500000
NODE_67770_length_419_cov_491.015625	63	143	60	4	80	0.0500000
NODE_67770_length_419_cov_491.015625	63	143	61	2	80	0.0250000
NODE_67770_length_419_cov_491.015625	63	143	63	1	80	0.0125000
NODE_67770_length_419_cov_491.015625	63	143	66	1	80	0.0125000
NODE_67770_length_419_cov_491.015625	63	143	68	1	80	0.0125000
NODE_67770_length_419_cov_491.015625	63	143	69	6	80	0.0750000
NODE_67770_length_419_cov_491.015625	63	143	71	2	80	0.0250000
NODE_67770_length_419_cov_491.015625	63	143	72	1	80	0.0125000
NODE_67770_length_419_cov_491.015625	63	143	73	1	80	0.0125000
NODE_67770_length_419_cov_491.015625	63	143	78	1	80	0.0125000
NODE_67770_length_419_cov_491.015625	63	143	79	2	80	0.0250000
NODE_67770_length_419_cov_491.015625	63	143	80	1	80	0.0125000
NODE_67770_length_419_cov_491.015625	63	143	82	3	80	0.0375000
NODE_67770_length_419_cov_491.015625	63	143	83	1	80	0.0125000
NODE_67770_length_419_cov_491.015625	63	143	85	1	80	0.0125000
NODE_67770_length_419_cov_491.015625	63	143	86	1	80	0.0125000
NODE_67770_length_419_cov_491.015625	63	143	88	2	80	0.0250000
NODE_67770_length_419_cov_491.015625	63	143	89	4	80	0.0500000
NODE_67770_length_419_cov_491.015625	63	143	90	3	80	0.0375000
NODE_67770_length_419_cov_491.015625	63	143	91	2	80	0.0250000
NODE_67770_length_419_cov_491.015625	63	143	93	3	80	0.0375000
NODE_67770_length_419_cov_491.015625	63	143	94	3	80	0.0375000
NODE_67770_length_419_cov_491.015625	63	143	95	1	80	0.0125000
NODE_67770_length_419_cov_491.015625	63	143	96	3	80	0.0375000
NODE_67770_length_419_cov_491.015625	63	143	100	1	80	0.0125000
NODE_67770_length_419_cov_491.015625	63	143	101	7	80	0.0875000
NODE_67770_length_419_cov_491.015625	63	143	47	8	80	0.1000000
NODE_67770_length_419_cov_491.015625	63	143	48	2	80	0.0250000
NODE_67770_length_419_cov_491.015625	63	143	49	1	80	0.0125000
NODE_67770_length_419_cov_491.015625	63	143	50	6	80	0.0750000
NODE_67770_length_419_cov_491.015625	63	143	53	1	80	0.0125000
NODE_67770_length_419_cov_491.015625	63	143	57	4	80	0.0500000
NODE_67770_length_419_cov_491.015625	63	143	60	4	80	0.0500000
NODE_67770_length_419_cov_491.015625	63	143	61	2	80	0.0250000
NODE_67770_length_419_cov_491.015625	63	143	63	1	80	0.0125000
NODE_67770_length_419_cov_491.015625	63	143	66	1	80	0.0125000
NODE_67770_length_419_cov_491.015625	63	143	68	1	80	0.0125000
NODE_67770_length_419_cov_491.015625	63	143	69	6	80	0.0750000
NODE_67770_length_419_cov_491.015625	63	143	71	2	80	0.0250000
NODE_67770_length_419_cov_491.015625	63	143	72	1	80	0.0125000
NODE_67770_length_419_cov_491.015625	63	143	73	1	80	0.0125000
NODE_67770_length_419_cov_491.015625	63	143	78	1	80	0.0125000
NODE_67770_length_419_cov_491.015625	63	143	79	2	80	0.0250000
NODE_67770_length_419_cov_491.015625	63	143	80	1	80	0.0125000
NODE_67770_length_419_cov_491.015625	63	143	82	3	80	0.0375000
NODE_67770_length_419_cov_491.015625	63	143	83	1	80	0.0125000
NODE_67770_length_419_cov_491.015625	63	143	85	1	80	0.0125000
NODE_67770_length_419_cov_491.015625	63	143	86	1	80	0.0125000
NODE_67770_length_419_cov_491.015625	63	143	88	2	80	0.0250000
NODE_67770_length_419_cov_491.015625	63	143	89	4	80	0.0500000
NODE_67770_length_419_cov_491.015625	63	143	90	3	80	0.0375000
NODE_67770_length_419_cov_491.015625	63	143	91	2	80	0.0250000
NODE_67770_length_419_cov_491.015625	63	143	93	3	80	0.0375000
NODE_67770_length_419_cov_491.015625	63	143	94	3	80	0.0375000
NODE_67770_length_419_cov_491.015625	63	143	95	1	80	0.0125000
NODE_67770_length_419_cov_491.015625	63	143	96	3	80	0.0375000
NODE_67770_length_419_cov_491.015625	63	143	100	1	80	0.0125000
NODE_67770_length_419_cov_491.015625	63	143	101	7	80	0.0875000
NODE_67770_length_419_cov_491.015625	116	196	88	3	80	0.0375000
NODE_67770_length_419_cov_491.015625	116	196	89	4	80	0.0500000
NODE_67770_length_419_cov_491.015625	116	196	90	3	80	0.0375000
NODE_67770_length_419_cov_491.015625	116	196	91	2	80	0.0250000
NODE_67770_length_419_cov_491.015625	116	196	92	1	80	0.0125000
NODE_67770_length_419_cov_491.015625	116	196	93	8	80	0.1000000
NODE_67770_length_419_cov_491.015625	116	196	94	7	80	0.0875000
NODE_67770_length_419_cov_491.015625	116	196	95	5	80	0.0625000
NODE_67770_length_419_cov_491.015625	116	196	96	3	80	0.0375000
NODE_67770_length_419_cov_491.015625	116	196	97	14	80	0.1750000
NODE_67770_length_419_cov_491.015625	116	196	98	14	80	0.1750000
NODE_67770_length_419_cov_491.015625	116	196	100	3	80	0.0375000
NODE_67770_length_419_cov_491.015625	116	196	101	9	80	0.1125000
NODE_67770_length_419_cov_491.015625	116	196	102	2	80	0.0250000
NODE_67770_length_419_cov_491.015625	116	196	103	2	80	0.0250000
NODE_67770_length_419_cov_491.015625	116	196	88	3	80	0.0375000
NODE_67770_length_419_cov_491.015625	116	196	89	4	80	0.0500000
NODE_67770_length_419_cov_491.015625	116	196	90	3	80	0.0375000
NODE_67770_length_419_cov_491.015625	116	196	91	2	80	0.0250000
NODE_67770_length_419_cov_491.015625	116	196	92	1	80	0.0125000
NODE_67770_length_419_cov_491.015625	116	196	93	8	80	0.1000000
NODE_67770_length_419_cov_491.015625	116	196	94	7	80	0.0875000
NODE_67770_length_419_cov_491.015625	116	196	95	5	80	0.0625000
NODE_67770_length_419_cov_491.015625	116	196	96	3	80	0.0375000
NODE_67770_length_419_cov_491.015625	116	196	97	14	80	0.1750000
NODE_67770_length_419_cov_491.015625	116	196	98	14	80	0.1750000
NODE_67770_length_419_cov_491.015625	116	196	100	3	80	0.0375000
NODE_67770_length_419_cov_491.015625	116	196	101	9	80	0.1125000
NODE_67770_length_419_cov_491.015625	116	196	102	2	80	0.0250000
NODE_67770_length_419_cov_491.015625	116	196	103	2	80	0.0250000
NODE_67770_length_419_cov_491.015625	116	196	88	3	80	0.0375000
NODE_67770_length_419_cov_491.015625	116	196	89	4	80	0.0500000
NODE_67770_length_419_cov_491.015625	116	196	90	3	80	0.0375000
NODE_67770_length_419_cov_491.015625	116	196	91	2	80	0.0250000
NODE_67770_length_419_cov_491.015625	116	196	92	1	80	0.0125000
NODE_67770_length_419_cov_491.015625	116	196	93	8	80	0.1000000
NODE_67770_length_419_cov_491.015625	116	196	94	7	80	0.0875000
NODE_67770_length_419_cov_491.015625	116	196	95	5	80	0.0625000
NODE_67770_length_419_cov_491.015625	116	196	96	3	80	0.0375000
NODE_67770_length_419_cov_491.015625	116	196	97	14	80	0.1750000
NODE_67770_length_419_cov_491.015625	116	196	98	14	80	0.1750000
NODE_67770_length_419_cov_491.015625	116	196	100	3	80	0.0375000
NODE_67770_length_419_cov_491.015625	116	196	101	9	80	0.1125000
NODE_67770_length_419_cov_491.015625	116	196	102	2	80	0.0250000
NODE_67770_length_419_cov_491.015625	116	196	103	2	80	0.0250000
NODE_67770_length_419_cov_491.015625	116	196	88	3	80	0.0375000
NODE_67770_length_419_cov_491.015625	116	196	89	4	80	0.0500000
NODE_67770_length_419_cov_491.015625	116	196	90	3	80	0.0375000
NODE_67770_length_419_cov_491.015625	116	196	91	2	80	0.0250000
NODE_67770_length_419_cov_491.015625	116	196	92	1	80	0.0125000
NODE_67770_length_419_cov_491.015625	116	196	93	8	80	0.1000000
NODE_67770_length_419_cov_491.015625	116	196	94	7	80	0.0875000
NODE_67770_length_419_cov_491.015625	116	196	95	5	80	0.0625000
NODE_67770_length_419_cov_491.015625	116	196	96	3	80	0.0375000
NODE_67770_length_419_cov_491.015625	116	196	97	14	80	0.1750000
NODE_67770_length_419_cov_491.015625	116	196	98	14	80	0.1750000
NODE_67770_length_419_cov_491.015625	116	196	100	3	80	0.0375000
NODE_67770_length_419_cov_491.015625	116	196	101	9	80	0.1125000
NODE_67770_length_419_cov_491.015625	116	196	102	2	80	0.0250000
NODE_67770_length_419_cov_491.015625	116	196	103	2	80	0.0250000
NODE_67770_length_419_cov_491.015625	116	196	88	3	80	0.0375000
NODE_67770_length_419_cov_491.015625	116	196	89	4	80	0.0500000
NODE_67770_length_419_cov_491.015625	116	196	90	3	80	0.0375000
NODE_67770_length_419_cov_491.015625	116	196	91	2	80	0.0250000
NODE_67770_length_419_cov_491.015625	116	196	92	1	80	0.0125000
NODE_67770_length_419_cov_491.015625	116	196	93	8	80	0.1000000
NODE_67770_length_419_cov_491.015625	116	196	94	7	80	0.0875000
NODE_67770_length_419_cov_491.015625	116	196	95	5	80	0.0625000
NODE_67770_length_419_cov_491.015625	116	196	96	3	80	0.0375000
NODE_67770_length_419_cov_491.015625	116	196	97	14	80	0.1750000
NODE_67770_length_419_cov_491.015625	116	196	98	14	80	0.1750000
NODE_67770_length_419_cov_491.015625	116	196	100	3	80	0.0375000
NODE_67770_length_419_cov_491.015625	116	196	101	9	80	0.1125000
NODE_67770_length_419_cov_491.015625	116	196	102	2	80	0.0250000
NODE_67770_length_419_cov_491.015625	116	196	103	2	80	0.0250000
NODE_67772_length_419_cov_31.725000	12	92	0	80	80	1.0000000
NODE_67772_length_419_cov_31.725000	65	145	0	80	80	1.0000000
NODE_67789_length_419_cov_4.862500	47	103	0	56	56	1.0000000
NODE_67789_length_419_cov_4.862500	258	327	0	69	69	1.0000000
NODE_67789_length_419_cov_4.862500	284	328	0	44	44	1.0000000
NODE_67803_length_419_cov_4.193750	215	262	2	47	47	1.0000000
NODE_67803_length_419_cov_4.193750	235	275	2	40	40	1.0000000
NODE_67817_length_419_cov_3.696875	165	215	1	16	50	0.3200000
NODE_67817_length_419_cov_3.696875	165	215	2	11	50	0.2200000
NODE_67817_length_419_cov_3.696875	165	215	3	23	50	0.4600000
NODE_67854_length_419_cov_2.628125	234	314	0	18	80	0.2250000
NODE_67854_length_419_cov_2.628125	234	314	9	62	80	0.7750000
NODE_67856_length_419_cov_2.603125	154	196	0	42	42	1.0000000
NODE_67878_length_419_cov_2.350000	156	220	2	15	64	0.2343750
NODE_67878_length_419_cov_2.350000	156	220	3	2	64	0.0312500
NODE_67878_length_419_cov_2.350000	156	220	4	47	64	0.7343750
NODE_67961_length_419_cov_1.593750	339	358	0	19	19	1.0000000
NODE_68250_length_418_cov_63.059561	105	186	1	81	81	1.0000000
NODE_68250_length_418_cov_63.059561	159	239	1	55	80	0.6875000
NODE_68250_length_418_cov_63.059561	159	239	2	25	80	0.3125000
NODE_68251_length_418_cov_49.796238	325	405	0	1	80	0.0125000
NODE_68251_length_418_cov_49.796238	325	405	1	12	80	0.1500000
NODE_68251_length_418_cov_49.796238	325	405	4	6	80	0.0750000
NODE_68251_length_418_cov_49.796238	325	405	5	8	80	0.1000000
NODE_68251_length_418_cov_49.796238	325	405	6	14	80	0.1750000
NODE_68251_length_418_cov_49.796238	325	405	7	4	80	0.0500000
NODE_68251_length_418_cov_49.796238	325	405	8	35	80	0.4375000
NODE_68251_length_418_cov_49.796238	378	415	0	11	37	0.2972973
NODE_68251_length_418_cov_49.796238	378	415	1	12	37	0.3243243
NODE_68251_length_418_cov_49.796238	378	415	4	6	37	0.1621622
NODE_68251_length_418_cov_49.796238	378	415	5	8	37	0.2162162
NODE_68252_length_418_cov_42.764890	119	196	0	77	77	1.0000000
NODE_68252_length_418_cov_42.764890	172	250	0	78	78	1.0000000
NODE_68253_length_418_cov_23.830721	73	153	4	80	80	1.0000000
NODE_68253_length_418_cov_23.830721	126	200	4	74	74	1.0000000
NODE_68255_length_418_cov_7.216301	211	291	0	45	80	0.5625000
NODE_68255_length_418_cov_7.216301	211	291	2	35	80	0.4375000
NODE_68265_length_418_cov_5.382445	134	215	0	13	81	0.1604938
NODE_68265_length_418_cov_5.382445	134	215	1	68	81	0.8395061
NODE_68265_length_418_cov_5.382445	187	268	1	81	81	1.0000000
NODE_68275_length_418_cov_4.463950	191	272	1	15	81	0.1851852
NODE_68275_length_418_cov_4.463950	191	272	2	66	81	0.8148148
NODE_68280_length_418_cov_4.216301	148	230	0	82	82	1.0000000
NODE_68281_length_418_cov_4.065831	211	280	0	69	69	1.0000000
NODE_68284_length_418_cov_3.909091	95	175	5	11	80	0.1375000
NODE_68284_length_418_cov_3.909091	95	175	6	61	80	0.7625000
NODE_68284_length_418_cov_3.909091	95	175	8	8	80	0.1000000
NODE_68284_length_418_cov_3.909091	148	224	4	39	76	0.5131579
NODE_68284_length_418_cov_3.909091	148	224	5	11	76	0.1447368
NODE_68284_length_418_cov_3.909091	148	224	6	8	76	0.1052632
NODE_68284_length_418_cov_3.909091	148	224	7	9	76	0.1184211
NODE_68284_length_418_cov_3.909091	148	224	8	9	76	0.1184211
NODE_68288_length_418_cov_3.749216	181	247	4	66	66	1.0000000
NODE_68289_length_418_cov_3.711599	249	313	0	64	64	1.0000000
NODE_68307_length_418_cov_3.012539	101	181	1	41	80	0.5125000
NODE_68307_length_418_cov_3.012539	101	181	2	39	80	0.4875000
NODE_68354_length_418_cov_2.376176	95	115	0	20	20	1.0000000
NODE_68436_length_418_cov_1.623824	47	128	0	81	81	1.0000000
NODE_68436_length_418_cov_1.623824	239	268	0	29	29	1.0000000
NODE_68682_length_418_cov_0.626959	255	299	0	44	44	1.0000000
NODE_68708_length_417_cov_45.267296	212	292	0	80	80	1.0000000
NODE_68708_length_417_cov_45.267296	265	345	0	80	80	1.0000000
NODE_68708_length_417_cov_45.267296	341	417	0	76	76	1.0000000
NODE_68709_length_417_cov_36.006289	159	239	16	5	80	0.0625000
NODE_68709_length_417_cov_36.006289	159	239	17	12	80	0.1500000
NODE_68709_length_417_cov_36.006289	159	239	18	1	80	0.0125000
NODE_68709_length_417_cov_36.006289	159	239	19	47	80	0.5875000
NODE_68709_length_417_cov_36.006289	159	239	20	15	80	0.1875000
NODE_68711_length_417_cov_12.886792	193	273	11	37	80	0.4625000
NODE_68711_length_417_cov_12.886792	193	273	13	43	80	0.5375000
NODE_68711_length_417_cov_12.886792	246	326	4	4	80	0.0500000
NODE_68711_length_417_cov_12.886792	246	326	7	14	80	0.1750000
NODE_68711_length_417_cov_12.886792	246	326	9	2	80	0.0250000
NODE_68711_length_417_cov_12.886792	246	326	11	60	80	0.7500000
NODE_68717_length_417_cov_7.056604	210	271	0	61	61	1.0000000
NODE_68717_length_417_cov_7.056604	263	315	0	52	52	1.0000000
NODE_68718_length_417_cov_6.669811	194	264	3	5	70	0.0714286
NODE_68718_length_417_cov_6.669811	194	264	6	20	70	0.2857143
NODE_68718_length_417_cov_6.669811	194	264	7	41	70	0.5857143
NODE_68718_length_417_cov_6.669811	194	264	9	1	70	0.0142857
NODE_68718_length_417_cov_6.669811	194	264	10	3	70	0.0428571
NODE_68779_length_417_cov_2.795597	20	91	0	71	71	1.0000000
NODE_69163_length_416_cov_115.782334	174	259	15	6	85	0.0705882
NODE_69163_length_416_cov_115.782334	174	259	16	16	85	0.1882353
NODE_69163_length_416_cov_115.782334	174	259	18	39	85	0.4588235
NODE_69163_length_416_cov_115.782334	174	259	19	7	85	0.0823529
NODE_69163_length_416_cov_115.782334	174	259	20	17	85	0.2000000
NODE_69164_length_416_cov_70.678233	180	244	7	18	64	0.2812500
NODE_69164_length_416_cov_70.678233	180	244	8	10	64	0.1562500
NODE_69164_length_416_cov_70.678233	180	244	9	5	64	0.0781250
NODE_69164_length_416_cov_70.678233	180	244	10	19	64	0.2968750
NODE_69164_length_416_cov_70.678233	180	244	13	12	64	0.1875000
NODE_69166_length_416_cov_39.933754	288	368	1	80	80	1.0000000
NODE_69166_length_416_cov_39.933754	341	416	0	30	75	0.4000000
NODE_69166_length_416_cov_39.933754	341	416	1	45	75	0.6000000
NODE_69167_length_416_cov_37.334385	158	238	9	11	80	0.1375000
NODE_69167_length_416_cov_37.334385	158	238	10	5	80	0.0625000
NODE_69167_length_416_cov_37.334385	158	238	11	11	80	0.1375000
NODE_69167_length_416_cov_37.334385	158	238	12	12	80	0.1500000
NODE_69167_length_416_cov_37.334385	158	238	13	9	80	0.1125000
NODE_69167_length_416_cov_37.334385	158	238	14	32	80	0.4000000
NODE_69167_length_416_cov_37.334385	211	291	9	10	80	0.1250000
NODE_69167_length_416_cov_37.334385	211	291	10	6	80	0.0750000
NODE_69167_length_416_cov_37.334385	211	291	12	18	80	0.2250000
NODE_69167_length_416_cov_37.334385	211	291	13	22	80	0.2750000
NODE_69167_length_416_cov_37.334385	211	291	14	24	80	0.3000000
NODE_69167_length_416_cov_37.334385	287	367	1	14	80	0.1750000
NODE_69167_length_416_cov_37.334385	287	367	2	6	80	0.0750000
NODE_69167_length_416_cov_37.334385	287	367	4	15	80	0.1875000
NODE_69167_length_416_cov_37.334385	287	367	5	8	80	0.1000000
NODE_69167_length_416_cov_37.334385	287	367	7	22	80	0.2750000
NODE_69167_length_416_cov_37.334385	287	367	8	4	80	0.0500000
NODE_69167_length_416_cov_37.334385	287	367	9	11	80	0.1375000
NODE_69167_length_416_cov_37.334385	340	416	0	44	76	0.5789474
NODE_69167_length_416_cov_37.334385	340	416	1	19	76	0.2500000
NODE_69167_length_416_cov_37.334385	340	416	2	6	76	0.0789474
NODE_69167_length_416_cov_37.334385	340	416	4	7	76	0.0921053
NODE_69179_length_416_cov_5.242902	89	169	0	80	80	1.0000000
NODE_69179_length_416_cov_5.242902	142	222	0	80	80	1.0000000
NODE_69184_length_416_cov_4.892744	79	145	0	66	66	1.0000000
NODE_69184_length_416_cov_4.892744	194	272	0	78	78	1.0000000
NODE_69184_length_416_cov_4.892744	247	272	0	25	25	1.0000000
NODE_69204_length_416_cov_3.886435	79	136	1	24	57	0.4210526
NODE_69204_length_416_cov_3.886435	79	136	2	33	57	0.5789474
NODE_69279_length_416_cov_2.230284	10	90	0	80	80	1.0000000
NODE_69399_length_416_cov_1.520505	198	244	0	46	46	1.0000000
NODE_69399_length_416_cov_1.520505	261	328	0	67	67	1.0000000
NODE_69673_length_415_cov_35.924051	260	339	0	79	79	1.0000000
NODE_69673_length_415_cov_35.924051	316	392	0	76	76	1.0000000
NODE_69679_length_415_cov_6.376582	117	197	0	80	80	1.0000000
NODE_69679_length_415_cov_6.376582	254	334	0	80	80	1.0000000
NODE_69774_length_415_cov_2.224684	144	224	2	80	80	1.0000000
NODE_69795_length_415_cov_2.069620	207	273	0	66	66	1.0000000
NODE_69817_length_415_cov_1.832278	225	283	0	58	58	1.0000000
NODE_69845_length_415_cov_1.610759	90	170	5	68	80	0.8500000
NODE_69845_length_415_cov_1.610759	90	170	6	12	80	0.1500000
NODE_69845_length_415_cov_1.610759	335	376	0	41	41	1.0000000
NODE_70175_length_414_cov_46.263492	0	49	0	49	49	1.0000000
NODE_70175_length_414_cov_46.263492	22	102	0	80	80	1.0000000
NODE_70183_length_414_cov_7.460317	167	247	2	63	80	0.7875000
NODE_70183_length_414_cov_7.460317	167	247	4	17	80	0.2125000
NODE_70183_length_414_cov_7.460317	220	300	2	10	80	0.1250000
NODE_70183_length_414_cov_7.460317	220	300	4	70	80	0.8750000
NODE_70192_length_414_cov_5.676190	54	134	0	80	80	1.0000000
NODE_70192_length_414_cov_5.676190	107	187	0	80	80	1.0000000
NODE_70222_length_414_cov_4.130159	257	303	0	46	46	1.0000000
NODE_70222_length_414_cov_4.130159	276	356	0	80	80	1.0000000
NODE_70254_length_414_cov_2.996825	75	135	0	60	60	1.0000000
NODE_70271_length_414_cov_2.631746	68	145	1	12	77	0.1558442
NODE_70271_length_414_cov_2.631746	68	145	2	65	77	0.8441558
NODE_70284_length_414_cov_2.473016	164	197	0	33	33	1.0000000
NODE_70284_length_414_cov_2.473016	170	255	0	85	85	1.0000000
NODE_70305_length_414_cov_2.222222	185	260	0	75	75	1.0000000
NODE_70305_length_414_cov_2.222222	233	304	0	71	71	1.0000000
NODE_70307_length_414_cov_2.206349	88	163	0	75	75	1.0000000
NODE_70326_length_414_cov_2.047619	298	349	0	51	51	1.0000000
NODE_70486_length_414_cov_1.177778	106	190	0	84	84	1.0000000
NODE_70494_length_414_cov_1.155556	0	23	0	23	23	1.0000000
NODE_70690_length_413_cov_41.471338	35	115	1	80	80	1.0000000
NODE_70690_length_413_cov_41.471338	35	115	1	80	80	1.0000000
NODE_70690_length_413_cov_41.471338	88	168	1	80	80	1.0000000
NODE_70690_length_413_cov_41.471338	88	168	1	80	80	1.0000000
NODE_70691_length_413_cov_16.687898	222	302	4	80	80	1.0000000
NODE_70691_length_413_cov_16.687898	275	355	0	33	80	0.4125000
NODE_70691_length_413_cov_16.687898	275	355	4	47	80	0.5875000
NODE_70699_length_413_cov_7.057325	170	250	0	80	80	1.0000000
NODE_70699_length_413_cov_7.057325	223	300	0	77	77	1.0000000
NODE_70703_length_413_cov_5.665605	125	182	3	19	57	0.3333333
NODE_70703_length_413_cov_5.665605	125	182	4	4	57	0.0701754
NODE_70703_length_413_cov_5.665605	125	182	5	34	57	0.5964912
NODE_70712_length_413_cov_4.754777	140	184	0	39	44	0.8863636
NODE_70712_length_413_cov_4.754777	140	184	1	5	44	0.1136364
NODE_70743_length_413_cov_3.506369	113	193	0	80	80	1.0000000
NODE_70749_length_413_cov_3.235669	251	331	0	80	80	1.0000000
NODE_70749_length_413_cov_3.235669	304	356	0	52	52	1.0000000
NODE_70792_length_413_cov_2.484076	209	257	0	48	48	1.0000000
NODE_70835_length_413_cov_1.949045	224	296	0	72	72	1.0000000
NODE_71196_length_412_cov_9.996805	172	244	0	50	72	0.6944444
NODE_71196_length_412_cov_9.996805	172	244	1	22	72	0.3055556
NODE_71218_length_412_cov_4.686901	112	167	0	55	55	1.0000000
NODE_71253_length_412_cov_3.204473	44	124	0	80	80	1.0000000
NODE_71276_length_412_cov_2.824281	225	305	0	80	80	1.0000000
NODE_71371_length_412_cov_1.782748	262	342	0	80	80	1.0000000
NODE_71398_length_412_cov_1.603834	143	182	0	39	39	1.0000000
NODE_71665_length_411_cov_44.701923	4	72	0	68	68	1.0000000
NODE_71665_length_411_cov_44.701923	35	116	0	81	81	1.0000000
NODE_71665_length_411_cov_44.701923	161	242	0	81	81	1.0000000
NODE_71665_length_411_cov_44.701923	293	374	0	81	81	1.0000000
NODE_71665_length_411_cov_44.701923	337	411	0	74	74	1.0000000
NODE_71666_length_411_cov_43.144231	102	183	1	36	81	0.4444444
NODE_71666_length_411_cov_43.144231	102	183	2	14	81	0.1728395
NODE_71666_length_411_cov_43.144231	102	183	3	5	81	0.0617284
NODE_71666_length_411_cov_43.144231	102	183	4	26	81	0.3209876
NODE_71666_length_411_cov_43.144231	156	236	3	23	80	0.2875000
NODE_71666_length_411_cov_43.144231	156	236	4	57	80	0.7125000
NODE_71666_length_411_cov_43.144231	232	312	0	4	80	0.0500000
NODE_71666_length_411_cov_43.144231	232	312	1	3	80	0.0375000
NODE_71666_length_411_cov_43.144231	232	312	2	17	80	0.2125000
NODE_71666_length_411_cov_43.144231	232	312	3	56	80	0.7000000
NODE_71666_length_411_cov_43.144231	285	365	0	57	80	0.7125000
NODE_71666_length_411_cov_43.144231	285	365	1	3	80	0.0375000
NODE_71666_length_411_cov_43.144231	285	365	2	17	80	0.2125000
NODE_71666_length_411_cov_43.144231	285	365	3	3	80	0.0375000
NODE_71672_length_411_cov_8.471154	133	213	0	80	80	1.0000000
NODE_71672_length_411_cov_8.471154	186	266	0	80	80	1.0000000
NODE_71673_length_411_cov_8.407051	133	220	0	87	87	1.0000000
NODE_71675_length_411_cov_6.455128	249	316	0	67	67	1.0000000
NODE_71675_length_411_cov_6.455128	292	344	0	52	52	1.0000000
NODE_71687_length_411_cov_4.782051	98	178	0	80	80	1.0000000
NODE_71687_length_411_cov_4.782051	151	228	0	77	77	1.0000000
NODE_71705_length_411_cov_3.698718	282	347	0	65	65	1.0000000
NODE_71713_length_411_cov_3.378205	88	148	0	60	60	1.0000000
NODE_71714_length_411_cov_3.371795	145	225	0	80	80	1.0000000
NODE_71714_length_411_cov_3.371795	198	274	0	76	76	1.0000000
NODE_72163_length_410_cov_49.331190	320	400	0	1	80	0.0125000
NODE_72163_length_410_cov_49.331190	320	400	1	48	80	0.6000000
NODE_72163_length_410_cov_49.331190	320	400	2	17	80	0.2125000
NODE_72163_length_410_cov_49.331190	320	400	3	14	80	0.1750000
NODE_72163_length_410_cov_49.331190	320	400	0	1	80	0.0125000
NODE_72163_length_410_cov_49.331190	320	400	1	48	80	0.6000000
NODE_72163_length_410_cov_49.331190	320	400	2	17	80	0.2125000
NODE_72163_length_410_cov_49.331190	320	400	3	14	80	0.1750000
NODE_72163_length_410_cov_49.331190	320	400	0	1	80	0.0125000
NODE_72163_length_410_cov_49.331190	320	400	1	48	80	0.6000000
NODE_72163_length_410_cov_49.331190	320	400	2	17	80	0.2125000
NODE_72163_length_410_cov_49.331190	320	400	3	14	80	0.1750000
NODE_72163_length_410_cov_49.331190	320	400	0	1	80	0.0125000
NODE_72163_length_410_cov_49.331190	320	400	1	48	80	0.6000000
NODE_72163_length_410_cov_49.331190	320	400	2	17	80	0.2125000
NODE_72163_length_410_cov_49.331190	320	400	3	14	80	0.1750000
NODE_72163_length_410_cov_49.331190	320	400	0	1	80	0.0125000
NODE_72163_length_410_cov_49.331190	320	400	1	48	80	0.6000000
NODE_72163_length_410_cov_49.331190	320	400	2	17	80	0.2125000
NODE_72163_length_410_cov_49.331190	320	400	3	14	80	0.1750000
NODE_72163_length_410_cov_49.331190	329	400	0	1	71	0.0140845
NODE_72163_length_410_cov_49.331190	329	400	1	48	71	0.6760563
NODE_72163_length_410_cov_49.331190	329	400	2	17	71	0.2394366
NODE_72163_length_410_cov_49.331190	329	400	3	5	71	0.0704225
NODE_72169_length_410_cov_6.797428	179	259	0	80	80	1.0000000
NODE_72169_length_410_cov_6.797428	232	312	0	80	80	1.0000000
NODE_72184_length_410_cov_5.102894	153	222	0	69	69	1.0000000
NODE_72186_length_410_cov_4.884244	101	179	0	78	78	1.0000000
NODE_72187_length_410_cov_4.787781	287	344	5	6	57	0.1052632
NODE_72187_length_410_cov_4.787781	287	344	6	51	57	0.8947368
NODE_72187_length_410_cov_4.787781	340	397	2	20	57	0.3508772
NODE_72187_length_410_cov_4.787781	340	397	3	3	57	0.0526316
NODE_72187_length_410_cov_4.787781	340	397	5	34	57	0.5964912
NODE_72194_length_410_cov_4.591640	245	303	0	58	58	1.0000000
NODE_72194_length_410_cov_4.591640	298	356	0	58	58	1.0000000
NODE_72230_length_410_cov_3.215434	32	112	1	80	80	1.0000000
NODE_72230_length_410_cov_3.215434	85	165	0	12	80	0.1500000
NODE_72230_length_410_cov_3.215434	85	165	1	68	80	0.8500000
NODE_72327_length_410_cov_1.913183	227	285	0	58	58	1.0000000
NODE_72526_length_410_cov_1.038585	272	316	0	44	44	1.0000000
NODE_72688_length_409_cov_11.506452	56	136	0	80	80	1.0000000
NODE_72688_length_409_cov_11.506452	109	189	0	80	80	1.0000000
NODE_72689_length_409_cov_10.329032	131	186	0	41	55	0.7454545
NODE_72689_length_409_cov_10.329032	131	186	1	14	55	0.2545455
NODE_72690_length_409_cov_9.625806	62	142	0	80	80	1.0000000
NODE_72690_length_409_cov_9.625806	115	195	0	80	80	1.0000000
NODE_72697_length_409_cov_6.867742	41	71	0	30	30	1.0000000
NODE_72730_length_409_cov_3.822581	103	158	0	55	55	1.0000000
NODE_72730_length_409_cov_3.822581	151	232	0	81	81	1.0000000
NODE_72754_length_409_cov_2.987097	240	287	0	47	47	1.0000000
NODE_72951_length_409_cov_1.319355	49	131	0	82	82	1.0000000
NODE_72951_length_409_cov_1.319355	104	161	0	57	57	1.0000000
NODE_73196_length_408_cov_8.585761	57	137	5	55	80	0.6875000
NODE_73196_length_408_cov_8.585761	57	137	7	1	80	0.0125000
NODE_73196_length_408_cov_8.585761	57	137	8	24	80	0.3000000
NODE_73196_length_408_cov_8.585761	110	190	5	17	80	0.2125000
NODE_73196_length_408_cov_8.585761	110	190	7	1	80	0.0125000
NODE_73196_length_408_cov_8.585761	110	190	8	44	80	0.5500000
NODE_73196_length_408_cov_8.585761	110	190	9	3	80	0.0375000
NODE_73196_length_408_cov_8.585761	110	190	10	15	80	0.1875000
NODE_73198_length_408_cov_6.948220	71	151	1	6	80	0.0750000
NODE_73198_length_408_cov_6.948220	71	151	2	30	80	0.3750000
NODE_73198_length_408_cov_6.948220	71	151	4	17	80	0.2125000
NODE_73198_length_408_cov_6.948220	71	151	5	27	80	0.3375000
NODE_73198_length_408_cov_6.948220	124	204	5	72	80	0.9000000
NODE_73198_length_408_cov_6.948220	124	204	6	8	80	0.1000000
NODE_73219_length_408_cov_3.957929	83	132	0	49	49	1.0000000
NODE_73226_length_408_cov_3.511327	40	97	0	57	57	1.0000000
NODE_73226_length_408_cov_3.511327	357	398	0	41	41	1.0000000
NODE_73262_length_408_cov_2.724919	128	180	1	52	52	1.0000000
NODE_73269_length_408_cov_2.563107	164	241	0	77	77	1.0000000
NODE_73271_length_408_cov_2.456311	314	379	0	65	65	1.0000000
NODE_73271_length_408_cov_2.456311	352	408	0	56	56	1.0000000
NODE_73690_length_407_cov_6.191558	144	208	3	19	64	0.2968750
NODE_73690_length_407_cov_6.191558	144	208	4	45	64	0.7031250
NODE_73698_length_407_cov_4.961039	212	291	0	79	79	1.0000000
NODE_73719_length_407_cov_3.681818	314	375	0	61	61	1.0000000
NODE_73732_length_407_cov_3.344156	199	247	0	48	48	1.0000000
NODE_73736_length_407_cov_3.250000	142	223	0	11	81	0.1358025
NODE_73736_length_407_cov_3.250000	142	223	1	70	81	0.8641976
NODE_73762_length_407_cov_2.594156	194	257	0	63	63	1.0000000
NODE_73769_length_407_cov_2.538961	34	114	0	80	80	1.0000000
NODE_73853_length_407_cov_1.737013	208	264	0	56	56	1.0000000
NODE_74200_length_406_cov_176.856678	200	271	14	53	71	0.7464789
NODE_74200_length_406_cov_176.856678	200	271	15	9	71	0.1267606
NODE_74200_length_406_cov_176.856678	200	271	16	2	71	0.0281690
NODE_74200_length_406_cov_176.856678	200	271	17	3	71	0.0422535
NODE_74200_length_406_cov_176.856678	200	271	18	4	71	0.0563380
NODE_74200_length_406_cov_176.856678	244	321	10	4	77	0.0519481
NODE_74200_length_406_cov_176.856678	244	321	11	5	77	0.0649351
NODE_74200_length_406_cov_176.856678	244	321	13	9	77	0.1168831
NODE_74200_length_406_cov_176.856678	244	321	14	57	77	0.7402598
NODE_74200_length_406_cov_176.856678	244	321	16	2	77	0.0259740
NODE_74203_length_406_cov_37.723127	15	95	0	79	80	0.9875000
NODE_74203_length_406_cov_37.723127	15	95	1	1	80	0.0125000
NODE_74219_length_406_cov_4.960912	268	327	0	31	59	0.5254237
NODE_74219_length_406_cov_4.960912	268	327	2	28	59	0.4745763
NODE_74253_length_406_cov_3.087948	261	302	1	41	41	1.0000000
NODE_74284_length_406_cov_2.475570	220	270	0	50	50	1.0000000
NODE_74332_length_406_cov_1.986971	238	276	0	38	38	1.0000000
NODE_74368_length_406_cov_1.778502	159	195	0	36	36	1.0000000
NODE_74368_length_406_cov_1.778502	234	294	0	60	60	1.0000000
NODE_74368_length_406_cov_1.778502	267	347	0	80	80	1.0000000
NODE_74427_length_406_cov_1.495114	173	212	0	39	39	1.0000000
NODE_74476_length_406_cov_1.325733	367	398	1	31	31	1.0000000
NODE_74588_length_406_cov_0.934853	1	32	0	31	31	1.0000000
NODE_74588_length_406_cov_0.934853	5	85	0	80	80	1.0000000
NODE_74696_length_405_cov_5.107843	332	380	0	48	48	1.0000000
NODE_74697_length_405_cov_4.915033	15	46	0	31	31	1.0000000
NODE_74727_length_405_cov_3.346405	195	240	0	45	45	1.0000000
NODE_74727_length_405_cov_3.346405	274	329	0	55	55	1.0000000
NODE_74737_length_405_cov_3.124183	210	260	0	50	50	1.0000000
NODE_74737_length_405_cov_3.124183	240	286	0	46	46	1.0000000
NODE_74737_length_405_cov_3.124183	260	339	0	79	79	1.0000000
NODE_74737_length_405_cov_3.124183	272	339	0	67	67	1.0000000
NODE_74780_length_405_cov_2.503268	352	399	0	47	47	1.0000000
NODE_74787_length_405_cov_2.460784	0	73	0	73	73	1.0000000
NODE_75145_length_405_cov_0.666667	207	268	0	61	61	1.0000000
NODE_75196_length_404_cov_40.937705	40	120	5	2	80	0.0250000
NODE_75196_length_404_cov_40.937705	40	120	6	41	80	0.5125000
NODE_75196_length_404_cov_40.937705	40	120	7	2	80	0.0250000
NODE_75196_length_404_cov_40.937705	40	120	8	10	80	0.1250000
NODE_75196_length_404_cov_40.937705	40	120	9	3	80	0.0375000
NODE_75196_length_404_cov_40.937705	40	120	11	12	80	0.1500000
NODE_75196_length_404_cov_40.937705	40	120	12	10	80	0.1250000
NODE_75196_length_404_cov_40.937705	93	173	8	2	80	0.0250000
NODE_75196_length_404_cov_40.937705	93	173	9	3	80	0.0375000
NODE_75196_length_404_cov_40.937705	93	173	10	3	80	0.0375000
NODE_75196_length_404_cov_40.937705	93	173	11	17	80	0.2125000
NODE_75196_length_404_cov_40.937705	93	173	12	34	80	0.4250000
NODE_75196_length_404_cov_40.937705	93	173	13	21	80	0.2625000
NODE_75197_length_404_cov_32.940984	46	126	3	24	80	0.3000000
NODE_75197_length_404_cov_32.940984	46	126	4	34	80	0.4250000
NODE_75197_length_404_cov_32.940984	46	126	6	1	80	0.0125000
NODE_75197_length_404_cov_32.940984	46	126	7	21	80	0.2625000
NODE_75197_length_404_cov_32.940984	99	179	4	24	80	0.3000000
NODE_75197_length_404_cov_32.940984	99	179	6	1	80	0.0125000
NODE_75197_length_404_cov_32.940984	99	179	7	55	80	0.6875000
NODE_75197_length_404_cov_32.940984	175	255	1	1	80	0.0125000
NODE_75197_length_404_cov_32.940984	175	255	3	34	80	0.4250000
NODE_75197_length_404_cov_32.940984	175	255	4	45	80	0.5625000
NODE_75197_length_404_cov_32.940984	228	308	0	53	80	0.6625000
NODE_75197_length_404_cov_32.940984	228	308	1	1	80	0.0125000
NODE_75197_length_404_cov_32.940984	228	308	3	26	80	0.3250000
NODE_75198_length_404_cov_11.731148	130	210	0	21	80	0.2625000
NODE_75198_length_404_cov_11.731148	130	210	3	59	80	0.7375000
NODE_75198_length_404_cov_11.731148	183	263	3	80	80	1.0000000
NODE_75200_length_404_cov_9.170492	201	257	1	35	56	0.6250000
NODE_75200_length_404_cov_9.170492	201	257	2	21	56	0.3750000
NODE_75236_length_404_cov_3.613115	323	385	0	62	62	1.0000000
NODE_75259_length_404_cov_2.914754	181	261	0	80	80	1.0000000
NODE_75345_length_404_cov_2.085246	245	325	0	80	80	1.0000000
NODE_75357_length_404_cov_1.993443	95	148	0	53	53	1.0000000
NODE_75399_length_404_cov_1.672131	32	106	0	74	74	1.0000000
NODE_75440_length_404_cov_1.498361	94	174	0	80	80	1.0000000
NODE_75446_length_404_cov_1.485246	234	282	0	48	48	1.0000000
NODE_75545_length_404_cov_1.121311	114	194	0	80	80	1.0000000
NODE_75750_length_403_cov_7.325658	80	146	0	66	66	1.0000000
NODE_75750_length_403_cov_7.325658	165	234	0	69	69	1.0000000
NODE_75750_length_403_cov_7.325658	215	255	0	40	40	1.0000000
NODE_75751_length_403_cov_7.217105	207	284	1	25	77	0.3246753
NODE_75751_length_403_cov_7.217105	207	284	2	24	77	0.3116883
NODE_75751_length_403_cov_7.217105	207	284	3	28	77	0.3636364
NODE_75751_length_403_cov_7.217105	257	334	1	75	77	0.9740260
NODE_75751_length_403_cov_7.217105	257	334	2	2	77	0.0259740
NODE_75752_length_403_cov_6.776316	192	250	0	58	58	1.0000000
NODE_75788_length_403_cov_3.710526	327	373	0	46	46	1.0000000
NODE_75788_length_403_cov_3.710526	346	403	0	57	57	1.0000000
NODE_75793_length_403_cov_3.611842	283	363	0	80	80	1.0000000
NODE_75824_length_403_cov_2.822368	201	282	0	81	81	1.0000000
NODE_75871_length_403_cov_2.082237	102	145	0	43	43	1.0000000
NODE_75908_length_403_cov_1.871711	130	166	0	36	36	1.0000000
NODE_75993_length_403_cov_1.398026	79	116	0	37	37	1.0000000
NODE_76029_length_403_cov_1.269737	82	111	0	29	29	1.0000000
NODE_76239_length_402_cov_6.293729	217	297	0	80	80	1.0000000
NODE_76239_length_402_cov_6.293729	270	350	0	80	80	1.0000000
NODE_76246_length_402_cov_5.227723	176	236	2	60	60	1.0000000
NODE_76261_length_402_cov_4.356436	44	123	0	79	79	1.0000000
NODE_76261_length_402_cov_4.356436	119	199	0	80	80	1.0000000
NODE_76261_length_402_cov_4.356436	172	252	0	80	80	1.0000000
NODE_76276_length_402_cov_3.564356	197	257	0	60	60	1.0000000
NODE_76276_length_402_cov_3.564356	230	310	0	80	80	1.0000000
NODE_76328_length_402_cov_2.633663	335	402	0	67	67	1.0000000
NODE_76336_length_402_cov_2.514851	82	162	0	80	80	1.0000000
NODE_76336_length_402_cov_2.514851	135	200	0	65	65	1.0000000
NODE_76380_length_402_cov_2.102310	114	165	0	51	51	1.0000000
NODE_76380_length_402_cov_2.102310	138	195	0	57	57	1.0000000
NODE_76560_length_402_cov_1.214521	0	33	0	33	33	1.0000000
NODE_76646_length_402_cov_1.000000	119	188	0	69	69	1.0000000
NODE_76752_length_402_cov_0.663366	0	46	0	46	46	1.0000000
NODE_76780_length_401_cov_43.675497	285	343	0	58	58	1.0000000
NODE_76801_length_401_cov_4.377483	309	389	0	80	80	1.0000000
NODE_76804_length_401_cov_4.241722	125	180	0	55	55	1.0000000
NODE_76808_length_401_cov_4.132450	195	275	0	80	80	1.0000000
NODE_76811_length_401_cov_3.973510	138	181	1	20	43	0.4651163
NODE_76811_length_401_cov_3.973510	138	181	2	23	43	0.5348837
NODE_76828_length_401_cov_3.370861	141	221	0	80	80	1.0000000
NODE_76828_length_401_cov_3.370861	194	273	0	79	79	1.0000000
NODE_76830_length_401_cov_3.317881	67	147	0	80	80	1.0000000
NODE_76918_length_401_cov_1.937086	160	239	0	78	79	0.9873418
NODE_76918_length_401_cov_1.937086	160	239	1	1	79	0.0126582
NODE_76978_length_401_cov_1.615894	205	269	0	2	64	0.0312500
NODE_76978_length_401_cov_1.615894	205	269	1	19	64	0.2968750
NODE_76978_length_401_cov_1.615894	205	269	2	43	64	0.6718750
NODE_77017_length_401_cov_1.407285	23	92	0	69	69	1.0000000
NODE_77017_length_401_cov_1.407285	76	122	0	46	46	1.0000000
NODE_77236_length_401_cov_0.675497	292	372	0	80	80	1.0000000
NODE_77236_length_401_cov_0.675497	345	401	0	56	56	1.0000000
NODE_77284_length_400_cov_40.584718	205	281	0	76	76	1.0000000
NODE_77284_length_400_cov_40.584718	254	334	0	80	80	1.0000000
NODE_77289_length_400_cov_8.631229	307	372	0	65	65	1.0000000
NODE_77292_length_400_cov_6.850498	281	329	0	48	48	1.0000000
NODE_77322_length_400_cov_4.000000	82	140	5	58	58	1.0000000
NODE_77358_length_400_cov_3.029900	204	284	0	80	80	1.0000000
NODE_77358_length_400_cov_3.029900	205	231	0	26	26	1.0000000
NODE_77362_length_400_cov_3.009967	146	220	0	74	74	1.0000000
NODE_77362_length_400_cov_3.009967	195	261	0	66	66	1.0000000
NODE_77363_length_400_cov_2.990033	253	332	0	79	79	1.0000000
NODE_77363_length_400_cov_2.990033	306	385	0	79	79	1.0000000
NODE_77368_length_400_cov_2.860465	365	400	0	35	35	1.0000000
NODE_77371_length_400_cov_2.797342	324	372	0	48	48	1.0000000
NODE_77380_length_400_cov_2.581395	192	254	0	62	62	1.0000000
NODE_77460_length_400_cov_1.940199	225	268	0	43	43	1.0000000
NODE_77460_length_400_cov_1.940199	293	374	2	81	81	1.0000000
NODE_77821_length_399_cov_71.493333	215	295	13	9	80	0.1125000
NODE_77821_length_399_cov_71.493333	215	295	14	40	80	0.5000000
NODE_77821_length_399_cov_71.493333	215	295	15	7	80	0.0875000
NODE_77821_length_399_cov_71.493333	215	295	16	24	80	0.3000000
NODE_77821_length_399_cov_71.493333	268	348	10	14	80	0.1750000
NODE_77821_length_399_cov_71.493333	268	348	12	13	80	0.1625000
NODE_77821_length_399_cov_71.493333	268	348	13	1	80	0.0125000
NODE_77821_length_399_cov_71.493333	268	348	14	52	80	0.6500000
NODE_77823_length_399_cov_7.510000	229	309	0	80	80	1.0000000
NODE_77823_length_399_cov_7.510000	282	362	0	80	80	1.0000000
NODE_77825_length_399_cov_7.310000	125	187	0	62	62	1.0000000
NODE_77854_length_399_cov_4.293333	86	164	0	78	78	1.0000000
NODE_77877_length_399_cov_3.406667	51	124	0	73	73	1.0000000
NODE_77933_length_399_cov_2.286667	310	390	0	16	80	0.2000000
NODE_77933_length_399_cov_2.286667	310	390	1	64	80	0.8000000
NODE_77966_length_399_cov_1.916667	76	136	0	60	60	1.0000000
NODE_77966_length_399_cov_1.916667	123	189	0	66	66	1.0000000
NODE_78276_length_399_cov_0.710000	313	392	0	79	79	1.0000000
NODE_78354_length_398_cov_9.688963	1	81	5	13	80	0.1625000
NODE_78354_length_398_cov_9.688963	1	81	10	67	80	0.8375000
NODE_78354_length_398_cov_9.688963	247	327	8	80	80	1.0000000
NODE_78354_length_398_cov_9.688963	300	380	0	16	80	0.2000000
NODE_78354_length_398_cov_9.688963	300	380	5	30	80	0.3750000
NODE_78354_length_398_cov_9.688963	300	380	8	34	80	0.4250000
NODE_78360_length_398_cov_6.488294	130	210	0	80	80	1.0000000
NODE_78364_length_398_cov_5.765886	253	333	0	80	80	1.0000000
NODE_78372_length_398_cov_5.244147	248	312	0	64	64	1.0000000
NODE_78376_length_398_cov_5.006689	116	196	0	80	80	1.0000000
NODE_78376_length_398_cov_5.006689	169	251	0	82	82	1.0000000
NODE_78383_length_398_cov_4.284281	63	117	0	54	54	1.0000000
NODE_78383_length_398_cov_4.284281	135	160	0	25	25	1.0000000
NODE_78420_length_398_cov_2.993311	229	309	0	80	80	1.0000000
NODE_78429_length_398_cov_2.822742	236	271	0	35	35	1.0000000
NODE_78891_length_397_cov_52.855705	124	204	5	3	80	0.0375000
NODE_78891_length_397_cov_52.855705	124	204	6	2	80	0.0250000
NODE_78891_length_397_cov_52.855705	124	204	7	18	80	0.2250000
NODE_78891_length_397_cov_52.855705	124	204	9	2	80	0.0250000
NODE_78891_length_397_cov_52.855705	124	204	11	21	80	0.2625000
NODE_78891_length_397_cov_52.855705	124	204	12	8	80	0.1000000
NODE_78891_length_397_cov_52.855705	124	204	13	26	80	0.3250000
NODE_78891_length_397_cov_52.855705	177	257	11	20	80	0.2500000
NODE_78891_length_397_cov_52.855705	177	257	12	12	80	0.1500000
NODE_78891_length_397_cov_52.855705	177	257	13	13	80	0.1625000
NODE_78891_length_397_cov_52.855705	177	257	14	23	80	0.2875000
NODE_78891_length_397_cov_52.855705	177	257	15	12	80	0.1500000
NODE_78894_length_397_cov_35.036913	173	253	8	4	80	0.0500000
NODE_78894_length_397_cov_35.036913	173	253	9	8	80	0.1000000
NODE_78894_length_397_cov_35.036913	173	253	10	3	80	0.0375000
NODE_78894_length_397_cov_35.036913	173	253	11	35	80	0.4375000
NODE_78894_length_397_cov_35.036913	173	253	12	21	80	0.2625000
NODE_78894_length_397_cov_35.036913	173	253	13	9	80	0.1125000
NODE_78895_length_397_cov_13.667785	94	174	0	80	80	1.0000000
NODE_78895_length_397_cov_13.667785	147	227	0	80	80	1.0000000
NODE_78897_length_397_cov_7.496644	192	272	0	80	80	1.0000000
NODE_78897_length_397_cov_7.496644	245	325	0	80	80	1.0000000
NODE_78898_length_397_cov_6.828859	127	173	0	46	46	1.0000000
NODE_78913_length_397_cov_4.902685	293	364	0	71	71	1.0000000
NODE_78933_length_397_cov_3.765101	164	244	0	80	80	1.0000000
NODE_78951_length_397_cov_3.325503	107	187	0	80	80	1.0000000
NODE_78951_length_397_cov_3.325503	163	236	0	73	73	1.0000000
NODE_78999_length_397_cov_2.530201	269	312	0	43	43	1.0000000
NODE_79047_length_397_cov_1.959732	154	193	0	39	39	1.0000000
NODE_79072_length_397_cov_1.791946	218	283	1	33	65	0.5076923
NODE_79072_length_397_cov_1.791946	218	283	2	32	65	0.4923077
NODE_79127_length_397_cov_1.560403	183	240	0	57	57	1.0000000
NODE_79456_length_396_cov_11.632997	162	242	9	3	80	0.0375000
NODE_79456_length_396_cov_11.632997	162	242	10	15	80	0.1875000
NODE_79456_length_396_cov_11.632997	162	242	11	15	80	0.1875000
NODE_79456_length_396_cov_11.632997	162	242	12	41	80	0.5125000
NODE_79456_length_396_cov_11.632997	162	242	15	6	80	0.0750000
NODE_79456_length_396_cov_11.632997	215	295	9	3	80	0.0375000
NODE_79456_length_396_cov_11.632997	215	295	12	24	80	0.3000000
NODE_79456_length_396_cov_11.632997	215	295	14	17	80	0.2125000
NODE_79456_length_396_cov_11.632997	215	295	15	36	80	0.4500000
NODE_79460_length_396_cov_7.053872	71	101	1	30	30	1.0000000
NODE_79464_length_396_cov_6.097643	229	309	0	80	80	1.0000000
NODE_79464_length_396_cov_6.097643	282	362	0	80	80	1.0000000
NODE_79471_length_396_cov_5.484848	125	205	0	80	80	1.0000000
NODE_79471_length_396_cov_5.484848	178	259	0	81	81	1.0000000
NODE_79473_length_396_cov_5.434343	224	275	0	51	51	1.0000000
NODE_79473_length_396_cov_5.434343	272	331	0	59	59	1.0000000
NODE_79483_length_396_cov_4.414141	189	264	5	53	75	0.7066666
NODE_79483_length_396_cov_4.414141	189	264	6	22	75	0.2933333
NODE_79483_length_396_cov_4.414141	241	317	3	5	76	0.0657895
NODE_79483_length_396_cov_4.414141	241	317	4	43	76	0.5657895
NODE_79483_length_396_cov_4.414141	241	317	5	19	76	0.2500000
NODE_79483_length_396_cov_4.414141	241	317	6	9	76	0.1184211
NODE_79493_length_396_cov_4.010101	163	205	0	42	42	1.0000000
NODE_79522_length_396_cov_3.080808	95	161	0	66	66	1.0000000
NODE_79524_length_396_cov_3.067340	252	316	0	60	64	0.9375000
NODE_79524_length_396_cov_3.067340	252	316	1	4	64	0.0625000
NODE_79535_length_396_cov_2.892256	136	217	0	81	81	1.0000000
NODE_79557_length_396_cov_2.710438	88	168	2	80	80	1.0000000
NODE_79561_length_396_cov_2.680135	297	335	0	38	38	1.0000000
NODE_79562_length_396_cov_2.659933	68	148	0	80	80	1.0000000
NODE_79562_length_396_cov_2.659933	121	168	0	47	47	1.0000000
NODE_79616_length_396_cov_2.060606	308	388	0	80	80	1.0000000
NODE_79643_length_396_cov_1.939394	63	142	0	79	79	1.0000000
NODE_79643_length_396_cov_1.939394	115	164	0	49	49	1.0000000
NODE_79683_length_396_cov_1.811448	82	162	0	80	80	1.0000000
NODE_79692_length_396_cov_1.734007	88	119	0	31	31	1.0000000
NODE_79930_length_396_cov_0.905724	101	151	0	50	50	1.0000000
NODE_80057_length_395_cov_449.327703	0	79	4	2	79	0.0253165
NODE_80057_length_395_cov_449.327703	0	79	7	5	79	0.0632911
NODE_80057_length_395_cov_449.327703	0	79	8	3	79	0.0379747
NODE_80057_length_395_cov_449.327703	0	79	11	5	79	0.0632911
NODE_80057_length_395_cov_449.327703	0	79	12	1	79	0.0126582
NODE_80057_length_395_cov_449.327703	0	79	13	2	79	0.0253165
NODE_80057_length_395_cov_449.327703	0	79	15	2	79	0.0253165
NODE_80057_length_395_cov_449.327703	0	79	18	1	79	0.0126582
NODE_80057_length_395_cov_449.327703	0	79	19	1	79	0.0126582
NODE_80057_length_395_cov_449.327703	0	79	20	10	79	0.1265823
NODE_80057_length_395_cov_449.327703	0	79	22	1	79	0.0126582
NODE_80057_length_395_cov_449.327703	0	79	23	3	79	0.0379747
NODE_80057_length_395_cov_449.327703	0	79	24	1	79	0.0126582
NODE_80057_length_395_cov_449.327703	0	79	26	2	79	0.0253165
NODE_80057_length_395_cov_449.327703	0	79	27	7	79	0.0886076
NODE_80057_length_395_cov_449.327703	0	79	33	4	79	0.0506329
NODE_80057_length_395_cov_449.327703	0	79	34	6	79	0.0759494
NODE_80057_length_395_cov_449.327703	0	79	36	20	79	0.2531646
NODE_80057_length_395_cov_449.327703	0	79	38	3	79	0.0379747
NODE_80058_length_395_cov_13.695946	113	193	0	80	80	1.0000000
NODE_80058_length_395_cov_13.695946	166	246	0	80	80	1.0000000
NODE_80086_length_395_cov_4.179054	152	232	0	80	80	1.0000000
NODE_80116_length_395_cov_2.962838	118	198	0	80	80	1.0000000
NODE_80116_length_395_cov_2.962838	171	237	0	66	66	1.0000000
NODE_80121_length_395_cov_2.878378	261	301	0	40	40	1.0000000
NODE_80139_length_395_cov_2.587838	111	188	0	77	77	1.0000000
NODE_80139_length_395_cov_2.587838	232	301	0	69	69	1.0000000
NODE_80139_length_395_cov_2.587838	258	302	0	44	44	1.0000000
NODE_80141_length_395_cov_2.560811	123	187	0	64	64	1.0000000
NODE_80146_length_395_cov_2.527027	194	274	0	80	80	1.0000000
NODE_80146_length_395_cov_2.527027	247	327	0	80	80	1.0000000
NODE_80439_length_395_cov_1.033784	103	151	0	48	48	1.0000000
NODE_80448_length_395_cov_1.010135	85	105	0	20	20	1.0000000
NODE_80639_length_394_cov_9.464407	211	291	1	12	80	0.1500000
NODE_80639_length_394_cov_9.464407	211	291	2	68	80	0.8500000
NODE_80639_length_394_cov_9.464407	264	344	0	23	80	0.2875000
NODE_80639_length_394_cov_9.464407	264	344	1	42	80	0.5250000
NODE_80639_length_394_cov_9.464407	264	344	2	15	80	0.1875000
NODE_80643_length_394_cov_7.437288	221	301	2	1	80	0.0125000
NODE_80643_length_394_cov_7.437288	221	301	4	79	80	0.9875000
NODE_80643_length_394_cov_7.437288	274	331	2	31	57	0.5438597
NODE_80643_length_394_cov_7.437288	274	331	4	26	57	0.4561403
NODE_80647_length_394_cov_6.444068	187	267	2	80	80	1.0000000
NODE_80647_length_394_cov_6.444068	240	320	0	12	80	0.1500000
NODE_80647_length_394_cov_6.444068	240	320	1	41	80	0.5125000
NODE_80647_length_394_cov_6.444068	240	320	2	27	80	0.3375000
NODE_80709_length_394_cov_2.932203	119	140	0	21	21	1.0000000
NODE_80710_length_394_cov_2.894915	79	135	0	56	56	1.0000000
NODE_80710_length_394_cov_2.894915	166	202	0	36	36	1.0000000
NODE_81216_length_393_cov_4.261905	201	267	0	66	66	1.0000000
NODE_81216_length_393_cov_4.261905	240	282	0	42	42	1.0000000
NODE_81240_length_393_cov_3.503401	121	201	0	80	80	1.0000000
NODE_81240_length_393_cov_3.503401	174	246	0	72	72	1.0000000
NODE_81277_length_393_cov_2.704082	198	271	2	2	73	0.0273973
NODE_81277_length_393_cov_2.704082	198	271	3	1	73	0.0136986
NODE_81277_length_393_cov_2.704082	198	271	4	70	73	0.9589041
NODE_81289_length_393_cov_2.493197	136	216	0	80	80	1.0000000
NODE_81289_length_393_cov_2.493197	189	269	0	80	80	1.0000000
NODE_81296_length_393_cov_2.360544	195	252	0	57	57	1.0000000
NODE_81416_length_393_cov_1.608844	207	270	0	63	63	1.0000000
NODE_81778_length_392_cov_7.873720	161	241	0	11	80	0.1375000
NODE_81778_length_392_cov_7.873720	161	241	1	49	80	0.6125000
NODE_81778_length_392_cov_7.873720	161	241	2	20	80	0.2500000
NODE_81778_length_392_cov_7.873720	214	294	1	7	80	0.0875000
NODE_81778_length_392_cov_7.873720	214	294	2	73	80	0.9125000
NODE_81790_length_392_cov_5.262799	218	248	0	30	30	1.0000000
NODE_81805_length_392_cov_3.655290	109	157	0	48	48	1.0000000
NODE_81805_length_392_cov_3.655290	306	386	0	80	80	1.0000000
NODE_81823_length_392_cov_3.197952	102	171	0	69	69	1.0000000
NODE_81823_length_392_cov_3.197952	233	314	0	81	81	1.0000000
NODE_81857_length_392_cov_2.511945	67	133	0	36	66	0.5454546
NODE_81857_length_392_cov_2.511945	67	133	2	30	66	0.4545455
NODE_81857_length_392_cov_2.511945	120	206	2	86	86	1.0000000
NODE_81914_length_392_cov_2.075085	268	349	0	81	81	1.0000000
NODE_81914_length_392_cov_2.075085	322	387	0	65	65	1.0000000
NODE_81928_length_392_cov_1.955631	11	56	0	45	45	1.0000000
NODE_81929_length_392_cov_1.952218	40	59	0	19	19	1.0000000
NODE_81940_length_392_cov_1.911263	238	315	0	42	77	0.5454546
NODE_81940_length_392_cov_1.911263	238	315	1	35	77	0.4545455
NODE_81994_length_392_cov_1.631399	114	139	0	25	25	1.0000000
NODE_82008_length_392_cov_1.559727	83	163	0	80	80	1.0000000
NODE_82015_length_392_cov_1.552901	32	52	0	20	20	1.0000000
NODE_82390_length_391_cov_69.510274	9	89	6	6	80	0.0750000
NODE_82390_length_391_cov_69.510274	9	89	7	3	80	0.0375000
NODE_82390_length_391_cov_69.510274	9	89	8	1	80	0.0125000
NODE_82390_length_391_cov_69.510274	9	89	9	1	80	0.0125000
NODE_82390_length_391_cov_69.510274	9	89	10	2	80	0.0250000
NODE_82390_length_391_cov_69.510274	9	89	11	4	80	0.0500000
NODE_82390_length_391_cov_69.510274	9	89	12	4	80	0.0500000
NODE_82390_length_391_cov_69.510274	9	89	13	8	80	0.1000000
NODE_82390_length_391_cov_69.510274	9	89	14	4	80	0.0500000
NODE_82390_length_391_cov_69.510274	9	89	15	1	80	0.0125000
NODE_82390_length_391_cov_69.510274	9	89	17	8	80	0.1000000
NODE_82390_length_391_cov_69.510274	9	89	18	11	80	0.1375000
NODE_82390_length_391_cov_69.510274	9	89	19	3	80	0.0375000
NODE_82390_length_391_cov_69.510274	9	89	22	5	80	0.0625000
NODE_82390_length_391_cov_69.510274	9	89	23	4	80	0.0500000
NODE_82390_length_391_cov_69.510274	9	89	25	15	80	0.1875000
NODE_82391_length_391_cov_39.414384	0	66	6	21	66	0.3181818
NODE_82391_length_391_cov_39.414384	0	66	7	22	66	0.3333333
NODE_82391_length_391_cov_39.414384	0	66	8	6	66	0.0909091
NODE_82391_length_391_cov_39.414384	0	66	11	5	66	0.0757576
NODE_82391_length_391_cov_39.414384	0	66	23	12	66	0.1818182
NODE_82391_length_391_cov_39.414384	0	71	6	21	71	0.2957746
NODE_82391_length_391_cov_39.414384	0	71	7	22	71	0.3098592
NODE_82391_length_391_cov_39.414384	0	71	8	6	71	0.0845070
NODE_82391_length_391_cov_39.414384	0	71	11	5	71	0.0704225
NODE_82391_length_391_cov_39.414384	0	71	23	14	71	0.1971831
NODE_82391_length_391_cov_39.414384	0	71	25	3	71	0.0422535
NODE_82391_length_391_cov_39.414384	44	124	8	5	80	0.0625000
NODE_82391_length_391_cov_39.414384	44	124	11	5	80	0.0625000
NODE_82391_length_391_cov_39.414384	44	124	23	14	80	0.1750000
NODE_82391_length_391_cov_39.414384	44	124	25	5	80	0.0625000
NODE_82391_length_391_cov_39.414384	44	124	26	3	80	0.0375000
NODE_82391_length_391_cov_39.414384	44	124	28	4	80	0.0500000
NODE_82391_length_391_cov_39.414384	44	124	30	30	80	0.3750000
NODE_82391_length_391_cov_39.414384	44	124	31	14	80	0.1750000
NODE_82394_length_391_cov_10.352740	156	235	0	53	79	0.6708861
NODE_82394_length_391_cov_10.352740	156	235	1	26	79	0.3291139
NODE_82415_length_391_cov_5.030822	85	166	0	81	81	1.0000000
NODE_82498_length_391_cov_2.660959	267	343	0	76	76	1.0000000
NODE_82552_length_391_cov_2.089041	176	256	0	80	80	1.0000000
NODE_82552_length_391_cov_2.089041	229	280	0	51	51	1.0000000
NODE_82574_length_391_cov_1.907534	200	257	0	57	57	1.0000000
NODE_82597_length_391_cov_1.773973	160	190	0	30	30	1.0000000
NODE_82632_length_391_cov_1.647260	298	378	0	80	80	1.0000000
NODE_82662_length_391_cov_1.561644	241	261	0	20	20	1.0000000
NODE_83015_length_390_cov_29.030928	86	166	5	51	80	0.6375000
NODE_83015_length_390_cov_29.030928	86	166	8	2	80	0.0250000
NODE_83015_length_390_cov_29.030928	86	166	9	25	80	0.3125000
NODE_83015_length_390_cov_29.030928	86	166	10	2	80	0.0250000
NODE_83015_length_390_cov_29.030928	139	219	8	5	80	0.0625000
NODE_83015_length_390_cov_29.030928	139	219	9	38	80	0.4750000
NODE_83015_length_390_cov_29.030928	139	219	10	37	80	0.4625000
NODE_83016_length_390_cov_22.319588	118	198	0	80	80	1.0000000
NODE_83016_length_390_cov_22.319588	171	251	0	80	80	1.0000000
NODE_83044_length_390_cov_4.481100	208	277	1	28	69	0.4057971
NODE_83044_length_390_cov_4.481100	208	277	2	41	69	0.5942029
NODE_83044_length_390_cov_4.481100	286	327	0	6	41	0.1463415
NODE_83044_length_390_cov_4.481100	286	327	1	35	41	0.8536586
NODE_83045_length_390_cov_4.481100	93	171	0	78	78	1.0000000
NODE_83045_length_390_cov_4.481100	144	210	0	66	66	1.0000000
NODE_83060_length_390_cov_3.814433	66	99	0	33	33	1.0000000
NODE_83061_length_390_cov_3.783505	188	268	0	80	80	1.0000000
NODE_83061_length_390_cov_3.783505	241	321	0	80	80	1.0000000
NODE_83066_length_390_cov_3.560137	304	367	0	63	63	1.0000000
NODE_83066_length_390_cov_3.560137	340	381	0	41	41	1.0000000
NODE_83169_length_390_cov_2.127148	242	322	0	80	80	1.0000000
NODE_83171_length_390_cov_2.123711	133	177	0	44	44	1.0000000
NODE_83171_length_390_cov_2.123711	157	237	0	80	80	1.0000000
NODE_83288_length_390_cov_1.536082	223	276	0	53	53	1.0000000
NODE_83338_length_390_cov_1.398625	49	110	0	61	61	1.0000000
NODE_83463_length_390_cov_1.034364	78	158	0	80	80	1.0000000
NODE_83633_length_389_cov_63.710345	32	112	2	21	80	0.2625000
NODE_83633_length_389_cov_63.710345	32	112	4	30	80	0.3750000
NODE_83633_length_389_cov_63.710345	32	112	5	8	80	0.1000000
NODE_83633_length_389_cov_63.710345	32	112	7	9	80	0.1125000
NODE_83633_length_389_cov_63.710345	32	112	8	5	80	0.0625000
NODE_83633_length_389_cov_63.710345	32	112	9	7	80	0.0875000
NODE_83633_length_389_cov_63.710345	85	165	5	6	80	0.0750000
NODE_83633_length_389_cov_63.710345	85	165	7	9	80	0.1125000
NODE_83633_length_389_cov_63.710345	85	165	8	5	80	0.0625000
NODE_83633_length_389_cov_63.710345	85	165	9	20	80	0.2500000
NODE_83633_length_389_cov_63.710345	85	165	10	35	80	0.4375000
NODE_83633_length_389_cov_63.710345	85	165	12	5	80	0.0625000
NODE_83633_length_389_cov_63.710345	161	241	12	5	80	0.0625000
NODE_83633_length_389_cov_63.710345	161	241	13	27	80	0.3375000
NODE_83633_length_389_cov_63.710345	161	241	14	45	80	0.5625000
NODE_83633_length_389_cov_63.710345	161	241	16	3	80	0.0375000
NODE_83633_length_389_cov_63.710345	214	294	10	24	80	0.3000000
NODE_83633_length_389_cov_63.710345	214	294	11	15	80	0.1875000
NODE_83633_length_389_cov_63.710345	214	294	12	5	80	0.0625000
NODE_83633_length_389_cov_63.710345	214	294	13	9	80	0.1125000
NODE_83633_length_389_cov_63.710345	214	294	14	27	80	0.3375000
NODE_83650_length_389_cov_5.382759	154	234	0	80	80	1.0000000
NODE_83662_length_389_cov_4.468966	199	269	0	70	70	1.0000000
NODE_83663_length_389_cov_4.424138	68	148	2	80	80	1.0000000
NODE_83685_length_389_cov_3.782759	194	225	0	31	31	1.0000000
NODE_83689_length_389_cov_3.555172	107	153	0	46	46	1.0000000
NODE_83695_length_389_cov_3.251724	120	163	1	10	43	0.2325581
NODE_83695_length_389_cov_3.251724	120	163	2	15	43	0.3488372
NODE_83695_length_389_cov_3.251724	120	163	3	18	43	0.4186046
NODE_83695_length_389_cov_3.251724	136	206	1	53	70	0.7571428
NODE_83695_length_389_cov_3.251724	136	206	2	4	70	0.0571429
NODE_83695_length_389_cov_3.251724	136	206	3	13	70	0.1857143
NODE_83816_length_389_cov_1.951724	68	148	0	80	80	1.0000000
NODE_83819_length_389_cov_1.937931	53	82	0	29	29	1.0000000
NODE_83819_length_389_cov_1.937931	153	233	0	80	80	1.0000000
NODE_83829_length_389_cov_1.920690	296	365	0	56	69	0.8115942
NODE_83829_length_389_cov_1.920690	296	365	1	13	69	0.1884058
NODE_84182_length_389_cov_0.720690	294	374	0	80	80	1.0000000
NODE_84267_length_388_cov_9.179931	47	127	0	80	80	1.0000000
NODE_84267_length_388_cov_9.179931	100	180	0	80	80	1.0000000
NODE_84270_length_388_cov_7.249135	171	251	0	80	80	1.0000000
NODE_84270_length_388_cov_7.249135	224	304	0	80	80	1.0000000
NODE_84305_length_388_cov_3.913495	151	231	0	80	80	1.0000000
NODE_84308_length_388_cov_3.809689	233	277	0	44	44	1.0000000
NODE_84332_length_388_cov_3.103806	101	166	0	65	65	1.0000000
NODE_84332_length_388_cov_3.103806	147	227	0	80	80	1.0000000
NODE_84334_length_388_cov_3.041522	48	128	1	80	80	1.0000000
NODE_84410_length_388_cov_2.114187	82	141	0	59	59	1.0000000
NODE_84410_length_388_cov_2.114187	135	194	0	59	59	1.0000000
NODE_84423_length_388_cov_2.017301	99	151	0	52	52	1.0000000
NODE_84427_length_388_cov_1.989619	0	76	0	76	76	1.0000000
NODE_84427_length_388_cov_1.989619	49	114	0	65	65	1.0000000
NODE_84587_length_388_cov_1.352941	172	247	0	75	75	1.0000000
NODE_84631_length_388_cov_1.228374	308	339	0	31	31	1.0000000
NODE_84885_length_387_cov_33.052083	194	274	0	80	80	1.0000000
NODE_84885_length_387_cov_33.052083	247	327	0	80	80	1.0000000
NODE_84890_length_387_cov_6.871528	26	106	0	80	80	1.0000000
NODE_84890_length_387_cov_6.871528	79	159	0	80	80	1.0000000
NODE_84902_length_387_cov_5.420139	286	341	0	55	55	1.0000000
NODE_84946_length_387_cov_3.364583	287	367	0	80	80	1.0000000
NODE_85007_length_387_cov_2.260417	140	210	0	70	70	1.0000000
NODE_85019_length_387_cov_2.128472	220	286	0	66	66	1.0000000
NODE_85019_length_387_cov_2.128472	273	329	0	56	56	1.0000000
NODE_85032_length_387_cov_2.090278	318	352	0	34	34	1.0000000
NODE_85037_length_387_cov_2.055556	23	45	0	22	22	1.0000000
NODE_85047_length_387_cov_1.979167	259	316	0	57	57	1.0000000
NODE_85047_length_387_cov_1.979167	312	369	0	57	57	1.0000000
NODE_85091_length_387_cov_1.770833	315	361	0	46	46	1.0000000
NODE_85528_length_386_cov_9.979094	38	118	0	80	80	1.0000000
NODE_85528_length_386_cov_9.979094	91	174	0	83	83	1.0000000
NODE_85546_length_386_cov_4.428571	197	249	0	52	52	1.0000000
NODE_85570_length_386_cov_3.355401	151	231	0	80	80	1.0000000
NODE_85570_length_386_cov_3.355401	204	265	0	61	61	1.0000000
NODE_85602_length_386_cov_2.686411	293	325	0	32	32	1.0000000
NODE_85602_length_386_cov_2.686411	349	379	0	30	30	1.0000000
NODE_85629_length_386_cov_2.442509	55	135	0	80	80	1.0000000
NODE_85629_length_386_cov_2.442509	108	164	0	56	56	1.0000000
NODE_85793_length_386_cov_1.494774	79	121	0	42	42	1.0000000
NODE_85793_length_386_cov_1.494774	93	156	0	63	63	1.0000000
NODE_85816_length_386_cov_1.421603	160	236	1	75	76	0.9868421
NODE_85816_length_386_cov_1.421603	160	236	2	1	76	0.0131579
NODE_85845_length_386_cov_1.372822	62	142	0	64	80	0.8000000
NODE_85845_length_386_cov_1.372822	62	142	2	16	80	0.2000000
NODE_85845_length_386_cov_1.372822	115	195	0	11	80	0.1375000
NODE_85845_length_386_cov_1.372822	115	195	2	69	80	0.8625000
NODE_85858_length_386_cov_1.317073	124	161	0	37	37	1.0000000
NODE_85902_length_386_cov_1.170732	260	308	0	48	48	1.0000000
NODE_86143_length_385_cov_167.877622	103	164	16	4	61	0.0655738
NODE_86143_length_385_cov_167.877622	103	164	17	5	61	0.0819672
NODE_86143_length_385_cov_167.877622	103	164	19	16	61	0.2622951
NODE_86143_length_385_cov_167.877622	103	164	20	7	61	0.1147541
NODE_86143_length_385_cov_167.877622	103	164	21	4	61	0.0655738
NODE_86143_length_385_cov_167.877622	103	164	26	1	61	0.0163934
NODE_86143_length_385_cov_167.877622	103	164	27	10	61	0.1639344
NODE_86143_length_385_cov_167.877622	103	164	28	5	61	0.0819672
NODE_86143_length_385_cov_167.877622	103	164	29	9	61	0.1475410
NODE_86144_length_385_cov_38.695804	164	244	2	3	80	0.0375000
NODE_86144_length_385_cov_38.695804	164	244	3	9	80	0.1125000
NODE_86144_length_385_cov_38.695804	164	244	4	68	80	0.8500000
NODE_86144_length_385_cov_38.695804	217	297	3	43	80	0.5375000
NODE_86144_length_385_cov_38.695804	217	297	4	37	80	0.4625000
NODE_86169_length_385_cov_4.335664	173	250	0	77	77	1.0000000
NODE_86185_length_385_cov_3.793706	215	297	0	82	82	1.0000000
NODE_86230_length_385_cov_2.786713	99	179	0	80	80	1.0000000
NODE_86230_length_385_cov_2.786713	152	232	0	80	80	1.0000000
NODE_86230_length_385_cov_2.786713	281	362	0	81	81	1.0000000
NODE_86448_length_385_cov_1.381119	71	145	0	74	74	1.0000000
NODE_86448_length_385_cov_1.381119	118	198	0	80	80	1.0000000
NODE_86798_length_384_cov_3.996491	135	217	2	4	82	0.0487805
NODE_86798_length_384_cov_3.996491	135	217	3	15	82	0.1829268
NODE_86798_length_384_cov_3.996491	135	217	5	63	82	0.7682927
NODE_86809_length_384_cov_3.729825	181	228	0	47	47	1.0000000
NODE_86812_length_384_cov_3.715789	145	221	1	76	76	1.0000000
NODE_86841_length_384_cov_2.996491	147	227	0	80	80	1.0000000
NODE_86847_length_384_cov_2.835088	65	145	0	80	80	1.0000000
NODE_86866_length_384_cov_2.575439	151	224	0	73	73	1.0000000
NODE_86866_length_384_cov_2.575439	197	281	0	84	84	1.0000000
NODE_86907_length_384_cov_2.231579	78	153	0	75	75	1.0000000
NODE_86942_length_384_cov_1.940351	73	153	0	80	80	1.0000000
NODE_87431_length_383_cov_4.869718	117	197	2	21	80	0.2625000
NODE_87431_length_383_cov_4.869718	117	197	5	59	80	0.7375000
NODE_87431_length_383_cov_4.869718	170	250	5	38	80	0.4750000
NODE_87431_length_383_cov_4.869718	170	250	6	8	80	0.1000000
NODE_87431_length_383_cov_4.869718	170	250	9	31	80	0.3875000
NODE_87431_length_383_cov_4.869718	170	250	11	3	80	0.0375000
NODE_87432_length_383_cov_4.841549	121	180	0	59	59	1.0000000
NODE_87438_length_383_cov_4.559859	33	109	0	76	76	1.0000000
NODE_87487_length_383_cov_2.940141	185	265	0	80	80	1.0000000
NODE_87495_length_383_cov_2.760563	123	203	8	17	80	0.2125000
NODE_87495_length_383_cov_2.760563	123	203	9	63	80	0.7875000
NODE_87495_length_383_cov_2.760563	169	249	3	18	80	0.2250000
NODE_87495_length_383_cov_2.760563	169	249	4	1	80	0.0125000
NODE_87495_length_383_cov_2.760563	169	249	5	2	80	0.0250000
NODE_87495_length_383_cov_2.760563	169	249	6	11	80	0.1375000
NODE_87495_length_383_cov_2.760563	169	249	7	12	80	0.1500000
NODE_87495_length_383_cov_2.760563	169	249	8	19	80	0.2375000
NODE_87495_length_383_cov_2.760563	169	249	9	17	80	0.2125000
NODE_87495_length_383_cov_2.760563	222	302	0	40	80	0.5000000
NODE_87495_length_383_cov_2.760563	222	302	1	8	80	0.1000000
NODE_87495_length_383_cov_2.760563	222	302	3	23	80	0.2875000
NODE_87495_length_383_cov_2.760563	222	302	4	1	80	0.0125000
NODE_87495_length_383_cov_2.760563	222	302	5	2	80	0.0250000
NODE_87495_length_383_cov_2.760563	222	302	6	6	80	0.0750000
NODE_87566_length_383_cov_2.123239	29	94	0	65	65	1.0000000
NODE_87566_length_383_cov_2.123239	93	173	0	80	80	1.0000000
NODE_87566_length_383_cov_2.123239	146	193	0	47	47	1.0000000
NODE_87634_length_383_cov_1.728873	196	257	0	61	61	1.0000000
NODE_87634_length_383_cov_1.728873	239	310	0	71	71	1.0000000
NODE_88039_length_382_cov_43.724382	245	325	3	8	80	0.1000000
NODE_88039_length_382_cov_43.724382	245	325	4	30	80	0.3750000
NODE_88039_length_382_cov_43.724382	245	325	5	16	80	0.2000000
NODE_88039_length_382_cov_43.724382	245	325	6	26	80	0.3250000
NODE_88039_length_382_cov_43.724382	298	378	0	43	80	0.5375000
NODE_88039_length_382_cov_43.724382	298	378	3	18	80	0.2250000
NODE_88039_length_382_cov_43.724382	298	378	4	19	80	0.2375000
NODE_88040_length_382_cov_35.908127	163	243	2	25	80	0.3125000
NODE_88040_length_382_cov_35.908127	163	243	4	6	80	0.0750000
NODE_88040_length_382_cov_35.908127	163	243	6	49	80	0.6125000
NODE_88040_length_382_cov_35.908127	216	296	4	5	80	0.0625000
NODE_88040_length_382_cov_35.908127	216	296	6	75	80	0.9375000
NODE_88040_length_382_cov_35.908127	292	372	2	33	80	0.4125000
NODE_88040_length_382_cov_35.908127	292	372	4	1	80	0.0125000
NODE_88040_length_382_cov_35.908127	292	372	6	46	80	0.5750000
NODE_88041_length_382_cov_26.240283	57	137	0	38	80	0.4750000
NODE_88041_length_382_cov_26.240283	57	137	8	42	80	0.5250000
NODE_88041_length_382_cov_26.240283	110	190	8	80	80	1.0000000
NODE_88054_length_382_cov_5.583039	63	143	0	80	80	1.0000000
NODE_88054_length_382_cov_5.583039	116	196	0	80	80	1.0000000
NODE_88063_length_382_cov_4.837456	19	78	0	59	59	1.0000000
NODE_88067_length_382_cov_4.618375	0	55	0	55	55	1.0000000
NODE_88067_length_382_cov_4.618375	104	184	0	80	80	1.0000000
NODE_88067_length_382_cov_4.618375	157	237	0	80	80	1.0000000
NODE_88075_length_382_cov_4.268551	71	152	0	46	81	0.5679013
NODE_88075_length_382_cov_4.268551	71	152	2	3	81	0.0370370
NODE_88075_length_382_cov_4.268551	71	152	3	23	81	0.2839506
NODE_88075_length_382_cov_4.268551	71	152	4	9	81	0.1111111
NODE_88075_length_382_cov_4.268551	124	205	3	19	81	0.2345679
NODE_88075_length_382_cov_4.268551	124	205	4	55	81	0.6790124
NODE_88075_length_382_cov_4.268551	124	205	5	1	81	0.0123457
NODE_88075_length_382_cov_4.268551	124	205	6	6	81	0.0740741
NODE_88080_length_382_cov_4.091873	30	92	0	62	62	1.0000000
NODE_88121_length_382_cov_3.031802	173	253	0	32	80	0.4000000
NODE_88121_length_382_cov_3.031802	173	253	2	48	80	0.6000000
NODE_88121_length_382_cov_3.031802	226	295	2	69	69	1.0000000
NODE_88135_length_382_cov_2.798587	231	293	0	62	62	1.0000000
NODE_88136_length_382_cov_2.791519	195	244	1	16	49	0.3265306
NODE_88136_length_382_cov_2.791519	195	244	3	25	49	0.5102041
NODE_88136_length_382_cov_2.791519	195	244	4	8	49	0.1632653
NODE_88136_length_382_cov_2.791519	217	297	3	19	80	0.2375000
NODE_88136_length_382_cov_2.791519	217	297	4	61	80	0.7625000
NODE_88164_length_382_cov_2.611307	301	368	0	67	67	1.0000000
NODE_88276_length_382_cov_1.802120	0	60	0	60	60	1.0000000
NODE_88660_length_382_cov_0.738516	48	95	0	47	47	1.0000000
NODE_88660_length_382_cov_0.738516	68	148	0	80	80	1.0000000
NODE_88758_length_381_cov_12.010638	195	274	2	79	79	1.0000000
NODE_88865_length_381_cov_2.606383	68	98	0	30	30	1.0000000
NODE_88867_length_381_cov_2.570922	115	175	0	60	60	1.0000000
NODE_88872_length_381_cov_2.514184	225	307	0	82	82	1.0000000
NODE_88900_length_381_cov_2.198582	193	276	0	83	83	1.0000000
NODE_88935_length_381_cov_1.989362	279	325	0	46	46	1.0000000
NODE_89009_length_381_cov_1.663121	51	128	2	5	77	0.0649351
NODE_89009_length_381_cov_1.663121	51	128	3	40	77	0.5194805
NODE_89009_length_381_cov_1.663121	51	128	5	5	77	0.0649351
NODE_89009_length_381_cov_1.663121	51	128	6	27	77	0.3506494
NODE_89009_length_381_cov_1.663121	101	181	6	80	80	1.0000000
NODE_89090_length_381_cov_1.400709	254	334	0	80	80	1.0000000
NODE_89090_length_381_cov_1.400709	254	334	0	80	80	1.0000000
NODE_89090_length_381_cov_1.400709	309	373	0	64	64	1.0000000
NODE_89482_length_380_cov_57.604982	196	276	4	20	80	0.2500000
NODE_89482_length_380_cov_57.604982	196	276	7	4	80	0.0500000
NODE_89482_length_380_cov_57.604982	196	276	9	56	80	0.7000000
NODE_89482_length_380_cov_57.604982	249	329	0	42	80	0.5250000
NODE_89482_length_380_cov_57.604982	249	329	2	10	80	0.1250000
NODE_89482_length_380_cov_57.604982	249	329	4	21	80	0.2625000
NODE_89482_length_380_cov_57.604982	249	329	7	4	80	0.0500000
NODE_89482_length_380_cov_57.604982	249	329	9	3	80	0.0375000
NODE_89482_length_380_cov_57.604982	325	359	0	34	34	1.0000000
NODE_89483_length_380_cov_11.185053	79	161	0	82	82	1.0000000
NODE_89483_length_380_cov_11.185053	134	214	0	62	80	0.7750000
NODE_89483_length_380_cov_11.185053	134	214	1	7	80	0.0875000
NODE_89483_length_380_cov_11.185053	134	214	2	11	80	0.1375000
NODE_89491_length_380_cov_5.811388	100	156	0	56	56	1.0000000
NODE_89491_length_380_cov_5.811388	177	213	0	36	36	1.0000000
NODE_89495_length_380_cov_5.377224	242	271	8	23	29	0.7931035
NODE_89495_length_380_cov_5.377224	242	271	11	1	29	0.0344828
NODE_89495_length_380_cov_5.377224	242	271	12	5	29	0.1724138
NODE_89508_length_380_cov_4.185053	158	230	0	72	72	1.0000000
NODE_89508_length_380_cov_4.185053	159	229	0	70	70	1.0000000
NODE_89508_length_380_cov_4.185053	203	283	0	80	80	1.0000000
NODE_89508_length_380_cov_4.185053	203	283	0	80	80	1.0000000
NODE_89527_length_380_cov_3.423488	164	233	0	69	69	1.0000000
NODE_89540_length_380_cov_3.153025	188	260	0	41	72	0.5694444
NODE_89540_length_380_cov_3.153025	188	260	2	31	72	0.4305556
NODE_89568_length_380_cov_2.718861	51	131	0	80	80	1.0000000
NODE_89568_length_380_cov_2.718861	104	184	0	80	80	1.0000000
NODE_89658_length_380_cov_1.943060	22	56	0	34	34	1.0000000
NODE_89750_length_380_cov_1.601423	292	332	1	40	40	1.0000000
NODE_89911_length_380_cov_1.088968	312	353	0	41	41	1.0000000
NODE_89911_length_380_cov_1.088968	326	380	0	54	54	1.0000000
NODE_90152_length_379_cov_42.339286	10	90	0	80	80	1.0000000
NODE_90152_length_379_cov_42.339286	86	166	0	80	80	1.0000000
NODE_90152_length_379_cov_42.339286	139	219	0	80	80	1.0000000
NODE_90153_length_379_cov_32.075000	0	62	0	62	62	1.0000000
NODE_90165_length_379_cov_5.607143	279	338	0	59	59	1.0000000
NODE_90180_length_379_cov_4.432143	219	243	0	24	24	1.0000000
NODE_90193_length_379_cov_3.778571	271	300	0	29	29	1.0000000
NODE_90198_length_379_cov_3.585714	128	152	0	24	24	1.0000000
NODE_90198_length_379_cov_3.585714	169	249	0	80	80	1.0000000
NODE_90203_length_379_cov_3.375000	19	43	0	24	24	1.0000000
NODE_90247_length_379_cov_2.692857	121	201	0	80	80	1.0000000
NODE_90247_length_379_cov_2.692857	174	221	0	47	47	1.0000000
NODE_90789_length_378_cov_53.039427	147	227	4	1	80	0.0125000
NODE_90789_length_378_cov_53.039427	147	227	5	37	80	0.4625000
NODE_90789_length_378_cov_53.039427	147	227	6	17	80	0.2125000
NODE_90789_length_378_cov_53.039427	147	227	7	13	80	0.1625000
NODE_90789_length_378_cov_53.039427	147	227	8	12	80	0.1500000
NODE_90789_length_378_cov_53.039427	200	280	2	27	80	0.3375000
NODE_90789_length_378_cov_53.039427	200	280	4	27	80	0.3375000
NODE_90789_length_378_cov_53.039427	200	280	5	26	80	0.3250000
NODE_90789_length_378_cov_53.039427	276	356	0	46	80	0.5750000
NODE_90789_length_378_cov_53.039427	276	356	1	21	80	0.2625000
NODE_90789_length_378_cov_53.039427	276	356	2	13	80	0.1625000
NODE_90789_length_378_cov_53.039427	329	378	0	49	49	1.0000000
NODE_90794_length_378_cov_6.569892	223	304	1	80	81	0.9876543
NODE_90794_length_378_cov_6.569892	223	304	2	1	81	0.0123457
NODE_90795_length_378_cov_6.444444	217	297	0	80	80	1.0000000
NODE_90795_length_378_cov_6.444444	270	350	0	80	80	1.0000000
NODE_90808_length_378_cov_4.899642	135	191	0	35	56	0.6250000
NODE_90808_length_378_cov_4.899642	135	191	2	21	56	0.3750000
NODE_90855_length_378_cov_3.236559	143	212	0	69	69	1.0000000
NODE_90859_length_378_cov_3.132616	238	280	0	42	42	1.0000000
NODE_90898_length_378_cov_2.534050	203	243	0	40	40	1.0000000
NODE_90898_length_378_cov_2.534050	271	347	0	76	76	1.0000000
NODE_90898_length_378_cov_2.534050	331	360	0	29	29	1.0000000
NODE_90948_length_378_cov_2.093190	179	250	0	71	71	1.0000000
NODE_90948_length_378_cov_2.093190	183	219	0	36	36	1.0000000
NODE_91002_length_378_cov_1.813620	36	89	0	53	53	1.0000000
NODE_91475_length_377_cov_71.723022	19	99	11	6	80	0.0750000
NODE_91475_length_377_cov_71.723022	19	99	13	3	80	0.0375000
NODE_91475_length_377_cov_71.723022	19	99	14	4	80	0.0500000
NODE_91475_length_377_cov_71.723022	19	99	15	21	80	0.2625000
NODE_91475_length_377_cov_71.723022	19	99	16	26	80	0.3250000
NODE_91475_length_377_cov_71.723022	19	99	17	20	80	0.2500000
NODE_91475_length_377_cov_71.723022	72	152	16	7	80	0.0875000
NODE_91475_length_377_cov_71.723022	72	152	17	38	80	0.4750000
NODE_91475_length_377_cov_71.723022	72	152	19	13	80	0.1625000
NODE_91475_length_377_cov_71.723022	72	152	20	11	80	0.1375000
NODE_91475_length_377_cov_71.723022	72	152	21	11	80	0.1375000
NODE_91475_length_377_cov_71.723022	148	228	6	10	80	0.1250000
NODE_91475_length_377_cov_71.723022	148	228	7	36	80	0.4500000
NODE_91475_length_377_cov_71.723022	148	228	8	4	80	0.0500000
NODE_91475_length_377_cov_71.723022	148	228	9	24	80	0.3000000
NODE_91475_length_377_cov_71.723022	148	228	11	1	80	0.0125000
NODE_91475_length_377_cov_71.723022	148	228	17	2	80	0.0250000
NODE_91475_length_377_cov_71.723022	148	228	19	3	80	0.0375000
NODE_91475_length_377_cov_71.723022	201	281	5	4	80	0.0500000
NODE_91475_length_377_cov_71.723022	201	281	6	30	80	0.3750000
NODE_91475_length_377_cov_71.723022	201	281	7	18	80	0.2250000
NODE_91475_length_377_cov_71.723022	201	281	9	28	80	0.3500000
NODE_91477_length_377_cov_41.787770	210	290	6	7	80	0.0875000
NODE_91477_length_377_cov_41.787770	210	290	7	38	80	0.4750000
NODE_91477_length_377_cov_41.787770	210	290	9	25	80	0.3125000
NODE_91477_length_377_cov_41.787770	210	290	10	2	80	0.0250000
NODE_91477_length_377_cov_41.787770	210	290	11	8	80	0.1000000
NODE_91477_length_377_cov_41.787770	263	343	4	46	80	0.5750000
NODE_91477_length_377_cov_41.787770	263	343	5	1	80	0.0125000
NODE_91477_length_377_cov_41.787770	263	343	6	13	80	0.1625000
NODE_91477_length_377_cov_41.787770	263	343	7	20	80	0.2500000
NODE_91478_length_377_cov_9.982014	32	83	0	38	51	0.7450981
NODE_91478_length_377_cov_9.982014	32	83	2	13	51	0.2549020
NODE_91486_length_377_cov_6.244604	101	177	2	76	76	1.0000000
NODE_91494_length_377_cov_5.183453	169	224	0	55	55	1.0000000
NODE_91499_length_377_cov_4.586331	186	266	0	80	80	1.0000000
NODE_91499_length_377_cov_4.586331	239	319	0	80	80	1.0000000
NODE_91500_length_377_cov_4.431655	139	216	1	67	77	0.8701299
NODE_91500_length_377_cov_4.431655	139	216	2	10	77	0.1298701
NODE_91502_length_377_cov_4.330935	134	214	0	80	80	1.0000000
NODE_91502_length_377_cov_4.330935	187	267	0	80	80	1.0000000
NODE_91506_length_377_cov_4.032374	124	181	0	57	57	1.0000000
NODE_91506_length_377_cov_4.032374	154	201	0	47	47	1.0000000
NODE_91526_length_377_cov_3.615108	82	140	0	58	58	1.0000000
NODE_91526_length_377_cov_3.615108	82	140	0	58	58	1.0000000
NODE_91526_length_377_cov_3.615108	113	193	0	80	80	1.0000000
NODE_91526_length_377_cov_3.615108	113	193	0	80	80	1.0000000
NODE_91526_length_377_cov_3.615108	189	258	0	69	69	1.0000000
NODE_91526_length_377_cov_3.615108	243	313	0	70	70	1.0000000
NODE_91553_length_377_cov_2.913669	38	61	0	23	23	1.0000000
NODE_91553_length_377_cov_2.913669	167	228	0	61	61	1.0000000
NODE_91619_length_377_cov_2.104317	137	188	0	51	51	1.0000000
NODE_91619_length_377_cov_2.104317	168	211	0	43	43	1.0000000
NODE_91619_length_377_cov_2.104317	190	241	0	51	51	1.0000000
NODE_91727_length_377_cov_1.622302	123	181	0	58	58	1.0000000
NODE_91727_length_377_cov_1.622302	176	234	0	58	58	1.0000000
NODE_91749_length_377_cov_1.539568	230	310	0	80	80	1.0000000
NODE_91749_length_377_cov_1.539568	230	310	0	80	80	1.0000000
NODE_91749_length_377_cov_1.539568	306	377	0	71	71	1.0000000
NODE_91749_length_377_cov_1.539568	327	351	0	24	24	1.0000000
NODE_91765_length_377_cov_1.471223	118	198	1	6	80	0.0750000
NODE_91765_length_377_cov_1.471223	118	198	3	28	80	0.3500000
NODE_91765_length_377_cov_1.471223	118	198	4	35	80	0.4375000
NODE_91765_length_377_cov_1.471223	118	198	5	11	80	0.1375000
NODE_91790_length_377_cov_1.456835	177	257	0	80	80	1.0000000
NODE_91790_length_377_cov_1.456835	230	310	0	80	80	1.0000000
NODE_91817_length_377_cov_1.330935	0	44	0	44	44	1.0000000
NODE_91817_length_377_cov_1.330935	45	117	0	72	72	1.0000000
NODE_92046_length_377_cov_0.762590	299	330	0	31	31	1.0000000
NODE_92166_length_376_cov_6.938628	0	63	0	44	63	0.6984127
NODE_92166_length_376_cov_6.938628	0	63	1	19	63	0.3015873
NODE_92166_length_376_cov_6.938628	269	340	0	71	71	1.0000000
NODE_92168_length_376_cov_6.415162	177	257	0	80	80	1.0000000
NODE_92168_length_376_cov_6.415162	230	310	0	80	80	1.0000000
NODE_92173_length_376_cov_5.722022	100	171	0	71	71	1.0000000
NODE_92173_length_376_cov_5.722022	155	192	0	37	37	1.0000000
NODE_92191_length_376_cov_4.148014	300	330	0	30	30	1.0000000
NODE_92196_length_376_cov_3.859206	168	236	0	68	68	1.0000000
NODE_92219_length_376_cov_3.140794	122	188	0	66	66	1.0000000
NODE_92442_length_376_cov_1.516245	57	106	0	49	49	1.0000000
NODE_92879_length_375_cov_4.217391	321	350	0	29	29	1.0000000
NODE_92897_length_375_cov_3.699275	287	367	0	80	80	1.0000000
NODE_92911_length_375_cov_3.376812	70	136	0	66	66	1.0000000
NODE_93031_length_375_cov_2.032609	162	224	0	62	62	1.0000000
NODE_93031_length_375_cov_2.032609	215	272	0	57	57	1.0000000
NODE_93050_length_375_cov_1.967391	131	190	0	59	59	1.0000000
NODE_93050_length_375_cov_1.967391	184	235	0	51	51	1.0000000
NODE_93081_length_375_cov_1.840580	195	276	0	81	81	1.0000000
NODE_93386_length_375_cov_1.000000	320	375	0	55	55	1.0000000
NODE_93609_length_374_cov_4.563636	93	160	0	7	67	0.1044776
NODE_93609_length_374_cov_4.563636	93	160	1	29	67	0.4328358
NODE_93609_length_374_cov_4.563636	93	160	2	31	67	0.4626866
NODE_93609_length_374_cov_4.563636	146	213	2	67	67	1.0000000
NODE_93612_length_374_cov_4.523636	23	101	0	78	78	1.0000000
NODE_93612_length_374_cov_4.523636	81	154	0	73	73	1.0000000
NODE_93628_length_374_cov_3.810909	130	189	0	59	59	1.0000000
NODE_93628_length_374_cov_3.810909	162	242	0	80	80	1.0000000
NODE_93630_length_374_cov_3.789091	236	271	0	35	35	1.0000000
NODE_93630_length_374_cov_3.789091	238	280	0	42	42	1.0000000
NODE_93637_length_374_cov_3.458182	190	248	0	58	58	1.0000000
NODE_93688_length_374_cov_2.600000	142	217	0	25	75	0.3333333
NODE_93688_length_374_cov_2.600000	142	217	1	50	75	0.6666667
NODE_93688_length_374_cov_2.600000	190	270	0	78	80	0.9750000
NODE_93688_length_374_cov_2.600000	190	270	1	2	80	0.0250000
NODE_93718_length_374_cov_2.330909	40	120	0	80	80	1.0000000
NODE_93769_length_374_cov_2.010909	40	105	0	65	65	1.0000000
NODE_93821_length_374_cov_1.796364	254	288	0	34	34	1.0000000
NODE_93852_length_374_cov_1.661818	95	157	0	6	62	0.0967742
NODE_93852_length_374_cov_1.661818	95	157	2	48	62	0.7741935
NODE_93852_length_374_cov_1.661818	95	157	4	8	62	0.1290323
NODE_93859_length_374_cov_1.621818	202	254	0	52	52	1.0000000
NODE_93936_length_374_cov_1.360000	211	291	0	80	80	1.0000000
NODE_93981_length_374_cov_1.236364	263	336	0	73	73	1.0000000
NODE_94321_length_373_cov_31.302920	0	53	0	53	53	1.0000000
NODE_94321_length_373_cov_31.302920	0	53	0	53	53	1.0000000
NODE_94321_length_373_cov_31.302920	0	53	0	53	53	1.0000000
NODE_94321_length_373_cov_31.302920	26	106	0	80	80	1.0000000
NODE_94340_length_373_cov_4.671533	76	142	3	49	66	0.7424242
NODE_94340_length_373_cov_4.671533	76	142	6	17	66	0.2575758
NODE_94340_length_373_cov_4.671533	115	195	3	11	80	0.1375000
NODE_94340_length_373_cov_4.671533	115	195	5	1	80	0.0125000
NODE_94340_length_373_cov_4.671533	115	195	6	68	80	0.8500000
NODE_94340_length_373_cov_4.671533	115	195	3	11	80	0.1375000
NODE_94340_length_373_cov_4.671533	115	195	5	1	80	0.0125000
NODE_94340_length_373_cov_4.671533	115	195	6	68	80	0.8500000
NODE_94340_length_373_cov_4.671533	288	368	0	21	80	0.2625000
NODE_94340_length_373_cov_4.671533	288	368	1	59	80	0.7375000
NODE_94352_length_373_cov_4.080292	109	189	0	80	80	1.0000000
NODE_94352_length_373_cov_4.080292	162	220	0	58	58	1.0000000
NODE_94380_length_373_cov_3.167883	131	210	2	79	79	1.0000000
NODE_94414_length_373_cov_2.751825	80	151	0	71	71	1.0000000
NODE_94414_length_373_cov_2.751825	124	162	0	38	38	1.0000000
NODE_94493_length_373_cov_2.036496	248	326	2	78	78	1.0000000
NODE_94493_length_373_cov_2.036496	299	359	1	24	60	0.4000000
NODE_94493_length_373_cov_2.036496	299	359	2	36	60	0.6000000
NODE_94500_length_373_cov_2.003650	150	194	0	44	44	1.0000000
NODE_94937_length_373_cov_0.759124	62	114	0	52	52	1.0000000
NODE_95051_length_372_cov_30.135531	111	191	0	80	80	1.0000000
NODE_95051_length_372_cov_30.135531	159	222	0	63	63	1.0000000
NODE_95051_length_372_cov_30.135531	164	239	0	75	75	1.0000000
NODE_95051_length_372_cov_30.135531	182	253	0	71	71	1.0000000
NODE_95051_length_372_cov_30.135531	195	275	0	80	80	1.0000000
NODE_95051_length_372_cov_30.135531	213	276	0	63	63	1.0000000
NODE_95053_length_372_cov_9.091575	150	230	0	80	80	1.0000000
NODE_95053_length_372_cov_9.091575	203	283	0	80	80	1.0000000
NODE_95063_length_372_cov_5.706960	168	208	0	40	40	1.0000000
NODE_95067_length_372_cov_5.124542	146	211	0	65	65	1.0000000
NODE_95067_length_372_cov_5.124542	189	264	0	75	75	1.0000000
NODE_95090_length_372_cov_3.761905	177	221	0	44	44	1.0000000
NODE_95109_length_372_cov_3.186813	137	218	0	81	81	1.0000000
NODE_95159_length_372_cov_2.582418	167	239	2	72	72	1.0000000
NODE_95159_length_372_cov_2.582418	212	292	1	8	80	0.1000000
NODE_95159_length_372_cov_2.582418	212	292	2	72	80	0.9000000
NODE_95183_length_372_cov_2.347985	97	141	0	44	44	1.0000000
NODE_95183_length_372_cov_2.347985	98	133	0	35	35	1.0000000
NODE_95183_length_372_cov_2.347985	178	243	0	65	65	1.0000000
NODE_95303_length_372_cov_1.699634	195	276	0	81	81	1.0000000
NODE_95453_length_372_cov_1.223443	264	334	0	70	70	1.0000000
NODE_95784_length_371_cov_52.040441	104	184	0	74	80	0.9250000
NODE_95784_length_371_cov_52.040441	104	184	1	1	80	0.0125000
NODE_95784_length_371_cov_52.040441	104	184	2	1	80	0.0125000
NODE_95784_length_371_cov_52.040441	104	184	4	4	80	0.0500000
NODE_95784_length_371_cov_52.040441	157	237	0	21	80	0.2625000
NODE_95784_length_371_cov_52.040441	157	237	1	1	80	0.0125000
NODE_95784_length_371_cov_52.040441	157	237	2	1	80	0.0125000
NODE_95784_length_371_cov_52.040441	157	237	4	4	80	0.0500000
NODE_95784_length_371_cov_52.040441	157	237	5	23	80	0.2875000
NODE_95784_length_371_cov_52.040441	157	237	6	7	80	0.0875000
NODE_95784_length_371_cov_52.040441	157	237	8	1	80	0.0125000
NODE_95784_length_371_cov_52.040441	157	237	9	10	80	0.1250000
NODE_95784_length_371_cov_52.040441	157	237	11	5	80	0.0625000
NODE_95784_length_371_cov_52.040441	157	237	13	7	80	0.0875000
NODE_95784_length_371_cov_52.040441	180	232	4	4	52	0.0769231
NODE_95784_length_371_cov_52.040441	180	232	5	23	52	0.4423077
NODE_95784_length_371_cov_52.040441	180	232	6	7	52	0.1346154
NODE_95784_length_371_cov_52.040441	180	232	8	1	52	0.0192308
NODE_95784_length_371_cov_52.040441	180	232	9	10	52	0.1923077
NODE_95784_length_371_cov_52.040441	180	232	11	5	52	0.0961538
NODE_95784_length_371_cov_52.040441	180	232	13	2	52	0.0384615
NODE_95785_length_371_cov_24.878676	91	171	4	3	80	0.0375000
NODE_95785_length_371_cov_24.878676	91	171	5	77	80	0.9625000
NODE_95785_length_371_cov_24.878676	144	224	3	13	80	0.1625000
NODE_95785_length_371_cov_24.878676	144	224	4	25	80	0.3125000
NODE_95785_length_371_cov_24.878676	144	224	5	42	80	0.5250000
NODE_95797_length_371_cov_5.738971	170	245	0	75	75	1.0000000
NODE_95797_length_371_cov_5.738971	218	298	0	80	80	1.0000000
NODE_95807_length_371_cov_4.452206	65	145	0	80	80	1.0000000
NODE_95807_length_371_cov_4.452206	118	198	0	80	80	1.0000000
NODE_95863_length_371_cov_2.841912	288	350	0	62	62	1.0000000
NODE_96013_length_371_cov_1.790441	188	235	4	47	47	1.0000000
NODE_96105_length_371_cov_1.422794	199	287	1	29	88	0.3295455
NODE_96105_length_371_cov_1.422794	199	287	2	59	88	0.6704546
NODE_96500_length_370_cov_50.380074	144	224	0	80	80	1.0000000
NODE_96500_length_370_cov_50.380074	197	277	0	80	80	1.0000000
NODE_96504_length_370_cov_7.553506	105	162	0	57	57	1.0000000
NODE_96510_length_370_cov_5.811808	153	221	3	58	68	0.8529412
NODE_96510_length_370_cov_5.811808	153	221	4	10	68	0.1470588
NODE_96510_length_370_cov_5.811808	206	286	2	36	80	0.4500000
NODE_96510_length_370_cov_5.811808	206	286	3	5	80	0.0625000
NODE_96510_length_370_cov_5.811808	206	286	4	39	80	0.4875000
NODE_96522_length_370_cov_4.915129	157	207	2	50	50	1.0000000
NODE_96528_length_370_cov_4.535055	141	221	0	80	80	1.0000000
NODE_96528_length_370_cov_4.535055	194	274	0	80	80	1.0000000
NODE_96532_length_370_cov_4.199262	230	275	0	45	45	1.0000000
NODE_96533_length_370_cov_4.151292	142	209	1	4	67	0.0597015
NODE_96533_length_370_cov_4.151292	142	209	2	63	67	0.9402985
NODE_96542_length_370_cov_3.719557	214	251	1	37	37	1.0000000
NODE_96581_length_370_cov_2.822878	126	173	3	47	47	1.0000000
NODE_96668_length_370_cov_2.081181	0	52	0	52	52	1.0000000
NODE_97207_length_369_cov_36.811111	273	358	1	15	85	0.1764706
NODE_97207_length_369_cov_36.811111	273	358	2	25	85	0.2941177
NODE_97207_length_369_cov_36.811111	273	358	4	45	85	0.5294118
NODE_97207_length_369_cov_36.811111	273	358	1	15	85	0.1764706
NODE_97207_length_369_cov_36.811111	273	358	2	25	85	0.2941177
NODE_97207_length_369_cov_36.811111	273	358	4	45	85	0.5294118
NODE_97207_length_369_cov_36.811111	273	358	1	15	85	0.1764706
NODE_97207_length_369_cov_36.811111	273	358	2	25	85	0.2941177
NODE_97207_length_369_cov_36.811111	273	358	4	45	85	0.5294118
NODE_97211_length_369_cov_8.751852	107	187	0	80	80	1.0000000
NODE_97226_length_369_cov_6.677778	189	269	2	75	80	0.9375000
NODE_97226_length_369_cov_6.677778	189	269	3	5	80	0.0625000
NODE_97226_length_369_cov_6.677778	242	323	0	33	81	0.4074074
NODE_97226_length_369_cov_6.677778	242	323	2	48	81	0.5925926
NODE_97236_length_369_cov_5.337037	199	264	0	65	65	1.0000000
NODE_97249_length_369_cov_4.459259	89	157	2	68	68	1.0000000
NODE_97249_length_369_cov_4.459259	130	210	2	80	80	1.0000000
NODE_97255_length_369_cov_4.111111	216	279	0	63	63	1.0000000
NODE_97265_length_369_cov_3.837037	205	238	3	33	33	1.0000000
NODE_97265_length_369_cov_3.837037	211	291	3	80	80	1.0000000
NODE_97265_length_369_cov_3.837037	287	316	3	29	29	1.0000000
NODE_97346_length_369_cov_2.355556	62	142	0	80	80	1.0000000
NODE_97346_length_369_cov_2.355556	114	195	0	81	81	1.0000000
NODE_97440_length_369_cov_1.803704	170	235	0	65	65	1.0000000
NODE_97936_length_368_cov_42.208178	231	311	2	13	80	0.1625000
NODE_97936_length_368_cov_42.208178	231	311	3	67	80	0.8375000
NODE_97936_length_368_cov_42.208178	284	364	1	50	80	0.6250000
NODE_97936_length_368_cov_42.208178	284	364	2	16	80	0.2000000
NODE_97936_length_368_cov_42.208178	284	364	3	14	80	0.1750000
NODE_97939_length_368_cov_11.988848	47	127	0	64	80	0.8000000
NODE_97939_length_368_cov_11.988848	47	127	1	16	80	0.2000000
NODE_97939_length_368_cov_11.988848	100	180	0	11	80	0.1375000
NODE_97939_length_368_cov_11.988848	100	180	1	69	80	0.8625000
NODE_97945_length_368_cov_6.267658	133	213	0	80	80	1.0000000
NODE_97945_length_368_cov_6.267658	186	266	0	80	80	1.0000000
NODE_97997_length_368_cov_3.486989	127	207	0	80	80	1.0000000
NODE_98008_length_368_cov_3.282528	182	255	0	73	73	1.0000000
NODE_98058_length_368_cov_2.605948	192	246	0	54	54	1.0000000
NODE_98123_length_368_cov_2.182156	85	145	0	60	60	1.0000000
NODE_98129_length_368_cov_2.137546	66	107	0	41	41	1.0000000
NODE_98157_length_368_cov_1.944238	192	272	0	80	80	1.0000000
NODE_98723_length_367_cov_7.156716	174	254	0	26	80	0.3250000
NODE_98723_length_367_cov_7.156716	174	254	1	54	80	0.6750000
NODE_98723_length_367_cov_7.156716	227	307	1	80	80	1.0000000
NODE_98734_length_367_cov_5.313433	148	206	1	58	58	1.0000000
NODE_98737_length_367_cov_5.138060	58	138	1	4	80	0.0500000
NODE_98737_length_367_cov_5.138060	58	138	2	27	80	0.3375000
NODE_98737_length_367_cov_5.138060	58	138	3	5	80	0.0625000
NODE_98737_length_367_cov_5.138060	58	138	4	44	80	0.5500000
NODE_98737_length_367_cov_5.138060	111	191	3	40	80	0.5000000
NODE_98737_length_367_cov_5.138060	111	191	4	40	80	0.5000000
NODE_98796_length_367_cov_3.059701	110	154	0	44	44	1.0000000
NODE_98796_length_367_cov_3.059701	111	146	0	35	35	1.0000000
NODE_98843_length_367_cov_2.384328	246	326	2	80	80	1.0000000
NODE_98843_length_367_cov_2.384328	299	367	1	5	68	0.0735294
NODE_98843_length_367_cov_2.384328	299	367	2	63	68	0.9264706
NODE_98849_length_367_cov_2.332090	127	207	0	80	80	1.0000000
NODE_98909_length_367_cov_1.944030	91	156	0	65	65	1.0000000
NODE_98980_length_367_cov_1.679104	173	252	0	79	79	1.0000000
NODE_99005_length_367_cov_1.552239	148	200	2	52	52	1.0000000
NODE_99138_length_367_cov_1.201493	79	159	0	80	80	1.0000000
NODE_99138_length_367_cov_1.201493	136	179	0	43	43	1.0000000
NODE_99318_length_367_cov_0.761194	288	357	0	69	69	1.0000000
NODE_99451_length_366_cov_5.239700	193	253	5	52	60	0.8666667
NODE_99451_length_366_cov_5.239700	193	253	7	8	60	0.1333333
NODE_99472_length_366_cov_4.168539	302	355	0	53	53	1.0000000
NODE_99478_length_366_cov_3.913858	183	229	0	46	46	1.0000000
NODE_99478_length_366_cov_3.913858	203	282	0	79	79	1.0000000
NODE_99496_length_366_cov_3.168539	88	160	0	72	72	1.0000000
NODE_99496_length_366_cov_3.168539	133	193	0	60	60	1.0000000
NODE_100137_length_365_cov_140.101504	40	107	8	2	67	0.0298507
NODE_100137_length_365_cov_140.101504	40	107	11	11	67	0.1641791
NODE_100137_length_365_cov_140.101504	40	107	12	1	67	0.0149254
NODE_100137_length_365_cov_140.101504	40	107	13	5	67	0.0746269
NODE_100137_length_365_cov_140.101504	40	107	14	1	67	0.0149254
NODE_100137_length_365_cov_140.101504	40	107	17	2	67	0.0298507
NODE_100137_length_365_cov_140.101504	40	107	18	4	67	0.0597015
NODE_100137_length_365_cov_140.101504	40	107	19	23	67	0.3432836
NODE_100137_length_365_cov_140.101504	40	107	21	5	67	0.0746269
NODE_100137_length_365_cov_140.101504	40	107	22	1	67	0.0149254
NODE_100137_length_365_cov_140.101504	40	107	23	2	67	0.0298507
NODE_100137_length_365_cov_140.101504	40	107	24	4	67	0.0597015
NODE_100137_length_365_cov_140.101504	40	107	26	4	67	0.0597015
NODE_100137_length_365_cov_140.101504	40	107	27	2	67	0.0298507
NODE_100138_length_365_cov_45.815789	0	38	0	38	38	1.0000000
NODE_100138_length_365_cov_45.815789	11	91	0	80	80	1.0000000
NODE_100140_length_365_cov_8.169173	191	244	0	53	53	1.0000000
NODE_100140_length_365_cov_8.169173	217	297	0	80	80	1.0000000
NODE_100145_length_365_cov_5.954887	136	216	0	80	80	1.0000000
NODE_100145_length_365_cov_5.954887	189	269	0	80	80	1.0000000
NODE_100147_length_365_cov_5.721805	37	78	0	41	41	1.0000000
NODE_100168_length_365_cov_4.195489	269	329	0	60	60	1.0000000
NODE_100172_length_365_cov_4.071429	106	186	0	80	80	1.0000000
NODE_100172_length_365_cov_4.071429	159	239	0	80	80	1.0000000
NODE_100180_length_365_cov_3.879699	131	187	0	56	56	1.0000000
NODE_100206_length_365_cov_3.270677	211	280	1	26	69	0.3768116
NODE_100206_length_365_cov_3.270677	211	280	2	43	69	0.6231884
NODE_100253_length_365_cov_2.601504	189	265	0	76	76	1.0000000
NODE_100293_length_365_cov_2.289474	169	249	0	80	80	1.0000000
NODE_100407_length_365_cov_1.635338	156	235	4	3	79	0.0379747
NODE_100407_length_365_cov_1.635338	156	235	6	56	79	0.7088608
NODE_100407_length_365_cov_1.635338	156	235	7	20	79	0.2531646
NODE_100485_length_365_cov_1.421053	228	309	0	81	81	1.0000000
NODE_100570_length_365_cov_1.169173	57	137	0	80	80	1.0000000
NODE_100570_length_365_cov_1.169173	65	145	0	80	80	1.0000000
NODE_100570_length_365_cov_1.169173	194	274	0	80	80	1.0000000
NODE_100893_length_364_cov_24.600000	101	181	0	29	80	0.3625000
NODE_100893_length_364_cov_24.600000	101	181	1	14	80	0.1750000
NODE_100893_length_364_cov_24.600000	101	181	9	20	80	0.2500000
NODE_100893_length_364_cov_24.600000	101	181	10	17	80	0.2125000
NODE_100893_length_364_cov_24.600000	154	234	9	10	80	0.1250000
NODE_100893_length_364_cov_24.600000	154	234	10	70	80	0.8750000
NODE_100896_length_364_cov_7.377358	0	50	0	50	50	1.0000000
NODE_100933_length_364_cov_3.988679	122	168	0	46	46	1.0000000
NODE_100935_length_364_cov_3.913208	151	208	0	57	57	1.0000000
NODE_100959_length_364_cov_3.305660	296	358	0	62	62	1.0000000
NODE_100966_length_364_cov_3.181132	78	138	0	60	60	1.0000000
NODE_100975_length_364_cov_3.041509	264	321	0	57	57	1.0000000
NODE_100975_length_364_cov_3.041509	294	359	0	65	65	1.0000000
NODE_100978_length_364_cov_3.015094	238	274	0	36	36	1.0000000
NODE_101087_length_364_cov_1.977358	126	201	0	75	75	1.0000000
NODE_101141_length_364_cov_1.811321	209	256	0	47	47	1.0000000
NODE_101148_length_364_cov_1.781132	130	203	3	35	73	0.4794520
NODE_101148_length_364_cov_1.781132	130	203	4	38	73	0.5205479
NODE_101148_length_364_cov_1.781132	183	203	3	20	20	1.0000000
NODE_101720_length_363_cov_7.791667	121	200	0	79	79	1.0000000
NODE_101725_length_363_cov_6.484848	33	90	1	57	57	1.0000000
NODE_101725_length_363_cov_6.484848	93	146	1	53	53	1.0000000
NODE_101734_length_363_cov_4.825758	154	215	2	44	61	0.7213115
NODE_101734_length_363_cov_4.825758	154	215	4	17	61	0.2786885
NODE_101760_length_363_cov_3.950758	112	183	0	71	71	1.0000000
NODE_101760_length_363_cov_3.950758	156	236	0	80	80	1.0000000
NODE_101769_length_363_cov_3.617424	16	79	0	63	63	1.0000000
NODE_101774_length_363_cov_3.409091	241	267	0	26	26	1.0000000
NODE_101791_length_363_cov_3.087121	228	308	0	80	80	1.0000000
NODE_101809_length_363_cov_2.795455	240	320	1	28	80	0.3500000
NODE_101809_length_363_cov_2.795455	240	320	2	24	80	0.3000000
NODE_101809_length_363_cov_2.795455	240	320	3	25	80	0.3125000
NODE_101809_length_363_cov_2.795455	240	320	4	3	80	0.0375000
NODE_101822_length_363_cov_2.481061	86	166	0	80	80	1.0000000
NODE_101822_length_363_cov_2.481061	139	219	0	80	80	1.0000000
NODE_101879_length_363_cov_2.034091	46	126	0	80	80	1.0000000
NODE_101879_length_363_cov_2.034091	99	153	0	54	54	1.0000000
NODE_101992_length_363_cov_1.541667	235	315	0	80	80	1.0000000
NODE_102022_length_363_cov_1.477273	141	202	0	61	61	1.0000000
NODE_102022_length_363_cov_1.477273	153	210	0	57	57	1.0000000
NODE_102187_length_363_cov_1.113636	245	316	0	71	71	1.0000000
NODE_102464_length_362_cov_54.927757	52	116	0	64	64	1.0000000
NODE_102465_length_362_cov_29.273764	86	166	0	80	80	1.0000000
NODE_102465_length_362_cov_29.273764	139	219	0	80	80	1.0000000
NODE_102467_length_362_cov_14.847909	130	210	5	52	80	0.6500000
NODE_102467_length_362_cov_14.847909	130	210	6	28	80	0.3500000
NODE_102467_length_362_cov_14.847909	183	263	3	24	80	0.3000000
NODE_102467_length_362_cov_14.847909	183	263	4	1	80	0.0125000
NODE_102467_length_362_cov_14.847909	183	263	5	5	80	0.0625000
NODE_102467_length_362_cov_14.847909	183	263	6	50	80	0.6250000
NODE_102633_length_362_cov_2.159696	133	216	0	83	83	1.0000000
NODE_103259_length_361_cov_4.641221	249	312	0	63	63	1.0000000
NODE_103280_length_361_cov_3.717557	185	265	0	80	80	1.0000000
NODE_103280_length_361_cov_3.717557	238	265	0	27	27	1.0000000
NODE_103314_length_361_cov_2.988550	121	201	0	80	80	1.0000000
NODE_103314_length_361_cov_2.988550	174	216	0	42	42	1.0000000
NODE_103338_length_361_cov_2.641221	4	33	0	29	29	1.0000000
NODE_103338_length_361_cov_2.641221	101	182	0	81	81	1.0000000
NODE_103391_length_361_cov_2.137405	138	194	0	56	56	1.0000000
NODE_103396_length_361_cov_2.106870	192	256	0	64	64	1.0000000
NODE_103418_length_361_cov_1.969466	137	198	0	61	61	1.0000000
NODE_103632_length_361_cov_1.343511	171	250	0	79	79	1.0000000
NODE_103802_length_361_cov_1.000000	60	123	0	63	63	1.0000000
NODE_104057_length_360_cov_8.191571	171	242	1	1	71	0.0140845
NODE_104057_length_360_cov_8.191571	171	242	2	70	71	0.9859155
NODE_104057_length_360_cov_8.191571	176	242	2	66	66	1.0000000
NODE_104057_length_360_cov_8.191571	215	279	1	15	64	0.2343750
NODE_104057_length_360_cov_8.191571	215	279	2	49	64	0.7656250
NODE_104057_length_360_cov_8.191571	215	279	1	15	64	0.2343750
NODE_104057_length_360_cov_8.191571	215	279	2	49	64	0.7656250
NODE_104079_length_360_cov_5.003831	86	166	0	13	80	0.1625000
NODE_104079_length_360_cov_5.003831	86	166	3	67	80	0.8375000
NODE_104091_length_360_cov_4.111111	158	238	0	80	80	1.0000000
NODE_104102_length_360_cov_3.613027	123	203	0	80	80	1.0000000
NODE_104102_length_360_cov_3.613027	176	256	0	80	80	1.0000000
NODE_104129_length_360_cov_3.080460	48	70	0	22	22	1.0000000
NODE_104162_length_360_cov_2.689655	118	198	0	80	80	1.0000000
NODE_104261_length_360_cov_1.977011	235	286	0	51	51	1.0000000
NODE_104572_length_360_cov_1.149425	273	353	0	64	80	0.8000000
NODE_104572_length_360_cov_1.149425	273	353	1	16	80	0.2000000
NODE_104669_length_360_cov_0.965517	119	175	0	56	56	1.0000000
NODE_104671_length_360_cov_0.957854	140	186	0	46	46	1.0000000
NODE_104858_length_359_cov_45.519231	140	220	22	11	80	0.1375000
NODE_104858_length_359_cov_45.519231	140	220	23	23	80	0.2875000
NODE_104858_length_359_cov_45.519231	140	220	24	4	80	0.0500000
NODE_104858_length_359_cov_45.519231	140	220	25	1	80	0.0125000
NODE_104858_length_359_cov_45.519231	140	220	26	14	80	0.1750000
NODE_104858_length_359_cov_45.519231	140	220	27	27	80	0.3375000
NODE_104858_length_359_cov_45.519231	193	273	12	5	80	0.0625000
NODE_104858_length_359_cov_45.519231	193	273	13	15	80	0.1875000
NODE_104858_length_359_cov_45.519231	193	273	14	1	80	0.0125000
NODE_104858_length_359_cov_45.519231	193	273	15	11	80	0.1375000
NODE_104858_length_359_cov_45.519231	193	273	16	4	80	0.0500000
NODE_104858_length_359_cov_45.519231	193	273	17	6	80	0.0750000
NODE_104858_length_359_cov_45.519231	193	273	19	2	80	0.0250000
NODE_104858_length_359_cov_45.519231	193	273	21	3	80	0.0375000
NODE_104858_length_359_cov_45.519231	193	273	22	11	80	0.1375000
NODE_104858_length_359_cov_45.519231	193	273	23	5	80	0.0625000
NODE_104858_length_359_cov_45.519231	193	273	24	4	80	0.0500000
NODE_104858_length_359_cov_45.519231	193	273	27	13	80	0.1625000
NODE_104932_length_359_cov_3.296154	67	147	0	80	80	1.0000000
NODE_104932_length_359_cov_3.296154	120	177	0	57	57	1.0000000
NODE_104932_length_359_cov_3.296154	201	256	0	55	55	1.0000000
NODE_104936_length_359_cov_3.276923	5	95	0	90	90	1.0000000
NODE_104954_length_359_cov_3.007692	156	212	1	8	56	0.1428571
NODE_104954_length_359_cov_3.007692	156	212	2	48	56	0.8571429
NODE_104998_length_359_cov_2.523077	148	228	4	80	80	1.0000000
NODE_104998_length_359_cov_2.523077	201	278	2	27	77	0.3506494
NODE_104998_length_359_cov_2.523077	201	278	4	50	77	0.6493506
NODE_105002_length_359_cov_2.419231	106	186	0	80	80	1.0000000
NODE_105002_length_359_cov_2.419231	159	211	0	49	52	0.9423077
NODE_105002_length_359_cov_2.419231	159	211	1	1	52	0.0192308
NODE_105002_length_359_cov_2.419231	159	211	2	2	52	0.0384615
NODE_105006_length_359_cov_2.353846	172	243	0	71	71	1.0000000
NODE_105006_length_359_cov_2.353846	216	296	0	80	80	1.0000000
NODE_105026_length_359_cov_2.257692	211	270	0	59	59	1.0000000
NODE_105063_length_359_cov_2.003846	8	88	0	80	80	1.0000000
NODE_105063_length_359_cov_2.003846	61	139	0	78	78	1.0000000
NODE_105106_length_359_cov_1.815385	126	207	0	81	81	1.0000000
NODE_105106_length_359_cov_1.815385	180	227	0	47	47	1.0000000
NODE_105142_length_359_cov_1.692308	88	116	0	28	28	1.0000000
NODE_105373_length_359_cov_1.096154	64	89	0	25	25	1.0000000
NODE_105599_length_359_cov_0.711538	222	248	0	26	26	1.0000000
NODE_105600_length_359_cov_0.707692	10	90	0	80	80	1.0000000
NODE_105600_length_359_cov_0.707692	10	90	0	80	80	1.0000000
NODE_105600_length_359_cov_0.707692	63	143	0	80	80	1.0000000
NODE_105678_length_358_cov_19.760618	213	293	1	34	80	0.4250000
NODE_105678_length_358_cov_19.760618	213	293	3	46	80	0.5750000
NODE_105678_length_358_cov_19.760618	266	346	0	14	80	0.1750000
NODE_105678_length_358_cov_19.760618	266	346	1	66	80	0.8250000
NODE_105679_length_358_cov_18.455598	303	358	0	53	55	0.9636363
NODE_105679_length_358_cov_18.455598	303	358	1	2	55	0.0363636
NODE_105680_length_358_cov_17.023166	0	63	0	63	63	1.0000000
NODE_105680_length_358_cov_17.023166	0	63	0	63	63	1.0000000
NODE_105680_length_358_cov_17.023166	0	63	0	63	63	1.0000000
NODE_105680_length_358_cov_17.023166	36	116	0	80	80	1.0000000
NODE_105680_length_358_cov_17.023166	53	115	0	62	62	1.0000000
NODE_105686_length_358_cov_6.509653	109	155	0	46	46	1.0000000
NODE_105710_length_358_cov_4.239382	114	143	0	29	29	1.0000000
NODE_105710_length_358_cov_4.239382	180	245	0	65	65	1.0000000
NODE_105710_length_358_cov_4.239382	218	298	0	80	80	1.0000000
NODE_105846_length_358_cov_2.162162	229	305	0	76	76	1.0000000
NODE_105902_length_358_cov_1.926641	290	358	0	68	68	1.0000000
NODE_105910_length_358_cov_1.884170	250	317	0	67	67	1.0000000
NODE_105923_length_358_cov_1.841699	189	269	0	80	80	1.0000000
NODE_106096_length_358_cov_1.235521	99	179	2	27	80	0.3375000
NODE_106096_length_358_cov_1.235521	99	179	3	53	80	0.6625000
NODE_106096_length_358_cov_1.235521	152	222	1	28	70	0.4000000
NODE_106096_length_358_cov_1.235521	152	222	2	8	70	0.1142857
NODE_106096_length_358_cov_1.235521	152	222	3	34	70	0.4857143
NODE_106189_length_358_cov_1.096525	148	228	0	80	80	1.0000000
NODE_106233_length_358_cov_0.984556	193	265	0	72	72	1.0000000
NODE_106489_length_357_cov_381.833333	244	324	7	2	80	0.0250000
NODE_106489_length_357_cov_381.833333	244	324	8	2	80	0.0250000
NODE_106489_length_357_cov_381.833333	244	324	9	8	80	0.1000000
NODE_106489_length_357_cov_381.833333	244	324	12	7	80	0.0875000
NODE_106489_length_357_cov_381.833333	244	324	13	11	80	0.1375000
NODE_106489_length_357_cov_381.833333	244	324	14	31	80	0.3875000
NODE_106489_length_357_cov_381.833333	244	324	15	19	80	0.2375000
NODE_106493_length_357_cov_7.643411	45	125	3	34	80	0.4250000
NODE_106493_length_357_cov_7.643411	45	125	4	2	80	0.0250000
NODE_106493_length_357_cov_7.643411	45	125	5	21	80	0.2625000
NODE_106493_length_357_cov_7.643411	45	125	8	20	80	0.2500000
NODE_106493_length_357_cov_7.643411	45	125	9	3	80	0.0375000
NODE_106493_length_357_cov_7.643411	98	178	5	4	80	0.0500000
NODE_106493_length_357_cov_7.643411	98	178	8	20	80	0.2500000
NODE_106493_length_357_cov_7.643411	98	178	9	8	80	0.1000000
NODE_106493_length_357_cov_7.643411	98	178	11	13	80	0.1625000
NODE_106493_length_357_cov_7.643411	98	178	14	7	80	0.0875000
NODE_106493_length_357_cov_7.643411	98	178	15	8	80	0.1000000
NODE_106493_length_357_cov_7.643411	98	178	18	20	80	0.2500000
NODE_106495_length_357_cov_7.027132	157	237	0	80	80	1.0000000
NODE_106495_length_357_cov_7.027132	210	252	0	42	42	1.0000000
NODE_106496_length_357_cov_6.732558	183	263	6	44	80	0.5500000
NODE_106496_length_357_cov_6.732558	183	263	7	2	80	0.0250000
NODE_106496_length_357_cov_6.732558	183	263	9	34	80	0.4250000
NODE_106529_length_357_cov_4.081395	145	225	0	56	80	0.7000000
NODE_106529_length_357_cov_4.081395	145	225	1	24	80	0.3000000
NODE_106529_length_357_cov_4.081395	198	271	0	3	73	0.0410959
NODE_106529_length_357_cov_4.081395	198	271	1	70	73	0.9589041
NODE_106542_length_357_cov_3.724806	192	265	0	73	73	1.0000000
NODE_106558_length_357_cov_3.341085	205	285	2	80	80	1.0000000
NODE_106558_length_357_cov_3.341085	258	338	0	29	80	0.3625000
NODE_106558_length_357_cov_3.341085	258	338	2	51	80	0.6375000
NODE_106625_length_357_cov_2.414729	245	302	0	57	57	1.0000000
NODE_106625_length_357_cov_2.414729	275	355	0	80	80	1.0000000
NODE_106661_length_357_cov_2.174419	250	330	0	80	80	1.0000000
NODE_106666_length_357_cov_2.166667	103	133	1	4	30	0.1333333
NODE_106666_length_357_cov_2.166667	103	133	2	26	30	0.8666667
NODE_106666_length_357_cov_2.166667	112	133	1	4	21	0.1904762
NODE_106666_length_357_cov_2.166667	112	133	2	17	21	0.8095238
NODE_106702_length_357_cov_1.961240	150	169	0	19	19	1.0000000
NODE_106708_length_357_cov_1.918605	173	253	0	80	80	1.0000000
NODE_106737_length_357_cov_1.782946	73	142	0	69	69	1.0000000
NODE_106737_length_357_cov_1.782946	115	195	0	80	80	1.0000000
NODE_107002_length_357_cov_1.127907	98	129	0	31	31	1.0000000
NODE_107306_length_356_cov_5.299611	140	200	0	60	60	1.0000000
NODE_107347_length_356_cov_3.400778	255	317	0	62	62	1.0000000
NODE_107347_length_356_cov_3.400778	308	353	0	45	45	1.0000000
NODE_107402_length_356_cov_2.657588	256	298	0	42	42	1.0000000
NODE_107402_length_356_cov_2.657588	265	338	0	73	73	1.0000000
NODE_107402_length_356_cov_2.657588	299	351	0	52	52	1.0000000
NODE_107452_length_356_cov_2.237354	90	135	0	45	45	1.0000000
NODE_107475_length_356_cov_1.996109	127	194	0	67	67	1.0000000
NODE_107521_length_356_cov_1.813230	296	341	0	45	45	1.0000000
NODE_107606_length_356_cov_1.560311	192	272	0	80	80	1.0000000
NODE_107606_length_356_cov_1.560311	245	319	0	74	74	1.0000000
NODE_108122_length_355_cov_6.796875	127	173	0	46	46	1.0000000
NODE_108210_length_355_cov_2.734375	111	162	0	51	51	1.0000000
NODE_108210_length_355_cov_2.734375	142	222	0	80	80	1.0000000
NODE_108215_length_355_cov_2.707031	277	314	0	37	37	1.0000000
NODE_108215_length_355_cov_2.707031	287	353	0	66	66	1.0000000
NODE_108239_length_355_cov_2.500000	38	82	0	44	44	1.0000000
NODE_108278_length_355_cov_2.207031	258	308	0	50	50	1.0000000
NODE_108284_length_355_cov_2.179688	153	233	0	80	80	1.0000000
NODE_108284_length_355_cov_2.179688	206	286	0	80	80	1.0000000
NODE_108291_length_355_cov_2.132812	261	334	0	73	73	1.0000000
NODE_108291_length_355_cov_2.132812	301	342	0	41	41	1.0000000
NODE_108315_length_355_cov_2.007812	281	347	0	66	66	1.0000000
NODE_108395_length_355_cov_1.765625	186	247	0	61	61	1.0000000
NODE_108395_length_355_cov_1.765625	220	300	0	80	80	1.0000000
NODE_109015_length_354_cov_6.843137	53	132	0	79	79	1.0000000
NODE_109015_length_354_cov_6.843137	53	132	0	79	79	1.0000000
NODE_109015_length_354_cov_6.843137	105	185	0	80	80	1.0000000
NODE_109015_length_354_cov_6.843137	105	185	0	80	80	1.0000000
NODE_109033_length_354_cov_4.823529	208	255	0	47	47	1.0000000
NODE_109054_length_354_cov_3.956863	145	208	0	63	63	1.0000000
NODE_109054_length_354_cov_3.956863	181	261	0	80	80	1.0000000
NODE_109057_length_354_cov_3.878431	198	244	0	46	46	1.0000000
NODE_109089_length_354_cov_3.207843	130	199	0	69	69	1.0000000
NODE_109126_length_354_cov_2.725490	179	259	0	80	80	1.0000000
NODE_109126_length_354_cov_2.725490	235	312	0	77	77	1.0000000
NODE_109128_length_354_cov_2.713725	16	76	0	60	60	1.0000000
NODE_109128_length_354_cov_2.713725	90	149	0	59	59	1.0000000
NODE_109140_length_354_cov_2.580392	176	234	0	58	58	1.0000000
NODE_109140_length_354_cov_2.580392	207	251	0	44	44	1.0000000
NODE_109237_length_354_cov_1.996078	79	145	0	66	66	1.0000000
NODE_109237_length_354_cov_1.996078	118	200	0	82	82	1.0000000
NODE_109244_length_354_cov_1.988235	7	77	0	70	70	1.0000000
NODE_109244_length_354_cov_1.988235	64	130	0	31	66	0.4696970
NODE_109244_length_354_cov_1.988235	64	130	4	35	66	0.5303030
NODE_109321_length_354_cov_1.682353	99	171	0	72	72	1.0000000
NODE_109321_length_354_cov_1.682353	144	224	0	80	80	1.0000000
NODE_109852_length_353_cov_11.169291	14	90	0	76	76	1.0000000
NODE_109852_length_353_cov_11.169291	67	143	0	76	76	1.0000000
NODE_109911_length_353_cov_3.874016	220	256	0	36	36	1.0000000
NODE_109911_length_353_cov_3.874016	265	334	0	69	69	1.0000000
NODE_109928_length_353_cov_3.488189	200	282	0	69	82	0.8414634
NODE_109928_length_353_cov_3.488189	200	282	1	13	82	0.1585366
NODE_109976_length_353_cov_2.826772	8	88	0	80	80	1.0000000
NODE_109976_length_353_cov_2.826772	61	120	0	59	59	1.0000000
NODE_110022_length_353_cov_2.417323	260	336	0	76	76	1.0000000
NODE_110610_length_353_cov_0.744094	299	318	0	19	19	1.0000000
NODE_110708_length_352_cov_34.691700	110	203	0	20	93	0.2150538
NODE_110708_length_352_cov_34.691700	110	203	1	51	93	0.5483871
NODE_110708_length_352_cov_34.691700	110	203	2	22	93	0.2365591
NODE_110710_length_352_cov_17.944664	20	100	0	80	80	1.0000000
NODE_110710_length_352_cov_17.944664	73	153	0	80	80	1.0000000
NODE_110710_length_352_cov_17.944664	273	352	0	79	79	1.0000000
NODE_110735_length_352_cov_4.707510	157	237	0	80	80	1.0000000
NODE_110749_length_352_cov_4.221344	144	205	1	61	61	1.0000000
NODE_110749_length_352_cov_4.221344	178	259	0	46	81	0.5679013
NODE_110749_length_352_cov_4.221344	178	259	1	35	81	0.4320988
NODE_110754_length_352_cov_4.011858	98	143	0	45	45	1.0000000
NODE_110754_length_352_cov_4.011858	151	228	0	77	77	1.0000000
NODE_110798_length_352_cov_2.849802	74	154	0	80	80	1.0000000
NODE_110798_length_352_cov_2.849802	127	198	0	71	71	1.0000000
NODE_110820_length_352_cov_2.683794	0	77	0	77	77	1.0000000
NODE_110820_length_352_cov_2.683794	50	130	0	80	80	1.0000000
NODE_110832_length_352_cov_2.608696	90	136	0	46	46	1.0000000
NODE_110832_length_352_cov_2.608696	144	189	0	45	45	1.0000000
NODE_110838_length_352_cov_2.577075	111	191	0	80	80	1.0000000
NODE_110876_length_352_cov_2.264822	171	251	0	80	80	1.0000000
NODE_110938_length_352_cov_2.007905	277	326	0	49	49	1.0000000
NODE_111439_length_352_cov_0.806324	165	238	1	3	73	0.0410959
NODE_111439_length_352_cov_0.806324	165	238	2	17	73	0.2328767
NODE_111439_length_352_cov_0.806324	165	238	3	29	73	0.3972603
NODE_111439_length_352_cov_0.806324	165	238	4	24	73	0.3287671
NODE_111593_length_351_cov_5.003968	115	195	0	80	80	1.0000000
NODE_111662_length_351_cov_2.900794	289	320	2	31	31	1.0000000
NODE_111738_length_351_cov_2.376984	79	159	0	6	80	0.0750000
NODE_111738_length_351_cov_2.376984	79	159	1	40	80	0.5000000
NODE_111738_length_351_cov_2.376984	79	159	2	34	80	0.4250000
NODE_111759_length_351_cov_2.226190	116	170	3	45	54	0.8333333
NODE_111759_length_351_cov_2.226190	116	170	4	9	54	0.1666667
NODE_111769_length_351_cov_2.186508	198	277	0	79	79	1.0000000
NODE_111861_length_351_cov_1.809524	276	309	0	33	33	1.0000000
NODE_111969_length_351_cov_1.515873	228	299	0	71	71	1.0000000
NODE_112493_length_350_cov_232.529880	25	92	7	2	67	0.0298507
NODE_112493_length_350_cov_232.529880	25	92	8	3	67	0.0447761
NODE_112493_length_350_cov_232.529880	25	92	9	13	67	0.1940299
NODE_112493_length_350_cov_232.529880	25	92	13	2	67	0.0298507
NODE_112493_length_350_cov_232.529880	25	92	14	6	67	0.0895522
NODE_112493_length_350_cov_232.529880	25	92	15	4	67	0.0597015
NODE_112493_length_350_cov_232.529880	25	92	16	15	67	0.2238806
NODE_112493_length_350_cov_232.529880	25	92	17	22	67	0.3283582
NODE_112494_length_350_cov_40.677291	181	246	4	40	65	0.6153846
NODE_112494_length_350_cov_40.677291	181	246	5	1	65	0.0153846
NODE_112494_length_350_cov_40.677291	181	246	7	24	65	0.3692308
NODE_112535_length_350_cov_4.179283	114	194	0	80	80	1.0000000
NODE_112535_length_350_cov_4.179283	167	244	0	77	77	1.0000000
NODE_112554_length_350_cov_3.573705	128	202	0	33	74	0.4459459
NODE_112554_length_350_cov_3.573705	128	202	2	41	74	0.5540541
NODE_112554_length_350_cov_3.573705	178	241	0	63	63	1.0000000
NODE_112627_length_350_cov_2.478088	266	297	0	31	31	1.0000000
NODE_112647_length_350_cov_2.346614	97	148	9	22	51	0.4313726
NODE_112647_length_350_cov_2.346614	97	148	10	3	51	0.0588235
NODE_112647_length_350_cov_2.346614	97	148	12	17	51	0.3333333
NODE_112647_length_350_cov_2.346614	97	148	14	5	51	0.0980392
NODE_112647_length_350_cov_2.346614	97	148	16	4	51	0.0784314
NODE_112714_length_350_cov_2.031873	181	238	6	57	57	1.0000000
NODE_112997_length_350_cov_1.223108	202	275	0	73	73	1.0000000
NODE_113450_length_349_cov_4.268000	83	163	0	80	80	1.0000000
NODE_113450_length_349_cov_4.268000	83	163	0	80	80	1.0000000
NODE_113450_length_349_cov_4.268000	136	216	0	80	80	1.0000000
NODE_113450_length_349_cov_4.268000	145	180	0	35	35	1.0000000
NODE_113473_length_349_cov_3.648000	219	300	0	81	81	1.0000000
NODE_113480_length_349_cov_3.484000	196	276	0	80	80	1.0000000
NODE_113486_length_349_cov_3.364000	219	284	0	65	65	1.0000000
NODE_113511_length_349_cov_2.916000	94	189	0	95	95	1.0000000
NODE_113571_length_349_cov_2.420000	35	54	0	19	19	1.0000000
NODE_113647_length_349_cov_1.964000	32	63	0	31	31	1.0000000
NODE_113654_length_349_cov_1.928000	9	77	0	68	68	1.0000000
NODE_113654_length_349_cov_1.928000	62	115	0	53	53	1.0000000
NODE_113710_length_349_cov_1.684000	225	265	0	40	40	1.0000000
NODE_113825_length_349_cov_1.392000	32	95	0	63	63	1.0000000
NODE_113961_length_349_cov_1.056000	316	339	0	23	23	1.0000000
NODE_114002_length_349_cov_1.020000	177	257	0	80	80	1.0000000
NODE_114263_length_348_cov_34.867470	156	236	0	61	80	0.7625000
NODE_114263_length_348_cov_34.867470	156	236	2	19	80	0.2375000
NODE_114263_length_348_cov_34.867470	209	289	0	8	80	0.1000000
NODE_114263_length_348_cov_34.867470	209	289	2	72	80	0.9000000
NODE_114296_length_348_cov_4.180723	106	186	2	53	80	0.6625000
NODE_114296_length_348_cov_4.180723	106	186	3	1	80	0.0125000
NODE_114296_length_348_cov_4.180723	106	186	4	26	80	0.3250000
NODE_114296_length_348_cov_4.180723	159	239	0	27	80	0.3375000
NODE_114296_length_348_cov_4.180723	159	239	2	53	80	0.6625000
NODE_114330_length_348_cov_3.277108	83	137	0	54	54	1.0000000
NODE_114330_length_348_cov_3.277108	145	197	0	52	52	1.0000000
NODE_114424_length_348_cov_2.305221	204	273	0	69	69	1.0000000
NODE_114448_length_348_cov_2.216867	103	152	0	49	49	1.0000000
NODE_114505_length_348_cov_1.995984	170	239	0	69	69	1.0000000
NODE_114591_length_348_cov_1.638554	309	346	0	37	37	1.0000000
NODE_114643_length_348_cov_1.485944	9	60	0	51	51	1.0000000
NODE_115147_length_347_cov_15.100806	57	137	9	37	80	0.4625000
NODE_115147_length_347_cov_15.100806	57	137	15	12	80	0.1500000
NODE_115147_length_347_cov_15.100806	57	137	24	8	80	0.1000000
NODE_115147_length_347_cov_15.100806	57	137	25	23	80	0.2875000
NODE_115147_length_347_cov_15.100806	110	152	24	4	42	0.0952381
NODE_115147_length_347_cov_15.100806	110	152	25	38	42	0.9047619
NODE_115147_length_347_cov_15.100806	182	209	11	12	27	0.4444444
NODE_115147_length_347_cov_15.100806	182	209	12	14	27	0.5185185
NODE_115147_length_347_cov_15.100806	182	209	13	1	27	0.0370370
NODE_115147_length_347_cov_15.100806	290	317	1	27	27	1.0000000
NODE_115161_length_347_cov_5.967742	110	173	4	17	63	0.2698413
NODE_115161_length_347_cov_5.967742	110	173	6	46	63	0.7301587
NODE_115195_length_347_cov_4.028226	260	329	0	69	69	1.0000000
NODE_115321_length_347_cov_2.463710	99	141	0	42	42	1.0000000
NODE_115321_length_347_cov_2.463710	108	143	0	35	35	1.0000000
NODE_115331_length_347_cov_2.391129	35	70	0	35	35	1.0000000
NODE_115331_length_347_cov_2.391129	37	79	0	42	42	1.0000000
NODE_115331_length_347_cov_2.391129	77	105	0	28	28	1.0000000
NODE_115397_length_347_cov_2.048387	15	34	0	19	19	1.0000000
NODE_115417_length_347_cov_1.967742	205	268	0	63	63	1.0000000
NODE_115450_length_347_cov_1.818548	109	156	0	47	47	1.0000000
NODE_115771_length_347_cov_1.028226	230	255	0	25	25	1.0000000
NODE_116114_length_346_cov_74.433198	10	90	0	80	80	1.0000000
NODE_116114_length_346_cov_74.433198	19	90	0	71	71	1.0000000
NODE_116114_length_346_cov_74.433198	192	272	0	80	80	1.0000000
NODE_116115_length_346_cov_67.834008	133	213	7	6	80	0.0750000
NODE_116115_length_346_cov_67.834008	133	213	10	2	80	0.0250000
NODE_116115_length_346_cov_67.834008	133	213	11	49	80	0.6125000
NODE_116115_length_346_cov_67.834008	133	213	12	23	80	0.2875000
NODE_116115_length_346_cov_67.834008	186	266	9	22	80	0.2750000
NODE_116115_length_346_cov_67.834008	186	266	10	2	80	0.0250000
NODE_116115_length_346_cov_67.834008	186	266	11	25	80	0.3125000
NODE_116115_length_346_cov_67.834008	186	266	12	1	80	0.0125000
NODE_116115_length_346_cov_67.834008	186	266	13	28	80	0.3500000
NODE_116115_length_346_cov_67.834008	186	266	14	2	80	0.0250000
NODE_116117_length_346_cov_10.299595	190	270	0	80	80	1.0000000
NODE_116117_length_346_cov_10.299595	243	323	0	80	80	1.0000000
NODE_116119_length_346_cov_9.566802	159	239	0	80	80	1.0000000
NODE_116119_length_346_cov_9.566802	212	292	0	80	80	1.0000000
NODE_116134_length_346_cov_5.506073	157	238	0	81	81	1.0000000
NODE_116155_length_346_cov_4.368421	205	264	0	59	59	1.0000000
NODE_116159_length_346_cov_4.032389	121	141	0	20	20	1.0000000
NODE_116184_length_346_cov_3.400810	194	253	2	23	59	0.3898305
NODE_116184_length_346_cov_3.400810	194	253	4	36	59	0.6101695
NODE_116212_length_346_cov_3.008097	183	263	0	80	80	1.0000000
NODE_116257_length_346_cov_2.538462	47	102	0	55	55	1.0000000
NODE_116257_length_346_cov_2.538462	118	173	0	55	55	1.0000000
NODE_116439_length_346_cov_1.700405	71	107	0	36	36	1.0000000
NODE_117035_length_345_cov_47.699187	0	66	0	66	66	1.0000000
NODE_117035_length_345_cov_47.699187	39	119	0	64	80	0.8000000
NODE_117035_length_345_cov_47.699187	39	119	1	16	80	0.2000000
NODE_117035_length_345_cov_47.699187	115	182	1	30	67	0.4477612
NODE_117035_length_345_cov_47.699187	115	182	2	37	67	0.5522388
NODE_117035_length_345_cov_47.699187	246	311	0	16	65	0.2461538
NODE_117035_length_345_cov_47.699187	246	311	1	10	65	0.1538462
NODE_117035_length_345_cov_47.699187	246	311	3	32	65	0.4923077
NODE_117035_length_345_cov_47.699187	246	311	4	7	65	0.1076923
NODE_117036_length_345_cov_13.439024	28	108	0	80	80	1.0000000
NODE_117036_length_345_cov_13.439024	81	161	0	80	80	1.0000000
NODE_117037_length_345_cov_9.906504	224	283	0	14	59	0.2372881
NODE_117037_length_345_cov_9.906504	224	283	1	45	59	0.7627119
NODE_117051_length_345_cov_5.475610	52	132	0	80	80	1.0000000
NODE_117051_length_345_cov_5.475610	105	185	0	80	80	1.0000000
NODE_117055_length_345_cov_5.321138	104	152	0	48	48	1.0000000
NODE_117065_length_345_cov_4.524390	205	269	2	64	64	1.0000000
NODE_117075_length_345_cov_4.109756	95	157	0	62	62	1.0000000
NODE_117075_length_345_cov_4.109756	162	204	0	42	42	1.0000000
NODE_117076_length_345_cov_4.073171	251	326	0	75	75	1.0000000
NODE_117084_length_345_cov_3.776423	199	273	0	74	74	1.0000000
NODE_117084_length_345_cov_3.776423	246	326	0	80	80	1.0000000
NODE_117148_length_345_cov_2.821138	61	141	0	80	80	1.0000000
NODE_117205_length_345_cov_2.333333	47	90	0	12	43	0.2790698
NODE_117205_length_345_cov_2.333333	47	90	2	31	43	0.7209302
NODE_117205_length_345_cov_2.333333	63	147	2	84	84	1.0000000
NODE_117219_length_345_cov_2.239837	0	81	1	43	81	0.5308642
NODE_117219_length_345_cov_2.239837	0	81	2	38	81	0.4691358
NODE_117669_length_345_cov_1.040650	6	73	0	67	67	1.0000000
NODE_117989_length_344_cov_54.020408	6	55	4	10	49	0.2040816
NODE_117989_length_344_cov_54.020408	6	55	5	39	49	0.7959183
NODE_117989_length_344_cov_54.020408	28	105	5	47	77	0.6103896
NODE_117989_length_344_cov_54.020408	28	105	6	30	77	0.3896104
NODE_117989_length_344_cov_54.020408	28	105	5	47	77	0.6103896
NODE_117989_length_344_cov_54.020408	28	105	6	30	77	0.3896104
NODE_117989_length_344_cov_54.020408	112	178	1	12	66	0.1818182
NODE_117989_length_344_cov_54.020408	112	178	2	12	66	0.1818182
NODE_117989_length_344_cov_54.020408	112	178	4	23	66	0.3484848
NODE_117989_length_344_cov_54.020408	112	178	5	19	66	0.2878788
NODE_118009_length_344_cov_5.016327	72	125	0	46	53	0.8679245
NODE_118009_length_344_cov_5.016327	72	125	1	7	53	0.1320755
NODE_118009_length_344_cov_5.016327	136	203	1	67	67	1.0000000
NODE_118017_length_344_cov_4.579592	172	254	0	82	82	1.0000000
NODE_118045_length_344_cov_3.840816	197	240	0	43	43	1.0000000
NODE_118074_length_344_cov_3.293878	149	189	2	40	40	1.0000000
NODE_118074_length_344_cov_3.293878	162	229	2	67	67	1.0000000
NODE_118111_length_344_cov_2.751020	24	87	0	63	63	1.0000000
NODE_118179_length_344_cov_2.126531	274	305	0	31	31	1.0000000
NODE_118243_length_344_cov_1.914286	114	194	0	80	80	1.0000000
NODE_118243_length_344_cov_1.914286	167	247	0	80	80	1.0000000
NODE_118297_length_344_cov_1.685714	180	220	0	40	40	1.0000000
NODE_118393_length_344_cov_1.457143	160	240	0	80	80	1.0000000
NODE_118393_length_344_cov_1.457143	213	273	0	60	60	1.0000000
NODE_118743_length_344_cov_0.800000	123	163	0	40	40	1.0000000
NODE_118899_length_343_cov_3.770492	2	60	0	58	58	1.0000000
NODE_118905_length_343_cov_3.598361	97	170	0	73	73	1.0000000
NODE_118905_length_343_cov_3.598361	150	223	0	73	73	1.0000000
NODE_118911_length_343_cov_3.401639	48	128	1	13	80	0.1625000
NODE_118911_length_343_cov_3.401639	48	128	2	19	80	0.2375000
NODE_118911_length_343_cov_3.401639	48	128	3	48	80	0.6000000
NODE_118941_length_343_cov_3.049180	12	62	0	50	50	1.0000000
NODE_118941_length_343_cov_3.049180	82	111	0	29	29	1.0000000
NODE_118941_length_343_cov_3.049180	133	205	0	72	72	1.0000000
NODE_118957_length_343_cov_2.770492	236	316	2	42	80	0.5250000
NODE_118957_length_343_cov_2.770492	236	316	3	38	80	0.4750000
NODE_118978_length_343_cov_2.590164	167	225	0	58	58	1.0000000
NODE_118998_length_343_cov_2.430328	208	274	0	66	66	1.0000000
NODE_119040_length_343_cov_2.209016	32	111	0	79	79	1.0000000
NODE_119067_length_343_cov_2.081967	95	177	0	82	82	1.0000000
NODE_119067_length_343_cov_2.081967	150	199	0	49	49	1.0000000
NODE_119202_length_343_cov_1.635246	0	52	0	52	52	1.0000000
NODE_119439_length_343_cov_1.143443	60	120	0	60	60	1.0000000
NODE_119834_length_342_cov_3.872428	136	216	0	80	80	1.0000000
NODE_119834_length_342_cov_3.872428	189	259	0	70	70	1.0000000
NODE_119840_length_342_cov_3.769547	146	212	0	66	66	1.0000000
NODE_119841_length_342_cov_3.740741	113	146	6	29	33	0.8787879
NODE_119841_length_342_cov_3.740741	113	146	12	4	33	0.1212121
NODE_119846_length_342_cov_3.674897	20	100	0	36	80	0.4500000
NODE_119846_length_342_cov_3.674897	20	100	1	36	80	0.4500000
NODE_119846_length_342_cov_3.674897	20	100	2	8	80	0.1000000
NODE_119846_length_342_cov_3.674897	73	153	1	19	80	0.2375000
NODE_119846_length_342_cov_3.674897	73	153	2	61	80	0.7625000
NODE_119847_length_342_cov_3.588477	117	197	2	80	80	1.0000000
NODE_119849_length_342_cov_3.530864	72	151	0	79	79	1.0000000
NODE_119852_length_342_cov_3.423868	172	252	2	80	80	1.0000000
NODE_119852_length_342_cov_3.423868	225	283	0	3	58	0.0517241
NODE_119852_length_342_cov_3.423868	225	283	1	8	58	0.1379310
NODE_119852_length_342_cov_3.423868	225	283	2	47	58	0.8103448
NODE_119922_length_342_cov_2.432099	16	81	0	65	65	1.0000000
NODE_119993_length_342_cov_2.049383	249	317	0	68	68	1.0000000
NODE_120047_length_342_cov_1.864198	138	190	1	46	52	0.8846154
NODE_120047_length_342_cov_1.864198	138	190	2	6	52	0.1153846
NODE_120047_length_342_cov_1.864198	183	243	0	20	60	0.3333333
NODE_120047_length_342_cov_1.864198	183	243	1	40	60	0.6666667
NODE_120073_length_342_cov_1.720165	91	147	0	56	56	1.0000000
NODE_120284_length_342_cov_1.271605	201	240	0	39	39	1.0000000
NODE_120755_length_341_cov_15.896694	50	130	0	80	80	1.0000000
NODE_120755_length_341_cov_15.896694	103	183	0	80	80	1.0000000
NODE_120757_length_341_cov_9.756198	117	196	0	79	79	1.0000000
NODE_120770_length_341_cov_5.404959	141	220	0	79	79	1.0000000
NODE_120780_length_341_cov_4.669421	301	320	0	19	19	1.0000000
NODE_120783_length_341_cov_4.438017	57	132	0	75	75	1.0000000
NODE_120783_length_341_cov_4.438017	110	185	0	75	75	1.0000000
NODE_120785_length_341_cov_4.400826	164	244	0	80	80	1.0000000
NODE_120785_length_341_cov_4.400826	224	297	0	73	73	1.0000000
NODE_120797_length_341_cov_3.896694	58	122	1	4	64	0.0625000
NODE_120797_length_341_cov_3.896694	58	122	2	20	64	0.3125000
NODE_120797_length_341_cov_3.896694	58	122	4	22	64	0.3437500
NODE_120797_length_341_cov_3.896694	58	122	5	6	64	0.0937500
NODE_120797_length_341_cov_3.896694	58	122	6	8	64	0.1250000
NODE_120797_length_341_cov_3.896694	58	122	7	4	64	0.0625000
NODE_120805_length_341_cov_3.727273	191	273	2	82	82	1.0000000
NODE_120805_length_341_cov_3.727273	253	326	1	35	73	0.4794520
NODE_120805_length_341_cov_3.727273	253	326	2	38	73	0.5205479
NODE_120839_length_341_cov_3.000000	91	161	0	70	70	1.0000000
NODE_120839_length_341_cov_3.000000	146	215	0	69	69	1.0000000
NODE_120840_length_341_cov_3.000000	127	207	0	80	80	1.0000000
NODE_120892_length_341_cov_2.533058	92	172	1	7	80	0.0875000
NODE_120892_length_341_cov_2.533058	92	172	2	73	80	0.9125000
NODE_120901_length_341_cov_2.495868	8	89	0	81	81	1.0000000
NODE_120946_length_341_cov_2.235537	10	90	0	80	80	1.0000000
NODE_120972_length_341_cov_2.103306	46	125	1	61	79	0.7721519
NODE_120972_length_341_cov_2.103306	46	125	2	18	79	0.2278481
NODE_120994_length_341_cov_2.066116	147	184	0	37	37	1.0000000
NODE_121052_length_341_cov_1.772727	179	250	2	71	71	1.0000000
NODE_121064_length_341_cov_1.727273	105	185	0	75	80	0.9375000
NODE_121064_length_341_cov_1.727273	105	185	1	1	80	0.0125000
NODE_121064_length_341_cov_1.727273	105	185	2	4	80	0.0500000
NODE_121160_length_341_cov_1.475207	120	185	0	65	65	1.0000000
NODE_121160_length_341_cov_1.475207	158	238	0	80	80	1.0000000
NODE_121173_length_341_cov_1.471074	186	266	0	80	80	1.0000000
NODE_121173_length_341_cov_1.471074	239	319	0	80	80	1.0000000
NODE_121211_length_341_cov_1.342975	284	322	0	38	38	1.0000000
NODE_121431_length_341_cov_0.991736	36	89	0	53	53	1.0000000
NODE_121693_length_340_cov_541.348548	86	144	67	4	58	0.0689655
NODE_121693_length_340_cov_541.348548	86	144	70	2	58	0.0344828
NODE_121693_length_340_cov_541.348548	86	144	72	1	58	0.0172414
NODE_121693_length_340_cov_541.348548	86	144	76	2	58	0.0344828
NODE_121693_length_340_cov_541.348548	86	144	77	8	58	0.1379310
NODE_121693_length_340_cov_541.348548	86	144	78	2	58	0.0344828
NODE_121693_length_340_cov_541.348548	86	144	80	5	58	0.0862069
NODE_121693_length_340_cov_541.348548	86	144	82	4	58	0.0689655
NODE_121693_length_340_cov_541.348548	86	144	83	2	58	0.0344828
NODE_121693_length_340_cov_541.348548	86	144	84	1	58	0.0172414
NODE_121693_length_340_cov_541.348548	86	144	87	1	58	0.0172414
NODE_121693_length_340_cov_541.348548	86	144	88	1	58	0.0172414
NODE_121693_length_340_cov_541.348548	86	144	89	5	58	0.0862069
NODE_121693_length_340_cov_541.348548	86	144	90	13	58	0.2241379
NODE_121693_length_340_cov_541.348548	86	144	91	1	58	0.0172414
NODE_121693_length_340_cov_541.348548	86	144	92	2	58	0.0344828
NODE_121693_length_340_cov_541.348548	86	144	94	1	58	0.0172414
NODE_121693_length_340_cov_541.348548	86	144	95	3	58	0.0517241
NODE_121693_length_340_cov_541.348548	86	154	67	4	68	0.0588235
NODE_121693_length_340_cov_541.348548	86	154	70	2	68	0.0294118
NODE_121693_length_340_cov_541.348548	86	154	72	1	68	0.0147059
NODE_121693_length_340_cov_541.348548	86	154	76	2	68	0.0294118
NODE_121693_length_340_cov_541.348548	86	154	77	8	68	0.1176471
NODE_121693_length_340_cov_541.348548	86	154	78	2	68	0.0294118
NODE_121693_length_340_cov_541.348548	86	154	80	5	68	0.0735294
NODE_121693_length_340_cov_541.348548	86	154	82	4	68	0.0588235
NODE_121693_length_340_cov_541.348548	86	154	83	2	68	0.0294118
NODE_121693_length_340_cov_541.348548	86	154	84	1	68	0.0147059
NODE_121693_length_340_cov_541.348548	86	154	87	1	68	0.0147059
NODE_121693_length_340_cov_541.348548	86	154	88	2	68	0.0294118
NODE_121693_length_340_cov_541.348548	86	154	89	8	68	0.1176471
NODE_121693_length_340_cov_541.348548	86	154	90	18	68	0.2647059
NODE_121693_length_340_cov_541.348548	86	154	91	1	68	0.0147059
NODE_121693_length_340_cov_541.348548	86	154	92	2	68	0.0294118
NODE_121693_length_340_cov_541.348548	86	154	94	2	68	0.0294118
NODE_121693_length_340_cov_541.348548	86	154	95	3	68	0.0441176
NODE_121693_length_340_cov_541.348548	86	107	67	4	21	0.1904762
NODE_121693_length_340_cov_541.348548	86	107	70	2	21	0.0952381
NODE_121693_length_340_cov_541.348548	86	107	72	1	21	0.0476190
NODE_121693_length_340_cov_541.348548	86	107	76	2	21	0.0952381
NODE_121693_length_340_cov_541.348548	86	107	77	8	21	0.3809524
NODE_121693_length_340_cov_541.348548	86	107	78	2	21	0.0952381
NODE_121693_length_340_cov_541.348548	86	107	80	2	21	0.0952381
NODE_121694_length_340_cov_50.755187	196	266	2	16	70	0.2285714
NODE_121694_length_340_cov_50.755187	196	266	3	5	70	0.0714286
NODE_121694_length_340_cov_50.755187	196	266	7	23	70	0.3285714
NODE_121694_length_340_cov_50.755187	196	266	9	26	70	0.3714286
NODE_121696_length_340_cov_8.917012	240	270	1	30	30	1.0000000
NODE_121696_length_340_cov_8.917012	243	315	1	72	72	1.0000000
NODE_121702_length_340_cov_6.439834	175	255	0	80	80	1.0000000
NODE_121702_length_340_cov_6.439834	228	310	0	82	82	1.0000000
NODE_121708_length_340_cov_5.883817	72	121	0	49	49	1.0000000
NODE_121708_length_340_cov_5.883817	82	113	0	31	31	1.0000000
NODE_121714_length_340_cov_5.228216	116	186	0	70	70	1.0000000
NODE_121714_length_340_cov_5.228216	159	201	0	42	42	1.0000000
NODE_121730_length_340_cov_4.497925	136	184	0	48	48	1.0000000
NODE_121752_length_340_cov_3.759336	88	169	0	14	81	0.1728395
NODE_121752_length_340_cov_3.759336	88	169	2	67	81	0.8271605
NODE_121849_length_340_cov_2.506224	68	114	0	46	46	1.0000000
NODE_121951_length_340_cov_1.995851	29	101	0	72	72	1.0000000
NODE_121951_length_340_cov_1.995851	96	143	0	47	47	1.0000000
NODE_122154_length_340_cov_1.427386	244	274	0	30	30	1.0000000
NODE_122218_length_340_cov_1.282158	71	135	0	64	64	1.0000000
NODE_122218_length_340_cov_1.282158	128	188	0	60	60	1.0000000
NODE_122218_length_340_cov_1.282158	142	189	0	47	47	1.0000000
NODE_122220_length_340_cov_1.278008	51	102	0	51	51	1.0000000
NODE_122321_length_340_cov_1.199170	98	160	0	62	62	1.0000000
NODE_122381_length_340_cov_1.070539	32	65	0	33	33	1.0000000
NODE_122429_length_340_cov_1.020747	209	228	0	19	19	1.0000000
NODE_122686_length_339_cov_87.841667	149	227	6	9	78	0.1153846
NODE_122686_length_339_cov_87.841667	149	227	7	27	78	0.3461539
NODE_122686_length_339_cov_87.841667	149	227	8	41	78	0.5256410
NODE_122686_length_339_cov_87.841667	149	227	9	1	78	0.0128205
NODE_122687_length_339_cov_14.304167	69	138	0	69	69	1.0000000
NODE_122687_length_339_cov_14.304167	69	138	0	69	69	1.0000000
NODE_122687_length_339_cov_14.304167	69	138	0	69	69	1.0000000
NODE_122687_length_339_cov_14.304167	88	138	0	50	50	1.0000000
NODE_122687_length_339_cov_14.304167	111	160	0	49	49	1.0000000
NODE_122727_length_339_cov_4.320833	187	267	0	80	80	1.0000000
NODE_122804_length_339_cov_2.754167	45	125	0	80	80	1.0000000
NODE_122971_length_339_cov_1.841667	265	312	0	47	47	1.0000000
NODE_123041_length_339_cov_1.662500	10	57	0	47	47	1.0000000
NODE_123182_length_339_cov_1.275000	247	312	0	65	65	1.0000000
NODE_123285_length_339_cov_1.070833	147	169	0	22	22	1.0000000
NODE_123633_length_338_cov_57.163180	59	120	0	61	61	1.0000000
NODE_123633_length_338_cov_57.163180	102	176	0	74	74	1.0000000
NODE_123674_length_338_cov_4.263598	113	165	0	52	52	1.0000000
NODE_123679_length_338_cov_4.079498	96	151	0	55	55	1.0000000
NODE_123689_length_338_cov_3.841004	122	149	1	27	27	1.0000000
NODE_123793_length_338_cov_2.393305	216	288	2	20	72	0.2777778
NODE_123793_length_338_cov_2.393305	216	288	3	52	72	0.7222222
NODE_123795_length_338_cov_2.380753	29	93	1	64	64	1.0000000
NODE_123919_length_338_cov_1.878661	146	232	0	86	86	1.0000000
NODE_123944_length_338_cov_1.740586	79	159	0	80	80	1.0000000
NODE_123946_length_338_cov_1.732218	216	257	0	41	41	1.0000000
NODE_124046_length_338_cov_1.493724	14	90	0	76	76	1.0000000
NODE_124247_length_338_cov_1.100418	265	333	0	68	68	1.0000000
NODE_124456_length_338_cov_0.849372	281	338	0	57	57	1.0000000
NODE_124533_length_338_cov_0.711297	188	263	0	75	75	1.0000000
NODE_124625_length_337_cov_468.180672	107	187	47	4	80	0.0500000
NODE_124625_length_337_cov_468.180672	107	187	48	6	80	0.0750000
NODE_124625_length_337_cov_468.180672	107	187	49	4	80	0.0500000
NODE_124625_length_337_cov_468.180672	107	187	50	3	80	0.0375000
NODE_124625_length_337_cov_468.180672	107	187	51	11	80	0.1375000
NODE_124625_length_337_cov_468.180672	107	187	52	6	80	0.0750000
NODE_124625_length_337_cov_468.180672	107	187	53	14	80	0.1750000
NODE_124625_length_337_cov_468.180672	107	187	54	10	80	0.1250000
NODE_124625_length_337_cov_468.180672	107	187	55	9	80	0.1125000
NODE_124625_length_337_cov_468.180672	107	187	56	8	80	0.1000000
NODE_124625_length_337_cov_468.180672	107	187	57	5	80	0.0625000
NODE_124625_length_337_cov_468.180672	160	230	51	9	70	0.1285714
NODE_124625_length_337_cov_468.180672	160	230	52	6	70	0.0857143
NODE_124625_length_337_cov_468.180672	160	230	53	15	70	0.2142857
NODE_124625_length_337_cov_468.180672	160	230	55	9	70	0.1285714
NODE_124625_length_337_cov_468.180672	160	230	56	12	70	0.1714286
NODE_124625_length_337_cov_468.180672	160	230	58	4	70	0.0571429
NODE_124625_length_337_cov_468.180672	160	230	60	3	70	0.0428571
NODE_124625_length_337_cov_468.180672	160	230	62	2	70	0.0285714
NODE_124625_length_337_cov_468.180672	160	230	63	10	70	0.1428571
NODE_124625_length_337_cov_468.180672	226	306	23	5	80	0.0625000
NODE_124625_length_337_cov_468.180672	226	306	25	1	80	0.0125000
NODE_124625_length_337_cov_468.180672	226	306	27	8	80	0.1000000
NODE_124625_length_337_cov_468.180672	226	306	28	3	80	0.0375000
NODE_124625_length_337_cov_468.180672	226	306	29	1	80	0.0125000
NODE_124625_length_337_cov_468.180672	226	306	30	1	80	0.0125000
NODE_124625_length_337_cov_468.180672	226	306	33	4	80	0.0500000
NODE_124625_length_337_cov_468.180672	226	306	34	3	80	0.0375000
NODE_124625_length_337_cov_468.180672	226	306	35	2	80	0.0250000
NODE_124625_length_337_cov_468.180672	226	306	36	3	80	0.0375000
NODE_124625_length_337_cov_468.180672	226	306	37	2	80	0.0250000
NODE_124625_length_337_cov_468.180672	226	306	38	3	80	0.0375000
NODE_124625_length_337_cov_468.180672	226	306	39	3	80	0.0375000
NODE_124625_length_337_cov_468.180672	226	306	40	6	80	0.0750000
NODE_124625_length_337_cov_468.180672	226	306	41	4	80	0.0500000
NODE_124625_length_337_cov_468.180672	226	306	42	1	80	0.0125000
NODE_124625_length_337_cov_468.180672	226	306	46	6	80	0.0750000
NODE_124625_length_337_cov_468.180672	226	306	47	1	80	0.0125000
NODE_124625_length_337_cov_468.180672	226	306	50	1	80	0.0125000
NODE_124625_length_337_cov_468.180672	226	306	51	5	80	0.0625000
NODE_124625_length_337_cov_468.180672	226	306	53	3	80	0.0375000
NODE_124625_length_337_cov_468.180672	226	306	57	6	80	0.0750000
NODE_124625_length_337_cov_468.180672	226	306	58	1	80	0.0125000
NODE_124625_length_337_cov_468.180672	226	306	62	5	80	0.0625000
NODE_124625_length_337_cov_468.180672	226	306	63	2	80	0.0250000
NODE_124625_length_337_cov_468.180672	279	337	11	5	58	0.0862069
NODE_124625_length_337_cov_468.180672	279	337	12	1	58	0.0172414
NODE_124625_length_337_cov_468.180672	279	337	14	1	58	0.0172414
NODE_124625_length_337_cov_468.180672	279	337	16	1	58	0.0172414
NODE_124625_length_337_cov_468.180672	279	337	18	3	58	0.0517241
NODE_124625_length_337_cov_468.180672	279	337	20	1	58	0.0172414
NODE_124625_length_337_cov_468.180672	279	337	21	2	58	0.0344828
NODE_124625_length_337_cov_468.180672	279	337	22	2	58	0.0344828
NODE_124625_length_337_cov_468.180672	279	337	23	20	58	0.3448276
NODE_124625_length_337_cov_468.180672	279	337	25	1	58	0.0172414
NODE_124625_length_337_cov_468.180672	279	337	27	8	58	0.1379310
NODE_124625_length_337_cov_468.180672	279	337	28	3	58	0.0517241
NODE_124625_length_337_cov_468.180672	279	337	29	1	58	0.0172414
NODE_124625_length_337_cov_468.180672	279	337	30	1	58	0.0172414
NODE_124625_length_337_cov_468.180672	279	337	33	4	58	0.0689655
NODE_124625_length_337_cov_468.180672	279	337	34	3	58	0.0517241
NODE_124625_length_337_cov_468.180672	279	337	35	1	58	0.0172414
NODE_124626_length_337_cov_91.344538	1	50	2	19	49	0.3877551
NODE_124626_length_337_cov_91.344538	1	50	3	2	49	0.0408163
NODE_124626_length_337_cov_91.344538	1	50	4	2	49	0.0408163
NODE_124626_length_337_cov_91.344538	1	50	5	1	49	0.0204082
NODE_124626_length_337_cov_91.344538	1	50	6	11	49	0.2244898
NODE_124626_length_337_cov_91.344538	1	50	7	13	49	0.2653061
NODE_124626_length_337_cov_91.344538	1	50	8	1	49	0.0204082
NODE_124626_length_337_cov_91.344538	23	103	4	1	80	0.0125000
NODE_124626_length_337_cov_91.344538	23	103	5	1	80	0.0125000
NODE_124626_length_337_cov_91.344538	23	103	6	11	80	0.1375000
NODE_124626_length_337_cov_91.344538	23	103	7	13	80	0.1625000
NODE_124626_length_337_cov_91.344538	23	103	8	4	80	0.0500000
NODE_124626_length_337_cov_91.344538	23	103	9	6	80	0.0750000
NODE_124626_length_337_cov_91.344538	23	103	10	1	80	0.0125000
NODE_124626_length_337_cov_91.344538	23	103	11	2	80	0.0250000
NODE_124626_length_337_cov_91.344538	23	103	13	2	80	0.0250000
NODE_124626_length_337_cov_91.344538	23	103	14	1	80	0.0125000
NODE_124626_length_337_cov_91.344538	23	103	15	17	80	0.2125000
NODE_124626_length_337_cov_91.344538	23	103	16	15	80	0.1875000
NODE_124626_length_337_cov_91.344538	23	103	17	6	80	0.0750000
NODE_124627_length_337_cov_73.352941	71	151	5	4	80	0.0500000
NODE_124627_length_337_cov_73.352941	71	151	13	2	80	0.0250000
NODE_124627_length_337_cov_73.352941	71	151	14	2	80	0.0250000
NODE_124627_length_337_cov_73.352941	71	151	15	2	80	0.0250000
NODE_124627_length_337_cov_73.352941	71	151	17	7	80	0.0875000
NODE_124627_length_337_cov_73.352941	71	151	23	11	80	0.1375000
NODE_124627_length_337_cov_73.352941	71	151	37	4	80	0.0500000
NODE_124627_length_337_cov_73.352941	71	151	39	36	80	0.4500000
NODE_124627_length_337_cov_73.352941	71	151	40	12	80	0.1500000
NODE_124627_length_337_cov_73.352941	124	204	39	22	80	0.2750000
NODE_124627_length_337_cov_73.352941	124	204	40	14	80	0.1750000
NODE_124627_length_337_cov_73.352941	124	204	42	6	80	0.0750000
NODE_124627_length_337_cov_73.352941	124	204	43	10	80	0.1250000
NODE_124627_length_337_cov_73.352941	124	204	44	6	80	0.0750000
NODE_124627_length_337_cov_73.352941	124	204	45	7	80	0.0875000
NODE_124627_length_337_cov_73.352941	124	204	46	4	80	0.0500000
NODE_124627_length_337_cov_73.352941	124	204	47	2	80	0.0250000
NODE_124627_length_337_cov_73.352941	124	204	52	5	80	0.0625000
NODE_124627_length_337_cov_73.352941	124	204	54	4	80	0.0500000
NODE_124629_length_337_cov_46.978992	220	305	0	85	85	1.0000000
NODE_124629_length_337_cov_46.978992	220	305	0	85	85	1.0000000
NODE_124629_length_337_cov_46.978992	220	305	0	85	85	1.0000000
NODE_124629_length_337_cov_46.978992	278	327	0	49	49	1.0000000
NODE_124629_length_337_cov_46.978992	278	337	0	59	59	1.0000000
NODE_124629_length_337_cov_46.978992	283	337	0	54	54	1.0000000
NODE_124640_length_337_cov_6.214286	52	95	0	43	43	1.0000000
NODE_124669_length_337_cov_4.298319	5	58	0	53	53	1.0000000
NODE_124703_length_337_cov_3.478992	179	259	2	4	80	0.0500000
NODE_124703_length_337_cov_3.478992	179	259	3	5	80	0.0625000
NODE_124703_length_337_cov_3.478992	179	259	4	17	80	0.2125000
NODE_124703_length_337_cov_3.478992	179	259	5	48	80	0.6000000
NODE_124703_length_337_cov_3.478992	179	259	6	6	80	0.0750000
NODE_124703_length_337_cov_3.478992	232	307	2	17	75	0.2266667
NODE_124703_length_337_cov_3.478992	232	307	3	12	75	0.1600000
NODE_124703_length_337_cov_3.478992	232	307	4	6	75	0.0800000
NODE_124703_length_337_cov_3.478992	232	307	5	40	75	0.5333334
NODE_124759_length_337_cov_2.647059	80	146	0	66	66	1.0000000
NODE_124858_length_337_cov_2.121849	23	103	0	80	80	1.0000000
NODE_124858_length_337_cov_2.121849	76	141	0	65	65	1.0000000
NODE_125001_length_337_cov_1.689076	138	218	0	80	80	1.0000000
NODE_125024_length_337_cov_1.592437	109	151	0	42	42	1.0000000
NODE_125024_length_337_cov_1.592437	126	204	0	78	78	1.0000000
NODE_125074_length_337_cov_1.466387	266	332	0	66	66	1.0000000
NODE_125271_length_337_cov_1.071429	279	319	0	40	40	1.0000000
NODE_125332_length_337_cov_0.978992	227	272	0	45	45	1.0000000
NODE_125633_length_336_cov_7.843882	151	231	0	80	80	1.0000000
NODE_125645_length_336_cov_5.578059	159	220	0	61	61	1.0000000
NODE_125645_length_336_cov_5.578059	212	273	0	61	61	1.0000000
NODE_125663_length_336_cov_4.481013	129	207	0	68	78	0.8717949
NODE_125663_length_336_cov_4.481013	129	207	1	10	78	0.1282051
NODE_125752_length_336_cov_2.755274	83	112	1	29	29	1.0000000
NODE_125752_length_336_cov_2.755274	187	268	0	73	81	0.9012346
NODE_125752_length_336_cov_2.755274	187	268	1	8	81	0.0987654
NODE_125806_length_336_cov_2.358650	60	133	0	73	73	1.0000000
NODE_125811_length_336_cov_2.337553	93	173	0	80	80	1.0000000
NODE_125965_length_336_cov_1.729958	78	141	0	63	63	1.0000000
NODE_125965_length_336_cov_1.729958	131	194	0	63	63	1.0000000
NODE_126134_length_336_cov_1.333333	34	114	0	80	80	1.0000000
NODE_126134_length_336_cov_1.333333	87	124	0	37	37	1.0000000
NODE_126134_length_336_cov_1.333333	182	213	0	31	31	1.0000000
NODE_126216_length_336_cov_1.244726	222	276	0	54	54	1.0000000
NODE_126216_length_336_cov_1.244726	288	312	0	24	24	1.0000000
NODE_126260_length_336_cov_1.143460	129	154	0	25	25	1.0000000
NODE_126545_length_336_cov_0.670886	259	288	0	29	29	1.0000000
NODE_126606_length_335_cov_16.114407	162	242	0	80	80	1.0000000
NODE_126606_length_335_cov_16.114407	215	295	0	80	80	1.0000000
NODE_126609_length_335_cov_9.258475	177	250	4	73	73	1.0000000
NODE_126614_length_335_cov_7.207627	29	109	0	80	80	1.0000000
NODE_126614_length_335_cov_7.207627	82	162	0	80	80	1.0000000
NODE_126636_length_335_cov_5.046610	182	263	1	44	81	0.5432099
NODE_126636_length_335_cov_5.046610	182	263	2	37	81	0.4567901
NODE_126639_length_335_cov_4.995763	144	215	0	71	71	1.0000000
NODE_126665_length_335_cov_3.923729	163	231	0	68	68	1.0000000
NODE_126787_length_335_cov_2.411017	230	294	0	64	64	1.0000000
NODE_126791_length_335_cov_2.402542	164	240	0	76	76	1.0000000
NODE_126792_length_335_cov_2.398305	116	179	1	18	63	0.2857143
NODE_126792_length_335_cov_2.398305	116	179	2	45	63	0.7142857
NODE_126826_length_335_cov_2.161017	82	141	0	59	59	1.0000000
NODE_126835_length_335_cov_2.152542	61	134	0	73	73	1.0000000
NODE_126835_length_335_cov_2.152542	114	134	0	20	20	1.0000000
NODE_126920_length_335_cov_1.766949	257	330	0	73	73	1.0000000
NODE_126920_length_335_cov_1.766949	297	335	0	38	38	1.0000000
NODE_127022_length_335_cov_1.529661	255	320	0	65	65	1.0000000
NODE_127023_length_335_cov_1.525424	222	266	0	44	44	1.0000000
NODE_127062_length_335_cov_1.457627	38	87	0	49	49	1.0000000
NODE_127130_length_335_cov_1.296610	291	311	0	20	20	1.0000000
NODE_127130_length_335_cov_1.296610	291	311	0	20	20	1.0000000
NODE_127143_length_335_cov_1.292373	202	232	0	30	30	1.0000000
NODE_127200_length_335_cov_1.194915	75	156	2	34	81	0.4197531
NODE_127200_length_335_cov_1.194915	75	156	3	47	81	0.5802469
NODE_127200_length_335_cov_1.194915	129	195	2	21	66	0.3181818
NODE_127200_length_335_cov_1.194915	129	195	3	45	66	0.6818182
NODE_127310_length_335_cov_0.983051	96	117	0	21	21	1.0000000
NODE_127585_length_334_cov_275.425532	135	215	22	3	80	0.0375000
NODE_127585_length_334_cov_275.425532	135	215	23	1	80	0.0125000
NODE_127585_length_334_cov_275.425532	135	215	25	1	80	0.0125000
NODE_127585_length_334_cov_275.425532	135	215	28	2	80	0.0250000
NODE_127585_length_334_cov_275.425532	135	215	30	1	80	0.0125000
NODE_127585_length_334_cov_275.425532	135	215	34	1	80	0.0125000
NODE_127585_length_334_cov_275.425532	135	215	37	5	80	0.0625000
NODE_127585_length_334_cov_275.425532	135	215	38	2	80	0.0250000
NODE_127585_length_334_cov_275.425532	135	215	41	1	80	0.0125000
NODE_127585_length_334_cov_275.425532	135	215	42	11	80	0.1375000
NODE_127585_length_334_cov_275.425532	135	215	43	19	80	0.2375000
NODE_127585_length_334_cov_275.425532	135	215	44	6	80	0.0750000
NODE_127585_length_334_cov_275.425532	135	215	45	3	80	0.0375000
NODE_127585_length_334_cov_275.425532	135	215	46	5	80	0.0625000
NODE_127585_length_334_cov_275.425532	135	215	49	3	80	0.0375000
NODE_127585_length_334_cov_275.425532	135	215	50	2	80	0.0250000
NODE_127585_length_334_cov_275.425532	135	215	51	9	80	0.1125000
NODE_127585_length_334_cov_275.425532	135	215	52	1	80	0.0125000
NODE_127585_length_334_cov_275.425532	135	215	53	4	80	0.0500000
NODE_127585_length_334_cov_275.425532	188	269	44	1	81	0.0123457
NODE_127585_length_334_cov_275.425532	188	269	45	16	81	0.1975309
NODE_127585_length_334_cov_275.425532	188	269	46	14	81	0.1728395
NODE_127585_length_334_cov_275.425532	188	269	47	5	81	0.0617284
NODE_127585_length_334_cov_275.425532	188	269	48	3	81	0.0370370
NODE_127585_length_334_cov_275.425532	188	269	49	23	81	0.2839506
NODE_127585_length_334_cov_275.425532	188	269	50	5	81	0.0617284
NODE_127585_length_334_cov_275.425532	188	269	51	9	81	0.1111111
NODE_127585_length_334_cov_275.425532	188	269	52	1	81	0.0123457
NODE_127585_length_334_cov_275.425532	188	269	53	4	81	0.0493827
NODE_127586_length_334_cov_14.753191	135	215	8	17	80	0.2125000
NODE_127586_length_334_cov_14.753191	135	215	9	61	80	0.7625000
NODE_127586_length_334_cov_14.753191	135	215	10	2	80	0.0250000
NODE_127586_length_334_cov_14.753191	188	268	5	41	80	0.5125000
NODE_127586_length_334_cov_14.753191	188	268	7	7	80	0.0875000
NODE_127586_length_334_cov_14.753191	188	268	9	32	80	0.4000000
NODE_127610_length_334_cov_4.829787	92	174	0	82	82	1.0000000
NODE_127610_length_334_cov_4.829787	151	237	0	86	86	1.0000000
NODE_127612_length_334_cov_4.817021	179	231	0	52	52	1.0000000
NODE_127626_length_334_cov_4.438298	121	201	2	38	80	0.4750000
NODE_127626_length_334_cov_4.438298	121	201	5	42	80	0.5250000
NODE_127672_length_334_cov_3.604255	248	314	0	66	66	1.0000000
NODE_127672_length_334_cov_3.604255	287	334	0	47	47	1.0000000
NODE_127844_length_334_cov_2.165957	0	48	0	48	48	1.0000000
NODE_128026_length_334_cov_1.595745	253	328	0	75	75	1.0000000
NODE_128258_length_334_cov_1.157447	146	177	0	31	31	1.0000000
NODE_128665_length_333_cov_5.423077	172	242	0	70	70	1.0000000
NODE_128673_length_333_cov_4.867521	122	172	1	21	50	0.4200000
NODE_128673_length_333_cov_4.867521	122	172	2	29	50	0.5800000
NODE_128673_length_333_cov_4.867521	175	255	2	80	80	1.0000000
NODE_128673_length_333_cov_4.867521	194	219	2	25	25	1.0000000
NODE_128717_length_333_cov_3.717949	49	129	0	80	80	1.0000000
NODE_128717_length_333_cov_3.717949	102	182	0	80	80	1.0000000
NODE_128767_length_333_cov_2.897436	59	139	0	80	80	1.0000000
NODE_128850_length_333_cov_2.307692	68	148	0	80	80	1.0000000
NODE_128933_length_333_cov_1.940171	135	215	1	80	80	1.0000000
NODE_129252_length_333_cov_1.200855	0	80	0	80	80	1.0000000
NODE_129263_length_333_cov_1.170940	146	193	0	47	47	1.0000000
NODE_129263_length_333_cov_1.170940	203	243	0	40	40	1.0000000
NODE_129303_length_333_cov_1.089744	241	306	0	65	65	1.0000000
NODE_129310_length_333_cov_1.089744	206	226	0	20	20	1.0000000
NODE_129665_length_332_cov_5.386266	101	167	0	66	66	1.0000000
NODE_129680_length_332_cov_4.768240	221	250	0	29	29	1.0000000
NODE_129695_length_332_cov_4.343348	130	179	0	49	49	1.0000000
NODE_129698_length_332_cov_4.201717	191	237	0	46	46	1.0000000
NODE_129698_length_332_cov_4.201717	211	290	0	79	79	1.0000000
NODE_129879_length_332_cov_2.274678	187	227	4	40	40	1.0000000
NODE_129901_length_332_cov_2.184549	194	258	0	64	64	1.0000000
NODE_130053_length_332_cov_1.682403	241	316	0	75	75	1.0000000
NODE_130055_length_332_cov_1.673820	157	220	0	63	63	1.0000000
NODE_130183_length_332_cov_1.364807	132	212	0	80	80	1.0000000
NODE_130187_length_332_cov_1.356223	276	332	0	56	56	1.0000000
NODE_130312_length_332_cov_1.210300	120	176	0	56	56	1.0000000
NODE_130757_length_331_cov_5.254310	141	221	3	1	80	0.0125000
NODE_130757_length_331_cov_5.254310	141	221	4	79	80	0.9875000
NODE_130757_length_331_cov_5.254310	194	274	1	22	80	0.2750000
NODE_130757_length_331_cov_5.254310	194	274	2	10	80	0.1250000
NODE_130757_length_331_cov_5.254310	194	274	3	2	80	0.0250000
NODE_130757_length_331_cov_5.254310	194	274	4	46	80	0.5750000
NODE_130781_length_331_cov_4.323276	26	108	0	31	82	0.3780488
NODE_130781_length_331_cov_4.323276	26	108	2	51	82	0.6219512
NODE_130902_length_331_cov_2.603448	128	181	0	53	53	1.0000000
NODE_131036_length_331_cov_1.965517	183	216	0	33	33	1.0000000
NODE_131054_length_331_cov_1.896552	266	331	0	65	65	1.0000000
NODE_131817_length_330_cov_14.731602	209	280	2	71	71	1.0000000
NODE_131840_length_330_cov_4.935065	16	97	0	81	81	1.0000000
NODE_131840_length_330_cov_4.935065	81	149	0	68	68	1.0000000
NODE_131841_length_330_cov_4.891775	177	255	0	78	78	1.0000000
NODE_131845_length_330_cov_4.740260	134	209	0	75	75	1.0000000
NODE_131892_length_330_cov_3.467532	161	225	1	10	64	0.1562500
NODE_131892_length_330_cov_3.467532	161	225	2	54	64	0.8437500
NODE_131969_length_330_cov_2.601732	8	88	0	33	80	0.4125000
NODE_131969_length_330_cov_2.601732	8	88	1	43	80	0.5375000
NODE_131969_length_330_cov_2.601732	8	88	2	4	80	0.0500000
NODE_132188_length_330_cov_1.623377	154	200	0	46	46	1.0000000
NODE_132238_length_330_cov_1.541126	98	156	0	58	58	1.0000000
NODE_132268_length_330_cov_1.467532	234	287	0	53	53	1.0000000
NODE_132268_length_330_cov_1.467532	242	283	0	41	41	1.0000000
NODE_132306_length_330_cov_1.346320	230	296	0	66	66	1.0000000
NODE_132306_length_330_cov_1.346320	230	257	0	27	27	1.0000000
NODE_132410_length_330_cov_1.220779	249	272	0	23	23	1.0000000
NODE_132478_length_330_cov_1.103896	189	227	0	38	38	1.0000000
NODE_132542_length_330_cov_1.038961	219	297	3	54	78	0.6923077
NODE_132542_length_330_cov_1.038961	219	297	5	24	78	0.3076923
NODE_132688_length_330_cov_0.883117	284	330	0	46	46	1.0000000
NODE_132873_length_329_cov_110.178261	138	167	1	29	29	1.0000000
NODE_132873_length_329_cov_110.178261	189	269	0	23	80	0.2875000
NODE_132873_length_329_cov_110.178261	189	269	1	57	80	0.7125000
NODE_132873_length_329_cov_110.178261	242	322	0	76	80	0.9500000
NODE_132873_length_329_cov_110.178261	242	322	1	4	80	0.0500000
NODE_132879_length_329_cov_8.882609	61	141	0	80	80	1.0000000
NODE_132879_length_329_cov_8.882609	114	194	0	80	80	1.0000000
NODE_132885_length_329_cov_6.586957	166	207	0	41	41	1.0000000
NODE_132908_length_329_cov_4.617391	175	229	0	54	54	1.0000000
NODE_132970_length_329_cov_3.160870	59	139	0	80	80	1.0000000
NODE_133003_length_329_cov_2.821739	164	209	0	45	45	1.0000000
NODE_133003_length_329_cov_2.821739	184	262	0	78	78	1.0000000
NODE_133033_length_329_cov_2.560870	139	201	0	62	62	1.0000000
NODE_133036_length_329_cov_2.543478	145	206	0	61	61	1.0000000
NODE_133123_length_329_cov_2.143478	39	119	0	80	80	1.0000000
NODE_133123_length_329_cov_2.143478	92	158	0	66	66	1.0000000
NODE_133184_length_329_cov_1.865217	182	252	0	70	70	1.0000000
NODE_133200_length_329_cov_1.791304	50	84	0	34	34	1.0000000
NODE_133200_length_329_cov_1.791304	92	149	0	57	57	1.0000000
NODE_133200_length_329_cov_1.791304	145	203	0	58	58	1.0000000
NODE_133332_length_329_cov_1.508696	261	323	0	62	62	1.0000000
NODE_133348_length_329_cov_1.469565	168	237	0	69	69	1.0000000
NODE_133376_length_329_cov_1.391304	275	307	4	5	32	0.1562500
NODE_133376_length_329_cov_1.391304	275	307	5	16	32	0.5000000
NODE_133376_length_329_cov_1.391304	275	307	6	11	32	0.3437500
NODE_133547_length_329_cov_1.165217	199	242	0	43	43	1.0000000
NODE_133768_length_329_cov_0.878261	221	296	0	75	75	1.0000000
NODE_133970_length_328_cov_4.484716	95	175	0	80	80	1.0000000
NODE_133989_length_328_cov_4.087336	79	159	0	80	80	1.0000000
NODE_133989_length_328_cov_4.087336	132	207	0	75	75	1.0000000
NODE_133993_length_328_cov_3.895197	110	190	0	80	80	1.0000000
NODE_134019_length_328_cov_3.393013	30	78	0	48	48	1.0000000
NODE_134144_length_328_cov_2.161572	103	134	0	31	31	1.0000000
NODE_134247_length_328_cov_1.781659	16	44	0	28	28	1.0000000
NODE_134335_length_328_cov_1.567686	0	76	0	76	76	1.0000000
NODE_134335_length_328_cov_1.567686	49	94	0	45	45	1.0000000
NODE_134452_length_328_cov_1.336245	0	73	0	73	73	1.0000000
NODE_134508_length_328_cov_1.266376	78	158	0	80	80	1.0000000
NODE_135002_length_327_cov_4.934211	170	250	0	80	80	1.0000000
NODE_135009_length_327_cov_4.701754	225	305	0	80	80	1.0000000
NODE_135018_length_327_cov_4.241228	97	173	7	32	76	0.4210526
NODE_135018_length_327_cov_4.241228	97	173	8	12	76	0.1578947
NODE_135018_length_327_cov_4.241228	97	173	10	9	76	0.1184211
NODE_135018_length_327_cov_4.241228	97	173	11	14	76	0.1842105
NODE_135018_length_327_cov_4.241228	97	173	14	9	76	0.1184211
NODE_135037_length_327_cov_3.719298	70	150	0	80	80	1.0000000
NODE_135063_length_327_cov_3.350877	156	227	0	71	71	1.0000000
NODE_135328_length_327_cov_1.780702	191	271	1	80	80	1.0000000
NODE_136081_length_326_cov_3.964758	178	228	0	50	50	1.0000000
NODE_136100_length_326_cov_3.502203	211	253	1	42	42	1.0000000
NODE_136100_length_326_cov_3.502203	220	255	1	35	35	1.0000000
NODE_136116_length_326_cov_3.202643	149	203	0	54	54	1.0000000
NODE_136130_length_326_cov_3.057269	107	126	0	19	19	1.0000000
NODE_136176_length_326_cov_2.594714	125	196	1	11	71	0.1549296
NODE_136176_length_326_cov_2.594714	125	196	2	60	71	0.8450704
NODE_136283_length_326_cov_2.123348	184	244	0	60	60	1.0000000
NODE_136496_length_326_cov_1.515419	86	166	0	80	80	1.0000000
NODE_137182_length_325_cov_4.893805	142	222	4	30	80	0.3750000
NODE_137182_length_325_cov_4.893805	142	222	5	16	80	0.2000000
NODE_137182_length_325_cov_4.893805	142	222	6	34	80	0.4250000
NODE_137182_length_325_cov_4.893805	195	275	3	3	80	0.0375000
NODE_137182_length_325_cov_4.893805	195	275	4	22	80	0.2750000
NODE_137182_length_325_cov_4.893805	195	275	5	6	80	0.0750000
NODE_137182_length_325_cov_4.893805	195	275	6	49	80	0.6125000
NODE_137199_length_325_cov_4.000000	134	198	0	64	64	1.0000000
NODE_137221_length_325_cov_3.513274	191	266	1	75	75	1.0000000
NODE_137221_length_325_cov_3.513274	240	319	0	25	79	0.3164557
NODE_137221_length_325_cov_3.513274	240	319	1	54	79	0.6835443
NODE_137223_length_325_cov_3.469027	216	278	1	62	62	1.0000000
NODE_137224_length_325_cov_3.429204	178	224	0	46	46	1.0000000
NODE_137243_length_325_cov_3.168142	188	274	0	86	86	1.0000000
NODE_137268_length_325_cov_2.880531	72	152	0	80	80	1.0000000
NODE_137268_length_325_cov_2.880531	125	205	0	80	80	1.0000000
NODE_137291_length_325_cov_2.707965	203	261	0	58	58	1.0000000
NODE_137296_length_325_cov_2.703540	68	148	0	80	80	1.0000000
NODE_137330_length_325_cov_2.500000	0	42	0	42	42	1.0000000
NODE_137407_length_325_cov_2.048673	122	202	4	60	80	0.7500000
NODE_137407_length_325_cov_2.048673	122	202	6	20	80	0.2500000
NODE_137409_length_325_cov_2.035398	83	154	0	71	71	1.0000000
NODE_137642_length_325_cov_1.464602	153	224	0	71	71	1.0000000
NODE_137939_length_325_cov_1.017699	103	134	0	31	31	1.0000000
NODE_138113_length_325_cov_0.827434	258	308	0	50	50	1.0000000
NODE_138309_length_324_cov_4.737778	113	160	0	47	47	1.0000000
NODE_138309_length_324_cov_4.737778	142	213	0	71	71	1.0000000
NODE_138358_length_324_cov_3.626667	218	273	0	55	55	1.0000000
NODE_138396_length_324_cov_3.124444	101	181	0	80	80	1.0000000
NODE_138396_length_324_cov_3.124444	256	285	0	29	29	1.0000000
NODE_138416_length_324_cov_2.924444	114	198	0	84	84	1.0000000
NODE_138416_length_324_cov_2.924444	178	237	0	59	59	1.0000000
NODE_138418_length_324_cov_2.915556	141	221	0	80	80	1.0000000
NODE_138434_length_324_cov_2.715556	4	51	1	32	47	0.6808510
NODE_138434_length_324_cov_2.715556	4	51	2	15	47	0.3191489
NODE_138434_length_324_cov_2.715556	24	104	1	12	80	0.1500000
NODE_138434_length_324_cov_2.715556	24	104	2	68	80	0.8500000
NODE_138463_length_324_cov_2.506667	270	306	0	33	36	0.9166667
NODE_138463_length_324_cov_2.506667	270	306	5	3	36	0.0833333
NODE_138483_length_324_cov_2.448889	187	238	0	51	51	1.0000000
NODE_138527_length_324_cov_2.248889	30	96	0	66	66	1.0000000
NODE_138778_length_324_cov_1.502222	10	90	0	80	80	1.0000000
NODE_138792_length_324_cov_1.457778	0	45	0	45	45	1.0000000
NODE_138792_length_324_cov_1.457778	18	75	0	57	57	1.0000000
NODE_138808_length_324_cov_1.382222	263	304	0	41	41	1.0000000
NODE_139129_length_324_cov_1.017778	0	59	0	59	59	1.0000000
NODE_139497_length_323_cov_6.669643	215	286	0	71	71	1.0000000
NODE_139497_length_323_cov_6.669643	268	315	0	47	47	1.0000000
NODE_139511_length_323_cov_5.089286	224	290	0	66	66	1.0000000
NODE_139511_length_323_cov_5.089286	263	319	0	56	56	1.0000000
NODE_139572_length_323_cov_3.276786	189	269	3	2	80	0.0250000
NODE_139572_length_323_cov_3.276786	189	269	4	78	80	0.9750000
NODE_139575_length_323_cov_3.263393	101	181	2	80	80	1.0000000
NODE_139591_length_323_cov_3.089286	128	208	0	80	80	1.0000000
NODE_139591_length_323_cov_3.089286	166	208	0	42	42	1.0000000
NODE_139591_length_323_cov_3.089286	181	261	0	80	80	1.0000000
NODE_139591_length_323_cov_3.089286	181	261	0	80	80	1.0000000
NODE_139629_length_323_cov_2.683036	144	215	0	71	71	1.0000000
NODE_139746_length_323_cov_2.089286	64	144	0	80	80	1.0000000
NODE_139797_length_323_cov_1.888393	148	207	1	59	59	1.0000000
NODE_139901_length_323_cov_1.705357	195	262	0	67	67	1.0000000
NODE_139901_length_323_cov_1.705357	235	315	0	80	80	1.0000000
NODE_140651_length_322_cov_5.475336	56	136	0	80	80	1.0000000
NODE_140651_length_322_cov_5.475336	113	189	0	76	76	1.0000000
NODE_140692_length_322_cov_3.753363	63	133	0	70	70	1.0000000
NODE_140692_length_322_cov_3.753363	116	190	0	74	74	1.0000000
NODE_140693_length_322_cov_3.735426	60	86	0	26	26	1.0000000
NODE_140693_length_322_cov_3.735426	99	139	0	40	40	1.0000000
NODE_140701_length_322_cov_3.605381	73	116	0	43	43	1.0000000
NODE_140702_length_322_cov_3.600897	75	145	0	70	70	1.0000000
NODE_140820_length_322_cov_2.304933	182	213	0	31	31	1.0000000
NODE_141738_length_321_cov_8.527027	176	240	0	64	64	1.0000000
NODE_141786_length_321_cov_4.094595	196	266	0	70	70	1.0000000
NODE_141811_length_321_cov_3.563063	59	131	0	72	72	1.0000000
NODE_141811_length_321_cov_3.563063	112	183	0	71	71	1.0000000
NODE_141813_length_321_cov_3.540541	112	141	0	29	29	1.0000000
NODE_141833_length_321_cov_3.049550	65	115	4	50	50	1.0000000
NODE_141833_length_321_cov_3.049550	95	138	4	43	43	1.0000000
NODE_141833_length_321_cov_3.049550	118	168	0	5	50	0.1000000
NODE_141833_length_321_cov_3.049550	118	168	2	4	50	0.0800000
NODE_141833_length_321_cov_3.049550	118	168	4	41	50	0.8200000
NODE_141837_length_321_cov_2.995495	146	220	0	74	74	1.0000000
NODE_141842_length_321_cov_2.981982	251	304	0	53	53	1.0000000
NODE_141876_length_321_cov_2.734234	239	306	0	67	67	1.0000000
NODE_141910_length_321_cov_2.427928	221	265	0	44	44	1.0000000
NODE_141922_length_321_cov_2.315315	22	65	0	43	43	1.0000000
NODE_141951_length_321_cov_2.270270	43	105	0	62	62	1.0000000
NODE_141951_length_321_cov_2.270270	120	203	0	83	83	1.0000000
NODE_141951_length_321_cov_2.270270	127	208	0	81	81	1.0000000
NODE_142200_length_321_cov_1.576577	241	321	0	80	80	1.0000000
NODE_142363_length_321_cov_1.319820	253	304	0	51	51	1.0000000
NODE_142484_length_321_cov_1.130631	0	43	0	43	43	1.0000000
NODE_142700_length_321_cov_0.869369	248	294	0	46	46	1.0000000
NODE_142885_length_320_cov_200.484163	264	320	2	2	56	0.0357143
NODE_142885_length_320_cov_200.484163	264	320	3	1	56	0.0178571
NODE_142885_length_320_cov_200.484163	264	320	4	28	56	0.5000000
NODE_142885_length_320_cov_200.484163	264	320	5	25	56	0.4464286
NODE_142886_length_320_cov_73.357466	51	97	0	46	46	1.0000000
NODE_142886_length_320_cov_73.357466	108	154	0	46	46	1.0000000
NODE_142886_length_320_cov_73.357466	165	245	2	80	80	1.0000000
NODE_142886_length_320_cov_73.357466	218	296	2	78	78	1.0000000
NODE_142887_length_320_cov_35.787330	212	292	6	1	80	0.0125000
NODE_142887_length_320_cov_35.787330	212	292	7	11	80	0.1375000
NODE_142887_length_320_cov_35.787330	212	292	8	10	80	0.1250000
NODE_142887_length_320_cov_35.787330	212	292	9	11	80	0.1375000
NODE_142887_length_320_cov_35.787330	212	292	10	44	80	0.5500000
NODE_142887_length_320_cov_35.787330	212	292	11	3	80	0.0375000
NODE_142887_length_320_cov_35.787330	212	292	6	1	80	0.0125000
NODE_142887_length_320_cov_35.787330	212	292	7	11	80	0.1375000
NODE_142887_length_320_cov_35.787330	212	292	8	10	80	0.1250000
NODE_142887_length_320_cov_35.787330	212	292	9	11	80	0.1375000
NODE_142887_length_320_cov_35.787330	212	292	10	44	80	0.5500000
NODE_142887_length_320_cov_35.787330	212	292	11	3	80	0.0375000
NODE_142887_length_320_cov_35.787330	212	292	6	1	80	0.0125000
NODE_142887_length_320_cov_35.787330	212	292	7	11	80	0.1375000
NODE_142887_length_320_cov_35.787330	212	292	8	10	80	0.1250000
NODE_142887_length_320_cov_35.787330	212	292	9	11	80	0.1375000
NODE_142887_length_320_cov_35.787330	212	292	10	44	80	0.5500000
NODE_142887_length_320_cov_35.787330	212	292	11	3	80	0.0375000
NODE_142887_length_320_cov_35.787330	212	292	6	1	80	0.0125000
NODE_142887_length_320_cov_35.787330	212	292	7	11	80	0.1375000
NODE_142887_length_320_cov_35.787330	212	292	8	10	80	0.1250000
NODE_142887_length_320_cov_35.787330	212	292	9	11	80	0.1375000
NODE_142887_length_320_cov_35.787330	212	292	10	44	80	0.5500000
NODE_142887_length_320_cov_35.787330	212	292	11	3	80	0.0375000
NODE_142887_length_320_cov_35.787330	212	292	6	1	80	0.0125000
NODE_142887_length_320_cov_35.787330	212	292	7	11	80	0.1375000
NODE_142887_length_320_cov_35.787330	212	292	8	10	80	0.1250000
NODE_142887_length_320_cov_35.787330	212	292	9	11	80	0.1375000
NODE_142887_length_320_cov_35.787330	212	292	10	44	80	0.5500000
NODE_142887_length_320_cov_35.787330	212	292	11	3	80	0.0375000
NODE_142887_length_320_cov_35.787330	265	314	3	21	49	0.4285714
NODE_142887_length_320_cov_35.787330	265	314	4	1	49	0.0204082
NODE_142887_length_320_cov_35.787330	265	314	6	1	49	0.0204082
NODE_142887_length_320_cov_35.787330	265	314	7	11	49	0.2244898
NODE_142887_length_320_cov_35.787330	265	314	8	10	49	0.2040816
NODE_142887_length_320_cov_35.787330	265	314	9	5	49	0.1020408
NODE_142887_length_320_cov_35.787330	265	320	1	6	55	0.1090909
NODE_142887_length_320_cov_35.787330	265	320	3	21	55	0.3818182
NODE_142887_length_320_cov_35.787330	265	320	4	1	55	0.0181818
NODE_142887_length_320_cov_35.787330	265	320	6	1	55	0.0181818
NODE_142887_length_320_cov_35.787330	265	320	7	11	55	0.2000000
NODE_142887_length_320_cov_35.787330	265	320	8	10	55	0.1818182
NODE_142887_length_320_cov_35.787330	265	320	9	5	55	0.0909091
NODE_142887_length_320_cov_35.787330	265	320	1	6	55	0.1090909
NODE_142887_length_320_cov_35.787330	265	320	3	21	55	0.3818182
NODE_142887_length_320_cov_35.787330	265	320	4	1	55	0.0181818
NODE_142887_length_320_cov_35.787330	265	320	6	1	55	0.0181818
NODE_142887_length_320_cov_35.787330	265	320	7	11	55	0.2000000
NODE_142887_length_320_cov_35.787330	265	320	8	10	55	0.1818182
NODE_142887_length_320_cov_35.787330	265	320	9	5	55	0.0909091
NODE_142887_length_320_cov_35.787330	268	320	1	6	52	0.1153846
NODE_142887_length_320_cov_35.787330	268	320	3	21	52	0.4038461
NODE_142887_length_320_cov_35.787330	268	320	4	1	52	0.0192308
NODE_142887_length_320_cov_35.787330	268	320	6	1	52	0.0192308
NODE_142887_length_320_cov_35.787330	268	320	7	11	52	0.2115385
NODE_142887_length_320_cov_35.787330	268	320	8	10	52	0.1923077
NODE_142887_length_320_cov_35.787330	268	320	9	2	52	0.0384615
NODE_142887_length_320_cov_35.787330	270	320	1	6	50	0.1200000
NODE_142887_length_320_cov_35.787330	270	320	3	21	50	0.4200000
NODE_142887_length_320_cov_35.787330	270	320	4	1	50	0.0200000
NODE_142887_length_320_cov_35.787330	270	320	6	1	50	0.0200000
NODE_142887_length_320_cov_35.787330	270	320	7	11	50	0.2200000
NODE_142887_length_320_cov_35.787330	270	320	8	10	50	0.2000000
NODE_142900_length_320_cov_5.841629	115	172	0	57	57	1.0000000
NODE_142900_length_320_cov_5.841629	168	225	0	57	57	1.0000000
NODE_142934_length_320_cov_4.153846	134	200	0	66	66	1.0000000
NODE_142958_length_320_cov_3.733032	5	40	0	35	35	1.0000000
NODE_142985_length_320_cov_3.402715	142	222	0	80	80	1.0000000
NODE_143076_length_320_cov_2.475113	120	187	0	67	67	1.0000000
NODE_143142_length_320_cov_2.171946	16	96	0	80	80	1.0000000
NODE_143142_length_320_cov_2.171946	69	149	0	80	80	1.0000000
NODE_143207_length_320_cov_1.900452	37	117	0	80	80	1.0000000
NODE_143207_length_320_cov_1.900452	90	164	0	74	74	1.0000000
NODE_143230_length_320_cov_1.846154	188	220	0	32	32	1.0000000
NODE_143309_length_320_cov_1.665158	144	198	0	54	54	1.0000000
NODE_143309_length_320_cov_1.665158	198	251	0	53	53	1.0000000
NODE_143351_length_320_cov_1.601810	157	181	0	24	24	1.0000000
NODE_143351_length_320_cov_1.601810	231	290	0	59	59	1.0000000
NODE_143366_length_320_cov_1.556561	0	39	0	39	39	1.0000000
NODE_143442_length_320_cov_1.384615	18	98	0	80	80	1.0000000
NODE_143442_length_320_cov_1.384615	71	145	0	74	74	1.0000000
NODE_143521_length_320_cov_1.312217	117	170	0	53	53	1.0000000
NODE_143670_length_320_cov_1.117647	58	109	0	51	51	1.0000000
NODE_144091_length_319_cov_5.940909	122	202	2	80	80	1.0000000
NODE_144107_length_319_cov_4.700000	16	47	0	31	31	1.0000000
NODE_144137_length_319_cov_4.068182	5	36	0	31	31	1.0000000
NODE_144162_length_319_cov_3.568182	149	229	0	16	80	0.2000000
NODE_144162_length_319_cov_3.568182	149	229	2	64	80	0.8000000
NODE_144206_length_319_cov_3.036364	112	174	0	28	62	0.4516129
NODE_144206_length_319_cov_3.036364	112	174	2	34	62	0.5483871
NODE_144226_length_319_cov_2.800000	25	106	0	4	81	0.0493827
NODE_144226_length_319_cov_2.800000	25	106	2	1	81	0.0123457
NODE_144226_length_319_cov_2.800000	25	106	3	2	81	0.0246914
NODE_144226_length_319_cov_2.800000	25	106	7	21	81	0.2592593
NODE_144226_length_319_cov_2.800000	25	106	8	3	81	0.0370370
NODE_144226_length_319_cov_2.800000	25	106	10	12	81	0.1481481
NODE_144226_length_319_cov_2.800000	25	106	12	33	81	0.4074074
NODE_144226_length_319_cov_2.800000	25	106	15	5	81	0.0617284
NODE_144226_length_319_cov_2.800000	79	158	12	22	79	0.2784810
NODE_144226_length_319_cov_2.800000	79	158	15	29	79	0.3670886
NODE_144226_length_319_cov_2.800000	79	158	16	28	79	0.3544304
NODE_144237_length_319_cov_2.740909	67	147	0	51	80	0.6375000
NODE_144237_length_319_cov_2.740909	67	147	2	29	80	0.3625000
NODE_144252_length_319_cov_2.586364	247	319	0	72	72	1.0000000
NODE_144272_length_319_cov_2.463636	90	153	0	63	63	1.0000000
NODE_144272_length_319_cov_2.463636	163	216	0	53	53	1.0000000
NODE_144316_length_319_cov_2.259091	146	212	0	66	66	1.0000000
NODE_144340_length_319_cov_2.163636	213	275	0	62	62	1.0000000
NODE_144390_length_319_cov_1.968182	120	200	0	80	80	1.0000000
NODE_144616_length_319_cov_1.431818	111	157	0	46	46	1.0000000
NODE_144629_length_319_cov_1.395455	129	179	0	50	50	1.0000000
NODE_144788_length_319_cov_1.190909	119	182	0	63	63	1.0000000
NODE_144788_length_319_cov_1.190909	197	232	0	35	35	1.0000000
NODE_145289_length_318_cov_232.639269	169	198	47	1	29	0.0344828
NODE_145289_length_318_cov_232.639269	169	198	49	3	29	0.1034483
NODE_145289_length_318_cov_232.639269	169	198	50	4	29	0.1379310
NODE_145289_length_318_cov_232.639269	169	198	51	18	29	0.6206896
NODE_145289_length_318_cov_232.639269	169	198	52	3	29	0.1034483
NODE_145289_length_318_cov_232.639269	171	246	40	5	75	0.0666667
NODE_145289_length_318_cov_232.639269	171	246	42	2	75	0.0266667
NODE_145289_length_318_cov_232.639269	171	246	43	1	75	0.0133333
NODE_145289_length_318_cov_232.639269	171	246	44	1	75	0.0133333
NODE_145289_length_318_cov_232.639269	171	246	45	2	75	0.0266667
NODE_145289_length_318_cov_232.639269	171	246	46	8	75	0.1066667
NODE_145289_length_318_cov_232.639269	171	246	47	7	75	0.0933333
NODE_145289_length_318_cov_232.639269	171	246	48	8	75	0.1066667
NODE_145289_length_318_cov_232.639269	171	246	49	14	75	0.1866667
NODE_145289_length_318_cov_232.639269	171	246	50	6	75	0.0800000
NODE_145289_length_318_cov_232.639269	171	246	51	18	75	0.2400000
NODE_145289_length_318_cov_232.639269	171	246	52	3	75	0.0400000
NODE_145333_length_318_cov_4.237443	222	294	0	72	72	1.0000000
NODE_145348_length_318_cov_3.721461	98	148	0	50	50	1.0000000
NODE_145362_length_318_cov_3.515982	60	129	0	69	69	1.0000000
NODE_145362_length_318_cov_3.515982	60	140	0	80	80	1.0000000
NODE_145362_length_318_cov_3.515982	60	140	0	80	80	1.0000000
NODE_145362_length_318_cov_3.515982	113	153	0	40	40	1.0000000
NODE_145362_length_318_cov_3.515982	122	153	0	31	31	1.0000000
NODE_145465_length_318_cov_2.557078	205	247	0	42	42	1.0000000
NODE_145551_length_318_cov_2.109589	70	150	0	80	80	1.0000000
NODE_145619_length_318_cov_1.945205	229	286	0	57	57	1.0000000
NODE_145709_length_318_cov_1.739726	242	308	0	44	66	0.6666667
NODE_145709_length_318_cov_1.739726	242	308	2	1	66	0.0151515
NODE_145709_length_318_cov_1.739726	242	308	4	21	66	0.3181818
NODE_145725_length_318_cov_1.684932	49	80	0	31	31	1.0000000
NODE_145787_length_318_cov_1.561644	99	158	0	59	59	1.0000000
NODE_145807_length_318_cov_1.493151	151	195	0	44	44	1.0000000
NODE_145807_length_318_cov_1.493151	199	258	0	59	59	1.0000000
NODE_145968_length_318_cov_1.301370	91	141	0	50	50	1.0000000
NODE_146017_length_318_cov_1.173516	83	150	2	67	67	1.0000000
NODE_146065_length_318_cov_1.127854	24	51	0	27	27	1.0000000
NODE_146065_length_318_cov_1.127854	24	60	0	36	36	1.0000000
NODE_146467_length_317_cov_55.467890	172	243	7	13	71	0.1830986
NODE_146467_length_317_cov_55.467890	172	243	8	34	71	0.4788733
NODE_146467_length_317_cov_55.467890	172	243	10	2	71	0.0281690
NODE_146467_length_317_cov_55.467890	172	243	11	6	71	0.0845070
NODE_146467_length_317_cov_55.467890	172	243	12	4	71	0.0563380
NODE_146467_length_317_cov_55.467890	172	243	14	12	71	0.1690141
NODE_146487_length_317_cov_5.252294	247	307	2	60	60	1.0000000
NODE_146503_length_317_cov_4.467890	105	185	0	80	80	1.0000000
NODE_146503_length_317_cov_4.467890	113	193	0	80	80	1.0000000
NODE_146554_length_317_cov_3.298165	146	206	0	60	60	1.0000000
NODE_146562_length_317_cov_3.266055	111	191	0	80	80	1.0000000
NODE_146562_length_317_cov_3.266055	164	244	0	80	80	1.0000000
NODE_146585_length_317_cov_3.036697	3	79	0	76	76	1.0000000
NODE_146601_length_317_cov_2.825688	14	94	1	69	80	0.8625000
NODE_146601_length_317_cov_2.825688	14	94	2	11	80	0.1375000
NODE_146601_length_317_cov_2.825688	67	147	1	19	80	0.2375000
NODE_146601_length_317_cov_2.825688	67	147	2	61	80	0.7625000
NODE_146602_length_317_cov_2.821101	142	208	0	66	66	1.0000000
NODE_146604_length_317_cov_2.816514	121	201	0	80	80	1.0000000
NODE_146612_length_317_cov_2.779817	67	138	0	71	71	1.0000000
NODE_147046_length_317_cov_1.353211	166	239	0	73	73	1.0000000
NODE_147046_length_317_cov_1.353211	212	292	0	80	80	1.0000000
NODE_147172_length_317_cov_1.160550	58	117	0	59	59	1.0000000
NODE_147172_length_317_cov_1.160550	90	170	0	80	80	1.0000000
NODE_147187_length_317_cov_1.137615	245	313	0	68	68	1.0000000
NODE_147259_length_317_cov_0.967890	170	211	0	41	41	1.0000000
NODE_147373_length_317_cov_0.926606	194	232	0	38	38	1.0000000
NODE_147383_length_317_cov_0.912844	186	244	0	58	58	1.0000000
NODE_147595_length_316_cov_31.502304	96	174	0	42	78	0.5384616
NODE_147595_length_316_cov_31.502304	96	174	1	28	78	0.3589744
NODE_147595_length_316_cov_31.502304	96	174	2	8	78	0.1025641
NODE_147595_length_316_cov_31.502304	96	121	0	25	25	1.0000000
NODE_147609_length_316_cov_6.179724	225	278	0	53	53	1.0000000
NODE_147623_length_316_cov_5.539171	91	171	0	80	80	1.0000000
NODE_147668_length_316_cov_3.732719	128	208	0	80	80	1.0000000
NODE_147668_length_316_cov_3.732719	181	257	0	76	76	1.0000000
NODE_147680_length_316_cov_3.589862	185	247	2	62	62	1.0000000
NODE_147684_length_316_cov_3.520737	101	143	0	42	42	1.0000000
NODE_147702_length_316_cov_3.221198	108	184	0	76	76	1.0000000
NODE_147734_length_316_cov_2.824885	274	311	0	37	37	1.0000000
NODE_147736_length_316_cov_2.820276	200	280	0	80	80	1.0000000
NODE_147757_length_316_cov_2.672811	23	80	0	57	57	1.0000000
NODE_147796_length_316_cov_2.456221	104	144	0	40	40	1.0000000
NODE_147985_length_316_cov_1.751152	73	122	0	49	49	1.0000000
NODE_148030_length_316_cov_1.640553	218	300	0	82	82	1.0000000
NODE_148042_length_316_cov_1.631336	180	233	0	53	53	1.0000000
NODE_148042_length_316_cov_1.631336	180	215	0	35	35	1.0000000
NODE_148080_length_316_cov_1.520737	194	275	0	81	81	1.0000000
NODE_148080_length_316_cov_1.520737	248	302	0	54	54	1.0000000
NODE_148086_length_316_cov_1.493088	64	144	0	80	80	1.0000000
NODE_148193_length_316_cov_1.377880	22	64	0	42	42	1.0000000
NODE_148204_length_316_cov_1.350230	74	117	0	43	43	1.0000000
NODE_148204_length_316_cov_1.350230	90	140	0	50	50	1.0000000
NODE_148533_length_316_cov_0.940092	104	180	0	76	76	1.0000000
NODE_148533_length_316_cov_0.940092	155	234	0	79	79	1.0000000
NODE_148693_length_316_cov_0.695853	232	267	0	35	35	1.0000000
NODE_148778_length_315_cov_6.967593	127	191	0	64	64	1.0000000
NODE_148786_length_315_cov_6.300926	67	147	2	80	80	1.0000000
NODE_148786_length_315_cov_6.300926	120	200	0	8	80	0.1000000
NODE_148786_length_315_cov_6.300926	120	200	1	1	80	0.0125000
NODE_148786_length_315_cov_6.300926	120	200	2	71	80	0.8875000
NODE_148812_length_315_cov_4.449074	125	205	1	80	80	1.0000000
NODE_148812_length_315_cov_4.449074	178	225	1	47	47	1.0000000
NODE_148834_length_315_cov_4.009259	0	61	0	61	61	1.0000000
NODE_148834_length_315_cov_4.009259	42	61	0	19	19	1.0000000
NODE_148872_length_315_cov_3.421296	37	120	0	83	83	1.0000000
NODE_148915_length_315_cov_2.847222	0	74	0	74	74	1.0000000
NODE_148915_length_315_cov_2.847222	47	127	0	80	80	1.0000000
NODE_148921_length_315_cov_2.833333	186	253	0	67	67	1.0000000
NODE_148921_length_315_cov_2.833333	186	253	0	67	67	1.0000000
NODE_148991_length_315_cov_2.416667	44	117	28	3	73	0.0410959
NODE_148991_length_315_cov_2.416667	44	117	31	4	73	0.0547945
NODE_148991_length_315_cov_2.416667	44	117	34	6	73	0.0821918
NODE_148991_length_315_cov_2.416667	44	117	35	2	73	0.0273973
NODE_148991_length_315_cov_2.416667	44	117	38	3	73	0.0410959
NODE_148991_length_315_cov_2.416667	44	117	45	1	73	0.0136986
NODE_148991_length_315_cov_2.416667	44	117	47	1	73	0.0136986
NODE_148991_length_315_cov_2.416667	44	117	51	6	73	0.0821918
NODE_148991_length_315_cov_2.416667	44	117	54	10	73	0.1369863
NODE_148991_length_315_cov_2.416667	44	117	55	1	73	0.0136986
NODE_148991_length_315_cov_2.416667	44	117	59	2	73	0.0273973
NODE_148991_length_315_cov_2.416667	44	117	60	4	73	0.0547945
NODE_148991_length_315_cov_2.416667	44	117	64	8	73	0.1095890
NODE_148991_length_315_cov_2.416667	44	117	65	4	73	0.0547945
NODE_148991_length_315_cov_2.416667	44	117	68	1	73	0.0136986
NODE_148991_length_315_cov_2.416667	44	117	70	1	73	0.0136986
NODE_148991_length_315_cov_2.416667	44	117	79	16	73	0.2191781
NODE_149074_length_315_cov_2.115741	128	193	0	65	65	1.0000000
NODE_149095_length_315_cov_2.004630	270	315	0	45	45	1.0000000
NODE_149201_length_315_cov_1.731481	125	202	0	77	77	1.0000000
NODE_149391_length_315_cov_1.384259	183	233	0	50	50	1.0000000
NODE_149935_length_315_cov_0.430556	125	145	0	20	20	1.0000000
NODE_149943_length_314_cov_108.139535	151	213	7	2	62	0.0322581
NODE_149943_length_314_cov_108.139535	151	213	8	12	62	0.1935484
NODE_149943_length_314_cov_108.139535	151	213	10	6	62	0.0967742
NODE_149943_length_314_cov_108.139535	151	213	11	8	62	0.1290323
NODE_149943_length_314_cov_108.139535	151	213	12	1	62	0.0161290
NODE_149943_length_314_cov_108.139535	151	213	13	1	62	0.0161290
NODE_149943_length_314_cov_108.139535	151	213	14	32	62	0.5161290
NODE_149943_length_314_cov_108.139535	160	213	8	5	53	0.0943396
NODE_149943_length_314_cov_108.139535	160	213	10	6	53	0.1132075
NODE_149943_length_314_cov_108.139535	160	213	11	8	53	0.1509434
NODE_149943_length_314_cov_108.139535	160	213	12	1	53	0.0188679
NODE_149943_length_314_cov_108.139535	160	213	13	1	53	0.0188679
NODE_149943_length_314_cov_108.139535	160	213	14	32	53	0.6037736
NODE_149944_length_314_cov_48.134884	245	314	0	23	69	0.3333333
NODE_149944_length_314_cov_48.134884	245	314	5	46	69	0.6666667
NODE_149946_length_314_cov_9.097674	149	206	0	34	57	0.5964912
NODE_149946_length_314_cov_9.097674	149	206	5	23	57	0.4035088
NODE_149967_length_314_cov_4.897674	109	189	0	80	80	1.0000000
NODE_150004_length_314_cov_3.823256	119	199	0	80	80	1.0000000
NODE_150020_length_314_cov_3.558140	32	92	0	60	60	1.0000000
NODE_150035_length_314_cov_3.316279	84	126	0	42	42	1.0000000
NODE_150035_length_314_cov_3.316279	127	180	0	53	53	1.0000000
NODE_150035_length_314_cov_3.316279	128	148	0	20	20	1.0000000
NODE_150066_length_314_cov_3.032558	252	308	0	56	56	1.0000000
NODE_150141_length_314_cov_2.520930	0	61	0	61	61	1.0000000
NODE_150141_length_314_cov_2.520930	34	93	0	59	59	1.0000000
NODE_150153_length_314_cov_2.441860	48	84	0	36	36	1.0000000
NODE_150159_length_314_cov_2.395349	62	112	0	50	50	1.0000000
NODE_150200_length_314_cov_2.265116	7	53	0	46	46	1.0000000
NODE_150220_length_314_cov_2.144186	224	264	0	40	40	1.0000000
NODE_150257_length_314_cov_2.004651	68	148	0	80	80	1.0000000
NODE_150257_length_314_cov_2.004651	121	201	0	80	80	1.0000000
NODE_150385_length_314_cov_1.665116	204	242	0	38	38	1.0000000
NODE_150385_length_314_cov_1.665116	215	295	0	80	80	1.0000000
NODE_150647_length_314_cov_1.223256	7	87	0	80	80	1.0000000
NODE_150709_length_314_cov_1.167442	1	69	0	68	68	1.0000000
NODE_151193_length_313_cov_156.051402	177	254	0	4	77	0.0519481
NODE_151193_length_313_cov_156.051402	177	254	1	73	77	0.9480519
NODE_151193_length_313_cov_156.051402	177	254	0	4	77	0.0519481
NODE_151193_length_313_cov_156.051402	177	254	1	73	77	0.9480519
NODE_151214_length_313_cov_5.359813	135	196	0	61	61	1.0000000
NODE_151214_length_313_cov_5.359813	169	241	0	72	72	1.0000000
NODE_151230_length_313_cov_4.794393	126	206	0	80	80	1.0000000
NODE_151230_length_313_cov_4.794393	179	259	0	80	80	1.0000000
NODE_151232_length_313_cov_4.761682	104	162	0	58	58	1.0000000
NODE_151232_length_313_cov_4.761682	135	215	0	80	80	1.0000000
NODE_151277_length_313_cov_3.560748	106	186	0	80	80	1.0000000
NODE_151331_length_313_cov_2.953271	92	153	0	61	61	1.0000000
NODE_151364_length_313_cov_2.640187	110	182	2	72	72	1.0000000
NODE_151364_length_313_cov_2.640187	113	184	2	71	71	1.0000000
NODE_151409_length_313_cov_2.383178	58	137	0	79	79	1.0000000
NODE_151409_length_313_cov_2.383178	110	190	0	80	80	1.0000000
NODE_151474_length_313_cov_2.107477	153	221	1	68	68	1.0000000
NODE_151510_length_313_cov_1.934579	107	187	0	80	80	1.0000000
NODE_151510_length_313_cov_1.934579	160	240	0	80	80	1.0000000
NODE_151576_length_313_cov_1.780374	236	296	0	60	60	1.0000000
NODE_151623_length_313_cov_1.663551	58	135	0	77	77	1.0000000
NODE_151703_length_313_cov_1.439252	0	64	0	64	64	1.0000000
NODE_151703_length_313_cov_1.439252	37	82	0	45	45	1.0000000
NODE_151753_length_313_cov_1.429907	74	111	0	37	37	1.0000000
NODE_151753_length_313_cov_1.429907	109	172	0	63	63	1.0000000
NODE_151953_length_313_cov_1.172897	106	161	0	2	55	0.0363636
NODE_151953_length_313_cov_1.172897	106	161	1	44	55	0.8000000
NODE_151953_length_313_cov_1.172897	106	161	2	9	55	0.1636364
NODE_151953_length_313_cov_1.172897	149	214	0	55	65	0.8461539
NODE_151953_length_313_cov_1.172897	149	214	1	10	65	0.1538462
NODE_152525_length_312_cov_3.723005	178	238	2	60	60	1.0000000
NODE_152525_length_312_cov_3.723005	231	291	2	60	60	1.0000000
NODE_152609_length_312_cov_2.723005	34	96	0	62	62	1.0000000
NODE_152609_length_312_cov_2.723005	87	149	0	62	62	1.0000000
NODE_152680_length_312_cov_2.333333	6	70	0	64	64	1.0000000
NODE_152680_length_312_cov_2.333333	43	123	0	80	80	1.0000000
NODE_152686_length_312_cov_2.267606	176	208	0	32	32	1.0000000
NODE_152697_length_312_cov_2.234742	108	169	0	56	61	0.9180328
NODE_152697_length_312_cov_2.234742	108	169	1	5	61	0.0819672
NODE_152751_length_312_cov_2.014085	141	205	3	39	64	0.6093750
NODE_152751_length_312_cov_2.014085	141	205	6	25	64	0.3906250
NODE_152751_length_312_cov_2.014085	178	258	3	34	80	0.4250000
NODE_152751_length_312_cov_2.014085	178	258	6	46	80	0.5750000
NODE_152827_length_312_cov_1.835681	176	221	0	45	45	1.0000000
NODE_152827_length_312_cov_1.835681	194	269	0	75	75	1.0000000
NODE_153222_length_312_cov_1.173709	87	133	1	13	46	0.2826087
NODE_153222_length_312_cov_1.173709	87	133	2	33	46	0.7173913
NODE_153222_length_312_cov_1.173709	150	217	4	67	67	1.0000000
NODE_153532_length_312_cov_0.788732	49	110	0	61	61	1.0000000
NODE_153532_length_312_cov_0.788732	102	163	0	61	61	1.0000000
NODE_153708_length_311_cov_5.179245	155	235	3	8	80	0.1000000
NODE_153708_length_311_cov_5.179245	155	235	5	72	80	0.9000000
NODE_153721_length_311_cov_4.589623	133	200	0	67	67	1.0000000
NODE_153730_length_311_cov_4.358491	199	263	0	64	64	1.0000000
NODE_153743_length_311_cov_3.929245	91	127	2	36	36	1.0000000
NODE_153755_length_311_cov_3.825472	224	304	0	80	80	1.0000000
NODE_153773_length_311_cov_3.466981	106	186	0	80	80	1.0000000
NODE_153796_length_311_cov_3.188679	39	96	0	57	57	1.0000000
NODE_153846_length_311_cov_2.702830	144	193	0	49	49	1.0000000
NODE_153850_length_311_cov_2.665094	43	113	0	70	70	1.0000000
NODE_153859_length_311_cov_2.617925	206	284	0	78	78	1.0000000
NODE_153859_length_311_cov_2.617925	257	301	0	44	44	1.0000000
NODE_153913_length_311_cov_2.349057	177	204	0	27	27	1.0000000
NODE_153919_length_311_cov_2.325472	74	138	0	64	64	1.0000000
NODE_153947_length_311_cov_2.188679	21	92	0	71	71	1.0000000
NODE_154014_length_311_cov_1.924528	46	65	0	19	19	1.0000000
NODE_154056_length_311_cov_1.891509	122	180	0	58	58	1.0000000
NODE_154188_length_311_cov_1.594340	0	35	0	35	35	1.0000000
NODE_154190_length_311_cov_1.589623	96	151	0	55	55	1.0000000
NODE_154194_length_311_cov_1.570755	125	145	0	20	20	1.0000000
NODE_154957_length_311_cov_0.613208	136	216	0	80	80	1.0000000
NODE_154957_length_311_cov_0.613208	189	264	0	75	75	1.0000000
NODE_154996_length_310_cov_96.995261	211	249	1	38	38	1.0000000
NODE_155001_length_310_cov_7.767773	80	151	0	71	71	1.0000000
NODE_155001_length_310_cov_7.767773	134	189	0	55	55	1.0000000
NODE_155017_length_310_cov_5.914692	84	134	3	1	50	0.0200000
NODE_155017_length_310_cov_5.914692	84	134	4	49	50	0.9800000
NODE_155017_length_310_cov_5.914692	113	134	4	21	21	1.0000000
NODE_155017_length_310_cov_5.914692	113	188	3	23	75	0.3066667
NODE_155017_length_310_cov_5.914692	113	188	4	52	75	0.6933333
NODE_155066_length_310_cov_3.777251	146	226	0	80	80	1.0000000
NODE_155115_length_310_cov_3.180095	137	211	0	74	74	1.0000000
NODE_155179_length_310_cov_2.630332	122	174	1	52	52	1.0000000
NODE_155179_length_310_cov_2.630332	175	222	0	4	47	0.0851064
NODE_155179_length_310_cov_2.630332	175	222	1	43	47	0.9148936
NODE_155180_length_310_cov_2.625592	258	301	0	43	43	1.0000000
NODE_155195_length_310_cov_2.563981	149	196	0	26	47	0.5531915
NODE_155195_length_310_cov_2.563981	149	196	2	21	47	0.4468085
NODE_155195_length_310_cov_2.563981	169	249	0	79	80	0.9875000
NODE_155195_length_310_cov_2.563981	169	249	2	1	80	0.0125000
NODE_155261_length_310_cov_2.298578	213	259	0	46	46	1.0000000
NODE_155334_length_310_cov_2.009479	223	303	0	80	80	1.0000000
NODE_155439_length_310_cov_1.729858	53	91	0	38	38	1.0000000
NODE_155768_length_310_cov_1.222749	181	244	0	63	63	1.0000000
NODE_155864_length_310_cov_1.142180	65	135	0	70	70	1.0000000
NODE_155937_length_310_cov_0.966825	131	212	0	81	81	1.0000000
NODE_155937_length_310_cov_0.966825	193	256	0	63	63	1.0000000
NODE_156078_length_310_cov_0.924171	180	222	0	42	42	1.0000000
NODE_156174_length_310_cov_0.739336	208	288	0	80	80	1.0000000
NODE_156332_length_309_cov_8.552381	154	234	0	80	80	1.0000000
NODE_156340_length_309_cov_6.147619	20	83	0	63	63	1.0000000
NODE_156349_length_309_cov_5.147619	213	291	0	78	78	1.0000000
NODE_156364_length_309_cov_4.585714	15	95	0	80	80	1.0000000
NODE_156472_length_309_cov_3.028571	0	47	0	47	47	1.0000000
NODE_156472_length_309_cov_3.028571	20	101	0	81	81	1.0000000
NODE_156563_length_309_cov_2.304762	179	218	0	39	39	1.0000000
NODE_156615_length_309_cov_2.095238	55	85	0	30	30	1.0000000
NODE_156678_length_309_cov_1.938095	2	73	0	71	71	1.0000000
NODE_156950_length_309_cov_1.414286	189	231	0	42	42	1.0000000
NODE_156978_length_309_cov_1.376190	94	168	0	74	74	1.0000000
NODE_157334_length_309_cov_0.966667	134	153	0	19	19	1.0000000
NODE_157469_length_309_cov_0.738095	150	215	0	65	65	1.0000000
NODE_157661_length_308_cov_4.775120	137	174	0	37	37	1.0000000
NODE_157690_length_308_cov_3.966507	126	206	0	80	80	1.0000000
NODE_157705_length_308_cov_3.665072	11	75	0	64	64	1.0000000
NODE_157819_length_308_cov_2.593301	137	193	0	56	56	1.0000000
NODE_157852_length_308_cov_2.435407	14	58	0	44	44	1.0000000
NODE_157852_length_308_cov_2.435407	31	111	0	80	80	1.0000000
NODE_157898_length_308_cov_2.191388	14	80	0	66	66	1.0000000
NODE_157903_length_308_cov_2.191388	236	296	0	60	60	1.0000000
NODE_157969_length_308_cov_1.952153	251	296	0	45	45	1.0000000
NODE_158083_length_308_cov_1.708134	102	148	2	46	46	1.0000000
NODE_158276_length_308_cov_1.435407	196	276	0	80	80	1.0000000
NODE_158439_length_308_cov_1.162679	260	300	0	40	40	1.0000000
NODE_158439_length_308_cov_1.162679	273	307	0	34	34	1.0000000
NODE_158447_length_308_cov_1.148325	35	83	0	48	48	1.0000000
NODE_158448_length_308_cov_1.148325	253	308	0	55	55	1.0000000
NODE_158510_length_308_cov_1.038278	147	202	0	55	55	1.0000000
NODE_158811_length_308_cov_0.684211	196	275	0	79	79	1.0000000
NODE_158821_length_308_cov_0.660287	109	157	0	48	48	1.0000000
NODE_158821_length_308_cov_0.660287	130	210	0	80	80	1.0000000
NODE_158905_length_307_cov_30.725962	0	73	0	73	73	1.0000000
NODE_158905_length_307_cov_30.725962	46	99	0	53	53	1.0000000
NODE_158906_length_307_cov_25.096154	84	164	5	7	80	0.0875000
NODE_158906_length_307_cov_25.096154	84	164	6	7	80	0.0875000
NODE_158906_length_307_cov_25.096154	84	164	7	5	80	0.0625000
NODE_158906_length_307_cov_25.096154	84	164	8	29	80	0.3625000
NODE_158906_length_307_cov_25.096154	84	164	9	10	80	0.1250000
NODE_158906_length_307_cov_25.096154	84	164	10	22	80	0.2750000
NODE_158906_length_307_cov_25.096154	137	217	6	6	80	0.0750000
NODE_158906_length_307_cov_25.096154	137	217	7	25	80	0.3125000
NODE_158906_length_307_cov_25.096154	137	217	8	6	80	0.0750000
NODE_158906_length_307_cov_25.096154	137	217	9	21	80	0.2625000
NODE_158906_length_307_cov_25.096154	137	217	10	22	80	0.2750000
NODE_158933_length_307_cov_5.524038	150	221	0	71	71	1.0000000
NODE_158983_length_307_cov_3.730769	172	252	0	80	80	1.0000000
NODE_158983_length_307_cov_3.730769	225	305	0	80	80	1.0000000
NODE_158999_length_307_cov_3.322115	20	100	0	80	80	1.0000000
NODE_158999_length_307_cov_3.322115	78	153	0	75	75	1.0000000
NODE_159000_length_307_cov_3.317308	12	94	0	82	82	1.0000000
NODE_159000_length_307_cov_3.317308	76	134	0	58	58	1.0000000
NODE_159053_length_307_cov_2.870192	43	108	0	65	65	1.0000000
NODE_159084_length_307_cov_2.653846	117	177	1	12	60	0.2000000
NODE_159084_length_307_cov_2.653846	117	177	2	48	60	0.8000000
NODE_159142_length_307_cov_2.346154	54	105	2	16	51	0.3137255
NODE_159142_length_307_cov_2.346154	54	105	3	1	51	0.0196078
NODE_159142_length_307_cov_2.346154	54	105	4	34	51	0.6666667
NODE_159351_length_307_cov_1.716346	124	165	0	41	41	1.0000000
NODE_159362_length_307_cov_1.716346	30	93	0	63	63	1.0000000
NODE_159407_length_307_cov_1.600962	221	269	0	48	48	1.0000000
NODE_159407_length_307_cov_1.600962	242	307	0	65	65	1.0000000
NODE_159447_length_307_cov_1.475962	252	307	0	55	55	1.0000000
NODE_159585_length_307_cov_1.326923	96	142	0	46	46	1.0000000
NODE_159585_length_307_cov_1.326923	115	195	0	80	80	1.0000000
NODE_159618_length_307_cov_1.264423	13	61	0	48	48	1.0000000
NODE_159618_length_307_cov_1.264423	23	54	0	31	31	1.0000000
NODE_159696_length_307_cov_1.197115	92	121	0	29	29	1.0000000
NODE_159787_length_307_cov_1.000000	132	168	0	36	36	1.0000000
NODE_160213_length_306_cov_74.526570	68	136	1	1	68	0.0147059
NODE_160213_length_306_cov_74.526570	68	136	2	13	68	0.1911765
NODE_160213_length_306_cov_74.526570	68	136	3	30	68	0.4411765
NODE_160213_length_306_cov_74.526570	68	136	4	3	68	0.0441176
NODE_160213_length_306_cov_74.526570	68	136	5	11	68	0.1617647
NODE_160213_length_306_cov_74.526570	68	136	6	8	68	0.1176471
NODE_160213_length_306_cov_74.526570	68	136	9	2	68	0.0294118
NODE_160213_length_306_cov_74.526570	68	148	1	1	80	0.0125000
NODE_160213_length_306_cov_74.526570	68	148	2	13	80	0.1625000
NODE_160213_length_306_cov_74.526570	68	148	3	30	80	0.3750000
NODE_160213_length_306_cov_74.526570	68	148	4	3	80	0.0375000
NODE_160213_length_306_cov_74.526570	68	148	5	11	80	0.1375000
NODE_160213_length_306_cov_74.526570	68	148	6	8	80	0.1000000
NODE_160213_length_306_cov_74.526570	68	148	9	14	80	0.1750000
NODE_160213_length_306_cov_74.526570	121	201	5	5	80	0.0625000
NODE_160213_length_306_cov_74.526570	121	201	6	8	80	0.1000000
NODE_160213_length_306_cov_74.526570	121	201	9	38	80	0.4750000
NODE_160213_length_306_cov_74.526570	121	201	11	29	80	0.3625000
NODE_160213_length_306_cov_74.526570	121	201	5	5	80	0.0625000
NODE_160213_length_306_cov_74.526570	121	201	6	8	80	0.1000000
NODE_160213_length_306_cov_74.526570	121	201	9	38	80	0.4750000
NODE_160213_length_306_cov_74.526570	121	201	11	29	80	0.3625000
NODE_160213_length_306_cov_74.526570	197	277	5	1	80	0.0125000
NODE_160213_length_306_cov_74.526570	197	277	6	11	80	0.1375000
NODE_160213_length_306_cov_74.526570	197	277	7	3	80	0.0375000
NODE_160213_length_306_cov_74.526570	197	277	8	30	80	0.3750000
NODE_160213_length_306_cov_74.526570	197	277	9	13	80	0.1625000
NODE_160213_length_306_cov_74.526570	197	277	10	1	80	0.0125000
NODE_160213_length_306_cov_74.526570	197	277	11	21	80	0.2625000
NODE_160213_length_306_cov_74.526570	197	277	5	1	80	0.0125000
NODE_160213_length_306_cov_74.526570	197	277	6	11	80	0.1375000
NODE_160213_length_306_cov_74.526570	197	277	7	3	80	0.0375000
NODE_160213_length_306_cov_74.526570	197	277	8	30	80	0.3750000
NODE_160213_length_306_cov_74.526570	197	277	9	13	80	0.1625000
NODE_160213_length_306_cov_74.526570	197	277	10	1	80	0.0125000
NODE_160213_length_306_cov_74.526570	197	277	11	21	80	0.2625000
NODE_160213_length_306_cov_74.526570	197	277	5	1	80	0.0125000
NODE_160213_length_306_cov_74.526570	197	277	6	11	80	0.1375000
NODE_160213_length_306_cov_74.526570	197	277	7	3	80	0.0375000
NODE_160213_length_306_cov_74.526570	197	277	8	30	80	0.3750000
NODE_160213_length_306_cov_74.526570	197	277	9	13	80	0.1625000
NODE_160213_length_306_cov_74.526570	197	277	10	1	80	0.0125000
NODE_160213_length_306_cov_74.526570	197	277	11	21	80	0.2625000
NODE_160213_length_306_cov_74.526570	250	299	2	15	49	0.3061225
NODE_160213_length_306_cov_74.526570	250	299	5	8	49	0.1632653
NODE_160213_length_306_cov_74.526570	250	299	6	11	49	0.2244898
NODE_160213_length_306_cov_74.526570	250	299	7	3	49	0.0612245
NODE_160213_length_306_cov_74.526570	250	299	8	12	49	0.2448980
NODE_160213_length_306_cov_74.526570	250	306	2	22	56	0.3928571
NODE_160213_length_306_cov_74.526570	250	306	5	8	56	0.1428571
NODE_160213_length_306_cov_74.526570	250	306	6	11	56	0.1964286
NODE_160213_length_306_cov_74.526570	250	306	7	3	56	0.0535714
NODE_160213_length_306_cov_74.526570	250	306	8	12	56	0.2142857
NODE_160213_length_306_cov_74.526570	255	306	2	22	51	0.4313726
NODE_160213_length_306_cov_74.526570	255	306	5	8	51	0.1568628
NODE_160213_length_306_cov_74.526570	255	306	6	11	51	0.2156863
NODE_160213_length_306_cov_74.526570	255	306	7	3	51	0.0588235
NODE_160213_length_306_cov_74.526570	255	306	8	7	51	0.1372549
NODE_160217_length_306_cov_7.396135	23	117	0	94	94	1.0000000
NODE_160217_length_306_cov_7.396135	90	170	0	80	80	1.0000000
NODE_160261_length_306_cov_4.275362	67	147	0	80	80	1.0000000
NODE_160275_length_306_cov_3.937198	104	176	0	72	72	1.0000000
NODE_160300_length_306_cov_3.444444	130	206	0	76	76	1.0000000
NODE_160323_length_306_cov_3.217391	198	278	0	3	80	0.0375000
NODE_160323_length_306_cov_3.217391	198	278	1	77	80	0.9625000
NODE_160333_length_306_cov_3.043478	90	171	2	81	81	1.0000000
NODE_160333_length_306_cov_3.043478	144	202	1	7	58	0.1206897
NODE_160333_length_306_cov_3.043478	144	202	2	51	58	0.8793104
NODE_160340_length_306_cov_2.956522	242	273	0	31	31	1.0000000
NODE_160355_length_306_cov_2.884058	173	243	2	70	70	1.0000000
NODE_160403_length_306_cov_2.574879	122	203	0	81	81	1.0000000
NODE_160403_length_306_cov_2.574879	176	254	0	78	78	1.0000000
NODE_160475_length_306_cov_2.265700	223	278	1	3	55	0.0545455
NODE_160475_length_306_cov_2.265700	223	278	12	52	55	0.9454545
NODE_160512_length_306_cov_2.106280	73	149	1	76	76	1.0000000
NODE_160512_length_306_cov_2.106280	125	205	1	56	80	0.7000000
NODE_160512_length_306_cov_2.106280	125	205	2	24	80	0.3000000
NODE_160608_length_306_cov_1.879227	165	196	0	31	31	1.0000000
NODE_160752_length_306_cov_1.478261	206	237	0	31	31	1.0000000
NODE_160761_length_306_cov_1.478261	157	220	0	63	63	1.0000000
NODE_160833_length_306_cov_1.434783	40	88	0	48	48	1.0000000
NODE_160875_length_306_cov_1.357488	128	171	0	43	43	1.0000000
NODE_160992_length_306_cov_1.222222	216	252	2	36	36	1.0000000
NODE_160992_length_306_cov_1.222222	230	305	0	16	75	0.2133333
NODE_160992_length_306_cov_1.222222	230	305	2	59	75	0.7866667
NODE_161018_length_306_cov_1.188406	79	159	0	5	80	0.0625000
NODE_161018_length_306_cov_1.188406	79	159	1	75	80	0.9375000
NODE_161042_length_306_cov_1.130435	122	202	0	80	80	1.0000000
NODE_161042_length_306_cov_1.130435	175	255	0	80	80	1.0000000
NODE_161078_length_306_cov_1.067633	156	188	0	32	32	1.0000000
NODE_161234_length_306_cov_0.975845	219	247	0	28	28	1.0000000
NODE_161246_length_306_cov_0.956522	206	284	0	78	78	1.0000000
NODE_161550_length_305_cov_5.718447	177	243	0	66	66	1.0000000
NODE_161566_length_305_cov_4.854369	55	135	0	80	80	1.0000000
NODE_161584_length_305_cov_4.266990	186	266	0	59	80	0.7375000
NODE_161584_length_305_cov_4.266990	186	266	1	10	80	0.1250000
NODE_161584_length_305_cov_4.266990	186	266	2	11	80	0.1375000
NODE_161723_length_305_cov_2.616505	220	263	0	43	43	1.0000000
NODE_161723_length_305_cov_2.616505	236	305	0	69	69	1.0000000
NODE_161726_length_305_cov_2.597087	171	256	1	13	85	0.1529412
NODE_161726_length_305_cov_2.597087	171	256	2	72	85	0.8470588
NODE_161732_length_305_cov_2.533981	3	57	0	54	54	1.0000000
NODE_161775_length_305_cov_2.339806	149	237	3	10	88	0.1136364
NODE_161775_length_305_cov_2.339806	149	237	4	61	88	0.6931818
NODE_161775_length_305_cov_2.339806	149	237	5	17	88	0.1931818
NODE_161795_length_305_cov_2.228155	194	274	0	80	80	1.0000000
NODE_161795_length_305_cov_2.228155	247	300	0	53	53	1.0000000
NODE_161877_length_305_cov_1.975728	44	116	0	72	72	1.0000000
NODE_161908_length_305_cov_1.883495	135	172	1	12	37	0.3243243
NODE_161908_length_305_cov_1.883495	135	172	2	25	37	0.6756757
NODE_161990_length_305_cov_1.674757	14	80	0	66	66	1.0000000
NODE_161990_length_305_cov_1.674757	53	133	0	48	80	0.6000000
NODE_161990_length_305_cov_1.674757	53	133	1	32	80	0.4000000
NODE_161996_length_305_cov_1.655340	110	179	0	69	69	1.0000000
NODE_162123_length_305_cov_1.466019	153	238	0	85	85	1.0000000
NODE_162123_length_305_cov_1.466019	222	284	0	62	62	1.0000000
NODE_162169_length_305_cov_1.398058	28	75	0	47	47	1.0000000
NODE_162198_length_305_cov_1.330097	212	292	0	80	80	1.0000000
NODE_162198_length_305_cov_1.330097	265	305	0	40	40	1.0000000
NODE_162359_length_305_cov_1.111650	245	275	0	30	30	1.0000000
NODE_162411_length_305_cov_0.990291	46	126	0	80	80	1.0000000
NODE_162593_length_305_cov_0.873786	73	109	0	36	36	1.0000000
NODE_162782_length_305_cov_0.631068	86	166	0	80	80	1.0000000
NODE_162782_length_305_cov_0.631068	139	186	0	47	47	1.0000000
NODE_162854_length_304_cov_44.482927	61	102	3	20	41	0.4878049
NODE_162854_length_304_cov_44.482927	61	102	4	21	41	0.5121951
NODE_162855_length_304_cov_30.678049	205	281	0	76	76	1.0000000
NODE_162855_length_304_cov_30.678049	254	304	0	50	50	1.0000000
NODE_162886_length_304_cov_4.956098	72	152	0	80	80	1.0000000
NODE_162919_length_304_cov_3.980488	46	126	0	80	80	1.0000000
NODE_162919_length_304_cov_3.980488	99	179	0	80	80	1.0000000
NODE_162932_length_304_cov_3.809756	108	156	2	48	48	1.0000000
NODE_162955_length_304_cov_3.424390	67	129	0	2	62	0.0322581
NODE_162955_length_304_cov_3.424390	67	129	1	22	62	0.3548387
NODE_162955_length_304_cov_3.424390	67	129	2	38	62	0.6129032
NODE_162955_length_304_cov_3.424390	120	182	2	62	62	1.0000000
NODE_162997_length_304_cov_2.980488	105	126	0	21	21	1.0000000
NODE_163048_length_304_cov_2.629268	106	186	3	10	80	0.1250000
NODE_163048_length_304_cov_2.629268	106	186	4	26	80	0.3250000
NODE_163048_length_304_cov_2.629268	106	186	5	2	80	0.0250000
NODE_163048_length_304_cov_2.629268	106	186	6	33	80	0.4125000
NODE_163048_length_304_cov_2.629268	106	186	7	9	80	0.1125000
NODE_163048_length_304_cov_2.629268	159	209	3	33	50	0.6600000
NODE_163048_length_304_cov_2.629268	159	209	4	17	50	0.3400000
NODE_163116_length_304_cov_2.239024	57	137	0	80	80	1.0000000
NODE_163116_length_304_cov_2.239024	110	152	0	42	42	1.0000000
NODE_163148_length_304_cov_2.170732	112	145	0	33	33	1.0000000
NODE_163148_length_304_cov_2.170732	146	198	0	52	52	1.0000000
NODE_163333_length_304_cov_1.687805	219	288	0	69	69	1.0000000
NODE_163432_length_304_cov_1.492683	190	238	0	48	48	1.0000000
NODE_163559_length_304_cov_1.287805	99	165	0	19	66	0.2878788
NODE_163559_length_304_cov_1.287805	99	165	1	47	66	0.7121212
NODE_163670_length_304_cov_1.175610	0	30	0	30	30	1.0000000
NODE_163895_length_304_cov_0.951220	70	150	0	80	80	1.0000000
NODE_164171_length_303_cov_30.843137	46	97	0	51	51	1.0000000
NODE_164194_length_303_cov_5.401961	33	79	0	46	46	1.0000000
NODE_164224_length_303_cov_4.210784	136	205	0	69	69	1.0000000
NODE_164224_length_303_cov_4.210784	178	259	0	81	81	1.0000000
NODE_164251_length_303_cov_3.671569	9	75	0	66	66	1.0000000
NODE_164251_length_303_cov_3.671569	48	128	0	80	80	1.0000000
NODE_164251_length_303_cov_3.671569	48	128	0	80	80	1.0000000
NODE_164251_length_303_cov_3.671569	220	300	0	80	80	1.0000000
NODE_164267_length_303_cov_3.500000	55	123	0	68	68	1.0000000
NODE_164272_length_303_cov_3.460784	0	67	0	52	67	0.7761194
NODE_164272_length_303_cov_3.460784	0	67	2	2	67	0.0298507
NODE_164272_length_303_cov_3.460784	0	67	3	12	67	0.1791045
NODE_164272_length_303_cov_3.460784	0	67	5	1	67	0.0149254
NODE_164272_length_303_cov_3.460784	98	178	8	3	80	0.0375000
NODE_164272_length_303_cov_3.460784	98	178	9	10	80	0.1250000
NODE_164272_length_303_cov_3.460784	98	178	11	1	80	0.0125000
NODE_164272_length_303_cov_3.460784	98	178	13	8	80	0.1000000
NODE_164272_length_303_cov_3.460784	98	178	14	17	80	0.2125000
NODE_164272_length_303_cov_3.460784	98	178	17	1	80	0.0125000
NODE_164272_length_303_cov_3.460784	98	178	18	39	80	0.4875000
NODE_164272_length_303_cov_3.460784	98	178	20	1	80	0.0125000
NODE_164272_length_303_cov_3.460784	151	191	18	39	40	0.9750000
NODE_164272_length_303_cov_3.460784	151	191	20	1	40	0.0250000
NODE_164283_length_303_cov_3.352941	77	146	0	69	69	1.0000000
NODE_164433_length_303_cov_2.284314	78	158	0	80	80	1.0000000
NODE_164433_length_303_cov_2.284314	215	295	0	80	80	1.0000000
NODE_164581_length_303_cov_1.848039	90	170	0	80	80	1.0000000
NODE_164581_length_303_cov_1.848039	143	223	0	80	80	1.0000000
NODE_164581_length_303_cov_1.848039	212	235	0	23	23	1.0000000
NODE_164668_length_303_cov_1.686275	62	88	0	26	26	1.0000000
NODE_164695_length_303_cov_1.583333	206	270	0	64	64	1.0000000
NODE_164800_length_303_cov_1.475490	155	221	0	66	66	1.0000000
NODE_164846_length_303_cov_1.392157	135	213	0	78	78	1.0000000
NODE_164878_length_303_cov_1.318627	0	75	0	75	75	1.0000000
NODE_164974_length_303_cov_1.215686	278	297	0	19	19	1.0000000
NODE_165498_length_302_cov_10.852217	266	300	0	34	34	1.0000000
NODE_165502_length_302_cov_7.896552	46	131	0	85	85	1.0000000
NODE_165502_length_302_cov_7.896552	104	160	0	56	56	1.0000000
NODE_165505_length_302_cov_7.266010	135	191	0	56	56	1.0000000
NODE_165507_length_302_cov_7.216749	93	149	0	56	56	1.0000000
NODE_165507_length_302_cov_7.216749	155	226	0	71	71	1.0000000
NODE_165517_length_302_cov_6.172414	179	243	0	64	64	1.0000000
NODE_165517_length_302_cov_6.172414	232	287	0	55	55	1.0000000
NODE_165528_length_302_cov_5.586207	221	293	0	72	72	1.0000000
NODE_165641_length_302_cov_2.985222	104	186	0	82	82	1.0000000
NODE_165848_length_302_cov_2.009852	12	34	0	22	22	1.0000000
NODE_165934_length_302_cov_1.758621	98	152	2	54	54	1.0000000
NODE_165945_length_302_cov_1.758621	230	294	0	64	64	1.0000000
NODE_166007_length_302_cov_1.620690	172	232	0	60	60	1.0000000
NODE_166007_length_302_cov_1.620690	225	277	0	52	52	1.0000000
NODE_166320_length_302_cov_1.172414	34	103	0	69	69	1.0000000
NODE_166381_length_302_cov_1.044335	54	130	0	76	76	1.0000000
NODE_166617_length_302_cov_0.847291	94	172	12	21	78	0.2692308
NODE_166617_length_302_cov_0.847291	94	172	17	1	78	0.0128205
NODE_166617_length_302_cov_0.847291	94	172	22	56	78	0.7179487
NODE_166617_length_302_cov_0.847291	94	172	12	21	78	0.2692308
NODE_166617_length_302_cov_0.847291	94	172	17	1	78	0.0128205
NODE_166617_length_302_cov_0.847291	94	172	22	56	78	0.7179487
NODE_166617_length_302_cov_0.847291	103	172	12	21	69	0.3043478
NODE_166617_length_302_cov_0.847291	103	172	17	1	69	0.0144928
NODE_166617_length_302_cov_0.847291	103	172	22	47	69	0.6811594
NODE_166638_length_302_cov_0.807882	97	177	0	80	80	1.0000000
NODE_166819_length_301_cov_6.960396	268	299	0	15	31	0.4838710
NODE_166819_length_301_cov_6.960396	268	299	1	16	31	0.5161290
NODE_166827_length_301_cov_6.148515	214	283	0	69	69	1.0000000
NODE_166889_length_301_cov_3.747525	116	196	0	80	80	1.0000000
NODE_166904_length_301_cov_3.509901	217	277	0	10	60	0.1666667
NODE_166904_length_301_cov_3.509901	217	277	2	50	60	0.8333333
NODE_166993_length_301_cov_2.653465	133	213	0	8	80	0.1000000
NODE_166993_length_301_cov_2.653465	133	213	1	51	80	0.6375000
NODE_166993_length_301_cov_2.653465	133	213	2	21	80	0.2625000
NODE_167126_length_301_cov_2.084158	178	258	0	80	80	1.0000000
NODE_167215_length_301_cov_1.831683	111	175	0	64	64	1.0000000
NODE_167215_length_301_cov_1.831683	164	228	0	64	64	1.0000000
NODE_167308_length_301_cov_1.603960	173	233	0	60	60	1.0000000
NODE_167313_length_301_cov_1.584158	30	108	0	78	78	1.0000000
NODE_167434_length_301_cov_1.470297	90	165	0	75	75	1.0000000
NODE_167508_length_301_cov_1.326733	175	247	0	72	72	1.0000000
NODE_167612_length_301_cov_1.247525	29	73	0	44	44	1.0000000
NODE_167642_length_301_cov_1.183168	123	203	0	75	80	0.9375000
NODE_167642_length_301_cov_1.183168	123	203	2	5	80	0.0625000
NODE_167659_length_301_cov_1.163366	10	83	0	73	73	1.0000000
NODE_167659_length_301_cov_1.163366	91	121	0	30	30	1.0000000
NODE_167668_length_301_cov_1.148515	161	209	0	48	48	1.0000000
NODE_167880_length_301_cov_0.980198	242	297	0	55	55	1.0000000
NODE_167891_length_301_cov_0.960396	22	63	0	41	41	1.0000000
NODE_168253_length_300_cov_3.402985	44	124	0	80	80	1.0000000
NODE_168253_length_300_cov_3.402985	97	177	0	80	80	1.0000000
NODE_168253_length_300_cov_3.402985	173	254	0	81	81	1.0000000
NODE_168253_length_300_cov_3.402985	233	300	0	67	67	1.0000000
NODE_168265_length_300_cov_3.298507	18	98	0	80	80	1.0000000
NODE_168360_length_300_cov_2.597015	110	182	0	72	72	1.0000000
NODE_168363_length_300_cov_2.572139	28	102	0	74	74	1.0000000
NODE_168363_length_300_cov_2.572139	75	141	0	66	66	1.0000000
NODE_168402_length_300_cov_2.417910	0	44	0	44	44	1.0000000
NODE_168459_length_300_cov_2.174129	117	197	0	80	80	1.0000000
NODE_168459_length_300_cov_2.174129	170	250	0	80	80	1.0000000
NODE_168459_length_300_cov_2.174129	216	296	0	80	80	1.0000000
NODE_168462_length_300_cov_2.164179	122	141	0	19	19	1.0000000
NODE_168479_length_300_cov_2.079602	127	207	0	80	80	1.0000000
NODE_168479_length_300_cov_2.079602	203	273	0	70	70	1.0000000
NODE_168541_length_300_cov_1.965174	15	86	0	71	71	1.0000000
NODE_168656_length_300_cov_1.731343	31	88	0	57	57	1.0000000
NODE_168906_length_300_cov_1.268657	62	98	0	36	36	1.0000000
NODE_168906_length_300_cov_1.268657	151	186	0	35	35	1.0000000
NODE_169014_length_300_cov_1.104478	86	165	0	79	79	1.0000000
NODE_169053_length_300_cov_1.029851	110	177	0	67	67	1.0000000
NODE_169053_length_300_cov_1.029851	120	177	0	57	57	1.0000000
NODE_169378_length_300_cov_0.716418	191	210	0	19	19	1.0000000
NODE_169528_length_299_cov_4.435000	48	128	0	80	80	1.0000000
NODE_169528_length_299_cov_4.435000	101	167	0	66	66	1.0000000
NODE_169567_length_299_cov_3.780000	114	181	0	67	67	1.0000000
NODE_169631_length_299_cov_3.095000	0	73	0	73	73	1.0000000
NODE_169631_length_299_cov_3.095000	0	20	0	20	20	1.0000000
NODE_169725_length_299_cov_2.495000	46	126	0	80	80	1.0000000
NODE_169725_length_299_cov_2.495000	99	179	0	80	80	1.0000000
NODE_169769_length_299_cov_2.275000	127	192	0	65	65	1.0000000
NODE_169781_length_299_cov_2.250000	72	135	0	63	63	1.0000000
NODE_169781_length_299_cov_2.250000	108	188	0	80	80	1.0000000
NODE_169811_length_299_cov_2.090000	25	105	0	80	80	1.0000000
NODE_169888_length_299_cov_1.955000	173	214	0	41	41	1.0000000
NODE_169888_length_299_cov_1.955000	187	227	0	40	40	1.0000000
NODE_169916_length_299_cov_1.885000	29	109	0	80	80	1.0000000
NODE_169920_length_299_cov_1.880000	204	236	0	32	32	1.0000000
NODE_169938_length_299_cov_1.840000	154	190	0	36	36	1.0000000
NODE_169995_length_299_cov_1.710000	211	291	0	80	80	1.0000000
NODE_170048_length_299_cov_1.550000	174	205	0	31	31	1.0000000
NODE_170501_length_299_cov_1.020000	42	115	0	73	73	1.0000000
NODE_170546_length_299_cov_1.020000	132	175	2	43	43	1.0000000
NODE_170620_length_299_cov_0.935000	173	216	0	43	43	1.0000000
NODE_170691_length_299_cov_0.765000	86	128	0	42	42	1.0000000
NODE_170887_length_298_cov_20.894472	70	150	6	80	80	1.0000000
NODE_170887_length_298_cov_20.894472	123	203	3	11	80	0.1375000
NODE_170887_length_298_cov_20.894472	123	203	4	17	80	0.2125000
NODE_170887_length_298_cov_20.894472	123	203	5	17	80	0.2125000
NODE_170887_length_298_cov_20.894472	123	203	6	35	80	0.4375000
NODE_170888_length_298_cov_13.859296	228	298	0	25	70	0.3571429
NODE_170888_length_298_cov_13.859296	228	298	2	45	70	0.6428571
NODE_170909_length_298_cov_5.859296	1	65	0	27	64	0.4218750
NODE_170909_length_298_cov_5.859296	1	65	1	37	64	0.5781250
NODE_170909_length_298_cov_5.859296	38	118	1	80	80	1.0000000
NODE_170909_length_298_cov_5.859296	114	194	0	16	80	0.2000000
NODE_170909_length_298_cov_5.859296	114	194	1	64	80	0.8000000
NODE_170909_length_298_cov_5.859296	167	238	0	60	71	0.8450704
NODE_170909_length_298_cov_5.859296	167	238	1	11	71	0.1549296
NODE_170964_length_298_cov_3.829146	80	160	2	80	80	1.0000000
NODE_170964_length_298_cov_3.829146	133	213	2	66	80	0.8250000
NODE_170964_length_298_cov_3.829146	133	213	3	12	80	0.1500000
NODE_170964_length_298_cov_3.829146	133	213	4	2	80	0.0250000
NODE_170968_length_298_cov_3.733668	203	283	0	80	80	1.0000000
NODE_170972_length_298_cov_3.673367	117	175	0	58	58	1.0000000
NODE_171043_length_298_cov_2.924623	159	239	0	80	80	1.0000000
NODE_171043_length_298_cov_2.924623	212	265	0	53	53	1.0000000
NODE_171047_length_298_cov_2.854271	50	120	0	70	70	1.0000000
NODE_171082_length_298_cov_2.663317	87	167	0	80	80	1.0000000
NODE_171082_length_298_cov_2.663317	140	192	0	52	52	1.0000000
NODE_171191_length_298_cov_2.201005	112	166	0	54	54	1.0000000
NODE_171210_length_298_cov_2.120603	135	166	0	31	31	1.0000000
NODE_171226_length_298_cov_2.055276	69	132	0	63	63	1.0000000
NODE_171286_length_298_cov_2.025126	21	92	0	71	71	1.0000000
NODE_171356_length_298_cov_1.798995	0	67	0	66	67	0.9850746
NODE_171356_length_298_cov_1.798995	0	67	2	1	67	0.0149254
NODE_171356_length_298_cov_1.798995	40	106	0	26	66	0.3939394
NODE_171356_length_298_cov_1.798995	40	106	2	40	66	0.6060606
NODE_171391_length_298_cov_1.788945	140	197	0	57	57	1.0000000
NODE_171415_length_298_cov_1.733668	56	91	0	35	35	1.0000000
NODE_171415_length_298_cov_1.733668	118	172	0	54	54	1.0000000
NODE_171505_length_298_cov_1.537688	101	154	0	53	53	1.0000000
NODE_172083_length_298_cov_0.829146	34	96	0	62	62	1.0000000
NODE_172330_length_297_cov_6.525253	100	122	0	22	22	1.0000000
NODE_172352_length_297_cov_4.888889	150	218	0	68	68	1.0000000
NODE_172356_length_297_cov_4.671717	56	120	0	64	64	1.0000000
NODE_172422_length_297_cov_3.338384	96	176	0	80	80	1.0000000
NODE_172422_length_297_cov_3.338384	149	198	0	49	49	1.0000000
NODE_172447_length_297_cov_3.040404	0	55	0	55	55	1.0000000
NODE_172447_length_297_cov_3.040404	14	55	0	41	41	1.0000000
NODE_172447_length_297_cov_3.040404	65	119	0	54	54	1.0000000
NODE_172574_length_297_cov_2.308081	8	70	0	62	62	1.0000000
NODE_172606_length_297_cov_2.196970	219	259	2	40	40	1.0000000
NODE_172629_length_297_cov_2.106061	81	161	0	80	80	1.0000000
NODE_172629_length_297_cov_2.106061	134	178	0	44	44	1.0000000
NODE_172668_length_297_cov_2.060606	46	76	0	30	30	1.0000000
NODE_172697_length_297_cov_2.010101	9	85	0	76	76	1.0000000
NODE_172783_length_297_cov_1.777778	168	208	0	40	40	1.0000000
NODE_172855_length_297_cov_1.595960	175	255	0	26	80	0.3250000
NODE_172855_length_297_cov_1.595960	175	255	1	17	80	0.2125000
NODE_172855_length_297_cov_1.595960	175	255	2	18	80	0.2250000
NODE_172855_length_297_cov_1.595960	175	255	3	19	80	0.2375000
NODE_172862_length_297_cov_1.570707	100	177	0	77	77	1.0000000
NODE_172863_length_297_cov_1.570707	194	275	0	81	81	1.0000000
NODE_173063_length_297_cov_1.338384	140	199	0	59	59	1.0000000
NODE_173136_length_297_cov_1.277778	39	115	0	76	76	1.0000000
NODE_173176_length_297_cov_1.196970	7	87	0	80	80	1.0000000
NODE_173176_length_297_cov_1.196970	60	116	0	56	56	1.0000000
NODE_173345_length_297_cov_1.030303	0	33	0	33	33	1.0000000
NODE_173467_length_297_cov_0.888889	109	172	0	63	63	1.0000000
NODE_173520_length_297_cov_0.782828	24	104	0	80	80	1.0000000
NODE_173708_length_296_cov_41.390863	189	260	0	63	71	0.8873239
NODE_173708_length_296_cov_41.390863	189	260	1	8	71	0.1126761
NODE_173709_length_296_cov_34.776650	214	294	0	80	80	1.0000000
NODE_173758_length_296_cov_4.243655	14	54	0	40	40	1.0000000
NODE_173773_length_296_cov_3.954315	120	200	0	80	80	1.0000000
NODE_173787_length_296_cov_3.736041	6	46	0	40	40	1.0000000
NODE_173797_length_296_cov_3.619289	193	251	0	58	58	1.0000000
NODE_173797_length_296_cov_3.619289	246	296	0	50	50	1.0000000
NODE_173859_length_296_cov_3.015228	177	257	0	80	80	1.0000000
NODE_173992_length_296_cov_2.309645	5	77	0	72	72	1.0000000
NODE_173992_length_296_cov_2.309645	50	130	0	57	80	0.7125000
NODE_173992_length_296_cov_2.309645	50	130	1	23	80	0.2875000
NODE_174040_length_296_cov_2.081218	90	139	0	49	49	1.0000000
NODE_174167_length_296_cov_1.807107	199	246	0	47	47	1.0000000
NODE_174167_length_296_cov_1.807107	219	296	0	77	77	1.0000000
NODE_174213_length_296_cov_1.670051	28	103	6	75	75	1.0000000
NODE_174274_length_296_cov_1.553299	102	179	0	77	77	1.0000000
NODE_174274_length_296_cov_1.553299	160	179	0	19	19	1.0000000
NODE_174438_length_296_cov_1.319797	82	162	0	80	80	1.0000000
NODE_174438_length_296_cov_1.319797	135	205	0	70	70	1.0000000
NODE_174545_length_296_cov_1.258883	222	280	0	58	58	1.0000000
NODE_174554_length_296_cov_1.238579	90	147	0	57	57	1.0000000
NODE_174614_length_296_cov_1.116751	130	169	0	39	39	1.0000000
NODE_175210_length_295_cov_4.290816	2	70	0	68	68	1.0000000
NODE_175210_length_295_cov_4.290816	55	123	0	68	68	1.0000000
NODE_175220_length_295_cov_4.040816	119	165	0	46	46	1.0000000
NODE_175258_length_295_cov_3.576531	130	198	0	68	68	1.0000000
NODE_175324_length_295_cov_2.918367	0	77	0	77	77	1.0000000
NODE_175416_length_295_cov_2.454082	216	277	0	61	61	1.0000000
NODE_175475_length_295_cov_2.224490	11	91	0	80	80	1.0000000
NODE_175483_length_295_cov_2.183673	93	151	0	26	58	0.4482759
NODE_175483_length_295_cov_2.183673	93	151	2	32	58	0.5517241
NODE_175483_length_295_cov_2.183673	124	204	2	80	80	1.0000000
NODE_175597_length_295_cov_1.867347	191	239	0	48	48	1.0000000
NODE_175598_length_295_cov_1.862245	225	285	0	60	60	1.0000000
NODE_175721_length_295_cov_1.596939	173	254	0	81	81	1.0000000
NODE_175804_length_295_cov_1.520408	217	282	0	65	65	1.0000000
NODE_175930_length_295_cov_1.301020	99	121	0	22	22	1.0000000
NODE_176250_length_295_cov_0.938776	200	247	0	47	47	1.0000000
NODE_176367_length_295_cov_0.780612	24	44	0	20	20	1.0000000
NODE_176436_length_295_cov_0.724490	6	87	1	16	81	0.1975309
NODE_176436_length_295_cov_0.724490	6	87	4	16	81	0.1975309
NODE_176436_length_295_cov_0.724490	6	87	5	39	81	0.4814815
NODE_176436_length_295_cov_0.724490	6	87	7	1	81	0.0123457
NODE_176436_length_295_cov_0.724490	6	87	8	9	81	0.1111111
NODE_176436_length_295_cov_0.724490	83	163	8	30	80	0.3750000
NODE_176436_length_295_cov_0.724490	83	163	9	6	80	0.0750000
NODE_176436_length_295_cov_0.724490	83	163	11	20	80	0.2500000
NODE_176436_length_295_cov_0.724490	83	163	12	24	80	0.3000000
NODE_176436_length_295_cov_0.724490	136	216	5	27	80	0.3375000
NODE_176436_length_295_cov_0.724490	136	216	6	2	80	0.0250000
NODE_176436_length_295_cov_0.724490	136	216	8	14	80	0.1750000
NODE_176436_length_295_cov_0.724490	136	216	11	30	80	0.3750000
NODE_176436_length_295_cov_0.724490	136	216	12	7	80	0.0875000
NODE_176547_length_294_cov_83.882051	143	173	5	30	30	1.0000000
NODE_176547_length_294_cov_83.882051	209	239	0	30	30	1.0000000
NODE_176549_length_294_cov_50.589744	187	258	0	32	71	0.4507042
NODE_176549_length_294_cov_50.589744	187	258	1	25	71	0.3521127
NODE_176549_length_294_cov_50.589744	187	258	2	14	71	0.1971831
NODE_176561_length_294_cov_6.676923	61	138	0	77	77	1.0000000
NODE_176596_length_294_cov_4.538462	127	214	0	87	87	1.0000000
NODE_176598_length_294_cov_4.512821	218	248	0	30	30	1.0000000
NODE_176600_length_294_cov_4.497436	159	200	0	41	41	1.0000000
NODE_176697_length_294_cov_2.953846	114	194	0	80	80	1.0000000
NODE_176727_length_294_cov_2.764103	103	183	0	41	80	0.5125000
NODE_176727_length_294_cov_2.764103	103	183	2	39	80	0.4875000
NODE_176727_length_294_cov_2.764103	156	236	2	80	80	1.0000000
NODE_176728_length_294_cov_2.764103	224	282	0	58	58	1.0000000
NODE_176728_length_294_cov_2.764103	225	277	0	52	52	1.0000000
NODE_176735_length_294_cov_2.697436	204	261	0	57	57	1.0000000
NODE_176735_length_294_cov_2.697436	234	294	0	60	60	1.0000000
NODE_176779_length_294_cov_2.517949	23	85	0	62	62	1.0000000
NODE_176816_length_294_cov_2.353846	129	167	1	23	38	0.6052632
NODE_176816_length_294_cov_2.353846	129	167	2	15	38	0.3947369
NODE_176833_length_294_cov_2.338462	133	213	0	80	80	1.0000000
NODE_176943_length_294_cov_2.046154	219	269	0	50	50	1.0000000
NODE_176957_length_294_cov_2.010256	191	235	0	44	44	1.0000000
NODE_176999_length_294_cov_1.902564	52	83	0	31	31	1.0000000
NODE_177102_length_294_cov_1.692308	46	112	0	2	66	0.0303030
NODE_177102_length_294_cov_1.692308	46	112	2	64	66	0.9696970
NODE_177187_length_294_cov_1.569231	49	95	0	46	46	1.0000000
NODE_177252_length_294_cov_1.482051	28	108	2	6	80	0.0750000
NODE_177252_length_294_cov_1.482051	28	108	3	39	80	0.4875000
NODE_177252_length_294_cov_1.482051	28	108	4	35	80	0.4375000
NODE_177252_length_294_cov_1.482051	201	281	0	59	80	0.7375000
NODE_177252_length_294_cov_1.482051	201	281	1	21	80	0.2625000
NODE_177252_length_294_cov_1.482051	201	281	0	59	80	0.7375000
NODE_177252_length_294_cov_1.482051	201	281	1	21	80	0.2625000
NODE_177298_length_294_cov_1.420513	216	262	0	46	46	1.0000000
NODE_177298_length_294_cov_1.420513	235	294	0	59	59	1.0000000
NODE_177972_length_294_cov_0.666667	245	293	0	48	48	1.0000000
NODE_178066_length_293_cov_6.257732	167	247	0	80	80	1.0000000
NODE_178161_length_293_cov_3.567010	50	130	0	80	80	1.0000000
NODE_178226_length_293_cov_2.907216	218	281	0	63	63	1.0000000
NODE_178246_length_293_cov_2.768041	95	175	0	80	80	1.0000000
NODE_178246_length_293_cov_2.768041	148	228	0	80	80	1.0000000
NODE_178268_length_293_cov_2.628866	207	266	0	59	59	1.0000000
NODE_178277_length_293_cov_2.623711	182	223	3	9	41	0.2195122
NODE_178277_length_293_cov_2.623711	182	223	6	32	41	0.7804878
NODE_178299_length_293_cov_2.561856	139	192	0	53	53	1.0000000
NODE_178299_length_293_cov_2.561856	177	223	0	46	46	1.0000000
NODE_178317_length_293_cov_2.448454	98	158	0	60	60	1.0000000
NODE_178351_length_293_cov_2.335052	62	91	0	29	29	1.0000000
NODE_178357_length_293_cov_2.314433	35	89	0	54	54	1.0000000
NODE_178523_length_293_cov_1.840206	27	107	0	80	80	1.0000000
NODE_178523_length_293_cov_1.840206	80	160	0	80	80	1.0000000
NODE_178560_length_293_cov_1.804124	144	173	1	20	29	0.6896552
NODE_178560_length_293_cov_1.804124	144	173	2	9	29	0.3103448
NODE_178570_length_293_cov_1.778351	224	258	0	34	34	1.0000000
NODE_178646_length_293_cov_1.577320	158	177	0	19	19	1.0000000
NODE_178692_length_293_cov_1.577320	161	225	0	64	64	1.0000000
NODE_178693_length_293_cov_1.577320	15	55	0	38	40	0.9500000
NODE_178693_length_293_cov_1.577320	15	55	1	2	40	0.0500000
NODE_178788_length_293_cov_1.402062	3	72	0	69	69	1.0000000
NODE_178822_length_293_cov_1.319588	202	268	0	66	66	1.0000000
NODE_178927_length_293_cov_1.226804	84	141	0	57	57	1.0000000
NODE_179542_length_292_cov_4.523316	240	290	0	50	50	1.0000000
NODE_179552_length_292_cov_4.145078	106	186	0	80	80	1.0000000
NODE_179604_length_292_cov_3.502591	129	205	0	76	76	1.0000000
NODE_179613_length_292_cov_3.435233	176	200	0	22	24	0.9166667
NODE_179613_length_292_cov_3.435233	176	200	1	2	24	0.0833333
NODE_179621_length_292_cov_3.341969	70	150	0	80	80	1.0000000
NODE_179621_length_292_cov_3.341969	118	175	0	57	57	1.0000000
NODE_179627_length_292_cov_3.222798	47	127	0	80	80	1.0000000
NODE_179627_length_292_cov_3.222798	100	129	0	29	29	1.0000000
NODE_179819_length_292_cov_2.238342	211	290	0	79	79	1.0000000
NODE_179943_length_292_cov_1.865285	34	114	0	80	80	1.0000000
NODE_179943_length_292_cov_1.865285	87	167	0	80	80	1.0000000
NODE_180013_length_292_cov_1.761658	174	254	0	80	80	1.0000000
NODE_180029_length_292_cov_1.699482	0	80	0	80	80	1.0000000
NODE_180068_length_292_cov_1.611399	89	157	0	68	68	1.0000000
NODE_180210_length_292_cov_1.455959	72	115	0	43	43	1.0000000
NODE_180210_length_292_cov_1.455959	203	265	0	62	62	1.0000000
NODE_180302_length_292_cov_1.321244	102	182	1	7	80	0.0875000
NODE_180302_length_292_cov_1.321244	102	182	2	73	80	0.9125000
NODE_180302_length_292_cov_1.321244	155	217	2	62	62	1.0000000
NODE_180968_length_291_cov_45.031250	71	145	2	13	74	0.1756757
NODE_180968_length_291_cov_45.031250	71	145	4	54	74	0.7297297
NODE_180968_length_291_cov_45.031250	71	145	5	2	74	0.0270270
NODE_180968_length_291_cov_45.031250	71	145	6	5	74	0.0675676
NODE_180968_length_291_cov_45.031250	71	145	2	13	74	0.1756757
NODE_180968_length_291_cov_45.031250	71	145	4	54	74	0.7297297
NODE_180968_length_291_cov_45.031250	71	145	5	2	74	0.0270270
NODE_180968_length_291_cov_45.031250	71	145	6	5	74	0.0675676
NODE_180968_length_291_cov_45.031250	118	184	2	44	66	0.6666667
NODE_180968_length_291_cov_45.031250	118	184	3	5	66	0.0757576
NODE_180968_length_291_cov_45.031250	118	184	4	10	66	0.1515152
NODE_180968_length_291_cov_45.031250	118	184	5	2	66	0.0303030
NODE_180968_length_291_cov_45.031250	118	184	6	5	66	0.0757576
NODE_180969_length_291_cov_14.791667	125	205	0	80	80	1.0000000
NODE_180969_length_291_cov_14.791667	178	258	0	80	80	1.0000000
NODE_180983_length_291_cov_5.536458	97	169	0	72	72	1.0000000
NODE_180986_length_291_cov_5.401042	77	130	2	53	53	1.0000000
NODE_180998_length_291_cov_4.859375	185	257	0	72	72	1.0000000
NODE_181043_length_291_cov_3.723958	196	276	0	80	80	1.0000000
NODE_181057_length_291_cov_3.531250	129	152	0	23	23	1.0000000
NODE_181191_length_291_cov_2.390625	18	80	0	62	62	1.0000000
NODE_181272_length_291_cov_2.125000	70	117	0	47	47	1.0000000
NODE_181391_length_291_cov_1.859375	197	228	0	31	31	1.0000000
NODE_181497_length_291_cov_1.593750	144	175	0	31	31	1.0000000
NODE_181530_length_291_cov_1.593750	206	281	0	75	75	1.0000000
NODE_181599_length_291_cov_1.552083	189	269	0	80	80	1.0000000
NODE_181615_length_291_cov_1.520833	180	258	0	78	78	1.0000000
NODE_181623_length_291_cov_1.510417	245	291	0	46	46	1.0000000
NODE_181696_length_291_cov_1.385417	80	120	0	40	40	1.0000000
NODE_181791_length_291_cov_1.322917	70	96	2	26	26	1.0000000
NODE_181799_length_291_cov_1.307292	108	188	0	80	80	1.0000000
NODE_181907_length_291_cov_1.114583	79	174	0	95	95	1.0000000
NODE_181930_length_291_cov_1.078125	4	85	0	81	81	1.0000000
NODE_182112_length_291_cov_1.031250	5	50	0	45	45	1.0000000
NODE_182205_length_291_cov_0.890625	0	55	0	55	55	1.0000000
NODE_182252_length_291_cov_0.802083	80	160	0	80	80	1.0000000
NODE_182491_length_290_cov_96.963351	44	124	1	7	80	0.0875000
NODE_182491_length_290_cov_96.963351	44	124	2	27	80	0.3375000
NODE_182491_length_290_cov_96.963351	44	124	4	7	80	0.0875000
NODE_182491_length_290_cov_96.963351	44	124	6	12	80	0.1500000
NODE_182491_length_290_cov_96.963351	44	124	7	27	80	0.3375000
NODE_182491_length_290_cov_96.963351	97	177	7	49	80	0.6125000
NODE_182491_length_290_cov_96.963351	97	177	8	31	80	0.3875000
NODE_182512_length_290_cov_5.968586	89	150	0	61	61	1.0000000
NODE_182512_length_290_cov_5.968586	142	203	0	61	61	1.0000000
NODE_182535_length_290_cov_4.968586	32	52	0	20	20	1.0000000
NODE_182535_length_290_cov_4.968586	73	93	0	20	20	1.0000000
NODE_182547_length_290_cov_4.670157	63	139	0	76	76	1.0000000
NODE_182550_length_290_cov_4.575916	110	153	0	43	43	1.0000000
NODE_182589_length_290_cov_3.816754	113	186	0	73	73	1.0000000
NODE_182607_length_290_cov_3.612565	114	181	0	67	67	1.0000000
NODE_182622_length_290_cov_3.445026	91	150	0	59	59	1.0000000
NODE_182772_length_290_cov_2.596859	189	218	0	29	29	1.0000000
NODE_182844_length_290_cov_2.319372	45	74	0	29	29	1.0000000
NODE_182973_length_290_cov_2.041885	59	139	0	80	80	1.0000000
NODE_182995_length_290_cov_1.979058	229	271	0	42	42	1.0000000
NODE_183288_length_290_cov_1.602094	16	68	0	52	52	1.0000000
NODE_183347_length_290_cov_1.575916	173	250	0	77	77	1.0000000
NODE_183373_length_290_cov_1.544503	151	203	0	52	52	1.0000000
NODE_183403_length_290_cov_1.513089	22	107	0	85	85	1.0000000
NODE_183436_length_290_cov_1.460733	11	91	0	80	80	1.0000000
NODE_183546_length_290_cov_1.335079	91	163	0	47	72	0.6527778
NODE_183546_length_290_cov_1.335079	91	163	1	25	72	0.3472222
NODE_183546_length_290_cov_1.335079	144	216	0	72	72	1.0000000
NODE_183642_length_290_cov_1.314136	0	80	0	80	80	1.0000000
NODE_183663_length_290_cov_1.287958	17	97	0	80	80	1.0000000
NODE_183946_length_290_cov_1.068063	0	60	0	60	60	1.0000000
NODE_183946_length_290_cov_1.068063	33	113	0	58	80	0.7250000
NODE_183946_length_290_cov_1.068063	33	113	2	22	80	0.2750000
NODE_184119_length_290_cov_1.000000	198	254	2	56	56	1.0000000
NODE_184326_length_290_cov_0.832461	154	236	0	82	82	1.0000000
NODE_184585_length_290_cov_0.701571	201	281	0	80	80	1.0000000
NODE_184716_length_289_cov_554.947368	45	125	18	2	80	0.0250000
NODE_184716_length_289_cov_554.947368	45	125	21	1	80	0.0125000
NODE_184716_length_289_cov_554.947368	45	125	22	22	80	0.2750000
NODE_184716_length_289_cov_554.947368	45	125	24	8	80	0.1000000
NODE_184716_length_289_cov_554.947368	45	125	25	3	80	0.0375000
NODE_184716_length_289_cov_554.947368	45	125	26	22	80	0.2750000
NODE_184716_length_289_cov_554.947368	45	125	28	5	80	0.0625000
NODE_184716_length_289_cov_554.947368	45	125	29	17	80	0.2125000
NODE_184729_length_289_cov_7.436842	181	229	0	48	48	1.0000000
NODE_184745_length_289_cov_5.789474	35	100	1	65	65	1.0000000
NODE_184745_length_289_cov_5.789474	85	153	1	68	68	1.0000000
NODE_184745_length_289_cov_5.789474	146	181	0	16	35	0.4571429
NODE_184745_length_289_cov_5.789474	146	181	1	19	35	0.5428572
NODE_184781_length_289_cov_4.515789	192	254	0	62	62	1.0000000
NODE_184806_length_289_cov_4.136842	101	148	0	47	47	1.0000000
NODE_184892_length_289_cov_2.973684	38	83	0	45	45	1.0000000
NODE_184960_length_289_cov_2.678947	105	168	0	63	63	1.0000000
NODE_184960_length_289_cov_2.678947	158	204	0	46	46	1.0000000
NODE_184963_length_289_cov_2.673684	216	263	0	47	47	1.0000000
NODE_185036_length_289_cov_2.378947	233	289	0	56	56	1.0000000
NODE_185152_length_289_cov_2.089474	26	91	0	65	65	1.0000000
NODE_185213_length_289_cov_1.921053	0	54	0	54	54	1.0000000
NODE_185383_length_289_cov_1.642105	58	123	0	65	65	1.0000000
NODE_185570_length_289_cov_1.547368	81	124	0	43	43	1.0000000
NODE_185617_length_289_cov_1.489474	192	274	0	78	82	0.9512195
NODE_185617_length_289_cov_1.489474	192	274	3	4	82	0.0487805
NODE_185622_length_289_cov_1.484211	50	69	2	19	19	1.0000000
NODE_185708_length_289_cov_1.357895	31	74	0	43	43	1.0000000
NODE_185852_length_289_cov_1.278947	239	270	0	31	31	1.0000000
NODE_185864_length_289_cov_1.252632	23	66	0	43	43	1.0000000
NODE_185926_length_289_cov_1.168421	40	100	0	60	60	1.0000000
NODE_185937_length_289_cov_1.152632	0	50	0	50	50	1.0000000
NODE_185937_length_289_cov_1.152632	41	103	0	62	62	1.0000000
NODE_186095_length_289_cov_1.073684	152	198	0	46	46	1.0000000
NODE_186491_length_289_cov_0.878947	113	193	0	80	80	1.0000000
NODE_186491_length_289_cov_0.878947	166	246	0	80	80	1.0000000
NODE_186507_length_289_cov_0.863158	116	211	0	95	95	1.0000000
NODE_186515_length_289_cov_0.857895	6	75	0	69	69	1.0000000
NODE_186547_length_289_cov_0.831579	230	289	0	59	59	1.0000000
NODE_186631_length_289_cov_0.805263	98	159	0	61	61	1.0000000
NODE_186865_length_289_cov_0.568421	141	213	0	72	72	1.0000000
NODE_186934_length_288_cov_11.089947	135	195	0	60	60	1.0000000
NODE_187025_length_288_cov_3.587302	108	188	0	80	80	1.0000000
NODE_187049_length_288_cov_3.296296	61	125	0	64	64	1.0000000
NODE_187049_length_288_cov_3.296296	102	178	0	76	76	1.0000000
NODE_187062_length_288_cov_3.206349	149	202	0	53	53	1.0000000
NODE_187170_length_288_cov_2.539683	4	68	1	43	64	0.6718750
NODE_187170_length_288_cov_2.539683	4	68	2	21	64	0.3281250
NODE_187187_length_288_cov_2.465608	137	182	0	45	45	1.0000000
NODE_187191_length_288_cov_2.449735	216	278	0	62	62	1.0000000
NODE_187191_length_288_cov_2.449735	237	273	0	36	36	1.0000000
NODE_187248_length_288_cov_2.275132	10	46	0	36	36	1.0000000
NODE_187248_length_288_cov_2.275132	13	86	0	73	73	1.0000000
NODE_187248_length_288_cov_2.275132	47	100	0	53	53	1.0000000
NODE_187318_length_288_cov_2.153439	50	81	0	31	31	1.0000000
NODE_187431_length_288_cov_1.915344	0	75	0	75	75	1.0000000
NODE_187443_length_288_cov_1.888889	49	125	0	76	76	1.0000000
NODE_187484_length_288_cov_1.878307	0	42	0	42	42	1.0000000
NODE_187484_length_288_cov_1.878307	15	63	0	48	48	1.0000000
NODE_187810_length_288_cov_1.492063	0	42	0	42	42	1.0000000
NODE_188135_length_288_cov_1.158730	213	288	0	75	75	1.0000000
NODE_188161_length_288_cov_1.100529	256	288	0	8	32	0.2500000
NODE_188161_length_288_cov_1.100529	256	288	1	24	32	0.7500000
NODE_188169_length_288_cov_1.079365	10	74	0	64	64	1.0000000
NODE_188169_length_288_cov_1.079365	65	110	0	45	45	1.0000000
NODE_188760_length_288_cov_0.809524	141	170	0	29	29	1.0000000
NODE_189068_length_287_cov_7.632979	117	184	0	67	67	1.0000000
NODE_189079_length_287_cov_6.510638	20	100	0	80	80	1.0000000
NODE_189097_length_287_cov_5.781915	164	246	0	82	82	1.0000000
NODE_189182_length_287_cov_3.590426	114	194	0	80	80	1.0000000
NODE_189192_length_287_cov_3.452128	0	52	0	52	52	1.0000000
NODE_189208_length_287_cov_3.281915	263	286	0	5	23	0.2173913
NODE_189208_length_287_cov_3.281915	263	286	1	18	23	0.7826087
NODE_189266_length_287_cov_2.936170	41	110	0	69	69	1.0000000
NODE_189266_length_287_cov_2.936170	41	111	0	70	70	1.0000000
NODE_189266_length_287_cov_2.936170	94	167	0	73	73	1.0000000
NODE_189266_length_287_cov_2.936170	156	179	0	23	23	1.0000000
NODE_189330_length_287_cov_2.638298	22	86	0	64	64	1.0000000
NODE_189381_length_287_cov_2.436170	182	262	0	80	80	1.0000000
NODE_189582_length_287_cov_1.984043	137	166	0	29	29	1.0000000
NODE_189594_length_287_cov_1.941489	56	123	0	67	67	1.0000000
NODE_189614_length_287_cov_1.904255	8	51	0	43	43	1.0000000
NODE_189710_length_287_cov_1.803191	146	217	0	71	71	1.0000000
NODE_189843_length_287_cov_1.627660	113	175	5	22	62	0.3548387
NODE_189843_length_287_cov_1.627660	113	175	6	23	62	0.3709677
NODE_189843_length_287_cov_1.627660	113	175	9	17	62	0.2741936
NODE_189843_length_287_cov_1.627660	148	228	6	51	80	0.6375000
NODE_189843_length_287_cov_1.627660	148	228	9	29	80	0.3625000
NODE_189864_length_287_cov_1.627660	14	59	0	45	45	1.0000000
NODE_189864_length_287_cov_1.627660	41	112	0	71	71	1.0000000
NODE_189949_length_287_cov_1.574468	150	220	0	70	70	1.0000000
NODE_189985_length_287_cov_1.531915	123	154	0	31	31	1.0000000
NODE_190122_length_287_cov_1.356383	93	147	0	54	54	1.0000000
NODE_190142_length_287_cov_1.356383	135	199	2	64	64	1.0000000
NODE_190189_length_287_cov_1.335106	149	201	0	52	52	1.0000000
NODE_190654_length_287_cov_1.037234	23	44	0	21	21	1.0000000
NODE_190701_length_287_cov_0.994681	206	225	0	19	19	1.0000000
NODE_190802_length_287_cov_0.898936	0	57	0	57	57	1.0000000
NODE_190873_length_287_cov_0.840426	46	121	0	75	75	1.0000000
NODE_191306_length_286_cov_141.540107	4	63	0	1	59	0.0169492
NODE_191306_length_286_cov_141.540107	4	63	1	1	59	0.0169492
NODE_191306_length_286_cov_141.540107	4	63	4	4	59	0.0677966
NODE_191306_length_286_cov_141.540107	4	63	5	2	59	0.0338983
NODE_191306_length_286_cov_141.540107	4	63	8	1	59	0.0169492
NODE_191306_length_286_cov_141.540107	4	63	9	34	59	0.5762712
NODE_191306_length_286_cov_141.540107	4	63	11	10	59	0.1694915
NODE_191306_length_286_cov_141.540107	4	63	15	6	59	0.1016949
NODE_191389_length_286_cov_3.935829	79	123	0	44	44	1.0000000
NODE_191391_length_286_cov_3.871658	45	121	0	76	76	1.0000000
NODE_191391_length_286_cov_3.871658	102	169	0	67	67	1.0000000
NODE_191393_length_286_cov_3.812834	62	142	0	80	80	1.0000000
NODE_191430_length_286_cov_3.352941	63	143	0	80	80	1.0000000
NODE_191430_length_286_cov_3.352941	116	196	0	80	80	1.0000000
NODE_191466_length_286_cov_3.101604	217	271	0	54	54	1.0000000
NODE_191509_length_286_cov_2.823529	56	122	0	30	66	0.4545455
NODE_191509_length_286_cov_2.823529	56	122	2	36	66	0.5454546
NODE_191598_length_286_cov_2.438503	151	218	0	67	67	1.0000000
NODE_191754_length_286_cov_2.037433	57	138	0	81	81	1.0000000
NODE_191892_length_286_cov_1.807487	186	232	0	46	46	1.0000000
NODE_191892_length_286_cov_1.807487	239	285	0	46	46	1.0000000
NODE_192100_length_286_cov_1.566845	112	160	0	48	48	1.0000000
NODE_192100_length_286_cov_1.566845	165	213	0	48	48	1.0000000
NODE_192150_length_286_cov_1.497326	107	160	0	53	53	1.0000000
NODE_192233_length_286_cov_1.363636	20	87	0	67	67	1.0000000
NODE_192302_length_286_cov_1.358289	218	262	0	44	44	1.0000000
NODE_192357_length_286_cov_1.304813	147	205	0	58	58	1.0000000
NODE_192427_length_286_cov_1.203209	30	76	0	46	46	1.0000000
NODE_192427_length_286_cov_1.203209	49	129	0	80	80	1.0000000
NODE_192757_length_286_cov_1.074866	160	220	1	11	60	0.1833333
NODE_192757_length_286_cov_1.074866	160	220	2	49	60	0.8166667
NODE_193023_length_286_cov_0.871658	218	279	0	61	61	1.0000000
NODE_193038_length_286_cov_0.855615	224	281	0	57	57	1.0000000
NODE_193362_length_286_cov_0.625668	110	190	0	80	80	1.0000000
NODE_193362_length_286_cov_0.625668	163	240	0	77	77	1.0000000
NODE_193481_length_285_cov_7.392473	91	152	0	61	61	1.0000000
NODE_193481_length_285_cov_7.392473	150	184	0	34	34	1.0000000
NODE_193513_length_285_cov_4.650538	0	74	0	74	74	1.0000000
NODE_193513_length_285_cov_4.650538	47	127	0	80	80	1.0000000
NODE_193513_length_285_cov_4.650538	123	203	0	80	80	1.0000000
NODE_193513_length_285_cov_4.650538	176	256	0	80	80	1.0000000
NODE_193532_length_285_cov_4.091398	91	154	0	63	63	1.0000000
NODE_193538_length_285_cov_4.010753	120	201	2	31	81	0.3827161
NODE_193538_length_285_cov_4.010753	120	201	4	50	81	0.6172839
NODE_193547_length_285_cov_3.854839	97	151	0	54	54	1.0000000
NODE_193547_length_285_cov_3.854839	106	153	0	47	47	1.0000000
NODE_193566_length_285_cov_3.607527	197	258	0	37	61	0.6065574
NODE_193566_length_285_cov_3.607527	197	258	1	24	61	0.3934426
NODE_193624_length_285_cov_3.037634	190	272	0	82	82	1.0000000
NODE_193660_length_285_cov_2.806452	215	279	0	64	64	1.0000000
NODE_193688_length_285_cov_2.736559	106	173	0	67	67	1.0000000
NODE_193784_length_285_cov_2.311828	220	262	0	42	42	1.0000000
NODE_193883_length_285_cov_2.043011	77	150	0	73	73	1.0000000
NODE_193883_length_285_cov_2.043011	155	197	0	42	42	1.0000000
NODE_193978_length_285_cov_1.876344	67	110	0	43	43	1.0000000
NODE_194150_length_285_cov_1.645161	112	160	0	48	48	1.0000000
NODE_194260_length_285_cov_1.548387	124	172	0	48	48	1.0000000
NODE_194332_length_285_cov_1.456989	210	277	0	67	67	1.0000000
NODE_194499_length_285_cov_1.327957	114	191	0	77	77	1.0000000
NODE_194865_length_285_cov_1.096774	175	229	0	54	54	1.0000000
NODE_194865_length_285_cov_1.096774	230	271	0	41	41	1.0000000
NODE_195109_length_285_cov_0.924731	128	208	0	80	80	1.0000000
NODE_195115_length_285_cov_0.919355	5	65	0	60	60	1.0000000
NODE_195124_length_285_cov_0.913978	6	80	0	74	74	1.0000000
NODE_195124_length_285_cov_0.913978	58	133	0	75	75	1.0000000
NODE_195642_length_284_cov_7.967568	143	207	3	31	64	0.4843750
NODE_195642_length_284_cov_7.967568	143	207	4	3	64	0.0468750
NODE_195642_length_284_cov_7.967568	143	207	5	30	64	0.4687500
NODE_195667_length_284_cov_5.016216	115	169	0	54	54	1.0000000
NODE_195715_length_284_cov_3.913514	26	82	0	56	56	1.0000000
NODE_195760_length_284_cov_3.405405	209	283	0	74	74	1.0000000
NODE_195863_length_284_cov_2.718919	138	162	0	24	24	1.0000000
NODE_195863_length_284_cov_2.718919	138	215	0	77	77	1.0000000
NODE_196090_length_284_cov_2.097297	46	122	0	76	76	1.0000000
NODE_196253_length_284_cov_1.756757	27	100	0	73	73	1.0000000
NODE_196253_length_284_cov_1.756757	97	153	0	56	56	1.0000000
NODE_196273_length_284_cov_1.713514	24	59	0	35	35	1.0000000
NODE_196372_length_284_cov_1.654054	207	251	0	44	44	1.0000000
NODE_196426_length_284_cov_1.643243	180	239	0	59	59	1.0000000
NODE_196505_length_284_cov_1.540541	148	186	0	38	38	1.0000000
NODE_196670_length_284_cov_1.378378	65	145	0	80	80	1.0000000
NODE_196670_length_284_cov_1.378378	118	165	0	47	47	1.0000000
NODE_196733_length_284_cov_1.329730	114	170	0	56	56	1.0000000
NODE_197755_length_284_cov_0.686486	13	94	0	81	81	1.0000000
NODE_197755_length_284_cov_0.686486	13	94	0	81	81	1.0000000
NODE_197755_length_284_cov_0.686486	13	94	0	81	81	1.0000000
NODE_197835_length_284_cov_0.551351	167	219	0	52	52	1.0000000
NODE_197936_length_283_cov_4.434783	81	137	3	56	56	1.0000000
NODE_197936_length_283_cov_4.434783	114	190	0	3	76	0.0394737
NODE_197936_length_283_cov_4.434783	114	190	1	12	76	0.1578947
NODE_197936_length_283_cov_4.434783	114	190	2	33	76	0.4342105
NODE_197936_length_283_cov_4.434783	114	190	3	28	76	0.3684210
NODE_197936_length_283_cov_4.434783	190	270	0	80	80	1.0000000
NODE_197937_length_283_cov_4.429348	104	168	0	64	64	1.0000000
NODE_197937_length_283_cov_4.429348	104	168	0	64	64	1.0000000
NODE_197937_length_283_cov_4.429348	141	207	0	66	66	1.0000000
NODE_197937_length_283_cov_4.429348	141	221	0	80	80	1.0000000
NODE_198007_length_283_cov_3.369565	0	35	0	35	35	1.0000000
NODE_198022_length_283_cov_3.309783	47	91	0	44	44	1.0000000
NODE_198081_length_283_cov_2.923913	95	137	0	42	42	1.0000000
NODE_198081_length_283_cov_2.923913	110	190	0	80	80	1.0000000
NODE_198098_length_283_cov_2.782609	120	200	0	80	80	1.0000000
NODE_198109_length_283_cov_2.771739	29	72	0	43	43	1.0000000
NODE_198171_length_283_cov_2.494565	186	229	0	43	43	1.0000000
NODE_198176_length_283_cov_2.494565	181	238	0	57	57	1.0000000
NODE_198271_length_283_cov_2.217391	222	281	0	59	59	1.0000000
NODE_198518_length_283_cov_1.777174	40	120	0	80	80	1.0000000
NODE_198745_length_283_cov_1.543478	125	161	0	36	36	1.0000000
NODE_198751_length_283_cov_1.538043	182	203	0	21	21	1.0000000
NODE_198986_length_283_cov_1.304348	208	270	0	62	62	1.0000000
NODE_199042_length_283_cov_1.211957	157	234	0	77	77	1.0000000
NODE_199070_length_283_cov_1.168478	183	250	4	67	67	1.0000000
NODE_199606_length_283_cov_0.918478	146	226	0	80	80	1.0000000
NODE_199606_length_283_cov_0.918478	199	279	0	80	80	1.0000000
NODE_199641_length_283_cov_0.885870	143	205	0	62	62	1.0000000
NODE_199958_length_283_cov_0.706522	119	159	0	40	40	1.0000000
NODE_200085_length_282_cov_51.027322	219	280	0	61	61	1.0000000
NODE_200085_length_282_cov_51.027322	219	282	0	63	63	1.0000000
NODE_200166_length_282_cov_3.901639	38	118	0	80	80	1.0000000
NODE_200166_length_282_cov_3.901639	91	171	0	80	80	1.0000000
NODE_200171_length_282_cov_3.874317	96	116	1	20	20	1.0000000
NODE_200201_length_282_cov_3.562842	224	279	0	55	55	1.0000000
NODE_200270_length_282_cov_2.890710	41	123	0	82	82	1.0000000
NODE_200276_length_282_cov_2.846995	26	47	0	21	21	1.0000000
NODE_200304_length_282_cov_2.770492	145	225	0	80	80	1.0000000
NODE_200304_length_282_cov_2.770492	198	278	0	80	80	1.0000000
NODE_200329_length_282_cov_2.655738	46	119	0	73	73	1.0000000
NODE_200329_length_282_cov_2.655738	100	159	0	59	59	1.0000000
NODE_200335_length_282_cov_2.622951	0	36	0	36	36	1.0000000
NODE_200335_length_282_cov_2.622951	9	89	0	80	80	1.0000000
NODE_200336_length_282_cov_2.622951	38	111	7	73	73	1.0000000
NODE_200336_length_282_cov_2.622951	98	144	7	46	46	1.0000000
NODE_200367_length_282_cov_2.508197	138	186	0	48	48	1.0000000
NODE_200367_length_282_cov_2.508197	191	234	0	43	43	1.0000000
NODE_200425_length_282_cov_2.289617	68	137	0	69	69	1.0000000
NODE_200443_length_282_cov_2.229508	169	249	0	80	80	1.0000000
NODE_200501_length_282_cov_2.163934	138	192	0	54	54	1.0000000
NODE_200634_length_282_cov_1.901639	149	216	0	67	67	1.0000000
NODE_200924_length_282_cov_1.612022	123	162	0	39	39	1.0000000
NODE_201084_length_282_cov_1.393443	158	225	0	67	67	1.0000000
NODE_201219_length_282_cov_1.273224	91	140	2	49	49	1.0000000
NODE_201413_length_282_cov_1.114754	5	53	0	48	48	1.0000000
NODE_202284_length_281_cov_7.895604	165	210	0	45	45	1.0000000
NODE_202284_length_281_cov_7.895604	183	263	0	80	80	1.0000000
NODE_202294_length_281_cov_6.379121	151	231	0	80	80	1.0000000
NODE_202333_length_281_cov_4.565934	71	127	0	56	56	1.0000000
NODE_202337_length_281_cov_4.494505	211	261	0	50	50	1.0000000
NODE_202356_length_281_cov_4.219780	85	135	0	50	50	1.0000000
NODE_202356_length_281_cov_4.219780	145	188	0	43	43	1.0000000
NODE_202401_length_281_cov_3.620879	245	281	0	36	36	1.0000000
NODE_202421_length_281_cov_3.324176	104	161	2	57	57	1.0000000
NODE_202421_length_281_cov_3.324176	112	192	2	80	80	1.0000000
NODE_202436_length_281_cov_3.197802	6	80	0	74	74	1.0000000
NODE_202473_length_281_cov_2.923077	92	150	0	58	58	1.0000000
NODE_202650_length_281_cov_2.241758	5	58	0	53	53	1.0000000
NODE_202712_length_281_cov_2.120879	56	136	0	80	80	1.0000000
NODE_202788_length_281_cov_1.961538	199	270	0	71	71	1.0000000
NODE_203008_length_281_cov_1.675824	147	199	0	52	52	1.0000000
NODE_203008_length_281_cov_1.675824	178	198	0	20	20	1.0000000
NODE_203008_length_281_cov_1.675824	200	241	0	41	41	1.0000000
NODE_203065_length_281_cov_1.653846	29	65	0	36	36	1.0000000
NODE_203168_length_281_cov_1.483516	85	135	0	50	50	1.0000000
NODE_203168_length_281_cov_1.483516	86	166	0	80	80	1.0000000
NODE_203168_length_281_cov_1.483516	139	184	0	45	45	1.0000000
NODE_203183_length_281_cov_1.461538	223	276	0	53	53	1.0000000
NODE_203262_length_281_cov_1.401099	237	281	0	44	44	1.0000000
NODE_203281_length_281_cov_1.401099	150	214	0	64	64	1.0000000
NODE_203281_length_281_cov_1.401099	187	267	0	80	80	1.0000000
NODE_203292_length_281_cov_1.401099	31	111	0	80	80	1.0000000
NODE_203440_length_281_cov_1.186813	0	79	0	79	79	1.0000000
NODE_203440_length_281_cov_1.186813	52	132	0	80	80	1.0000000
NODE_203516_length_281_cov_1.120879	47	82	0	35	35	1.0000000
NODE_203534_length_281_cov_1.120879	243	276	0	33	33	1.0000000
NODE_203544_length_281_cov_1.120879	216	281	0	65	65	1.0000000
NODE_203785_length_281_cov_1.060440	139	179	0	40	40	1.0000000
NODE_204094_length_281_cov_0.840659	72	138	0	66	66	1.0000000
NODE_204094_length_281_cov_0.840659	111	191	0	80	80	1.0000000
NODE_204467_length_280_cov_39.320442	118	198	0	80	80	1.0000000
NODE_204467_length_280_cov_39.320442	181	251	0	70	70	1.0000000
NODE_204468_length_280_cov_34.259669	97	137	2	2	40	0.0500000
NODE_204468_length_280_cov_34.259669	97	137	4	38	40	0.9500000
NODE_204532_length_280_cov_4.287293	53	100	0	47	47	1.0000000
NODE_204532_length_280_cov_4.287293	129	186	0	57	57	1.0000000
NODE_204596_length_280_cov_3.436464	34	103	0	69	69	1.0000000
NODE_204597_length_280_cov_3.430939	17	97	0	80	80	1.0000000
NODE_204597_length_280_cov_3.430939	27	97	0	70	70	1.0000000
NODE_204674_length_280_cov_2.988950	118	164	0	46	46	1.0000000
NODE_204938_length_280_cov_2.165746	2	48	0	46	46	1.0000000
NODE_204938_length_280_cov_2.165746	6	48	0	42	42	1.0000000
NODE_204938_length_280_cov_2.165746	21	101	0	80	80	1.0000000
NODE_204938_length_280_cov_2.165746	22	101	0	79	79	1.0000000
NODE_204938_length_280_cov_2.165746	32	101	0	69	69	1.0000000
NODE_204976_length_280_cov_2.022099	105	148	0	43	43	1.0000000
NODE_204976_length_280_cov_2.022099	121	148	0	27	27	1.0000000
NODE_205044_length_280_cov_1.889503	50	132	0	82	82	1.0000000
NODE_205062_length_280_cov_1.828729	45	75	0	30	30	1.0000000
NODE_205410_length_280_cov_1.425414	17	50	0	33	33	1.0000000
NODE_205410_length_280_cov_1.425414	70	112	0	42	42	1.0000000
NODE_205416_length_280_cov_1.414365	37	97	0	60	60	1.0000000
NODE_205633_length_280_cov_1.187845	56	136	0	80	80	1.0000000
NODE_205635_length_280_cov_1.182320	154	234	0	80	80	1.0000000
NODE_205635_length_280_cov_1.182320	207	280	0	73	73	1.0000000
NODE_205701_length_280_cov_1.127072	204	265	0	61	61	1.0000000
NODE_205794_length_280_cov_1.127072	0	39	0	39	39	1.0000000
NODE_205801_length_280_cov_1.127072	218	253	2	35	35	1.0000000
NODE_205894_length_280_cov_1.127072	0	59	0	59	59	1.0000000
NODE_206211_length_280_cov_0.911602	176	256	0	80	80	1.0000000
NODE_206211_length_280_cov_0.911602	229	280	0	51	51	1.0000000
NODE_206319_length_280_cov_0.845304	211	268	0	57	57	1.0000000
NODE_206531_length_280_cov_0.779006	129	203	3	74	74	1.0000000
NODE_206721_length_279_cov_50.005556	51	130	2	79	79	1.0000000
NODE_206721_length_279_cov_50.005556	103	179	1	40	76	0.5263158
NODE_206721_length_279_cov_50.005556	103	179	2	36	76	0.4736842
NODE_206744_length_279_cov_6.055556	196	228	0	32	32	1.0000000
NODE_206762_length_279_cov_5.166667	197	277	0	80	80	1.0000000
NODE_206788_length_279_cov_4.427778	107	187	0	80	80	1.0000000
NODE_206879_length_279_cov_3.200000	205	225	0	20	20	1.0000000
NODE_206886_length_279_cov_3.116667	115	195	0	80	80	1.0000000
NODE_206886_length_279_cov_3.116667	168	248	0	80	80	1.0000000
NODE_206972_length_279_cov_2.600000	67	147	0	80	80	1.0000000
NODE_206972_length_279_cov_2.600000	120	199	0	79	79	1.0000000
NODE_207023_length_279_cov_2.427778	155	199	0	44	44	1.0000000
NODE_207052_length_279_cov_2.283333	168	240	2	72	72	1.0000000
NODE_207054_length_279_cov_2.277778	190	265	0	75	75	1.0000000
NODE_207086_length_279_cov_2.266667	66	109	0	43	43	1.0000000
NODE_207115_length_279_cov_2.255556	115	176	0	61	61	1.0000000
NODE_207115_length_279_cov_2.255556	168	222	0	54	54	1.0000000
NODE_207155_length_279_cov_2.200000	57	104	0	47	47	1.0000000
NODE_207269_length_279_cov_1.977778	0	62	0	62	62	1.0000000
NODE_207293_length_279_cov_1.944444	63	105	0	42	42	1.0000000
NODE_207306_length_279_cov_1.916667	182	262	0	80	80	1.0000000
NODE_207318_length_279_cov_1.866667	63	143	0	80	80	1.0000000
NODE_207387_length_279_cov_1.700000	8	37	0	29	29	1.0000000
NODE_207389_length_279_cov_1.700000	10	42	0	32	32	1.0000000
NODE_207534_length_279_cov_1.672222	103	183	0	80	80	1.0000000
NODE_207641_length_279_cov_1.433333	51	110	0	59	59	1.0000000
NODE_207641_length_279_cov_1.433333	83	119	0	36	36	1.0000000
NODE_207929_length_279_cov_1.144444	146	211	0	65	65	1.0000000
NODE_207929_length_279_cov_1.144444	184	266	0	82	82	1.0000000
NODE_207931_length_279_cov_1.138889	125	188	0	63	63	1.0000000
NODE_207932_length_279_cov_1.138889	111	191	0	80	80	1.0000000
NODE_207948_length_279_cov_1.133333	231	271	0	40	40	1.0000000
NODE_208183_length_279_cov_1.116667	15	92	0	77	77	1.0000000
NODE_208334_length_279_cov_0.988889	181	261	0	80	80	1.0000000
NODE_208410_length_279_cov_0.927778	50	69	0	19	19	1.0000000
NODE_208410_length_279_cov_0.927778	50	69	0	19	19	1.0000000
NODE_208664_length_279_cov_0.844444	35	70	0	35	35	1.0000000
NODE_209293_length_278_cov_44.882682	158	210	2	5	52	0.0961538
NODE_209293_length_278_cov_44.882682	158	210	3	7	52	0.1346154
NODE_209293_length_278_cov_44.882682	158	210	4	20	52	0.3846154
NODE_209293_length_278_cov_44.882682	158	210	5	10	52	0.1923077
NODE_209293_length_278_cov_44.882682	158	210	6	10	52	0.1923077
NODE_209293_length_278_cov_44.882682	206	232	2	26	26	1.0000000
NODE_209293_length_278_cov_44.882682	206	265	2	59	59	1.0000000
NODE_209294_length_278_cov_37.474860	0	52	2	22	52	0.4230769
NODE_209294_length_278_cov_37.474860	0	52	3	16	52	0.3076923
NODE_209294_length_278_cov_37.474860	0	52	5	14	52	0.2692308
NODE_209294_length_278_cov_37.474860	48	128	5	29	80	0.3625000
NODE_209294_length_278_cov_37.474860	48	128	6	8	80	0.1000000
NODE_209294_length_278_cov_37.474860	48	128	8	20	80	0.2500000
NODE_209294_length_278_cov_37.474860	48	128	9	1	80	0.0125000
NODE_209294_length_278_cov_37.474860	48	128	10	17	80	0.2125000
NODE_209294_length_278_cov_37.474860	48	128	12	5	80	0.0625000
NODE_209294_length_278_cov_37.474860	101	181	8	4	80	0.0500000
NODE_209294_length_278_cov_37.474860	101	181	9	1	80	0.0125000
NODE_209294_length_278_cov_37.474860	101	181	10	17	80	0.2125000
NODE_209294_length_278_cov_37.474860	101	181	12	26	80	0.3250000
NODE_209294_length_278_cov_37.474860	101	181	13	23	80	0.2875000
NODE_209294_length_278_cov_37.474860	101	181	14	7	80	0.0875000
NODE_209294_length_278_cov_37.474860	101	181	15	2	80	0.0250000
NODE_209295_length_278_cov_21.340782	84	164	2	80	80	1.0000000
NODE_209295_length_278_cov_21.340782	137	217	0	1	80	0.0125000
NODE_209295_length_278_cov_21.340782	137	217	2	79	80	0.9875000
NODE_209360_length_278_cov_4.156425	132	210	0	78	78	1.0000000
NODE_209360_length_278_cov_4.156425	193	263	0	70	70	1.0000000
NODE_209372_length_278_cov_3.977654	142	221	0	79	79	1.0000000
NODE_209378_length_278_cov_3.865922	168	210	0	42	42	1.0000000
NODE_209552_length_278_cov_2.558659	93	123	0	30	30	1.0000000
NODE_209565_length_278_cov_2.513966	54	106	0	52	52	1.0000000
NODE_209565_length_278_cov_2.513966	79	158	0	79	79	1.0000000
NODE_209605_length_278_cov_2.296089	127	207	0	80	80	1.0000000
NODE_209883_length_278_cov_1.731844	145	194	0	49	49	1.0000000
NODE_210038_length_278_cov_1.681564	129	184	0	55	55	1.0000000
NODE_210068_length_278_cov_1.636872	13	41	0	28	28	1.0000000
NODE_210373_length_278_cov_1.290503	3	67	0	6	64	0.0937500
NODE_210373_length_278_cov_1.290503	3	67	2	1	64	0.0156250
NODE_210373_length_278_cov_1.290503	3	67	3	10	64	0.1562500
NODE_210373_length_278_cov_1.290503	3	67	5	6	64	0.0937500
NODE_210373_length_278_cov_1.290503	3	67	6	41	64	0.6406250
NODE_210373_length_278_cov_1.290503	3	67	0	6	64	0.0937500
NODE_210373_length_278_cov_1.290503	3	67	2	1	64	0.0156250
NODE_210373_length_278_cov_1.290503	3	67	3	10	64	0.1562500
NODE_210373_length_278_cov_1.290503	3	67	5	6	64	0.0937500
NODE_210373_length_278_cov_1.290503	3	67	6	41	64	0.6406250
NODE_210373_length_278_cov_1.290503	3	67	0	6	64	0.0937500
NODE_210373_length_278_cov_1.290503	3	67	2	1	64	0.0156250
NODE_210373_length_278_cov_1.290503	3	67	3	10	64	0.1562500
NODE_210373_length_278_cov_1.290503	3	67	5	6	64	0.0937500
NODE_210373_length_278_cov_1.290503	3	67	6	41	64	0.6406250
NODE_210463_length_278_cov_1.150838	52	76	0	24	24	1.0000000
NODE_210463_length_278_cov_1.150838	58	84	0	26	26	1.0000000
NODE_210559_length_278_cov_1.139665	108	187	0	79	79	1.0000000
NODE_210612_length_278_cov_1.139665	232	278	0	46	46	1.0000000
NODE_210691_length_278_cov_1.139665	210	278	0	68	68	1.0000000
NODE_212166_length_277_cov_2.691011	0	60	0	60	60	1.0000000
NODE_212166_length_277_cov_2.691011	33	113	0	80	80	1.0000000
NODE_212175_length_277_cov_2.617978	85	127	0	34	42	0.8095238
NODE_212175_length_277_cov_2.617978	85	127	1	8	42	0.1904762
NODE_212233_length_277_cov_2.438202	137	218	0	81	81	1.0000000
NODE_212357_length_277_cov_2.140449	234	276	0	42	42	1.0000000
NODE_212377_length_277_cov_2.095506	41	114	0	73	73	1.0000000
NODE_212377_length_277_cov_2.095506	41	114	0	73	73	1.0000000
NODE_212377_length_277_cov_2.095506	94	161	0	67	67	1.0000000
NODE_212525_length_277_cov_1.837079	92	172	0	14	80	0.1750000
NODE_212525_length_277_cov_1.837079	92	172	1	29	80	0.3625000
NODE_212525_length_277_cov_1.837079	92	172	2	37	80	0.4625000
NODE_212558_length_277_cov_1.764045	115	155	0	40	40	1.0000000
NODE_212605_length_277_cov_1.719101	150	215	0	65	65	1.0000000
NODE_212845_length_277_cov_1.505618	0	47	0	47	47	1.0000000
NODE_212845_length_277_cov_1.505618	20	100	0	80	80	1.0000000
NODE_212970_length_277_cov_1.426966	113	191	0	78	78	1.0000000
NODE_213057_length_277_cov_1.314607	127	176	0	49	49	1.0000000
NODE_213091_length_277_cov_1.258427	141	222	0	81	81	1.0000000
NODE_213223_length_277_cov_1.146067	19	95	0	76	76	1.0000000
NODE_213490_length_277_cov_1.061798	67	105	2	38	38	1.0000000
NODE_213505_length_277_cov_1.044944	19	77	0	58	58	1.0000000
NODE_214572_length_276_cov_31.774011	91	153	2	44	62	0.7096774
NODE_214572_length_276_cov_31.774011	91	153	3	15	62	0.2419355
NODE_214572_length_276_cov_31.774011	91	153	4	3	62	0.0483871
NODE_214576_length_276_cov_10.056497	66	146	0	80	80	1.0000000
NODE_214698_length_276_cov_3.564972	176	256	0	80	80	1.0000000
NODE_214785_length_276_cov_2.920904	203	260	0	57	57	1.0000000
NODE_214785_length_276_cov_2.920904	233	276	0	43	43	1.0000000
NODE_214883_length_276_cov_2.542373	164	204	2	40	40	1.0000000
NODE_215016_length_276_cov_2.197740	64	144	0	80	80	1.0000000
NODE_215086_length_276_cov_2.022599	136	193	0	57	57	1.0000000
NODE_215105_length_276_cov_2.016949	97	138	0	41	41	1.0000000
NODE_215139_length_276_cov_2.005650	82	153	0	71	71	1.0000000
NODE_215234_length_276_cov_1.734463	102	182	0	80	80	1.0000000
NODE_215516_length_276_cov_1.525424	70	116	0	46	46	1.0000000
NODE_215516_length_276_cov_1.525424	123	169	0	46	46	1.0000000
NODE_215519_length_276_cov_1.514124	115	155	0	2	40	0.0500000
NODE_215519_length_276_cov_1.514124	115	155	1	38	40	0.9500000
NODE_215748_length_276_cov_1.288136	114	154	0	40	40	1.0000000
NODE_216141_length_276_cov_1.124294	122	170	0	48	48	1.0000000
NODE_216141_length_276_cov_1.124294	132	163	0	31	31	1.0000000
NODE_216220_length_276_cov_1.039548	7	68	0	61	61	1.0000000
NODE_216220_length_276_cov_1.039548	7	70	0	63	63	1.0000000
NODE_216220_length_276_cov_1.039548	7	70	0	63	63	1.0000000
NODE_216220_length_276_cov_1.039548	7	70	0	63	63	1.0000000
NODE_216269_length_276_cov_1.000000	48	89	0	41	41	1.0000000
NODE_216269_length_276_cov_1.000000	62	106	0	44	44	1.0000000
NODE_216414_length_276_cov_0.898305	54	105	0	51	51	1.0000000
NODE_217265_length_275_cov_85.085227	94	174	19	5	80	0.0625000
NODE_217265_length_275_cov_85.085227	94	174	20	2	80	0.0250000
NODE_217265_length_275_cov_85.085227	94	174	21	48	80	0.6000000
NODE_217265_length_275_cov_85.085227	94	174	22	19	80	0.2375000
NODE_217265_length_275_cov_85.085227	94	174	23	6	80	0.0750000
NODE_217265_length_275_cov_85.085227	147	227	12	4	80	0.0500000
NODE_217265_length_275_cov_85.085227	147	227	13	10	80	0.1250000
NODE_217265_length_275_cov_85.085227	147	227	16	10	80	0.1250000
NODE_217265_length_275_cov_85.085227	147	227	17	6	80	0.0750000
NODE_217265_length_275_cov_85.085227	147	227	18	6	80	0.0750000
NODE_217265_length_275_cov_85.085227	147	227	20	6	80	0.0750000
NODE_217265_length_275_cov_85.085227	147	227	21	26	80	0.3250000
NODE_217265_length_275_cov_85.085227	147	227	22	12	80	0.1500000
NODE_217287_length_275_cov_5.818182	0	44	0	44	44	1.0000000
NODE_217355_length_275_cov_3.857955	0	67	0	67	67	1.0000000
NODE_217396_length_275_cov_3.306818	199	275	2	76	76	1.0000000
NODE_217402_length_275_cov_3.284091	127	175	0	48	48	1.0000000
NODE_217433_length_275_cov_2.977273	95	145	0	28	50	0.5600000
NODE_217433_length_275_cov_2.977273	95	145	1	22	50	0.4400000
NODE_217531_length_275_cov_2.585227	85	122	2	37	37	1.0000000
NODE_217714_length_275_cov_2.090909	0	47	0	47	47	1.0000000
NODE_217714_length_275_cov_2.090909	20	91	0	71	71	1.0000000
NODE_217801_length_275_cov_1.960227	198	251	0	53	53	1.0000000
NODE_217835_length_275_cov_1.875000	190	247	0	57	57	1.0000000
NODE_217839_length_275_cov_1.857955	52	119	0	67	67	1.0000000
NODE_217839_length_275_cov_1.857955	136	182	0	46	46	1.0000000
NODE_217885_length_275_cov_1.755682	21	76	0	55	55	1.0000000
NODE_217912_length_275_cov_1.738636	225	256	0	31	31	1.0000000
NODE_217967_length_275_cov_1.738636	161	241	0	80	80	1.0000000
NODE_218257_length_275_cov_1.448864	123	155	0	32	32	1.0000000
NODE_218402_length_275_cov_1.301136	132	196	0	64	64	1.0000000
NODE_218706_length_275_cov_1.159091	13	93	0	80	80	1.0000000
NODE_218734_length_275_cov_1.153409	11	91	0	80	80	1.0000000
NODE_219031_length_275_cov_0.937500	13	49	0	36	36	1.0000000
NODE_219031_length_275_cov_0.937500	22	86	0	64	64	1.0000000
NODE_219220_length_275_cov_0.869318	67	126	0	59	59	1.0000000
NODE_219655_length_275_cov_0.579545	40	70	0	30	30	1.0000000
NODE_220021_length_274_cov_6.074286	141	175	0	34	34	1.0000000
NODE_220047_length_274_cov_4.845714	48	105	11	38	57	0.6666667
NODE_220047_length_274_cov_4.845714	48	105	15	19	57	0.3333333
NODE_220047_length_274_cov_4.845714	113	175	13	6	62	0.0967742
NODE_220047_length_274_cov_4.845714	113	175	14	11	62	0.1774193
NODE_220047_length_274_cov_4.845714	113	175	19	1	62	0.0161290
NODE_220047_length_274_cov_4.845714	113	175	20	44	62	0.7096774
NODE_220078_length_274_cov_4.080000	210	274	0	64	64	1.0000000
NODE_220215_length_274_cov_2.988571	104	161	0	57	57	1.0000000
NODE_220221_length_274_cov_2.937143	199	234	0	35	35	1.0000000
NODE_220293_length_274_cov_2.622857	29	76	0	47	47	1.0000000
NODE_220293_length_274_cov_2.622857	82	157	0	75	75	1.0000000
NODE_220413_length_274_cov_2.308571	51	130	0	74	79	0.9367089
NODE_220413_length_274_cov_2.308571	51	130	1	5	79	0.0632911
NODE_220504_length_274_cov_2.062857	172	242	0	70	70	1.0000000
NODE_220504_length_274_cov_2.062857	215	256	0	41	41	1.0000000
NODE_220662_length_274_cov_1.754286	219	259	0	40	40	1.0000000
NODE_220681_length_274_cov_1.748571	168	231	0	63	63	1.0000000
NODE_220806_length_274_cov_1.737143	134	172	0	38	38	1.0000000
NODE_220847_length_274_cov_1.685714	132	189	0	57	57	1.0000000
NODE_220847_length_274_cov_1.685714	141	199	0	58	58	1.0000000
NODE_220966_length_274_cov_1.502857	170	232	0	62	62	1.0000000
NODE_220966_length_274_cov_1.502857	223	274	0	51	51	1.0000000
NODE_221005_length_274_cov_1.457143	118	147	0	29	29	1.0000000
NODE_221101_length_274_cov_1.434286	25	69	0	44	44	1.0000000
NODE_221211_length_274_cov_1.285714	84	156	2	50	72	0.6944444
NODE_221211_length_274_cov_1.285714	84	156	3	11	72	0.1527778
NODE_221211_length_274_cov_1.285714	84	156	4	11	72	0.1527778
NODE_221612_length_274_cov_1.131429	205	251	0	46	46	1.0000000
NODE_221764_length_274_cov_0.994286	219	260	0	41	41	1.0000000
NODE_222849_length_273_cov_4.948276	204	262	0	58	58	1.0000000
NODE_222849_length_273_cov_4.948276	204	258	0	54	54	1.0000000
NODE_222914_length_273_cov_3.712644	103	183	0	80	80	1.0000000
NODE_222955_length_273_cov_3.298851	69	100	0	31	31	1.0000000
NODE_222955_length_273_cov_3.298851	73	153	0	80	80	1.0000000
NODE_222974_length_273_cov_3.195402	122	189	0	67	67	1.0000000
NODE_222991_length_273_cov_3.063218	76	151	3	1	75	0.0133333
NODE_222991_length_273_cov_3.063218	76	151	4	74	75	0.9866667
NODE_222991_length_273_cov_3.063218	135	191	0	4	56	0.0714286
NODE_222991_length_273_cov_3.063218	135	191	2	20	56	0.3571429
NODE_222991_length_273_cov_3.063218	135	191	3	17	56	0.3035714
NODE_222991_length_273_cov_3.063218	135	191	4	15	56	0.2678571
NODE_223066_length_273_cov_2.706897	11	45	0	34	34	1.0000000
NODE_223203_length_273_cov_2.339080	69	145	0	76	76	1.0000000
NODE_223353_length_273_cov_2.051724	31	74	0	43	43	1.0000000
NODE_223377_length_273_cov_2.034483	81	161	3	17	80	0.2125000
NODE_223377_length_273_cov_2.034483	81	161	4	7	80	0.0875000
NODE_223377_length_273_cov_2.034483	81	161	5	1	80	0.0125000
NODE_223377_length_273_cov_2.034483	81	161	7	27	80	0.3375000
NODE_223377_length_273_cov_2.034483	81	161	8	28	80	0.3500000
NODE_223377_length_273_cov_2.034483	213	263	1	2	50	0.0400000
NODE_223377_length_273_cov_2.034483	213	263	2	6	50	0.1200000
NODE_223377_length_273_cov_2.034483	213	263	3	1	50	0.0200000
NODE_223377_length_273_cov_2.034483	213	263	4	7	50	0.1400000
NODE_223377_length_273_cov_2.034483	213	263	5	34	50	0.6800000
NODE_223680_length_273_cov_1.706897	181	238	0	57	57	1.0000000
NODE_223913_length_273_cov_1.442529	5	47	0	42	42	1.0000000
NODE_224023_length_273_cov_1.281609	167	247	0	80	80	1.0000000
NODE_224082_length_273_cov_1.189655	120	156	0	36	36	1.0000000
NODE_224082_length_273_cov_1.189655	129	160	0	31	31	1.0000000
NODE_224165_length_273_cov_1.172414	94	130	0	36	36	1.0000000
NODE_224254_length_273_cov_1.172414	8	58	0	50	50	1.0000000
NODE_224367_length_273_cov_1.166667	74	93	0	19	19	1.0000000
NODE_224441_length_273_cov_1.091954	6	42	0	36	36	1.0000000
NODE_224441_length_273_cov_1.091954	43	95	0	52	52	1.0000000
NODE_224587_length_273_cov_0.971264	188	235	0	47	47	1.0000000
NODE_225303_length_273_cov_0.586207	27	88	0	61	61	1.0000000
NODE_225344_length_273_cov_0.586207	24	79	0	55	55	1.0000000
NODE_225344_length_273_cov_0.586207	81	113	0	32	32	1.0000000
NODE_225592_length_272_cov_6.190751	172	236	0	64	64	1.0000000
NODE_225607_length_272_cov_5.335260	193	272	0	79	79	1.0000000
NODE_225633_length_272_cov_4.716763	228	257	0	29	29	1.0000000
NODE_225656_length_272_cov_4.219653	93	166	0	73	73	1.0000000
NODE_225656_length_272_cov_4.219653	146	219	0	73	73	1.0000000
NODE_225658_length_272_cov_4.184971	75	128	0	5	53	0.0943396
NODE_225658_length_272_cov_4.184971	75	128	1	12	53	0.2264151
NODE_225658_length_272_cov_4.184971	75	128	2	36	53	0.6792453
NODE_225739_length_272_cov_3.352601	154	199	0	45	45	1.0000000
NODE_225872_length_272_cov_2.664740	106	186	2	80	80	1.0000000
NODE_226010_length_272_cov_2.335260	33	103	0	70	70	1.0000000
NODE_226029_length_272_cov_2.277457	219	256	0	37	37	1.0000000
NODE_226045_length_272_cov_2.236994	104	184	0	80	80	1.0000000
NODE_226169_length_272_cov_1.982659	172	252	0	80	80	1.0000000
NODE_226245_length_272_cov_1.780347	37	99	0	62	62	1.0000000
NODE_226245_length_272_cov_1.780347	90	152	0	62	62	1.0000000
NODE_226248_length_272_cov_1.768786	12	45	0	33	33	1.0000000
NODE_226461_length_272_cov_1.618497	97	160	0	63	63	1.0000000
NODE_226508_length_272_cov_1.543353	69	137	0	68	68	1.0000000
NODE_227037_length_272_cov_1.173410	147	203	0	56	56	1.0000000
NODE_227265_length_272_cov_0.988439	169	215	3	46	46	1.0000000
NODE_227444_length_272_cov_0.884393	126	163	0	37	37	1.0000000
NODE_228332_length_271_cov_5.238372	103	183	0	80	80	1.0000000
NODE_228423_length_271_cov_3.546512	102	165	0	63	63	1.0000000
NODE_228429_length_271_cov_3.476744	62	93	0	31	31	1.0000000
NODE_228494_length_271_cov_2.959302	96	176	0	80	80	1.0000000
NODE_228494_length_271_cov_2.959302	149	229	0	80	80	1.0000000
NODE_228554_length_271_cov_2.715116	160	241	0	81	81	1.0000000
NODE_228593_length_271_cov_2.622093	180	253	0	73	73	1.0000000
NODE_228623_length_271_cov_2.465116	45	75	0	30	30	1.0000000
NODE_228731_length_271_cov_2.284884	95	158	1	26	63	0.4126984
NODE_228731_length_271_cov_2.284884	95	158	2	37	63	0.5873016
NODE_228731_length_271_cov_2.284884	131	211	0	45	80	0.5625000
NODE_228731_length_271_cov_2.284884	131	211	1	34	80	0.4250000
NODE_228731_length_271_cov_2.284884	131	211	2	1	80	0.0125000
NODE_228737_length_271_cov_2.273256	163	219	0	56	56	1.0000000
NODE_228830_length_271_cov_2.069767	130	212	0	82	82	1.0000000
NODE_228932_length_271_cov_1.784884	135	183	0	48	48	1.0000000
NODE_228937_length_271_cov_1.779070	204	268	0	64	64	1.0000000
NODE_229085_length_271_cov_1.755814	119	199	0	80	80	1.0000000
NODE_229242_length_271_cov_1.523256	122	183	0	61	61	1.0000000
NODE_229254_length_271_cov_1.511628	106	186	2	24	80	0.3000000
NODE_229254_length_271_cov_1.511628	106	186	4	56	80	0.7000000
NODE_229525_length_271_cov_1.226744	119	184	3	65	65	1.0000000
NODE_229541_length_271_cov_1.197674	88	145	0	57	57	1.0000000
NODE_229541_length_271_cov_1.197674	118	192	0	74	74	1.0000000
NODE_230154_length_271_cov_0.918605	155	227	0	72	72	1.0000000
NODE_230255_length_271_cov_0.889535	101	148	0	47	47	1.0000000
NODE_230318_length_271_cov_0.889535	127	188	0	61	61	1.0000000
NODE_231165_length_270_cov_4.818713	72	118	0	46	46	1.0000000
NODE_231187_length_270_cov_4.327485	5	82	0	77	77	1.0000000
NODE_231240_length_270_cov_3.666667	87	154	0	67	67	1.0000000
NODE_231240_length_270_cov_3.666667	140	207	0	67	67	1.0000000
NODE_231263_length_270_cov_3.491228	186	270	0	84	84	1.0000000
NODE_231310_length_270_cov_3.105263	43	90	0	47	47	1.0000000
NODE_231316_length_270_cov_3.046784	64	135	0	71	71	1.0000000
NODE_231439_length_270_cov_2.649123	210	270	0	60	60	1.0000000
NODE_231655_length_270_cov_2.087719	16	55	0	39	39	1.0000000
NODE_231655_length_270_cov_2.087719	78	108	0	30	30	1.0000000
NODE_231714_length_270_cov_2.040936	103	159	0	56	56	1.0000000
NODE_231726_length_270_cov_2.017544	1	48	0	47	47	1.0000000
NODE_231820_length_270_cov_1.789474	146	228	0	82	82	1.0000000
NODE_232008_length_270_cov_1.678363	178	246	0	68	68	1.0000000
NODE_232021_length_270_cov_1.666667	127	191	0	64	64	1.0000000
NODE_232021_length_270_cov_1.666667	180	227	0	47	47	1.0000000
NODE_232087_length_270_cov_1.555556	138	218	0	19	80	0.2375000
NODE_232087_length_270_cov_1.555556	138	218	3	44	80	0.5500000
NODE_232087_length_270_cov_1.555556	138	218	6	17	80	0.2125000
NODE_232331_length_270_cov_1.280702	4	75	0	71	71	1.0000000
NODE_232331_length_270_cov_1.280702	57	137	0	80	80	1.0000000
NODE_232331_length_270_cov_1.280702	65	120	0	55	55	1.0000000
NODE_232331_length_270_cov_1.280702	125	198	0	73	73	1.0000000
NODE_232440_length_270_cov_1.192982	146	194	0	48	48	1.0000000
NODE_232583_length_270_cov_1.192982	61	141	0	80	80	1.0000000
NODE_233290_length_270_cov_0.847953	53	128	0	75	75	1.0000000
NODE_234072_length_269_cov_3.894118	30	110	0	80	80	1.0000000
NODE_234072_length_269_cov_3.894118	83	163	0	80	80	1.0000000
NODE_234100_length_269_cov_3.605882	175	205	0	30	30	1.0000000
NODE_234116_length_269_cov_3.523529	192	233	1	41	41	1.0000000
NODE_234116_length_269_cov_3.523529	206	268	0	3	62	0.0483871
NODE_234116_length_269_cov_3.523529	206	268	1	59	62	0.9516129
NODE_234118_length_269_cov_3.505882	13	93	0	80	80	1.0000000
NODE_234118_length_269_cov_3.505882	66	145	0	79	79	1.0000000
NODE_234162_length_269_cov_3.147059	134	174	0	40	40	1.0000000
NODE_234167_length_269_cov_3.111765	39	119	0	51	80	0.6375000
NODE_234167_length_269_cov_3.111765	39	119	1	29	80	0.3625000
NODE_234167_length_269_cov_3.111765	92	169	1	33	77	0.4285714
NODE_234167_length_269_cov_3.111765	92	169	2	44	77	0.5714286
NODE_234178_length_269_cov_3.000000	166	233	0	67	67	1.0000000
NODE_234205_length_269_cov_2.947059	55	123	0	68	68	1.0000000
NODE_234224_length_269_cov_2.858824	9	89	0	80	80	1.0000000
NODE_234224_length_269_cov_2.858824	62	91	0	29	29	1.0000000
NODE_234228_length_269_cov_2.823529	0	73	0	4	73	0.0547945
NODE_234228_length_269_cov_2.823529	0	73	1	5	73	0.0684932
NODE_234228_length_269_cov_2.823529	0	73	2	64	73	0.8767123
NODE_234228_length_269_cov_2.823529	46	77	2	31	31	1.0000000
NODE_234431_length_269_cov_2.311765	111	157	0	46	46	1.0000000
NODE_234431_length_269_cov_2.311765	130	209	0	79	79	1.0000000
NODE_234606_length_269_cov_1.958824	176	248	0	72	72	1.0000000
NODE_234647_length_269_cov_1.847059	72	99	0	27	27	1.0000000
NODE_234657_length_269_cov_1.823529	30	81	0	51	51	1.0000000
NODE_234758_length_269_cov_1.800000	0	42	0	42	42	1.0000000
NODE_234978_length_269_cov_1.552941	90	170	0	80	80	1.0000000
NODE_235157_length_269_cov_1.400000	139	219	0	80	80	1.0000000
NODE_235168_length_269_cov_1.388235	185	252	0	67	67	1.0000000
NODE_235239_length_269_cov_1.288235	150	179	0	29	29	1.0000000
NODE_235292_length_269_cov_1.217647	141	221	0	80	80	1.0000000
NODE_235561_length_269_cov_1.194118	107	170	0	63	63	1.0000000
NODE_235561_length_269_cov_1.194118	143	221	0	78	78	1.0000000
NODE_235714_length_269_cov_1.094118	38	72	0	34	34	1.0000000
NODE_235780_length_269_cov_1.035294	6	36	0	30	30	1.0000000
NODE_235780_length_269_cov_1.035294	96	150	0	54	54	1.0000000
NODE_235930_length_269_cov_0.917647	4	79	0	75	75	1.0000000
NODE_235930_length_269_cov_0.917647	57	93	0	36	36	1.0000000
NODE_236243_length_269_cov_0.782353	2	52	0	50	50	1.0000000
NODE_236243_length_269_cov_0.782353	76	132	0	56	56	1.0000000
NODE_236856_length_268_cov_223.165680	161	188	44	10	27	0.3703704
NODE_236856_length_268_cov_223.165680	161	188	45	10	27	0.3703704
NODE_236856_length_268_cov_223.165680	161	188	46	7	27	0.2592593
NODE_236856_length_268_cov_223.165680	161	241	23	5	80	0.0625000
NODE_236856_length_268_cov_223.165680	161	241	24	2	80	0.0250000
NODE_236856_length_268_cov_223.165680	161	241	27	1	80	0.0125000
NODE_236856_length_268_cov_223.165680	161	241	28	1	80	0.0125000
NODE_236856_length_268_cov_223.165680	161	241	31	1	80	0.0125000
NODE_236856_length_268_cov_223.165680	161	241	35	4	80	0.0500000
NODE_236856_length_268_cov_223.165680	161	241	36	4	80	0.0500000
NODE_236856_length_268_cov_223.165680	161	241	37	2	80	0.0250000
NODE_236856_length_268_cov_223.165680	161	241	38	1	80	0.0125000
NODE_236856_length_268_cov_223.165680	161	241	39	9	80	0.1125000
NODE_236856_length_268_cov_223.165680	161	241	40	7	80	0.0875000
NODE_236856_length_268_cov_223.165680	161	241	41	2	80	0.0250000
NODE_236856_length_268_cov_223.165680	161	241	42	8	80	0.1000000
NODE_236856_length_268_cov_223.165680	161	241	43	4	80	0.0500000
NODE_236856_length_268_cov_223.165680	161	241	44	12	80	0.1500000
NODE_236856_length_268_cov_223.165680	161	241	45	10	80	0.1250000
NODE_236856_length_268_cov_223.165680	161	241	46	7	80	0.0875000
NODE_236878_length_268_cov_6.266272	29	111	0	82	82	1.0000000
NODE_236909_length_268_cov_5.053254	137	217	0	80	80	1.0000000
NODE_236909_length_268_cov_5.053254	190	253	0	63	63	1.0000000
NODE_236911_length_268_cov_4.994083	92	168	1	76	76	1.0000000
NODE_236972_length_268_cov_3.905325	1	61	0	60	60	1.0000000
NODE_237107_length_268_cov_2.982249	95	175	0	80	80	1.0000000
NODE_237115_length_268_cov_2.940828	28	97	0	69	69	1.0000000
NODE_237185_length_268_cov_2.668639	57	110	0	53	53	1.0000000
NODE_237190_length_268_cov_2.621302	149	176	0	27	27	1.0000000
NODE_237325_length_268_cov_2.289941	87	127	4	40	40	1.0000000
NODE_237345_length_268_cov_2.224852	96	176	0	80	80	1.0000000
NODE_237345_length_268_cov_2.224852	149	229	0	80	80	1.0000000
NODE_237457_length_268_cov_2.005917	97	162	0	65	65	1.0000000
NODE_237502_length_268_cov_1.840237	80	155	0	75	75	1.0000000
NODE_237572_length_268_cov_1.810651	8	84	0	76	76	1.0000000
NODE_237831_length_268_cov_1.532544	186	257	0	71	71	1.0000000
NODE_237906_length_268_cov_1.508876	52	131	0	79	79	1.0000000
NODE_238009_length_268_cov_1.384615	0	46	0	46	46	1.0000000
NODE_238070_length_268_cov_1.278107	100	175	0	75	75	1.0000000
NODE_238153_length_268_cov_1.207101	187	209	0	22	22	1.0000000
NODE_238478_length_268_cov_1.153846	135	195	0	60	60	1.0000000
NODE_239018_length_268_cov_0.852071	59	119	5	60	60	1.0000000
NODE_239805_length_267_cov_4.297619	0	52	0	52	52	1.0000000
NODE_239817_length_267_cov_4.119048	41	87	0	46	46	1.0000000
NODE_239845_length_267_cov_3.785714	96	163	0	67	67	1.0000000
NODE_239845_length_267_cov_3.785714	136	178	0	42	42	1.0000000
NODE_239873_length_267_cov_3.535714	40	101	1	3	61	0.0491803
NODE_239873_length_267_cov_3.535714	40	101	3	29	61	0.4754098
NODE_239873_length_267_cov_3.535714	40	101	4	29	61	0.4754098
NODE_239873_length_267_cov_3.535714	74	154	4	80	80	1.0000000
NODE_239958_length_267_cov_3.005952	216	267	0	51	51	1.0000000
NODE_239959_length_267_cov_3.000000	87	144	0	57	57	1.0000000
NODE_240007_length_267_cov_2.726190	177	220	1	10	43	0.2325581
NODE_240007_length_267_cov_2.726190	177	220	2	33	43	0.7674419
NODE_240024_length_267_cov_2.690476	117	170	0	53	53	1.0000000
NODE_240029_length_267_cov_2.666667	198	267	0	69	69	1.0000000
NODE_240114_length_267_cov_2.428571	189	254	0	65	65	1.0000000
NODE_240207_length_267_cov_2.208333	45	103	0	58	58	1.0000000
NODE_240246_length_267_cov_2.125000	124	175	0	51	51	1.0000000
NODE_240303_length_267_cov_2.077381	65	146	0	81	81	1.0000000
NODE_240303_length_267_cov_2.077381	229	264	0	35	35	1.0000000
NODE_240331_length_267_cov_2.005952	147	228	0	81	81	1.0000000
NODE_240331_length_267_cov_2.005952	201	267	0	66	66	1.0000000
NODE_240336_length_267_cov_1.988095	77	157	0	80	80	1.0000000
NODE_240336_length_267_cov_1.988095	130	210	0	80	80	1.0000000
NODE_240620_length_267_cov_1.755952	119	199	0	80	80	1.0000000
NODE_240624_length_267_cov_1.750000	23	104	0	81	81	1.0000000
NODE_240624_length_267_cov_1.750000	179	208	0	29	29	1.0000000
NODE_240653_length_267_cov_1.690476	18	90	0	72	72	1.0000000
NODE_240790_length_267_cov_1.517857	6	43	0	37	37	1.0000000
NODE_241075_length_267_cov_1.214286	37	91	2	54	54	1.0000000
NODE_241240_length_267_cov_1.214286	89	126	0	37	37	1.0000000
NODE_241352_length_267_cov_1.208333	124	164	0	40	40	1.0000000
NODE_241484_length_267_cov_1.125000	57	103	0	46	46	1.0000000
NODE_241512_length_267_cov_1.089286	119	196	0	77	77	1.0000000
NODE_241512_length_267_cov_1.089286	169	249	0	80	80	1.0000000
NODE_241517_length_267_cov_1.083333	133	152	2	19	19	1.0000000
NODE_241517_length_267_cov_1.083333	183	264	0	8	81	0.0987654
NODE_241517_length_267_cov_1.083333	183	264	1	73	81	0.9012346
NODE_241588_length_267_cov_1.017857	205	267	2	62	62	1.0000000
NODE_241633_length_267_cov_0.982143	4	75	0	71	71	1.0000000
NODE_242999_length_266_cov_5.706587	120	199	0	79	79	1.0000000
NODE_242999_length_266_cov_5.706587	172	239	0	67	67	1.0000000
NODE_243010_length_266_cov_5.107784	68	150	0	82	82	1.0000000
NODE_243064_length_266_cov_4.125749	99	168	0	69	69	1.0000000
NODE_243079_length_266_cov_3.958084	40	120	2	37	80	0.4625000
NODE_243079_length_266_cov_3.958084	40	120	3	3	80	0.0375000
NODE_243079_length_266_cov_3.958084	40	120	5	20	80	0.2500000
NODE_243079_length_266_cov_3.958084	40	120	6	20	80	0.2500000
NODE_243079_length_266_cov_3.958084	93	159	5	7	66	0.1060606
NODE_243079_length_266_cov_3.958084	93	159	6	59	66	0.8939394
NODE_243136_length_266_cov_3.419162	68	130	0	62	62	1.0000000
NODE_243136_length_266_cov_3.419162	116	183	0	67	67	1.0000000
NODE_243168_length_266_cov_3.137725	6	86	0	80	80	1.0000000
NODE_243168_length_266_cov_3.137725	59	120	0	61	61	1.0000000
NODE_243174_length_266_cov_3.107784	166	232	0	66	66	1.0000000
NODE_243475_length_266_cov_2.179641	110	191	0	81	81	1.0000000
NODE_243497_length_266_cov_2.137725	156	236	0	80	80	1.0000000
NODE_243570_length_266_cov_2.023952	47	123	0	76	76	1.0000000
NODE_243972_length_266_cov_1.532934	155	235	0	80	80	1.0000000
NODE_244681_length_266_cov_1.113772	70	97	0	27	27	1.0000000
NODE_244760_length_266_cov_1.023952	144	201	0	57	57	1.0000000
NODE_244760_length_266_cov_1.023952	199	265	0	66	66	1.0000000
NODE_245049_length_266_cov_0.916168	51	122	0	71	71	1.0000000
NODE_245280_length_266_cov_0.730539	132	158	0	26	26	1.0000000
NODE_245538_length_266_cov_0.610778	99	139	0	40	40	1.0000000
NODE_245538_length_266_cov_0.610778	112	156	0	44	44	1.0000000
NODE_246087_length_265_cov_7.843373	128	208	0	80	80	1.0000000
NODE_246192_length_265_cov_4.054217	65	145	0	80	80	1.0000000
NODE_246192_length_265_cov_4.054217	118	198	0	80	80	1.0000000
NODE_246198_length_265_cov_3.993976	195	231	0	36	36	1.0000000
NODE_246284_length_265_cov_3.150602	183	263	0	80	80	1.0000000
NODE_246374_length_265_cov_2.789157	177	238	0	61	61	1.0000000
NODE_246409_length_265_cov_2.734940	167	247	0	80	80	1.0000000
NODE_246432_length_265_cov_2.608434	188	259	0	71	71	1.0000000
NODE_246606_length_265_cov_2.156627	197	237	0	40	40	1.0000000
NODE_246624_length_265_cov_2.150602	169	218	0	49	49	1.0000000
NODE_246692_length_265_cov_1.975904	15	44	0	29	29	1.0000000
NODE_246811_length_265_cov_1.843373	195	265	0	70	70	1.0000000
NODE_247028_length_265_cov_1.620482	115	186	0	4	71	0.0563380
NODE_247028_length_265_cov_1.620482	115	186	1	67	71	0.9436620
NODE_247028_length_265_cov_1.620482	117	171	0	2	54	0.0370370
NODE_247028_length_265_cov_1.620482	117	171	1	52	54	0.9629630
NODE_247031_length_265_cov_1.614458	53	113	3	3	60	0.0500000
NODE_247031_length_265_cov_1.614458	53	113	4	2	60	0.0333333
NODE_247031_length_265_cov_1.614458	53	113	5	4	60	0.0666667
NODE_247031_length_265_cov_1.614458	53	113	9	1	60	0.0166667
NODE_247031_length_265_cov_1.614458	53	113	10	3	60	0.0500000
NODE_247031_length_265_cov_1.614458	53	113	11	13	60	0.2166667
NODE_247031_length_265_cov_1.614458	53	113	12	10	60	0.1666667
NODE_247031_length_265_cov_1.614458	53	113	13	24	60	0.4000000
NODE_247031_length_265_cov_1.614458	86	166	12	3	80	0.0375000
NODE_247031_length_265_cov_1.614458	86	166	13	67	80	0.8375000
NODE_247031_length_265_cov_1.614458	86	166	17	6	80	0.0750000
NODE_247031_length_265_cov_1.614458	86	166	18	4	80	0.0500000
NODE_247314_length_265_cov_1.337349	107	168	0	61	61	1.0000000
NODE_247952_length_265_cov_1.000000	187	251	0	64	64	1.0000000
NODE_247972_length_265_cov_0.987952	44	63	0	19	19	1.0000000
NODE_249395_length_264_cov_4.018182	141	178	0	37	37	1.0000000
NODE_249404_length_264_cov_3.957576	59	132	0	73	73	1.0000000
NODE_249404_length_264_cov_3.957576	112	192	0	80	80	1.0000000
NODE_249415_length_264_cov_3.824242	178	220	0	42	42	1.0000000
NODE_249452_length_264_cov_3.400000	73	125	1	41	52	0.7884616
NODE_249452_length_264_cov_3.400000	73	125	2	11	52	0.2115385
NODE_249452_length_264_cov_3.400000	124	165	2	41	41	1.0000000
NODE_249485_length_264_cov_3.133333	119	186	0	67	67	1.0000000
NODE_249530_length_264_cov_3.012121	122	198	0	76	76	1.0000000
NODE_249904_length_264_cov_2.048485	32	98	0	66	66	1.0000000
NODE_249905_length_264_cov_2.048485	133	176	0	43	43	1.0000000
NODE_249912_length_264_cov_2.012121	20	84	0	64	64	1.0000000
NODE_249931_length_264_cov_1.951515	178	211	0	33	33	1.0000000
NODE_249982_length_264_cov_1.854545	130	161	7	13	31	0.4193548
NODE_249982_length_264_cov_1.854545	130	161	8	18	31	0.5806451
NODE_250202_length_264_cov_1.745455	26	81	0	55	55	1.0000000
NODE_250202_length_264_cov_1.745455	86	153	0	67	67	1.0000000
NODE_250203_length_264_cov_1.745455	90	169	0	79	79	1.0000000
NODE_250203_length_264_cov_1.745455	143	207	0	64	64	1.0000000
NODE_250297_length_264_cov_1.569697	173	236	0	63	63	1.0000000
NODE_250314_length_264_cov_1.545455	206	255	0	49	49	1.0000000
NODE_250381_length_264_cov_1.545455	35	66	0	31	31	1.0000000
NODE_250446_length_264_cov_1.503030	0	63	0	63	63	1.0000000
NODE_250513_length_264_cov_1.406061	149	230	0	81	81	1.0000000
NODE_250513_length_264_cov_1.406061	225	260	0	35	35	1.0000000
NODE_250635_length_264_cov_1.236364	2	63	0	61	61	1.0000000
NODE_251015_length_264_cov_1.151515	11	68	0	57	57	1.0000000
NODE_251529_length_264_cov_0.921212	49	85	0	36	36	1.0000000
NODE_251703_length_264_cov_0.721212	233	252	0	19	19	1.0000000
NODE_252559_length_263_cov_5.115854	132	219	1	41	87	0.4712644
NODE_252559_length_263_cov_5.115854	132	219	2	46	87	0.5287356
NODE_252563_length_263_cov_4.914634	45	117	0	72	72	1.0000000
NODE_252595_length_263_cov_4.225610	67	124	0	57	57	1.0000000
NODE_252663_length_263_cov_3.518293	104	176	0	3	72	0.0416667
NODE_252663_length_263_cov_3.518293	104	176	1	2	72	0.0277778
NODE_252663_length_263_cov_3.518293	104	176	4	12	72	0.1666667
NODE_252663_length_263_cov_3.518293	104	176	5	55	72	0.7638889
NODE_252766_length_263_cov_2.908537	7	93	0	86	86	1.0000000
NODE_252778_length_263_cov_2.798780	67	146	0	79	79	1.0000000
NODE_252932_length_263_cov_2.396341	207	238	0	31	31	1.0000000
NODE_253261_length_263_cov_1.865854	51	81	1	30	30	1.0000000
NODE_253310_length_263_cov_1.847561	113	189	0	76	76	1.0000000
NODE_253379_length_263_cov_1.750000	151	231	0	80	80	1.0000000
NODE_253468_length_263_cov_1.579268	32	95	0	63	63	1.0000000
NODE_253477_length_263_cov_1.567073	98	155	1	24	57	0.4210526
NODE_253477_length_263_cov_1.567073	98	155	2	33	57	0.5789474
NODE_253619_length_263_cov_1.506098	157	217	0	60	60	1.0000000
NODE_253620_length_263_cov_1.506098	84	113	0	29	29	1.0000000
NODE_253753_length_263_cov_1.286585	143	223	0	80	80	1.0000000
NODE_253788_length_263_cov_1.243902	206	263	0	57	57	1.0000000
NODE_254174_length_263_cov_1.170732	12	66	0	54	54	1.0000000
NODE_254174_length_263_cov_1.170732	39	119	0	80	80	1.0000000
NODE_254301_length_263_cov_1.067073	137	202	0	65	65	1.0000000
NODE_254301_length_263_cov_1.067073	175	255	0	80	80	1.0000000
NODE_254783_length_263_cov_0.810976	163	245	3	82	82	1.0000000
NODE_255446_length_263_cov_0.621951	212	258	0	46	46	1.0000000
NODE_255524_length_263_cov_0.621951	131	151	0	20	20	1.0000000
NODE_255559_length_263_cov_0.621951	67	86	0	19	19	1.0000000
NODE_255727_length_262_cov_5.312883	20	82	0	62	62	1.0000000
NODE_255769_length_262_cov_4.447853	102	155	0	53	53	1.0000000
NODE_255821_length_262_cov_3.766871	48	89	0	41	41	1.0000000
NODE_255860_length_262_cov_3.435583	158	235	0	77	77	1.0000000
NODE_255945_length_262_cov_2.938650	142	222	0	80	80	1.0000000
NODE_256009_length_262_cov_2.723926	103	183	0	80	80	1.0000000
NODE_256049_length_262_cov_2.509202	88	148	0	60	60	1.0000000
NODE_256050_length_262_cov_2.509202	0	61	0	61	61	1.0000000
NODE_256050_length_262_cov_2.509202	107	171	0	64	64	1.0000000
NODE_256050_length_262_cov_2.509202	144	224	0	80	80	1.0000000
NODE_256129_length_262_cov_2.429448	14	87	0	73	73	1.0000000
NODE_256129_length_262_cov_2.429448	62	149	0	87	87	1.0000000
NODE_256176_length_262_cov_2.226994	2	79	0	77	77	1.0000000
NODE_256187_length_262_cov_2.202454	61	81	0	20	20	1.0000000
NODE_256199_length_262_cov_2.190184	172	235	0	63	63	1.0000000
NODE_256239_length_262_cov_2.177914	133	189	0	56	56	1.0000000
NODE_256265_length_262_cov_2.122699	96	157	0	61	61	1.0000000
NODE_256386_length_262_cov_1.877301	0	77	0	12	77	0.1558442
NODE_256386_length_262_cov_1.877301	0	77	1	44	77	0.5714286
NODE_256386_length_262_cov_1.877301	0	77	2	21	77	0.2727273
NODE_256390_length_262_cov_1.877301	77	124	0	47	47	1.0000000
NODE_256481_length_262_cov_1.871166	192	252	0	60	60	1.0000000
NODE_256596_length_262_cov_1.736196	149	208	0	59	59	1.0000000
NODE_256630_length_262_cov_1.680982	2	82	0	80	80	1.0000000
NODE_256650_length_262_cov_1.656442	135	166	0	31	31	1.0000000
NODE_256659_length_262_cov_1.638037	111	142	0	31	31	1.0000000
NODE_256704_length_262_cov_1.576687	102	182	0	80	80	1.0000000
NODE_256704_length_262_cov_1.576687	155	221	0	66	66	1.0000000
NODE_256742_length_262_cov_1.564417	69	124	2	55	55	1.0000000
NODE_256742_length_262_cov_1.564417	106	177	1	15	71	0.2112676
NODE_256742_length_262_cov_1.564417	106	177	2	56	71	0.7887324
NODE_256933_length_262_cov_1.349693	52	102	0	50	50	1.0000000
NODE_256933_length_262_cov_1.349693	83	149	0	66	66	1.0000000
NODE_257199_length_262_cov_1.251534	44	124	0	80	80	1.0000000
NODE_257199_length_262_cov_1.251534	97	171	0	74	74	1.0000000
NODE_258876_length_261_cov_31.913580	32	112	7	11	80	0.1375000
NODE_258876_length_261_cov_31.913580	32	112	8	7	80	0.0875000
NODE_258876_length_261_cov_31.913580	32	112	9	36	80	0.4500000
NODE_258876_length_261_cov_31.913580	32	112	10	26	80	0.3250000
NODE_258876_length_261_cov_31.913580	85	171	8	36	86	0.4186046
NODE_258876_length_261_cov_31.913580	85	171	9	30	86	0.3488372
NODE_258876_length_261_cov_31.913580	85	171	10	20	86	0.2325581
NODE_258901_length_261_cov_6.376543	126	201	0	75	75	1.0000000
NODE_258901_length_261_cov_6.376543	179	254	0	75	75	1.0000000
NODE_258929_length_261_cov_5.469136	56	132	0	76	76	1.0000000
NODE_259329_length_261_cov_2.425926	53	134	0	81	81	1.0000000
NODE_259361_length_261_cov_2.333333	41	136	0	95	95	1.0000000
NODE_259435_length_261_cov_2.191358	86	122	0	36	36	1.0000000
NODE_259495_length_261_cov_1.993827	134	214	0	80	80	1.0000000
NODE_259672_length_261_cov_1.882716	51	105	0	54	54	1.0000000
NODE_259740_length_261_cov_1.839506	118	197	0	79	79	1.0000000
NODE_259769_length_261_cov_1.783951	69	141	0	72	72	1.0000000
NODE_260089_length_261_cov_1.388889	202	247	0	45	45	1.0000000
NODE_260090_length_261_cov_1.382716	14	61	0	47	47	1.0000000
NODE_260428_length_261_cov_1.253086	100	138	0	38	38	1.0000000
NODE_260738_length_261_cov_1.030864	122	205	0	83	83	1.0000000
NODE_260738_length_261_cov_1.030864	129	210	0	81	81	1.0000000
NODE_260738_length_261_cov_1.030864	129	184	0	55	55	1.0000000
NODE_260738_length_261_cov_1.030864	187	248	0	61	61	1.0000000
NODE_260767_length_261_cov_1.006173	3	45	0	42	42	1.0000000
NODE_260767_length_261_cov_1.006173	46	98	0	52	52	1.0000000
NODE_262062_length_261_cov_0.580247	11	31	0	20	20	1.0000000
NODE_262121_length_260_cov_8.844720	74	138	0	64	64	1.0000000
NODE_262123_length_260_cov_8.447205	30	110	0	80	80	1.0000000
NODE_262123_length_260_cov_8.447205	83	167	0	84	84	1.0000000
NODE_262123_length_260_cov_8.447205	163	243	0	80	80	1.0000000
NODE_262149_length_260_cov_5.807453	38	118	0	80	80	1.0000000
NODE_262149_length_260_cov_5.807453	91	171	0	80	80	1.0000000
NODE_262264_length_260_cov_3.645963	5	57	2	52	52	1.0000000
NODE_262329_length_260_cov_3.167702	91	163	0	72	72	1.0000000
NODE_262378_length_260_cov_2.981366	58	127	0	69	69	1.0000000
NODE_262384_length_260_cov_2.913043	10	90	0	80	80	1.0000000
NODE_262708_length_260_cov_2.161491	174	251	0	77	77	1.0000000
NODE_262733_length_260_cov_2.080745	188	258	0	70	70	1.0000000
NODE_262788_length_260_cov_1.950311	27	85	0	58	58	1.0000000
NODE_262930_length_260_cov_1.900621	14	50	0	36	36	1.0000000
NODE_263117_length_260_cov_1.683230	50	130	0	80	80	1.0000000
NODE_263428_length_260_cov_1.347826	38	118	0	80	80	1.0000000
NODE_263533_length_260_cov_1.267081	114	199	0	23	85	0.2705882
NODE_263533_length_260_cov_1.267081	114	199	1	62	85	0.7294118
NODE_263556_length_260_cov_1.267081	198	244	0	46	46	1.0000000
NODE_263568_length_260_cov_1.267081	145	189	0	44	44	1.0000000
NODE_265483_length_259_cov_4.800000	35	95	0	60	60	1.0000000
NODE_265584_length_259_cov_3.675000	119	161	0	42	42	1.0000000
NODE_265584_length_259_cov_3.675000	134	214	0	80	80	1.0000000
NODE_265592_length_259_cov_3.593750	100	143	0	43	43	1.0000000
NODE_265611_length_259_cov_3.475000	198	259	0	61	61	1.0000000
NODE_265625_length_259_cov_3.331250	72	118	0	46	46	1.0000000
NODE_265636_length_259_cov_3.237500	103	160	0	57	57	1.0000000
NODE_265704_length_259_cov_2.937500	209	233	0	24	24	1.0000000
NODE_265735_length_259_cov_2.850000	0	41	0	41	41	1.0000000
NODE_265735_length_259_cov_2.850000	14	94	0	80	80	1.0000000
NODE_265818_length_259_cov_2.550000	9	82	0	73	73	1.0000000
NODE_265942_length_259_cov_2.287500	147	225	0	78	78	1.0000000
NODE_265942_length_259_cov_2.287500	198	241	0	43	43	1.0000000
NODE_266032_length_259_cov_2.156250	0	72	0	72	72	1.0000000
NODE_266080_length_259_cov_2.012500	8	73	2	65	65	1.0000000
NODE_266080_length_259_cov_2.012500	53	126	1	19	73	0.2602740
NODE_266080_length_259_cov_2.012500	53	126	2	54	73	0.7397260
NODE_266101_length_259_cov_1.962500	108	189	0	81	81	1.0000000
NODE_266117_length_259_cov_1.918750	49	120	0	71	71	1.0000000
NODE_266183_length_259_cov_1.912500	114	177	0	63	63	1.0000000
NODE_266365_length_259_cov_1.837500	180	252	0	9	72	0.1250000
NODE_266365_length_259_cov_1.837500	180	252	2	63	72	0.8750000
NODE_266609_length_259_cov_1.593750	27	67	0	40	40	1.0000000
NODE_266746_length_259_cov_1.400000	117	164	0	47	47	1.0000000
NODE_266746_length_259_cov_1.400000	137	217	0	80	80	1.0000000
NODE_268816_length_258_cov_6.415094	129	209	0	80	80	1.0000000
NODE_268816_length_258_cov_6.415094	182	258	0	76	76	1.0000000
NODE_268823_length_258_cov_6.157233	1	81	0	80	80	1.0000000
NODE_268823_length_258_cov_6.157233	9	64	0	55	55	1.0000000
NODE_268852_length_258_cov_4.798742	83	163	0	80	80	1.0000000
NODE_268870_length_258_cov_4.396226	0	44	0	44	44	1.0000000
NODE_268870_length_258_cov_4.396226	24	97	0	73	73	1.0000000
NODE_268880_length_258_cov_4.301887	0	54	0	52	54	0.9629630
NODE_268880_length_258_cov_4.301887	0	54	1	2	54	0.0370370
NODE_268942_length_258_cov_3.616352	29	58	0	29	29	1.0000000
NODE_268982_length_258_cov_3.352201	47	127	0	80	80	1.0000000
NODE_269086_length_258_cov_2.886792	102	121	0	19	19	1.0000000
NODE_269091_length_258_cov_2.880503	92	172	0	80	80	1.0000000
NODE_269102_length_258_cov_2.855346	96	138	4	22	42	0.5238096
NODE_269102_length_258_cov_2.855346	96	138	5	20	42	0.4761905
NODE_269102_length_258_cov_2.855346	148	191	4	43	43	1.0000000
NODE_269113_length_258_cov_2.817610	10	58	0	48	48	1.0000000
NODE_269264_length_258_cov_2.383648	48	128	0	80	80	1.0000000
NODE_269264_length_258_cov_2.383648	101	182	0	81	81	1.0000000
NODE_269338_length_258_cov_2.238994	61	141	0	80	80	1.0000000
NODE_269615_length_258_cov_1.918239	0	51	0	51	51	1.0000000
NODE_269682_length_258_cov_1.855346	26	47	0	3	21	0.1428571
NODE_269682_length_258_cov_1.855346	26	47	1	1	21	0.0476190
NODE_269682_length_258_cov_1.855346	26	47	2	17	21	0.8095238
NODE_269682_length_258_cov_1.855346	71	104	2	33	33	1.0000000
NODE_269682_length_258_cov_1.855346	81	156	2	75	75	1.0000000
NODE_269749_length_258_cov_1.735849	105	176	0	71	71	1.0000000
NODE_269767_length_258_cov_1.710692	8	49	0	41	41	1.0000000
NODE_270191_length_258_cov_1.283019	127	191	0	64	64	1.0000000
NODE_270191_length_258_cov_1.283019	164	227	0	63	63	1.0000000
NODE_270465_length_258_cov_1.270440	4	55	0	51	51	1.0000000
NODE_270504_length_258_cov_1.232704	90	166	0	76	76	1.0000000
NODE_270547_length_258_cov_1.201258	49	98	0	49	49	1.0000000
NODE_270876_length_258_cov_0.962264	186	258	0	72	72	1.0000000
NODE_270970_length_258_cov_0.962264	69	124	0	55	55	1.0000000
NODE_272169_length_257_cov_71.158228	81	165	6	10	84	0.1190476
NODE_272169_length_257_cov_71.158228	81	165	7	41	84	0.4880952
NODE_272169_length_257_cov_71.158228	81	165	8	31	84	0.3690476
NODE_272169_length_257_cov_71.158228	81	165	9	2	84	0.0238095
NODE_272169_length_257_cov_71.158228	145	218	3	3	73	0.0410959
NODE_272169_length_257_cov_71.158228	145	218	4	22	73	0.3013699
NODE_272169_length_257_cov_71.158228	145	218	5	10	73	0.1369863
NODE_272169_length_257_cov_71.158228	145	218	6	24	73	0.3287671
NODE_272169_length_257_cov_71.158228	145	218	7	14	73	0.1917808
NODE_272194_length_257_cov_6.329114	15	93	0	78	78	1.0000000
NODE_272275_length_257_cov_4.177215	25	86	0	61	61	1.0000000
NODE_272291_length_257_cov_3.987342	55	107	0	52	52	1.0000000
NODE_272304_length_257_cov_3.873418	145	225	0	80	80	1.0000000
NODE_272304_length_257_cov_3.873418	198	254	0	56	56	1.0000000
NODE_272322_length_257_cov_3.740506	133	199	0	66	66	1.0000000
NODE_272322_length_257_cov_3.740506	177	256	0	79	79	1.0000000
NODE_272486_length_257_cov_2.734177	1	65	0	64	64	1.0000000
NODE_272491_length_257_cov_2.677215	170	250	0	80	80	1.0000000
NODE_272580_length_257_cov_2.537975	60	137	0	77	77	1.0000000
NODE_272596_length_257_cov_2.487342	95	172	0	77	77	1.0000000
NODE_272625_length_257_cov_2.379747	106	186	3	80	80	1.0000000
NODE_272625_length_257_cov_2.379747	159	207	0	17	48	0.3541667
NODE_272625_length_257_cov_2.379747	159	207	3	31	48	0.6458333
NODE_272724_length_257_cov_2.221519	163	240	0	77	77	1.0000000
NODE_272729_length_257_cov_2.202532	16	97	0	81	81	1.0000000
NODE_273151_length_257_cov_1.664557	220	239	0	19	19	1.0000000
NODE_273357_length_257_cov_1.500000	85	166	0	81	81	1.0000000
NODE_273462_length_257_cov_1.329114	120	186	0	66	66	1.0000000
NODE_273533_length_257_cov_1.291139	13	53	0	40	40	1.0000000
NODE_273697_length_257_cov_1.291139	205	257	0	52	52	1.0000000
NODE_273894_length_257_cov_1.221519	10	74	0	64	64	1.0000000
NODE_273917_length_257_cov_1.196203	70	150	0	80	80	1.0000000
NODE_273917_length_257_cov_1.196203	123	204	0	81	81	1.0000000
NODE_275399_length_257_cov_0.645570	138	158	0	20	20	1.0000000
NODE_275419_length_257_cov_0.645570	181	241	0	60	60	1.0000000
NODE_275598_length_256_cov_5.235669	30	77	0	47	47	1.0000000
NODE_275624_length_256_cov_4.598726	100	180	0	80	80	1.0000000
NODE_275624_length_256_cov_4.598726	160	211	0	51	51	1.0000000
NODE_275682_length_256_cov_3.866242	112	166	0	54	54	1.0000000
NODE_275840_length_256_cov_2.878981	79	159	2	80	80	1.0000000
NODE_275840_length_256_cov_2.878981	132	212	1	37	80	0.4625000
NODE_275840_length_256_cov_2.878981	132	212	2	43	80	0.5375000
NODE_275909_length_256_cov_2.598726	157	222	0	65	65	1.0000000
NODE_275909_length_256_cov_2.598726	195	249	0	54	54	1.0000000
NODE_275981_length_256_cov_2.445860	104	183	0	79	79	1.0000000
NODE_276082_length_256_cov_2.229299	0	58	0	58	58	1.0000000
NODE_276082_length_256_cov_2.229299	17	68	0	51	51	1.0000000
NODE_276082_length_256_cov_2.229299	41	88	0	47	47	1.0000000
NODE_276082_length_256_cov_2.229299	42	122	0	80	80	1.0000000
NODE_276098_length_256_cov_2.184713	192	246	0	54	54	1.0000000
NODE_276119_length_256_cov_2.121019	150	236	0	86	86	1.0000000
NODE_276174_length_256_cov_1.974522	130	174	0	44	44	1.0000000
NODE_276471_length_256_cov_1.707006	39	92	0	16	53	0.3018868
NODE_276471_length_256_cov_1.707006	39	92	2	4	53	0.0754717
NODE_276471_length_256_cov_1.707006	39	92	3	22	53	0.4150943
NODE_276471_length_256_cov_1.707006	39	92	4	11	53	0.2075472
NODE_276471_length_256_cov_1.707006	93	135	4	42	42	1.0000000
NODE_276484_length_256_cov_1.700637	107	129	0	22	22	1.0000000
NODE_276495_length_256_cov_1.675159	52	98	0	46	46	1.0000000
NODE_276654_length_256_cov_1.598726	125	202	0	77	77	1.0000000
NODE_276654_length_256_cov_1.598726	178	256	0	78	78	1.0000000
NODE_276672_length_256_cov_1.579618	110	172	0	62	62	1.0000000
NODE_276672_length_256_cov_1.579618	194	239	0	45	45	1.0000000
NODE_276742_length_256_cov_1.464968	112	135	0	23	23	1.0000000
NODE_276826_length_256_cov_1.331210	138	209	0	71	71	1.0000000
NODE_276826_length_256_cov_1.331210	182	240	0	58	58	1.0000000
NODE_277113_length_256_cov_1.299363	88	160	1	39	72	0.5416667
NODE_277113_length_256_cov_1.299363	88	160	2	33	72	0.4583333
NODE_277305_length_256_cov_1.203822	3	43	0	40	40	1.0000000
NODE_277305_length_256_cov_1.203822	16	96	0	80	80	1.0000000
NODE_278934_length_255_cov_73.756410	52	99	4	2	47	0.0425532
NODE_278934_length_255_cov_73.756410	52	99	5	1	47	0.0212766
NODE_278934_length_255_cov_73.756410	52	99	6	3	47	0.0638298
NODE_278934_length_255_cov_73.756410	52	99	16	12	47	0.2553191
NODE_278934_length_255_cov_73.756410	52	99	18	5	47	0.1063830
NODE_278934_length_255_cov_73.756410	52	99	19	2	47	0.0425532
NODE_278934_length_255_cov_73.756410	52	99	20	2	47	0.0425532
NODE_278934_length_255_cov_73.756410	52	99	21	2	47	0.0425532
NODE_278934_length_255_cov_73.756410	52	99	25	18	47	0.3829787
NODE_278934_length_255_cov_73.756410	133	184	26	15	51	0.2941177
NODE_278934_length_255_cov_73.756410	133	184	27	1	51	0.0196078
NODE_278934_length_255_cov_73.756410	133	184	28	9	51	0.1764706
NODE_278934_length_255_cov_73.756410	133	184	29	26	51	0.5098040
NODE_278934_length_255_cov_73.756410	157	237	5	10	80	0.1250000
NODE_278934_length_255_cov_73.756410	157	237	6	1	80	0.0125000
NODE_278934_length_255_cov_73.756410	157	237	7	1	80	0.0125000
NODE_278934_length_255_cov_73.756410	157	237	8	5	80	0.0625000
NODE_278934_length_255_cov_73.756410	157	237	9	6	80	0.0750000
NODE_278934_length_255_cov_73.756410	157	237	10	9	80	0.1125000
NODE_278934_length_255_cov_73.756410	157	237	12	8	80	0.1000000
NODE_278934_length_255_cov_73.756410	157	237	14	7	80	0.0875000
NODE_278934_length_255_cov_73.756410	157	237	16	1	80	0.0125000
NODE_278934_length_255_cov_73.756410	157	237	17	2	80	0.0250000
NODE_278934_length_255_cov_73.756410	157	237	26	17	80	0.2125000
NODE_278934_length_255_cov_73.756410	157	237	27	2	80	0.0250000
NODE_278934_length_255_cov_73.756410	157	237	28	9	80	0.1125000
NODE_278934_length_255_cov_73.756410	157	237	29	2	80	0.0250000
NODE_278937_length_255_cov_15.538462	219	255	0	36	36	1.0000000
NODE_279003_length_255_cov_4.884615	157	230	0	73	73	1.0000000
NODE_279003_length_255_cov_4.884615	203	248	0	45	45	1.0000000
NODE_279058_length_255_cov_4.012821	68	148	0	80	80	1.0000000
NODE_279075_length_255_cov_3.826923	16	80	0	33	64	0.5156250
NODE_279075_length_255_cov_3.826923	16	80	2	31	64	0.4843750
NODE_279102_length_255_cov_3.596154	30	60	0	30	30	1.0000000
NODE_279134_length_255_cov_3.423077	64	109	1	43	45	0.9555556
NODE_279134_length_255_cov_3.423077	64	109	2	2	45	0.0444444
NODE_279166_length_255_cov_3.262821	0	48	0	48	48	1.0000000
NODE_279166_length_255_cov_3.262821	66	113	0	47	47	1.0000000
NODE_279241_length_255_cov_2.942308	157	176	0	19	19	1.0000000
NODE_279320_length_255_cov_2.621795	227	254	0	27	27	1.0000000
NODE_279379_length_255_cov_2.602564	131	185	0	54	54	1.0000000
NODE_279427_length_255_cov_2.487179	43	119	0	76	76	1.0000000
NODE_279447_length_255_cov_2.435897	0	58	0	58	58	1.0000000
NODE_279462_length_255_cov_2.391026	189	255	0	66	66	1.0000000
NODE_279507_length_255_cov_2.288462	0	60	0	60	60	1.0000000
NODE_279510_length_255_cov_2.288462	0	74	0	74	74	1.0000000
NODE_279620_length_255_cov_2.089744	105	145	0	40	40	1.0000000
NODE_279649_length_255_cov_1.987179	0	72	0	72	72	1.0000000
NODE_279842_length_255_cov_1.910256	198	255	0	57	57	1.0000000
NODE_279871_length_255_cov_1.871795	16	68	0	52	52	1.0000000
NODE_279892_length_255_cov_1.826923	146	218	0	72	72	1.0000000
NODE_279956_length_255_cov_1.705128	0	45	3	21	45	0.4666667
NODE_279956_length_255_cov_1.705128	0	45	5	2	45	0.0444444
NODE_279956_length_255_cov_1.705128	0	45	6	22	45	0.4888889
NODE_279956_length_255_cov_1.705128	41	121	6	5	80	0.0625000
NODE_279956_length_255_cov_1.705128	41	121	7	9	80	0.1125000
NODE_279956_length_255_cov_1.705128	41	121	9	14	80	0.1750000
NODE_279956_length_255_cov_1.705128	41	121	12	17	80	0.2125000
NODE_279956_length_255_cov_1.705128	41	121	14	16	80	0.2000000
NODE_279956_length_255_cov_1.705128	41	121	15	3	80	0.0375000
NODE_279956_length_255_cov_1.705128	41	121	17	1	80	0.0125000
NODE_279956_length_255_cov_1.705128	41	121	18	15	80	0.1875000
NODE_279956_length_255_cov_1.705128	94	174	14	8	80	0.1000000
NODE_279956_length_255_cov_1.705128	94	174	15	3	80	0.0375000
NODE_279956_length_255_cov_1.705128	94	174	17	2	80	0.0250000
NODE_279956_length_255_cov_1.705128	94	174	18	18	80	0.2250000
NODE_279956_length_255_cov_1.705128	94	174	20	22	80	0.2750000
NODE_279956_length_255_cov_1.705128	94	174	21	27	80	0.3375000
NODE_280153_length_255_cov_1.576923	43	117	0	74	74	1.0000000
NODE_280153_length_255_cov_1.576923	90	175	0	85	85	1.0000000
NODE_280168_length_255_cov_1.557692	62	125	0	63	63	1.0000000
NODE_280297_length_255_cov_1.358974	178	246	0	68	68	1.0000000
NODE_280904_length_255_cov_1.128205	183	219	0	36	36	1.0000000
NODE_281094_length_255_cov_0.987179	220	241	0	21	21	1.0000000
NODE_281380_length_255_cov_0.955128	119	171	0	52	52	1.0000000
NODE_281384_length_255_cov_0.955128	12	92	0	80	80	1.0000000
NODE_282137_length_255_cov_0.653846	87	106	0	19	19	1.0000000
NODE_282534_length_254_cov_4.935484	144	189	0	45	45	1.0000000
NODE_282534_length_254_cov_4.935484	164	242	0	78	78	1.0000000
NODE_282548_length_254_cov_4.722581	44	85	0	41	41	1.0000000
NODE_282576_length_254_cov_4.296774	149	174	0	25	25	1.0000000
NODE_282576_length_254_cov_4.296774	149	223	0	74	74	1.0000000
NODE_282590_length_254_cov_4.206452	57	86	0	29	29	1.0000000
NODE_282626_length_254_cov_3.677419	7	64	0	57	57	1.0000000
NODE_282626_length_254_cov_3.677419	60	117	0	57	57	1.0000000
NODE_282642_length_254_cov_3.593548	154	197	0	43	43	1.0000000
NODE_282659_length_254_cov_3.438710	82	129	0	47	47	1.0000000
NODE_282659_length_254_cov_3.438710	102	182	0	80	80	1.0000000
NODE_282736_length_254_cov_2.961290	5	79	0	74	74	1.0000000
NODE_282736_length_254_cov_2.961290	52	118	0	66	66	1.0000000
NODE_282771_length_254_cov_2.780645	169	252	0	83	83	1.0000000
NODE_282947_length_254_cov_2.341935	167	201	0	34	34	1.0000000
NODE_283082_length_254_cov_2.161290	14	74	0	60	60	1.0000000
NODE_283244_length_254_cov_1.974194	156	204	0	48	48	1.0000000
NODE_283440_length_254_cov_1.780645	79	126	0	47	47	1.0000000
NODE_283952_length_254_cov_1.316129	23	87	0	64	64	1.0000000
NODE_284013_length_254_cov_1.316129	193	215	0	22	22	1.0000000
NODE_284256_length_254_cov_1.258065	181	249	0	68	68	1.0000000
NODE_284275_length_254_cov_1.238710	9	82	0	73	73	1.0000000
NODE_284275_length_254_cov_1.238710	62	82	0	20	20	1.0000000
NODE_284277_length_254_cov_1.238710	54	73	0	19	19	1.0000000
NODE_284301_length_254_cov_1.219355	98	157	0	59	59	1.0000000
NODE_284638_length_254_cov_0.987097	139	193	0	54	54	1.0000000
NODE_284638_length_254_cov_0.987097	205	254	0	49	49	1.0000000
NODE_284796_length_254_cov_0.987097	121	152	0	31	31	1.0000000
NODE_285963_length_253_cov_60.311688	137	202	0	1	65	0.0153846
NODE_285963_length_253_cov_60.311688	137	202	3	64	65	0.9846154
NODE_285963_length_253_cov_60.311688	175	253	0	5	78	0.0641026
NODE_285963_length_253_cov_60.311688	175	253	2	13	78	0.1666667
NODE_285963_length_253_cov_60.311688	175	253	3	60	78	0.7692308
NODE_285965_length_253_cov_41.519481	0	68	0	2	68	0.0294118
NODE_285965_length_253_cov_41.519481	0	68	2	66	68	0.9705882
NODE_285965_length_253_cov_41.519481	0	70	0	2	70	0.0285714
NODE_285965_length_253_cov_41.519481	0	70	2	68	70	0.9714286
NODE_285965_length_253_cov_41.519481	2	73	2	71	71	1.0000000
NODE_285965_length_253_cov_41.519481	7	73	2	66	66	1.0000000
NODE_285965_length_253_cov_41.519481	46	123	2	77	77	1.0000000
NODE_285965_length_253_cov_41.519481	46	123	2	77	77	1.0000000
NODE_285965_length_253_cov_41.519481	46	123	2	77	77	1.0000000
NODE_285967_length_253_cov_13.967532	25	105	1	12	80	0.1500000
NODE_285967_length_253_cov_13.967532	25	105	2	8	80	0.1000000
NODE_285967_length_253_cov_13.967532	25	105	3	21	80	0.2625000
NODE_285967_length_253_cov_13.967532	25	105	4	39	80	0.4875000
NODE_285967_length_253_cov_13.967532	78	158	4	80	80	1.0000000
NODE_285969_length_253_cov_12.259740	0	54	0	54	54	1.0000000
NODE_285969_length_253_cov_12.259740	27	62	0	35	35	1.0000000
NODE_285969_length_253_cov_12.259740	51	131	0	80	80	1.0000000
NODE_285969_length_253_cov_12.259740	104	139	0	35	35	1.0000000
NODE_285969_length_253_cov_12.259740	128	208	0	80	80	1.0000000
NODE_285969_length_253_cov_12.259740	181	216	0	35	35	1.0000000
NODE_285987_length_253_cov_7.279221	184	250	0	66	66	1.0000000
NODE_286022_length_253_cov_5.376623	66	147	0	81	81	1.0000000
NODE_286022_length_253_cov_5.376623	120	185	0	65	65	1.0000000
NODE_286042_length_253_cov_4.896104	102	182	6	7	80	0.0875000
NODE_286042_length_253_cov_4.896104	102	182	9	32	80	0.4000000
NODE_286042_length_253_cov_4.896104	102	182	10	1	80	0.0125000
NODE_286042_length_253_cov_4.896104	102	182	11	2	80	0.0250000
NODE_286042_length_253_cov_4.896104	102	182	12	38	80	0.4750000
NODE_286046_length_253_cov_4.798701	199	253	0	54	54	1.0000000
NODE_286069_length_253_cov_4.487013	85	126	0	41	41	1.0000000
NODE_286151_length_253_cov_3.500000	44	105	0	61	61	1.0000000
NODE_286151_length_253_cov_3.500000	90	158	0	68	68	1.0000000
NODE_286259_length_253_cov_2.987013	85	165	0	80	80	1.0000000
NODE_286259_length_253_cov_2.987013	138	169	0	31	31	1.0000000
NODE_286275_length_253_cov_2.954545	100	148	0	48	48	1.0000000
NODE_286281_length_253_cov_2.909091	34	99	0	65	65	1.0000000
NODE_286288_length_253_cov_2.889610	129	200	0	71	71	1.0000000
NODE_286288_length_253_cov_2.889610	173	253	0	80	80	1.0000000
NODE_286289_length_253_cov_2.889610	21	76	0	55	55	1.0000000
NODE_286289_length_253_cov_2.889610	149	229	0	80	80	1.0000000
NODE_286379_length_253_cov_2.610390	113	193	0	80	80	1.0000000
NODE_286386_length_253_cov_2.584416	97	154	0	57	57	1.0000000
NODE_286545_length_253_cov_2.240260	185	250	0	65	65	1.0000000
NODE_286667_length_253_cov_1.987013	157	237	0	80	80	1.0000000
NODE_286667_length_253_cov_1.987013	210	253	0	43	43	1.0000000
NODE_286685_length_253_cov_1.987013	18	60	0	42	42	1.0000000
NODE_286829_length_253_cov_1.961039	186	232	0	46	46	1.0000000
NODE_286837_length_253_cov_1.948052	68	120	0	52	52	1.0000000
NODE_286838_length_253_cov_1.948052	63	114	0	51	51	1.0000000
NODE_286947_length_253_cov_1.746753	164	193	0	29	29	1.0000000
NODE_287031_length_253_cov_1.655844	40	120	0	80	80	1.0000000
NODE_287031_length_253_cov_1.655844	93	152	0	59	59	1.0000000
NODE_287133_length_253_cov_1.590909	102	148	0	46	46	1.0000000
NODE_287156_length_253_cov_1.558442	67	149	0	82	82	1.0000000
NODE_287230_length_253_cov_1.441558	49	113	0	64	64	1.0000000
NODE_287230_length_253_cov_1.441558	102	166	0	64	64	1.0000000
NODE_287232_length_253_cov_1.441558	121	185	0	64	64	1.0000000
NODE_287234_length_253_cov_1.435065	50	81	0	31	31	1.0000000
NODE_287584_length_253_cov_1.324675	193	239	0	46	46	1.0000000
NODE_287599_length_253_cov_1.324675	90	132	0	42	42	1.0000000
NODE_287599_length_253_cov_1.324675	133	185	0	52	52	1.0000000
NODE_287721_length_253_cov_1.285714	87	125	0	38	38	1.0000000
NODE_287794_length_253_cov_1.214286	99	148	0	49	49	1.0000000
NODE_287845_length_253_cov_1.181818	185	247	0	62	62	1.0000000
NODE_287845_length_253_cov_1.181818	185	247	0	62	62	1.0000000
NODE_287989_length_253_cov_1.064935	83	159	0	38	76	0.5000000
NODE_287989_length_253_cov_1.064935	83	159	2	38	76	0.5000000
NODE_288099_length_253_cov_0.993506	0	44	0	44	44	1.0000000
NODE_288465_length_253_cov_0.870130	17	46	0	29	29	1.0000000
NODE_288478_length_253_cov_0.850649	0	89	0	89	89	1.0000000
NODE_289563_length_252_cov_4.771242	94	148	0	54	54	1.0000000
NODE_289574_length_252_cov_4.614379	16	37	0	21	21	1.0000000
NODE_289624_length_252_cov_3.960784	7	85	0	78	78	1.0000000
NODE_289624_length_252_cov_3.960784	63	136	0	73	73	1.0000000
NODE_289663_length_252_cov_3.549020	89	157	0	68	68	1.0000000
NODE_289672_length_252_cov_3.405229	26	107	0	81	81	1.0000000
NODE_289705_length_252_cov_3.307190	91	141	0	50	50	1.0000000
NODE_289742_length_252_cov_3.032680	135	212	0	77	77	1.0000000
NODE_289775_length_252_cov_2.928105	0	57	0	57	57	1.0000000
NODE_289799_length_252_cov_2.803922	41	121	0	80	80	1.0000000
NODE_290032_length_252_cov_2.320261	0	64	0	64	64	1.0000000
NODE_290046_length_252_cov_2.281046	120	170	0	50	50	1.0000000
NODE_290066_length_252_cov_2.215686	137	175	0	7	38	0.1842105
NODE_290066_length_252_cov_2.215686	137	175	1	31	38	0.8157895
NODE_290103_length_252_cov_2.052288	18	39	0	21	21	1.0000000
NODE_290238_length_252_cov_1.993464	80	139	0	59	59	1.0000000
NODE_290385_length_252_cov_1.810458	3	49	0	46	46	1.0000000
NODE_290623_length_252_cov_1.594771	103	156	0	53	53	1.0000000
NODE_290623_length_252_cov_1.594771	152	192	0	40	40	1.0000000
NODE_290638_length_252_cov_1.568627	1	68	0	67	67	1.0000000
NODE_290767_length_252_cov_1.359477	26	93	0	67	67	1.0000000
NODE_290790_length_252_cov_1.333333	179	232	0	53	53	1.0000000
NODE_290850_length_252_cov_1.333333	187	222	0	35	35	1.0000000
NODE_291072_length_252_cov_1.333333	31	111	0	80	80	1.0000000
NODE_291076_length_252_cov_1.333333	90	140	0	50	50	1.0000000
NODE_291118_length_252_cov_1.326797	112	143	0	31	31	1.0000000
NODE_291351_length_252_cov_1.156863	1	32	0	31	31	1.0000000
NODE_291650_length_252_cov_1.000000	49	79	0	30	30	1.0000000
NODE_291911_length_252_cov_0.836601	125	172	0	47	47	1.0000000
NODE_293004_length_251_cov_5.032895	0	62	0	62	62	1.0000000
NODE_293005_length_251_cov_5.026316	84	164	0	49	80	0.6125000
NODE_293005_length_251_cov_5.026316	84	164	3	31	80	0.3875000
NODE_293165_length_251_cov_3.302632	187	249	0	62	62	1.0000000
NODE_293195_length_251_cov_3.131579	96	148	0	52	52	1.0000000
NODE_293238_length_251_cov_2.980263	11	38	1	9	27	0.3333333
NODE_293238_length_251_cov_2.980263	11	38	2	18	27	0.6666667
NODE_293238_length_251_cov_2.980263	11	91	1	9	80	0.1125000
NODE_293238_length_251_cov_2.980263	11	91	2	71	80	0.8875000
NODE_293259_length_251_cov_2.842105	170	198	0	28	28	1.0000000
NODE_293279_length_251_cov_2.743421	181	232	0	51	51	1.0000000
NODE_293335_length_251_cov_2.677632	35	54	0	19	19	1.0000000
NODE_293454_length_251_cov_2.348684	196	251	0	55	55	1.0000000
NODE_293502_length_251_cov_2.328947	86	149	0	63	63	1.0000000
NODE_293516_length_251_cov_2.296053	91	171	2	80	80	1.0000000
NODE_293516_length_251_cov_2.296053	144	224	2	80	80	1.0000000
NODE_293591_length_251_cov_2.065789	7	52	0	45	45	1.0000000
NODE_293698_length_251_cov_2.013158	96	179	0	83	83	1.0000000
NODE_293698_length_251_cov_2.013158	96	179	0	83	83	1.0000000
NODE_293698_length_251_cov_2.013158	152	203	0	51	51	1.0000000
NODE_293698_length_251_cov_2.013158	152	201	0	49	49	1.0000000
NODE_293919_length_251_cov_1.710526	135	194	0	59	59	1.0000000
NODE_294028_length_251_cov_1.671053	94	127	0	33	33	1.0000000
NODE_294063_length_251_cov_1.644737	135	164	0	29	29	1.0000000
NODE_294147_length_251_cov_1.473684	137	202	0	65	65	1.0000000
NODE_294153_length_251_cov_1.460526	17	78	0	61	61	1.0000000
NODE_294190_length_251_cov_1.407895	182	246	0	64	64	1.0000000
NODE_294393_length_251_cov_1.342105	9	89	0	80	80	1.0000000
NODE_294393_length_251_cov_1.342105	62	91	0	29	29	1.0000000
NODE_294624_length_251_cov_1.296053	7	47	0	40	40	1.0000000
NODE_294624_length_251_cov_1.296053	24	47	0	23	23	1.0000000
NODE_295165_length_251_cov_1.006579	4	50	0	46	46	1.0000000
NODE_296033_length_251_cov_0.671053	184	204	0	20	20	1.0000000
NODE_296386_length_251_cov_0.572368	54	74	0	20	20	1.0000000
NODE_296437_length_250_cov_35.662252	33	99	0	66	66	1.0000000
NODE_296437_length_250_cov_35.662252	143	223	0	80	80	1.0000000
NODE_296456_length_250_cov_6.503311	186	250	0	64	64	1.0000000
NODE_296467_length_250_cov_5.867550	99	120	0	21	21	1.0000000
NODE_296520_length_250_cov_4.662252	143	187	0	44	44	1.0000000
NODE_296520_length_250_cov_4.662252	160	227	0	67	67	1.0000000
NODE_296598_length_250_cov_3.715232	37	90	0	53	53	1.0000000
NODE_296633_length_250_cov_3.417219	113	193	0	80	80	1.0000000
NODE_296633_length_250_cov_3.417219	166	246	0	80	80	1.0000000
NODE_296653_length_250_cov_3.364238	0	61	0	61	61	1.0000000
NODE_296653_length_250_cov_3.364238	34	94	0	60	60	1.0000000
NODE_296680_length_250_cov_3.225166	157	209	0	52	52	1.0000000
NODE_296680_length_250_cov_3.225166	182	250	0	68	68	1.0000000
NODE_296699_length_250_cov_3.086093	33	67	0	34	34	1.0000000
NODE_296703_length_250_cov_3.052980	29	94	0	65	65	1.0000000
NODE_296707_length_250_cov_3.039735	51	106	0	55	55	1.0000000
NODE_296737_length_250_cov_2.986755	124	185	0	61	61	1.0000000
NODE_296737_length_250_cov_2.986755	172	243	0	71	71	1.0000000
NODE_296885_length_250_cov_2.516556	0	49	0	49	49	1.0000000
NODE_296893_length_250_cov_2.476821	94	174	0	80	80	1.0000000
NODE_296893_length_250_cov_2.476821	147	227	0	80	80	1.0000000
NODE_296897_length_250_cov_2.470199	166	212	1	46	46	1.0000000
NODE_297070_length_250_cov_2.059603	150	207	0	57	57	1.0000000
NODE_297211_length_250_cov_2.019868	74	141	5	67	67	1.0000000
NODE_297211_length_250_cov_2.019868	158	204	3	34	46	0.7391304
NODE_297211_length_250_cov_2.019868	158	204	5	12	46	0.2608696
NODE_297550_length_250_cov_1.688742	6	42	0	36	36	1.0000000
NODE_297624_length_250_cov_1.635762	150	191	0	41	41	1.0000000
NODE_297679_length_250_cov_1.529801	59	108	0	49	49	1.0000000
NODE_297679_length_250_cov_1.529801	81	161	0	80	80	1.0000000
NODE_297693_length_250_cov_1.516556	124	184	0	60	60	1.0000000
NODE_297693_length_250_cov_1.516556	166	237	0	71	71	1.0000000
NODE_297762_length_250_cov_1.377483	0	80	0	80	80	1.0000000
NODE_297963_length_250_cov_1.350993	40	98	0	58	58	1.0000000
NODE_298213_length_250_cov_1.291391	116	196	2	80	80	1.0000000
NODE_298719_length_250_cov_1.013245	126	163	0	37	37	1.0000000
NODE_298794_length_250_cov_1.006623	129	148	0	19	19	1.0000000
NODE_298900_length_250_cov_0.920530	126	178	0	52	52	1.0000000
NODE_299979_length_249_cov_55.413333	97	172	0	75	75	1.0000000
NODE_299979_length_249_cov_55.413333	150	225	0	75	75	1.0000000
NODE_300012_length_247_cov_51.243243	172	247	0	75	75	1.0000000
NODE_300014_length_247_cov_37.614865	156	239	0	1	83	0.0120482
NODE_300014_length_247_cov_37.614865	156	239	1	30	83	0.3614458
NODE_300014_length_247_cov_37.614865	156	239	2	37	83	0.4457831
NODE_300014_length_247_cov_37.614865	156	239	3	15	83	0.1807229
NODE_300056_length_245_cov_40.876712	138	202	7	4	64	0.0625000
NODE_300056_length_245_cov_40.876712	138	202	8	1	64	0.0156250
NODE_300056_length_245_cov_40.876712	138	202	9	48	64	0.7500000
NODE_300056_length_245_cov_40.876712	138	202	10	1	64	0.0156250
NODE_300056_length_245_cov_40.876712	138	202	13	2	64	0.0312500
NODE_300056_length_245_cov_40.876712	138	202	15	2	64	0.0312500
NODE_300056_length_245_cov_40.876712	138	202	16	6	64	0.0937500
NODE_300056_length_245_cov_40.876712	138	202	7	4	64	0.0625000
NODE_300056_length_245_cov_40.876712	138	202	8	1	64	0.0156250
NODE_300056_length_245_cov_40.876712	138	202	9	48	64	0.7500000
NODE_300056_length_245_cov_40.876712	138	202	10	1	64	0.0156250
NODE_300056_length_245_cov_40.876712	138	202	13	2	64	0.0312500
NODE_300056_length_245_cov_40.876712	138	202	15	2	64	0.0312500
NODE_300056_length_245_cov_40.876712	138	202	16	6	64	0.0937500
NODE_300056_length_245_cov_40.876712	138	202	7	4	64	0.0625000
NODE_300056_length_245_cov_40.876712	138	202	8	1	64	0.0156250
NODE_300056_length_245_cov_40.876712	138	202	9	48	64	0.7500000
NODE_300056_length_245_cov_40.876712	138	202	10	1	64	0.0156250
NODE_300056_length_245_cov_40.876712	138	202	13	2	64	0.0312500
NODE_300056_length_245_cov_40.876712	138	202	15	2	64	0.0312500
NODE_300056_length_245_cov_40.876712	138	202	16	6	64	0.0937500
NODE_300056_length_245_cov_40.876712	175	241	4	25	66	0.3787879
NODE_300056_length_245_cov_40.876712	175	241	5	4	66	0.0606061
NODE_300056_length_245_cov_40.876712	175	241	6	4	66	0.0606061
NODE_300056_length_245_cov_40.876712	175	241	7	10	66	0.1515152
NODE_300056_length_245_cov_40.876712	175	241	8	1	66	0.0151515
NODE_300056_length_245_cov_40.876712	175	241	9	22	66	0.3333333
NODE_300147_length_240_cov_80.744681	167	238	0	41	71	0.5774648
NODE_300147_length_240_cov_80.744681	167	238	1	17	71	0.2394366
NODE_300147_length_240_cov_80.744681	167	238	2	13	71	0.1830986
NODE_300148_length_240_cov_38.035461	31	82	4	51	51	1.0000000
NODE_300165_length_239_cov_72.878571	0	48	0	7	48	0.1458333
NODE_300165_length_239_cov_72.878571	0	48	1	13	48	0.2708333
NODE_300165_length_239_cov_72.878571	0	48	3	22	48	0.4583333
NODE_300165_length_239_cov_72.878571	0	48	4	6	48	0.1250000
NODE_300165_length_239_cov_72.878571	21	101	3	21	80	0.2625000
NODE_300165_length_239_cov_72.878571	21	101	4	8	80	0.1000000
NODE_300165_length_239_cov_72.878571	21	101	5	51	80	0.6375000
NODE_300165_length_239_cov_72.878571	150	230	0	30	80	0.3750000
NODE_300165_length_239_cov_72.878571	150	230	1	8	80	0.1000000
NODE_300165_length_239_cov_72.878571	150	230	2	35	80	0.4375000
NODE_300165_length_239_cov_72.878571	150	230	3	7	80	0.0875000
NODE_300165_length_239_cov_72.878571	150	230	0	30	80	0.3750000
NODE_300165_length_239_cov_72.878571	150	230	1	8	80	0.1000000
NODE_300165_length_239_cov_72.878571	150	230	2	35	80	0.4375000
NODE_300165_length_239_cov_72.878571	150	230	3	7	80	0.0875000
NODE_300165_length_239_cov_72.878571	150	212	0	12	62	0.1935484
NODE_300165_length_239_cov_72.878571	150	212	1	8	62	0.1290323
NODE_300165_length_239_cov_72.878571	150	212	2	35	62	0.5645161
NODE_300165_length_239_cov_72.878571	150	212	3	7	62	0.1129032
NODE_300165_length_239_cov_72.878571	150	221	0	21	71	0.2957746
NODE_300165_length_239_cov_72.878571	150	221	1	8	71	0.1126761
NODE_300165_length_239_cov_72.878571	150	221	2	35	71	0.4929577
NODE_300165_length_239_cov_72.878571	150	221	3	7	71	0.0985916
NODE_300208_length_238_cov_385.683453	35	104	30	2	69	0.0289855
NODE_300208_length_238_cov_385.683453	35	104	31	2	69	0.0289855
NODE_300208_length_238_cov_385.683453	35	104	33	2	69	0.0289855
NODE_300208_length_238_cov_385.683453	35	104	34	5	69	0.0724638
NODE_300208_length_238_cov_385.683453	35	104	35	1	69	0.0144928
NODE_300208_length_238_cov_385.683453	35	104	36	3	69	0.0434783
NODE_300208_length_238_cov_385.683453	35	104	37	5	69	0.0724638
NODE_300208_length_238_cov_385.683453	35	104	38	2	69	0.0289855
NODE_300208_length_238_cov_385.683453	35	104	42	2	69	0.0289855
NODE_300208_length_238_cov_385.683453	35	104	43	1	69	0.0144928
NODE_300208_length_238_cov_385.683453	35	104	44	5	69	0.0724638
NODE_300208_length_238_cov_385.683453	35	104	49	2	69	0.0289855
NODE_300208_length_238_cov_385.683453	35	104	50	2	69	0.0289855
NODE_300208_length_238_cov_385.683453	35	104	52	3	69	0.0434783
NODE_300208_length_238_cov_385.683453	35	104	54	2	69	0.0289855
NODE_300208_length_238_cov_385.683453	35	104	58	3	69	0.0434783
NODE_300208_length_238_cov_385.683453	35	104	59	10	69	0.1449275
NODE_300208_length_238_cov_385.683453	35	104	60	6	69	0.0869565
NODE_300208_length_238_cov_385.683453	35	104	61	6	69	0.0869565
NODE_300208_length_238_cov_385.683453	35	104	64	2	69	0.0289855
NODE_300208_length_238_cov_385.683453	35	104	66	3	69	0.0434783
NODE_300225_length_237_cov_101.543478	83	163	3	15	80	0.1875000
NODE_300225_length_237_cov_101.543478	83	163	12	65	80	0.8125000
NODE_300225_length_237_cov_101.543478	83	163	3	15	80	0.1875000
NODE_300225_length_237_cov_101.543478	83	163	12	65	80	0.8125000
NODE_300225_length_237_cov_101.543478	83	163	3	15	80	0.1875000
NODE_300225_length_237_cov_101.543478	83	163	12	65	80	0.8125000
NODE_300225_length_237_cov_101.543478	83	163	3	15	80	0.1875000
NODE_300225_length_237_cov_101.543478	83	163	12	65	80	0.8125000
NODE_300225_length_237_cov_101.543478	136	216	9	4	80	0.0500000
NODE_300225_length_237_cov_101.543478	136	216	10	44	80	0.5500000
NODE_300225_length_237_cov_101.543478	136	216	11	5	80	0.0625000
NODE_300225_length_237_cov_101.543478	136	216	12	27	80	0.3375000
NODE_300225_length_237_cov_101.543478	136	216	9	4	80	0.0500000
NODE_300225_length_237_cov_101.543478	136	216	10	44	80	0.5500000
NODE_300225_length_237_cov_101.543478	136	216	11	5	80	0.0625000
NODE_300225_length_237_cov_101.543478	136	216	12	27	80	0.3375000
NODE_300225_length_237_cov_101.543478	136	216	9	4	80	0.0500000
NODE_300225_length_237_cov_101.543478	136	216	10	44	80	0.5500000
NODE_300225_length_237_cov_101.543478	136	216	11	5	80	0.0625000
NODE_300225_length_237_cov_101.543478	136	216	12	27	80	0.3375000
NODE_300225_length_237_cov_101.543478	138	216	9	4	78	0.0512821
NODE_300225_length_237_cov_101.543478	138	216	10	44	78	0.5641026
NODE_300225_length_237_cov_101.543478	138	216	11	5	78	0.0641026
NODE_300225_length_237_cov_101.543478	138	216	12	25	78	0.3205128
NODE_300225_length_237_cov_101.543478	138	216	9	4	78	0.0512821
NODE_300225_length_237_cov_101.543478	138	216	10	44	78	0.5641026
NODE_300225_length_237_cov_101.543478	138	216	11	5	78	0.0641026
NODE_300225_length_237_cov_101.543478	138	216	12	25	78	0.3205128
NODE_300227_length_237_cov_49.623188	13	88	4	12	75	0.1600000
NODE_300227_length_237_cov_49.623188	13	88	5	6	75	0.0800000
NODE_300227_length_237_cov_49.623188	13	88	6	12	75	0.1600000
NODE_300227_length_237_cov_49.623188	13	88	7	17	75	0.2266667
NODE_300227_length_237_cov_49.623188	13	88	9	2	75	0.0266667
NODE_300227_length_237_cov_49.623188	13	88	10	26	75	0.3466667
NODE_300227_length_237_cov_49.623188	73	153	7	11	80	0.1375000
NODE_300227_length_237_cov_49.623188	73	153	9	8	80	0.1000000
NODE_300227_length_237_cov_49.623188	73	153	10	61	80	0.7625000
NODE_300227_length_237_cov_49.623188	126	206	3	13	80	0.1625000
NODE_300227_length_237_cov_49.623188	126	206	4	12	80	0.1500000
NODE_300227_length_237_cov_49.623188	126	206	5	6	80	0.0750000
NODE_300227_length_237_cov_49.623188	126	206	6	18	80	0.2250000
NODE_300227_length_237_cov_49.623188	126	206	7	15	80	0.1875000
NODE_300227_length_237_cov_49.623188	126	206	9	8	80	0.1000000
NODE_300227_length_237_cov_49.623188	126	206	10	8	80	0.1000000
NODE_300289_length_235_cov_67.904412	0	62	0	62	62	1.0000000
NODE_300289_length_235_cov_67.904412	25	111	0	86	86	1.0000000
NODE_300289_length_235_cov_67.904412	69	150	0	81	81	1.0000000
NODE_300289_length_235_cov_67.904412	113	194	0	81	81	1.0000000
NODE_300289_length_235_cov_67.904412	157	235	0	78	78	1.0000000
NODE_300322_length_234_cov_76.496296	0	76	0	76	76	1.0000000
NODE_300322_length_234_cov_76.496296	0	76	0	76	76	1.0000000
NODE_300322_length_234_cov_76.496296	0	76	0	76	76	1.0000000
NODE_300322_length_234_cov_76.496296	0	76	0	76	76	1.0000000
NODE_300322_length_234_cov_76.496296	49	128	0	79	79	1.0000000
NODE_300322_length_234_cov_76.496296	49	128	0	79	79	1.0000000
NODE_300322_length_234_cov_76.496296	124	204	0	80	80	1.0000000
NODE_300322_length_234_cov_76.496296	124	204	0	80	80	1.0000000
NODE_300322_length_234_cov_76.496296	124	204	0	80	80	1.0000000
NODE_300322_length_234_cov_76.496296	177	226	0	49	49	1.0000000
NODE_300322_length_234_cov_76.496296	177	234	0	57	57	1.0000000
NODE_300322_length_234_cov_76.496296	182	234	0	52	52	1.0000000
NODE_300323_length_234_cov_71.548148	90	162	2	72	72	1.0000000
NODE_300323_length_234_cov_71.548148	90	162	2	72	72	1.0000000
NODE_300323_length_234_cov_71.548148	135	215	0	14	80	0.1750000
NODE_300323_length_234_cov_71.548148	135	215	1	27	80	0.3375000
NODE_300323_length_234_cov_71.548148	135	215	2	39	80	0.4875000
NODE_300323_length_234_cov_71.548148	135	215	0	14	80	0.1750000
NODE_300323_length_234_cov_71.548148	135	215	1	27	80	0.3375000
NODE_300323_length_234_cov_71.548148	135	215	2	39	80	0.4875000
NODE_300357_length_233_cov_180.701493	0	65	1	2	65	0.0307692
NODE_300357_length_233_cov_180.701493	0	65	2	2	65	0.0307692
NODE_300357_length_233_cov_180.701493	0	65	4	9	65	0.1384615
NODE_300357_length_233_cov_180.701493	0	65	5	4	65	0.0615385
NODE_300357_length_233_cov_180.701493	0	65	6	3	65	0.0461538
NODE_300357_length_233_cov_180.701493	0	65	7	2	65	0.0307692
NODE_300357_length_233_cov_180.701493	0	65	9	12	65	0.1846154
NODE_300357_length_233_cov_180.701493	0	65	10	1	65	0.0153846
NODE_300357_length_233_cov_180.701493	0	65	11	6	65	0.0923077
NODE_300357_length_233_cov_180.701493	0	65	12	1	65	0.0153846
NODE_300357_length_233_cov_180.701493	0	65	13	10	65	0.1538462
NODE_300357_length_233_cov_180.701493	0	65	14	10	65	0.1538462
NODE_300357_length_233_cov_180.701493	0	65	15	3	65	0.0461538
NODE_300357_length_233_cov_180.701493	38	118	11	3	80	0.0375000
NODE_300357_length_233_cov_180.701493	38	118	12	1	80	0.0125000
NODE_300357_length_233_cov_180.701493	38	118	13	10	80	0.1250000
NODE_300357_length_233_cov_180.701493	38	118	14	10	80	0.1250000
NODE_300357_length_233_cov_180.701493	38	118	15	28	80	0.3500000
NODE_300357_length_233_cov_180.701493	38	118	16	28	80	0.3500000
NODE_300392_length_232_cov_132.045113	53	133	5	1	80	0.0125000
NODE_300392_length_232_cov_132.045113	53	133	6	2	80	0.0250000
NODE_300392_length_232_cov_132.045113	53	133	7	8	80	0.1000000
NODE_300392_length_232_cov_132.045113	53	133	9	32	80	0.4000000
NODE_300392_length_232_cov_132.045113	53	133	12	8	80	0.1000000
NODE_300392_length_232_cov_132.045113	53	133	13	29	80	0.3625000
NODE_300392_length_232_cov_132.045113	106	186	11	11	80	0.1375000
NODE_300392_length_232_cov_132.045113	106	186	12	21	80	0.2625000
NODE_300392_length_232_cov_132.045113	106	186	13	48	80	0.6000000
NODE_300471_length_230_cov_34.427481	0	59	0	59	59	1.0000000
NODE_300471_length_230_cov_34.427481	0	59	0	59	59	1.0000000
NODE_300471_length_230_cov_34.427481	10	59	0	49	49	1.0000000
NODE_300487_length_229_cov_76.907692	94	176	0	82	82	1.0000000
NODE_300523_length_228_cov_127.131783	0	76	0	22	76	0.2894737
NODE_300523_length_228_cov_127.131783	0	76	1	53	76	0.6973684
NODE_300523_length_228_cov_127.131783	0	76	3	1	76	0.0131579
NODE_300523_length_228_cov_127.131783	5	76	0	17	71	0.2394366
NODE_300523_length_228_cov_127.131783	5	76	1	53	71	0.7464789
NODE_300523_length_228_cov_127.131783	5	76	3	1	71	0.0140845
NODE_300523_length_228_cov_127.131783	10	76	0	12	66	0.1818182
NODE_300523_length_228_cov_127.131783	10	76	1	53	66	0.8030303
NODE_300523_length_228_cov_127.131783	10	76	3	1	66	0.0151515
NODE_300523_length_228_cov_127.131783	49	129	1	26	80	0.3250000
NODE_300523_length_228_cov_127.131783	49	129	3	30	80	0.3750000
NODE_300523_length_228_cov_127.131783	49	129	4	24	80	0.3000000
NODE_300523_length_228_cov_127.131783	49	129	1	26	80	0.3250000
NODE_300523_length_228_cov_127.131783	49	129	3	30	80	0.3750000
NODE_300523_length_228_cov_127.131783	49	129	4	24	80	0.3000000
NODE_300523_length_228_cov_127.131783	49	129	1	26	80	0.3250000
NODE_300523_length_228_cov_127.131783	49	129	3	30	80	0.3750000
NODE_300523_length_228_cov_127.131783	49	129	4	24	80	0.3000000
NODE_300523_length_228_cov_127.131783	125	205	3	33	80	0.4125000
NODE_300523_length_228_cov_127.131783	125	205	4	47	80	0.5875000
NODE_300523_length_228_cov_127.131783	125	205	3	33	80	0.4125000
NODE_300523_length_228_cov_127.131783	125	205	4	47	80	0.5875000
NODE_300523_length_228_cov_127.131783	125	205	3	33	80	0.4125000
NODE_300523_length_228_cov_127.131783	125	205	4	47	80	0.5875000
NODE_300523_length_228_cov_127.131783	178	228	1	3	50	0.0600000
NODE_300523_length_228_cov_127.131783	178	228	2	1	50	0.0200000
NODE_300523_length_228_cov_127.131783	178	228	3	46	50	0.9200000
NODE_300523_length_228_cov_127.131783	178	228	1	3	50	0.0600000
NODE_300523_length_228_cov_127.131783	178	228	2	1	50	0.0200000
NODE_300523_length_228_cov_127.131783	178	228	3	46	50	0.9200000
NODE_300523_length_228_cov_127.131783	178	228	1	3	50	0.0600000
NODE_300523_length_228_cov_127.131783	178	228	2	1	50	0.0200000
NODE_300523_length_228_cov_127.131783	178	228	3	46	50	0.9200000
NODE_300524_length_228_cov_94.255814	34	99	0	5	65	0.0769231
NODE_300524_length_228_cov_94.255814	34	99	1	49	65	0.7538462
NODE_300524_length_228_cov_94.255814	34	99	2	1	65	0.0153846
NODE_300524_length_228_cov_94.255814	34	99	14	10	65	0.1538462
NODE_300524_length_228_cov_94.255814	34	114	0	5	80	0.0625000
NODE_300524_length_228_cov_94.255814	34	114	1	49	80	0.6125000
NODE_300524_length_228_cov_94.255814	34	114	2	1	80	0.0125000
NODE_300524_length_228_cov_94.255814	34	114	14	11	80	0.1375000
NODE_300524_length_228_cov_94.255814	34	114	16	14	80	0.1750000
NODE_300524_length_228_cov_94.255814	41	111	1	47	70	0.6714286
NODE_300524_length_228_cov_94.255814	41	111	2	1	70	0.0142857
NODE_300524_length_228_cov_94.255814	41	111	14	11	70	0.1571429
NODE_300524_length_228_cov_94.255814	41	111	16	11	70	0.1571429
NODE_300524_length_228_cov_94.255814	43	114	1	45	71	0.6338028
NODE_300524_length_228_cov_94.255814	43	114	2	1	71	0.0140845
NODE_300524_length_228_cov_94.255814	43	114	14	11	71	0.1549296
NODE_300524_length_228_cov_94.255814	43	114	16	14	71	0.1971831
NODE_300524_length_228_cov_94.255814	87	167	1	1	80	0.0125000
NODE_300524_length_228_cov_94.255814	87	167	2	1	80	0.0125000
NODE_300524_length_228_cov_94.255814	87	167	14	11	80	0.1375000
NODE_300524_length_228_cov_94.255814	87	167	16	17	80	0.2125000
NODE_300524_length_228_cov_94.255814	87	167	17	50	80	0.6250000
NODE_300524_length_228_cov_94.255814	87	167	1	1	80	0.0125000
NODE_300524_length_228_cov_94.255814	87	167	2	1	80	0.0125000
NODE_300524_length_228_cov_94.255814	87	167	14	11	80	0.1375000
NODE_300524_length_228_cov_94.255814	87	167	16	17	80	0.2125000
NODE_300524_length_228_cov_94.255814	87	167	17	50	80	0.6250000
NODE_300524_length_228_cov_94.255814	87	167	1	1	80	0.0125000
NODE_300524_length_228_cov_94.255814	87	167	2	1	80	0.0125000
NODE_300524_length_228_cov_94.255814	87	167	14	11	80	0.1375000
NODE_300524_length_228_cov_94.255814	87	167	16	17	80	0.2125000
NODE_300524_length_228_cov_94.255814	87	167	17	50	80	0.6250000
NODE_300524_length_228_cov_94.255814	87	167	1	1	80	0.0125000
NODE_300524_length_228_cov_94.255814	87	167	2	1	80	0.0125000
NODE_300524_length_228_cov_94.255814	87	167	14	11	80	0.1375000
NODE_300524_length_228_cov_94.255814	87	167	16	17	80	0.2125000
NODE_300524_length_228_cov_94.255814	87	167	17	50	80	0.6250000
NODE_300547_length_228_cov_0.395349	27	107	0	80	80	1.0000000
NODE_300547_length_228_cov_0.395349	70	150	0	80	80	1.0000000
NODE_300556_length_227_cov_37.429688	40	111	1	71	71	1.0000000
NODE_300556_length_227_cov_37.429688	49	112	1	63	63	1.0000000
NODE_300556_length_227_cov_37.429688	93	172	0	3	79	0.0379747
NODE_300556_length_227_cov_37.429688	93	172	1	76	79	0.9620253
NODE_300556_length_227_cov_37.429688	168	227	0	58	59	0.9830508
NODE_300556_length_227_cov_37.429688	168	227	1	1	59	0.0169492
NODE_300556_length_227_cov_37.429688	168	227	0	58	59	0.9830508
NODE_300556_length_227_cov_37.429688	168	227	1	1	59	0.0169492
NODE_300595_length_226_cov_547.629921	82	162	49	5	80	0.0625000
NODE_300595_length_226_cov_547.629921	82	162	50	1	80	0.0125000
NODE_300595_length_226_cov_547.629921	82	162	51	10	80	0.1250000
NODE_300595_length_226_cov_547.629921	82	162	52	4	80	0.0500000
NODE_300595_length_226_cov_547.629921	82	162	53	2	80	0.0250000
NODE_300595_length_226_cov_547.629921	82	162	55	1	80	0.0125000
NODE_300595_length_226_cov_547.629921	82	162	57	16	80	0.2000000
NODE_300595_length_226_cov_547.629921	82	162	58	9	80	0.1125000
NODE_300595_length_226_cov_547.629921	82	162	59	5	80	0.0625000
NODE_300595_length_226_cov_547.629921	82	162	60	27	80	0.3375000
NODE_300617_length_225_cov_41.269841	81	165	0	84	84	1.0000000
NODE_300617_length_225_cov_41.269841	134	218	0	84	84	1.0000000
NODE_300661_length_224_cov_209.528000	12	84	7	26	72	0.3611111
NODE_300661_length_224_cov_209.528000	12	84	8	15	72	0.2083333
NODE_300661_length_224_cov_209.528000	12	84	10	17	72	0.2361111
NODE_300661_length_224_cov_209.528000	12	84	12	14	72	0.1944444
NODE_300663_length_224_cov_146.568000	13	72	1	21	59	0.3559322
NODE_300663_length_224_cov_146.568000	13	72	2	19	59	0.3220339
NODE_300663_length_224_cov_146.568000	13	72	4	19	59	0.3220339
NODE_300663_length_224_cov_146.568000	46	72	2	7	26	0.2692308
NODE_300663_length_224_cov_146.568000	46	72	4	19	26	0.7307692
NODE_300663_length_224_cov_146.568000	68	120	4	52	52	1.0000000
NODE_300665_length_224_cov_59.088000	98	178	1	17	80	0.2125000
NODE_300665_length_224_cov_59.088000	98	178	2	5	80	0.0625000
NODE_300665_length_224_cov_59.088000	98	178	3	4	80	0.0500000
NODE_300665_length_224_cov_59.088000	98	178	4	54	80	0.6750000
NODE_300665_length_224_cov_59.088000	98	178	1	17	80	0.2125000
NODE_300665_length_224_cov_59.088000	98	178	2	5	80	0.0625000
NODE_300665_length_224_cov_59.088000	98	178	3	4	80	0.0500000
NODE_300665_length_224_cov_59.088000	98	178	4	54	80	0.6750000
NODE_300665_length_224_cov_59.088000	98	178	1	17	80	0.2125000
NODE_300665_length_224_cov_59.088000	98	178	2	5	80	0.0625000
NODE_300665_length_224_cov_59.088000	98	178	3	4	80	0.0500000
NODE_300665_length_224_cov_59.088000	98	178	4	54	80	0.6750000
NODE_300665_length_224_cov_59.088000	151	217	0	2	66	0.0303030
NODE_300665_length_224_cov_59.088000	151	217	1	54	66	0.8181818
NODE_300665_length_224_cov_59.088000	151	217	2	5	66	0.0757576
NODE_300665_length_224_cov_59.088000	151	217	3	4	66	0.0606061
NODE_300665_length_224_cov_59.088000	151	217	4	1	66	0.0151515
NODE_300665_length_224_cov_59.088000	151	224	0	9	73	0.1232877
NODE_300665_length_224_cov_59.088000	151	224	1	54	73	0.7397260
NODE_300665_length_224_cov_59.088000	151	224	2	5	73	0.0684932
NODE_300665_length_224_cov_59.088000	151	224	3	4	73	0.0547945
NODE_300665_length_224_cov_59.088000	151	224	4	1	73	0.0136986
NODE_300667_length_224_cov_43.640000	98	157	0	59	59	1.0000000
NODE_300667_length_224_cov_43.640000	98	157	0	59	59	1.0000000
NODE_300667_length_224_cov_43.640000	106	157	0	51	51	1.0000000
NODE_300669_length_224_cov_36.224000	100	171	0	71	71	1.0000000
NODE_300669_length_224_cov_36.224000	151	224	0	73	73	1.0000000
NODE_300696_length_223_cov_35.814516	0	54	3	1	54	0.0185185
NODE_300696_length_223_cov_35.814516	0	54	4	46	54	0.8518519
NODE_300696_length_223_cov_35.814516	0	54	6	7	54	0.1296296
NODE_300696_length_223_cov_35.814516	30	107	4	17	77	0.2207792
NODE_300696_length_223_cov_35.814516	30	107	6	23	77	0.2987013
NODE_300696_length_223_cov_35.814516	30	107	7	2	77	0.0259740
NODE_300696_length_223_cov_35.814516	30	107	11	35	77	0.4545455
NODE_300768_length_221_cov_71.319672	14	94	0	80	80	1.0000000
NODE_300800_length_220_cov_42.206612	3	74	0	71	71	1.0000000
NODE_300800_length_220_cov_42.206612	8	74	0	66	66	1.0000000
NODE_300800_length_220_cov_42.206612	47	98	0	51	51	1.0000000
NODE_300800_length_220_cov_42.206612	47	98	0	51	51	1.0000000
NODE_300800_length_220_cov_42.206612	47	98	0	51	51	1.0000000
NODE_300874_length_218_cov_244.773109	128	203	4	27	75	0.3600000
NODE_300874_length_218_cov_244.773109	128	203	5	1	75	0.0133333
NODE_300874_length_218_cov_244.773109	128	203	7	29	75	0.3866667
NODE_300874_length_218_cov_244.773109	128	203	8	18	75	0.2400000
NODE_300874_length_218_cov_244.773109	176	218	1	4	42	0.0952381
NODE_300874_length_218_cov_244.773109	176	218	2	1	42	0.0238095
NODE_300874_length_218_cov_244.773109	176	218	3	5	42	0.1190476
NODE_300874_length_218_cov_244.773109	176	218	4	32	42	0.7619048
NODE_300915_length_217_cov_2.144068	14	49	0	35	35	1.0000000
NODE_300915_length_217_cov_2.144068	132	167	0	35	35	1.0000000
NODE_300924_length_216_cov_215.410256	0	63	6	9	63	0.1428571
NODE_300924_length_216_cov_215.410256	0	63	9	2	63	0.0317460
NODE_300924_length_216_cov_215.410256	0	63	10	5	63	0.0793651
NODE_300924_length_216_cov_215.410256	0	63	14	5	63	0.0793651
NODE_300924_length_216_cov_215.410256	0	63	16	39	63	0.6190476
NODE_300924_length_216_cov_215.410256	0	63	17	3	63	0.0476190
NODE_300924_length_216_cov_215.410256	36	102	16	24	66	0.3636364
NODE_300924_length_216_cov_215.410256	36	102	17	42	66	0.6363636
NODE_300925_length_216_cov_51.940171	164	216	6	1	52	0.0192308
NODE_300925_length_216_cov_51.940171	164	216	7	31	52	0.5961539
NODE_300925_length_216_cov_51.940171	164	216	10	4	52	0.0769231
NODE_300925_length_216_cov_51.940171	164	216	11	12	52	0.2307692
NODE_300925_length_216_cov_51.940171	164	216	12	4	52	0.0769231
NODE_300953_length_215_cov_14.784483	0	50	0	50	50	1.0000000
NODE_300953_length_215_cov_14.784483	23	103	0	80	80	1.0000000
NODE_300984_length_214_cov_144.165217	0	62	0	62	62	1.0000000
NODE_300984_length_214_cov_144.165217	0	62	0	62	62	1.0000000
NODE_300984_length_214_cov_144.165217	35	115	0	80	80	1.0000000
NODE_300984_length_214_cov_144.165217	35	115	0	80	80	1.0000000
NODE_300984_length_214_cov_144.165217	35	115	0	80	80	1.0000000
NODE_300984_length_214_cov_144.165217	111	191	0	80	80	1.0000000
NODE_300984_length_214_cov_144.165217	111	191	0	80	80	1.0000000
NODE_300984_length_214_cov_144.165217	111	191	0	80	80	1.0000000
NODE_300984_length_214_cov_144.165217	164	214	0	50	50	1.0000000
NODE_300984_length_214_cov_144.165217	164	214	0	50	50	1.0000000
NODE_300984_length_214_cov_144.165217	164	214	0	50	50	1.0000000
NODE_301068_length_211_cov_39.571429	4	84	0	80	80	1.0000000
NODE_301169_length_208_cov_45.238532	3	59	0	56	56	1.0000000
NODE_301169_length_208_cov_45.238532	35	112	0	77	77	1.0000000
NODE_301170_length_208_cov_35.229358	76	156	0	80	80	1.0000000
NODE_301179_length_207_cov_341.324074	33	113	2	50	80	0.6250000
NODE_301179_length_207_cov_341.324074	33	113	3	30	80	0.3750000
NODE_301179_length_207_cov_341.324074	86	166	3	80	80	1.0000000
NODE_301248_length_205_cov_64.179245	6	77	0	71	71	1.0000000
NODE_301248_length_205_cov_64.179245	11	77	0	66	66	1.0000000
NODE_301248_length_205_cov_64.179245	50	98	0	48	48	1.0000000
NODE_301248_length_205_cov_64.179245	50	98	0	48	48	1.0000000
NODE_301248_length_205_cov_64.179245	50	98	0	48	48	1.0000000
NODE_301281_length_204_cov_183.390476	119	199	1	10	80	0.1250000
NODE_301281_length_204_cov_183.390476	119	199	2	42	80	0.5250000
NODE_301281_length_204_cov_183.390476	119	199	3	12	80	0.1500000
NODE_301281_length_204_cov_183.390476	119	199	4	16	80	0.2000000
NODE_301281_length_204_cov_183.390476	172	194	1	5	22	0.2272727
NODE_301281_length_204_cov_183.390476	172	194	2	17	22	0.7727273
NODE_301283_length_204_cov_80.095238	10	90	0	34	80	0.4250000
NODE_301283_length_204_cov_80.095238	10	90	2	46	80	0.5750000
NODE_301283_length_204_cov_80.095238	63	143	2	80	80	1.0000000
NODE_301345_length_202_cov_123.184466	0	64	0	7	64	0.1093750
NODE_301345_length_202_cov_123.184466	0	64	2	57	64	0.8906250
NODE_301345_length_202_cov_123.184466	31	72	2	41	41	1.0000000
NODE_301370_length_201_cov_56.323529	133	201	5	41	68	0.6029412
NODE_301370_length_201_cov_56.323529	133	201	13	9	68	0.1323529
NODE_301370_length_201_cov_56.323529	133	201	15	7	68	0.1029412
NODE_301370_length_201_cov_56.323529	133	201	16	9	68	0.1323529
NODE_301370_length_201_cov_56.323529	133	201	18	2	68	0.0294118
NODE_301371_length_201_cov_50.647059	44	99	5	7	55	0.1272727
NODE_301371_length_201_cov_50.647059	44	99	6	48	55	0.8727273
NODE_301371_length_201_cov_50.647059	136	201	0	6	65	0.0923077
NODE_301371_length_201_cov_50.647059	136	201	1	11	65	0.1692308
NODE_301371_length_201_cov_50.647059	136	201	2	4	65	0.0615385
NODE_301371_length_201_cov_50.647059	136	201	4	8	65	0.1230769
NODE_301371_length_201_cov_50.647059	136	201	5	2	65	0.0307692
NODE_301371_length_201_cov_50.647059	136	201	6	34	65	0.5230770
NODE_301371_length_201_cov_50.647059	136	201	0	6	65	0.0923077
NODE_301371_length_201_cov_50.647059	136	201	1	11	65	0.1692308
NODE_301371_length_201_cov_50.647059	136	201	2	4	65	0.0615385
NODE_301371_length_201_cov_50.647059	136	201	4	8	65	0.1230769
NODE_301371_length_201_cov_50.647059	136	201	5	2	65	0.0307692
NODE_301371_length_201_cov_50.647059	136	201	6	34	65	0.5230770
NODE_301371_length_201_cov_50.647059	136	201	0	6	65	0.0923077
NODE_301371_length_201_cov_50.647059	136	201	1	11	65	0.1692308
NODE_301371_length_201_cov_50.647059	136	201	2	4	65	0.0615385
NODE_301371_length_201_cov_50.647059	136	201	4	8	65	0.1230769
NODE_301371_length_201_cov_50.647059	136	201	5	2	65	0.0307692
NODE_301371_length_201_cov_50.647059	136	201	6	34	65	0.5230770
NODE_301371_length_201_cov_50.647059	136	201	0	6	65	0.0923077
NODE_301371_length_201_cov_50.647059	136	201	1	11	65	0.1692308
NODE_301371_length_201_cov_50.647059	136	201	2	4	65	0.0615385
NODE_301371_length_201_cov_50.647059	136	201	4	8	65	0.1230769
NODE_301371_length_201_cov_50.647059	136	201	5	2	65	0.0307692
NODE_301371_length_201_cov_50.647059	136	201	6	34	65	0.5230770
NODE_301405_length_200_cov_29.118812	0	73	3	2	73	0.0273973
NODE_301405_length_200_cov_29.118812	0	73	4	3	73	0.0410959
NODE_301405_length_200_cov_29.118812	0	73	7	9	73	0.1232877
NODE_301405_length_200_cov_29.118812	0	73	9	7	73	0.0958904
NODE_301405_length_200_cov_29.118812	0	73	10	52	73	0.7123288
NODE_301419_length_199_cov_768.700000	94	142	6	48	48	1.0000000
NODE_301419_length_199_cov_768.700000	115	186	2	6	71	0.0845070
NODE_301419_length_199_cov_768.700000	115	186	3	13	71	0.1830986
NODE_301419_length_199_cov_768.700000	115	186	4	15	71	0.2112676
NODE_301419_length_199_cov_768.700000	115	186	5	1	71	0.0140845
NODE_301419_length_199_cov_768.700000	115	186	6	36	71	0.5070422
NODE_301420_length_199_cov_702.860000	3	78	2	4	75	0.0533333
NODE_301420_length_199_cov_702.860000	3	78	5	1	75	0.0133333
NODE_301420_length_199_cov_702.860000	3	78	7	2	75	0.0266667
NODE_301420_length_199_cov_702.860000	3	78	8	2	75	0.0266667
NODE_301420_length_199_cov_702.860000	3	78	9	3	75	0.0400000
NODE_301420_length_199_cov_702.860000	3	78	11	10	75	0.1333333
NODE_301420_length_199_cov_702.860000	3	78	13	2	75	0.0266667
NODE_301420_length_199_cov_702.860000	3	78	15	2	75	0.0266667
NODE_301420_length_199_cov_702.860000	3	78	18	2	75	0.0266667
NODE_301420_length_199_cov_702.860000	3	78	19	5	75	0.0666667
NODE_301420_length_199_cov_702.860000	3	78	20	4	75	0.0533333
NODE_301420_length_199_cov_702.860000	3	78	22	4	75	0.0533333
NODE_301420_length_199_cov_702.860000	3	78	23	13	75	0.1733333
NODE_301420_length_199_cov_702.860000	3	78	25	6	75	0.0800000
NODE_301420_length_199_cov_702.860000	3	78	26	4	75	0.0533333
NODE_301420_length_199_cov_702.860000	3	78	27	2	75	0.0266667
NODE_301420_length_199_cov_702.860000	3	78	29	9	75	0.1200000
NODE_301420_length_199_cov_702.860000	51	131	23	6	80	0.0750000
NODE_301420_length_199_cov_702.860000	51	131	25	6	80	0.0750000
NODE_301420_length_199_cov_702.860000	51	131	26	4	80	0.0500000
NODE_301420_length_199_cov_702.860000	51	131	27	2	80	0.0250000
NODE_301420_length_199_cov_702.860000	51	131	29	15	80	0.1875000
NODE_301420_length_199_cov_702.860000	51	131	31	47	80	0.5875000
NODE_301421_length_199_cov_670.570000	22	52	4	1	30	0.0333333
NODE_301421_length_199_cov_670.570000	22	52	6	3	30	0.1000000
NODE_301421_length_199_cov_670.570000	22	52	7	4	30	0.1333333
NODE_301421_length_199_cov_670.570000	22	52	8	9	30	0.3000000
NODE_301421_length_199_cov_670.570000	22	52	9	2	30	0.0666667
NODE_301421_length_199_cov_670.570000	22	52	11	11	30	0.3666667
NODE_301421_length_199_cov_670.570000	25	105	6	1	80	0.0125000
NODE_301421_length_199_cov_670.570000	25	105	7	4	80	0.0500000
NODE_301421_length_199_cov_670.570000	25	105	8	9	80	0.1125000
NODE_301421_length_199_cov_670.570000	25	105	9	2	80	0.0250000
NODE_301421_length_199_cov_670.570000	25	105	11	15	80	0.1875000
NODE_301421_length_199_cov_670.570000	25	105	14	49	80	0.6125000
NODE_301430_length_199_cov_215.860000	3	75	0	72	72	1.0000000
NODE_301430_length_199_cov_215.860000	48	128	0	80	80	1.0000000
NODE_301432_length_199_cov_206.800000	120	199	0	79	79	1.0000000
NODE_301441_length_199_cov_131.120000	97	177	0	80	80	1.0000000
NODE_301448_length_199_cov_97.490000	4	77	0	73	73	1.0000000
NODE_301449_length_199_cov_96.090000	91	171	2	9	80	0.1125000
NODE_301449_length_199_cov_96.090000	91	171	3	7	80	0.0875000
NODE_301449_length_199_cov_96.090000	91	171	4	64	80	0.8000000
NODE_301455_length_199_cov_84.060000	44	75	9	6	31	0.1935484
NODE_301455_length_199_cov_84.060000	44	75	10	10	31	0.3225806
NODE_301455_length_199_cov_84.060000	44	75	11	8	31	0.2580645
NODE_301455_length_199_cov_84.060000	44	75	12	7	31	0.2258064
NODE_301456_length_199_cov_83.220000	0	64	0	64	64	1.0000000
NODE_301459_length_199_cov_80.390000	15	98	0	19	83	0.2289157
NODE_301459_length_199_cov_80.390000	15	98	1	28	83	0.3373494
NODE_301459_length_199_cov_80.390000	15	98	2	36	83	0.4337350
NODE_301469_length_199_cov_63.420000	128	194	4	66	66	1.0000000
NODE_301477_length_199_cov_58.660000	18	85	0	67	67	1.0000000
NODE_301484_length_199_cov_50.350000	102	183	3	9	81	0.1111111
NODE_301484_length_199_cov_50.350000	102	183	4	27	81	0.3333333
NODE_301484_length_199_cov_50.350000	102	183	5	4	81	0.0493827
NODE_301484_length_199_cov_50.350000	102	183	7	41	81	0.5061728
NODE_301485_length_199_cov_49.630000	5	47	0	5	42	0.1190476
NODE_301485_length_199_cov_49.630000	5	47	1	10	42	0.2380952
NODE_301485_length_199_cov_49.630000	5	47	2	27	42	0.6428571
NODE_301485_length_199_cov_49.630000	100	163	1	63	63	1.0000000
NODE_301485_length_199_cov_49.630000	100	163	1	63	63	1.0000000
NODE_301485_length_199_cov_49.630000	100	163	1	63	63	1.0000000
NODE_301485_length_199_cov_49.630000	136	185	0	15	49	0.3061225
NODE_301485_length_199_cov_49.630000	136	185	1	34	49	0.6938776
NODE_301485_length_199_cov_49.630000	153	199	0	29	46	0.6304348
NODE_301485_length_199_cov_49.630000	153	199	1	17	46	0.3695652
NODE_301491_length_199_cov_40.000000	0	66	0	66	66	1.0000000
NODE_301491_length_199_cov_40.000000	34	114	0	80	80	1.0000000
NODE_301491_length_199_cov_40.000000	39	61	0	22	22	1.0000000
NODE_301498_length_199_cov_31.400000	3	77	0	9	74	0.1216216
NODE_301498_length_199_cov_31.400000	3	77	1	65	74	0.8783784
NODE_301498_length_199_cov_31.400000	76	153	1	77	77	1.0000000
NODE_301498_length_199_cov_31.400000	76	153	1	77	77	1.0000000
NODE_301498_length_199_cov_31.400000	76	153	1	77	77	1.0000000
NODE_301498_length_199_cov_31.400000	126	192	0	30	66	0.4545455
NODE_301498_length_199_cov_31.400000	126	192	1	36	66	0.5454546
NODE_301498_length_199_cov_31.400000	129	199	0	37	70	0.5285714
NODE_301498_length_199_cov_31.400000	129	199	1	33	70	0.4714286
NODE_301498_length_199_cov_31.400000	131	199	0	37	68	0.5441176
NODE_301498_length_199_cov_31.400000	131	199	1	31	68	0.4558823
NODE_301500_length_199_cov_30.140000	118	198	0	80	80	1.0000000
NODE_301500_length_199_cov_30.140000	118	198	0	80	80	1.0000000
NODE_301500_length_199_cov_30.140000	118	198	0	80	80	1.0000000
NODE_301500_length_199_cov_30.140000	118	198	0	80	80	1.0000000
NODE_301500_length_199_cov_30.140000	118	198	0	80	80	1.0000000
NODE_301500_length_199_cov_30.140000	127	198	0	71	71	1.0000000
NODE_301581_length_197_cov_41.265306	0	70	0	70	70	1.0000000
NODE_301611_length_196_cov_101.855670	72	136	0	64	64	1.0000000
NODE_301611_length_196_cov_101.855670	72	136	0	64	64	1.0000000
NODE_301611_length_196_cov_101.855670	109	169	0	60	60	1.0000000
NODE_301613_length_196_cov_100.618557	129	196	0	67	67	1.0000000
NODE_301618_length_196_cov_67.268041	8	88	0	80	80	1.0000000
NODE_301618_length_196_cov_67.268041	61	124	0	63	63	1.0000000
NODE_301629_length_196_cov_40.195876	101	184	0	83	83	1.0000000
NODE_301704_length_194_cov_63.252632	12	78	1	27	66	0.4090909
NODE_301704_length_194_cov_63.252632	12	78	2	39	66	0.5909091
NODE_301704_length_194_cov_63.252632	51	112	2	61	61	1.0000000
NODE_301704_length_194_cov_63.252632	51	99	2	48	48	1.0000000
NODE_301704_length_194_cov_63.252632	51	112	2	61	61	1.0000000
NODE_301708_length_194_cov_35.010526	95	162	0	22	67	0.3283582
NODE_301708_length_194_cov_35.010526	95	162	1	24	67	0.3582090
NODE_301708_length_194_cov_35.010526	95	162	2	21	67	0.3134328
NODE_301708_length_194_cov_35.010526	95	162	0	22	67	0.3283582
NODE_301708_length_194_cov_35.010526	95	162	1	24	67	0.3582090
NODE_301708_length_194_cov_35.010526	95	162	2	21	67	0.3134328
NODE_301708_length_194_cov_35.010526	135	184	0	44	49	0.8979592
NODE_301708_length_194_cov_35.010526	135	184	1	5	49	0.1020408
NODE_301714_length_194_cov_9.978947	153	194	0	41	41	1.0000000
NODE_301727_length_193_cov_117.170213	21	93	6	17	72	0.2361111
NODE_301727_length_193_cov_117.170213	21	93	7	2	72	0.0277778
NODE_301727_length_193_cov_117.170213	21	93	8	53	72	0.7361111
NODE_301727_length_193_cov_117.170213	41	121	8	80	80	1.0000000
NODE_301729_length_193_cov_54.734043	108	188	0	80	80	1.0000000
NODE_301729_length_193_cov_54.734043	161	183	0	22	22	1.0000000
NODE_301735_length_193_cov_30.638298	108	188	0	80	80	1.0000000
NODE_301735_length_193_cov_30.638298	161	183	0	22	22	1.0000000
NODE_301737_length_193_cov_29.968085	0	45	1	1	45	0.0222222
NODE_301737_length_193_cov_29.968085	0	45	2	10	45	0.2222222
NODE_301737_length_193_cov_29.968085	0	45	3	12	45	0.2666667
NODE_301737_length_193_cov_29.968085	0	45	5	22	45	0.4888889
NODE_301737_length_193_cov_29.968085	8	57	2	3	49	0.0612245
NODE_301737_length_193_cov_29.968085	8	57	3	12	49	0.2448980
NODE_301737_length_193_cov_29.968085	8	57	5	34	49	0.6938776
NODE_301737_length_193_cov_29.968085	30	98	5	68	68	1.0000000
NODE_301737_length_193_cov_29.968085	30	98	5	68	68	1.0000000
NODE_301737_length_193_cov_29.968085	30	98	5	68	68	1.0000000
NODE_301737_length_193_cov_29.968085	146	188	0	15	42	0.3571429
NODE_301737_length_193_cov_29.968085	146	188	2	12	42	0.2857143
NODE_301737_length_193_cov_29.968085	146	188	3	10	42	0.2380952
NODE_301737_length_193_cov_29.968085	146	188	4	5	42	0.1190476
NODE_301776_length_192_cov_160.258065	0	76	0	5	76	0.0657895
NODE_301776_length_192_cov_160.258065	0	76	2	30	76	0.3947369
NODE_301776_length_192_cov_160.258065	0	76	3	41	76	0.5394737
NODE_301825_length_191_cov_92.913043	81	144	8	63	63	1.0000000
NODE_301855_length_190_cov_112.285714	8	91	0	83	83	1.0000000
NODE_301859_length_190_cov_41.373626	92	172	2	80	80	1.0000000
NODE_301859_length_190_cov_41.373626	145	190	0	6	45	0.1333333
NODE_301859_length_190_cov_41.373626	145	190	2	39	45	0.8666667
NODE_301880_length_189_cov_234.500000	19	88	5	13	69	0.1884058
NODE_301880_length_189_cov_234.500000	19	88	6	56	69	0.8115942
NODE_301882_length_189_cov_192.211111	134	186	1	5	52	0.0961538
NODE_301882_length_189_cov_192.211111	134	186	2	1	52	0.0192308
NODE_301882_length_189_cov_192.211111	134	186	3	2	52	0.0384615
NODE_301882_length_189_cov_192.211111	134	186	4	1	52	0.0192308
NODE_301882_length_189_cov_192.211111	134	186	5	10	52	0.1923077
NODE_301882_length_189_cov_192.211111	134	186	6	2	52	0.0384615
NODE_301882_length_189_cov_192.211111	134	186	8	3	52	0.0576923
NODE_301882_length_189_cov_192.211111	134	186	9	3	52	0.0576923
NODE_301882_length_189_cov_192.211111	134	186	11	2	52	0.0384615
NODE_301882_length_189_cov_192.211111	134	186	12	4	52	0.0769231
NODE_301882_length_189_cov_192.211111	134	186	13	10	52	0.1923077
NODE_301882_length_189_cov_192.211111	134	186	14	3	52	0.0576923
NODE_301882_length_189_cov_192.211111	134	186	15	6	52	0.1153846
NODE_301885_length_189_cov_70.600000	19	88	0	69	69	1.0000000
NODE_301885_length_189_cov_70.600000	72	156	0	84	84	1.0000000
NODE_301886_length_189_cov_63.455556	70	150	0	80	80	1.0000000
NODE_301886_length_189_cov_63.455556	70	141	0	71	71	1.0000000
NODE_301891_length_189_cov_43.600000	0	73	2	2	73	0.0273973
NODE_301891_length_189_cov_43.600000	0	73	3	2	73	0.0273973
NODE_301891_length_189_cov_43.600000	0	73	5	5	73	0.0684932
NODE_301891_length_189_cov_43.600000	0	73	7	7	73	0.0958904
NODE_301891_length_189_cov_43.600000	0	73	8	2	73	0.0273973
NODE_301891_length_189_cov_43.600000	0	73	10	5	73	0.0684932
NODE_301891_length_189_cov_43.600000	0	73	11	5	73	0.0684932
NODE_301891_length_189_cov_43.600000	0	73	14	9	73	0.1232877
NODE_301891_length_189_cov_43.600000	0	73	15	1	73	0.0136986
NODE_301891_length_189_cov_43.600000	0	73	16	31	73	0.4246575
NODE_301891_length_189_cov_43.600000	0	73	18	4	73	0.0547945
NODE_301940_length_188_cov_2021.561798	108	188	0	1	80	0.0125000
NODE_301940_length_188_cov_2021.561798	108	188	2	16	80	0.2000000
NODE_301940_length_188_cov_2021.561798	108	188	4	11	80	0.1375000
NODE_301940_length_188_cov_2021.561798	108	188	5	2	80	0.0250000
NODE_301940_length_188_cov_2021.561798	108	188	6	50	80	0.6250000
NODE_301940_length_188_cov_2021.561798	161	183	2	12	22	0.5454546
NODE_301940_length_188_cov_2021.561798	161	183	4	10	22	0.4545455
NODE_301952_length_188_cov_37.988764	0	50	0	50	50	1.0000000
NODE_301980_length_187_cov_71.170455	124	155	3	6	31	0.1935484
NODE_301980_length_187_cov_71.170455	124	155	4	25	31	0.8064516
NODE_301981_length_187_cov_56.000000	72	136	2	64	64	1.0000000
NODE_301981_length_187_cov_56.000000	72	136	2	64	64	1.0000000
NODE_301981_length_187_cov_56.000000	109	175	0	3	66	0.0454545
NODE_301981_length_187_cov_56.000000	109	175	1	17	66	0.2575758
NODE_301981_length_187_cov_56.000000	109	175	2	46	66	0.6969697
NODE_301981_length_187_cov_56.000000	109	180	0	8	71	0.1126761
NODE_301981_length_187_cov_56.000000	109	180	1	17	71	0.2394366
NODE_301981_length_187_cov_56.000000	109	180	2	46	71	0.6478873
NODE_301986_length_187_cov_37.397727	4	57	1	53	53	1.0000000
NODE_301986_length_187_cov_37.397727	12	78	1	49	66	0.7424242
NODE_301986_length_187_cov_37.397727	12	78	2	17	66	0.2575758
NODE_301986_length_187_cov_37.397727	51	112	1	10	61	0.1639344
NODE_301986_length_187_cov_37.397727	51	112	2	51	61	0.8360656
NODE_301986_length_187_cov_37.397727	51	114	1	10	63	0.1587302
NODE_301986_length_187_cov_37.397727	51	114	2	53	63	0.8412699
NODE_302020_length_186_cov_309.620690	20	104	0	84	84	1.0000000
NODE_302021_length_186_cov_295.505747	57	115	4	58	58	1.0000000
NODE_302021_length_186_cov_295.505747	101	168	2	41	67	0.6119403
NODE_302021_length_186_cov_295.505747	101	168	4	26	67	0.3880597
NODE_302025_length_186_cov_61.344828	38	118	4	80	80	1.0000000
NODE_302025_length_186_cov_61.344828	91	171	4	80	80	1.0000000
NODE_302201_length_182_cov_127.759036	6	52	5	11	46	0.2391304
NODE_302201_length_182_cov_127.759036	6	52	10	3	46	0.0652174
NODE_302201_length_182_cov_127.759036	6	52	11	10	46	0.2173913
NODE_302201_length_182_cov_127.759036	6	52	12	22	46	0.4782609
NODE_302201_length_182_cov_127.759036	59	105	16	46	46	1.0000000
NODE_302214_length_182_cov_29.421687	5	35	0	30	30	1.0000000
NODE_302214_length_182_cov_29.421687	8	88	0	80	80	1.0000000
NODE_302236_length_181_cov_141.195122	1	60	2	9	59	0.1525424
NODE_302236_length_181_cov_141.195122	1	60	3	3	59	0.0508475
NODE_302236_length_181_cov_141.195122	1	60	6	3	59	0.0508475
NODE_302236_length_181_cov_141.195122	1	60	7	2	59	0.0338983
NODE_302236_length_181_cov_141.195122	1	60	8	3	59	0.0508475
NODE_302236_length_181_cov_141.195122	1	60	9	1	59	0.0169492
NODE_302236_length_181_cov_141.195122	1	60	10	5	59	0.0847458
NODE_302236_length_181_cov_141.195122	1	60	11	1	59	0.0169492
NODE_302236_length_181_cov_141.195122	1	60	13	5	59	0.0847458
NODE_302236_length_181_cov_141.195122	1	60	14	3	59	0.0508475
NODE_302236_length_181_cov_141.195122	1	60	16	1	59	0.0169492
NODE_302236_length_181_cov_141.195122	1	60	18	23	59	0.3898305
NODE_302236_length_181_cov_141.195122	34	60	14	2	26	0.0769231
NODE_302236_length_181_cov_141.195122	34	60	16	1	26	0.0384615
NODE_302236_length_181_cov_141.195122	34	60	18	23	26	0.8846154
NODE_302236_length_181_cov_141.195122	114	145	17	18	31	0.5806451
NODE_302236_length_181_cov_141.195122	114	145	18	13	31	0.4193548
NODE_302285_length_180_cov_102.567901	6	75	0	69	69	1.0000000
NODE_302363_length_178_cov_93.620253	81	112	3	31	31	1.0000000
NODE_302365_length_178_cov_62.696203	0	78	0	78	78	1.0000000
NODE_302365_length_178_cov_62.696203	51	131	0	80	80	1.0000000
NODE_302477_length_175_cov_116.684211	42	122	2	80	80	1.0000000
NODE_302477_length_175_cov_116.684211	95	175	0	33	80	0.4125000
NODE_302477_length_175_cov_116.684211	95	175	2	47	80	0.5875000
NODE_302482_length_175_cov_61.000000	81	121	0	40	40	1.0000000
NODE_302538_length_174_cov_173.893333	53	93	0	40	40	1.0000000
NODE_302543_length_174_cov_50.346667	91	161	0	3	70	0.0428571
NODE_302543_length_174_cov_50.346667	91	161	1	30	70	0.4285714
NODE_302543_length_174_cov_50.346667	91	161	2	37	70	0.5285714
NODE_302590_length_173_cov_184.351351	62	126	7	12	64	0.1875000
NODE_302590_length_173_cov_184.351351	62	126	9	52	64	0.8125000
NODE_302590_length_173_cov_184.351351	62	126	7	12	64	0.1875000
NODE_302590_length_173_cov_184.351351	62	126	9	52	64	0.8125000
NODE_302590_length_173_cov_184.351351	62	126	7	12	64	0.1875000
NODE_302590_length_173_cov_184.351351	62	126	9	52	64	0.8125000
NODE_302590_length_173_cov_184.351351	62	126	7	12	64	0.1875000
NODE_302590_length_173_cov_184.351351	62	126	9	52	64	0.8125000
NODE_302590_length_173_cov_184.351351	99	165	3	10	66	0.1515152
NODE_302590_length_173_cov_184.351351	99	165	6	11	66	0.1666667
NODE_302590_length_173_cov_184.351351	99	165	7	26	66	0.3939394
NODE_302590_length_173_cov_184.351351	99	165	9	19	66	0.2878788
NODE_302590_length_173_cov_184.351351	99	170	3	15	71	0.2112676
NODE_302590_length_173_cov_184.351351	99	170	6	11	71	0.1549296
NODE_302590_length_173_cov_184.351351	99	170	7	26	71	0.3661972
NODE_302590_length_173_cov_184.351351	99	170	9	19	71	0.2676056
NODE_302590_length_173_cov_184.351351	115	173	3	18	58	0.3103448
NODE_302590_length_173_cov_184.351351	115	173	6	11	58	0.1896552
NODE_302590_length_173_cov_184.351351	115	173	7	26	58	0.4482759
NODE_302590_length_173_cov_184.351351	115	173	9	3	58	0.0517241
NODE_302596_length_173_cov_58.472973	0	78	0	78	78	1.0000000
NODE_302597_length_173_cov_57.148649	101	142	6	22	41	0.5365854
NODE_302597_length_173_cov_57.148649	101	142	7	1	41	0.0243902
NODE_302597_length_173_cov_57.148649	101	142	8	18	41	0.4390244
NODE_302597_length_173_cov_57.148649	109	173	2	1	64	0.0156250
NODE_302597_length_173_cov_57.148649	109	173	4	8	64	0.1250000
NODE_302597_length_173_cov_57.148649	109	173	5	1	64	0.0156250
NODE_302597_length_173_cov_57.148649	109	173	6	43	64	0.6718750
NODE_302597_length_173_cov_57.148649	109	173	7	1	64	0.0156250
NODE_302597_length_173_cov_57.148649	109	173	8	10	64	0.1562500
NODE_302686_length_171_cov_218.666667	12	90	0	78	78	1.0000000
NODE_302686_length_171_cov_218.666667	12	90	0	78	78	1.0000000
NODE_302686_length_171_cov_218.666667	21	90	0	69	69	1.0000000
NODE_302689_length_171_cov_110.194444	81	161	0	80	80	1.0000000
NODE_302689_length_171_cov_110.194444	81	152	0	71	71	1.0000000
NODE_302691_length_171_cov_86.013889	106	171	0	19	65	0.2923077
NODE_302691_length_171_cov_86.013889	106	171	1	46	65	0.7076923
NODE_302697_length_171_cov_46.430556	0	59	0	59	59	1.0000000
NODE_302697_length_171_cov_46.430556	32	98	0	66	66	1.0000000
NODE_302700_length_171_cov_40.069444	13	87	0	74	74	1.0000000
NODE_302702_length_171_cov_33.319444	84	158	0	74	74	1.0000000
NODE_302764_length_170_cov_217.422535	10	90	4	10	80	0.1250000
NODE_302764_length_170_cov_217.422535	10	90	5	70	80	0.8750000
NODE_302764_length_170_cov_217.422535	10	90	4	10	80	0.1250000
NODE_302764_length_170_cov_217.422535	10	90	5	70	80	0.8750000
NODE_302764_length_170_cov_217.422535	10	90	4	10	80	0.1250000
NODE_302764_length_170_cov_217.422535	10	90	5	70	80	0.8750000
NODE_302764_length_170_cov_217.422535	10	90	4	10	80	0.1250000
NODE_302764_length_170_cov_217.422535	10	90	5	70	80	0.8750000
NODE_302764_length_170_cov_217.422535	10	90	4	10	80	0.1250000
NODE_302764_length_170_cov_217.422535	10	90	5	70	80	0.8750000
NODE_302764_length_170_cov_217.422535	19	90	4	1	71	0.0140845
NODE_302764_length_170_cov_217.422535	19	90	5	70	71	0.9859155
NODE_302764_length_170_cov_217.422535	63	126	3	2	63	0.0317460
NODE_302764_length_170_cov_217.422535	63	126	5	61	63	0.9682540
NODE_302764_length_170_cov_217.422535	63	126	3	2	63	0.0317460
NODE_302764_length_170_cov_217.422535	63	126	5	61	63	0.9682540
NODE_302768_length_170_cov_102.816901	23	86	4	63	63	1.0000000
NODE_302806_length_169_cov_47.757143	70	150	1	23	80	0.2875000
NODE_302806_length_169_cov_47.757143	70	150	2	57	80	0.7125000
NODE_302869_length_168_cov_10.391304	66	99	0	33	33	1.0000000
NODE_302869_length_168_cov_10.391304	135	168	0	33	33	1.0000000
NODE_302966_length_166_cov_401.149254	31	109	4	1	78	0.0128205
NODE_302966_length_166_cov_401.149254	31	109	6	2	78	0.0256410
NODE_302966_length_166_cov_401.149254	31	109	7	2	78	0.0256410
NODE_302966_length_166_cov_401.149254	31	109	8	7	78	0.0897436
NODE_302966_length_166_cov_401.149254	31	109	10	66	78	0.8461539
NODE_302966_length_166_cov_401.149254	82	157	5	10	75	0.1333333
NODE_302966_length_166_cov_401.149254	82	157	6	5	75	0.0666667
NODE_302966_length_166_cov_401.149254	82	157	9	21	75	0.2800000
NODE_302966_length_166_cov_401.149254	82	157	10	39	75	0.5200000
NODE_302974_length_166_cov_123.223881	46	97	0	51	51	1.0000000
NODE_303071_length_164_cov_154.076923	0	75	0	75	75	1.0000000
NODE_303071_length_164_cov_154.076923	48	128	0	80	80	1.0000000
NODE_303074_length_164_cov_69.369231	0	64	0	64	64	1.0000000
NODE_303079_length_164_cov_43.923077	36	100	0	64	64	1.0000000
NODE_303079_length_164_cov_43.923077	36	100	0	64	64	1.0000000
NODE_303079_length_164_cov_43.923077	73	153	0	80	80	1.0000000
NODE_303079_length_164_cov_43.923077	73	153	0	80	80	1.0000000
NODE_303079_length_164_cov_43.923077	73	153	0	80	80	1.0000000
NODE_303079_length_164_cov_43.923077	73	153	0	80	80	1.0000000
NODE_303079_length_164_cov_43.923077	73	153	0	80	80	1.0000000
NODE_303079_length_164_cov_43.923077	73	144	0	71	71	1.0000000
NODE_303135_length_163_cov_480.593750	0	40	2	40	40	1.0000000
NODE_303136_length_163_cov_368.000000	24	96	0	72	72	1.0000000
NODE_303138_length_163_cov_319.843750	0	68	0	2	68	0.0294118
NODE_303138_length_163_cov_319.843750	0	68	1	7	68	0.1029412
NODE_303138_length_163_cov_319.843750	0	68	2	59	68	0.8676471
NODE_303139_length_163_cov_198.078125	34	109	2	75	75	1.0000000
NODE_303139_length_163_cov_198.078125	34	114	2	80	80	1.0000000
NODE_303139_length_163_cov_198.078125	35	110	2	75	75	1.0000000
NODE_303139_length_163_cov_198.078125	87	163	0	1	76	0.0131579
NODE_303139_length_163_cov_198.078125	87	163	2	75	76	0.9868421
NODE_303139_length_163_cov_198.078125	87	163	0	1	76	0.0131579
NODE_303139_length_163_cov_198.078125	87	163	2	75	76	0.9868421
NODE_303139_length_163_cov_198.078125	87	163	0	1	76	0.0131579
NODE_303139_length_163_cov_198.078125	87	163	2	75	76	0.9868421
NODE_303231_length_162_cov_421.047619	7	56	0	22	49	0.4489796
NODE_303231_length_162_cov_421.047619	7	56	2	18	49	0.3673469
NODE_303231_length_162_cov_421.047619	7	56	4	9	49	0.1836735
NODE_303231_length_162_cov_421.047619	29	90	2	18	61	0.2950820
NODE_303231_length_162_cov_421.047619	29	90	4	43	61	0.7049180
NODE_303231_length_162_cov_421.047619	29	92	2	18	63	0.2857143
NODE_303231_length_162_cov_421.047619	29	92	4	45	63	0.7142857
NODE_303231_length_162_cov_421.047619	29	92	2	18	63	0.2857143
NODE_303231_length_162_cov_421.047619	29	92	4	45	63	0.7142857
NODE_303231_length_162_cov_421.047619	29	92	2	18	63	0.2857143
NODE_303231_length_162_cov_421.047619	29	92	4	45	63	0.7142857
NODE_303250_length_162_cov_45.380952	63	127	2	64	64	1.0000000
NODE_303250_length_162_cov_45.380952	63	127	2	64	64	1.0000000
NODE_303250_length_162_cov_45.380952	100	162	0	33	62	0.5322581
NODE_303250_length_162_cov_45.380952	100	162	2	29	62	0.4677419
NODE_303301_length_161_cov_1483.177419	51	131	2	80	80	1.0000000
NODE_303301_length_161_cov_1483.177419	104	161	1	7	57	0.1228070
NODE_303301_length_161_cov_1483.177419	104	161	2	50	57	0.8771930
NODE_303312_length_161_cov_71.500000	33	110	0	77	77	1.0000000
NODE_303312_length_161_cov_71.500000	33	110	0	77	77	1.0000000
NODE_303312_length_161_cov_71.500000	33	110	0	77	77	1.0000000
NODE_303312_length_161_cov_71.500000	33	110	0	77	77	1.0000000
NODE_303312_length_161_cov_71.500000	83	149	0	66	66	1.0000000
NODE_303312_length_161_cov_71.500000	83	161	0	78	78	1.0000000
NODE_303312_length_161_cov_71.500000	86	161	0	75	75	1.0000000
NODE_303312_length_161_cov_71.500000	86	161	0	75	75	1.0000000
NODE_303312_length_161_cov_71.500000	88	161	0	73	73	1.0000000
NODE_303321_length_161_cov_29.758065	0	80	0	16	80	0.2000000
NODE_303321_length_161_cov_29.758065	0	80	2	64	80	0.8000000
NODE_303381_length_160_cov_143.573770	45	125	0	17	80	0.2125000
NODE_303381_length_160_cov_143.573770	45	125	2	63	80	0.7875000
NODE_303381_length_160_cov_143.573770	93	160	0	52	67	0.7761194
NODE_303381_length_160_cov_143.573770	93	160	2	15	67	0.2238806
NODE_303381_length_160_cov_143.573770	98	120	0	12	22	0.5454546
NODE_303381_length_160_cov_143.573770	98	120	2	10	22	0.4545455
NODE_303388_length_160_cov_58.245902	0	45	0	45	45	1.0000000
NODE_303431_length_159_cov_182.016667	71	156	1	15	85	0.1764706
NODE_303431_length_159_cov_182.016667	71	156	2	70	85	0.8235294
NODE_303431_length_159_cov_182.016667	71	156	1	15	85	0.1764706
NODE_303431_length_159_cov_182.016667	71	156	2	70	85	0.8235294
NODE_303431_length_159_cov_182.016667	71	156	1	15	85	0.1764706
NODE_303431_length_159_cov_182.016667	71	156	2	70	85	0.8235294
NODE_303440_length_159_cov_85.750000	0	43	0	43	43	1.0000000
NODE_303440_length_159_cov_85.750000	16	97	0	81	81	1.0000000
NODE_303440_length_159_cov_85.750000	65	145	0	80	80	1.0000000
NODE_303440_length_159_cov_85.750000	70	92	0	22	22	1.0000000
NODE_303546_length_158_cov_119.813559	34	77	3	43	43	1.0000000
NODE_303546_length_158_cov_119.813559	78	113	3	35	35	1.0000000
NODE_303546_length_158_cov_119.813559	123	158	0	19	35	0.5428572
NODE_303546_length_158_cov_119.813559	123	158	2	16	35	0.4571429
NODE_303552_length_158_cov_70.135593	5	82	0	77	77	1.0000000
NODE_303552_length_158_cov_70.135593	5	82	0	77	77	1.0000000
NODE_303552_length_158_cov_70.135593	81	155	0	74	74	1.0000000
NODE_303555_length_158_cov_63.559322	80	151	0	71	71	1.0000000
NODE_303556_length_158_cov_61.203390	2	66	0	64	64	1.0000000
NODE_303556_length_158_cov_61.203390	2	66	0	64	64	1.0000000
NODE_303556_length_158_cov_61.203390	2	66	0	64	64	1.0000000
NODE_303556_length_158_cov_61.203390	39	119	0	80	80	1.0000000
NODE_303563_length_158_cov_40.271186	43	107	3	64	64	1.0000000
NODE_303563_length_158_cov_40.271186	80	151	1	1	71	0.0140845
NODE_303563_length_158_cov_40.271186	80	151	2	7	71	0.0985916
NODE_303563_length_158_cov_40.271186	80	151	3	63	71	0.8873239
NODE_303566_length_158_cov_29.661017	0	61	0	61	61	1.0000000
NODE_303566_length_158_cov_29.661017	34	64	0	30	30	1.0000000
NODE_303605_length_157_cov_1488.586207	57	138	4	81	81	1.0000000
NODE_303605_length_157_cov_1488.586207	111	157	1	17	46	0.3695652
NODE_303605_length_157_cov_1488.586207	111	157	2	1	46	0.0217391
NODE_303605_length_157_cov_1488.586207	111	157	4	28	46	0.6086956
NODE_303606_length_157_cov_295.896552	32	78	4	46	46	1.0000000
NODE_303608_length_157_cov_161.689655	0	59	0	59	59	1.0000000
NODE_303608_length_157_cov_161.689655	0	59	0	59	59	1.0000000
NODE_303608_length_157_cov_161.689655	55	135	0	80	80	1.0000000
NODE_303608_length_157_cov_161.689655	55	135	0	80	80	1.0000000
NODE_303608_length_157_cov_161.689655	108	157	0	49	49	1.0000000
NODE_303608_length_157_cov_161.689655	113	157	0	44	44	1.0000000
NODE_303677_length_156_cov_100.491228	0	41	0	41	41	1.0000000
NODE_303677_length_156_cov_100.491228	21	94	0	73	73	1.0000000
NODE_303688_length_156_cov_37.368421	24	81	0	57	57	1.0000000
NODE_303688_length_156_cov_37.368421	54	134	0	80	80	1.0000000
NODE_303700_length_156_cov_9.543860	2	48	0	46	46	1.0000000
NODE_303700_length_156_cov_9.543860	59	105	0	46	46	1.0000000
NODE_303752_length_155_cov_56.750000	27	102	0	75	75	1.0000000
NODE_303752_length_155_cov_56.750000	80	155	0	75	75	1.0000000
NODE_304022_length_153_cov_0.944444	5	48	0	43	43	1.0000000
NODE_304022_length_153_cov_0.944444	37	86	0	49	49	1.0000000
NODE_304022_length_153_cov_0.944444	59	102	0	43	43	1.0000000
NODE_304022_length_153_cov_0.944444	91	140	0	49	49	1.0000000
NODE_304022_length_153_cov_0.944444	113	153	0	40	40	1.0000000
NODE_304027_length_152_cov_195.396226	9	89	2	9	80	0.1125000
NODE_304027_length_152_cov_195.396226	9	89	3	71	80	0.8875000
NODE_304027_length_152_cov_195.396226	9	89	2	9	80	0.1125000
NODE_304027_length_152_cov_195.396226	9	89	3	71	80	0.8875000
NODE_304027_length_152_cov_195.396226	85	149	2	2	64	0.0312500
NODE_304027_length_152_cov_195.396226	85	149	3	62	64	0.9687500
NODE_304027_length_152_cov_195.396226	85	152	2	5	67	0.0746269
NODE_304027_length_152_cov_195.396226	85	152	3	62	67	0.9253731
NODE_304027_length_152_cov_195.396226	85	152	2	5	67	0.0746269
NODE_304027_length_152_cov_195.396226	85	152	3	62	67	0.9253731
NODE_304027_length_152_cov_195.396226	85	152	2	5	67	0.0746269
NODE_304027_length_152_cov_195.396226	85	152	3	62	67	0.9253731
NODE_304030_length_152_cov_68.094340	99	150	0	51	51	1.0000000
NODE_304112_length_151_cov_541.615385	19	88	2	9	69	0.1304348
NODE_304112_length_151_cov_541.615385	19	88	4	60	69	0.8695652
NODE_304112_length_151_cov_541.615385	72	149	4	77	77	1.0000000
NODE_304229_length_150_cov_88.647059	51	102	0	51	51	1.0000000
NODE_304472_length_148_cov_34.183673	23	99	4	76	76	1.0000000
NODE_304570_length_147_cov_472.354167	0	55	0	55	55	1.0000000
NODE_304570_length_147_cov_472.354167	12	89	0	77	77	1.0000000
NODE_304570_length_147_cov_472.354167	65	137	0	72	72	1.0000000
NODE_304572_length_147_cov_229.729167	7	56	0	49	49	1.0000000
NODE_304572_length_147_cov_229.729167	29	93	0	64	64	1.0000000
NODE_304572_length_147_cov_229.729167	29	93	0	64	64	1.0000000
NODE_304572_length_147_cov_229.729167	29	93	0	64	64	1.0000000
NODE_304573_length_147_cov_213.770833	37	117	0	80	80	1.0000000
NODE_304573_length_147_cov_213.770833	90	146	0	56	56	1.0000000
NODE_304697_length_146_cov_182.893617	1	60	0	59	59	1.0000000
NODE_304697_length_146_cov_182.893617	34	60	0	26	26	1.0000000
NODE_304697_length_146_cov_182.893617	113	144	0	31	31	1.0000000
NODE_304698_length_146_cov_152.808511	0	69	0	69	69	1.0000000
NODE_304698_length_146_cov_152.808511	42	122	0	80	80	1.0000000
NODE_304703_length_146_cov_89.808511	0	53	0	53	53	1.0000000
NODE_304703_length_146_cov_89.808511	26	106	0	80	80	1.0000000
NODE_304703_length_146_cov_89.808511	74	146	0	72	72	1.0000000
NODE_304703_length_146_cov_89.808511	79	101	0	22	22	1.0000000
NODE_304707_length_146_cov_57.446809	44	124	0	80	80	1.0000000
NODE_304708_length_146_cov_54.106383	0	69	0	69	69	1.0000000
NODE_304708_length_146_cov_54.106383	42	122	0	80	80	1.0000000
NODE_304710_length_146_cov_46.765957	3	83	0	80	80	1.0000000
NODE_304710_length_146_cov_46.765957	3	83	0	80	80	1.0000000
NODE_304710_length_146_cov_46.765957	3	83	0	80	80	1.0000000
NODE_304710_length_146_cov_46.765957	3	83	0	80	80	1.0000000
NODE_304710_length_146_cov_46.765957	3	83	0	80	80	1.0000000
NODE_304710_length_146_cov_46.765957	12	83	0	71	71	1.0000000
NODE_304710_length_146_cov_46.765957	56	136	0	80	80	1.0000000
NODE_304710_length_146_cov_46.765957	56	136	0	80	80	1.0000000
NODE_304711_length_146_cov_44.021277	0	69	0	69	69	1.0000000
NODE_304711_length_146_cov_44.021277	42	122	0	80	80	1.0000000
NODE_304798_length_145_cov_1385.413043	0	69	8	3	69	0.0434783
NODE_304798_length_145_cov_1385.413043	0	69	10	19	69	0.2753623
NODE_304798_length_145_cov_1385.413043	0	69	12	47	69	0.6811594
NODE_304798_length_145_cov_1385.413043	42	122	8	5	80	0.0625000
NODE_304798_length_145_cov_1385.413043	42	122	10	4	80	0.0500000
NODE_304798_length_145_cov_1385.413043	42	122	12	71	80	0.8875000
NODE_304799_length_145_cov_880.369565	56	120	2	64	64	1.0000000
NODE_304799_length_145_cov_880.369565	56	120	2	64	64	1.0000000
NODE_304799_length_145_cov_880.369565	56	120	2	64	64	1.0000000
NODE_304799_length_145_cov_880.369565	93	142	0	12	49	0.2448980
NODE_304799_length_145_cov_880.369565	93	142	2	37	49	0.7551020
NODE_304923_length_144_cov_46.155556	1	81	0	80	80	1.0000000
NODE_305208_length_142_cov_244.488372	0	52	4	6	52	0.1153846
NODE_305208_length_142_cov_244.488372	0	52	5	1	52	0.0192308
NODE_305208_length_142_cov_244.488372	0	52	7	45	52	0.8653846
NODE_305229_length_142_cov_46.976744	1	65	0	64	64	1.0000000
NODE_305229_length_142_cov_46.976744	1	65	0	64	64	1.0000000
NODE_305229_length_142_cov_46.976744	1	65	0	64	64	1.0000000
NODE_305230_length_142_cov_45.000000	0	69	0	69	69	1.0000000
NODE_305385_length_141_cov_178.785714	58	118	4	60	60	1.0000000
NODE_305398_length_141_cov_62.285714	26	106	0	80	80	1.0000000
NODE_305398_length_141_cov_62.285714	26	106	0	80	80	1.0000000
NODE_305398_length_141_cov_62.285714	26	97	0	71	71	1.0000000
NODE_305402_length_141_cov_41.142857	26	97	0	71	71	1.0000000
NODE_305600_length_140_cov_60.439024	8	88	2	80	80	1.0000000
NODE_305600_length_140_cov_60.439024	8	88	2	80	80	1.0000000
NODE_305600_length_140_cov_60.439024	8	88	2	80	80	1.0000000
NODE_305600_length_140_cov_60.439024	8	88	2	80	80	1.0000000
NODE_305600_length_140_cov_60.439024	8	88	2	80	80	1.0000000
NODE_305616_length_140_cov_35.146341	22	102	0	80	80	1.0000000
NODE_305616_length_140_cov_35.146341	75	105	0	30	30	1.0000000
NODE_305618_length_140_cov_34.048780	0	77	0	77	77	1.0000000
NODE_305618_length_140_cov_34.048780	0	77	0	77	77	1.0000000
NODE_305618_length_140_cov_34.048780	50	130	0	80	80	1.0000000
NODE_305618_length_140_cov_34.048780	50	130	0	80	80	1.0000000
NODE_305618_length_140_cov_34.048780	55	130	0	75	75	1.0000000
NODE_305619_length_140_cov_19.926829	44	118	0	74	74	1.0000000
NODE_305783_length_139_cov_29.700000	0	40	0	40	40	1.0000000
NODE_305783_length_139_cov_29.700000	0	40	0	40	40	1.0000000
NODE_305783_length_139_cov_29.700000	13	93	0	80	80	1.0000000
NODE_305783_length_139_cov_29.700000	13	93	0	80	80	1.0000000
NODE_305783_length_139_cov_29.700000	13	93	0	80	80	1.0000000
NODE_305783_length_139_cov_29.700000	13	93	0	80	80	1.0000000
NODE_305783_length_139_cov_29.700000	13	93	0	80	80	1.0000000
NODE_305783_length_139_cov_29.700000	13	84	0	71	71	1.0000000
NODE_305936_length_138_cov_1475.615385	30	97	2	67	67	1.0000000
NODE_305936_length_138_cov_1475.615385	70	138	1	2	68	0.0294118
NODE_305936_length_138_cov_1475.615385	70	138	2	66	68	0.9705882
NODE_305963_length_138_cov_29.564103	11	91	0	80	80	1.0000000
NODE_305963_length_138_cov_29.564103	11	91	0	80	80	1.0000000
NODE_305963_length_138_cov_29.564103	64	128	0	64	64	1.0000000
NODE_305963_length_138_cov_29.564103	64	128	0	64	64	1.0000000
NODE_306081_length_137_cov_185.684211	20	104	0	84	84	1.0000000
NODE_306092_length_137_cov_58.289474	76	106	0	30	30	1.0000000
NODE_306099_length_137_cov_36.473684	31	111	0	80	80	1.0000000
NODE_306208_length_136_cov_1257.621622	27	107	0	80	80	1.0000000
NODE_306209_length_136_cov_769.594595	0	69	0	69	69	1.0000000
NODE_306222_length_136_cov_128.324324	39	119	0	80	80	1.0000000
NODE_306227_length_136_cov_90.783784	10	86	2	76	76	1.0000000
NODE_306227_length_136_cov_90.783784	59	136	2	77	77	1.0000000
NODE_306368_length_135_cov_2144.166667	0	73	0	3	73	0.0410959
NODE_306368_length_135_cov_2144.166667	0	73	2	5	73	0.0684932
NODE_306368_length_135_cov_2144.166667	0	73	4	65	73	0.8904110
NODE_306368_length_135_cov_2144.166667	46	126	4	80	80	1.0000000
NODE_306368_length_135_cov_2144.166667	83	135	0	4	52	0.0769231
NODE_306368_length_135_cov_2144.166667	83	135	2	1	52	0.0192308
NODE_306368_length_135_cov_2144.166667	83	135	4	47	52	0.9038461
NODE_306370_length_135_cov_630.194444	0	76	0	76	76	1.0000000
NODE_306371_length_135_cov_540.611111	0	76	0	76	76	1.0000000
NODE_306373_length_135_cov_257.416667	36	88	0	52	52	1.0000000
NODE_306374_length_135_cov_239.638889	97	135	0	38	38	1.0000000
NODE_306400_length_135_cov_35.055556	8	88	0	80	80	1.0000000
NODE_306400_length_135_cov_35.055556	61	125	0	64	64	1.0000000
NODE_306400_length_135_cov_35.055556	61	125	0	64	64	1.0000000
NODE_306402_length_135_cov_31.805556	0	76	0	76	76	1.0000000
NODE_306658_length_133_cov_140.411765	8	43	3	35	35	1.0000000
NODE_306658_length_133_cov_140.411765	53	88	3	35	35	1.0000000
NODE_306658_length_133_cov_140.411765	98	133	1	5	35	0.1428571
NODE_306658_length_133_cov_140.411765	98	133	2	6	35	0.1714286
NODE_306658_length_133_cov_140.411765	98	133	3	24	35	0.6857143
NODE_306661_length_133_cov_109.441176	63	129	0	27	66	0.4090909
NODE_306661_length_133_cov_109.441176	63	129	2	39	66	0.5909091
NODE_306812_length_132_cov_114.151515	2	44	0	42	42	1.0000000
NODE_306812_length_132_cov_114.151515	4	44	0	40	40	1.0000000
NODE_306812_length_132_cov_114.151515	17	83	0	66	66	1.0000000
NODE_306812_length_132_cov_114.151515	17	88	0	71	71	1.0000000
NODE_306824_length_132_cov_61.636364	3	76	0	73	73	1.0000000
NODE_306824_length_132_cov_61.636364	49	130	0	81	81	1.0000000
NODE_306824_length_132_cov_61.636364	103	125	0	22	22	1.0000000
NODE_306834_length_132_cov_33.393939	2	83	0	81	81	1.0000000
NODE_306834_length_132_cov_33.393939	7	29	0	22	22	1.0000000
NODE_306834_length_132_cov_33.393939	56	129	0	73	73	1.0000000
NODE_306965_length_131_cov_810.000000	0	60	0	60	60	1.0000000
NODE_306965_length_131_cov_810.000000	33	97	0	64	64	1.0000000
NODE_306965_length_131_cov_810.000000	33	97	0	64	64	1.0000000
NODE_306965_length_131_cov_810.000000	33	97	0	64	64	1.0000000
NODE_306985_length_131_cov_149.187500	25	105	0	80	80	1.0000000
NODE_306985_length_131_cov_149.187500	78	131	0	53	53	1.0000000
NODE_307121_length_130_cov_319.806452	54	126	0	72	72	1.0000000
NODE_307132_length_130_cov_153.516129	82	113	0	31	31	1.0000000
NODE_307140_length_130_cov_79.064516	0	53	0	53	53	1.0000000
NODE_307140_length_130_cov_79.064516	26	56	0	30	30	1.0000000
NODE_307270_length_129_cov_1851.133333	0	45	0	45	45	1.0000000
NODE_307270_length_129_cov_1851.133333	18	98	0	80	80	1.0000000
NODE_307285_length_129_cov_186.500000	0	78	0	78	78	1.0000000
NODE_307285_length_129_cov_186.500000	53	129	0	76	76	1.0000000
NODE_307287_length_129_cov_165.466667	36	111	0	75	75	1.0000000
NODE_307287_length_129_cov_165.466667	84	113	0	29	29	1.0000000
NODE_307292_length_129_cov_90.366667	0	48	0	48	48	1.0000000
NODE_307292_length_129_cov_90.366667	0	48	0	48	48	1.0000000
NODE_307292_length_129_cov_90.366667	0	48	0	48	48	1.0000000
NODE_307292_length_129_cov_90.366667	21	101	0	80	80	1.0000000
NODE_307442_length_128_cov_2621.517241	3	83	1	7	80	0.0875000
NODE_307442_length_128_cov_2621.517241	3	83	2	73	80	0.9125000
NODE_307442_length_128_cov_2621.517241	8	30	1	2	22	0.0909091
NODE_307442_length_128_cov_2621.517241	8	30	2	20	22	0.9090909
NODE_307442_length_128_cov_2621.517241	56	128	2	72	72	1.0000000
NODE_307443_length_128_cov_1604.275862	58	127	0	69	69	1.0000000
NODE_307458_length_128_cov_79.034483	43	123	0	80	80	1.0000000
NODE_307464_length_128_cov_61.793103	5	85	0	80	80	1.0000000
NODE_307549_length_127_cov_1879.785714	21	101	0	80	80	1.0000000
NODE_307549_length_127_cov_1879.785714	74	127	0	53	53	1.0000000
NODE_307583_length_127_cov_66.142857	38	118	0	80	80	1.0000000
NODE_307583_length_127_cov_66.142857	47	118	0	71	71	1.0000000
NODE_307590_length_127_cov_38.285714	12	86	0	74	74	1.0000000
NODE_307596_length_127_cov_30.607143	21	93	0	72	72	1.0000000
NODE_307662_length_126_cov_936.777778	24	96	0	72	72	1.0000000
NODE_307675_length_126_cov_147.185185	2	66	0	64	64	1.0000000
NODE_307675_length_126_cov_147.185185	2	66	0	64	64	1.0000000
NODE_307675_length_126_cov_147.185185	2	66	0	64	64	1.0000000
NODE_307675_length_126_cov_147.185185	39	99	0	60	60	1.0000000
NODE_307675_length_126_cov_147.185185	55	99	0	44	44	1.0000000
NODE_307684_length_126_cov_82.518519	44	75	0	31	31	1.0000000
NODE_307793_length_125_cov_656.807692	19	99	0	80	80	1.0000000
NODE_307806_length_125_cov_143.615385	52	125	0	73	73	1.0000000
NODE_307810_length_125_cov_131.923077	3	52	0	49	49	1.0000000
NODE_307810_length_125_cov_131.923077	25	89	0	64	64	1.0000000
NODE_307810_length_125_cov_131.923077	25	89	0	64	64	1.0000000
NODE_307816_length_125_cov_102.500000	0	56	0	56	56	1.0000000
NODE_307816_length_125_cov_102.500000	7	56	0	49	49	1.0000000
NODE_307816_length_125_cov_102.500000	29	114	0	85	85	1.0000000
NODE_307816_length_125_cov_102.500000	29	114	0	85	85	1.0000000
NODE_307816_length_125_cov_102.500000	29	114	0	85	85	1.0000000
NODE_307839_length_125_cov_28.115385	17	90	0	73	73	1.0000000
NODE_307839_length_125_cov_28.115385	57	98	0	41	41	1.0000000
NODE_307906_length_124_cov_945.680000	0	73	2	73	73	1.0000000
NODE_307906_length_124_cov_945.680000	53	124	0	11	71	0.1549296
NODE_307906_length_124_cov_945.680000	53	124	2	60	71	0.8450704
NODE_308023_length_123_cov_1186.083333	0	76	0	1	76	0.0131579
NODE_308023_length_123_cov_1186.083333	0	76	2	75	76	0.9868421
NODE_308023_length_123_cov_1186.083333	0	76	0	1	76	0.0131579
NODE_308023_length_123_cov_1186.083333	0	76	2	75	76	0.9868421
NODE_308023_length_123_cov_1186.083333	0	76	0	1	76	0.0131579
NODE_308023_length_123_cov_1186.083333	0	76	2	75	76	0.9868421
NODE_308023_length_123_cov_1186.083333	0	76	0	1	76	0.0131579
NODE_308023_length_123_cov_1186.083333	0	76	2	75	76	0.9868421
NODE_308023_length_123_cov_1186.083333	49	123	0	20	74	0.2702703
NODE_308023_length_123_cov_1186.083333	49	123	2	54	74	0.7297297
NODE_308023_length_123_cov_1186.083333	49	123	0	20	74	0.2702703
NODE_308023_length_123_cov_1186.083333	49	123	2	54	74	0.7297297
NODE_308023_length_123_cov_1186.083333	49	123	0	20	74	0.2702703
NODE_308023_length_123_cov_1186.083333	49	123	2	54	74	0.7297297
NODE_308024_length_123_cov_963.500000	19	88	0	69	69	1.0000000
NODE_308037_length_123_cov_181.291667	0	47	0	47	47	1.0000000
NODE_308037_length_123_cov_181.291667	24	100	0	76	76	1.0000000
NODE_308057_length_123_cov_55.375000	52	123	0	71	71	1.0000000
NODE_308057_length_123_cov_55.375000	52	123	0	71	71	1.0000000
NODE_308057_length_123_cov_55.375000	61	123	0	62	62	1.0000000
NODE_308068_length_123_cov_40.958333	9	89	0	80	80	1.0000000
NODE_308068_length_123_cov_40.958333	9	89	0	80	80	1.0000000
NODE_308068_length_123_cov_40.958333	9	89	0	80	80	1.0000000
NODE_308068_length_123_cov_40.958333	9	89	0	80	80	1.0000000
NODE_308068_length_123_cov_40.958333	9	89	0	80	80	1.0000000
NODE_308068_length_123_cov_40.958333	9	80	0	71	71	1.0000000
NODE_308180_length_122_cov_111.043478	8	88	0	80	80	1.0000000
NODE_308180_length_122_cov_111.043478	8	88	0	80	80	1.0000000
NODE_308184_length_122_cov_67.565217	0	50	0	50	50	1.0000000
NODE_308184_length_122_cov_67.565217	0	50	0	50	50	1.0000000
NODE_308184_length_122_cov_67.565217	23	103	0	80	80	1.0000000
NODE_308184_length_122_cov_67.565217	23	103	0	80	80	1.0000000
NODE_308184_length_122_cov_67.565217	23	103	0	80	80	1.0000000
NODE_308184_length_122_cov_67.565217	23	103	0	80	80	1.0000000
NODE_308184_length_122_cov_67.565217	23	103	0	80	80	1.0000000
NODE_308184_length_122_cov_67.565217	23	94	0	71	71	1.0000000
NODE_308188_length_122_cov_58.826087	28	99	0	71	71	1.0000000
NODE_308188_length_122_cov_58.826087	33	99	0	66	66	1.0000000
NODE_308188_length_122_cov_58.826087	72	122	0	50	50	1.0000000
NODE_308188_length_122_cov_58.826087	72	122	0	50	50	1.0000000
NODE_308198_length_122_cov_38.173913	12	93	0	81	81	1.0000000
NODE_308257_length_121_cov_159.318182	24	55	0	31	31	1.0000000
NODE_308260_length_121_cov_120.181818	20	100	0	80	80	1.0000000
NODE_308260_length_121_cov_120.181818	20	95	0	75	75	1.0000000
NODE_308260_length_121_cov_120.181818	20	100	0	80	80	1.0000000
NODE_308260_length_121_cov_120.181818	29	100	0	71	71	1.0000000
NODE_308273_length_121_cov_54.181818	7	70	0	63	63	1.0000000
NODE_308273_length_121_cov_54.181818	7	70	0	63	63	1.0000000
NODE_308273_length_121_cov_54.181818	7	70	0	63	63	1.0000000
NODE_308273_length_121_cov_54.181818	9	70	0	61	61	1.0000000
NODE_308273_length_121_cov_54.181818	43	109	0	66	66	1.0000000
NODE_308273_length_121_cov_54.181818	43	121	0	78	78	1.0000000
NODE_308273_length_121_cov_54.181818	64	117	0	53	53	1.0000000
NODE_308317_length_120_cov_1404.619048	0	64	0	64	64	1.0000000
NODE_308317_length_120_cov_1404.619048	45	117	0	72	72	1.0000000
NODE_308318_length_120_cov_1138.428571	19	99	2	80	80	1.0000000
NODE_308318_length_120_cov_1138.428571	72	120	0	1	48	0.0208333
NODE_308318_length_120_cov_1138.428571	72	120	2	47	48	0.9791667
NODE_308357_length_120_cov_54.666667	0	69	0	69	69	1.0000000
NODE_308357_length_120_cov_54.666667	0	69	0	69	69	1.0000000
NODE_308357_length_120_cov_54.666667	0	69	0	69	69	1.0000000
NODE_308357_length_120_cov_54.666667	42	108	0	66	66	1.0000000
NODE_308357_length_120_cov_54.666667	53	120	0	67	67	1.0000000
NODE_308357_length_120_cov_54.666667	53	120	0	67	67	1.0000000
NODE_308487_length_118_cov_1211.578947	49	116	0	67	67	1.0000000
NODE_308488_length_118_cov_1157.157895	4	70	2	66	66	1.0000000
NODE_308500_length_118_cov_218.210526	0	63	0	63	63	1.0000000
NODE_308500_length_118_cov_218.210526	35	115	0	80	80	1.0000000
NODE_308504_length_118_cov_161.052632	4	70	0	66	66	1.0000000
NODE_308572_length_117_cov_338.555556	7	70	0	63	63	1.0000000
NODE_308572_length_117_cov_338.555556	7	70	0	63	63	1.0000000
NODE_308572_length_117_cov_338.555556	7	70	0	63	63	1.0000000
NODE_308572_length_117_cov_338.555556	9	70	0	61	61	1.0000000
NODE_308572_length_117_cov_338.555556	43	109	0	66	66	1.0000000
NODE_308572_length_117_cov_338.555556	43	114	0	71	71	1.0000000
NODE_308572_length_117_cov_338.555556	64	117	0	53	53	1.0000000
NODE_308654_length_116_cov_1897.470588	0	77	0	77	77	1.0000000
NODE_308654_length_116_cov_1897.470588	34	111	0	77	77	1.0000000
NODE_308668_length_116_cov_438.529412	15	95	0	80	80	1.0000000
NODE_308668_length_116_cov_438.529412	68	116	0	48	48	1.0000000
NODE_308701_length_116_cov_93.235294	52	116	0	64	64	1.0000000
NODE_308722_length_116_cov_46.882353	6	66	0	60	60	1.0000000
NODE_308727_length_116_cov_38.352941	20	100	0	80	80	1.0000000
NODE_308746_length_115_cov_1012.625000	31	114	0	83	83	1.0000000
NODE_308750_length_115_cov_776.625000	9	92	0	83	83	1.0000000
NODE_308752_length_115_cov_623.937500	0	74	0	74	74	1.0000000
NODE_308782_length_115_cov_144.812500	4	73	0	69	69	1.0000000
NODE_308806_length_115_cov_65.187500	16	76	0	60	60	1.0000000
NODE_308846_length_114_cov_819.466667	40	114	0	74	74	1.0000000
NODE_308846_length_114_cov_819.466667	40	114	0	74	74	1.0000000
NODE_308846_length_114_cov_819.466667	49	114	0	65	65	1.0000000
NODE_308866_length_114_cov_285.666667	0	78	0	78	78	1.0000000
NODE_308866_length_114_cov_285.666667	51	114	0	63	63	1.0000000
NODE_308886_length_114_cov_83.600000	51	82	0	31	31	1.0000000
NODE_308891_length_114_cov_67.666667	40	90	0	50	50	1.0000000
NODE_308939_length_113_cov_446.214286	5	82	0	77	77	1.0000000
NODE_308939_length_113_cov_446.214286	5	82	0	77	77	1.0000000
NODE_308967_length_113_cov_160.071429	0	64	0	64	64	1.0000000
NODE_308967_length_113_cov_160.071429	0	64	0	64	64	1.0000000
NODE_308967_length_113_cov_160.071429	37	103	0	66	66	1.0000000
NODE_308967_length_113_cov_160.071429	37	108	0	71	71	1.0000000
NODE_309037_length_112_cov_963.384615	43	112	0	69	69	1.0000000
NODE_309044_length_112_cov_653.615385	7	78	0	71	71	1.0000000
NODE_309044_length_112_cov_653.615385	12	78	0	66	66	1.0000000
NODE_309044_length_112_cov_653.615385	51	112	0	61	61	1.0000000
NODE_309044_length_112_cov_653.615385	51	112	0	61	61	1.0000000
NODE_309067_length_112_cov_219.538462	0	62	0	62	62	1.0000000
NODE_309067_length_112_cov_219.538462	0	57	0	57	57	1.0000000
NODE_309067_length_112_cov_219.538462	0	62	0	62	62	1.0000000
NODE_309067_length_112_cov_219.538462	0	59	0	59	59	1.0000000
NODE_309067_length_112_cov_219.538462	35	112	0	77	77	1.0000000
NODE_309067_length_112_cov_219.538462	35	112	0	77	77	1.0000000
NODE_309067_length_112_cov_219.538462	35	112	0	77	77	1.0000000
NODE_309078_length_112_cov_160.307692	0	69	0	69	69	1.0000000
NODE_309079_length_112_cov_134.846154	11	91	0	80	80	1.0000000
NODE_309079_length_112_cov_134.846154	11	91	0	80	80	1.0000000
NODE_309079_length_112_cov_134.846154	64	112	0	48	48	1.0000000
NODE_309079_length_112_cov_134.846154	64	112	0	48	48	1.0000000
NODE_309079_length_112_cov_134.846154	64	112	0	48	48	1.0000000
NODE_309092_length_112_cov_84.384615	10	90	0	80	80	1.0000000
NODE_309097_length_112_cov_72.769231	36	100	0	64	64	1.0000000
NODE_309106_length_112_cov_35.307692	13	76	0	63	63	1.0000000
NODE_309123_length_111_cov_1107.833333	0	52	0	52	52	1.0000000
NODE_309123_length_111_cov_1107.833333	0	52	0	52	52	1.0000000
NODE_309123_length_111_cov_1107.833333	0	52	0	52	52	1.0000000
NODE_309123_length_111_cov_1107.833333	0	52	0	52	52	1.0000000
NODE_309123_length_111_cov_1107.833333	25	105	0	80	80	1.0000000
NODE_309123_length_111_cov_1107.833333	25	105	0	80	80	1.0000000
NODE_309123_length_111_cov_1107.833333	25	105	0	80	80	1.0000000
NODE_309123_length_111_cov_1107.833333	25	105	0	80	80	1.0000000
NODE_309123_length_111_cov_1107.833333	25	105	0	80	80	1.0000000
NODE_309123_length_111_cov_1107.833333	25	105	0	80	80	1.0000000
NODE_309126_length_111_cov_827.500000	3	74	0	71	71	1.0000000
NODE_309126_length_111_cov_827.500000	8	74	0	66	66	1.0000000
NODE_309126_length_111_cov_827.500000	47	111	0	64	64	1.0000000
NODE_309126_length_111_cov_827.500000	47	111	0	64	64	1.0000000
NODE_309126_length_111_cov_827.500000	47	111	0	64	64	1.0000000
NODE_309129_length_111_cov_726.833333	12	89	0	77	77	1.0000000
NODE_309129_length_111_cov_726.833333	12	89	0	77	77	1.0000000
NODE_309129_length_111_cov_726.833333	62	111	0	49	49	1.0000000
NODE_309129_length_111_cov_726.833333	67	111	0	44	44	1.0000000
NODE_309131_length_111_cov_692.416667	31	111	0	80	80	1.0000000
NODE_309149_length_111_cov_241.750000	30	97	0	67	67	1.0000000
NODE_309160_length_111_cov_169.416667	21	102	0	81	81	1.0000000
NODE_309200_length_110_cov_554.909091	1	28	0	27	27	1.0000000
NODE_309200_length_110_cov_554.909091	1	81	0	80	80	1.0000000
NODE_309202_length_110_cov_537.545455	0	75	0	75	75	1.0000000
NODE_309202_length_110_cov_537.545455	53	107	0	54	54	1.0000000
NODE_309235_length_110_cov_91.636364	19	54	0	35	35	1.0000000
NODE_309235_length_110_cov_91.636364	64	107	0	43	43	1.0000000
NODE_309239_length_110_cov_80.272727	19	54	0	35	35	1.0000000
NODE_309239_length_110_cov_80.272727	64	99	0	35	35	1.0000000
NODE_309241_length_110_cov_78.363636	19	54	0	35	35	1.0000000
NODE_309241_length_110_cov_78.363636	64	107	0	43	43	1.0000000
NODE_309245_length_110_cov_68.727273	11	46	2	35	35	1.0000000
NODE_309245_length_110_cov_68.727273	56	91	2	35	35	1.0000000
NODE_309252_length_110_cov_44.545455	5	57	0	52	52	1.0000000
NODE_309263_length_109_cov_1364.100000	29	98	0	69	69	1.0000000
NODE_309275_length_109_cov_689.800000	12	86	0	74	74	1.0000000
NODE_309309_length_109_cov_250.800000	4	66	0	62	62	1.0000000
NODE_309311_length_109_cov_242.000000	29	98	0	69	69	1.0000000
NODE_309326_length_109_cov_139.000000	26	106	0	80	80	1.0000000
NODE_309345_length_109_cov_84.500000	33	93	0	60	60	1.0000000
NODE_309349_length_109_cov_75.300000	0	65	0	65	65	1.0000000
NODE_309384_length_108_cov_1542.666667	28	108	0	80	80	1.0000000
NODE_309391_length_108_cov_987.666667	5	85	0	80	80	1.0000000
NODE_309391_length_108_cov_987.666667	5	85	0	80	80	1.0000000
NODE_309391_length_108_cov_987.666667	5	85	0	80	80	1.0000000
NODE_309391_length_108_cov_987.666667	5	85	0	80	80	1.0000000
NODE_309391_length_108_cov_987.666667	5	85	0	80	80	1.0000000
NODE_309391_length_108_cov_987.666667	58	108	0	50	50	1.0000000
NODE_309391_length_108_cov_987.666667	58	108	0	50	50	1.0000000
NODE_309395_length_108_cov_841.666667	1	65	0	64	64	1.0000000
NODE_309395_length_108_cov_841.666667	1	65	0	64	64	1.0000000
NODE_309395_length_108_cov_841.666667	1	65	0	64	64	1.0000000
NODE_309433_length_108_cov_213.333333	22	81	0	59	59	1.0000000
NODE_309433_length_108_cov_213.333333	55	81	0	26	26	1.0000000
NODE_309464_length_108_cov_107.888889	11	82	0	71	71	1.0000000
NODE_309464_length_108_cov_107.888889	16	82	0	66	66	1.0000000
NODE_309464_length_108_cov_107.888889	55	108	0	53	53	1.0000000
NODE_309464_length_108_cov_107.888889	55	108	0	53	53	1.0000000
NODE_309464_length_108_cov_107.888889	55	108	0	53	53	1.0000000
NODE_309472_length_108_cov_76.444444	13	76	0	63	63	1.0000000
NODE_309479_length_108_cov_51.000000	0	53	0	53	53	1.0000000
NODE_309479_length_108_cov_51.000000	0	53	0	53	53	1.0000000
NODE_309479_length_108_cov_51.000000	0	53	0	53	53	1.0000000
NODE_309479_length_108_cov_51.000000	26	106	0	80	80	1.0000000
NODE_309479_length_108_cov_51.000000	26	106	0	80	80	1.0000000
NODE_309479_length_108_cov_51.000000	26	106	0	80	80	1.0000000
NODE_309479_length_108_cov_51.000000	26	106	0	80	80	1.0000000
NODE_309479_length_108_cov_51.000000	26	106	0	80	80	1.0000000
NODE_309479_length_108_cov_51.000000	26	97	0	71	71	1.0000000
NODE_309490_length_108_cov_31.111111	11	82	0	71	71	1.0000000
NODE_309490_length_108_cov_31.111111	16	82	0	66	66	1.0000000
NODE_309490_length_108_cov_31.111111	55	108	0	53	53	1.0000000
NODE_309490_length_108_cov_31.111111	55	108	0	53	53	1.0000000
NODE_309490_length_108_cov_31.111111	55	108	0	53	53	1.0000000
NODE_309530_length_107_cov_608.250000	0	64	0	64	64	1.0000000
NODE_309530_length_107_cov_608.250000	53	103	0	50	50	1.0000000
NODE_309551_length_107_cov_303.250000	0	56	0	56	56	1.0000000
NODE_309551_length_107_cov_303.250000	29	99	0	70	70	1.0000000
NODE_309657_length_106_cov_522.571429	10	90	0	80	80	1.0000000
NODE_309657_length_106_cov_522.571429	10	90	0	80	80	1.0000000
NODE_309657_length_106_cov_522.571429	10	90	0	80	80	1.0000000
NODE_309657_length_106_cov_522.571429	10	90	0	80	80	1.0000000
NODE_309657_length_106_cov_522.571429	10	90	0	80	80	1.0000000
NODE_309657_length_106_cov_522.571429	19	90	0	71	71	1.0000000
NODE_309696_length_106_cov_161.857143	7	78	0	71	71	1.0000000
NODE_309696_length_106_cov_161.857143	51	106	0	55	55	1.0000000
NODE_309707_length_106_cov_130.714286	0	76	0	76	76	1.0000000
NODE_309714_length_106_cov_108.000000	0	76	0	76	76	1.0000000
NODE_309717_length_106_cov_102.142857	0	62	0	62	62	1.0000000
NODE_309717_length_106_cov_102.142857	35	106	0	71	71	1.0000000
NODE_309717_length_106_cov_102.142857	35	106	0	71	71	1.0000000
NODE_309747_length_106_cov_39.428571	0	76	0	76	76	1.0000000
NODE_309761_length_106_cov_30.857143	0	70	0	70	70	1.0000000
NODE_309761_length_106_cov_30.857143	0	70	0	70	70	1.0000000
NODE_309761_length_106_cov_30.857143	0	70	0	70	70	1.0000000
NODE_309761_length_106_cov_30.857143	43	92	0	49	49	1.0000000
NODE_309761_length_106_cov_30.857143	53	106	0	53	53	1.0000000
NODE_309761_length_106_cov_30.857143	53	106	0	53	53	1.0000000
NODE_309775_length_105_cov_2054.666667	31	105	0	74	74	1.0000000
NODE_309775_length_105_cov_2054.666667	31	105	0	74	74	1.0000000
NODE_309775_length_105_cov_2054.666667	31	105	0	74	74	1.0000000
NODE_309775_length_105_cov_2054.666667	31	105	0	74	74	1.0000000
NODE_309788_length_105_cov_830.833333	30	105	0	75	75	1.0000000
NODE_309789_length_105_cov_825.500000	0	77	0	77	77	1.0000000
NODE_309789_length_105_cov_825.500000	0	77	0	77	77	1.0000000
NODE_309789_length_105_cov_825.500000	50	99	0	49	49	1.0000000
NODE_309789_length_105_cov_825.500000	55	105	0	50	50	1.0000000
NODE_309815_length_105_cov_231.333333	0	54	0	54	54	1.0000000
NODE_309815_length_105_cov_231.333333	27	99	0	72	72	1.0000000
NODE_309842_length_105_cov_85.333333	14	94	0	80	80	1.0000000
NODE_309842_length_105_cov_85.333333	67	89	0	22	22	1.0000000
NODE_309855_length_105_cov_61.833333	23	103	0	80	80	1.0000000
NODE_309867_length_105_cov_40.666667	6	66	0	60	60	1.0000000
NODE_309925_length_104_cov_1016.000000	0	78	0	78	78	1.0000000
NODE_309925_length_104_cov_1016.000000	53	99	0	46	46	1.0000000
NODE_309935_length_104_cov_791.200000	0	67	0	67	67	1.0000000
NODE_309935_length_104_cov_791.200000	0	67	0	67	67	1.0000000
NODE_309935_length_104_cov_791.200000	40	104	0	64	64	1.0000000
NODE_309938_length_104_cov_574.200000	21	101	0	80	80	1.0000000
NODE_309938_length_104_cov_574.200000	21	101	0	80	80	1.0000000
NODE_309938_length_104_cov_574.200000	21	101	0	80	80	1.0000000
NODE_309938_length_104_cov_574.200000	21	101	0	80	80	1.0000000
NODE_309938_length_104_cov_574.200000	21	101	0	80	80	1.0000000
NODE_309938_length_104_cov_574.200000	21	92	0	71	71	1.0000000
NODE_309940_length_104_cov_547.400000	10	87	0	77	77	1.0000000
NODE_309940_length_104_cov_547.400000	10	87	0	77	77	1.0000000
NODE_310020_length_104_cov_46.800000	42	104	0	62	62	1.0000000
NODE_310054_length_103_cov_2267.000000	0	54	0	54	54	1.0000000
NODE_310054_length_103_cov_2267.000000	27	100	0	73	73	1.0000000
NODE_310082_length_103_cov_890.000000	6	70	0	64	64	1.0000000
NODE_310082_length_103_cov_890.000000	6	70	0	64	64	1.0000000
NODE_310082_length_103_cov_890.000000	6	70	0	64	64	1.0000000
NODE_310082_length_103_cov_890.000000	43	103	0	60	60	1.0000000
NODE_310082_length_103_cov_890.000000	59	103	0	44	44	1.0000000
NODE_310090_length_103_cov_768.500000	7	78	0	71	71	1.0000000
NODE_310090_length_103_cov_768.500000	12	78	0	66	66	1.0000000
NODE_310090_length_103_cov_768.500000	51	99	0	48	48	1.0000000
NODE_310090_length_103_cov_768.500000	51	99	0	48	48	1.0000000
NODE_310090_length_103_cov_768.500000	51	99	0	48	48	1.0000000
NODE_310091_length_103_cov_751.000000	0	71	0	71	71	1.0000000
NODE_310091_length_103_cov_751.000000	0	71	0	71	71	1.0000000
NODE_310091_length_103_cov_751.000000	44	93	0	49	49	1.0000000
NODE_310094_length_103_cov_678.000000	10	74	0	64	64	1.0000000
NODE_310094_length_103_cov_678.000000	10	74	0	64	64	1.0000000
NODE_310094_length_103_cov_678.000000	10	74	0	64	64	1.0000000
NODE_310094_length_103_cov_678.000000	47	96	0	49	49	1.0000000
NODE_310103_length_103_cov_462.750000	19	99	0	80	80	1.0000000
NODE_310116_length_103_cov_300.250000	0	63	0	63	63	1.0000000
NODE_310147_length_103_cov_103.250000	4	47	0	43	43	1.0000000
NODE_310152_length_103_cov_80.250000	36	99	0	63	63	1.0000000
NODE_310153_length_103_cov_76.500000	4	63	0	59	59	1.0000000
NODE_310160_length_103_cov_42.000000	0	78	0	78	78	1.0000000
NODE_310160_length_103_cov_42.000000	7	78	0	71	71	1.0000000
NODE_310160_length_103_cov_42.000000	12	78	0	66	66	1.0000000
NODE_310160_length_103_cov_42.000000	51	99	0	48	48	1.0000000
NODE_310160_length_103_cov_42.000000	51	99	0	48	48	1.0000000
NODE_310160_length_103_cov_42.000000	51	99	0	48	48	1.0000000
NODE_310211_length_102_cov_2033.666667	0	48	0	48	48	1.0000000
NODE_310211_length_102_cov_2033.666667	21	101	0	80	80	1.0000000
NODE_310227_length_102_cov_1028.333333	52	102	0	50	50	1.0000000
NODE_310230_length_102_cov_987.666667	15	98	0	83	83	1.0000000
NODE_310231_length_102_cov_934.000000	12	95	0	83	83	1.0000000
NODE_310246_length_102_cov_685.666667	0	73	0	73	73	1.0000000
NODE_310247_length_102_cov_646.666667	15	89	0	74	74	1.0000000
NODE_310269_length_102_cov_250.000000	12	72	0	60	60	1.0000000
NODE_310273_length_102_cov_216.333333	4	70	0	66	66	1.0000000
NODE_310273_length_102_cov_216.333333	4	70	0	66	66	1.0000000
NODE_310273_length_102_cov_216.333333	4	70	0	66	66	1.0000000
NODE_310273_length_102_cov_216.333333	43	92	0	49	49	1.0000000
NODE_310273_length_102_cov_216.333333	57	102	0	45	45	1.0000000
NODE_310287_length_102_cov_152.333333	0	63	0	63	63	1.0000000
NODE_310295_length_102_cov_124.333333	0	70	0	70	70	1.0000000
NODE_310302_length_102_cov_106.333333	0	78	0	78	78	1.0000000
NODE_310302_length_102_cov_106.333333	7	78	0	71	71	1.0000000
NODE_310302_length_102_cov_106.333333	12	78	0	66	66	1.0000000
NODE_310302_length_102_cov_106.333333	51	102	0	51	51	1.0000000
NODE_310302_length_102_cov_106.333333	51	102	0	51	51	1.0000000
NODE_310302_length_102_cov_106.333333	51	102	0	51	51	1.0000000
NODE_310316_length_102_cov_74.333333	31	99	0	68	68	1.0000000
NODE_310321_length_102_cov_71.000000	11	91	0	80	80	1.0000000
NODE_310336_length_102_cov_32.666667	0	65	0	65	65	1.0000000
NODE_310336_length_102_cov_32.666667	38	99	0	61	61	1.0000000
NODE_310405_length_101_cov_2217.000000	0	43	0	43	43	1.0000000
NODE_310405_length_101_cov_2217.000000	23	96	0	73	73	1.0000000
NODE_310464_length_101_cov_740.500000	2	66	0	64	64	1.0000000
NODE_310464_length_101_cov_740.500000	2	66	0	64	64	1.0000000
NODE_310464_length_101_cov_740.500000	2	66	0	64	64	1.0000000
NODE_310464_length_101_cov_740.500000	39	101	0	62	62	1.0000000
NODE_310464_length_101_cov_740.500000	55	101	0	46	46	1.0000000
NODE_310469_length_101_cov_701.000000	0	62	0	62	62	1.0000000
NODE_310469_length_101_cov_701.000000	35	99	0	64	64	1.0000000
NODE_310469_length_101_cov_701.000000	35	99	0	64	64	1.0000000
NODE_310469_length_101_cov_701.000000	35	99	0	64	64	1.0000000
NODE_310471_length_101_cov_679.000000	2	76	0	74	74	1.0000000
NODE_310500_length_101_cov_374.500000	2	50	0	48	48	1.0000000
NODE_310500_length_101_cov_374.500000	2	50	0	48	48	1.0000000
NODE_310500_length_101_cov_374.500000	2	50	0	48	48	1.0000000
NODE_310500_length_101_cov_374.500000	23	89	0	66	66	1.0000000
NODE_310500_length_101_cov_374.500000	23	94	0	71	71	1.0000000
NODE_310516_length_101_cov_294.000000	4	52	0	48	48	1.0000000
NODE_310516_length_101_cov_294.000000	4	52	0	48	48	1.0000000
NODE_310516_length_101_cov_294.000000	4	52	0	48	48	1.0000000
NODE_310516_length_101_cov_294.000000	25	91	0	66	66	1.0000000
NODE_310516_length_101_cov_294.000000	25	96	0	71	71	1.0000000
NODE_310529_length_101_cov_230.500000	2	76	0	74	74	1.0000000
NODE_310529_length_101_cov_230.500000	2	76	0	74	74	1.0000000
NODE_310529_length_101_cov_230.500000	2	76	0	74	74	1.0000000
NODE_310529_length_101_cov_230.500000	49	101	0	52	52	1.0000000
NODE_310529_length_101_cov_230.500000	55	101	0	46	46	1.0000000
NODE_310550_length_101_cov_157.000000	13	72	0	59	59	1.0000000
NODE_310550_length_101_cov_157.000000	46	72	0	26	26	1.0000000
NODE_310565_length_101_cov_134.500000	2	37	0	35	35	1.0000000
NODE_310685_length_100_cov_1883.000000	32	100	0	68	68	1.0000000
NODE_310685_length_100_cov_1883.000000	32	100	0	68	68	1.0000000
NODE_310685_length_100_cov_1883.000000	32	99	0	67	67	1.0000000
NODE_310685_length_100_cov_1883.000000	32	100	0	68	68	1.0000000
NODE_310704_length_100_cov_1310.000000	0	42	0	42	42	1.0000000
NODE_310704_length_100_cov_1310.000000	1	42	0	41	41	1.0000000
NODE_310704_length_100_cov_1310.000000	38	100	0	62	62	1.0000000
NODE_310704_length_100_cov_1310.000000	38	95	0	57	57	1.0000000
NODE_310704_length_100_cov_1310.000000	38	100	0	62	62	1.0000000
NODE_310704_length_100_cov_1310.000000	38	100	0	62	62	1.0000000
NODE_310708_length_100_cov_1239.000000	1	48	0	47	47	1.0000000
NODE_310740_length_100_cov_694.000000	0	62	0	62	62	1.0000000
NODE_310740_length_100_cov_694.000000	0	62	0	62	62	1.0000000
NODE_310740_length_100_cov_694.000000	35	100	0	65	65	1.0000000
NODE_310748_length_100_cov_602.000000	0	57	0	57	57	1.0000000
NODE_310750_length_100_cov_590.000000	0	58	0	58	58	1.0000000
NODE_310798_length_100_cov_274.000000	1	67	0	66	66	1.0000000
NODE_310798_length_100_cov_274.000000	1	67	0	66	66	1.0000000
NODE_310798_length_100_cov_274.000000	1	67	0	66	66	1.0000000
NODE_310798_length_100_cov_274.000000	40	100	0	60	60	1.0000000
NODE_310798_length_100_cov_274.000000	54	100	0	46	46	1.0000000
NODE_310808_length_100_cov_217.000000	4	75	0	71	71	1.0000000
NODE_310808_length_100_cov_217.000000	9	75	0	66	66	1.0000000
NODE_310808_length_100_cov_217.000000	48	99	0	51	51	1.0000000
NODE_310808_length_100_cov_217.000000	48	99	0	51	51	1.0000000
NODE_310808_length_100_cov_217.000000	48	99	0	51	51	1.0000000
NODE_310810_length_100_cov_209.000000	1	44	0	43	43	1.0000000
NODE_310810_length_100_cov_209.000000	40	100	0	60	60	1.0000000
NODE_310810_length_100_cov_209.000000	40	100	0	60	60	1.0000000
NODE_310819_length_100_cov_185.000000	0	46	0	46	46	1.0000000
NODE_310819_length_100_cov_185.000000	9	58	0	49	49	1.0000000
NODE_310819_length_100_cov_185.000000	31	99	0	68	68	1.0000000
NODE_310819_length_100_cov_185.000000	31	99	0	68	68	1.0000000
NODE_310819_length_100_cov_185.000000	31	99	0	68	68	1.0000000
NODE_310828_length_100_cov_164.000000	9	92	0	83	83	1.0000000
NODE_310837_length_100_cov_152.000000	11	91	0	80	80	1.0000000
NODE_310837_length_100_cov_152.000000	11	91	0	80	80	1.0000000
NODE_310837_length_100_cov_152.000000	11	91	0	80	80	1.0000000
NODE_310837_length_100_cov_152.000000	11	91	0	80	80	1.0000000
NODE_310837_length_100_cov_152.000000	11	91	0	80	80	1.0000000
NODE_310839_length_100_cov_150.000000	0	54	0	54	54	1.0000000
NODE_310839_length_100_cov_150.000000	0	54	0	54	54	1.0000000
NODE_310839_length_100_cov_150.000000	27	100	0	73	73	1.0000000
NODE_310839_length_100_cov_150.000000	27	100	0	73	73	1.0000000
NODE_310840_length_100_cov_148.000000	2	82	0	80	80	1.0000000
NODE_310841_length_100_cov_148.000000	0	71	0	71	71	1.0000000
NODE_310841_length_100_cov_148.000000	0	71	0	71	71	1.0000000
NODE_310841_length_100_cov_148.000000	0	62	0	62	62	1.0000000
NODE_310876_length_100_cov_71.000000	0	75	0	75	75	1.0000000
NODE_310876_length_100_cov_71.000000	4	75	0	71	71	1.0000000
NODE_310876_length_100_cov_71.000000	9	75	0	66	66	1.0000000
NODE_310876_length_100_cov_71.000000	48	100	0	52	52	1.0000000
NODE_310876_length_100_cov_71.000000	48	100	0	52	52	1.0000000
NODE_310876_length_100_cov_71.000000	48	100	0	52	52	1.0000000
NODE_310896_length_100_cov_41.000000	0	75	0	75	75	1.0000000
NODE_310896_length_100_cov_41.000000	4	75	0	71	71	1.0000000
NODE_310896_length_100_cov_41.000000	9	75	0	66	66	1.0000000
NODE_310896_length_100_cov_41.000000	48	99	0	51	51	1.0000000
NODE_310896_length_100_cov_41.000000	48	99	0	51	51	1.0000000
NODE_310896_length_100_cov_41.000000	48	99	0	51	51	1.0000000
NODE_310904_length_100_cov_30.000000	1	42	0	41	41	1.0000000
