NODE_1_length_25698_cov_36.651041	315	395	0	80	80	1.0000000
NODE_1_length_25698_cov_36.651041	368	403	0	34	35	0.9714286
NODE_1_length_25698_cov_36.651041	368	403	3	1	35	0.0285714
NODE_1_length_25698_cov_36.651041	24448	24494	0	46	46	1.0000000
NODE_2_length_24307_cov_15.119712	2613	2689	0	76	76	1.0000000
NODE_2_length_24307_cov_15.119712	2662	2716	0	54	54	1.0000000
NODE_2_length_24307_cov_15.119712	11257	11320	0	63	63	1.0000000
NODE_2_length_24307_cov_15.119712	20621	20701	0	36	80	0.4500000
NODE_2_length_24307_cov_15.119712	20621	20701	2	44	80	0.5500000
NODE_2_length_24307_cov_15.119712	20674	20754	0	17	80	0.2125000
NODE_2_length_24307_cov_15.119712	20674	20754	2	63	80	0.7875000
NODE_7_length_12349_cov_28.144571	12251	12310	14	5	59	0.0847458
NODE_7_length_12349_cov_28.144571	12251	12310	15	6	59	0.1016949
NODE_7_length_12349_cov_28.144571	12251	12310	17	1	59	0.0169492
NODE_7_length_12349_cov_28.144571	12251	12310	23	1	59	0.0169492
NODE_7_length_12349_cov_28.144571	12251	12310	24	3	59	0.0508475
NODE_7_length_12349_cov_28.144571	12251	12310	30	1	59	0.0169492
NODE_7_length_12349_cov_28.144571	12251	12310	32	1	59	0.0169492
NODE_7_length_12349_cov_28.144571	12251	12310	34	1	59	0.0169492
NODE_7_length_12349_cov_28.144571	12251	12310	36	1	59	0.0169492
NODE_7_length_12349_cov_28.144571	12251	12310	38	1	59	0.0169492
NODE_7_length_12349_cov_28.144571	12251	12310	40	3	59	0.0508475
NODE_7_length_12349_cov_28.144571	12251	12310	49	11	59	0.1864407
NODE_7_length_12349_cov_28.144571	12251	12310	51	4	59	0.0677966
NODE_7_length_12349_cov_28.144571	12251	12310	53	2	59	0.0338983
NODE_7_length_12349_cov_28.144571	12251	12310	59	2	59	0.0338983
NODE_7_length_12349_cov_28.144571	12251	12310	61	2	59	0.0338983
NODE_7_length_12349_cov_28.144571	12251	12310	63	1	59	0.0169492
NODE_7_length_12349_cov_28.144571	12251	12310	65	1	59	0.0169492
NODE_7_length_12349_cov_28.144571	12251	12310	67	2	59	0.0338983
NODE_7_length_12349_cov_28.144571	12251	12310	69	1	59	0.0169492
NODE_7_length_12349_cov_28.144571	12251	12310	71	9	59	0.1525424
NODE_7_length_12349_cov_28.144571	12284	12310	14	5	26	0.1923077
NODE_7_length_12349_cov_28.144571	12284	12310	15	6	26	0.2307692
NODE_7_length_12349_cov_28.144571	12284	12310	17	1	26	0.0384615
NODE_7_length_12349_cov_28.144571	12284	12310	23	1	26	0.0384615
NODE_7_length_12349_cov_28.144571	12284	12310	24	3	26	0.1153846
NODE_7_length_12349_cov_28.144571	12284	12310	30	1	26	0.0384615
NODE_7_length_12349_cov_28.144571	12284	12310	32	1	26	0.0384615
NODE_7_length_12349_cov_28.144571	12284	12310	34	1	26	0.0384615
NODE_7_length_12349_cov_28.144571	12284	12310	36	1	26	0.0384615
NODE_7_length_12349_cov_28.144571	12284	12310	38	1	26	0.0384615
NODE_7_length_12349_cov_28.144571	12284	12310	40	3	26	0.1153846
NODE_7_length_12349_cov_28.144571	12284	12310	49	2	26	0.0769231
NODE_10_length_11096_cov_14.154679	6455	6535	0	80	80	1.0000000
NODE_10_length_11096_cov_14.154679	6508	6588	0	80	80	1.0000000
NODE_10_length_11096_cov_14.154679	6584	6664	0	80	80	1.0000000
NODE_10_length_11096_cov_14.154679	6637	6717	0	77	80	0.9625000
NODE_10_length_11096_cov_14.154679	6637	6717	2	3	80	0.0375000
NODE_10_length_11096_cov_14.154679	7182	7229	177	1	47	0.0212766
NODE_10_length_11096_cov_14.154679	7182	7229	186	1	47	0.0212766
NODE_10_length_11096_cov_14.154679	7182	7229	191	1	47	0.0212766
NODE_10_length_11096_cov_14.154679	7182	7229	192	1	47	0.0212766
NODE_10_length_11096_cov_14.154679	7182	7229	194	1	47	0.0212766
NODE_10_length_11096_cov_14.154679	7182	7229	197	2	47	0.0425532
NODE_10_length_11096_cov_14.154679	7182	7229	199	3	47	0.0638298
NODE_10_length_11096_cov_14.154679	7182	7229	200	1	47	0.0212766
NODE_10_length_11096_cov_14.154679	7182	7229	201	1	47	0.0212766
NODE_10_length_11096_cov_14.154679	7182	7229	202	1	47	0.0212766
NODE_10_length_11096_cov_14.154679	7182	7229	203	1	47	0.0212766
NODE_10_length_11096_cov_14.154679	7182	7229	204	2	47	0.0425532
NODE_10_length_11096_cov_14.154679	7182	7229	206	1	47	0.0212766
NODE_10_length_11096_cov_14.154679	7182	7229	208	1	47	0.0212766
NODE_10_length_11096_cov_14.154679	7182	7229	217	1	47	0.0212766
NODE_10_length_11096_cov_14.154679	7182	7229	220	1	47	0.0212766
NODE_10_length_11096_cov_14.154679	7182	7229	221	3	47	0.0638298
NODE_10_length_11096_cov_14.154679	7182	7229	222	1	47	0.0212766
NODE_10_length_11096_cov_14.154679	7182	7229	226	1	47	0.0212766
NODE_10_length_11096_cov_14.154679	7182	7229	233	1	47	0.0212766
NODE_10_length_11096_cov_14.154679	7182	7229	234	1	47	0.0212766
NODE_10_length_11096_cov_14.154679	7182	7229	235	2	47	0.0425532
NODE_10_length_11096_cov_14.154679	7182	7229	236	6	47	0.1276596
NODE_10_length_11096_cov_14.154679	7182	7229	237	2	47	0.0425532
NODE_10_length_11096_cov_14.154679	7182	7229	238	1	47	0.0212766
NODE_10_length_11096_cov_14.154679	7182	7229	240	1	47	0.0212766
NODE_10_length_11096_cov_14.154679	7182	7229	246	1	47	0.0212766
NODE_10_length_11096_cov_14.154679	7182	7229	248	2	47	0.0425532
NODE_10_length_11096_cov_14.154679	7182	7229	250	1	47	0.0212766
NODE_10_length_11096_cov_14.154679	7182	7229	252	1	47	0.0212766
NODE_10_length_11096_cov_14.154679	7182	7229	254	1	47	0.0212766
NODE_10_length_11096_cov_14.154679	7182	7229	256	2	47	0.0425532
NODE_10_length_11096_cov_14.154679	7218	7282	110	2	64	0.0312500
NODE_10_length_11096_cov_14.154679	7218	7282	112	2	64	0.0312500
NODE_10_length_11096_cov_14.154679	7218	7282	115	2	64	0.0312500
NODE_10_length_11096_cov_14.154679	7218	7282	116	2	64	0.0312500
NODE_10_length_11096_cov_14.154679	7218	7282	118	3	64	0.0468750
NODE_10_length_11096_cov_14.154679	7218	7282	119	2	64	0.0312500
NODE_10_length_11096_cov_14.154679	7218	7282	121	1	64	0.0156250
NODE_10_length_11096_cov_14.154679	7218	7282	125	2	64	0.0312500
NODE_10_length_11096_cov_14.154679	7218	7282	127	1	64	0.0156250
NODE_10_length_11096_cov_14.154679	7218	7282	129	1	64	0.0156250
NODE_10_length_11096_cov_14.154679	7218	7282	130	4	64	0.0625000
NODE_10_length_11096_cov_14.154679	7218	7282	131	3	64	0.0468750
NODE_10_length_11096_cov_14.154679	7218	7282	132	4	64	0.0625000
NODE_10_length_11096_cov_14.154679	7218	7282	133	2	64	0.0312500
NODE_10_length_11096_cov_14.154679	7218	7282	135	1	64	0.0156250
NODE_10_length_11096_cov_14.154679	7218	7282	136	1	64	0.0156250
NODE_10_length_11096_cov_14.154679	7218	7282	138	1	64	0.0156250
NODE_10_length_11096_cov_14.154679	7218	7282	142	3	64	0.0468750
NODE_10_length_11096_cov_14.154679	7218	7282	147	2	64	0.0312500
NODE_10_length_11096_cov_14.154679	7218	7282	149	3	64	0.0468750
NODE_10_length_11096_cov_14.154679	7218	7282	150	3	64	0.0468750
NODE_10_length_11096_cov_14.154679	7218	7282	151	2	64	0.0312500
NODE_10_length_11096_cov_14.154679	7218	7282	152	1	64	0.0156250
NODE_10_length_11096_cov_14.154679	7218	7282	156	1	64	0.0156250
NODE_10_length_11096_cov_14.154679	7218	7282	158	1	64	0.0156250
NODE_10_length_11096_cov_14.154679	7218	7282	165	1	64	0.0156250
NODE_10_length_11096_cov_14.154679	7218	7282	173	1	64	0.0156250
NODE_10_length_11096_cov_14.154679	7218	7282	175	1	64	0.0156250
NODE_10_length_11096_cov_14.154679	7218	7282	177	1	64	0.0156250
NODE_10_length_11096_cov_14.154679	7218	7282	186	1	64	0.0156250
NODE_10_length_11096_cov_14.154679	7218	7282	191	1	64	0.0156250
NODE_10_length_11096_cov_14.154679	7218	7282	192	1	64	0.0156250
NODE_10_length_11096_cov_14.154679	7218	7282	194	1	64	0.0156250
NODE_10_length_11096_cov_14.154679	7218	7282	197	2	64	0.0312500
NODE_10_length_11096_cov_14.154679	7218	7282	199	3	64	0.0468750
NODE_10_length_11096_cov_14.154679	7218	7282	200	1	64	0.0156250
NODE_13_length_10749_cov_34.330235	3589	3669	0	80	80	1.0000000
NODE_13_length_10749_cov_34.330235	3642	3722	0	80	80	1.0000000
NODE_13_length_10749_cov_34.330235	3718	3798	0	80	80	1.0000000
NODE_13_length_10749_cov_34.330235	3771	3851	0	73	80	0.9125000
NODE_13_length_10749_cov_34.330235	3771	3851	3	2	80	0.0250000
NODE_13_length_10749_cov_34.330235	3771	3851	5	5	80	0.0625000
NODE_14_length_10557_cov_50.055938	423	503	0	80	80	1.0000000
NODE_14_length_10557_cov_50.055938	476	556	0	80	80	1.0000000
NODE_14_length_10557_cov_50.055938	1625	1696	8	2	71	0.0281690
NODE_14_length_10557_cov_50.055938	1625	1696	9	2	71	0.0281690
NODE_14_length_10557_cov_50.055938	1625	1696	10	3	71	0.0422535
NODE_14_length_10557_cov_50.055938	1625	1696	11	4	71	0.0563380
NODE_14_length_10557_cov_50.055938	1625	1696	12	23	71	0.3239437
NODE_14_length_10557_cov_50.055938	1625	1696	13	37	71	0.5211267
NODE_14_length_10557_cov_50.055938	1678	1733	3	19	55	0.3454545
NODE_14_length_10557_cov_50.055938	1678	1733	5	12	55	0.2181818
NODE_14_length_10557_cov_50.055938	1678	1733	9	8	55	0.1454545
NODE_14_length_10557_cov_50.055938	1678	1733	11	1	55	0.0181818
NODE_14_length_10557_cov_50.055938	1678	1733	13	15	55	0.2727273
NODE_14_length_10557_cov_50.055938	2428	2488	10	6	60	0.1000000
NODE_14_length_10557_cov_50.055938	2428	2488	12	14	60	0.2333333
NODE_14_length_10557_cov_50.055938	2428	2488	13	7	60	0.1166667
NODE_14_length_10557_cov_50.055938	2428	2488	15	6	60	0.1000000
NODE_14_length_10557_cov_50.055938	2428	2488	16	3	60	0.0500000
NODE_14_length_10557_cov_50.055938	2428	2488	17	12	60	0.2000000
NODE_14_length_10557_cov_50.055938	2428	2488	20	12	60	0.2000000
NODE_17_length_10101_cov_12.236253	923	966	0	43	43	1.0000000
NODE_17_length_10101_cov_12.236253	943	1007	0	64	64	1.0000000
NODE_17_length_10101_cov_12.236253	1715	1795	0	80	80	1.0000000
NODE_17_length_10101_cov_12.236253	1768	1820	0	52	52	1.0000000
NODE_20_length_9442_cov_109.961147	2108	2188	0	80	80	1.0000000
NODE_20_length_9442_cov_109.961147	2161	2241	0	80	80	1.0000000
NODE_21_length_9414_cov_34.165217	2363	2443	20	3	80	0.0375000
NODE_21_length_9414_cov_34.165217	2363	2443	22	9	80	0.1125000
NODE_21_length_9414_cov_34.165217	2363	2443	27	14	80	0.1750000
NODE_21_length_9414_cov_34.165217	2363	2443	28	26	80	0.3250000
NODE_21_length_9414_cov_34.165217	2363	2443	30	28	80	0.3500000
NODE_21_length_9414_cov_34.165217	2416	2484	0	2	68	0.0294118
NODE_21_length_9414_cov_34.165217	2416	2484	8	29	68	0.4264706
NODE_21_length_9414_cov_34.165217	2416	2484	10	2	68	0.0294118
NODE_21_length_9414_cov_34.165217	2416	2484	12	2	68	0.0294118
NODE_21_length_9414_cov_34.165217	2416	2484	14	6	68	0.0882353
NODE_21_length_9414_cov_34.165217	2416	2484	20	3	68	0.0441176
NODE_21_length_9414_cov_34.165217	2416	2484	22	9	68	0.1323529
NODE_21_length_9414_cov_34.165217	2416	2484	28	15	68	0.2205882
NODE_21_length_9414_cov_34.165217	5899	5975	84	5	76	0.0657895
NODE_21_length_9414_cov_34.165217	5899	5975	85	6	76	0.0789474
NODE_21_length_9414_cov_34.165217	5899	5975	86	21	76	0.2763158
NODE_21_length_9414_cov_34.165217	5899	5975	87	8	76	0.1052632
NODE_21_length_9414_cov_34.165217	5899	5975	88	5	76	0.0657895
NODE_21_length_9414_cov_34.165217	5899	5975	89	7	76	0.0921053
NODE_21_length_9414_cov_34.165217	5899	5975	90	4	76	0.0526316
NODE_21_length_9414_cov_34.165217	5899	5975	91	10	76	0.1315790
NODE_21_length_9414_cov_34.165217	5899	5975	92	6	76	0.0789474
NODE_21_length_9414_cov_34.165217	5899	5975	94	3	76	0.0394737
NODE_21_length_9414_cov_34.165217	5899	5975	95	1	76	0.0131579
NODE_24_length_9168_cov_47.407542	470	550	18	5	80	0.0625000
NODE_24_length_9168_cov_47.407542	470	550	20	4	80	0.0500000
NODE_24_length_9168_cov_47.407542	470	550	21	39	80	0.4875000
NODE_24_length_9168_cov_47.407542	470	550	22	3	80	0.0375000
NODE_24_length_9168_cov_47.407542	470	550	23	5	80	0.0625000
NODE_24_length_9168_cov_47.407542	470	550	24	5	80	0.0625000
NODE_24_length_9168_cov_47.407542	470	550	25	10	80	0.1250000
NODE_24_length_9168_cov_47.407542	470	550	26	9	80	0.1125000
NODE_24_length_9168_cov_47.407542	523	603	8	4	80	0.0500000
NODE_24_length_9168_cov_47.407542	523	603	10	41	80	0.5125000
NODE_24_length_9168_cov_47.407542	523	603	14	7	80	0.0875000
NODE_24_length_9168_cov_47.407542	523	603	18	5	80	0.0625000
NODE_24_length_9168_cov_47.407542	523	603	20	4	80	0.0500000
NODE_24_length_9168_cov_47.407542	523	603	21	14	80	0.1750000
NODE_24_length_9168_cov_47.407542	523	603	22	3	80	0.0375000
NODE_24_length_9168_cov_47.407542	523	603	24	2	80	0.0250000
NODE_27_length_9108_cov_47.430347	4786	4866	108	3	80	0.0375000
NODE_27_length_9108_cov_47.430347	4786	4866	110	7	80	0.0875000
NODE_27_length_9108_cov_47.430347	4786	4866	114	1	80	0.0125000
NODE_27_length_9108_cov_47.430347	4786	4866	116	6	80	0.0750000
NODE_27_length_9108_cov_47.430347	4786	4866	118	2	80	0.0250000
NODE_27_length_9108_cov_47.430347	4786	4866	119	2	80	0.0250000
NODE_27_length_9108_cov_47.430347	4786	4866	120	3	80	0.0375000
NODE_27_length_9108_cov_47.430347	4786	4866	121	1	80	0.0125000
NODE_27_length_9108_cov_47.430347	4786	4866	123	3	80	0.0375000
NODE_27_length_9108_cov_47.430347	4786	4866	124	1	80	0.0125000
NODE_27_length_9108_cov_47.430347	4786	4866	125	4	80	0.0500000
NODE_27_length_9108_cov_47.430347	4786	4866	126	3	80	0.0375000
NODE_27_length_9108_cov_47.430347	4786	4866	127	2	80	0.0250000
NODE_27_length_9108_cov_47.430347	4786	4866	128	7	80	0.0875000
NODE_27_length_9108_cov_47.430347	4786	4866	129	13	80	0.1625000
NODE_27_length_9108_cov_47.430347	4786	4866	130	13	80	0.1625000
NODE_27_length_9108_cov_47.430347	4786	4866	131	4	80	0.0500000
NODE_27_length_9108_cov_47.430347	4786	4866	133	4	80	0.0500000
NODE_27_length_9108_cov_47.430347	4786	4866	135	1	80	0.0125000
NODE_27_length_9108_cov_47.430347	4839	4902	112	2	63	0.0317460
NODE_27_length_9108_cov_47.430347	4839	4902	114	3	63	0.0476190
NODE_27_length_9108_cov_47.430347	4839	4902	115	3	63	0.0476190
NODE_27_length_9108_cov_47.430347	4839	4902	116	4	63	0.0634921
NODE_27_length_9108_cov_47.430347	4839	4902	117	1	63	0.0158730
NODE_27_length_9108_cov_47.430347	4839	4902	118	5	63	0.0793651
NODE_27_length_9108_cov_47.430347	4839	4902	119	1	63	0.0158730
NODE_27_length_9108_cov_47.430347	4839	4902	120	3	63	0.0476190
NODE_27_length_9108_cov_47.430347	4839	4902	121	2	63	0.0317460
NODE_27_length_9108_cov_47.430347	4839	4902	122	4	63	0.0634921
NODE_27_length_9108_cov_47.430347	4839	4902	123	6	63	0.0952381
NODE_27_length_9108_cov_47.430347	4839	4902	124	3	63	0.0476190
NODE_27_length_9108_cov_47.430347	4839	4902	125	2	63	0.0317460
NODE_27_length_9108_cov_47.430347	4839	4902	126	4	63	0.0634921
NODE_27_length_9108_cov_47.430347	4839	4902	127	1	63	0.0158730
NODE_27_length_9108_cov_47.430347	4839	4902	128	6	63	0.0952381
NODE_27_length_9108_cov_47.430347	4839	4902	129	2	63	0.0317460
NODE_27_length_9108_cov_47.430347	4839	4902	130	6	63	0.0952381
NODE_27_length_9108_cov_47.430347	4839	4902	131	1	63	0.0158730
NODE_27_length_9108_cov_47.430347	4839	4902	133	3	63	0.0476190
NODE_27_length_9108_cov_47.430347	4839	4902	135	1	63	0.0158730
NODE_27_length_9108_cov_47.430347	4895	4963	66	2	68	0.0294118
NODE_27_length_9108_cov_47.430347	4895	4963	68	10	68	0.1470588
NODE_27_length_9108_cov_47.430347	4895	4963	69	1	68	0.0147059
NODE_27_length_9108_cov_47.430347	4895	4963	77	1	68	0.0147059
NODE_27_length_9108_cov_47.430347	4895	4963	81	9	68	0.1323529
NODE_27_length_9108_cov_47.430347	4895	4963	85	1	68	0.0147059
NODE_27_length_9108_cov_47.430347	4895	4963	87	3	68	0.0441176
NODE_27_length_9108_cov_47.430347	4895	4963	89	1	68	0.0147059
NODE_27_length_9108_cov_47.430347	4895	4963	91	5	68	0.0735294
NODE_27_length_9108_cov_47.430347	4895	4963	93	1	68	0.0147059
NODE_27_length_9108_cov_47.430347	4895	4963	95	3	68	0.0441176
NODE_27_length_9108_cov_47.430347	4895	4963	96	2	68	0.0294118
NODE_27_length_9108_cov_47.430347	4895	4963	98	5	68	0.0735294
NODE_27_length_9108_cov_47.430347	4895	4963	99	4	68	0.0588235
NODE_27_length_9108_cov_47.430347	4895	4963	101	1	68	0.0147059
NODE_27_length_9108_cov_47.430347	4895	4963	104	1	68	0.0147059
NODE_27_length_9108_cov_47.430347	4895	4963	105	1	68	0.0147059
NODE_27_length_9108_cov_47.430347	4895	4963	106	5	68	0.0735294
NODE_27_length_9108_cov_47.430347	4895	4963	110	2	68	0.0294118
NODE_27_length_9108_cov_47.430347	4895	4963	112	5	68	0.0735294
NODE_27_length_9108_cov_47.430347	4895	4963	115	2	68	0.0294118
NODE_27_length_9108_cov_47.430347	4895	4963	116	2	68	0.0294118
NODE_27_length_9108_cov_47.430347	4895	4963	117	1	68	0.0147059
NODE_27_length_9108_cov_47.430347	4936	5016	11	5	80	0.0625000
NODE_27_length_9108_cov_47.430347	4936	5016	13	1	80	0.0125000
NODE_27_length_9108_cov_47.430347	4936	5016	16	1	80	0.0125000
NODE_27_length_9108_cov_47.430347	4936	5016	17	3	80	0.0375000
NODE_27_length_9108_cov_47.430347	4936	5016	21	1	80	0.0125000
NODE_27_length_9108_cov_47.430347	4936	5016	23	1	80	0.0125000
NODE_27_length_9108_cov_47.430347	4936	5016	25	4	80	0.0500000
NODE_27_length_9108_cov_47.430347	4936	5016	29	1	80	0.0125000
NODE_27_length_9108_cov_47.430347	4936	5016	35	1	80	0.0125000
NODE_27_length_9108_cov_47.430347	4936	5016	37	3	80	0.0375000
NODE_27_length_9108_cov_47.430347	4936	5016	38	4	80	0.0500000
NODE_27_length_9108_cov_47.430347	4936	5016	40	6	80	0.0750000
NODE_27_length_9108_cov_47.430347	4936	5016	42	2	80	0.0250000
NODE_27_length_9108_cov_47.430347	4936	5016	44	2	80	0.0250000
NODE_27_length_9108_cov_47.430347	4936	5016	48	1	80	0.0125000
NODE_27_length_9108_cov_47.430347	4936	5016	58	1	80	0.0125000
NODE_27_length_9108_cov_47.430347	4936	5016	60	2	80	0.0250000
NODE_27_length_9108_cov_47.430347	4936	5016	64	8	80	0.1000000
NODE_27_length_9108_cov_47.430347	4936	5016	66	8	80	0.1000000
NODE_27_length_9108_cov_47.430347	4936	5016	68	10	80	0.1250000
NODE_27_length_9108_cov_47.430347	4936	5016	69	1	80	0.0125000
NODE_27_length_9108_cov_47.430347	4936	5016	77	1	80	0.0125000
NODE_27_length_9108_cov_47.430347	4936	5016	81	9	80	0.1125000
NODE_27_length_9108_cov_47.430347	4936	5016	85	1	80	0.0125000
NODE_27_length_9108_cov_47.430347	4936	5016	87	3	80	0.0375000
NODE_28_length_9108_cov_26.469974	44	120	0	76	76	1.0000000
NODE_28_length_9108_cov_26.469974	7711	7791	10	1	80	0.0125000
NODE_28_length_9108_cov_26.469974	7711	7791	25	2	80	0.0250000
NODE_28_length_9108_cov_26.469974	7711	7791	29	1	80	0.0125000
NODE_28_length_9108_cov_26.469974	7711	7791	32	11	80	0.1375000
NODE_28_length_9108_cov_26.469974	7711	7791	36	4	80	0.0500000
NODE_28_length_9108_cov_26.469974	7711	7791	37	2	80	0.0250000
NODE_28_length_9108_cov_26.469974	7711	7791	38	1	80	0.0125000
NODE_28_length_9108_cov_26.469974	7711	7791	39	20	80	0.2500000
NODE_28_length_9108_cov_26.469974	7711	7791	44	2	80	0.0250000
NODE_28_length_9108_cov_26.469974	7711	7791	49	3	80	0.0375000
NODE_28_length_9108_cov_26.469974	7711	7791	50	7	80	0.0875000
NODE_28_length_9108_cov_26.469974	7711	7791	51	1	80	0.0125000
NODE_28_length_9108_cov_26.469974	7711	7791	56	1	80	0.0125000
NODE_28_length_9108_cov_26.469974	7711	7791	58	1	80	0.0125000
NODE_28_length_9108_cov_26.469974	7711	7791	60	2	80	0.0250000
NODE_28_length_9108_cov_26.469974	7711	7791	62	1	80	0.0125000
NODE_28_length_9108_cov_26.469974	7711	7791	66	2	80	0.0250000
NODE_28_length_9108_cov_26.469974	7711	7791	69	6	80	0.0750000
NODE_28_length_9108_cov_26.469974	7711	7791	71	11	80	0.1375000
NODE_28_length_9108_cov_26.469974	7711	7791	73	1	80	0.0125000
NODE_28_length_9108_cov_26.469974	8144	8224	0	1	80	0.0125000
NODE_28_length_9108_cov_26.469974	8144	8224	12	1	80	0.0125000
NODE_28_length_9108_cov_26.469974	8144	8224	16	21	80	0.2625000
NODE_28_length_9108_cov_26.469974	8144	8224	18	1	80	0.0125000
NODE_28_length_9108_cov_26.469974	8144	8224	19	10	80	0.1250000
NODE_28_length_9108_cov_26.469974	8144	8224	20	7	80	0.0875000
NODE_28_length_9108_cov_26.469974	8144	8224	22	3	80	0.0375000
NODE_28_length_9108_cov_26.469974	8144	8224	28	1	80	0.0125000
NODE_28_length_9108_cov_26.469974	8144	8224	29	4	80	0.0500000
NODE_28_length_9108_cov_26.469974	8144	8224	30	2	80	0.0250000
NODE_28_length_9108_cov_26.469974	8144	8224	31	1	80	0.0125000
NODE_28_length_9108_cov_26.469974	8144	8224	33	1	80	0.0125000
NODE_28_length_9108_cov_26.469974	8144	8224	35	5	80	0.0625000
NODE_28_length_9108_cov_26.469974	8144	8224	39	6	80	0.0750000
NODE_28_length_9108_cov_26.469974	8144	8224	44	5	80	0.0625000
NODE_28_length_9108_cov_26.469974	8144	8224	46	1	80	0.0125000
NODE_28_length_9108_cov_26.469974	8144	8224	48	1	80	0.0125000
NODE_28_length_9108_cov_26.469974	8144	8224	50	8	80	0.1000000
NODE_28_length_9108_cov_26.469974	8144	8224	52	1	80	0.0125000
NODE_28_length_9108_cov_26.469974	8568	8648	0	2	80	0.0250000
NODE_28_length_9108_cov_26.469974	8568	8648	4	78	80	0.9750000
NODE_28_length_9108_cov_26.469974	8621	8701	4	80	80	1.0000000
NODE_30_length_8743_cov_14.172721	7849	7929	28	1	80	0.0125000
NODE_30_length_8743_cov_14.172721	7849	7929	30	2	80	0.0250000
NODE_30_length_8743_cov_14.172721	7849	7929	38	1	80	0.0125000
NODE_30_length_8743_cov_14.172721	7849	7929	42	2	80	0.0250000
NODE_30_length_8743_cov_14.172721	7849	7929	44	1	80	0.0125000
NODE_30_length_8743_cov_14.172721	7849	7929	48	1	80	0.0125000
NODE_30_length_8743_cov_14.172721	7849	7929	50	1	80	0.0125000
NODE_30_length_8743_cov_14.172721	7849	7929	52	7	80	0.0875000
NODE_30_length_8743_cov_14.172721	7849	7929	53	2	80	0.0250000
NODE_30_length_8743_cov_14.172721	7849	7929	54	14	80	0.1750000
NODE_30_length_8743_cov_14.172721	7849	7929	56	17	80	0.2125000
NODE_30_length_8743_cov_14.172721	7849	7929	58	10	80	0.1250000
NODE_30_length_8743_cov_14.172721	7849	7929	60	10	80	0.1250000
NODE_30_length_8743_cov_14.172721	7849	7929	62	2	80	0.0250000
NODE_30_length_8743_cov_14.172721	7849	7929	64	9	80	0.1125000
NODE_30_length_8743_cov_14.172721	7902	7964	14	11	62	0.1774193
NODE_30_length_8743_cov_14.172721	7902	7964	18	2	62	0.0322581
NODE_30_length_8743_cov_14.172721	7902	7964	21	12	62	0.1935484
NODE_30_length_8743_cov_14.172721	7902	7964	24	1	62	0.0161290
NODE_30_length_8743_cov_14.172721	7902	7964	28	10	62	0.1612903
NODE_30_length_8743_cov_14.172721	7902	7964	30	2	62	0.0322581
NODE_30_length_8743_cov_14.172721	7902	7964	38	1	62	0.0161290
NODE_30_length_8743_cov_14.172721	7902	7964	42	2	62	0.0322581
NODE_30_length_8743_cov_14.172721	7902	7964	44	1	62	0.0161290
NODE_30_length_8743_cov_14.172721	7902	7964	48	1	62	0.0161290
NODE_30_length_8743_cov_14.172721	7902	7964	50	1	62	0.0161290
NODE_30_length_8743_cov_14.172721	7902	7964	52	5	62	0.0806452
NODE_30_length_8743_cov_14.172721	7902	7964	53	2	62	0.0322581
NODE_30_length_8743_cov_14.172721	7902	7964	54	11	62	0.1774193
NODE_32_length_8707_cov_6.353044	8541	8621	32	10	80	0.1250000
NODE_32_length_8707_cov_6.353044	8541	8621	34	6	80	0.0750000
NODE_32_length_8707_cov_6.353044	8541	8621	44	2	80	0.0250000
NODE_32_length_8707_cov_6.353044	8541	8621	56	9	80	0.1125000
NODE_32_length_8707_cov_6.353044	8541	8621	58	10	80	0.1250000
NODE_32_length_8707_cov_6.353044	8541	8621	67	1	80	0.0125000
NODE_32_length_8707_cov_6.353044	8541	8621	68	14	80	0.1750000
NODE_32_length_8707_cov_6.353044	8541	8621	69	11	80	0.1375000
NODE_32_length_8707_cov_6.353044	8541	8621	71	5	80	0.0625000
NODE_32_length_8707_cov_6.353044	8541	8621	72	12	80	0.1500000
NODE_32_length_8707_cov_6.353044	8541	8621	32	10	80	0.1250000
NODE_32_length_8707_cov_6.353044	8541	8621	34	6	80	0.0750000
NODE_32_length_8707_cov_6.353044	8541	8621	44	2	80	0.0250000
NODE_32_length_8707_cov_6.353044	8541	8621	56	9	80	0.1125000
NODE_32_length_8707_cov_6.353044	8541	8621	58	10	80	0.1250000
NODE_32_length_8707_cov_6.353044	8541	8621	67	1	80	0.0125000
NODE_32_length_8707_cov_6.353044	8541	8621	68	14	80	0.1750000
NODE_32_length_8707_cov_6.353044	8541	8621	69	11	80	0.1375000
NODE_32_length_8707_cov_6.353044	8541	8621	71	5	80	0.0625000
NODE_32_length_8707_cov_6.353044	8541	8621	72	12	80	0.1500000
NODE_32_length_8707_cov_6.353044	8541	8621	32	10	80	0.1250000
NODE_32_length_8707_cov_6.353044	8541	8621	34	6	80	0.0750000
NODE_32_length_8707_cov_6.353044	8541	8621	44	2	80	0.0250000
NODE_32_length_8707_cov_6.353044	8541	8621	56	9	80	0.1125000
NODE_32_length_8707_cov_6.353044	8541	8621	58	10	80	0.1250000
NODE_32_length_8707_cov_6.353044	8541	8621	67	1	80	0.0125000
NODE_32_length_8707_cov_6.353044	8541	8621	68	14	80	0.1750000
NODE_32_length_8707_cov_6.353044	8541	8621	69	11	80	0.1375000
NODE_32_length_8707_cov_6.353044	8541	8621	71	5	80	0.0625000
NODE_32_length_8707_cov_6.353044	8541	8621	72	12	80	0.1500000
NODE_32_length_8707_cov_6.353044	8594	8674	38	13	80	0.1625000
NODE_32_length_8707_cov_6.353044	8594	8674	40	20	80	0.2500000
NODE_32_length_8707_cov_6.353044	8594	8674	51	5	80	0.0625000
NODE_32_length_8707_cov_6.353044	8594	8674	66	1	80	0.0125000
NODE_32_length_8707_cov_6.353044	8594	8674	67	5	80	0.0625000
NODE_32_length_8707_cov_6.353044	8594	8674	68	1	80	0.0125000
NODE_32_length_8707_cov_6.353044	8594	8674	69	19	80	0.2375000
NODE_32_length_8707_cov_6.353044	8594	8674	71	5	80	0.0625000
NODE_32_length_8707_cov_6.353044	8594	8674	72	11	80	0.1375000
NODE_32_length_8707_cov_6.353044	8594	8674	38	13	80	0.1625000
NODE_32_length_8707_cov_6.353044	8594	8674	40	20	80	0.2500000
NODE_32_length_8707_cov_6.353044	8594	8674	51	5	80	0.0625000
NODE_32_length_8707_cov_6.353044	8594	8674	66	1	80	0.0125000
NODE_32_length_8707_cov_6.353044	8594	8674	67	5	80	0.0625000
NODE_32_length_8707_cov_6.353044	8594	8674	68	1	80	0.0125000
NODE_32_length_8707_cov_6.353044	8594	8674	69	19	80	0.2375000
NODE_32_length_8707_cov_6.353044	8594	8674	71	5	80	0.0625000
NODE_32_length_8707_cov_6.353044	8594	8674	72	11	80	0.1375000
NODE_32_length_8707_cov_6.353044	8594	8673	38	12	79	0.1518987
NODE_32_length_8707_cov_6.353044	8594	8673	40	20	79	0.2531646
NODE_32_length_8707_cov_6.353044	8594	8673	51	5	79	0.0632911
NODE_32_length_8707_cov_6.353044	8594	8673	66	1	79	0.0126582
NODE_32_length_8707_cov_6.353044	8594	8673	67	5	79	0.0632911
NODE_32_length_8707_cov_6.353044	8594	8673	68	1	79	0.0126582
NODE_32_length_8707_cov_6.353044	8594	8673	69	19	79	0.2405063
NODE_32_length_8707_cov_6.353044	8594	8673	71	5	79	0.0632911
NODE_32_length_8707_cov_6.353044	8594	8673	72	11	79	0.1392405
NODE_32_length_8707_cov_6.353044	8599	8674	38	13	75	0.1733333
NODE_32_length_8707_cov_6.353044	8599	8674	40	20	75	0.2666667
NODE_32_length_8707_cov_6.353044	8599	8674	51	5	75	0.0666667
NODE_32_length_8707_cov_6.353044	8599	8674	66	1	75	0.0133333
NODE_32_length_8707_cov_6.353044	8599	8674	67	5	75	0.0666667
NODE_32_length_8707_cov_6.353044	8599	8674	68	1	75	0.0133333
NODE_32_length_8707_cov_6.353044	8599	8674	69	19	75	0.2533333
NODE_32_length_8707_cov_6.353044	8599	8674	71	5	75	0.0666667
NODE_32_length_8707_cov_6.353044	8599	8674	72	6	75	0.0800000
NODE_38_length_8281_cov_13.025177	7108	7188	0	80	80	1.0000000
NODE_38_length_8281_cov_13.025177	7161	7199	0	38	38	1.0000000
NODE_38_length_8281_cov_13.025177	7175	7255	0	59	80	0.7375000
NODE_38_length_8281_cov_13.025177	7175	7255	2	21	80	0.2625000
NODE_38_length_8281_cov_13.025177	7228	7308	0	6	80	0.0750000
NODE_38_length_8281_cov_13.025177	7228	7308	2	74	80	0.9250000
NODE_38_length_8281_cov_13.025177	7749	7829	0	41	80	0.5125000
NODE_38_length_8281_cov_13.025177	7749	7829	1	39	80	0.4875000
NODE_38_length_8281_cov_13.025177	7802	7882	1	80	80	1.0000000
NODE_38_length_8281_cov_13.025177	7878	7958	1	64	80	0.8000000
NODE_38_length_8281_cov_13.025177	7878	7958	2	16	80	0.2000000
NODE_38_length_8281_cov_13.025177	7931	8011	1	71	80	0.8875000
NODE_38_length_8281_cov_13.025177	7931	8011	2	9	80	0.1125000
NODE_39_length_8259_cov_60.011152	1424	1504	0	71	80	0.8875000
NODE_39_length_8259_cov_60.011152	1424	1504	1	9	80	0.1125000
NODE_39_length_8259_cov_60.011152	1477	1549	0	72	72	1.0000000
NODE_40_length_8228_cov_17.079592	314	394	0	28	80	0.3500000
NODE_40_length_8228_cov_17.079592	314	394	2	52	80	0.6500000
NODE_40_length_8228_cov_17.079592	367	447	0	42	80	0.5250000
NODE_40_length_8228_cov_17.079592	367	447	2	38	80	0.4750000
NODE_40_length_8228_cov_17.079592	443	523	0	80	80	1.0000000
NODE_40_length_8228_cov_17.079592	496	576	0	80	80	1.0000000
NODE_40_length_8228_cov_17.079592	3154	3217	14	1	63	0.0158730
NODE_40_length_8228_cov_17.079592	3154	3217	58	1	63	0.0158730
NODE_40_length_8228_cov_17.079592	3154	3217	60	5	63	0.0793651
NODE_40_length_8228_cov_17.079592	3154	3217	62	1	63	0.0158730
NODE_40_length_8228_cov_17.079592	3154	3217	67	2	63	0.0317460
NODE_40_length_8228_cov_17.079592	3154	3217	69	2	63	0.0317460
NODE_40_length_8228_cov_17.079592	3154	3217	74	1	63	0.0158730
NODE_40_length_8228_cov_17.079592	3154	3217	75	2	63	0.0317460
NODE_40_length_8228_cov_17.079592	3154	3217	79	3	63	0.0476190
NODE_40_length_8228_cov_17.079592	3154	3217	83	2	63	0.0317460
NODE_40_length_8228_cov_17.079592	3154	3217	87	5	63	0.0793651
NODE_40_length_8228_cov_17.079592	3154	3217	93	2	63	0.0317460
NODE_40_length_8228_cov_17.079592	3154	3217	95	1	63	0.0158730
NODE_40_length_8228_cov_17.079592	3154	3217	101	1	63	0.0158730
NODE_40_length_8228_cov_17.079592	3154	3217	110	1	63	0.0158730
NODE_40_length_8228_cov_17.079592	3154	3217	114	2	63	0.0317460
NODE_40_length_8228_cov_17.079592	3154	3217	118	1	63	0.0158730
NODE_40_length_8228_cov_17.079592	3154	3217	121	2	63	0.0317460
NODE_40_length_8228_cov_17.079592	3154	3217	126	2	63	0.0317460
NODE_40_length_8228_cov_17.079592	3154	3217	128	1	63	0.0158730
NODE_40_length_8228_cov_17.079592	3154	3217	130	1	63	0.0158730
NODE_40_length_8228_cov_17.079592	3154	3217	131	1	63	0.0158730
NODE_40_length_8228_cov_17.079592	3154	3217	132	8	63	0.1269841
NODE_40_length_8228_cov_17.079592	3154	3217	134	7	63	0.1111111
NODE_40_length_8228_cov_17.079592	3154	3217	136	8	63	0.1269841
NODE_43_length_8100_cov_32.115236	501	581	2	69	80	0.8625000
NODE_43_length_8100_cov_32.115236	501	581	5	11	80	0.1375000
NODE_43_length_8100_cov_32.115236	554	634	0	43	80	0.5375000
NODE_43_length_8100_cov_32.115236	554	634	2	37	80	0.4625000
NODE_43_length_8100_cov_32.115236	1383	1463	0	80	80	1.0000000
NODE_43_length_8100_cov_32.115236	1436	1516	0	80	80	1.0000000
NODE_43_length_8100_cov_32.115236	3391	3462	270	1	71	0.0140845
NODE_43_length_8100_cov_32.115236	3391	3462	274	1	71	0.0140845
NODE_43_length_8100_cov_32.115236	3391	3462	287	1	71	0.0140845
NODE_43_length_8100_cov_32.115236	3391	3462	298	1	71	0.0140845
NODE_43_length_8100_cov_32.115236	3391	3462	303	1	71	0.0140845
NODE_43_length_8100_cov_32.115236	3391	3462	305	1	71	0.0140845
NODE_43_length_8100_cov_32.115236	3391	3462	309	1	71	0.0140845
NODE_43_length_8100_cov_32.115236	3391	3462	310	3	71	0.0422535
NODE_43_length_8100_cov_32.115236	3391	3462	311	1	71	0.0140845
NODE_43_length_8100_cov_32.115236	3391	3462	317	2	71	0.0281690
NODE_43_length_8100_cov_32.115236	3391	3462	319	1	71	0.0140845
NODE_43_length_8100_cov_32.115236	3391	3462	327	1	71	0.0140845
NODE_43_length_8100_cov_32.115236	3391	3462	341	1	71	0.0140845
NODE_43_length_8100_cov_32.115236	3391	3462	343	1	71	0.0140845
NODE_43_length_8100_cov_32.115236	3391	3462	345	1	71	0.0140845
NODE_43_length_8100_cov_32.115236	3391	3462	357	1	71	0.0140845
NODE_43_length_8100_cov_32.115236	3391	3462	364	1	71	0.0140845
NODE_43_length_8100_cov_32.115236	3391	3462	366	1	71	0.0140845
NODE_43_length_8100_cov_32.115236	3391	3462	372	1	71	0.0140845
NODE_43_length_8100_cov_32.115236	3391	3462	373	1	71	0.0140845
NODE_43_length_8100_cov_32.115236	3391	3462	376	3	71	0.0422535
NODE_43_length_8100_cov_32.115236	3391	3462	378	2	71	0.0281690
NODE_43_length_8100_cov_32.115236	3391	3462	383	1	71	0.0140845
NODE_43_length_8100_cov_32.115236	3391	3462	386	1	71	0.0140845
NODE_43_length_8100_cov_32.115236	3391	3462	389	2	71	0.0281690
NODE_43_length_8100_cov_32.115236	3391	3462	391	2	71	0.0281690
NODE_43_length_8100_cov_32.115236	3391	3462	392	4	71	0.0563380
NODE_43_length_8100_cov_32.115236	3391	3462	393	3	71	0.0422535
NODE_43_length_8100_cov_32.115236	3391	3462	394	6	71	0.0845070
NODE_43_length_8100_cov_32.115236	3391	3462	395	1	71	0.0140845
NODE_43_length_8100_cov_32.115236	3391	3462	396	2	71	0.0281690
NODE_43_length_8100_cov_32.115236	3391	3462	397	1	71	0.0140845
NODE_43_length_8100_cov_32.115236	3391	3462	399	1	71	0.0140845
NODE_43_length_8100_cov_32.115236	3391	3462	400	1	71	0.0140845
NODE_43_length_8100_cov_32.115236	3391	3462	402	2	71	0.0281690
NODE_43_length_8100_cov_32.115236	3391	3462	404	1	71	0.0140845
NODE_43_length_8100_cov_32.115236	3391	3462	405	1	71	0.0140845
NODE_43_length_8100_cov_32.115236	3391	3462	406	4	71	0.0563380
NODE_43_length_8100_cov_32.115236	3391	3462	407	1	71	0.0140845
NODE_43_length_8100_cov_32.115236	3391	3462	409	3	71	0.0422535
NODE_43_length_8100_cov_32.115236	3391	3462	411	6	71	0.0845070
NODE_43_length_8100_cov_32.115236	3435	3483	148	1	48	0.0208333
NODE_43_length_8100_cov_32.115236	3435	3483	152	2	48	0.0416667
NODE_43_length_8100_cov_32.115236	3435	3483	154	2	48	0.0416667
NODE_43_length_8100_cov_32.115236	3435	3483	156	1	48	0.0208333
NODE_43_length_8100_cov_32.115236	3435	3483	158	1	48	0.0208333
NODE_43_length_8100_cov_32.115236	3435	3483	172	2	48	0.0416667
NODE_43_length_8100_cov_32.115236	3435	3483	186	2	48	0.0416667
NODE_43_length_8100_cov_32.115236	3435	3483	196	1	48	0.0208333
NODE_43_length_8100_cov_32.115236	3435	3483	215	3	48	0.0625000
NODE_43_length_8100_cov_32.115236	3435	3483	217	1	48	0.0208333
NODE_43_length_8100_cov_32.115236	3435	3483	248	1	48	0.0208333
NODE_43_length_8100_cov_32.115236	3435	3483	252	1	48	0.0208333
NODE_43_length_8100_cov_32.115236	3435	3483	253	1	48	0.0208333
NODE_43_length_8100_cov_32.115236	3435	3483	268	1	48	0.0208333
NODE_43_length_8100_cov_32.115236	3435	3483	270	1	48	0.0208333
NODE_43_length_8100_cov_32.115236	3435	3483	272	1	48	0.0208333
NODE_43_length_8100_cov_32.115236	3435	3483	274	1	48	0.0208333
NODE_43_length_8100_cov_32.115236	3435	3483	287	1	48	0.0208333
NODE_43_length_8100_cov_32.115236	3435	3483	298	1	48	0.0208333
NODE_43_length_8100_cov_32.115236	3435	3483	303	1	48	0.0208333
NODE_43_length_8100_cov_32.115236	3435	3483	305	1	48	0.0208333
NODE_43_length_8100_cov_32.115236	3435	3483	309	1	48	0.0208333
NODE_43_length_8100_cov_32.115236	3435	3483	310	3	48	0.0625000
NODE_43_length_8100_cov_32.115236	3435	3483	311	1	48	0.0208333
NODE_43_length_8100_cov_32.115236	3435	3483	317	2	48	0.0416667
NODE_43_length_8100_cov_32.115236	3435	3483	319	1	48	0.0208333
NODE_43_length_8100_cov_32.115236	3435	3483	327	1	48	0.0208333
NODE_43_length_8100_cov_32.115236	3435	3483	341	1	48	0.0208333
NODE_43_length_8100_cov_32.115236	3435	3483	343	1	48	0.0208333
NODE_43_length_8100_cov_32.115236	3435	3483	345	1	48	0.0208333
NODE_43_length_8100_cov_32.115236	3435	3483	357	1	48	0.0208333
NODE_43_length_8100_cov_32.115236	3435	3483	364	1	48	0.0208333
NODE_43_length_8100_cov_32.115236	3435	3483	366	1	48	0.0208333
NODE_43_length_8100_cov_32.115236	3435	3483	372	1	48	0.0208333
NODE_43_length_8100_cov_32.115236	3435	3483	376	3	48	0.0625000
NODE_43_length_8100_cov_32.115236	3435	3483	378	2	48	0.0416667
NODE_46_length_7962_cov_31.622790	6281	6363	49	2	82	0.0243902
NODE_46_length_7962_cov_31.622790	6281	6363	50	1	82	0.0121951
NODE_46_length_7962_cov_31.622790	6281	6363	54	3	82	0.0365854
NODE_46_length_7962_cov_31.622790	6281	6363	57	1	82	0.0121951
NODE_46_length_7962_cov_31.622790	6281	6363	60	6	82	0.0731707
NODE_46_length_7962_cov_31.622790	6281	6363	62	1	82	0.0121951
NODE_46_length_7962_cov_31.622790	6281	6363	64	3	82	0.0365854
NODE_46_length_7962_cov_31.622790	6281	6363	66	1	82	0.0121951
NODE_46_length_7962_cov_31.622790	6281	6363	70	3	82	0.0365854
NODE_46_length_7962_cov_31.622790	6281	6363	72	3	82	0.0365854
NODE_46_length_7962_cov_31.622790	6281	6363	75	2	82	0.0243902
NODE_46_length_7962_cov_31.622790	6281	6363	78	6	82	0.0731707
NODE_46_length_7962_cov_31.622790	6281	6363	79	2	82	0.0243902
NODE_46_length_7962_cov_31.622790	6281	6363	80	18	82	0.2195122
NODE_46_length_7962_cov_31.622790	6281	6363	81	4	82	0.0487805
NODE_46_length_7962_cov_31.622790	6281	6363	82	6	82	0.0731707
NODE_46_length_7962_cov_31.622790	6281	6363	83	5	82	0.0609756
NODE_46_length_7962_cov_31.622790	6281	6363	84	1	82	0.0121951
NODE_46_length_7962_cov_31.622790	6281	6363	85	12	82	0.1463415
NODE_46_length_7962_cov_31.622790	6281	6363	86	2	82	0.0243902
NODE_47_length_7944_cov_12.238496	348	419	34	22	71	0.3098592
NODE_47_length_7944_cov_12.238496	348	419	35	4	71	0.0563380
NODE_47_length_7944_cov_12.238496	348	419	37	4	71	0.0563380
NODE_47_length_7944_cov_12.238496	348	419	38	7	71	0.0985916
NODE_47_length_7944_cov_12.238496	348	419	39	3	71	0.0422535
NODE_47_length_7944_cov_12.238496	348	419	40	14	71	0.1971831
NODE_47_length_7944_cov_12.238496	348	419	42	6	71	0.0845070
NODE_47_length_7944_cov_12.238496	348	419	54	11	71	0.1549296
NODE_48_length_7919_cov_14.554859	2380	2460	4	6	80	0.0750000
NODE_48_length_7919_cov_14.554859	2380	2460	6	4	80	0.0500000
NODE_48_length_7919_cov_14.554859	2380	2460	8	26	80	0.3250000
NODE_48_length_7919_cov_14.554859	2380	2460	10	24	80	0.3000000
NODE_48_length_7919_cov_14.554859	2380	2460	12	20	80	0.2500000
NODE_50_length_7830_cov_4.211098	0	52	0	52	52	1.0000000
NODE_50_length_7830_cov_4.211098	30	105	0	75	75	1.0000000
NODE_52_length_7779_cov_20.230859	7691	7771	0	80	80	1.0000000
NODE_52_length_7779_cov_20.230859	7691	7771	0	80	80	1.0000000
NODE_52_length_7779_cov_20.230859	7691	7761	0	70	70	1.0000000
NODE_52_length_7779_cov_20.230859	7744	7779	0	35	35	1.0000000
NODE_53_length_7765_cov_18.871119	254	322	0	36	68	0.5294118
NODE_53_length_7765_cov_18.871119	254	322	2	10	68	0.1470588
NODE_53_length_7765_cov_18.871119	254	322	4	2	68	0.0294118
NODE_53_length_7765_cov_18.871119	254	322	8	5	68	0.0735294
NODE_53_length_7765_cov_18.871119	254	322	10	3	68	0.0441176
NODE_53_length_7765_cov_18.871119	254	322	12	6	68	0.0882353
NODE_53_length_7765_cov_18.871119	254	322	14	2	68	0.0294118
NODE_53_length_7765_cov_18.871119	254	322	15	1	68	0.0147059
NODE_53_length_7765_cov_18.871119	254	322	25	3	68	0.0441176
NODE_53_length_7765_cov_18.871119	353	433	15	5	80	0.0625000
NODE_53_length_7765_cov_18.871119	353	433	17	52	80	0.6500000
NODE_53_length_7765_cov_18.871119	353	433	20	2	80	0.0250000
NODE_53_length_7765_cov_18.871119	353	433	21	21	80	0.2625000
NODE_61_length_7411_cov_74.967314	2283	2347	0	64	64	1.0000000
NODE_61_length_7411_cov_74.967314	4725	4789	0	64	64	1.0000000
NODE_64_length_7305_cov_3.696087	971	1019	0	17	48	0.3541667
NODE_64_length_7305_cov_3.696087	971	1019	2	31	48	0.6458333
NODE_64_length_7305_cov_3.696087	7142	7190	0	48	48	1.0000000
NODE_66_length_7261_cov_12.433398	2313	2395	170	1	82	0.0121951
NODE_66_length_7261_cov_12.433398	2313	2395	171	1	82	0.0121951
NODE_66_length_7261_cov_12.433398	2313	2395	174	1	82	0.0121951
NODE_66_length_7261_cov_12.433398	2313	2395	175	3	82	0.0365854
NODE_66_length_7261_cov_12.433398	2313	2395	176	2	82	0.0243902
NODE_66_length_7261_cov_12.433398	2313	2395	177	2	82	0.0243902
NODE_66_length_7261_cov_12.433398	2313	2395	178	2	82	0.0243902
NODE_66_length_7261_cov_12.433398	2313	2395	179	10	82	0.1219512
NODE_66_length_7261_cov_12.433398	2313	2395	180	6	82	0.0731707
NODE_66_length_7261_cov_12.433398	2313	2395	181	5	82	0.0609756
NODE_66_length_7261_cov_12.433398	2313	2395	183	1	82	0.0121951
NODE_66_length_7261_cov_12.433398	2313	2395	186	1	82	0.0121951
NODE_66_length_7261_cov_12.433398	2313	2395	188	1	82	0.0121951
NODE_66_length_7261_cov_12.433398	2313	2395	191	1	82	0.0121951
NODE_66_length_7261_cov_12.433398	2313	2395	192	1	82	0.0121951
NODE_66_length_7261_cov_12.433398	2313	2395	194	1	82	0.0121951
NODE_66_length_7261_cov_12.433398	2313	2395	195	1	82	0.0121951
NODE_66_length_7261_cov_12.433398	2313	2395	198	1	82	0.0121951
NODE_66_length_7261_cov_12.433398	2313	2395	200	1	82	0.0121951
NODE_66_length_7261_cov_12.433398	2313	2395	203	1	82	0.0121951
NODE_66_length_7261_cov_12.433398	2313	2395	206	1	82	0.0121951
NODE_66_length_7261_cov_12.433398	2313	2395	208	1	82	0.0121951
NODE_66_length_7261_cov_12.433398	2313	2395	220	2	82	0.0243902
NODE_66_length_7261_cov_12.433398	2313	2395	240	1	82	0.0121951
NODE_66_length_7261_cov_12.433398	2313	2395	242	1	82	0.0121951
NODE_66_length_7261_cov_12.433398	2313	2395	247	1	82	0.0121951
NODE_66_length_7261_cov_12.433398	2313	2395	248	1	82	0.0121951
NODE_66_length_7261_cov_12.433398	2313	2395	258	1	82	0.0121951
NODE_66_length_7261_cov_12.433398	2313	2395	267	5	82	0.0609756
NODE_66_length_7261_cov_12.433398	2313	2395	272	1	82	0.0121951
NODE_66_length_7261_cov_12.433398	2313	2395	273	3	82	0.0365854
NODE_66_length_7261_cov_12.433398	2313	2395	276	1	82	0.0121951
NODE_66_length_7261_cov_12.433398	2313	2395	278	1	82	0.0121951
NODE_66_length_7261_cov_12.433398	2313	2395	280	1	82	0.0121951
NODE_66_length_7261_cov_12.433398	2313	2395	283	2	82	0.0243902
NODE_66_length_7261_cov_12.433398	2313	2395	284	4	82	0.0487805
NODE_66_length_7261_cov_12.433398	2313	2395	285	1	82	0.0121951
NODE_66_length_7261_cov_12.433398	2313	2395	287	1	82	0.0121951
NODE_66_length_7261_cov_12.433398	2313	2395	288	1	82	0.0121951
NODE_66_length_7261_cov_12.433398	2313	2395	289	2	82	0.0243902
NODE_66_length_7261_cov_12.433398	2313	2395	290	1	82	0.0121951
NODE_66_length_7261_cov_12.433398	2313	2395	291	6	82	0.0731707
NODE_73_length_7036_cov_65.961943	4375	4455	2	48	80	0.6000000
NODE_73_length_7036_cov_65.961943	4375	4455	3	24	80	0.3000000
NODE_73_length_7036_cov_65.961943	4375	4455	5	8	80	0.1000000
NODE_73_length_7036_cov_65.961943	5538	5618	377	2	80	0.0250000
NODE_73_length_7036_cov_65.961943	5538	5618	391	1	80	0.0125000
NODE_73_length_7036_cov_65.961943	5538	5618	393	1	80	0.0125000
NODE_73_length_7036_cov_65.961943	5538	5618	407	1	80	0.0125000
NODE_73_length_7036_cov_65.961943	5538	5618	410	1	80	0.0125000
NODE_73_length_7036_cov_65.961943	5538	5618	411	1	80	0.0125000
NODE_73_length_7036_cov_65.961943	5538	5618	421	1	80	0.0125000
NODE_73_length_7036_cov_65.961943	5538	5618	427	1	80	0.0125000
NODE_73_length_7036_cov_65.961943	5538	5618	434	1	80	0.0125000
NODE_73_length_7036_cov_65.961943	5538	5618	443	1	80	0.0125000
NODE_73_length_7036_cov_65.961943	5538	5618	460	1	80	0.0125000
NODE_73_length_7036_cov_65.961943	5538	5618	468	2	80	0.0250000
NODE_73_length_7036_cov_65.961943	5538	5618	478	1	80	0.0125000
NODE_73_length_7036_cov_65.961943	5538	5618	484	1	80	0.0125000
NODE_73_length_7036_cov_65.961943	5538	5618	503	2	80	0.0250000
NODE_73_length_7036_cov_65.961943	5538	5618	512	1	80	0.0125000
NODE_73_length_7036_cov_65.961943	5538	5618	524	1	80	0.0125000
NODE_73_length_7036_cov_65.961943	5538	5618	526	1	80	0.0125000
NODE_73_length_7036_cov_65.961943	5538	5618	536	1	80	0.0125000
NODE_73_length_7036_cov_65.961943	5538	5618	538	1	80	0.0125000
NODE_73_length_7036_cov_65.961943	5538	5618	545	1	80	0.0125000
NODE_73_length_7036_cov_65.961943	5538	5618	546	1	80	0.0125000
NODE_73_length_7036_cov_65.961943	5538	5618	557	1	80	0.0125000
NODE_73_length_7036_cov_65.961943	5538	5618	562	1	80	0.0125000
NODE_73_length_7036_cov_65.961943	5538	5618	566	1	80	0.0125000
NODE_73_length_7036_cov_65.961943	5538	5618	590	1	80	0.0125000
NODE_73_length_7036_cov_65.961943	5538	5618	599	1	80	0.0125000
NODE_73_length_7036_cov_65.961943	5538	5618	602	2	80	0.0250000
NODE_73_length_7036_cov_65.961943	5538	5618	612	1	80	0.0125000
NODE_73_length_7036_cov_65.961943	5538	5618	625	1	80	0.0125000
NODE_73_length_7036_cov_65.961943	5538	5618	645	1	80	0.0125000
NODE_73_length_7036_cov_65.961943	5538	5618	671	1	80	0.0125000
NODE_73_length_7036_cov_65.961943	5538	5618	676	1	80	0.0125000
NODE_73_length_7036_cov_65.961943	5538	5618	679	1	80	0.0125000
NODE_73_length_7036_cov_65.961943	5538	5618	689	1	80	0.0125000
NODE_73_length_7036_cov_65.961943	5538	5618	699	1	80	0.0125000
NODE_73_length_7036_cov_65.961943	5538	5618	712	1	80	0.0125000
NODE_73_length_7036_cov_65.961943	5538	5618	715	1	80	0.0125000
NODE_73_length_7036_cov_65.961943	5538	5618	716	1	80	0.0125000
NODE_73_length_7036_cov_65.961943	5538	5618	717	1	80	0.0125000
NODE_73_length_7036_cov_65.961943	5538	5618	722	2	80	0.0250000
NODE_73_length_7036_cov_65.961943	5538	5618	724	1	80	0.0125000
NODE_73_length_7036_cov_65.961943	5538	5618	727	2	80	0.0250000
NODE_73_length_7036_cov_65.961943	5538	5618	728	2	80	0.0250000
NODE_73_length_7036_cov_65.961943	5538	5618	736	2	80	0.0250000
NODE_73_length_7036_cov_65.961943	5538	5618	753	1	80	0.0125000
NODE_73_length_7036_cov_65.961943	5538	5618	763	1	80	0.0125000
NODE_73_length_7036_cov_65.961943	5538	5618	772	1	80	0.0125000
NODE_73_length_7036_cov_65.961943	5538	5618	785	2	80	0.0250000
NODE_73_length_7036_cov_65.961943	5538	5618	789	1	80	0.0125000
NODE_73_length_7036_cov_65.961943	5538	5618	790	1	80	0.0125000
NODE_73_length_7036_cov_65.961943	5538	5618	796	1	80	0.0125000
NODE_73_length_7036_cov_65.961943	5538	5618	812	1	80	0.0125000
NODE_73_length_7036_cov_65.961943	5538	5618	818	1	80	0.0125000
NODE_73_length_7036_cov_65.961943	5538	5618	833	1	80	0.0125000
NODE_73_length_7036_cov_65.961943	5538	5618	841	1	80	0.0125000
NODE_73_length_7036_cov_65.961943	5538	5618	842	1	80	0.0125000
NODE_73_length_7036_cov_65.961943	5538	5618	845	1	80	0.0125000
NODE_73_length_7036_cov_65.961943	5538	5618	847	1	80	0.0125000
NODE_73_length_7036_cov_65.961943	5538	5618	849	1	80	0.0125000
NODE_73_length_7036_cov_65.961943	5538	5618	851	1	80	0.0125000
NODE_73_length_7036_cov_65.961943	5538	5618	852	4	80	0.0500000
NODE_73_length_7036_cov_65.961943	5538	5618	854	2	80	0.0250000
NODE_73_length_7036_cov_65.961943	5538	5618	859	1	80	0.0125000
NODE_73_length_7036_cov_65.961943	5538	5618	860	1	80	0.0125000
NODE_73_length_7036_cov_65.961943	5538	5618	866	1	80	0.0125000
NODE_73_length_7036_cov_65.961943	5538	5618	874	1	80	0.0125000
NODE_73_length_7036_cov_65.961943	5591	5666	753	1	75	0.0133333
NODE_73_length_7036_cov_65.961943	5591	5666	763	1	75	0.0133333
NODE_73_length_7036_cov_65.961943	5591	5666	772	1	75	0.0133333
NODE_73_length_7036_cov_65.961943	5591	5666	785	2	75	0.0266667
NODE_73_length_7036_cov_65.961943	5591	5666	789	1	75	0.0133333
NODE_73_length_7036_cov_65.961943	5591	5666	790	1	75	0.0133333
NODE_73_length_7036_cov_65.961943	5591	5666	796	1	75	0.0133333
NODE_73_length_7036_cov_65.961943	5591	5666	812	1	75	0.0133333
NODE_73_length_7036_cov_65.961943	5591	5666	818	1	75	0.0133333
NODE_73_length_7036_cov_65.961943	5591	5666	833	1	75	0.0133333
NODE_73_length_7036_cov_65.961943	5591	5666	841	1	75	0.0133333
NODE_73_length_7036_cov_65.961943	5591	5666	842	1	75	0.0133333
NODE_73_length_7036_cov_65.961943	5591	5666	845	1	75	0.0133333
NODE_73_length_7036_cov_65.961943	5591	5666	847	1	75	0.0133333
NODE_73_length_7036_cov_65.961943	5591	5666	849	1	75	0.0133333
NODE_73_length_7036_cov_65.961943	5591	5666	851	1	75	0.0133333
NODE_73_length_7036_cov_65.961943	5591	5666	852	4	75	0.0533333
NODE_73_length_7036_cov_65.961943	5591	5666	854	2	75	0.0266667
NODE_73_length_7036_cov_65.961943	5591	5666	859	1	75	0.0133333
NODE_73_length_7036_cov_65.961943	5591	5666	860	1	75	0.0133333
NODE_73_length_7036_cov_65.961943	5591	5666	861	1	75	0.0133333
NODE_73_length_7036_cov_65.961943	5591	5666	865	1	75	0.0133333
NODE_73_length_7036_cov_65.961943	5591	5666	866	1	75	0.0133333
NODE_73_length_7036_cov_65.961943	5591	5666	867	1	75	0.0133333
NODE_73_length_7036_cov_65.961943	5591	5666	870	1	75	0.0133333
NODE_73_length_7036_cov_65.961943	5591	5666	873	1	75	0.0133333
NODE_73_length_7036_cov_65.961943	5591	5666	874	2	75	0.0266667
NODE_73_length_7036_cov_65.961943	5591	5666	876	1	75	0.0133333
NODE_73_length_7036_cov_65.961943	5591	5666	877	1	75	0.0133333
NODE_73_length_7036_cov_65.961943	5591	5666	880	1	75	0.0133333
NODE_73_length_7036_cov_65.961943	5591	5666	881	1	75	0.0133333
NODE_73_length_7036_cov_65.961943	5591	5666	885	1	75	0.0133333
NODE_73_length_7036_cov_65.961943	5591	5666	886	1	75	0.0133333
NODE_73_length_7036_cov_65.961943	5591	5666	888	1	75	0.0133333
NODE_73_length_7036_cov_65.961943	5591	5666	893	1	75	0.0133333
NODE_73_length_7036_cov_65.961943	5591	5666	899	1	75	0.0133333
NODE_73_length_7036_cov_65.961943	5591	5666	904	1	75	0.0133333
NODE_73_length_7036_cov_65.961943	5591	5666	905	2	75	0.0266667
NODE_73_length_7036_cov_65.961943	5591	5666	907	2	75	0.0266667
NODE_73_length_7036_cov_65.961943	5591	5666	910	2	75	0.0266667
NODE_73_length_7036_cov_65.961943	5591	5666	912	1	75	0.0133333
NODE_73_length_7036_cov_65.961943	5591	5666	913	2	75	0.0266667
NODE_73_length_7036_cov_65.961943	5591	5666	914	2	75	0.0266667
NODE_73_length_7036_cov_65.961943	5591	5666	915	1	75	0.0133333
NODE_73_length_7036_cov_65.961943	5591	5666	916	2	75	0.0266667
NODE_73_length_7036_cov_65.961943	5591	5666	918	1	75	0.0133333
NODE_73_length_7036_cov_65.961943	5591	5666	921	1	75	0.0133333
NODE_73_length_7036_cov_65.961943	5591	5666	923	2	75	0.0266667
NODE_73_length_7036_cov_65.961943	5591	5666	945	2	75	0.0266667
NODE_73_length_7036_cov_65.961943	5591	5666	956	1	75	0.0133333
NODE_73_length_7036_cov_65.961943	5591	5666	963	1	75	0.0133333
NODE_73_length_7036_cov_65.961943	5591	5666	965	1	75	0.0133333
NODE_73_length_7036_cov_65.961943	5591	5666	976	1	75	0.0133333
NODE_73_length_7036_cov_65.961943	5591	5666	990	1	75	0.0133333
NODE_73_length_7036_cov_65.961943	5591	5666	998	1	75	0.0133333
NODE_73_length_7036_cov_65.961943	5591	5666	1002	1	75	0.0133333
NODE_73_length_7036_cov_65.961943	5591	5666	1011	1	75	0.0133333
NODE_73_length_7036_cov_65.961943	5591	5666	1012	1	75	0.0133333
NODE_73_length_7036_cov_65.961943	5591	5666	1015	1	75	0.0133333
NODE_73_length_7036_cov_65.961943	5591	5666	1018	1	75	0.0133333
NODE_73_length_7036_cov_65.961943	5591	5666	1029	1	75	0.0133333
NODE_73_length_7036_cov_65.961943	5690	5746	1090	1	56	0.0178571
NODE_73_length_7036_cov_65.961943	5690	5746	1108	1	56	0.0178571
NODE_73_length_7036_cov_65.961943	5690	5746	1110	1	56	0.0178571
NODE_73_length_7036_cov_65.961943	5690	5746	1111	1	56	0.0178571
NODE_73_length_7036_cov_65.961943	5690	5746	1113	1	56	0.0178571
NODE_73_length_7036_cov_65.961943	5690	5746	1116	2	56	0.0357143
NODE_73_length_7036_cov_65.961943	5690	5746	1119	1	56	0.0178571
NODE_73_length_7036_cov_65.961943	5690	5746	1122	1	56	0.0178571
NODE_73_length_7036_cov_65.961943	5690	5746	1127	2	56	0.0357143
NODE_73_length_7036_cov_65.961943	5690	5746	1128	1	56	0.0178571
NODE_73_length_7036_cov_65.961943	5690	5746	1131	1	56	0.0178571
NODE_73_length_7036_cov_65.961943	5690	5746	1132	1	56	0.0178571
NODE_73_length_7036_cov_65.961943	5690	5746	1136	2	56	0.0357143
NODE_73_length_7036_cov_65.961943	5690	5746	1138	1	56	0.0178571
NODE_73_length_7036_cov_65.961943	5690	5746	1143	1	56	0.0178571
NODE_73_length_7036_cov_65.961943	5690	5746	1156	1	56	0.0178571
NODE_73_length_7036_cov_65.961943	5690	5746	1171	2	56	0.0357143
NODE_73_length_7036_cov_65.961943	5690	5746	1178	2	56	0.0357143
NODE_73_length_7036_cov_65.961943	5690	5746	1184	1	56	0.0178571
NODE_73_length_7036_cov_65.961943	5690	5746	1185	1	56	0.0178571
NODE_73_length_7036_cov_65.961943	5690	5746	1186	1	56	0.0178571
NODE_73_length_7036_cov_65.961943	5690	5746	1190	2	56	0.0357143
NODE_73_length_7036_cov_65.961943	5690	5746	1191	1	56	0.0178571
NODE_73_length_7036_cov_65.961943	5690	5746	1193	1	56	0.0178571
NODE_73_length_7036_cov_65.961943	5690	5746	1194	1	56	0.0178571
NODE_73_length_7036_cov_65.961943	5690	5746	1197	1	56	0.0178571
NODE_73_length_7036_cov_65.961943	5690	5746	1200	1	56	0.0178571
NODE_73_length_7036_cov_65.961943	5690	5746	1203	2	56	0.0357143
NODE_73_length_7036_cov_65.961943	5690	5746	1205	1	56	0.0178571
NODE_73_length_7036_cov_65.961943	5690	5746	1209	1	56	0.0178571
NODE_73_length_7036_cov_65.961943	5690	5746	1218	1	56	0.0178571
NODE_73_length_7036_cov_65.961943	5690	5746	1230	1	56	0.0178571
NODE_73_length_7036_cov_65.961943	5690	5746	1243	1	56	0.0178571
NODE_73_length_7036_cov_65.961943	5690	5746	1244	1	56	0.0178571
NODE_73_length_7036_cov_65.961943	5690	5746	1249	1	56	0.0178571
NODE_73_length_7036_cov_65.961943	5690	5746	1265	2	56	0.0357143
NODE_73_length_7036_cov_65.961943	5690	5746	1283	1	56	0.0178571
NODE_73_length_7036_cov_65.961943	5690	5746	1284	1	56	0.0178571
NODE_73_length_7036_cov_65.961943	5690	5746	1286	1	56	0.0178571
NODE_73_length_7036_cov_65.961943	5690	5746	1287	2	56	0.0357143
NODE_73_length_7036_cov_65.961943	5690	5746	1293	1	56	0.0178571
NODE_73_length_7036_cov_65.961943	5690	5746	1297	1	56	0.0178571
NODE_73_length_7036_cov_65.961943	5690	5746	1298	1	56	0.0178571
NODE_73_length_7036_cov_65.961943	5690	5746	1301	1	56	0.0178571
NODE_73_length_7036_cov_65.961943	5690	5746	1302	1	56	0.0178571
NODE_73_length_7036_cov_65.961943	5690	5746	1304	1	56	0.0178571
NODE_73_length_7036_cov_65.961943	5690	5746	1307	1	56	0.0178571
NODE_73_length_7036_cov_65.961943	6373	6453	0	80	80	1.0000000
NODE_73_length_7036_cov_65.961943	6426	6506	0	80	80	1.0000000
NODE_74_length_6974_cov_16.058327	976	1056	0	23	80	0.2875000
NODE_74_length_6974_cov_16.058327	976	1056	2	57	80	0.7125000
NODE_74_length_6974_cov_16.058327	1029	1109	0	76	80	0.9500000
NODE_74_length_6974_cov_16.058327	1029	1109	2	4	80	0.0500000
NODE_80_length_6826_cov_10.483574	4462	4542	0	10	80	0.1250000
NODE_80_length_6826_cov_10.483574	4462	4542	10	1	80	0.0125000
NODE_80_length_6826_cov_10.483574	4462	4542	11	3	80	0.0375000
NODE_80_length_6826_cov_10.483574	4462	4542	13	10	80	0.1250000
NODE_80_length_6826_cov_10.483574	4462	4542	14	7	80	0.0875000
NODE_80_length_6826_cov_10.483574	4462	4542	16	21	80	0.2625000
NODE_80_length_6826_cov_10.483574	4462	4542	20	2	80	0.0250000
NODE_80_length_6826_cov_10.483574	4462	4542	26	26	80	0.3250000
NODE_80_length_6826_cov_10.483574	4515	4595	20	1	80	0.0125000
NODE_80_length_6826_cov_10.483574	4515	4595	24	4	80	0.0500000
NODE_80_length_6826_cov_10.483574	4515	4595	25	4	80	0.0500000
NODE_80_length_6826_cov_10.483574	4515	4595	26	26	80	0.3250000
NODE_80_length_6826_cov_10.483574	4515	4595	28	3	80	0.0375000
NODE_80_length_6826_cov_10.483574	4515	4595	30	4	80	0.0500000
NODE_80_length_6826_cov_10.483574	4515	4595	32	21	80	0.2625000
NODE_80_length_6826_cov_10.483574	4515	4595	34	17	80	0.2125000
NODE_81_length_6816_cov_2.820753	6726	6801	0	75	75	1.0000000
NODE_81_length_6816_cov_2.820753	6774	6816	0	42	42	1.0000000
NODE_84_length_6744_cov_6.222272	5	85	0	80	80	1.0000000
NODE_84_length_6744_cov_6.222272	58	138	0	80	80	1.0000000
NODE_84_length_6744_cov_6.222272	6650	6730	0	25	80	0.3125000
NODE_84_length_6744_cov_6.222272	6650	6730	2	14	80	0.1750000
NODE_84_length_6744_cov_6.222272	6650	6730	4	41	80	0.5125000
NODE_84_length_6744_cov_6.222272	6703	6744	0	39	41	0.9512195
NODE_84_length_6744_cov_6.222272	6703	6744	2	2	41	0.0487805
NODE_86_length_6733_cov_88.965029	3141	3221	0	80	80	1.0000000
NODE_86_length_6733_cov_88.965029	3194	3274	0	80	80	1.0000000
NODE_86_length_6733_cov_88.965029	3270	3350	0	80	80	1.0000000
NODE_86_length_6733_cov_88.965029	3323	3403	0	80	80	1.0000000
NODE_90_length_6627_cov_9.440564	350	430	1	39	80	0.4875000
NODE_90_length_6627_cov_9.440564	350	430	2	41	80	0.5125000
NODE_90_length_6627_cov_9.440564	403	483	1	31	80	0.3875000
NODE_90_length_6627_cov_9.440564	403	483	2	49	80	0.6125000
NODE_95_length_6507_cov_95.786049	171	247	0	11	76	0.1447368
NODE_95_length_6507_cov_95.786049	171	247	2	61	76	0.8026316
NODE_95_length_6507_cov_95.786049	171	247	4	2	76	0.0263158
NODE_95_length_6507_cov_95.786049	171	247	10	1	76	0.0131579
NODE_95_length_6507_cov_95.786049	171	247	39	1	76	0.0131579
NODE_96_length_6497_cov_2.677399	366	436	2	10	70	0.1428571
NODE_96_length_6497_cov_2.677399	366	436	4	11	70	0.1571429
NODE_96_length_6497_cov_2.677399	366	436	8	41	70	0.5857143
NODE_96_length_6497_cov_2.677399	366	436	9	8	70	0.1142857
NODE_96_length_6497_cov_2.677399	409	444	0	3	35	0.0857143
NODE_96_length_6497_cov_2.677399	409	444	2	15	35	0.4285714
NODE_96_length_6497_cov_2.677399	409	444	4	11	35	0.3142857
NODE_96_length_6497_cov_2.677399	409	444	8	6	35	0.1714286
NODE_97_length_6450_cov_26.108172	5024	5104	0	19	80	0.2375000
NODE_97_length_6450_cov_26.108172	5024	5104	6	37	80	0.4625000
NODE_97_length_6450_cov_26.108172	5024	5104	10	6	80	0.0750000
NODE_97_length_6450_cov_26.108172	5024	5104	12	18	80	0.2250000
NODE_109_length_6171_cov_36.061100	3743	3813	17	2	70	0.0285714
NODE_109_length_6171_cov_36.061100	3743	3813	22	2	70	0.0285714
NODE_109_length_6171_cov_36.061100	3743	3813	42	3	70	0.0428571
NODE_109_length_6171_cov_36.061100	3743	3813	43	4	70	0.0571429
NODE_109_length_6171_cov_36.061100	3743	3813	45	6	70	0.0857143
NODE_109_length_6171_cov_36.061100	3743	3813	47	14	70	0.2000000
NODE_109_length_6171_cov_36.061100	3743	3813	48	5	70	0.0714286
NODE_109_length_6171_cov_36.061100	3743	3813	54	5	70	0.0714286
NODE_109_length_6171_cov_36.061100	3743	3813	55	1	70	0.0142857
NODE_109_length_6171_cov_36.061100	3743	3813	59	10	70	0.1428571
NODE_109_length_6171_cov_36.061100	3743	3813	61	3	70	0.0428571
NODE_109_length_6171_cov_36.061100	3743	3813	67	3	70	0.0428571
NODE_109_length_6171_cov_36.061100	3743	3813	69	3	70	0.0428571
NODE_109_length_6171_cov_36.061100	3743	3813	71	1	70	0.0142857
NODE_109_length_6171_cov_36.061100	3743	3813	73	2	70	0.0285714
NODE_109_length_6171_cov_36.061100	3743	3813	75	6	70	0.0857143
NODE_109_length_6171_cov_36.061100	3798	3851	67	3	53	0.0566038
NODE_109_length_6171_cov_36.061100	3798	3851	69	4	53	0.0754717
NODE_109_length_6171_cov_36.061100	3798	3851	71	1	53	0.0188679
NODE_109_length_6171_cov_36.061100	3798	3851	72	2	53	0.0377358
NODE_109_length_6171_cov_36.061100	3798	3851	73	2	53	0.0377358
NODE_109_length_6171_cov_36.061100	3798	3851	74	1	53	0.0188679
NODE_109_length_6171_cov_36.061100	3798	3851	75	10	53	0.1886792
NODE_109_length_6171_cov_36.061100	3798	3851	76	3	53	0.0566038
NODE_109_length_6171_cov_36.061100	3798	3851	77	1	53	0.0188679
NODE_109_length_6171_cov_36.061100	3798	3851	79	1	53	0.0188679
NODE_109_length_6171_cov_36.061100	3798	3851	81	11	53	0.2075472
NODE_109_length_6171_cov_36.061100	3798	3851	82	4	53	0.0754717
NODE_109_length_6171_cov_36.061100	3798	3851	85	1	53	0.0188679
NODE_109_length_6171_cov_36.061100	3798	3851	86	2	53	0.0377358
NODE_109_length_6171_cov_36.061100	3798	3851	87	1	53	0.0188679
NODE_109_length_6171_cov_36.061100	3798	3851	88	1	53	0.0188679
NODE_109_length_6171_cov_36.061100	3798	3851	89	5	53	0.0943396
NODE_109_length_6171_cov_36.061100	4552	4596	279	1	44	0.0227273
NODE_109_length_6171_cov_36.061100	4552	4596	283	1	44	0.0227273
NODE_109_length_6171_cov_36.061100	4552	4596	287	1	44	0.0227273
NODE_109_length_6171_cov_36.061100	4552	4596	289	1	44	0.0227273
NODE_109_length_6171_cov_36.061100	4552	4596	290	2	44	0.0454545
NODE_109_length_6171_cov_36.061100	4552	4596	292	1	44	0.0227273
NODE_109_length_6171_cov_36.061100	4552	4596	295	1	44	0.0227273
NODE_109_length_6171_cov_36.061100	4552	4596	296	4	44	0.0909091
NODE_109_length_6171_cov_36.061100	4552	4596	299	3	44	0.0681818
NODE_109_length_6171_cov_36.061100	4552	4596	300	1	44	0.0227273
NODE_109_length_6171_cov_36.061100	4552	4596	301	3	44	0.0681818
NODE_109_length_6171_cov_36.061100	4552	4596	305	1	44	0.0227273
NODE_109_length_6171_cov_36.061100	4552	4596	306	1	44	0.0227273
NODE_109_length_6171_cov_36.061100	4552	4596	307	2	44	0.0454545
NODE_109_length_6171_cov_36.061100	4552	4596	309	2	44	0.0454545
NODE_109_length_6171_cov_36.061100	4552	4596	310	3	44	0.0681818
NODE_109_length_6171_cov_36.061100	4552	4596	312	3	44	0.0681818
NODE_109_length_6171_cov_36.061100	4552	4596	313	1	44	0.0227273
NODE_109_length_6171_cov_36.061100	4552	4596	314	2	44	0.0454545
NODE_109_length_6171_cov_36.061100	4552	4596	316	1	44	0.0227273
NODE_109_length_6171_cov_36.061100	4552	4596	317	1	44	0.0227273
NODE_109_length_6171_cov_36.061100	4552	4596	318	1	44	0.0227273
NODE_109_length_6171_cov_36.061100	4552	4596	321	1	44	0.0227273
NODE_109_length_6171_cov_36.061100	4552	4596	325	1	44	0.0227273
NODE_109_length_6171_cov_36.061100	4552	4596	326	1	44	0.0227273
NODE_109_length_6171_cov_36.061100	4552	4596	327	1	44	0.0227273
NODE_109_length_6171_cov_36.061100	4552	4596	333	1	44	0.0227273
NODE_109_length_6171_cov_36.061100	4552	4596	335	1	44	0.0227273
NODE_109_length_6171_cov_36.061100	4552	4596	337	1	44	0.0227273
NODE_109_length_6171_cov_36.061100	4569	4649	279	1	80	0.0125000
NODE_109_length_6171_cov_36.061100	4569	4649	283	1	80	0.0125000
NODE_109_length_6171_cov_36.061100	4569	4649	287	1	80	0.0125000
NODE_109_length_6171_cov_36.061100	4569	4649	289	1	80	0.0125000
NODE_109_length_6171_cov_36.061100	4569	4649	290	2	80	0.0250000
NODE_109_length_6171_cov_36.061100	4569	4649	292	1	80	0.0125000
NODE_109_length_6171_cov_36.061100	4569	4649	295	1	80	0.0125000
NODE_109_length_6171_cov_36.061100	4569	4649	296	4	80	0.0500000
NODE_109_length_6171_cov_36.061100	4569	4649	299	3	80	0.0375000
NODE_109_length_6171_cov_36.061100	4569	4649	300	1	80	0.0125000
NODE_109_length_6171_cov_36.061100	4569	4649	301	3	80	0.0375000
NODE_109_length_6171_cov_36.061100	4569	4649	305	2	80	0.0250000
NODE_109_length_6171_cov_36.061100	4569	4649	306	1	80	0.0125000
NODE_109_length_6171_cov_36.061100	4569	4649	307	1	80	0.0125000
NODE_109_length_6171_cov_36.061100	4569	4649	308	1	80	0.0125000
NODE_109_length_6171_cov_36.061100	4569	4649	309	2	80	0.0250000
NODE_109_length_6171_cov_36.061100	4569	4649	310	1	80	0.0125000
NODE_109_length_6171_cov_36.061100	4569	4649	311	5	80	0.0625000
NODE_109_length_6171_cov_36.061100	4569	4649	312	2	80	0.0250000
NODE_109_length_6171_cov_36.061100	4569	4649	313	1	80	0.0125000
NODE_109_length_6171_cov_36.061100	4569	4649	315	1	80	0.0125000
NODE_109_length_6171_cov_36.061100	4569	4649	316	6	80	0.0750000
NODE_109_length_6171_cov_36.061100	4569	4649	317	2	80	0.0250000
NODE_109_length_6171_cov_36.061100	4569	4649	318	6	80	0.0750000
NODE_109_length_6171_cov_36.061100	4569	4649	319	6	80	0.0750000
NODE_109_length_6171_cov_36.061100	4569	4649	320	1	80	0.0125000
NODE_109_length_6171_cov_36.061100	4569	4649	321	2	80	0.0250000
NODE_109_length_6171_cov_36.061100	4569	4649	322	1	80	0.0125000
NODE_109_length_6171_cov_36.061100	4569	4649	323	3	80	0.0375000
NODE_109_length_6171_cov_36.061100	4569	4649	324	2	80	0.0250000
NODE_109_length_6171_cov_36.061100	4569	4649	325	2	80	0.0250000
NODE_109_length_6171_cov_36.061100	4569	4649	326	2	80	0.0250000
NODE_109_length_6171_cov_36.061100	4569	4649	331	1	80	0.0125000
NODE_109_length_6171_cov_36.061100	4569	4649	335	1	80	0.0125000
NODE_109_length_6171_cov_36.061100	4569	4649	336	1	80	0.0125000
NODE_109_length_6171_cov_36.061100	4569	4649	337	1	80	0.0125000
NODE_109_length_6171_cov_36.061100	4569	4649	339	2	80	0.0250000
NODE_109_length_6171_cov_36.061100	4569	4649	341	1	80	0.0125000
NODE_109_length_6171_cov_36.061100	4569	4649	353	1	80	0.0125000
NODE_109_length_6171_cov_36.061100	4569	4649	354	1	80	0.0125000
NODE_109_length_6171_cov_36.061100	4569	4649	355	1	80	0.0125000
NODE_109_length_6171_cov_36.061100	4569	4649	359	1	80	0.0125000
NODE_109_length_6171_cov_36.061100	5742	5788	0	46	46	1.0000000
NODE_109_length_6171_cov_36.061100	5761	5841	0	80	80	1.0000000
NODE_110_length_6148_cov_58.915358	5602	5682	0	80	80	1.0000000
NODE_110_length_6148_cov_58.915358	5655	5735	0	80	80	1.0000000
NODE_112_length_6026_cov_17.775772	4124	4204	0	80	80	1.0000000
NODE_112_length_6026_cov_17.775772	4177	4257	0	80	80	1.0000000
NODE_112_length_6026_cov_17.775772	4253	4333	0	78	80	0.9750000
NODE_112_length_6026_cov_17.775772	4253	4333	2	2	80	0.0250000
NODE_112_length_6026_cov_17.775772	4306	4386	0	25	80	0.3125000
NODE_112_length_6026_cov_17.775772	4306	4386	2	54	80	0.6750000
NODE_112_length_6026_cov_17.775772	4306	4386	3	1	80	0.0125000
NODE_124_length_5810_cov_24.750657	2064	2144	5	2	80	0.0250000
NODE_124_length_5810_cov_24.750657	2064	2144	6	1	80	0.0125000
NODE_124_length_5810_cov_24.750657	2064	2144	7	1	80	0.0125000
NODE_124_length_5810_cov_24.750657	2064	2144	10	1	80	0.0125000
NODE_124_length_5810_cov_24.750657	2064	2144	12	2	80	0.0250000
NODE_124_length_5810_cov_24.750657	2064	2144	13	24	80	0.3000000
NODE_124_length_5810_cov_24.750657	2064	2144	15	18	80	0.2250000
NODE_124_length_5810_cov_24.750657	2064	2144	17	1	80	0.0125000
NODE_124_length_5810_cov_24.750657	2064	2144	20	6	80	0.0750000
NODE_124_length_5810_cov_24.750657	2064	2144	24	1	80	0.0125000
NODE_124_length_5810_cov_24.750657	2064	2144	30	2	80	0.0250000
NODE_124_length_5810_cov_24.750657	2064	2144	31	4	80	0.0500000
NODE_124_length_5810_cov_24.750657	2064	2144	33	2	80	0.0250000
NODE_124_length_5810_cov_24.750657	2064	2144	35	1	80	0.0125000
NODE_124_length_5810_cov_24.750657	2064	2144	36	2	80	0.0250000
NODE_124_length_5810_cov_24.750657	2064	2144	38	3	80	0.0375000
NODE_124_length_5810_cov_24.750657	2064	2144	42	4	80	0.0500000
NODE_124_length_5810_cov_24.750657	2064	2144	44	1	80	0.0125000
NODE_124_length_5810_cov_24.750657	2064	2144	46	4	80	0.0500000
NODE_124_length_5810_cov_24.750657	2117	2194	2	42	77	0.5454546
NODE_124_length_5810_cov_24.750657	2117	2194	5	10	77	0.1298701
NODE_124_length_5810_cov_24.750657	2117	2194	6	1	77	0.0129870
NODE_124_length_5810_cov_24.750657	2117	2194	7	1	77	0.0129870
NODE_124_length_5810_cov_24.750657	2117	2194	10	1	77	0.0129870
NODE_124_length_5810_cov_24.750657	2117	2194	12	2	77	0.0259740
NODE_124_length_5810_cov_24.750657	2117	2194	13	20	77	0.2597403
NODE_127_length_5771_cov_10.854549	2814	2883	2	16	69	0.2318841
NODE_127_length_5771_cov_10.854549	2814	2883	4	53	69	0.7681159
NODE_128_length_5769_cov_6.878483	5701	5731	2	30	30	1.0000000
NODE_133_length_5728_cov_16.351039	63	134	0	50	71	0.7042254
NODE_133_length_5728_cov_16.351039	63	134	2	21	71	0.2957746
NODE_133_length_5728_cov_16.351039	2960	3040	0	9	80	0.1125000
NODE_133_length_5728_cov_16.351039	2960	3040	1	4	80	0.0500000
NODE_133_length_5728_cov_16.351039	2960	3040	3	44	80	0.5500000
NODE_133_length_5728_cov_16.351039	2960	3040	4	23	80	0.2875000
NODE_133_length_5728_cov_16.351039	5106	5172	46	1	66	0.0151515
NODE_133_length_5728_cov_16.351039	5106	5172	47	6	66	0.0909091
NODE_133_length_5728_cov_16.351039	5106	5172	48	1	66	0.0151515
NODE_133_length_5728_cov_16.351039	5106	5172	50	2	66	0.0303030
NODE_133_length_5728_cov_16.351039	5106	5172	52	5	66	0.0757576
NODE_133_length_5728_cov_16.351039	5106	5172	54	2	66	0.0303030
NODE_133_length_5728_cov_16.351039	5106	5172	55	3	66	0.0454545
NODE_133_length_5728_cov_16.351039	5106	5172	57	4	66	0.0606061
NODE_133_length_5728_cov_16.351039	5106	5172	58	7	66	0.1060606
NODE_133_length_5728_cov_16.351039	5106	5172	60	1	66	0.0151515
NODE_133_length_5728_cov_16.351039	5106	5172	64	2	66	0.0303030
NODE_133_length_5728_cov_16.351039	5106	5172	68	2	66	0.0303030
NODE_133_length_5728_cov_16.351039	5106	5172	70	2	66	0.0303030
NODE_133_length_5728_cov_16.351039	5106	5172	72	2	66	0.0303030
NODE_133_length_5728_cov_16.351039	5106	5172	75	4	66	0.0606061
NODE_133_length_5728_cov_16.351039	5106	5172	76	2	66	0.0303030
NODE_133_length_5728_cov_16.351039	5106	5172	77	5	66	0.0757576
NODE_133_length_5728_cov_16.351039	5106	5172	78	6	66	0.0909091
NODE_133_length_5728_cov_16.351039	5106	5172	79	2	66	0.0303030
NODE_133_length_5728_cov_16.351039	5106	5172	81	1	66	0.0151515
NODE_133_length_5728_cov_16.351039	5106	5172	82	6	66	0.0909091
NODE_133_length_5728_cov_16.351039	5145	5225	72	1	80	0.0125000
NODE_133_length_5728_cov_16.351039	5145	5225	73	5	80	0.0625000
NODE_133_length_5728_cov_16.351039	5145	5225	75	7	80	0.0875000
NODE_133_length_5728_cov_16.351039	5145	5225	76	2	80	0.0250000
NODE_133_length_5728_cov_16.351039	5145	5225	77	6	80	0.0750000
NODE_133_length_5728_cov_16.351039	5145	5225	78	6	80	0.0750000
NODE_133_length_5728_cov_16.351039	5145	5225	79	2	80	0.0250000
NODE_133_length_5728_cov_16.351039	5145	5225	81	4	80	0.0500000
NODE_133_length_5728_cov_16.351039	5145	5225	82	6	80	0.0750000
NODE_133_length_5728_cov_16.351039	5145	5225	87	4	80	0.0500000
NODE_133_length_5728_cov_16.351039	5145	5225	89	1	80	0.0125000
NODE_133_length_5728_cov_16.351039	5145	5225	91	1	80	0.0125000
NODE_133_length_5728_cov_16.351039	5145	5225	94	1	80	0.0125000
NODE_133_length_5728_cov_16.351039	5145	5225	95	1	80	0.0125000
NODE_133_length_5728_cov_16.351039	5145	5225	96	12	80	0.1500000
NODE_133_length_5728_cov_16.351039	5145	5225	97	1	80	0.0125000
NODE_133_length_5728_cov_16.351039	5145	5225	98	3	80	0.0375000
NODE_133_length_5728_cov_16.351039	5145	5225	99	2	80	0.0250000
NODE_133_length_5728_cov_16.351039	5145	5225	100	2	80	0.0250000
NODE_133_length_5728_cov_16.351039	5145	5225	101	7	80	0.0875000
NODE_133_length_5728_cov_16.351039	5145	5225	102	6	80	0.0750000
NODE_137_length_5696_cov_20.656244	179	258	0	79	79	1.0000000
NODE_137_length_5696_cov_20.656244	231	311	0	80	80	1.0000000
NODE_137_length_5696_cov_20.656244	307	387	0	80	80	1.0000000
NODE_137_length_5696_cov_20.656244	360	440	0	80	80	1.0000000
NODE_137_length_5696_cov_20.656244	5100	5180	0	80	80	1.0000000
NODE_137_length_5696_cov_20.656244	5153	5233	0	80	80	1.0000000
NODE_137_length_5696_cov_20.656244	5280	5360	0	80	80	1.0000000
NODE_137_length_5696_cov_20.656244	5333	5413	0	80	80	1.0000000
NODE_139_length_5681_cov_68.065030	253	333	0	80	80	1.0000000
NODE_139_length_5681_cov_68.065030	306	386	0	80	80	1.0000000
NODE_139_length_5681_cov_68.065030	4762	4842	231	3	80	0.0375000
NODE_139_length_5681_cov_68.065030	4762	4842	233	1	80	0.0125000
NODE_139_length_5681_cov_68.065030	4762	4842	236	1	80	0.0125000
NODE_139_length_5681_cov_68.065030	4762	4842	238	3	80	0.0375000
NODE_139_length_5681_cov_68.065030	4762	4842	240	2	80	0.0250000
NODE_139_length_5681_cov_68.065030	4762	4842	241	1	80	0.0125000
NODE_139_length_5681_cov_68.065030	4762	4842	269	3	80	0.0375000
NODE_139_length_5681_cov_68.065030	4762	4842	271	1	80	0.0125000
NODE_139_length_5681_cov_68.065030	4762	4842	278	8	80	0.1000000
NODE_139_length_5681_cov_68.065030	4762	4842	279	2	80	0.0250000
NODE_139_length_5681_cov_68.065030	4762	4842	286	2	80	0.0250000
NODE_139_length_5681_cov_68.065030	4762	4842	288	6	80	0.0750000
NODE_139_length_5681_cov_68.065030	4762	4842	290	4	80	0.0500000
NODE_139_length_5681_cov_68.065030	4762	4842	294	2	80	0.0250000
NODE_139_length_5681_cov_68.065030	4762	4842	295	3	80	0.0375000
NODE_139_length_5681_cov_68.065030	4762	4842	296	1	80	0.0125000
NODE_139_length_5681_cov_68.065030	4762	4842	298	1	80	0.0125000
NODE_139_length_5681_cov_68.065030	4762	4842	299	7	80	0.0875000
NODE_139_length_5681_cov_68.065030	4762	4842	300	2	80	0.0250000
NODE_139_length_5681_cov_68.065030	4762	4842	301	10	80	0.1250000
NODE_139_length_5681_cov_68.065030	4762	4842	302	7	80	0.0875000
NODE_139_length_5681_cov_68.065030	4762	4842	303	3	80	0.0375000
NODE_139_length_5681_cov_68.065030	4762	4842	304	7	80	0.0875000
NODE_139_length_5681_cov_68.065030	4762	4842	231	3	80	0.0375000
NODE_139_length_5681_cov_68.065030	4762	4842	233	1	80	0.0125000
NODE_139_length_5681_cov_68.065030	4762	4842	236	1	80	0.0125000
NODE_139_length_5681_cov_68.065030	4762	4842	238	3	80	0.0375000
NODE_139_length_5681_cov_68.065030	4762	4842	240	2	80	0.0250000
NODE_139_length_5681_cov_68.065030	4762	4842	241	1	80	0.0125000
NODE_139_length_5681_cov_68.065030	4762	4842	269	3	80	0.0375000
NODE_139_length_5681_cov_68.065030	4762	4842	271	1	80	0.0125000
NODE_139_length_5681_cov_68.065030	4762	4842	278	8	80	0.1000000
NODE_139_length_5681_cov_68.065030	4762	4842	279	2	80	0.0250000
NODE_139_length_5681_cov_68.065030	4762	4842	286	2	80	0.0250000
NODE_139_length_5681_cov_68.065030	4762	4842	288	6	80	0.0750000
NODE_139_length_5681_cov_68.065030	4762	4842	290	4	80	0.0500000
NODE_139_length_5681_cov_68.065030	4762	4842	294	2	80	0.0250000
NODE_139_length_5681_cov_68.065030	4762	4842	295	3	80	0.0375000
NODE_139_length_5681_cov_68.065030	4762	4842	296	1	80	0.0125000
NODE_139_length_5681_cov_68.065030	4762	4842	298	1	80	0.0125000
NODE_139_length_5681_cov_68.065030	4762	4842	299	7	80	0.0875000
NODE_139_length_5681_cov_68.065030	4762	4842	300	2	80	0.0250000
NODE_139_length_5681_cov_68.065030	4762	4842	301	10	80	0.1250000
NODE_139_length_5681_cov_68.065030	4762	4842	302	7	80	0.0875000
NODE_139_length_5681_cov_68.065030	4762	4842	303	3	80	0.0375000
NODE_139_length_5681_cov_68.065030	4762	4842	304	7	80	0.0875000
NODE_139_length_5681_cov_68.065030	4762	4842	231	3	80	0.0375000
NODE_139_length_5681_cov_68.065030	4762	4842	233	1	80	0.0125000
NODE_139_length_5681_cov_68.065030	4762	4842	236	1	80	0.0125000
NODE_139_length_5681_cov_68.065030	4762	4842	238	3	80	0.0375000
NODE_139_length_5681_cov_68.065030	4762	4842	240	2	80	0.0250000
NODE_139_length_5681_cov_68.065030	4762	4842	241	1	80	0.0125000
NODE_139_length_5681_cov_68.065030	4762	4842	269	3	80	0.0375000
NODE_139_length_5681_cov_68.065030	4762	4842	271	1	80	0.0125000
NODE_139_length_5681_cov_68.065030	4762	4842	278	8	80	0.1000000
NODE_139_length_5681_cov_68.065030	4762	4842	279	2	80	0.0250000
NODE_139_length_5681_cov_68.065030	4762	4842	286	2	80	0.0250000
NODE_139_length_5681_cov_68.065030	4762	4842	288	6	80	0.0750000
NODE_139_length_5681_cov_68.065030	4762	4842	290	4	80	0.0500000
NODE_139_length_5681_cov_68.065030	4762	4842	294	2	80	0.0250000
NODE_139_length_5681_cov_68.065030	4762	4842	295	3	80	0.0375000
NODE_139_length_5681_cov_68.065030	4762	4842	296	1	80	0.0125000
NODE_139_length_5681_cov_68.065030	4762	4842	298	1	80	0.0125000
NODE_139_length_5681_cov_68.065030	4762	4842	299	7	80	0.0875000
NODE_139_length_5681_cov_68.065030	4762	4842	300	2	80	0.0250000
NODE_139_length_5681_cov_68.065030	4762	4842	301	10	80	0.1250000
NODE_139_length_5681_cov_68.065030	4762	4842	302	7	80	0.0875000
NODE_139_length_5681_cov_68.065030	4762	4842	303	3	80	0.0375000
NODE_139_length_5681_cov_68.065030	4762	4842	304	7	80	0.0875000
NODE_139_length_5681_cov_68.065030	4762	4842	231	3	80	0.0375000
NODE_139_length_5681_cov_68.065030	4762	4842	233	1	80	0.0125000
NODE_139_length_5681_cov_68.065030	4762	4842	236	1	80	0.0125000
NODE_139_length_5681_cov_68.065030	4762	4842	238	3	80	0.0375000
NODE_139_length_5681_cov_68.065030	4762	4842	240	2	80	0.0250000
NODE_139_length_5681_cov_68.065030	4762	4842	241	1	80	0.0125000
NODE_139_length_5681_cov_68.065030	4762	4842	269	3	80	0.0375000
NODE_139_length_5681_cov_68.065030	4762	4842	271	1	80	0.0125000
NODE_139_length_5681_cov_68.065030	4762	4842	278	8	80	0.1000000
NODE_139_length_5681_cov_68.065030	4762	4842	279	2	80	0.0250000
NODE_139_length_5681_cov_68.065030	4762	4842	286	2	80	0.0250000
NODE_139_length_5681_cov_68.065030	4762	4842	288	6	80	0.0750000
NODE_139_length_5681_cov_68.065030	4762	4842	290	4	80	0.0500000
NODE_139_length_5681_cov_68.065030	4762	4842	294	2	80	0.0250000
NODE_139_length_5681_cov_68.065030	4762	4842	295	3	80	0.0375000
NODE_139_length_5681_cov_68.065030	4762	4842	296	1	80	0.0125000
NODE_139_length_5681_cov_68.065030	4762	4842	298	1	80	0.0125000
NODE_139_length_5681_cov_68.065030	4762	4842	299	7	80	0.0875000
NODE_139_length_5681_cov_68.065030	4762	4842	300	2	80	0.0250000
NODE_139_length_5681_cov_68.065030	4762	4842	301	10	80	0.1250000
NODE_139_length_5681_cov_68.065030	4762	4842	302	7	80	0.0875000
NODE_139_length_5681_cov_68.065030	4762	4842	303	3	80	0.0375000
NODE_139_length_5681_cov_68.065030	4762	4842	304	7	80	0.0875000
NODE_139_length_5681_cov_68.065030	4762	4842	231	3	80	0.0375000
NODE_139_length_5681_cov_68.065030	4762	4842	233	1	80	0.0125000
NODE_139_length_5681_cov_68.065030	4762	4842	236	1	80	0.0125000
NODE_139_length_5681_cov_68.065030	4762	4842	238	3	80	0.0375000
NODE_139_length_5681_cov_68.065030	4762	4842	240	2	80	0.0250000
NODE_139_length_5681_cov_68.065030	4762	4842	241	1	80	0.0125000
NODE_139_length_5681_cov_68.065030	4762	4842	269	3	80	0.0375000
NODE_139_length_5681_cov_68.065030	4762	4842	271	1	80	0.0125000
NODE_139_length_5681_cov_68.065030	4762	4842	278	8	80	0.1000000
NODE_139_length_5681_cov_68.065030	4762	4842	279	2	80	0.0250000
NODE_139_length_5681_cov_68.065030	4762	4842	286	2	80	0.0250000
NODE_139_length_5681_cov_68.065030	4762	4842	288	6	80	0.0750000
NODE_139_length_5681_cov_68.065030	4762	4842	290	4	80	0.0500000
NODE_139_length_5681_cov_68.065030	4762	4842	294	2	80	0.0250000
NODE_139_length_5681_cov_68.065030	4762	4842	295	3	80	0.0375000
NODE_139_length_5681_cov_68.065030	4762	4842	296	1	80	0.0125000
NODE_139_length_5681_cov_68.065030	4762	4842	298	1	80	0.0125000
NODE_139_length_5681_cov_68.065030	4762	4842	299	7	80	0.0875000
NODE_139_length_5681_cov_68.065030	4762	4842	300	2	80	0.0250000
NODE_139_length_5681_cov_68.065030	4762	4842	301	10	80	0.1250000
NODE_139_length_5681_cov_68.065030	4762	4842	302	7	80	0.0875000
NODE_139_length_5681_cov_68.065030	4762	4842	303	3	80	0.0375000
NODE_139_length_5681_cov_68.065030	4762	4842	304	7	80	0.0875000
NODE_139_length_5681_cov_68.065030	4762	4842	231	3	80	0.0375000
NODE_139_length_5681_cov_68.065030	4762	4842	233	1	80	0.0125000
NODE_139_length_5681_cov_68.065030	4762	4842	236	1	80	0.0125000
NODE_139_length_5681_cov_68.065030	4762	4842	238	3	80	0.0375000
NODE_139_length_5681_cov_68.065030	4762	4842	240	2	80	0.0250000
NODE_139_length_5681_cov_68.065030	4762	4842	241	1	80	0.0125000
NODE_139_length_5681_cov_68.065030	4762	4842	269	3	80	0.0375000
NODE_139_length_5681_cov_68.065030	4762	4842	271	1	80	0.0125000
NODE_139_length_5681_cov_68.065030	4762	4842	278	8	80	0.1000000
NODE_139_length_5681_cov_68.065030	4762	4842	279	2	80	0.0250000
NODE_139_length_5681_cov_68.065030	4762	4842	286	2	80	0.0250000
NODE_139_length_5681_cov_68.065030	4762	4842	288	6	80	0.0750000
NODE_139_length_5681_cov_68.065030	4762	4842	290	4	80	0.0500000
NODE_139_length_5681_cov_68.065030	4762	4842	294	2	80	0.0250000
NODE_139_length_5681_cov_68.065030	4762	4842	295	3	80	0.0375000
NODE_139_length_5681_cov_68.065030	4762	4842	296	1	80	0.0125000
NODE_139_length_5681_cov_68.065030	4762	4842	298	1	80	0.0125000
NODE_139_length_5681_cov_68.065030	4762	4842	299	7	80	0.0875000
NODE_139_length_5681_cov_68.065030	4762	4842	300	2	80	0.0250000
NODE_139_length_5681_cov_68.065030	4762	4842	301	10	80	0.1250000
NODE_139_length_5681_cov_68.065030	4762	4842	302	7	80	0.0875000
NODE_139_length_5681_cov_68.065030	4762	4842	303	3	80	0.0375000
NODE_139_length_5681_cov_68.065030	4762	4842	304	7	80	0.0875000
NODE_139_length_5681_cov_68.065030	4769	4839	233	1	70	0.0142857
NODE_139_length_5681_cov_68.065030	4769	4839	236	1	70	0.0142857
NODE_139_length_5681_cov_68.065030	4769	4839	238	3	70	0.0428571
NODE_139_length_5681_cov_68.065030	4769	4839	240	2	70	0.0285714
NODE_139_length_5681_cov_68.065030	4769	4839	241	1	70	0.0142857
NODE_139_length_5681_cov_68.065030	4769	4839	269	3	70	0.0428571
NODE_139_length_5681_cov_68.065030	4769	4839	271	1	70	0.0142857
NODE_139_length_5681_cov_68.065030	4769	4839	278	1	70	0.0142857
NODE_139_length_5681_cov_68.065030	4769	4839	279	2	70	0.0285714
NODE_139_length_5681_cov_68.065030	4769	4839	286	2	70	0.0285714
NODE_139_length_5681_cov_68.065030	4769	4839	288	6	70	0.0857143
NODE_139_length_5681_cov_68.065030	4769	4839	290	4	70	0.0571429
NODE_139_length_5681_cov_68.065030	4769	4839	294	2	70	0.0285714
NODE_139_length_5681_cov_68.065030	4769	4839	295	3	70	0.0428571
NODE_139_length_5681_cov_68.065030	4769	4839	296	1	70	0.0142857
NODE_139_length_5681_cov_68.065030	4769	4839	298	1	70	0.0142857
NODE_139_length_5681_cov_68.065030	4769	4839	299	7	70	0.1000000
NODE_139_length_5681_cov_68.065030	4769	4839	300	2	70	0.0285714
NODE_139_length_5681_cov_68.065030	4769	4839	301	10	70	0.1428571
NODE_139_length_5681_cov_68.065030	4769	4839	302	7	70	0.1000000
NODE_139_length_5681_cov_68.065030	4769	4839	303	3	70	0.0428571
NODE_139_length_5681_cov_68.065030	4769	4839	304	7	70	0.1000000
NODE_139_length_5681_cov_68.065030	4771	4842	231	3	71	0.0422535
NODE_139_length_5681_cov_68.065030	4771	4842	233	1	71	0.0140845
NODE_139_length_5681_cov_68.065030	4771	4842	236	1	71	0.0140845
NODE_139_length_5681_cov_68.065030	4771	4842	238	3	71	0.0422535
NODE_139_length_5681_cov_68.065030	4771	4842	240	2	71	0.0281690
NODE_139_length_5681_cov_68.065030	4771	4842	241	1	71	0.0140845
NODE_139_length_5681_cov_68.065030	4771	4842	269	3	71	0.0422535
NODE_139_length_5681_cov_68.065030	4771	4842	271	1	71	0.0140845
NODE_139_length_5681_cov_68.065030	4771	4842	279	1	71	0.0140845
NODE_139_length_5681_cov_68.065030	4771	4842	286	2	71	0.0281690
NODE_139_length_5681_cov_68.065030	4771	4842	288	6	71	0.0845070
NODE_139_length_5681_cov_68.065030	4771	4842	290	4	71	0.0563380
NODE_139_length_5681_cov_68.065030	4771	4842	294	2	71	0.0281690
NODE_139_length_5681_cov_68.065030	4771	4842	295	3	71	0.0422535
NODE_139_length_5681_cov_68.065030	4771	4842	296	1	71	0.0140845
NODE_139_length_5681_cov_68.065030	4771	4842	298	1	71	0.0140845
NODE_139_length_5681_cov_68.065030	4771	4842	299	7	71	0.0985916
NODE_139_length_5681_cov_68.065030	4771	4842	300	2	71	0.0281690
NODE_139_length_5681_cov_68.065030	4771	4842	301	10	71	0.1408451
NODE_139_length_5681_cov_68.065030	4771	4842	302	7	71	0.0985916
NODE_139_length_5681_cov_68.065030	4771	4842	303	3	71	0.0422535
NODE_139_length_5681_cov_68.065030	4771	4842	304	7	71	0.0985916
NODE_139_length_5681_cov_68.065030	4815	4895	47	7	80	0.0875000
NODE_139_length_5681_cov_68.065030	4815	4895	48	12	80	0.1500000
NODE_139_length_5681_cov_68.065030	4815	4895	50	2	80	0.0250000
NODE_139_length_5681_cov_68.065030	4815	4895	86	1	80	0.0125000
NODE_139_length_5681_cov_68.065030	4815	4895	88	1	80	0.0125000
NODE_139_length_5681_cov_68.065030	4815	4895	132	4	80	0.0500000
NODE_139_length_5681_cov_68.065030	4815	4895	136	2	80	0.0250000
NODE_139_length_5681_cov_68.065030	4815	4895	137	1	80	0.0125000
NODE_139_length_5681_cov_68.065030	4815	4895	140	1	80	0.0125000
NODE_139_length_5681_cov_68.065030	4815	4895	141	1	80	0.0125000
NODE_139_length_5681_cov_68.065030	4815	4895	142	2	80	0.0250000
NODE_139_length_5681_cov_68.065030	4815	4895	146	4	80	0.0500000
NODE_139_length_5681_cov_68.065030	4815	4895	148	1	80	0.0125000
NODE_139_length_5681_cov_68.065030	4815	4895	158	5	80	0.0625000
NODE_139_length_5681_cov_68.065030	4815	4895	186	1	80	0.0125000
NODE_139_length_5681_cov_68.065030	4815	4895	201	3	80	0.0375000
NODE_139_length_5681_cov_68.065030	4815	4895	202	1	80	0.0125000
NODE_139_length_5681_cov_68.065030	4815	4895	205	1	80	0.0125000
NODE_139_length_5681_cov_68.065030	4815	4895	206	1	80	0.0125000
NODE_139_length_5681_cov_68.065030	4815	4895	208	1	80	0.0125000
NODE_139_length_5681_cov_68.065030	4815	4895	231	4	80	0.0500000
NODE_139_length_5681_cov_68.065030	4815	4895	233	1	80	0.0125000
NODE_139_length_5681_cov_68.065030	4815	4895	236	1	80	0.0125000
NODE_139_length_5681_cov_68.065030	4815	4895	238	3	80	0.0375000
NODE_139_length_5681_cov_68.065030	4815	4895	240	2	80	0.0250000
NODE_139_length_5681_cov_68.065030	4815	4895	241	1	80	0.0125000
NODE_139_length_5681_cov_68.065030	4815	4895	269	3	80	0.0375000
NODE_139_length_5681_cov_68.065030	4815	4895	271	1	80	0.0125000
NODE_139_length_5681_cov_68.065030	4815	4895	286	2	80	0.0250000
NODE_139_length_5681_cov_68.065030	4815	4895	288	6	80	0.0750000
NODE_139_length_5681_cov_68.065030	4815	4895	290	4	80	0.0500000
NODE_139_length_5681_cov_68.065030	4815	4895	47	7	80	0.0875000
NODE_139_length_5681_cov_68.065030	4815	4895	48	12	80	0.1500000
NODE_139_length_5681_cov_68.065030	4815	4895	50	2	80	0.0250000
NODE_139_length_5681_cov_68.065030	4815	4895	86	1	80	0.0125000
NODE_139_length_5681_cov_68.065030	4815	4895	88	1	80	0.0125000
NODE_139_length_5681_cov_68.065030	4815	4895	132	4	80	0.0500000
NODE_139_length_5681_cov_68.065030	4815	4895	136	2	80	0.0250000
NODE_139_length_5681_cov_68.065030	4815	4895	137	1	80	0.0125000
NODE_139_length_5681_cov_68.065030	4815	4895	140	1	80	0.0125000
NODE_139_length_5681_cov_68.065030	4815	4895	141	1	80	0.0125000
NODE_139_length_5681_cov_68.065030	4815	4895	142	2	80	0.0250000
NODE_139_length_5681_cov_68.065030	4815	4895	146	4	80	0.0500000
NODE_139_length_5681_cov_68.065030	4815	4895	148	1	80	0.0125000
NODE_139_length_5681_cov_68.065030	4815	4895	158	5	80	0.0625000
NODE_139_length_5681_cov_68.065030	4815	4895	186	1	80	0.0125000
NODE_139_length_5681_cov_68.065030	4815	4895	201	3	80	0.0375000
NODE_139_length_5681_cov_68.065030	4815	4895	202	1	80	0.0125000
NODE_139_length_5681_cov_68.065030	4815	4895	205	1	80	0.0125000
NODE_139_length_5681_cov_68.065030	4815	4895	206	1	80	0.0125000
NODE_139_length_5681_cov_68.065030	4815	4895	208	1	80	0.0125000
NODE_139_length_5681_cov_68.065030	4815	4895	231	4	80	0.0500000
NODE_139_length_5681_cov_68.065030	4815	4895	233	1	80	0.0125000
NODE_139_length_5681_cov_68.065030	4815	4895	236	1	80	0.0125000
NODE_139_length_5681_cov_68.065030	4815	4895	238	3	80	0.0375000
NODE_139_length_5681_cov_68.065030	4815	4895	240	2	80	0.0250000
NODE_139_length_5681_cov_68.065030	4815	4895	241	1	80	0.0125000
NODE_139_length_5681_cov_68.065030	4815	4895	269	3	80	0.0375000
NODE_139_length_5681_cov_68.065030	4815	4895	271	1	80	0.0125000
NODE_139_length_5681_cov_68.065030	4815	4895	286	2	80	0.0250000
NODE_139_length_5681_cov_68.065030	4815	4895	288	6	80	0.0750000
NODE_139_length_5681_cov_68.065030	4815	4895	290	4	80	0.0500000
NODE_139_length_5681_cov_68.065030	4815	4895	47	7	80	0.0875000
NODE_139_length_5681_cov_68.065030	4815	4895	48	12	80	0.1500000
NODE_139_length_5681_cov_68.065030	4815	4895	50	2	80	0.0250000
NODE_139_length_5681_cov_68.065030	4815	4895	86	1	80	0.0125000
NODE_139_length_5681_cov_68.065030	4815	4895	88	1	80	0.0125000
NODE_139_length_5681_cov_68.065030	4815	4895	132	4	80	0.0500000
NODE_139_length_5681_cov_68.065030	4815	4895	136	2	80	0.0250000
NODE_139_length_5681_cov_68.065030	4815	4895	137	1	80	0.0125000
NODE_139_length_5681_cov_68.065030	4815	4895	140	1	80	0.0125000
NODE_139_length_5681_cov_68.065030	4815	4895	141	1	80	0.0125000
NODE_139_length_5681_cov_68.065030	4815	4895	142	2	80	0.0250000
NODE_139_length_5681_cov_68.065030	4815	4895	146	4	80	0.0500000
NODE_139_length_5681_cov_68.065030	4815	4895	148	1	80	0.0125000
NODE_139_length_5681_cov_68.065030	4815	4895	158	5	80	0.0625000
NODE_139_length_5681_cov_68.065030	4815	4895	186	1	80	0.0125000
NODE_139_length_5681_cov_68.065030	4815	4895	201	3	80	0.0375000
NODE_139_length_5681_cov_68.065030	4815	4895	202	1	80	0.0125000
NODE_139_length_5681_cov_68.065030	4815	4895	205	1	80	0.0125000
NODE_139_length_5681_cov_68.065030	4815	4895	206	1	80	0.0125000
NODE_139_length_5681_cov_68.065030	4815	4895	208	1	80	0.0125000
NODE_139_length_5681_cov_68.065030	4815	4895	231	4	80	0.0500000
NODE_139_length_5681_cov_68.065030	4815	4895	233	1	80	0.0125000
NODE_139_length_5681_cov_68.065030	4815	4895	236	1	80	0.0125000
NODE_139_length_5681_cov_68.065030	4815	4895	238	3	80	0.0375000
NODE_139_length_5681_cov_68.065030	4815	4895	240	2	80	0.0250000
NODE_139_length_5681_cov_68.065030	4815	4895	241	1	80	0.0125000
NODE_139_length_5681_cov_68.065030	4815	4895	269	3	80	0.0375000
NODE_139_length_5681_cov_68.065030	4815	4895	271	1	80	0.0125000
NODE_139_length_5681_cov_68.065030	4815	4895	286	2	80	0.0250000
NODE_139_length_5681_cov_68.065030	4815	4895	288	6	80	0.0750000
NODE_139_length_5681_cov_68.065030	4815	4895	290	4	80	0.0500000
NODE_139_length_5681_cov_68.065030	4815	4895	47	7	80	0.0875000
NODE_139_length_5681_cov_68.065030	4815	4895	48	12	80	0.1500000
NODE_139_length_5681_cov_68.065030	4815	4895	50	2	80	0.0250000
NODE_139_length_5681_cov_68.065030	4815	4895	86	1	80	0.0125000
NODE_139_length_5681_cov_68.065030	4815	4895	88	1	80	0.0125000
NODE_139_length_5681_cov_68.065030	4815	4895	132	4	80	0.0500000
NODE_139_length_5681_cov_68.065030	4815	4895	136	2	80	0.0250000
NODE_139_length_5681_cov_68.065030	4815	4895	137	1	80	0.0125000
NODE_139_length_5681_cov_68.065030	4815	4895	140	1	80	0.0125000
NODE_139_length_5681_cov_68.065030	4815	4895	141	1	80	0.0125000
NODE_139_length_5681_cov_68.065030	4815	4895	142	2	80	0.0250000
NODE_139_length_5681_cov_68.065030	4815	4895	146	4	80	0.0500000
NODE_139_length_5681_cov_68.065030	4815	4895	148	1	80	0.0125000
NODE_139_length_5681_cov_68.065030	4815	4895	158	5	80	0.0625000
NODE_139_length_5681_cov_68.065030	4815	4895	186	1	80	0.0125000
NODE_139_length_5681_cov_68.065030	4815	4895	201	3	80	0.0375000
NODE_139_length_5681_cov_68.065030	4815	4895	202	1	80	0.0125000
NODE_139_length_5681_cov_68.065030	4815	4895	205	1	80	0.0125000
NODE_139_length_5681_cov_68.065030	4815	4895	206	1	80	0.0125000
NODE_139_length_5681_cov_68.065030	4815	4895	208	1	80	0.0125000
NODE_139_length_5681_cov_68.065030	4815	4895	231	4	80	0.0500000
NODE_139_length_5681_cov_68.065030	4815	4895	233	1	80	0.0125000
NODE_139_length_5681_cov_68.065030	4815	4895	236	1	80	0.0125000
NODE_139_length_5681_cov_68.065030	4815	4895	238	3	80	0.0375000
NODE_139_length_5681_cov_68.065030	4815	4895	240	2	80	0.0250000
NODE_139_length_5681_cov_68.065030	4815	4895	241	1	80	0.0125000
NODE_139_length_5681_cov_68.065030	4815	4895	269	3	80	0.0375000
NODE_139_length_5681_cov_68.065030	4815	4895	271	1	80	0.0125000
NODE_139_length_5681_cov_68.065030	4815	4895	286	2	80	0.0250000
NODE_139_length_5681_cov_68.065030	4815	4895	288	6	80	0.0750000
NODE_139_length_5681_cov_68.065030	4815	4895	290	4	80	0.0500000
NODE_139_length_5681_cov_68.065030	4815	4895	47	7	80	0.0875000
NODE_139_length_5681_cov_68.065030	4815	4895	48	12	80	0.1500000
NODE_139_length_5681_cov_68.065030	4815	4895	50	2	80	0.0250000
NODE_139_length_5681_cov_68.065030	4815	4895	86	1	80	0.0125000
NODE_139_length_5681_cov_68.065030	4815	4895	88	1	80	0.0125000
NODE_139_length_5681_cov_68.065030	4815	4895	132	4	80	0.0500000
NODE_139_length_5681_cov_68.065030	4815	4895	136	2	80	0.0250000
NODE_139_length_5681_cov_68.065030	4815	4895	137	1	80	0.0125000
NODE_139_length_5681_cov_68.065030	4815	4895	140	1	80	0.0125000
NODE_139_length_5681_cov_68.065030	4815	4895	141	1	80	0.0125000
NODE_139_length_5681_cov_68.065030	4815	4895	142	2	80	0.0250000
NODE_139_length_5681_cov_68.065030	4815	4895	146	4	80	0.0500000
NODE_139_length_5681_cov_68.065030	4815	4895	148	1	80	0.0125000
NODE_139_length_5681_cov_68.065030	4815	4895	158	5	80	0.0625000
NODE_139_length_5681_cov_68.065030	4815	4895	186	1	80	0.0125000
NODE_139_length_5681_cov_68.065030	4815	4895	201	3	80	0.0375000
NODE_139_length_5681_cov_68.065030	4815	4895	202	1	80	0.0125000
NODE_139_length_5681_cov_68.065030	4815	4895	205	1	80	0.0125000
NODE_139_length_5681_cov_68.065030	4815	4895	206	1	80	0.0125000
NODE_139_length_5681_cov_68.065030	4815	4895	208	1	80	0.0125000
NODE_139_length_5681_cov_68.065030	4815	4895	231	4	80	0.0500000
NODE_139_length_5681_cov_68.065030	4815	4895	233	1	80	0.0125000
NODE_139_length_5681_cov_68.065030	4815	4895	236	1	80	0.0125000
NODE_139_length_5681_cov_68.065030	4815	4895	238	3	80	0.0375000
NODE_139_length_5681_cov_68.065030	4815	4895	240	2	80	0.0250000
NODE_139_length_5681_cov_68.065030	4815	4895	241	1	80	0.0125000
NODE_139_length_5681_cov_68.065030	4815	4895	269	3	80	0.0375000
NODE_139_length_5681_cov_68.065030	4815	4895	271	1	80	0.0125000
NODE_139_length_5681_cov_68.065030	4815	4895	286	2	80	0.0250000
NODE_139_length_5681_cov_68.065030	4815	4895	288	6	80	0.0750000
NODE_139_length_5681_cov_68.065030	4815	4895	290	4	80	0.0500000
NODE_139_length_5681_cov_68.065030	4815	4895	47	7	80	0.0875000
NODE_139_length_5681_cov_68.065030	4815	4895	48	12	80	0.1500000
NODE_139_length_5681_cov_68.065030	4815	4895	50	2	80	0.0250000
NODE_139_length_5681_cov_68.065030	4815	4895	86	1	80	0.0125000
NODE_139_length_5681_cov_68.065030	4815	4895	88	1	80	0.0125000
NODE_139_length_5681_cov_68.065030	4815	4895	132	4	80	0.0500000
NODE_139_length_5681_cov_68.065030	4815	4895	136	2	80	0.0250000
NODE_139_length_5681_cov_68.065030	4815	4895	137	1	80	0.0125000
NODE_139_length_5681_cov_68.065030	4815	4895	140	1	80	0.0125000
NODE_139_length_5681_cov_68.065030	4815	4895	141	1	80	0.0125000
NODE_139_length_5681_cov_68.065030	4815	4895	142	2	80	0.0250000
NODE_139_length_5681_cov_68.065030	4815	4895	146	4	80	0.0500000
NODE_139_length_5681_cov_68.065030	4815	4895	148	1	80	0.0125000
NODE_139_length_5681_cov_68.065030	4815	4895	158	5	80	0.0625000
NODE_139_length_5681_cov_68.065030	4815	4895	186	1	80	0.0125000
NODE_139_length_5681_cov_68.065030	4815	4895	201	3	80	0.0375000
NODE_139_length_5681_cov_68.065030	4815	4895	202	1	80	0.0125000
NODE_139_length_5681_cov_68.065030	4815	4895	205	1	80	0.0125000
NODE_139_length_5681_cov_68.065030	4815	4895	206	1	80	0.0125000
NODE_139_length_5681_cov_68.065030	4815	4895	208	1	80	0.0125000
NODE_139_length_5681_cov_68.065030	4815	4895	231	4	80	0.0500000
NODE_139_length_5681_cov_68.065030	4815	4895	233	1	80	0.0125000
NODE_139_length_5681_cov_68.065030	4815	4895	236	1	80	0.0125000
NODE_139_length_5681_cov_68.065030	4815	4895	238	3	80	0.0375000
NODE_139_length_5681_cov_68.065030	4815	4895	240	2	80	0.0250000
NODE_139_length_5681_cov_68.065030	4815	4895	241	1	80	0.0125000
NODE_139_length_5681_cov_68.065030	4815	4895	269	3	80	0.0375000
NODE_139_length_5681_cov_68.065030	4815	4895	271	1	80	0.0125000
NODE_139_length_5681_cov_68.065030	4815	4895	286	2	80	0.0250000
NODE_139_length_5681_cov_68.065030	4815	4895	288	6	80	0.0750000
NODE_139_length_5681_cov_68.065030	4815	4895	290	4	80	0.0500000
NODE_139_length_5681_cov_68.065030	4891	4971	14	22	80	0.2750000
NODE_139_length_5681_cov_68.065030	4891	4971	15	28	80	0.3500000
NODE_139_length_5681_cov_68.065030	4891	4971	17	13	80	0.1625000
NODE_139_length_5681_cov_68.065030	4891	4971	21	5	80	0.0625000
NODE_139_length_5681_cov_68.065030	4891	4971	22	2	80	0.0250000
NODE_139_length_5681_cov_68.065030	4891	4971	41	1	80	0.0125000
NODE_139_length_5681_cov_68.065030	4891	4971	47	9	80	0.1125000
NODE_139_length_5681_cov_68.065030	4944	5007	10	12	63	0.1904762
NODE_139_length_5681_cov_68.065030	4944	5007	14	5	63	0.0793651
NODE_139_length_5681_cov_68.065030	4944	5007	15	34	63	0.5396826
NODE_139_length_5681_cov_68.065030	4944	5007	16	1	63	0.0158730
NODE_139_length_5681_cov_68.065030	4944	5007	17	11	63	0.1746032
NODE_139_length_5681_cov_68.065030	4944	5024	10	29	80	0.3625000
NODE_139_length_5681_cov_68.065030	4944	5024	14	5	80	0.0625000
NODE_139_length_5681_cov_68.065030	4944	5024	15	34	80	0.4250000
NODE_139_length_5681_cov_68.065030	4944	5024	16	1	80	0.0125000
NODE_139_length_5681_cov_68.065030	4944	5024	17	11	80	0.1375000
NODE_140_length_5677_cov_21.613482	1792	1863	46	3	71	0.0422535
NODE_140_length_5677_cov_21.613482	1792	1863	48	5	71	0.0704225
NODE_140_length_5677_cov_21.613482	1792	1863	50	6	71	0.0845070
NODE_140_length_5677_cov_21.613482	1792	1863	51	3	71	0.0422535
NODE_140_length_5677_cov_21.613482	1792	1863	53	1	71	0.0140845
NODE_140_length_5677_cov_21.613482	1792	1863	54	2	71	0.0281690
NODE_140_length_5677_cov_21.613482	1792	1863	57	2	71	0.0281690
NODE_140_length_5677_cov_21.613482	1792	1863	58	6	71	0.0845070
NODE_140_length_5677_cov_21.613482	1792	1863	59	2	71	0.0281690
NODE_140_length_5677_cov_21.613482	1792	1863	60	14	71	0.1971831
NODE_140_length_5677_cov_21.613482	1792	1863	61	6	71	0.0845070
NODE_140_length_5677_cov_21.613482	1792	1863	62	1	71	0.0140845
NODE_140_length_5677_cov_21.613482	1792	1863	63	1	71	0.0140845
NODE_140_length_5677_cov_21.613482	1792	1863	64	2	71	0.0281690
NODE_140_length_5677_cov_21.613482	1792	1863	65	8	71	0.1126761
NODE_140_length_5677_cov_21.613482	1792	1863	66	1	71	0.0140845
NODE_140_length_5677_cov_21.613482	1792	1863	68	8	71	0.1126761
NODE_140_length_5677_cov_21.613482	1845	1916	39	1	71	0.0140845
NODE_140_length_5677_cov_21.613482	1845	1916	41	9	71	0.1267606
NODE_140_length_5677_cov_21.613482	1845	1916	43	6	71	0.0845070
NODE_140_length_5677_cov_21.613482	1845	1916	47	2	71	0.0281690
NODE_140_length_5677_cov_21.613482	1845	1916	51	4	71	0.0563380
NODE_140_length_5677_cov_21.613482	1845	1916	53	1	71	0.0140845
NODE_140_length_5677_cov_21.613482	1845	1916	55	5	71	0.0704225
NODE_140_length_5677_cov_21.613482	1845	1916	57	8	71	0.1126761
NODE_140_length_5677_cov_21.613482	1845	1916	58	5	71	0.0704225
NODE_140_length_5677_cov_21.613482	1845	1916	59	10	71	0.1408451
NODE_140_length_5677_cov_21.613482	1845	1916	60	1	71	0.0140845
NODE_140_length_5677_cov_21.613482	1845	1916	61	7	71	0.0985916
NODE_140_length_5677_cov_21.613482	1845	1916	63	1	71	0.0140845
NODE_140_length_5677_cov_21.613482	1845	1916	65	8	71	0.1126761
NODE_140_length_5677_cov_21.613482	1845	1916	66	1	71	0.0140845
NODE_140_length_5677_cov_21.613482	1845	1916	68	2	71	0.0281690
NODE_142_length_5631_cov_25.927332	96	176	4	11	80	0.1375000
NODE_142_length_5631_cov_25.927332	96	176	6	32	80	0.4000000
NODE_142_length_5631_cov_25.927332	96	176	8	8	80	0.1000000
NODE_142_length_5631_cov_25.927332	96	176	10	29	80	0.3625000
NODE_142_length_5631_cov_25.927332	149	229	6	12	80	0.1500000
NODE_142_length_5631_cov_25.927332	149	229	8	13	80	0.1625000
NODE_142_length_5631_cov_25.927332	149	229	10	32	80	0.4000000
NODE_142_length_5631_cov_25.927332	149	229	12	6	80	0.0750000
NODE_142_length_5631_cov_25.927332	149	229	14	17	80	0.2125000
NODE_146_length_5588_cov_40.961377	2793	2873	0	80	80	1.0000000
NODE_146_length_5588_cov_40.961377	2846	2926	0	80	80	1.0000000
NODE_146_length_5588_cov_40.961377	2922	3002	0	80	80	1.0000000
NODE_146_length_5588_cov_40.961377	2975	3055	0	31	80	0.3875000
NODE_146_length_5588_cov_40.961377	2975	3055	4	22	80	0.2750000
NODE_146_length_5588_cov_40.961377	2975	3055	8	27	80	0.3375000
NODE_149_length_5578_cov_5.173389	331	411	0	61	80	0.7625000
NODE_149_length_5578_cov_5.173389	331	411	2	19	80	0.2375000
NODE_149_length_5578_cov_5.173389	388	464	0	4	76	0.0526316
NODE_149_length_5578_cov_5.173389	388	464	2	72	76	0.9473684
NODE_150_length_5572_cov_79.124246	1555	1627	38	3	72	0.0416667
NODE_150_length_5572_cov_79.124246	1555	1627	39	3	72	0.0416667
NODE_150_length_5572_cov_79.124246	1555	1627	40	2	72	0.0277778
NODE_150_length_5572_cov_79.124246	1555	1627	42	3	72	0.0416667
NODE_150_length_5572_cov_79.124246	1555	1627	44	1	72	0.0138889
NODE_150_length_5572_cov_79.124246	1555	1627	47	2	72	0.0277778
NODE_150_length_5572_cov_79.124246	1555	1627	48	1	72	0.0138889
NODE_150_length_5572_cov_79.124246	1555	1627	49	4	72	0.0555556
NODE_150_length_5572_cov_79.124246	1555	1627	52	1	72	0.0138889
NODE_150_length_5572_cov_79.124246	1555	1627	53	7	72	0.0972222
NODE_150_length_5572_cov_79.124246	1555	1627	54	1	72	0.0138889
NODE_150_length_5572_cov_79.124246	1555	1627	55	1	72	0.0138889
NODE_150_length_5572_cov_79.124246	1555	1627	56	1	72	0.0138889
NODE_150_length_5572_cov_79.124246	1555	1627	57	3	72	0.0416667
NODE_150_length_5572_cov_79.124246	1555	1627	58	2	72	0.0277778
NODE_150_length_5572_cov_79.124246	1555	1627	68	2	72	0.0277778
NODE_150_length_5572_cov_79.124246	1555	1627	69	1	72	0.0138889
NODE_150_length_5572_cov_79.124246	1555	1627	70	1	72	0.0138889
NODE_150_length_5572_cov_79.124246	1555	1627	89	1	72	0.0138889
NODE_150_length_5572_cov_79.124246	1555	1627	100	1	72	0.0138889
NODE_150_length_5572_cov_79.124246	1555	1627	101	2	72	0.0277778
NODE_150_length_5572_cov_79.124246	1555	1627	108	1	72	0.0138889
NODE_150_length_5572_cov_79.124246	1555	1627	112	1	72	0.0138889
NODE_150_length_5572_cov_79.124246	1555	1627	114	1	72	0.0138889
NODE_150_length_5572_cov_79.124246	1555	1627	119	1	72	0.0138889
NODE_150_length_5572_cov_79.124246	1555	1627	121	1	72	0.0138889
NODE_150_length_5572_cov_79.124246	1555	1627	123	2	72	0.0277778
NODE_150_length_5572_cov_79.124246	1555	1627	130	1	72	0.0138889
NODE_150_length_5572_cov_79.124246	1555	1627	134	1	72	0.0138889
NODE_150_length_5572_cov_79.124246	1555	1627	139	1	72	0.0138889
NODE_150_length_5572_cov_79.124246	1555	1627	151	1	72	0.0138889
NODE_150_length_5572_cov_79.124246	1555	1627	159	1	72	0.0138889
NODE_150_length_5572_cov_79.124246	1555	1627	167	1	72	0.0138889
NODE_150_length_5572_cov_79.124246	1555	1627	176	1	72	0.0138889
NODE_150_length_5572_cov_79.124246	1555	1627	180	1	72	0.0138889
NODE_150_length_5572_cov_79.124246	1555	1627	199	1	72	0.0138889
NODE_150_length_5572_cov_79.124246	1555	1627	214	1	72	0.0138889
NODE_150_length_5572_cov_79.124246	1555	1627	218	1	72	0.0138889
NODE_150_length_5572_cov_79.124246	1555	1627	219	1	72	0.0138889
NODE_150_length_5572_cov_79.124246	1555	1627	222	1	72	0.0138889
NODE_150_length_5572_cov_79.124246	1555	1627	229	1	72	0.0138889
NODE_150_length_5572_cov_79.124246	1555	1627	235	1	72	0.0138889
NODE_150_length_5572_cov_79.124246	1555	1627	236	1	72	0.0138889
NODE_150_length_5572_cov_79.124246	1555	1627	239	1	72	0.0138889
NODE_150_length_5572_cov_79.124246	1555	1627	243	1	72	0.0138889
NODE_150_length_5572_cov_79.124246	1555	1627	248	1	72	0.0138889
NODE_150_length_5572_cov_79.124246	1555	1627	258	1	72	0.0138889
NODE_150_length_5572_cov_79.124246	1555	1627	265	1	72	0.0138889
NODE_150_length_5572_cov_79.124246	1555	1627	270	1	72	0.0138889
NODE_150_length_5572_cov_79.124246	1603	1680	123	2	77	0.0259740
NODE_150_length_5572_cov_79.124246	1603	1680	130	1	77	0.0129870
NODE_150_length_5572_cov_79.124246	1603	1680	134	1	77	0.0129870
NODE_150_length_5572_cov_79.124246	1603	1680	139	1	77	0.0129870
NODE_150_length_5572_cov_79.124246	1603	1680	151	1	77	0.0129870
NODE_150_length_5572_cov_79.124246	1603	1680	159	1	77	0.0129870
NODE_150_length_5572_cov_79.124246	1603	1680	167	1	77	0.0129870
NODE_150_length_5572_cov_79.124246	1603	1680	176	1	77	0.0129870
NODE_150_length_5572_cov_79.124246	1603	1680	180	1	77	0.0129870
NODE_150_length_5572_cov_79.124246	1603	1680	199	1	77	0.0129870
NODE_150_length_5572_cov_79.124246	1603	1680	214	1	77	0.0129870
NODE_150_length_5572_cov_79.124246	1603	1680	218	1	77	0.0129870
NODE_150_length_5572_cov_79.124246	1603	1680	219	1	77	0.0129870
NODE_150_length_5572_cov_79.124246	1603	1680	222	1	77	0.0129870
NODE_150_length_5572_cov_79.124246	1603	1680	229	1	77	0.0129870
NODE_150_length_5572_cov_79.124246	1603	1680	235	1	77	0.0129870
NODE_150_length_5572_cov_79.124246	1603	1680	236	1	77	0.0129870
NODE_150_length_5572_cov_79.124246	1603	1680	239	1	77	0.0129870
NODE_150_length_5572_cov_79.124246	1603	1680	243	1	77	0.0129870
NODE_150_length_5572_cov_79.124246	1603	1680	248	1	77	0.0129870
NODE_150_length_5572_cov_79.124246	1603	1680	258	1	77	0.0129870
NODE_150_length_5572_cov_79.124246	1603	1680	265	1	77	0.0129870
NODE_150_length_5572_cov_79.124246	1603	1680	270	1	77	0.0129870
NODE_150_length_5572_cov_79.124246	1603	1680	272	1	77	0.0129870
NODE_150_length_5572_cov_79.124246	1603	1680	273	1	77	0.0129870
NODE_150_length_5572_cov_79.124246	1603	1680	275	1	77	0.0129870
NODE_150_length_5572_cov_79.124246	1603	1680	294	1	77	0.0129870
NODE_150_length_5572_cov_79.124246	1603	1680	298	1	77	0.0129870
NODE_150_length_5572_cov_79.124246	1603	1680	305	1	77	0.0129870
NODE_150_length_5572_cov_79.124246	1603	1680	322	1	77	0.0129870
NODE_150_length_5572_cov_79.124246	1603	1680	327	1	77	0.0129870
NODE_150_length_5572_cov_79.124246	1603	1680	333	1	77	0.0129870
NODE_150_length_5572_cov_79.124246	1603	1680	345	1	77	0.0129870
NODE_150_length_5572_cov_79.124246	1603	1680	365	1	77	0.0129870
NODE_150_length_5572_cov_79.124246	1603	1680	369	1	77	0.0129870
NODE_150_length_5572_cov_79.124246	1603	1680	382	2	77	0.0259740
NODE_150_length_5572_cov_79.124246	1603	1680	394	1	77	0.0129870
NODE_150_length_5572_cov_79.124246	1603	1680	401	1	77	0.0129870
NODE_150_length_5572_cov_79.124246	1603	1680	415	1	77	0.0129870
NODE_150_length_5572_cov_79.124246	1603	1680	418	1	77	0.0129870
NODE_150_length_5572_cov_79.124246	1603	1680	439	1	77	0.0129870
NODE_150_length_5572_cov_79.124246	1603	1680	455	1	77	0.0129870
NODE_150_length_5572_cov_79.124246	1603	1680	506	1	77	0.0129870
NODE_150_length_5572_cov_79.124246	1603	1680	517	1	77	0.0129870
NODE_150_length_5572_cov_79.124246	1603	1680	528	1	77	0.0129870
NODE_150_length_5572_cov_79.124246	1603	1680	535	1	77	0.0129870
NODE_150_length_5572_cov_79.124246	1603	1680	554	1	77	0.0129870
NODE_150_length_5572_cov_79.124246	1603	1680	562	1	77	0.0129870
NODE_150_length_5572_cov_79.124246	1603	1680	573	1	77	0.0129870
NODE_150_length_5572_cov_79.124246	1603	1680	576	1	77	0.0129870
NODE_150_length_5572_cov_79.124246	1603	1680	607	1	77	0.0129870
NODE_150_length_5572_cov_79.124246	1603	1680	610	2	77	0.0259740
NODE_150_length_5572_cov_79.124246	1603	1680	616	1	77	0.0129870
NODE_150_length_5572_cov_79.124246	1603	1680	621	1	77	0.0129870
NODE_150_length_5572_cov_79.124246	1603	1680	631	1	77	0.0129870
NODE_150_length_5572_cov_79.124246	1603	1680	637	1	77	0.0129870
NODE_150_length_5572_cov_79.124246	1603	1680	665	2	77	0.0259740
NODE_150_length_5572_cov_79.124246	1603	1680	676	2	77	0.0259740
NODE_150_length_5572_cov_79.124246	1603	1680	702	1	77	0.0129870
NODE_150_length_5572_cov_79.124246	1603	1680	707	1	77	0.0129870
NODE_150_length_5572_cov_79.124246	1603	1680	716	1	77	0.0129870
NODE_150_length_5572_cov_79.124246	1603	1680	718	1	77	0.0129870
NODE_150_length_5572_cov_79.124246	1603	1680	723	1	77	0.0129870
NODE_150_length_5572_cov_79.124246	1603	1680	729	1	77	0.0129870
NODE_150_length_5572_cov_79.124246	1603	1680	737	1	77	0.0129870
NODE_150_length_5572_cov_79.124246	1603	1680	741	1	77	0.0129870
NODE_150_length_5572_cov_79.124246	1603	1680	773	1	77	0.0129870
NODE_150_length_5572_cov_79.124246	1603	1680	798	1	77	0.0129870
NODE_150_length_5572_cov_79.124246	1603	1680	811	1	77	0.0129870
NODE_150_length_5572_cov_79.124246	1603	1680	822	1	77	0.0129870
NODE_150_length_5572_cov_79.124246	1603	1680	835	1	77	0.0129870
NODE_150_length_5572_cov_79.124246	1603	1680	847	1	77	0.0129870
NODE_150_length_5572_cov_79.124246	1637	1717	365	1	80	0.0125000
NODE_150_length_5572_cov_79.124246	1637	1717	369	1	80	0.0125000
NODE_150_length_5572_cov_79.124246	1637	1717	382	2	80	0.0250000
NODE_150_length_5572_cov_79.124246	1637	1717	394	1	80	0.0125000
NODE_150_length_5572_cov_79.124246	1637	1717	401	1	80	0.0125000
NODE_150_length_5572_cov_79.124246	1637	1717	415	1	80	0.0125000
NODE_150_length_5572_cov_79.124246	1637	1717	418	1	80	0.0125000
NODE_150_length_5572_cov_79.124246	1637	1717	439	1	80	0.0125000
NODE_150_length_5572_cov_79.124246	1637	1717	455	1	80	0.0125000
NODE_150_length_5572_cov_79.124246	1637	1717	506	1	80	0.0125000
NODE_150_length_5572_cov_79.124246	1637	1717	517	1	80	0.0125000
NODE_150_length_5572_cov_79.124246	1637	1717	528	1	80	0.0125000
NODE_150_length_5572_cov_79.124246	1637	1717	535	1	80	0.0125000
NODE_150_length_5572_cov_79.124246	1637	1717	554	1	80	0.0125000
NODE_150_length_5572_cov_79.124246	1637	1717	562	1	80	0.0125000
NODE_150_length_5572_cov_79.124246	1637	1717	573	1	80	0.0125000
NODE_150_length_5572_cov_79.124246	1637	1717	576	1	80	0.0125000
NODE_150_length_5572_cov_79.124246	1637	1717	607	1	80	0.0125000
NODE_150_length_5572_cov_79.124246	1637	1717	610	2	80	0.0250000
NODE_150_length_5572_cov_79.124246	1637	1717	616	1	80	0.0125000
NODE_150_length_5572_cov_79.124246	1637	1717	621	1	80	0.0125000
NODE_150_length_5572_cov_79.124246	1637	1717	631	1	80	0.0125000
NODE_150_length_5572_cov_79.124246	1637	1717	637	1	80	0.0125000
NODE_150_length_5572_cov_79.124246	1637	1717	665	2	80	0.0250000
NODE_150_length_5572_cov_79.124246	1637	1717	676	2	80	0.0250000
NODE_150_length_5572_cov_79.124246	1637	1717	702	1	80	0.0125000
NODE_150_length_5572_cov_79.124246	1637	1717	707	1	80	0.0125000
NODE_150_length_5572_cov_79.124246	1637	1717	716	1	80	0.0125000
NODE_150_length_5572_cov_79.124246	1637	1717	718	1	80	0.0125000
NODE_150_length_5572_cov_79.124246	1637	1717	723	1	80	0.0125000
NODE_150_length_5572_cov_79.124246	1637	1717	729	1	80	0.0125000
NODE_150_length_5572_cov_79.124246	1637	1717	737	1	80	0.0125000
NODE_150_length_5572_cov_79.124246	1637	1717	741	1	80	0.0125000
NODE_150_length_5572_cov_79.124246	1637	1717	773	1	80	0.0125000
NODE_150_length_5572_cov_79.124246	1637	1717	798	1	80	0.0125000
NODE_150_length_5572_cov_79.124246	1637	1717	811	1	80	0.0125000
NODE_150_length_5572_cov_79.124246	1637	1717	822	1	80	0.0125000
NODE_150_length_5572_cov_79.124246	1637	1717	835	1	80	0.0125000
NODE_150_length_5572_cov_79.124246	1637	1717	845	1	80	0.0125000
NODE_150_length_5572_cov_79.124246	1637	1717	847	1	80	0.0125000
NODE_150_length_5572_cov_79.124246	1637	1717	853	1	80	0.0125000
NODE_150_length_5572_cov_79.124246	1637	1717	865	1	80	0.0125000
NODE_150_length_5572_cov_79.124246	1637	1717	878	1	80	0.0125000
NODE_150_length_5572_cov_79.124246	1637	1717	880	2	80	0.0250000
NODE_150_length_5572_cov_79.124246	1637	1717	882	1	80	0.0125000
NODE_150_length_5572_cov_79.124246	1637	1717	888	1	80	0.0125000
NODE_150_length_5572_cov_79.124246	1637	1717	917	1	80	0.0125000
NODE_150_length_5572_cov_79.124246	1637	1717	928	1	80	0.0125000
NODE_150_length_5572_cov_79.124246	1637	1717	935	1	80	0.0125000
NODE_150_length_5572_cov_79.124246	1637	1717	940	1	80	0.0125000
NODE_150_length_5572_cov_79.124246	1637	1717	941	1	80	0.0125000
NODE_150_length_5572_cov_79.124246	1637	1717	946	1	80	0.0125000
NODE_150_length_5572_cov_79.124246	1637	1717	947	1	80	0.0125000
NODE_150_length_5572_cov_79.124246	1637	1717	948	1	80	0.0125000
NODE_150_length_5572_cov_79.124246	1637	1717	949	1	80	0.0125000
NODE_150_length_5572_cov_79.124246	1637	1717	966	1	80	0.0125000
NODE_150_length_5572_cov_79.124246	1637	1717	974	1	80	0.0125000
NODE_150_length_5572_cov_79.124246	1637	1717	978	1	80	0.0125000
NODE_150_length_5572_cov_79.124246	1637	1717	982	1	80	0.0125000
NODE_150_length_5572_cov_79.124246	1637	1717	985	1	80	0.0125000
NODE_150_length_5572_cov_79.124246	1637	1717	986	1	80	0.0125000
NODE_150_length_5572_cov_79.124246	1637	1717	987	1	80	0.0125000
NODE_150_length_5572_cov_79.124246	1637	1717	988	1	80	0.0125000
NODE_150_length_5572_cov_79.124246	1637	1717	990	3	80	0.0375000
NODE_150_length_5572_cov_79.124246	1637	1717	992	3	80	0.0375000
NODE_150_length_5572_cov_79.124246	1637	1717	993	1	80	0.0125000
NODE_150_length_5572_cov_79.124246	1637	1717	996	1	80	0.0125000
NODE_150_length_5572_cov_79.124246	1637	1717	999	2	80	0.0250000
NODE_150_length_5572_cov_79.124246	1637	1717	1001	1	80	0.0125000
NODE_150_length_5572_cov_79.124246	1637	1717	1003	1	80	0.0125000
NODE_150_length_5572_cov_79.124246	1690	1770	566	1	80	0.0125000
NODE_150_length_5572_cov_79.124246	1690	1770	576	1	80	0.0125000
NODE_150_length_5572_cov_79.124246	1690	1770	598	1	80	0.0125000
NODE_150_length_5572_cov_79.124246	1690	1770	616	1	80	0.0125000
NODE_150_length_5572_cov_79.124246	1690	1770	643	1	80	0.0125000
NODE_150_length_5572_cov_79.124246	1690	1770	655	1	80	0.0125000
NODE_150_length_5572_cov_79.124246	1690	1770	659	1	80	0.0125000
NODE_150_length_5572_cov_79.124246	1690	1770	679	2	80	0.0250000
NODE_150_length_5572_cov_79.124246	1690	1770	693	1	80	0.0125000
NODE_150_length_5572_cov_79.124246	1690	1770	711	1	80	0.0125000
NODE_150_length_5572_cov_79.124246	1690	1770	720	1	80	0.0125000
NODE_150_length_5572_cov_79.124246	1690	1770	733	1	80	0.0125000
NODE_150_length_5572_cov_79.124246	1690	1770	755	1	80	0.0125000
NODE_150_length_5572_cov_79.124246	1690	1770	775	1	80	0.0125000
NODE_150_length_5572_cov_79.124246	1690	1770	789	1	80	0.0125000
NODE_150_length_5572_cov_79.124246	1690	1770	799	1	80	0.0125000
NODE_150_length_5572_cov_79.124246	1690	1770	805	1	80	0.0125000
NODE_150_length_5572_cov_79.124246	1690	1770	812	1	80	0.0125000
NODE_150_length_5572_cov_79.124246	1690	1770	816	1	80	0.0125000
NODE_150_length_5572_cov_79.124246	1690	1770	822	2	80	0.0250000
NODE_150_length_5572_cov_79.124246	1690	1770	831	1	80	0.0125000
NODE_150_length_5572_cov_79.124246	1690	1770	850	2	80	0.0250000
NODE_150_length_5572_cov_79.124246	1690	1770	855	1	80	0.0125000
NODE_150_length_5572_cov_79.124246	1690	1770	871	1	80	0.0125000
NODE_150_length_5572_cov_79.124246	1690	1770	877	2	80	0.0250000
NODE_150_length_5572_cov_79.124246	1690	1770	890	2	80	0.0250000
NODE_150_length_5572_cov_79.124246	1690	1770	900	1	80	0.0125000
NODE_150_length_5572_cov_79.124246	1690	1770	904	1	80	0.0125000
NODE_150_length_5572_cov_79.124246	1690	1770	906	1	80	0.0125000
NODE_150_length_5572_cov_79.124246	1690	1770	922	1	80	0.0125000
NODE_150_length_5572_cov_79.124246	1690	1770	935	1	80	0.0125000
NODE_150_length_5572_cov_79.124246	1690	1770	940	2	80	0.0250000
NODE_150_length_5572_cov_79.124246	1690	1770	941	1	80	0.0125000
NODE_150_length_5572_cov_79.124246	1690	1770	944	1	80	0.0125000
NODE_150_length_5572_cov_79.124246	1690	1770	946	1	80	0.0125000
NODE_150_length_5572_cov_79.124246	1690	1770	947	1	80	0.0125000
NODE_150_length_5572_cov_79.124246	1690	1770	948	1	80	0.0125000
NODE_150_length_5572_cov_79.124246	1690	1770	949	1	80	0.0125000
NODE_150_length_5572_cov_79.124246	1690	1770	954	1	80	0.0125000
NODE_150_length_5572_cov_79.124246	1690	1770	958	1	80	0.0125000
NODE_150_length_5572_cov_79.124246	1690	1770	960	2	80	0.0250000
NODE_150_length_5572_cov_79.124246	1690	1770	965	1	80	0.0125000
NODE_150_length_5572_cov_79.124246	1690	1770	966	1	80	0.0125000
NODE_150_length_5572_cov_79.124246	1690	1770	974	2	80	0.0250000
NODE_150_length_5572_cov_79.124246	1690	1770	977	1	80	0.0125000
NODE_150_length_5572_cov_79.124246	1690	1770	978	1	80	0.0125000
NODE_150_length_5572_cov_79.124246	1690	1770	982	1	80	0.0125000
NODE_150_length_5572_cov_79.124246	1690	1770	984	2	80	0.0250000
NODE_150_length_5572_cov_79.124246	1690	1770	985	2	80	0.0250000
NODE_150_length_5572_cov_79.124246	1690	1770	986	4	80	0.0500000
NODE_150_length_5572_cov_79.124246	1690	1770	987	2	80	0.0250000
NODE_150_length_5572_cov_79.124246	1690	1770	988	3	80	0.0375000
NODE_150_length_5572_cov_79.124246	1690	1770	990	3	80	0.0375000
NODE_150_length_5572_cov_79.124246	1690	1770	992	3	80	0.0375000
NODE_150_length_5572_cov_79.124246	1690	1770	993	1	80	0.0125000
NODE_150_length_5572_cov_79.124246	1690	1770	996	1	80	0.0125000
NODE_150_length_5572_cov_79.124246	1690	1770	999	2	80	0.0250000
NODE_150_length_5572_cov_79.124246	1690	1770	1001	1	80	0.0125000
NODE_150_length_5572_cov_79.124246	1690	1770	1003	1	80	0.0125000
NODE_150_length_5572_cov_79.124246	5130	5210	0	60	80	0.7500000
NODE_150_length_5572_cov_79.124246	5130	5210	2	20	80	0.2500000
NODE_150_length_5572_cov_79.124246	5183	5263	0	7	80	0.0875000
NODE_150_length_5572_cov_79.124246	5183	5263	2	73	80	0.9125000
NODE_151_length_5557_cov_26.198241	341	414	0	73	73	1.0000000
NODE_151_length_5557_cov_26.198241	394	460	0	66	66	1.0000000
NODE_156_length_5500_cov_35.832438	81	161	0	18	80	0.2250000
NODE_156_length_5500_cov_35.832438	81	161	2	62	80	0.7750000
NODE_156_length_5500_cov_35.832438	134	214	0	51	80	0.6375000
NODE_156_length_5500_cov_35.832438	134	214	2	29	80	0.3625000
NODE_159_length_5470_cov_5.987526	5180	5249	0	69	69	1.0000000
NODE_160_length_5434_cov_14.997751	541	621	0	80	80	1.0000000
NODE_160_length_5434_cov_14.997751	594	674	0	80	80	1.0000000
NODE_160_length_5434_cov_14.997751	2664	2744	0	80	80	1.0000000
NODE_160_length_5434_cov_14.997751	2717	2797	0	80	80	1.0000000
NODE_160_length_5434_cov_14.997751	3041	3093	0	52	52	1.0000000
NODE_160_length_5434_cov_14.997751	3419	3467	8	48	48	1.0000000
NODE_161_length_5425_cov_15.812242	141	218	6	7	77	0.0909091
NODE_161_length_5425_cov_15.812242	141	218	12	3	77	0.0389610
NODE_161_length_5425_cov_15.812242	141	218	16	1	77	0.0129870
NODE_161_length_5425_cov_15.812242	141	218	18	4	77	0.0519481
NODE_161_length_5425_cov_15.812242	141	218	19	3	77	0.0389610
NODE_161_length_5425_cov_15.812242	141	218	25	2	77	0.0259740
NODE_161_length_5425_cov_15.812242	141	218	27	6	77	0.0779221
NODE_161_length_5425_cov_15.812242	141	218	31	1	77	0.0129870
NODE_161_length_5425_cov_15.812242	141	218	32	4	77	0.0519481
NODE_161_length_5425_cov_15.812242	141	218	35	1	77	0.0129870
NODE_161_length_5425_cov_15.812242	141	218	36	3	77	0.0389610
NODE_161_length_5425_cov_15.812242	141	218	37	1	77	0.0129870
NODE_161_length_5425_cov_15.812242	141	218	39	3	77	0.0389610
NODE_161_length_5425_cov_15.812242	141	218	41	2	77	0.0259740
NODE_161_length_5425_cov_15.812242	141	218	45	1	77	0.0129870
NODE_161_length_5425_cov_15.812242	141	218	47	1	77	0.0129870
NODE_161_length_5425_cov_15.812242	141	218	48	3	77	0.0389610
NODE_161_length_5425_cov_15.812242	141	218	51	1	77	0.0129870
NODE_161_length_5425_cov_15.812242	141	218	52	2	77	0.0259740
NODE_161_length_5425_cov_15.812242	141	218	53	2	77	0.0259740
NODE_161_length_5425_cov_15.812242	141	218	54	3	77	0.0389610
NODE_161_length_5425_cov_15.812242	141	218	57	2	77	0.0259740
NODE_161_length_5425_cov_15.812242	141	218	59	1	77	0.0129870
NODE_161_length_5425_cov_15.812242	141	218	62	1	77	0.0129870
NODE_161_length_5425_cov_15.812242	141	218	70	1	77	0.0129870
NODE_161_length_5425_cov_15.812242	141	218	71	1	77	0.0129870
NODE_161_length_5425_cov_15.812242	141	218	72	1	77	0.0129870
NODE_161_length_5425_cov_15.812242	141	218	73	2	77	0.0259740
NODE_161_length_5425_cov_15.812242	141	218	76	1	77	0.0129870
NODE_161_length_5425_cov_15.812242	141	218	80	2	77	0.0259740
NODE_161_length_5425_cov_15.812242	141	218	84	1	77	0.0129870
NODE_161_length_5425_cov_15.812242	141	218	86	4	77	0.0519481
NODE_161_length_5425_cov_15.812242	141	218	90	5	77	0.0649351
NODE_161_length_5425_cov_15.812242	141	218	92	1	77	0.0129870
NODE_161_length_5425_cov_15.812242	841	921	0	78	80	0.9750000
NODE_161_length_5425_cov_15.812242	841	921	2	2	80	0.0250000
NODE_161_length_5425_cov_15.812242	894	974	0	80	80	1.0000000
NODE_163_length_5402_cov_5.397322	191	263	25	55	72	0.7638889
NODE_163_length_5402_cov_5.397322	191	263	29	17	72	0.2361111
NODE_163_length_5402_cov_5.397322	2305	2385	9	1	80	0.0125000
NODE_163_length_5402_cov_5.397322	2305	2385	10	3	80	0.0375000
NODE_163_length_5402_cov_5.397322	2305	2385	11	5	80	0.0625000
NODE_163_length_5402_cov_5.397322	2305	2385	12	23	80	0.2875000
NODE_163_length_5402_cov_5.397322	2305	2385	13	8	80	0.1000000
NODE_163_length_5402_cov_5.397322	2305	2385	14	29	80	0.3625000
NODE_163_length_5402_cov_5.397322	2305	2385	15	5	80	0.0625000
NODE_163_length_5402_cov_5.397322	2305	2385	16	6	80	0.0750000
NODE_163_length_5402_cov_5.397322	2358	2438	13	8	80	0.1000000
NODE_163_length_5402_cov_5.397322	2358	2438	14	8	80	0.1000000
NODE_163_length_5402_cov_5.397322	2358	2438	15	18	80	0.2250000
NODE_163_length_5402_cov_5.397322	2358	2438	16	6	80	0.0750000
NODE_163_length_5402_cov_5.397322	2358	2438	17	6	80	0.0750000
NODE_163_length_5402_cov_5.397322	2358	2438	19	12	80	0.1500000
NODE_163_length_5402_cov_5.397322	2358	2438	20	20	80	0.2500000
NODE_163_length_5402_cov_5.397322	2358	2438	21	2	80	0.0250000
NODE_164_length_5383_cov_15.680545	205	285	0	80	80	1.0000000
NODE_164_length_5383_cov_15.680545	258	317	0	59	59	1.0000000
NODE_164_length_5383_cov_15.680545	2042	2122	0	3	80	0.0375000
NODE_164_length_5383_cov_15.680545	2042	2122	2	3	80	0.0375000
NODE_164_length_5383_cov_15.680545	2042	2122	6	23	80	0.2875000
NODE_164_length_5383_cov_15.680545	2042	2122	8	16	80	0.2000000
NODE_164_length_5383_cov_15.680545	2042	2122	10	35	80	0.4375000
NODE_164_length_5383_cov_15.680545	2095	2175	0	56	80	0.7000000
NODE_164_length_5383_cov_15.680545	2095	2175	2	3	80	0.0375000
NODE_164_length_5383_cov_15.680545	2095	2175	6	21	80	0.2625000
NODE_165_length_5382_cov_16.894378	1301	1347	0	2	46	0.0434783
NODE_165_length_5382_cov_16.894378	1301	1347	1	23	46	0.5000000
NODE_165_length_5382_cov_16.894378	1301	1347	5	4	46	0.0869565
NODE_165_length_5382_cov_16.894378	1301	1347	8	4	46	0.0869565
NODE_165_length_5382_cov_16.894378	1301	1347	13	13	46	0.2826087
NODE_165_length_5382_cov_16.894378	5056	5082	53	1	26	0.0384615
NODE_165_length_5382_cov_16.894378	5056	5082	55	3	26	0.1153846
NODE_165_length_5382_cov_16.894378	5056	5082	57	2	26	0.0769231
NODE_165_length_5382_cov_16.894378	5056	5082	58	1	26	0.0384615
NODE_165_length_5382_cov_16.894378	5056	5082	62	2	26	0.0769231
NODE_165_length_5382_cov_16.894378	5056	5082	66	3	26	0.1153846
NODE_165_length_5382_cov_16.894378	5056	5082	71	5	26	0.1923077
NODE_165_length_5382_cov_16.894378	5056	5082	77	1	26	0.0384615
NODE_165_length_5382_cov_16.894378	5056	5082	83	1	26	0.0384615
NODE_165_length_5382_cov_16.894378	5056	5082	85	3	26	0.1153846
NODE_165_length_5382_cov_16.894378	5056	5082	87	2	26	0.0769231
NODE_165_length_5382_cov_16.894378	5056	5082	89	1	26	0.0384615
NODE_165_length_5382_cov_16.894378	5056	5082	91	1	26	0.0384615
NODE_165_length_5382_cov_16.894378	5056	5115	53	1	59	0.0169492
NODE_165_length_5382_cov_16.894378	5056	5115	55	3	59	0.0508475
NODE_165_length_5382_cov_16.894378	5056	5115	57	2	59	0.0338983
NODE_165_length_5382_cov_16.894378	5056	5115	58	1	59	0.0169492
NODE_165_length_5382_cov_16.894378	5056	5115	62	2	59	0.0338983
NODE_165_length_5382_cov_16.894378	5056	5115	66	3	59	0.0508475
NODE_165_length_5382_cov_16.894378	5056	5115	71	5	59	0.0847458
NODE_165_length_5382_cov_16.894378	5056	5115	77	1	59	0.0169492
NODE_165_length_5382_cov_16.894378	5056	5115	83	1	59	0.0169492
NODE_165_length_5382_cov_16.894378	5056	5115	85	3	59	0.0508475
NODE_165_length_5382_cov_16.894378	5056	5115	87	2	59	0.0338983
NODE_165_length_5382_cov_16.894378	5056	5115	89	1	59	0.0169492
NODE_165_length_5382_cov_16.894378	5056	5115	91	1	59	0.0169492
NODE_165_length_5382_cov_16.894378	5056	5115	93	2	59	0.0338983
NODE_165_length_5382_cov_16.894378	5056	5115	98	1	59	0.0169492
NODE_165_length_5382_cov_16.894378	5056	5115	100	2	59	0.0338983
NODE_165_length_5382_cov_16.894378	5056	5115	101	1	59	0.0169492
NODE_165_length_5382_cov_16.894378	5056	5115	103	2	59	0.0338983
NODE_165_length_5382_cov_16.894378	5056	5115	104	3	59	0.0508475
NODE_165_length_5382_cov_16.894378	5056	5115	105	2	59	0.0338983
NODE_165_length_5382_cov_16.894378	5056	5115	106	3	59	0.0508475
NODE_165_length_5382_cov_16.894378	5056	5115	107	1	59	0.0169492
NODE_165_length_5382_cov_16.894378	5056	5115	110	1	59	0.0169492
NODE_165_length_5382_cov_16.894378	5056	5115	112	1	59	0.0169492
NODE_165_length_5382_cov_16.894378	5056	5115	115	2	59	0.0338983
NODE_165_length_5382_cov_16.894378	5056	5115	117	1	59	0.0169492
NODE_165_length_5382_cov_16.894378	5056	5115	118	1	59	0.0169492
NODE_165_length_5382_cov_16.894378	5056	5115	120	2	59	0.0338983
NODE_165_length_5382_cov_16.894378	5056	5115	122	4	59	0.0677966
NODE_165_length_5382_cov_16.894378	5056	5115	123	1	59	0.0169492
NODE_165_length_5382_cov_16.894378	5056	5115	125	1	59	0.0169492
NODE_165_length_5382_cov_16.894378	5056	5115	126	1	59	0.0169492
NODE_165_length_5382_cov_16.894378	5056	5115	127	1	59	0.0169492
NODE_167_length_5339_cov_28.708969	3375	3455	0	60	80	0.7500000
NODE_167_length_5339_cov_28.708969	3375	3455	4	16	80	0.2000000
NODE_167_length_5339_cov_28.708969	3375	3455	9	1	80	0.0125000
NODE_167_length_5339_cov_28.708969	3375	3455	10	3	80	0.0375000
NODE_167_length_5339_cov_28.708969	3428	3508	0	7	80	0.0875000
NODE_167_length_5339_cov_28.708969	3428	3508	4	16	80	0.2000000
NODE_167_length_5339_cov_28.708969	3428	3508	9	1	80	0.0125000
NODE_167_length_5339_cov_28.708969	3428	3508	10	56	80	0.7000000
NODE_168_length_5336_cov_33.036471	3109	3189	17	15	80	0.1875000
NODE_168_length_5336_cov_33.036471	3109	3189	18	8	80	0.1000000
NODE_168_length_5336_cov_33.036471	3109	3189	19	17	80	0.2125000
NODE_168_length_5336_cov_33.036471	3109	3189	21	24	80	0.3000000
NODE_168_length_5336_cov_33.036471	3109	3189	23	3	80	0.0375000
NODE_168_length_5336_cov_33.036471	3109	3189	25	1	80	0.0125000
NODE_168_length_5336_cov_33.036471	3109	3189	27	12	80	0.1500000
NODE_168_length_5336_cov_33.036471	3162	3242	4	11	80	0.1375000
NODE_168_length_5336_cov_33.036471	3162	3242	8	17	80	0.2125000
NODE_168_length_5336_cov_33.036471	3162	3242	12	17	80	0.2125000
NODE_168_length_5336_cov_33.036471	3162	3242	18	2	80	0.0250000
NODE_168_length_5336_cov_33.036471	3162	3242	19	23	80	0.2875000
NODE_168_length_5336_cov_33.036471	3162	3242	27	10	80	0.1250000
NODE_179_length_5269_cov_23.392650	1905	1985	0	80	80	1.0000000
NODE_179_length_5269_cov_23.392650	1958	2038	0	80	80	1.0000000
NODE_181_length_5207_cov_31.352780	4588	4668	0	80	80	1.0000000
NODE_181_length_5207_cov_31.352780	4641	4721	0	80	80	1.0000000
NODE_183_length_5193_cov_14.930506	4659	4739	0	80	80	1.0000000
NODE_183_length_5193_cov_14.930506	4712	4792	0	80	80	1.0000000
NODE_183_length_5193_cov_14.930506	4788	4868	0	80	80	1.0000000
NODE_183_length_5193_cov_14.930506	4841	4921	0	80	80	1.0000000
NODE_186_length_5159_cov_261.593676	158	227	119	1	69	0.0144928
NODE_186_length_5159_cov_261.593676	158	227	123	1	69	0.0144928
NODE_186_length_5159_cov_261.593676	158	227	124	4	69	0.0579710
NODE_186_length_5159_cov_261.593676	158	227	125	2	69	0.0289855
NODE_186_length_5159_cov_261.593676	158	227	126	2	69	0.0289855
NODE_186_length_5159_cov_261.593676	158	227	128	1	69	0.0144928
NODE_186_length_5159_cov_261.593676	158	227	129	2	69	0.0289855
NODE_186_length_5159_cov_261.593676	158	227	130	2	69	0.0289855
NODE_186_length_5159_cov_261.593676	158	227	131	8	69	0.1159420
NODE_186_length_5159_cov_261.593676	158	227	132	4	69	0.0579710
NODE_186_length_5159_cov_261.593676	158	227	133	8	69	0.1159420
NODE_186_length_5159_cov_261.593676	158	227	134	6	69	0.0869565
NODE_186_length_5159_cov_261.593676	158	227	135	7	69	0.1014493
NODE_186_length_5159_cov_261.593676	158	227	136	12	69	0.1739130
NODE_186_length_5159_cov_261.593676	158	227	137	6	69	0.0869565
NODE_186_length_5159_cov_261.593676	158	227	138	1	69	0.0144928
NODE_186_length_5159_cov_261.593676	158	227	139	2	69	0.0289855
NODE_189_length_5138_cov_31.467355	3004	3075	4	5	71	0.0704225
NODE_189_length_5138_cov_31.467355	3004	3075	6	2	71	0.0281690
NODE_189_length_5138_cov_31.467355	3004	3075	8	8	71	0.1126761
NODE_189_length_5138_cov_31.467355	3004	3075	9	2	71	0.0281690
NODE_189_length_5138_cov_31.467355	3004	3075	10	7	71	0.0985916
NODE_189_length_5138_cov_31.467355	3004	3075	11	8	71	0.1126761
NODE_189_length_5138_cov_31.467355	3004	3075	12	3	71	0.0422535
NODE_189_length_5138_cov_31.467355	3004	3075	13	1	71	0.0140845
NODE_189_length_5138_cov_31.467355	3004	3075	15	5	71	0.0704225
NODE_189_length_5138_cov_31.467355	3004	3075	16	8	71	0.1126761
NODE_189_length_5138_cov_31.467355	3004	3075	17	4	71	0.0563380
NODE_189_length_5138_cov_31.467355	3004	3075	19	5	71	0.0704225
NODE_189_length_5138_cov_31.467355	3004	3075	22	6	71	0.0845070
NODE_189_length_5138_cov_31.467355	3004	3075	24	4	71	0.0563380
NODE_189_length_5138_cov_31.467355	3004	3075	29	1	71	0.0140845
NODE_189_length_5138_cov_31.467355	3004	3075	30	2	71	0.0281690
NODE_191_length_5126_cov_5.900935	731	811	0	80	80	1.0000000
NODE_191_length_5126_cov_5.900935	784	864	0	80	80	1.0000000
NODE_194_length_5102_cov_12.729962	367	447	0	22	80	0.2750000
NODE_194_length_5102_cov_12.729962	367	447	4	58	80	0.7250000
NODE_194_length_5102_cov_12.729962	420	500	0	6	80	0.0750000
NODE_194_length_5102_cov_12.729962	420	500	4	74	80	0.9250000
NODE_194_length_5102_cov_12.729962	496	576	0	80	80	1.0000000
NODE_194_length_5102_cov_12.729962	549	629	0	80	80	1.0000000
NODE_196_length_5079_cov_5.580522	875	940	15	1	65	0.0153846
NODE_196_length_5079_cov_5.580522	875	940	17	14	65	0.2153846
NODE_196_length_5079_cov_5.580522	875	940	18	4	65	0.0615385
NODE_196_length_5079_cov_5.580522	875	940	19	2	65	0.0307692
NODE_196_length_5079_cov_5.580522	875	940	21	32	65	0.4923077
NODE_196_length_5079_cov_5.580522	875	940	23	12	65	0.1846154
NODE_197_length_5057_cov_16.348729	2929	3000	172	1	71	0.0140845
NODE_197_length_5057_cov_16.348729	2929	3000	178	1	71	0.0140845
NODE_197_length_5057_cov_16.348729	2929	3000	193	2	71	0.0281690
NODE_197_length_5057_cov_16.348729	2929	3000	196	1	71	0.0140845
NODE_197_length_5057_cov_16.348729	2929	3000	206	2	71	0.0281690
NODE_197_length_5057_cov_16.348729	2929	3000	209	1	71	0.0140845
NODE_197_length_5057_cov_16.348729	2929	3000	210	1	71	0.0140845
NODE_197_length_5057_cov_16.348729	2929	3000	220	2	71	0.0281690
NODE_197_length_5057_cov_16.348729	2929	3000	228	2	71	0.0281690
NODE_197_length_5057_cov_16.348729	2929	3000	230	1	71	0.0140845
NODE_197_length_5057_cov_16.348729	2929	3000	235	1	71	0.0140845
NODE_197_length_5057_cov_16.348729	2929	3000	256	1	71	0.0140845
NODE_197_length_5057_cov_16.348729	2929	3000	260	2	71	0.0281690
NODE_197_length_5057_cov_16.348729	2929	3000	266	1	71	0.0140845
NODE_197_length_5057_cov_16.348729	2929	3000	269	1	71	0.0140845
NODE_197_length_5057_cov_16.348729	2929	3000	273	1	71	0.0140845
NODE_197_length_5057_cov_16.348729	2929	3000	284	1	71	0.0140845
NODE_197_length_5057_cov_16.348729	2929	3000	293	3	71	0.0422535
NODE_197_length_5057_cov_16.348729	2929	3000	295	1	71	0.0140845
NODE_197_length_5057_cov_16.348729	2929	3000	298	5	71	0.0704225
NODE_197_length_5057_cov_16.348729	2929	3000	300	1	71	0.0140845
NODE_197_length_5057_cov_16.348729	2929	3000	302	2	71	0.0281690
NODE_197_length_5057_cov_16.348729	2929	3000	308	1	71	0.0140845
NODE_197_length_5057_cov_16.348729	2929	3000	310	1	71	0.0140845
NODE_197_length_5057_cov_16.348729	2929	3000	312	1	71	0.0140845
NODE_197_length_5057_cov_16.348729	2929	3000	314	2	71	0.0281690
NODE_197_length_5057_cov_16.348729	2929	3000	315	1	71	0.0140845
NODE_197_length_5057_cov_16.348729	2929	3000	317	4	71	0.0563380
NODE_197_length_5057_cov_16.348729	2929	3000	321	2	71	0.0281690
NODE_197_length_5057_cov_16.348729	2929	3000	323	3	71	0.0422535
NODE_197_length_5057_cov_16.348729	2929	3000	327	1	71	0.0140845
NODE_197_length_5057_cov_16.348729	2929	3000	329	1	71	0.0140845
NODE_197_length_5057_cov_16.348729	2929	3000	331	1	71	0.0140845
NODE_197_length_5057_cov_16.348729	2929	3000	336	1	71	0.0140845
NODE_197_length_5057_cov_16.348729	2929	3000	337	1	71	0.0140845
NODE_197_length_5057_cov_16.348729	2929	3000	340	1	71	0.0140845
NODE_197_length_5057_cov_16.348729	2929	3000	342	2	71	0.0281690
NODE_197_length_5057_cov_16.348729	2929	3000	344	1	71	0.0140845
NODE_197_length_5057_cov_16.348729	2929	3000	346	3	71	0.0422535
NODE_197_length_5057_cov_16.348729	2929	3000	347	1	71	0.0140845
NODE_197_length_5057_cov_16.348729	2929	3000	349	1	71	0.0140845
NODE_197_length_5057_cov_16.348729	2929	3000	353	2	71	0.0281690
NODE_197_length_5057_cov_16.348729	2929	3000	354	4	71	0.0563380
NODE_197_length_5057_cov_16.348729	2929	3000	367	1	71	0.0140845
NODE_197_length_5057_cov_16.348729	2929	3000	368	1	71	0.0140845
NODE_197_length_5057_cov_16.348729	2973	3012	321	2	39	0.0512821
NODE_197_length_5057_cov_16.348729	2973	3012	323	3	39	0.0769231
NODE_197_length_5057_cov_16.348729	2973	3012	327	1	39	0.0256410
NODE_197_length_5057_cov_16.348729	2973	3012	329	1	39	0.0256410
NODE_197_length_5057_cov_16.348729	2973	3012	331	1	39	0.0256410
NODE_197_length_5057_cov_16.348729	2973	3012	336	1	39	0.0256410
NODE_197_length_5057_cov_16.348729	2973	3012	337	1	39	0.0256410
NODE_197_length_5057_cov_16.348729	2973	3012	340	1	39	0.0256410
NODE_197_length_5057_cov_16.348729	2973	3012	342	2	39	0.0512821
NODE_197_length_5057_cov_16.348729	2973	3012	344	1	39	0.0256410
NODE_197_length_5057_cov_16.348729	2973	3012	346	4	39	0.1025641
NODE_197_length_5057_cov_16.348729	2973	3012	347	2	39	0.0512821
NODE_197_length_5057_cov_16.348729	2973	3012	349	2	39	0.0512821
NODE_197_length_5057_cov_16.348729	2973	3012	350	1	39	0.0256410
NODE_197_length_5057_cov_16.348729	2973	3012	352	1	39	0.0256410
NODE_197_length_5057_cov_16.348729	2973	3012	353	2	39	0.0512821
NODE_197_length_5057_cov_16.348729	2973	3012	354	4	39	0.1025641
NODE_197_length_5057_cov_16.348729	2973	3012	361	1	39	0.0256410
NODE_197_length_5057_cov_16.348729	2973	3012	363	1	39	0.0256410
NODE_197_length_5057_cov_16.348729	2973	3012	365	2	39	0.0512821
NODE_197_length_5057_cov_16.348729	2973	3012	367	1	39	0.0256410
NODE_197_length_5057_cov_16.348729	2973	3012	368	1	39	0.0256410
NODE_197_length_5057_cov_16.348729	2973	3012	369	1	39	0.0256410
NODE_197_length_5057_cov_16.348729	2973	3012	371	2	39	0.0512821
NODE_198_length_5053_cov_11.281994	791	834	0	43	43	1.0000000
NODE_198_length_5053_cov_11.281994	807	887	0	80	80	1.0000000
NODE_198_length_5053_cov_11.281994	883	963	0	80	80	1.0000000
NODE_198_length_5053_cov_11.281994	936	999	0	63	63	1.0000000
NODE_204_length_4906_cov_37.988350	3170	3251	15	4	81	0.0493827
NODE_204_length_4906_cov_37.988350	3170	3251	16	1	81	0.0123457
NODE_204_length_4906_cov_37.988350	3170	3251	20	1	81	0.0123457
NODE_204_length_4906_cov_37.988350	3170	3251	22	5	81	0.0617284
NODE_204_length_4906_cov_37.988350	3170	3251	23	9	81	0.1111111
NODE_204_length_4906_cov_37.988350	3170	3251	27	2	81	0.0246914
NODE_204_length_4906_cov_37.988350	3170	3251	29	1	81	0.0123457
NODE_204_length_4906_cov_37.988350	3170	3251	32	1	81	0.0123457
NODE_204_length_4906_cov_37.988350	3170	3251	34	1	81	0.0123457
NODE_204_length_4906_cov_37.988350	3170	3251	37	2	81	0.0246914
NODE_204_length_4906_cov_37.988350	3170	3251	43	3	81	0.0370370
NODE_204_length_4906_cov_37.988350	3170	3251	46	2	81	0.0246914
NODE_204_length_4906_cov_37.988350	3170	3251	47	1	81	0.0123457
NODE_204_length_4906_cov_37.988350	3170	3251	51	3	81	0.0370370
NODE_204_length_4906_cov_37.988350	3170	3251	53	2	81	0.0246914
NODE_204_length_4906_cov_37.988350	3170	3251	57	1	81	0.0123457
NODE_204_length_4906_cov_37.988350	3170	3251	58	2	81	0.0246914
NODE_204_length_4906_cov_37.988350	3170	3251	59	2	81	0.0246914
NODE_204_length_4906_cov_37.988350	3170	3251	60	1	81	0.0123457
NODE_204_length_4906_cov_37.988350	3170	3251	72	2	81	0.0246914
NODE_204_length_4906_cov_37.988350	3170	3251	82	1	81	0.0123457
NODE_204_length_4906_cov_37.988350	3170	3251	86	2	81	0.0246914
NODE_204_length_4906_cov_37.988350	3170	3251	89	1	81	0.0123457
NODE_204_length_4906_cov_37.988350	3170	3251	97	1	81	0.0123457
NODE_204_length_4906_cov_37.988350	3170	3251	105	1	81	0.0123457
NODE_204_length_4906_cov_37.988350	3170	3251	108	1	81	0.0123457
NODE_204_length_4906_cov_37.988350	3170	3251	116	1	81	0.0123457
NODE_204_length_4906_cov_37.988350	3170	3251	117	1	81	0.0123457
NODE_204_length_4906_cov_37.988350	3170	3251	120	1	81	0.0123457
NODE_204_length_4906_cov_37.988350	3170	3251	123	1	81	0.0123457
NODE_204_length_4906_cov_37.988350	3170	3251	131	3	81	0.0370370
NODE_204_length_4906_cov_37.988350	3170	3251	132	1	81	0.0123457
NODE_204_length_4906_cov_37.988350	3170	3251	133	1	81	0.0123457
NODE_204_length_4906_cov_37.988350	3170	3251	139	1	81	0.0123457
NODE_204_length_4906_cov_37.988350	3170	3251	147	1	81	0.0123457
NODE_204_length_4906_cov_37.988350	3170	3251	159	1	81	0.0123457
NODE_204_length_4906_cov_37.988350	3170	3251	162	1	81	0.0123457
NODE_204_length_4906_cov_37.988350	3170	3251	166	1	81	0.0123457
NODE_204_length_4906_cov_37.988350	3170	3251	174	1	81	0.0123457
NODE_204_length_4906_cov_37.988350	3170	3251	179	1	81	0.0123457
NODE_204_length_4906_cov_37.988350	3170	3251	182	4	81	0.0493827
NODE_204_length_4906_cov_37.988350	3170	3251	194	2	81	0.0246914
NODE_204_length_4906_cov_37.988350	3170	3251	198	1	81	0.0123457
NODE_204_length_4906_cov_37.988350	3170	3251	206	3	81	0.0370370
NODE_204_length_4906_cov_37.988350	3170	3251	214	1	81	0.0123457
NODE_204_length_4906_cov_37.988350	3170	3251	217	1	81	0.0123457
NODE_205_length_4888_cov_60.162247	4029	4068	2	39	39	1.0000000
NODE_205_length_4888_cov_60.162247	4041	4121	0	38	80	0.4750000
NODE_205_length_4888_cov_60.162247	4041	4121	2	42	80	0.5250000
NODE_207_length_4875_cov_63.035176	2905	2985	6	58	80	0.7250000
NODE_207_length_4875_cov_63.035176	2905	2985	8	13	80	0.1625000
NODE_207_length_4875_cov_63.035176	2905	2985	10	5	80	0.0625000
NODE_207_length_4875_cov_63.035176	2905	2985	14	4	80	0.0500000
NODE_207_length_4875_cov_63.035176	2958	3038	6	5	80	0.0625000
NODE_207_length_4875_cov_63.035176	2958	3038	8	13	80	0.1625000
NODE_207_length_4875_cov_63.035176	2958	3038	10	20	80	0.2500000
NODE_207_length_4875_cov_63.035176	2958	3038	14	4	80	0.0500000
NODE_207_length_4875_cov_63.035176	2958	3038	16	1	80	0.0125000
NODE_207_length_4875_cov_63.035176	2958	3038	25	1	80	0.0125000
NODE_207_length_4875_cov_63.035176	2958	3038	27	1	80	0.0125000
NODE_207_length_4875_cov_63.035176	2958	3038	29	8	80	0.1000000
NODE_207_length_4875_cov_63.035176	2958	3038	31	7	80	0.0875000
NODE_207_length_4875_cov_63.035176	2958	3038	33	20	80	0.2500000
NODE_208_length_4875_cov_8.996859	4683	4760	0	77	77	1.0000000
NODE_208_length_4875_cov_8.996859	4736	4813	0	77	77	1.0000000
NODE_211_length_4827_cov_15.364636	1803	1865	50	3	62	0.0483871
NODE_211_length_4827_cov_15.364636	1803	1865	52	2	62	0.0322581
NODE_211_length_4827_cov_15.364636	1803	1865	53	1	62	0.0161290
NODE_211_length_4827_cov_15.364636	1803	1865	54	1	62	0.0161290
NODE_211_length_4827_cov_15.364636	1803	1865	55	1	62	0.0161290
NODE_211_length_4827_cov_15.364636	1803	1865	56	10	62	0.1612903
NODE_211_length_4827_cov_15.364636	1803	1865	59	1	62	0.0161290
NODE_211_length_4827_cov_15.364636	1803	1865	60	1	62	0.0161290
NODE_211_length_4827_cov_15.364636	1803	1865	62	1	62	0.0161290
NODE_211_length_4827_cov_15.364636	1803	1865	65	2	62	0.0322581
NODE_211_length_4827_cov_15.364636	1803	1865	66	2	62	0.0322581
NODE_211_length_4827_cov_15.364636	1803	1865	67	2	62	0.0322581
NODE_211_length_4827_cov_15.364636	1803	1865	68	5	62	0.0806452
NODE_211_length_4827_cov_15.364636	1803	1865	71	2	62	0.0322581
NODE_211_length_4827_cov_15.364636	1803	1865	73	2	62	0.0322581
NODE_211_length_4827_cov_15.364636	1803	1865	74	1	62	0.0161290
NODE_211_length_4827_cov_15.364636	1803	1865	82	1	62	0.0161290
NODE_211_length_4827_cov_15.364636	1803	1865	84	1	62	0.0161290
NODE_211_length_4827_cov_15.364636	1803	1865	86	2	62	0.0322581
NODE_211_length_4827_cov_15.364636	1803	1865	92	2	62	0.0322581
NODE_211_length_4827_cov_15.364636	1803	1865	98	1	62	0.0161290
NODE_211_length_4827_cov_15.364636	1803	1865	102	4	62	0.0645161
NODE_211_length_4827_cov_15.364636	1803	1865	103	1	62	0.0161290
NODE_211_length_4827_cov_15.364636	1803	1865	104	5	62	0.0806452
NODE_211_length_4827_cov_15.364636	1803	1865	106	2	62	0.0322581
NODE_211_length_4827_cov_15.364636	1803	1865	110	4	62	0.0645161
NODE_211_length_4827_cov_15.364636	1803	1865	112	1	62	0.0161290
NODE_211_length_4827_cov_15.364636	1803	1865	114	1	62	0.0161290
NODE_211_length_4827_cov_15.364636	1899	1979	38	2	80	0.0250000
NODE_211_length_4827_cov_15.364636	1899	1979	46	3	80	0.0375000
NODE_211_length_4827_cov_15.364636	1899	1979	48	5	80	0.0625000
NODE_211_length_4827_cov_15.364636	1899	1979	50	4	80	0.0500000
NODE_211_length_4827_cov_15.364636	1899	1979	52	1	80	0.0125000
NODE_211_length_4827_cov_15.364636	1899	1979	55	5	80	0.0625000
NODE_211_length_4827_cov_15.364636	1899	1979	57	3	80	0.0375000
NODE_211_length_4827_cov_15.364636	1899	1979	58	5	80	0.0625000
NODE_211_length_4827_cov_15.364636	1899	1979	59	5	80	0.0625000
NODE_211_length_4827_cov_15.364636	1899	1979	60	8	80	0.1000000
NODE_211_length_4827_cov_15.364636	1899	1979	61	2	80	0.0250000
NODE_211_length_4827_cov_15.364636	1899	1979	62	5	80	0.0625000
NODE_211_length_4827_cov_15.364636	1899	1979	63	5	80	0.0625000
NODE_211_length_4827_cov_15.364636	1899	1979	64	8	80	0.1000000
NODE_211_length_4827_cov_15.364636	1899	1979	65	1	80	0.0125000
NODE_211_length_4827_cov_15.364636	1899	1979	66	7	80	0.0875000
NODE_211_length_4827_cov_15.364636	1899	1979	67	9	80	0.1125000
NODE_211_length_4827_cov_15.364636	1899	1979	68	2	80	0.0250000
NODE_211_length_4827_cov_15.364636	1952	1996	34	4	44	0.0909091
NODE_211_length_4827_cov_15.364636	1952	1996	36	9	44	0.2045455
NODE_211_length_4827_cov_15.364636	1952	1996	38	6	44	0.1363636
NODE_211_length_4827_cov_15.364636	1952	1996	46	3	44	0.0681818
NODE_211_length_4827_cov_15.364636	1952	1996	48	5	44	0.1136364
NODE_211_length_4827_cov_15.364636	1952	1996	50	4	44	0.0909091
NODE_211_length_4827_cov_15.364636	1952	1996	52	1	44	0.0227273
NODE_211_length_4827_cov_15.364636	1952	1996	55	1	44	0.0227273
NODE_211_length_4827_cov_15.364636	1952	1996	58	2	44	0.0454545
NODE_211_length_4827_cov_15.364636	1952	1996	60	2	44	0.0454545
NODE_211_length_4827_cov_15.364636	1952	1996	62	1	44	0.0227273
NODE_211_length_4827_cov_15.364636	1952	1996	64	6	44	0.1363636
NODE_212_length_4821_cov_10.856840	999	1061	0	35	62	0.5645161
NODE_212_length_4821_cov_10.856840	999	1061	1	24	62	0.3870968
NODE_212_length_4821_cov_10.856840	999	1061	3	2	62	0.0322581
NODE_212_length_4821_cov_10.856840	999	1061	4	1	62	0.0161290
NODE_213_length_4819_cov_16.363347	2392	2461	5	9	69	0.1304348
NODE_213_length_4819_cov_16.363347	2392	2461	7	18	69	0.2608696
NODE_213_length_4819_cov_16.363347	2392	2461	9	14	69	0.2028985
NODE_213_length_4819_cov_16.363347	2392	2461	11	1	69	0.0144928
NODE_213_length_4819_cov_16.363347	2392	2461	13	27	69	0.3913043
NODE_217_length_4794_cov_14.912886	657	737	56	2	80	0.0250000
NODE_217_length_4794_cov_14.912886	657	737	58	1	80	0.0125000
NODE_217_length_4794_cov_14.912886	657	737	60	7	80	0.0875000
NODE_217_length_4794_cov_14.912886	657	737	62	4	80	0.0500000
NODE_217_length_4794_cov_14.912886	657	737	64	1	80	0.0125000
NODE_217_length_4794_cov_14.912886	657	737	70	5	80	0.0625000
NODE_217_length_4794_cov_14.912886	657	737	71	3	80	0.0375000
NODE_217_length_4794_cov_14.912886	657	737	73	17	80	0.2125000
NODE_217_length_4794_cov_14.912886	657	737	75	3	80	0.0375000
NODE_217_length_4794_cov_14.912886	657	737	77	1	80	0.0125000
NODE_217_length_4794_cov_14.912886	657	737	78	4	80	0.0500000
NODE_217_length_4794_cov_14.912886	657	737	80	5	80	0.0625000
NODE_217_length_4794_cov_14.912886	657	737	82	1	80	0.0125000
NODE_217_length_4794_cov_14.912886	657	737	83	1	80	0.0125000
NODE_217_length_4794_cov_14.912886	657	737	85	2	80	0.0250000
NODE_217_length_4794_cov_14.912886	657	737	86	3	80	0.0375000
NODE_217_length_4794_cov_14.912886	657	737	88	6	80	0.0750000
NODE_217_length_4794_cov_14.912886	657	737	89	4	80	0.0500000
NODE_217_length_4794_cov_14.912886	657	737	90	6	80	0.0750000
NODE_217_length_4794_cov_14.912886	657	737	92	4	80	0.0500000
NODE_217_length_4794_cov_14.912886	4240	4312	0	72	72	1.0000000
NODE_217_length_4794_cov_14.912886	4293	4312	0	19	19	1.0000000
NODE_217_length_4794_cov_14.912886	4345	4408	0	11	63	0.1746032
NODE_217_length_4794_cov_14.912886	4345	4408	2	52	63	0.8253968
NODE_218_length_4791_cov_16.126172	2438	2518	0	80	80	1.0000000
NODE_218_length_4791_cov_16.126172	2491	2571	0	80	80	1.0000000
NODE_218_length_4791_cov_16.126172	2567	2647	0	80	80	1.0000000
NODE_218_length_4791_cov_16.126172	2620	2700	0	80	80	1.0000000
NODE_218_length_4791_cov_16.126172	4607	4687	0	41	80	0.5125000
NODE_218_length_4791_cov_16.126172	4607	4687	2	39	80	0.4875000
NODE_219_length_4790_cov_9.713494	2159	2239	13	2	80	0.0250000
NODE_219_length_4790_cov_9.713494	2159	2239	14	1	80	0.0125000
NODE_219_length_4790_cov_9.713494	2159	2239	15	17	80	0.2125000
NODE_219_length_4790_cov_9.713494	2159	2239	18	2	80	0.0250000
NODE_219_length_4790_cov_9.713494	2159	2239	20	9	80	0.1125000
NODE_219_length_4790_cov_9.713494	2159	2239	21	10	80	0.1250000
NODE_219_length_4790_cov_9.713494	2159	2239	22	10	80	0.1250000
NODE_219_length_4790_cov_9.713494	2159	2239	24	20	80	0.2500000
NODE_219_length_4790_cov_9.713494	2159	2239	28	3	80	0.0375000
NODE_219_length_4790_cov_9.713494	2159	2239	32	2	80	0.0250000
NODE_219_length_4790_cov_9.713494	2159	2239	34	4	80	0.0500000
NODE_219_length_4790_cov_9.713494	4273	4353	2	16	80	0.2000000
NODE_219_length_4790_cov_9.713494	4273	4353	4	2	80	0.0250000
NODE_219_length_4790_cov_9.713494	4273	4353	6	62	80	0.7750000
NODE_219_length_4790_cov_9.713494	4273	4335	2	7	62	0.1129032
NODE_219_length_4790_cov_9.713494	4273	4335	4	1	62	0.0161290
NODE_219_length_4790_cov_9.713494	4273	4335	6	54	62	0.8709677
NODE_219_length_4790_cov_9.713494	4326	4406	2	60	80	0.7500000
NODE_219_length_4790_cov_9.713494	4326	4406	4	3	80	0.0375000
NODE_219_length_4790_cov_9.713494	4326	4406	6	17	80	0.2125000
NODE_221_length_4772_cov_10.560454	4281	4367	0	86	86	1.0000000
NODE_222_length_4770_cov_106.953543	2778	2858	41	3	80	0.0375000
NODE_222_length_4770_cov_106.953543	2778	2858	43	5	80	0.0625000
NODE_222_length_4770_cov_106.953543	2778	2858	45	4	80	0.0500000
NODE_222_length_4770_cov_106.953543	2778	2858	47	7	80	0.0875000
NODE_222_length_4770_cov_106.953543	2778	2858	49	8	80	0.1000000
NODE_222_length_4770_cov_106.953543	2778	2858	52	1	80	0.0125000
NODE_222_length_4770_cov_106.953543	2778	2858	54	10	80	0.1250000
NODE_222_length_4770_cov_106.953543	2778	2858	56	4	80	0.0500000
NODE_222_length_4770_cov_106.953543	2778	2858	57	15	80	0.1875000
NODE_222_length_4770_cov_106.953543	2778	2858	59	1	80	0.0125000
NODE_222_length_4770_cov_106.953543	2778	2858	60	1	80	0.0125000
NODE_222_length_4770_cov_106.953543	2778	2858	61	6	80	0.0750000
NODE_222_length_4770_cov_106.953543	2778	2858	62	5	80	0.0625000
NODE_222_length_4770_cov_106.953543	2778	2858	63	1	80	0.0125000
NODE_222_length_4770_cov_106.953543	2778	2858	64	9	80	0.1125000
NODE_222_length_4770_cov_106.953543	2831	2911	49	1	80	0.0125000
NODE_222_length_4770_cov_106.953543	2831	2911	51	5	80	0.0625000
NODE_222_length_4770_cov_106.953543	2831	2911	52	8	80	0.1000000
NODE_222_length_4770_cov_106.953543	2831	2911	53	8	80	0.1000000
NODE_222_length_4770_cov_106.953543	2831	2911	54	11	80	0.1375000
NODE_222_length_4770_cov_106.953543	2831	2911	55	8	80	0.1000000
NODE_222_length_4770_cov_106.953543	2831	2911	56	3	80	0.0375000
NODE_222_length_4770_cov_106.953543	2831	2911	57	5	80	0.0625000
NODE_222_length_4770_cov_106.953543	2831	2911	59	3	80	0.0375000
NODE_222_length_4770_cov_106.953543	2831	2911	61	10	80	0.1250000
NODE_222_length_4770_cov_106.953543	2831	2911	62	5	80	0.0625000
NODE_222_length_4770_cov_106.953543	2831	2911	63	1	80	0.0125000
NODE_222_length_4770_cov_106.953543	2831	2911	64	3	80	0.0375000
NODE_222_length_4770_cov_106.953543	2831	2911	66	2	80	0.0250000
NODE_222_length_4770_cov_106.953543	2831	2911	67	5	80	0.0625000
NODE_222_length_4770_cov_106.953543	2831	2911	69	2	80	0.0250000
NODE_222_length_4770_cov_106.953543	2907	2987	64	2	80	0.0250000
NODE_222_length_4770_cov_106.953543	2907	2987	66	2	80	0.0250000
NODE_222_length_4770_cov_106.953543	2907	2987	72	2	80	0.0250000
NODE_222_length_4770_cov_106.953543	2907	2987	75	1	80	0.0125000
NODE_222_length_4770_cov_106.953543	2907	2987	82	1	80	0.0125000
NODE_222_length_4770_cov_106.953543	2907	2987	83	4	80	0.0500000
NODE_222_length_4770_cov_106.953543	2907	2987	84	2	80	0.0250000
NODE_222_length_4770_cov_106.953543	2907	2987	86	10	80	0.1250000
NODE_222_length_4770_cov_106.953543	2907	2987	88	5	80	0.0625000
NODE_222_length_4770_cov_106.953543	2907	2987	90	1	80	0.0125000
NODE_222_length_4770_cov_106.953543	2907	2987	92	1	80	0.0125000
NODE_222_length_4770_cov_106.953543	2907	2987	93	1	80	0.0125000
NODE_222_length_4770_cov_106.953543	2907	2987	94	6	80	0.0750000
NODE_222_length_4770_cov_106.953543	2907	2987	98	2	80	0.0250000
NODE_222_length_4770_cov_106.953543	2907	2987	100	2	80	0.0250000
NODE_222_length_4770_cov_106.953543	2907	2987	104	1	80	0.0125000
NODE_222_length_4770_cov_106.953543	2907	2987	105	1	80	0.0125000
NODE_222_length_4770_cov_106.953543	2907	2987	106	5	80	0.0625000
NODE_222_length_4770_cov_106.953543	2907	2987	109	4	80	0.0500000
NODE_222_length_4770_cov_106.953543	2907	2987	111	9	80	0.1125000
NODE_222_length_4770_cov_106.953543	2907	2987	112	3	80	0.0375000
NODE_222_length_4770_cov_106.953543	2907	2987	113	10	80	0.1250000
NODE_222_length_4770_cov_106.953543	2907	2987	115	5	80	0.0625000
NODE_222_length_4770_cov_106.953543	2960	3040	93	1	80	0.0125000
NODE_222_length_4770_cov_106.953543	2960	3040	95	1	80	0.0125000
NODE_222_length_4770_cov_106.953543	2960	3040	99	3	80	0.0375000
NODE_222_length_4770_cov_106.953543	2960	3040	101	2	80	0.0250000
NODE_222_length_4770_cov_106.953543	2960	3040	103	4	80	0.0500000
NODE_222_length_4770_cov_106.953543	2960	3040	104	9	80	0.1125000
NODE_222_length_4770_cov_106.953543	2960	3040	105	7	80	0.0875000
NODE_222_length_4770_cov_106.953543	2960	3040	106	7	80	0.0875000
NODE_222_length_4770_cov_106.953543	2960	3040	107	6	80	0.0750000
NODE_222_length_4770_cov_106.953543	2960	3040	108	1	80	0.0125000
NODE_222_length_4770_cov_106.953543	2960	3040	109	2	80	0.0250000
NODE_222_length_4770_cov_106.953543	2960	3040	110	3	80	0.0375000
NODE_222_length_4770_cov_106.953543	2960	3040	111	11	80	0.1375000
NODE_222_length_4770_cov_106.953543	2960	3040	112	2	80	0.0250000
NODE_222_length_4770_cov_106.953543	2960	3040	113	11	80	0.1375000
NODE_222_length_4770_cov_106.953543	2960	3040	114	2	80	0.0250000
NODE_222_length_4770_cov_106.953543	2960	3040	115	5	80	0.0625000
NODE_222_length_4770_cov_106.953543	2960	3040	116	2	80	0.0250000
NODE_222_length_4770_cov_106.953543	2960	3040	117	1	80	0.0125000
NODE_223_length_4768_cov_15.447205	1237	1317	6	13	80	0.1625000
NODE_223_length_4768_cov_15.447205	1237	1317	8	12	80	0.1500000
NODE_223_length_4768_cov_15.447205	1237	1317	10	55	80	0.6875000
NODE_228_length_4730_cov_30.142734	256	336	0	80	80	1.0000000
NODE_228_length_4730_cov_30.142734	309	389	0	80	80	1.0000000
NODE_228_length_4730_cov_30.142734	4052	4132	0	30	80	0.3750000
NODE_228_length_4730_cov_30.142734	4052	4132	2	8	80	0.1000000
NODE_228_length_4730_cov_30.142734	4052	4132	4	42	80	0.5250000
NODE_228_length_4730_cov_30.142734	4105	4185	0	12	80	0.1500000
NODE_228_length_4730_cov_30.142734	4105	4185	2	44	80	0.5500000
NODE_228_length_4730_cov_30.142734	4105	4185	4	24	80	0.3000000
NODE_231_length_4706_cov_25.522683	2181	2261	3	27	80	0.3375000
NODE_231_length_4706_cov_25.522683	2181	2261	4	4	80	0.0500000
NODE_231_length_4706_cov_25.522683	2181	2261	6	5	80	0.0625000
NODE_231_length_4706_cov_25.522683	2181	2261	12	2	80	0.0250000
NODE_231_length_4706_cov_25.522683	2181	2261	13	1	80	0.0125000
NODE_231_length_4706_cov_25.522683	2181	2261	16	5	80	0.0625000
NODE_231_length_4706_cov_25.522683	2181	2261	17	1	80	0.0125000
NODE_231_length_4706_cov_25.522683	2181	2261	18	2	80	0.0250000
NODE_231_length_4706_cov_25.522683	2181	2261	19	8	80	0.1000000
NODE_231_length_4706_cov_25.522683	2181	2261	21	8	80	0.1000000
NODE_231_length_4706_cov_25.522683	2181	2261	23	3	80	0.0375000
NODE_231_length_4706_cov_25.522683	2181	2261	25	2	80	0.0250000
NODE_231_length_4706_cov_25.522683	2181	2261	26	3	80	0.0375000
NODE_231_length_4706_cov_25.522683	2181	2261	27	1	80	0.0125000
NODE_231_length_4706_cov_25.522683	2181	2261	30	2	80	0.0250000
NODE_231_length_4706_cov_25.522683	2181	2261	34	6	80	0.0750000
NODE_231_length_4706_cov_25.522683	2234	2288	0	10	54	0.1851852
NODE_231_length_4706_cov_25.522683	2234	2288	1	10	54	0.1851852
NODE_231_length_4706_cov_25.522683	2234	2288	2	4	54	0.0740741
NODE_231_length_4706_cov_25.522683	2234	2288	3	30	54	0.5555556
NODE_231_length_4706_cov_25.522683	3943	4026	7	8	83	0.0963855
NODE_231_length_4706_cov_25.522683	3943	4026	9	47	83	0.5662650
NODE_231_length_4706_cov_25.522683	3943	4026	11	15	83	0.1807229
NODE_231_length_4706_cov_25.522683	3943	4026	14	3	83	0.0361446
NODE_231_length_4706_cov_25.522683	3943	4026	20	10	83	0.1204819
NODE_235_length_4693_cov_16.973008	374	454	2	23	80	0.2875000
NODE_235_length_4693_cov_16.973008	374	454	4	1	80	0.0125000
NODE_235_length_4693_cov_16.973008	374	454	13	1	80	0.0125000
NODE_235_length_4693_cov_16.973008	374	454	14	55	80	0.6875000
NODE_235_length_4693_cov_16.973008	427	507	12	45	80	0.5625000
NODE_235_length_4693_cov_16.973008	427	507	14	35	80	0.4375000
NODE_240_length_4672_cov_39.029084	1391	1470	44	4	79	0.0506329
NODE_240_length_4672_cov_39.029084	1391	1470	48	1	79	0.0126582
NODE_240_length_4672_cov_39.029084	1391	1470	50	1	79	0.0126582
NODE_240_length_4672_cov_39.029084	1391	1470	52	3	79	0.0379747
NODE_240_length_4672_cov_39.029084	1391	1470	74	1	79	0.0126582
NODE_240_length_4672_cov_39.029084	1391	1470	84	1	79	0.0126582
NODE_240_length_4672_cov_39.029084	1391	1470	92	3	79	0.0379747
NODE_240_length_4672_cov_39.029084	1391	1470	96	1	79	0.0126582
NODE_240_length_4672_cov_39.029084	1391	1470	106	5	79	0.0632911
NODE_240_length_4672_cov_39.029084	1391	1470	108	1	79	0.0126582
NODE_240_length_4672_cov_39.029084	1391	1470	116	2	79	0.0253165
NODE_240_length_4672_cov_39.029084	1391	1470	120	5	79	0.0632911
NODE_240_length_4672_cov_39.029084	1391	1470	124	1	79	0.0126582
NODE_240_length_4672_cov_39.029084	1391	1470	133	2	79	0.0253165
NODE_240_length_4672_cov_39.029084	1391	1470	135	2	79	0.0253165
NODE_240_length_4672_cov_39.029084	1391	1470	139	1	79	0.0126582
NODE_240_length_4672_cov_39.029084	1391	1470	141	3	79	0.0379747
NODE_240_length_4672_cov_39.029084	1391	1470	148	1	79	0.0126582
NODE_240_length_4672_cov_39.029084	1391	1470	152	1	79	0.0126582
NODE_240_length_4672_cov_39.029084	1391	1470	155	1	79	0.0126582
NODE_240_length_4672_cov_39.029084	1391	1470	156	5	79	0.0632911
NODE_240_length_4672_cov_39.029084	1391	1470	158	1	79	0.0126582
NODE_240_length_4672_cov_39.029084	1391	1470	162	1	79	0.0126582
NODE_240_length_4672_cov_39.029084	1391	1470	164	4	79	0.0506329
NODE_240_length_4672_cov_39.029084	1391	1470	181	5	79	0.0632911
NODE_240_length_4672_cov_39.029084	1391	1470	182	2	79	0.0253165
NODE_240_length_4672_cov_39.029084	1391	1470	186	1	79	0.0126582
NODE_240_length_4672_cov_39.029084	1391	1470	188	1	79	0.0126582
NODE_240_length_4672_cov_39.029084	1391	1470	189	1	79	0.0126582
NODE_240_length_4672_cov_39.029084	1391	1470	191	1	79	0.0126582
NODE_240_length_4672_cov_39.029084	1391	1470	192	2	79	0.0253165
NODE_240_length_4672_cov_39.029084	1391	1470	193	1	79	0.0126582
NODE_240_length_4672_cov_39.029084	1391	1470	194	4	79	0.0506329
NODE_240_length_4672_cov_39.029084	1391	1470	197	2	79	0.0253165
NODE_240_length_4672_cov_39.029084	1391	1470	198	1	79	0.0126582
NODE_240_length_4672_cov_39.029084	1391	1470	200	5	79	0.0632911
NODE_240_length_4672_cov_39.029084	1391	1470	201	2	79	0.0253165
NODE_240_length_4672_cov_39.029084	1444	1523	87	1	79	0.0126582
NODE_240_length_4672_cov_39.029084	1444	1523	98	1	79	0.0126582
NODE_240_length_4672_cov_39.029084	1444	1523	108	2	79	0.0253165
NODE_240_length_4672_cov_39.029084	1444	1523	115	2	79	0.0253165
NODE_240_length_4672_cov_39.029084	1444	1523	123	1	79	0.0126582
NODE_240_length_4672_cov_39.029084	1444	1523	125	2	79	0.0253165
NODE_240_length_4672_cov_39.029084	1444	1523	126	2	79	0.0253165
NODE_240_length_4672_cov_39.029084	1444	1523	132	1	79	0.0126582
NODE_240_length_4672_cov_39.029084	1444	1523	138	3	79	0.0379747
NODE_240_length_4672_cov_39.029084	1444	1523	145	1	79	0.0126582
NODE_240_length_4672_cov_39.029084	1444	1523	151	1	79	0.0126582
NODE_240_length_4672_cov_39.029084	1444	1523	156	1	79	0.0126582
NODE_240_length_4672_cov_39.029084	1444	1523	158	1	79	0.0126582
NODE_240_length_4672_cov_39.029084	1444	1523	160	1	79	0.0126582
NODE_240_length_4672_cov_39.029084	1444	1523	161	4	79	0.0506329
NODE_240_length_4672_cov_39.029084	1444	1523	163	1	79	0.0126582
NODE_240_length_4672_cov_39.029084	1444	1523	165	2	79	0.0253165
NODE_240_length_4672_cov_39.029084	1444	1523	167	4	79	0.0506329
NODE_240_length_4672_cov_39.029084	1444	1523	173	1	79	0.0126582
NODE_240_length_4672_cov_39.029084	1444	1523	174	4	79	0.0506329
NODE_240_length_4672_cov_39.029084	1444	1523	176	1	79	0.0126582
NODE_240_length_4672_cov_39.029084	1444	1523	178	2	79	0.0253165
NODE_240_length_4672_cov_39.029084	1444	1523	180	1	79	0.0126582
NODE_240_length_4672_cov_39.029084	1444	1523	181	5	79	0.0632911
NODE_240_length_4672_cov_39.029084	1444	1523	182	1	79	0.0126582
NODE_240_length_4672_cov_39.029084	1444	1523	184	2	79	0.0253165
NODE_240_length_4672_cov_39.029084	1444	1523	186	1	79	0.0126582
NODE_240_length_4672_cov_39.029084	1444	1523	188	2	79	0.0253165
NODE_240_length_4672_cov_39.029084	1444	1523	189	1	79	0.0126582
NODE_240_length_4672_cov_39.029084	1444	1523	190	4	79	0.0506329
NODE_240_length_4672_cov_39.029084	1444	1523	191	1	79	0.0126582
NODE_240_length_4672_cov_39.029084	1444	1523	192	7	79	0.0886076
NODE_240_length_4672_cov_39.029084	1444	1523	193	1	79	0.0126582
NODE_240_length_4672_cov_39.029084	1444	1523	194	4	79	0.0506329
NODE_240_length_4672_cov_39.029084	1444	1523	197	2	79	0.0253165
NODE_240_length_4672_cov_39.029084	1444	1523	198	1	79	0.0126582
NODE_240_length_4672_cov_39.029084	1444	1523	200	5	79	0.0632911
NODE_240_length_4672_cov_39.029084	1444	1523	201	2	79	0.0253165
NODE_246_length_4602_cov_17.281368	3106	3186	1	23	80	0.2875000
NODE_246_length_4602_cov_17.281368	3106	3186	2	7	80	0.0875000
NODE_246_length_4602_cov_17.281368	3106	3186	3	37	80	0.4625000
NODE_246_length_4602_cov_17.281368	3106	3186	4	13	80	0.1625000
NODE_246_length_4602_cov_17.281368	3159	3239	3	68	80	0.8500000
NODE_246_length_4602_cov_17.281368	3159	3239	5	12	80	0.1500000
NODE_248_length_4587_cov_14.431150	1294	1370	115	2	76	0.0263158
NODE_248_length_4587_cov_14.431150	1294	1370	116	5	76	0.0657895
NODE_248_length_4587_cov_14.431150	1294	1370	118	2	76	0.0263158
NODE_248_length_4587_cov_14.431150	1294	1370	120	1	76	0.0131579
NODE_248_length_4587_cov_14.431150	1294	1370	122	2	76	0.0263158
NODE_248_length_4587_cov_14.431150	1294	1370	126	2	76	0.0263158
NODE_248_length_4587_cov_14.431150	1294	1370	127	2	76	0.0263158
NODE_248_length_4587_cov_14.431150	1294	1370	130	1	76	0.0131579
NODE_248_length_4587_cov_14.431150	1294	1370	132	1	76	0.0131579
NODE_248_length_4587_cov_14.431150	1294	1370	134	3	76	0.0394737
NODE_248_length_4587_cov_14.431150	1294	1370	135	1	76	0.0131579
NODE_248_length_4587_cov_14.431150	1294	1370	137	1	76	0.0131579
NODE_248_length_4587_cov_14.431150	1294	1370	139	9	76	0.1184211
NODE_248_length_4587_cov_14.431150	1294	1370	140	4	76	0.0526316
NODE_248_length_4587_cov_14.431150	1294	1370	141	4	76	0.0526316
NODE_248_length_4587_cov_14.431150	1294	1370	142	5	76	0.0657895
NODE_248_length_4587_cov_14.431150	1294	1370	143	5	76	0.0657895
NODE_248_length_4587_cov_14.431150	1294	1370	144	6	76	0.0789474
NODE_248_length_4587_cov_14.431150	1294	1370	146	5	76	0.0657895
NODE_248_length_4587_cov_14.431150	1294	1370	148	3	76	0.0394737
NODE_248_length_4587_cov_14.431150	1294	1370	150	2	76	0.0263158
NODE_248_length_4587_cov_14.431150	1294	1370	151	1	76	0.0131579
NODE_248_length_4587_cov_14.431150	1294	1370	152	1	76	0.0131579
NODE_248_length_4587_cov_14.431150	1294	1370	153	1	76	0.0131579
NODE_248_length_4587_cov_14.431150	1294	1370	154	2	76	0.0263158
NODE_248_length_4587_cov_14.431150	1294	1370	155	1	76	0.0131579
NODE_248_length_4587_cov_14.431150	1294	1370	156	2	76	0.0263158
NODE_248_length_4587_cov_14.431150	1294	1370	158	1	76	0.0131579
NODE_248_length_4587_cov_14.431150	1294	1370	159	1	76	0.0131579
NODE_248_length_4587_cov_14.431150	1347	1427	106	4	80	0.0500000
NODE_248_length_4587_cov_14.431150	1347	1427	108	2	80	0.0250000
NODE_248_length_4587_cov_14.431150	1347	1427	109	1	80	0.0125000
NODE_248_length_4587_cov_14.431150	1347	1427	110	2	80	0.0250000
NODE_248_length_4587_cov_14.431150	1347	1427	112	1	80	0.0125000
NODE_248_length_4587_cov_14.431150	1347	1427	113	3	80	0.0375000
NODE_248_length_4587_cov_14.431150	1347	1427	114	6	80	0.0750000
NODE_248_length_4587_cov_14.431150	1347	1427	115	3	80	0.0375000
NODE_248_length_4587_cov_14.431150	1347	1427	116	1	80	0.0125000
NODE_248_length_4587_cov_14.431150	1347	1427	118	3	80	0.0375000
NODE_248_length_4587_cov_14.431150	1347	1427	121	1	80	0.0125000
NODE_248_length_4587_cov_14.431150	1347	1427	123	4	80	0.0500000
NODE_248_length_4587_cov_14.431150	1347	1427	125	4	80	0.0500000
NODE_248_length_4587_cov_14.431150	1347	1427	126	1	80	0.0125000
NODE_248_length_4587_cov_14.431150	1347	1427	127	1	80	0.0125000
NODE_248_length_4587_cov_14.431150	1347	1427	128	3	80	0.0375000
NODE_248_length_4587_cov_14.431150	1347	1427	129	1	80	0.0125000
NODE_248_length_4587_cov_14.431150	1347	1427	130	3	80	0.0375000
NODE_248_length_4587_cov_14.431150	1347	1427	131	1	80	0.0125000
NODE_248_length_4587_cov_14.431150	1347	1427	135	2	80	0.0250000
NODE_248_length_4587_cov_14.431150	1347	1427	136	3	80	0.0375000
NODE_248_length_4587_cov_14.431150	1347	1427	139	1	80	0.0125000
NODE_248_length_4587_cov_14.431150	1347	1427	140	3	80	0.0375000
NODE_248_length_4587_cov_14.431150	1347	1427	142	2	80	0.0250000
NODE_248_length_4587_cov_14.431150	1347	1427	143	4	80	0.0500000
NODE_248_length_4587_cov_14.431150	1347	1427	144	5	80	0.0625000
NODE_248_length_4587_cov_14.431150	1347	1427	145	2	80	0.0250000
NODE_248_length_4587_cov_14.431150	1347	1427	146	4	80	0.0500000
NODE_248_length_4587_cov_14.431150	1347	1427	148	3	80	0.0375000
NODE_248_length_4587_cov_14.431150	1347	1427	151	1	80	0.0125000
NODE_248_length_4587_cov_14.431150	1347	1427	153	1	80	0.0125000
NODE_248_length_4587_cov_14.431150	1347	1427	154	1	80	0.0125000
NODE_248_length_4587_cov_14.431150	1347	1427	155	1	80	0.0125000
NODE_248_length_4587_cov_14.431150	1347	1427	158	1	80	0.0125000
NODE_248_length_4587_cov_14.431150	1347	1427	159	1	80	0.0125000
NODE_248_length_4587_cov_14.431150	1466	1533	74	2	67	0.0298507
NODE_248_length_4587_cov_14.431150	1466	1533	75	3	67	0.0447761
NODE_248_length_4587_cov_14.431150	1466	1533	78	7	67	0.1044776
NODE_248_length_4587_cov_14.431150	1466	1533	79	2	67	0.0298507
NODE_248_length_4587_cov_14.431150	1466	1533	80	9	67	0.1343284
NODE_248_length_4587_cov_14.431150	1466	1533	81	3	67	0.0447761
NODE_248_length_4587_cov_14.431150	1466	1533	82	10	67	0.1492537
NODE_248_length_4587_cov_14.431150	1466	1533	83	8	67	0.1194030
NODE_248_length_4587_cov_14.431150	1466	1533	84	2	67	0.0298507
NODE_248_length_4587_cov_14.431150	1466	1533	85	4	67	0.0597015
NODE_248_length_4587_cov_14.431150	1466	1533	87	4	67	0.0597015
NODE_248_length_4587_cov_14.431150	1466	1533	88	3	67	0.0447761
NODE_248_length_4587_cov_14.431150	1466	1533	89	8	67	0.1194030
NODE_248_length_4587_cov_14.431150	1466	1533	91	2	67	0.0298507
NODE_248_length_4587_cov_14.431150	4316	4382	215	1	66	0.0151515
NODE_248_length_4587_cov_14.431150	4316	4382	235	1	66	0.0151515
NODE_248_length_4587_cov_14.431150	4316	4382	243	1	66	0.0151515
NODE_248_length_4587_cov_14.431150	4316	4382	245	1	66	0.0151515
NODE_248_length_4587_cov_14.431150	4316	4382	250	1	66	0.0151515
NODE_248_length_4587_cov_14.431150	4316	4382	259	1	66	0.0151515
NODE_248_length_4587_cov_14.431150	4316	4382	267	1	66	0.0151515
NODE_248_length_4587_cov_14.431150	4316	4382	268	1	66	0.0151515
NODE_248_length_4587_cov_14.431150	4316	4382	270	2	66	0.0303030
NODE_248_length_4587_cov_14.431150	4316	4382	272	2	66	0.0303030
NODE_248_length_4587_cov_14.431150	4316	4382	280	1	66	0.0151515
NODE_248_length_4587_cov_14.431150	4316	4382	294	1	66	0.0151515
NODE_248_length_4587_cov_14.431150	4316	4382	296	1	66	0.0151515
NODE_248_length_4587_cov_14.431150	4316	4382	316	1	66	0.0151515
NODE_248_length_4587_cov_14.431150	4316	4382	319	1	66	0.0151515
NODE_248_length_4587_cov_14.431150	4316	4382	327	1	66	0.0151515
NODE_248_length_4587_cov_14.431150	4316	4382	329	1	66	0.0151515
NODE_248_length_4587_cov_14.431150	4316	4382	336	1	66	0.0151515
NODE_248_length_4587_cov_14.431150	4316	4382	341	3	66	0.0454545
NODE_248_length_4587_cov_14.431150	4316	4382	345	1	66	0.0151515
NODE_248_length_4587_cov_14.431150	4316	4382	350	1	66	0.0151515
NODE_248_length_4587_cov_14.431150	4316	4382	353	1	66	0.0151515
NODE_248_length_4587_cov_14.431150	4316	4382	354	1	66	0.0151515
NODE_248_length_4587_cov_14.431150	4316	4382	355	2	66	0.0303030
NODE_248_length_4587_cov_14.431150	4316	4382	363	1	66	0.0151515
NODE_248_length_4587_cov_14.431150	4316	4382	365	1	66	0.0151515
NODE_248_length_4587_cov_14.431150	4316	4382	372	3	66	0.0454545
NODE_248_length_4587_cov_14.431150	4316	4382	373	1	66	0.0151515
NODE_248_length_4587_cov_14.431150	4316	4382	377	2	66	0.0303030
NODE_248_length_4587_cov_14.431150	4316	4382	378	1	66	0.0151515
NODE_248_length_4587_cov_14.431150	4316	4382	380	1	66	0.0151515
NODE_248_length_4587_cov_14.431150	4316	4382	384	1	66	0.0151515
NODE_248_length_4587_cov_14.431150	4316	4382	386	1	66	0.0151515
NODE_248_length_4587_cov_14.431150	4316	4382	387	1	66	0.0151515
NODE_248_length_4587_cov_14.431150	4316	4382	388	1	66	0.0151515
NODE_248_length_4587_cov_14.431150	4316	4382	389	1	66	0.0151515
NODE_248_length_4587_cov_14.431150	4316	4382	391	2	66	0.0303030
NODE_248_length_4587_cov_14.431150	4316	4382	397	1	66	0.0151515
NODE_248_length_4587_cov_14.431150	4316	4382	398	1	66	0.0151515
NODE_248_length_4587_cov_14.431150	4316	4382	405	2	66	0.0303030
NODE_248_length_4587_cov_14.431150	4316	4382	407	1	66	0.0151515
NODE_248_length_4587_cov_14.431150	4316	4382	414	2	66	0.0303030
NODE_248_length_4587_cov_14.431150	4316	4382	415	2	66	0.0303030
NODE_248_length_4587_cov_14.431150	4316	4382	417	1	66	0.0151515
NODE_248_length_4587_cov_14.431150	4316	4382	420	1	66	0.0151515
NODE_248_length_4587_cov_14.431150	4316	4382	421	4	66	0.0606061
NODE_248_length_4587_cov_14.431150	4316	4382	422	2	66	0.0303030
NODE_248_length_4587_cov_14.431150	4316	4382	423	2	66	0.0303030
NODE_248_length_4587_cov_14.431150	4316	4382	424	1	66	0.0151515
NODE_248_length_4587_cov_14.431150	4355	4435	368	1	80	0.0125000
NODE_248_length_4587_cov_14.431150	4355	4435	370	1	80	0.0125000
NODE_248_length_4587_cov_14.431150	4355	4435	372	1	80	0.0125000
NODE_248_length_4587_cov_14.431150	4355	4435	378	1	80	0.0125000
NODE_248_length_4587_cov_14.431150	4355	4435	381	1	80	0.0125000
NODE_248_length_4587_cov_14.431150	4355	4435	384	1	80	0.0125000
NODE_248_length_4587_cov_14.431150	4355	4435	386	1	80	0.0125000
NODE_248_length_4587_cov_14.431150	4355	4435	387	1	80	0.0125000
NODE_248_length_4587_cov_14.431150	4355	4435	388	1	80	0.0125000
NODE_248_length_4587_cov_14.431150	4355	4435	389	1	80	0.0125000
NODE_248_length_4587_cov_14.431150	4355	4435	391	3	80	0.0375000
NODE_248_length_4587_cov_14.431150	4355	4435	394	1	80	0.0125000
NODE_248_length_4587_cov_14.431150	4355	4435	397	2	80	0.0250000
NODE_248_length_4587_cov_14.431150	4355	4435	398	1	80	0.0125000
NODE_248_length_4587_cov_14.431150	4355	4435	405	2	80	0.0250000
NODE_248_length_4587_cov_14.431150	4355	4435	407	1	80	0.0125000
NODE_248_length_4587_cov_14.431150	4355	4435	414	3	80	0.0375000
NODE_248_length_4587_cov_14.431150	4355	4435	415	2	80	0.0250000
NODE_248_length_4587_cov_14.431150	4355	4435	417	1	80	0.0125000
NODE_248_length_4587_cov_14.431150	4355	4435	418	2	80	0.0250000
NODE_248_length_4587_cov_14.431150	4355	4435	420	1	80	0.0125000
NODE_248_length_4587_cov_14.431150	4355	4435	421	5	80	0.0625000
NODE_248_length_4587_cov_14.431150	4355	4435	422	4	80	0.0500000
NODE_248_length_4587_cov_14.431150	4355	4435	423	2	80	0.0250000
NODE_248_length_4587_cov_14.431150	4355	4435	424	1	80	0.0125000
NODE_248_length_4587_cov_14.431150	4355	4435	425	1	80	0.0125000
NODE_248_length_4587_cov_14.431150	4355	4435	427	2	80	0.0250000
NODE_248_length_4587_cov_14.431150	4355	4435	428	3	80	0.0375000
NODE_248_length_4587_cov_14.431150	4355	4435	430	3	80	0.0375000
NODE_248_length_4587_cov_14.431150	4355	4435	433	2	80	0.0250000
NODE_248_length_4587_cov_14.431150	4355	4435	434	5	80	0.0625000
NODE_248_length_4587_cov_14.431150	4355	4435	435	1	80	0.0125000
NODE_248_length_4587_cov_14.431150	4355	4435	437	1	80	0.0125000
NODE_248_length_4587_cov_14.431150	4355	4435	438	1	80	0.0125000
NODE_248_length_4587_cov_14.431150	4355	4435	441	2	80	0.0250000
NODE_248_length_4587_cov_14.431150	4355	4435	442	1	80	0.0125000
NODE_248_length_4587_cov_14.431150	4355	4435	443	1	80	0.0125000
NODE_248_length_4587_cov_14.431150	4355	4435	444	4	80	0.0500000
NODE_248_length_4587_cov_14.431150	4355	4435	445	4	80	0.0500000
NODE_248_length_4587_cov_14.431150	4355	4435	446	4	80	0.0500000
NODE_248_length_4587_cov_14.431150	4355	4435	448	3	80	0.0375000
NODE_248_length_4587_cov_14.431150	4355	4435	450	1	80	0.0125000
NODE_249_length_4572_cov_50.244579	2406	2483	0	8	77	0.1038961
NODE_249_length_4572_cov_50.244579	2406	2483	2	38	77	0.4935065
NODE_249_length_4572_cov_50.244579	2406	2483	4	31	77	0.4025974
NODE_249_length_4572_cov_50.244579	2406	2483	0	8	77	0.1038961
NODE_249_length_4572_cov_50.244579	2406	2483	2	38	77	0.4935065
NODE_249_length_4572_cov_50.244579	2406	2483	4	31	77	0.4025974
NODE_251_length_4556_cov_14.556652	4229	4288	34	1	59	0.0169492
NODE_251_length_4556_cov_14.556652	4229	4288	36	6	59	0.1016949
NODE_251_length_4556_cov_14.556652	4229	4288	38	4	59	0.0677966
NODE_251_length_4556_cov_14.556652	4229	4288	39	5	59	0.0847458
NODE_251_length_4556_cov_14.556652	4229	4288	41	1	59	0.0169492
NODE_251_length_4556_cov_14.556652	4229	4288	42	4	59	0.0677966
NODE_251_length_4556_cov_14.556652	4229	4288	43	4	59	0.0677966
NODE_251_length_4556_cov_14.556652	4229	4288	44	2	59	0.0338983
NODE_251_length_4556_cov_14.556652	4229	4288	45	5	59	0.0847458
NODE_251_length_4556_cov_14.556652	4229	4288	46	4	59	0.0677966
NODE_251_length_4556_cov_14.556652	4229	4288	47	1	59	0.0169492
NODE_251_length_4556_cov_14.556652	4229	4288	52	1	59	0.0169492
NODE_251_length_4556_cov_14.556652	4229	4288	53	2	59	0.0338983
NODE_251_length_4556_cov_14.556652	4229	4288	54	4	59	0.0677966
NODE_251_length_4556_cov_14.556652	4229	4288	56	7	59	0.1186441
NODE_251_length_4556_cov_14.556652	4229	4288	57	4	59	0.0677966
NODE_251_length_4556_cov_14.556652	4229	4288	58	4	59	0.0677966
NODE_252_length_4550_cov_5.664120	3548	3628	0	15	80	0.1875000
NODE_252_length_4550_cov_5.664120	3548	3628	2	65	80	0.8125000
NODE_252_length_4550_cov_5.664120	3601	3681	0	45	80	0.5625000
NODE_252_length_4550_cov_5.664120	3601	3681	2	35	80	0.4375000
NODE_253_length_4544_cov_10.690439	353	433	0	80	80	1.0000000
NODE_253_length_4544_cov_10.690439	406	486	0	80	80	1.0000000
NODE_253_length_4544_cov_10.690439	4487	4544	0	57	57	1.0000000
NODE_255_length_4535_cov_24.849188	675	755	0	80	80	1.0000000
NODE_255_length_4535_cov_24.849188	728	809	0	81	81	1.0000000
NODE_255_length_4535_cov_24.849188	1319	1399	0	62	80	0.7750000
NODE_255_length_4535_cov_24.849188	1319	1399	1	8	80	0.1000000
NODE_255_length_4535_cov_24.849188	1319	1399	6	10	80	0.1250000
NODE_255_length_4535_cov_24.849188	1372	1452	0	9	80	0.1125000
NODE_255_length_4535_cov_24.849188	1372	1452	1	8	80	0.1000000
NODE_255_length_4535_cov_24.849188	1372	1452	6	28	80	0.3500000
NODE_255_length_4535_cov_24.849188	1372	1452	8	3	80	0.0375000
NODE_255_length_4535_cov_24.849188	1372	1452	18	1	80	0.0125000
NODE_255_length_4535_cov_24.849188	1372	1452	24	1	80	0.0125000
NODE_255_length_4535_cov_24.849188	1372	1452	28	1	80	0.0125000
NODE_255_length_4535_cov_24.849188	1372	1452	30	3	80	0.0375000
NODE_255_length_4535_cov_24.849188	1372	1452	36	1	80	0.0125000
NODE_255_length_4535_cov_24.849188	1372	1452	37	1	80	0.0125000
NODE_255_length_4535_cov_24.849188	1372	1452	38	1	80	0.0125000
NODE_255_length_4535_cov_24.849188	1372	1452	39	3	80	0.0375000
NODE_255_length_4535_cov_24.849188	1372	1452	51	1	80	0.0125000
NODE_255_length_4535_cov_24.849188	1372	1452	53	2	80	0.0250000
NODE_255_length_4535_cov_24.849188	1372	1452	55	1	80	0.0125000
NODE_255_length_4535_cov_24.849188	1372	1452	57	1	80	0.0125000
NODE_255_length_4535_cov_24.849188	1372	1452	62	2	80	0.0250000
NODE_255_length_4535_cov_24.849188	1372	1452	66	1	80	0.0125000
NODE_255_length_4535_cov_24.849188	1372	1452	68	1	80	0.0125000
NODE_255_length_4535_cov_24.849188	1372	1452	70	1	80	0.0125000
NODE_255_length_4535_cov_24.849188	1372	1452	72	2	80	0.0250000
NODE_255_length_4535_cov_24.849188	1372	1452	76	1	80	0.0125000
NODE_255_length_4535_cov_24.849188	1372	1452	78	2	80	0.0250000
NODE_255_length_4535_cov_24.849188	1372	1452	80	2	80	0.0250000
NODE_255_length_4535_cov_24.849188	1372	1452	85	2	80	0.0250000
NODE_255_length_4535_cov_24.849188	1372	1452	87	1	80	0.0125000
NODE_258_length_4528_cov_19.736509	4295	4366	0	68	71	0.9577465
NODE_258_length_4528_cov_19.736509	4295	4366	8	1	71	0.0140845
NODE_258_length_4528_cov_19.736509	4295	4366	12	1	71	0.0140845
NODE_258_length_4528_cov_19.736509	4295	4366	23	1	71	0.0140845
NODE_259_length_4505_cov_10.409215	3166	3202	6	17	36	0.4722222
NODE_259_length_4505_cov_10.409215	3166	3202	8	10	36	0.2777778
NODE_259_length_4505_cov_10.409215	3166	3202	10	3	36	0.0833333
NODE_259_length_4505_cov_10.409215	3166	3202	14	5	36	0.1388889
NODE_259_length_4505_cov_10.409215	3166	3202	16	1	36	0.0277778
NODE_259_length_4505_cov_10.409215	3175	3255	6	8	80	0.1000000
NODE_259_length_4505_cov_10.409215	3175	3255	8	10	80	0.1250000
NODE_259_length_4505_cov_10.409215	3175	3255	10	3	80	0.0375000
NODE_259_length_4505_cov_10.409215	3175	3255	12	4	80	0.0500000
NODE_259_length_4505_cov_10.409215	3175	3255	14	44	80	0.5500000
NODE_259_length_4505_cov_10.409215	3175	3255	16	11	80	0.1375000
NODE_260_length_4498_cov_8.216185	3161	3219	0	58	58	1.0000000
NODE_260_length_4498_cov_8.216185	4257	4314	0	57	57	1.0000000
NODE_263_length_4476_cov_29.825451	141	215	4	7	74	0.0945946
NODE_263_length_4476_cov_29.825451	141	215	8	6	74	0.0810811
NODE_263_length_4476_cov_29.825451	141	215	12	61	74	0.8243243
NODE_263_length_4476_cov_29.825451	1890	1970	16	4	80	0.0500000
NODE_263_length_4476_cov_29.825451	1890	1970	18	9	80	0.1125000
NODE_263_length_4476_cov_29.825451	1890	1970	19	7	80	0.0875000
NODE_263_length_4476_cov_29.825451	1890	1970	20	1	80	0.0125000
NODE_263_length_4476_cov_29.825451	1890	1970	24	7	80	0.0875000
NODE_263_length_4476_cov_29.825451	1890	1970	26	7	80	0.0875000
NODE_263_length_4476_cov_29.825451	1890	1970	28	25	80	0.3125000
NODE_263_length_4476_cov_29.825451	1890	1970	30	13	80	0.1625000
NODE_263_length_4476_cov_29.825451	1890	1970	32	7	80	0.0875000
NODE_263_length_4476_cov_29.825451	1943	2023	16	2	80	0.0250000
NODE_263_length_4476_cov_29.825451	1943	2023	18	10	80	0.1250000
NODE_263_length_4476_cov_29.825451	1943	2023	20	15	80	0.1875000
NODE_263_length_4476_cov_29.825451	1943	2023	22	14	80	0.1750000
NODE_263_length_4476_cov_29.825451	1943	2023	24	10	80	0.1250000
NODE_263_length_4476_cov_29.825451	1943	2023	25	1	80	0.0125000
NODE_263_length_4476_cov_29.825451	1943	2023	26	6	80	0.0750000
NODE_263_length_4476_cov_29.825451	1943	2023	28	7	80	0.0875000
NODE_263_length_4476_cov_29.825451	1943	2023	30	12	80	0.1500000
NODE_263_length_4476_cov_29.825451	1943	2023	32	3	80	0.0375000
NODE_264_length_4474_cov_17.051886	23	99	0	76	76	1.0000000
NODE_264_length_4474_cov_17.051886	23	98	0	75	75	1.0000000
NODE_264_length_4474_cov_17.051886	23	99	0	76	76	1.0000000
NODE_264_length_4474_cov_17.051886	32	99	0	67	67	1.0000000
NODE_264_length_4474_cov_17.051886	76	140	0	64	64	1.0000000
NODE_264_length_4474_cov_17.051886	1528	1569	90	1	41	0.0243902
NODE_264_length_4474_cov_17.051886	1528	1569	94	1	41	0.0243902
NODE_264_length_4474_cov_17.051886	1528	1569	97	2	41	0.0487805
NODE_264_length_4474_cov_17.051886	1528	1569	98	1	41	0.0243902
NODE_264_length_4474_cov_17.051886	1528	1569	102	3	41	0.0731707
NODE_264_length_4474_cov_17.051886	1528	1569	105	1	41	0.0243902
NODE_264_length_4474_cov_17.051886	1528	1569	107	1	41	0.0243902
NODE_264_length_4474_cov_17.051886	1528	1569	109	1	41	0.0243902
NODE_264_length_4474_cov_17.051886	1528	1569	111	1	41	0.0243902
NODE_264_length_4474_cov_17.051886	1528	1569	116	1	41	0.0243902
NODE_264_length_4474_cov_17.051886	1528	1569	121	1	41	0.0243902
NODE_264_length_4474_cov_17.051886	1528	1569	124	1	41	0.0243902
NODE_264_length_4474_cov_17.051886	1528	1569	127	1	41	0.0243902
NODE_264_length_4474_cov_17.051886	1528	1569	131	1	41	0.0243902
NODE_264_length_4474_cov_17.051886	1528	1569	135	1	41	0.0243902
NODE_264_length_4474_cov_17.051886	1528	1569	137	1	41	0.0243902
NODE_264_length_4474_cov_17.051886	1528	1569	144	1	41	0.0243902
NODE_264_length_4474_cov_17.051886	1528	1569	148	1	41	0.0243902
NODE_264_length_4474_cov_17.051886	1528	1569	166	1	41	0.0243902
NODE_264_length_4474_cov_17.051886	1528	1569	171	1	41	0.0243902
NODE_264_length_4474_cov_17.051886	1528	1569	173	2	41	0.0487805
NODE_264_length_4474_cov_17.051886	1528	1569	178	1	41	0.0243902
NODE_264_length_4474_cov_17.051886	1528	1569	184	1	41	0.0243902
NODE_264_length_4474_cov_17.051886	1528	1569	186	1	41	0.0243902
NODE_264_length_4474_cov_17.051886	1528	1569	190	1	41	0.0243902
NODE_264_length_4474_cov_17.051886	1528	1569	198	1	41	0.0243902
NODE_264_length_4474_cov_17.051886	1528	1569	203	1	41	0.0243902
NODE_264_length_4474_cov_17.051886	1528	1569	207	2	41	0.0487805
NODE_264_length_4474_cov_17.051886	1528	1569	221	1	41	0.0243902
NODE_264_length_4474_cov_17.051886	1528	1569	222	1	41	0.0243902
NODE_264_length_4474_cov_17.051886	1528	1569	229	1	41	0.0243902
NODE_264_length_4474_cov_17.051886	1528	1569	230	1	41	0.0243902
NODE_264_length_4474_cov_17.051886	1528	1569	233	1	41	0.0243902
NODE_264_length_4474_cov_17.051886	1528	1569	239	1	41	0.0243902
NODE_264_length_4474_cov_17.051886	1528	1569	245	1	41	0.0243902
NODE_264_length_4474_cov_17.051886	1528	1569	247	1	41	0.0243902
NODE_264_length_4474_cov_17.051886	1536	1609	31	1	73	0.0136986
NODE_264_length_4474_cov_17.051886	1536	1609	36	1	73	0.0136986
NODE_264_length_4474_cov_17.051886	1536	1609	37	3	73	0.0410959
NODE_264_length_4474_cov_17.051886	1536	1609	39	1	73	0.0136986
NODE_264_length_4474_cov_17.051886	1536	1609	40	2	73	0.0273973
NODE_264_length_4474_cov_17.051886	1536	1609	43	4	73	0.0547945
NODE_264_length_4474_cov_17.051886	1536	1609	44	2	73	0.0273973
NODE_264_length_4474_cov_17.051886	1536	1609	52	2	73	0.0273973
NODE_264_length_4474_cov_17.051886	1536	1609	54	1	73	0.0136986
NODE_264_length_4474_cov_17.051886	1536	1609	57	3	73	0.0410959
NODE_264_length_4474_cov_17.051886	1536	1609	59	1	73	0.0136986
NODE_264_length_4474_cov_17.051886	1536	1609	61	6	73	0.0821918
NODE_264_length_4474_cov_17.051886	1536	1609	67	1	73	0.0136986
NODE_264_length_4474_cov_17.051886	1536	1609	69	3	73	0.0410959
NODE_264_length_4474_cov_17.051886	1536	1609	71	1	73	0.0136986
NODE_264_length_4474_cov_17.051886	1536	1609	75	1	73	0.0136986
NODE_264_length_4474_cov_17.051886	1536	1609	76	1	73	0.0136986
NODE_264_length_4474_cov_17.051886	1536	1609	80	4	73	0.0547945
NODE_264_length_4474_cov_17.051886	1536	1609	82	1	73	0.0136986
NODE_264_length_4474_cov_17.051886	1536	1609	88	1	73	0.0136986
NODE_264_length_4474_cov_17.051886	1536	1609	90	1	73	0.0136986
NODE_264_length_4474_cov_17.051886	1536	1609	94	1	73	0.0136986
NODE_264_length_4474_cov_17.051886	1536	1609	97	2	73	0.0273973
NODE_264_length_4474_cov_17.051886	1536	1609	98	1	73	0.0136986
NODE_264_length_4474_cov_17.051886	1536	1609	102	3	73	0.0410959
NODE_264_length_4474_cov_17.051886	1536	1609	105	1	73	0.0136986
NODE_264_length_4474_cov_17.051886	1536	1609	107	1	73	0.0136986
NODE_264_length_4474_cov_17.051886	1536	1609	109	1	73	0.0136986
NODE_264_length_4474_cov_17.051886	1536	1609	111	1	73	0.0136986
NODE_264_length_4474_cov_17.051886	1536	1609	116	1	73	0.0136986
NODE_264_length_4474_cov_17.051886	1536	1609	121	1	73	0.0136986
NODE_264_length_4474_cov_17.051886	1536	1609	124	1	73	0.0136986
NODE_264_length_4474_cov_17.051886	1536	1609	127	1	73	0.0136986
NODE_264_length_4474_cov_17.051886	1536	1609	131	1	73	0.0136986
NODE_264_length_4474_cov_17.051886	1536	1609	135	1	73	0.0136986
NODE_264_length_4474_cov_17.051886	1536	1609	137	1	73	0.0136986
NODE_264_length_4474_cov_17.051886	1536	1609	144	1	73	0.0136986
NODE_264_length_4474_cov_17.051886	1536	1609	148	1	73	0.0136986
NODE_264_length_4474_cov_17.051886	1536	1609	166	1	73	0.0136986
NODE_264_length_4474_cov_17.051886	1536	1609	171	1	73	0.0136986
NODE_264_length_4474_cov_17.051886	1536	1609	173	2	73	0.0273973
NODE_264_length_4474_cov_17.051886	1536	1609	178	1	73	0.0136986
NODE_264_length_4474_cov_17.051886	1536	1609	184	1	73	0.0136986
NODE_264_length_4474_cov_17.051886	1536	1609	186	1	73	0.0136986
NODE_264_length_4474_cov_17.051886	1536	1609	190	1	73	0.0136986
NODE_264_length_4474_cov_17.051886	1536	1609	198	1	73	0.0136986
NODE_264_length_4474_cov_17.051886	1536	1609	203	1	73	0.0136986
NODE_264_length_4474_cov_17.051886	1536	1609	207	2	73	0.0273973
NODE_264_length_4474_cov_17.051886	1618	1643	0	19	25	0.7600000
NODE_264_length_4474_cov_17.051886	1618	1643	4	2	25	0.0800000
NODE_264_length_4474_cov_17.051886	1618	1643	11	2	25	0.0800000
NODE_264_length_4474_cov_17.051886	1618	1643	15	1	25	0.0400000
NODE_264_length_4474_cov_17.051886	1618	1643	16	1	25	0.0400000
NODE_264_length_4474_cov_17.051886	1618	1696	0	72	78	0.9230769
NODE_264_length_4474_cov_17.051886	1618	1696	4	2	78	0.0256410
NODE_264_length_4474_cov_17.051886	1618	1696	11	2	78	0.0256410
NODE_264_length_4474_cov_17.051886	1618	1696	15	1	78	0.0128205
NODE_264_length_4474_cov_17.051886	1618	1696	16	1	78	0.0128205
NODE_265_length_4474_cov_14.441829	282	362	0	80	80	1.0000000
NODE_265_length_4474_cov_14.441829	335	415	0	76	80	0.9500000
NODE_265_length_4474_cov_14.441829	335	415	6	1	80	0.0125000
NODE_265_length_4474_cov_14.441829	335	415	18	1	80	0.0125000
NODE_265_length_4474_cov_14.441829	335	415	31	1	80	0.0125000
NODE_265_length_4474_cov_14.441829	335	415	38	1	80	0.0125000
NODE_265_length_4474_cov_14.441829	1522	1575	2	49	53	0.9245283
NODE_265_length_4474_cov_14.441829	1522	1575	16	4	53	0.0754717
NODE_265_length_4474_cov_14.441829	1548	1623	2	45	75	0.6000000
NODE_265_length_4474_cov_14.441829	1548	1623	4	13	75	0.1733333
NODE_265_length_4474_cov_14.441829	1548	1623	6	1	75	0.0133333
NODE_265_length_4474_cov_14.441829	1548	1623	8	16	75	0.2133333
NODE_265_length_4474_cov_14.441829	3068	3121	0	48	53	0.9056604
NODE_265_length_4474_cov_14.441829	3068	3121	1	3	53	0.0566038
NODE_265_length_4474_cov_14.441829	3068	3121	11	2	53	0.0377358
NODE_268_length_4463_cov_7.023144	119	168	0	44	49	0.8979592
NODE_268_length_4463_cov_7.023144	119	168	8	5	49	0.1020408
NODE_270_length_4453_cov_16.820395	3383	3463	44	1	80	0.0125000
NODE_270_length_4453_cov_16.820395	3383	3463	46	3	80	0.0375000
NODE_270_length_4453_cov_16.820395	3383	3463	47	2	80	0.0250000
NODE_270_length_4453_cov_16.820395	3383	3463	53	1	80	0.0125000
NODE_270_length_4453_cov_16.820395	3383	3463	58	4	80	0.0500000
NODE_270_length_4453_cov_16.820395	3383	3463	64	2	80	0.0250000
NODE_270_length_4453_cov_16.820395	3383	3463	66	10	80	0.1250000
NODE_270_length_4453_cov_16.820395	3383	3463	70	14	80	0.1750000
NODE_270_length_4453_cov_16.820395	3383	3463	72	10	80	0.1250000
NODE_270_length_4453_cov_16.820395	3383	3463	74	1	80	0.0125000
NODE_270_length_4453_cov_16.820395	3383	3463	76	8	80	0.1000000
NODE_270_length_4453_cov_16.820395	3383	3463	78	3	80	0.0375000
NODE_270_length_4453_cov_16.820395	3383	3463	80	3	80	0.0375000
NODE_270_length_4453_cov_16.820395	3383	3463	82	6	80	0.0750000
NODE_270_length_4453_cov_16.820395	3383	3463	83	2	80	0.0250000
NODE_270_length_4453_cov_16.820395	3383	3463	84	2	80	0.0250000
NODE_270_length_4453_cov_16.820395	3383	3463	85	5	80	0.0625000
NODE_270_length_4453_cov_16.820395	3383	3463	86	3	80	0.0375000
NODE_270_length_4453_cov_16.820395	3436	3496	14	4	60	0.0666667
NODE_270_length_4453_cov_16.820395	3436	3496	16	8	60	0.1333333
NODE_270_length_4453_cov_16.820395	3436	3496	22	5	60	0.0833333
NODE_270_length_4453_cov_16.820395	3436	3496	24	5	60	0.0833333
NODE_270_length_4453_cov_16.820395	3436	3496	34	3	60	0.0500000
NODE_270_length_4453_cov_16.820395	3436	3496	40	1	60	0.0166667
NODE_270_length_4453_cov_16.820395	3436	3496	42	7	60	0.1166667
NODE_270_length_4453_cov_16.820395	3436	3496	44	1	60	0.0166667
NODE_270_length_4453_cov_16.820395	3436	3496	46	3	60	0.0500000
NODE_270_length_4453_cov_16.820395	3436	3496	47	2	60	0.0333333
NODE_270_length_4453_cov_16.820395	3436	3496	53	1	60	0.0166667
NODE_270_length_4453_cov_16.820395	3436	3496	58	4	60	0.0666667
NODE_270_length_4453_cov_16.820395	3436	3496	64	2	60	0.0333333
NODE_270_length_4453_cov_16.820395	3436	3496	66	10	60	0.1666667
NODE_270_length_4453_cov_16.820395	3436	3496	70	4	60	0.0666667
NODE_272_length_4436_cov_31.114595	2807	2871	13	4	64	0.0625000
NODE_272_length_4436_cov_31.114595	2807	2871	14	12	64	0.1875000
NODE_272_length_4436_cov_31.114595	2807	2871	16	4	64	0.0625000
NODE_272_length_4436_cov_31.114595	2807	2871	18	3	64	0.0468750
NODE_272_length_4436_cov_31.114595	2807	2871	20	7	64	0.1093750
NODE_272_length_4436_cov_31.114595	2807	2871	30	4	64	0.0625000
NODE_272_length_4436_cov_31.114595	2807	2871	32	8	64	0.1250000
NODE_272_length_4436_cov_31.114595	2807	2871	34	7	64	0.1093750
NODE_272_length_4436_cov_31.114595	2807	2871	36	15	64	0.2343750
NODE_272_length_4436_cov_31.114595	2846	2906	0	23	60	0.3833333
NODE_272_length_4436_cov_31.114595	2846	2906	2	5	60	0.0833333
NODE_272_length_4436_cov_31.114595	2846	2906	3	5	60	0.0833333
NODE_272_length_4436_cov_31.114595	2846	2906	5	1	60	0.0166667
NODE_272_length_4436_cov_31.114595	2846	2906	13	5	60	0.0833333
NODE_272_length_4436_cov_31.114595	2846	2906	14	12	60	0.2000000
NODE_272_length_4436_cov_31.114595	2846	2906	16	4	60	0.0666667
NODE_272_length_4436_cov_31.114595	2846	2906	18	3	60	0.0500000
NODE_272_length_4436_cov_31.114595	2846	2906	20	2	60	0.0333333
NODE_272_length_4436_cov_31.114595	2846	2898	0	15	52	0.2884615
NODE_272_length_4436_cov_31.114595	2846	2898	2	5	52	0.0961538
NODE_272_length_4436_cov_31.114595	2846	2898	3	5	52	0.0961538
NODE_272_length_4436_cov_31.114595	2846	2898	5	1	52	0.0192308
NODE_272_length_4436_cov_31.114595	2846	2898	13	5	52	0.0961538
NODE_272_length_4436_cov_31.114595	2846	2898	14	12	52	0.2307692
NODE_272_length_4436_cov_31.114595	2846	2898	16	4	52	0.0769231
NODE_272_length_4436_cov_31.114595	2846	2898	18	3	52	0.0576923
NODE_272_length_4436_cov_31.114595	2846	2898	20	2	52	0.0384615
NODE_278_length_4391_cov_7.711323	66	141	0	6	75	0.0800000
NODE_278_length_4391_cov_7.711323	66	141	2	69	75	0.9200000
NODE_278_length_4391_cov_7.711323	119	155	0	15	36	0.4166667
NODE_278_length_4391_cov_7.711323	119	155	2	21	36	0.5833333
NODE_279_length_4385_cov_6.067662	1556	1606	0	3	50	0.0600000
NODE_279_length_4385_cov_6.067662	1556	1606	2	1	50	0.0200000
NODE_279_length_4385_cov_6.067662	1556	1606	6	2	50	0.0400000
NODE_279_length_4385_cov_6.067662	1556	1606	8	6	50	0.1200000
NODE_279_length_4385_cov_6.067662	1556	1606	10	11	50	0.2200000
NODE_279_length_4385_cov_6.067662	1556	1606	12	24	50	0.4800000
NODE_279_length_4385_cov_6.067662	1556	1606	14	3	50	0.0600000
NODE_286_length_4331_cov_37.938800	1898	1978	9	16	80	0.2000000
NODE_286_length_4331_cov_37.938800	1898	1978	10	3	80	0.0375000
NODE_286_length_4331_cov_37.938800	1898	1978	14	1	80	0.0125000
NODE_286_length_4331_cov_37.938800	1898	1978	16	27	80	0.3375000
NODE_286_length_4331_cov_37.938800	1898	1978	17	1	80	0.0125000
NODE_286_length_4331_cov_37.938800	1898	1978	18	14	80	0.1750000
NODE_286_length_4331_cov_37.938800	1898	1978	21	1	80	0.0125000
NODE_286_length_4331_cov_37.938800	1898	1978	22	5	80	0.0625000
NODE_286_length_4331_cov_37.938800	1898	1978	24	12	80	0.1500000
NODE_286_length_4331_cov_37.938800	1951	2031	9	1	80	0.0125000
NODE_286_length_4331_cov_37.938800	1951	2031	16	7	80	0.0875000
NODE_286_length_4331_cov_37.938800	1951	2031	17	1	80	0.0125000
NODE_286_length_4331_cov_37.938800	1951	2031	21	1	80	0.0125000
NODE_286_length_4331_cov_37.938800	1951	2031	22	5	80	0.0625000
NODE_286_length_4331_cov_37.938800	1951	2031	24	12	80	0.1500000
NODE_286_length_4331_cov_37.938800	1951	2031	29	2	80	0.0250000
NODE_286_length_4331_cov_37.938800	1951	2031	30	20	80	0.2500000
NODE_286_length_4331_cov_37.938800	1951	2031	38	1	80	0.0125000
NODE_286_length_4331_cov_37.938800	1951	2031	39	12	80	0.1500000
NODE_286_length_4331_cov_37.938800	1951	2031	41	8	80	0.1000000
NODE_286_length_4331_cov_37.938800	1951	2031	43	2	80	0.0250000
NODE_286_length_4331_cov_37.938800	1951	2031	55	2	80	0.0250000
NODE_286_length_4331_cov_37.938800	1951	2031	56	1	80	0.0125000
NODE_286_length_4331_cov_37.938800	1951	2031	57	5	80	0.0625000
NODE_286_length_4331_cov_37.938800	2027	2107	57	5	80	0.0625000
NODE_286_length_4331_cov_37.938800	2027	2107	70	6	80	0.0750000
NODE_286_length_4331_cov_37.938800	2027	2107	72	29	80	0.3625000
NODE_286_length_4331_cov_37.938800	2027	2107	74	3	80	0.0375000
NODE_286_length_4331_cov_37.938800	2027	2107	76	1	80	0.0125000
NODE_286_length_4331_cov_37.938800	2027	2107	77	7	80	0.0875000
NODE_286_length_4331_cov_37.938800	2027	2107	78	3	80	0.0375000
NODE_286_length_4331_cov_37.938800	2027	2107	85	1	80	0.0125000
NODE_286_length_4331_cov_37.938800	2027	2107	87	6	80	0.0750000
NODE_286_length_4331_cov_37.938800	2027	2107	94	2	80	0.0250000
NODE_286_length_4331_cov_37.938800	2027	2107	96	3	80	0.0375000
NODE_286_length_4331_cov_37.938800	2027	2107	98	1	80	0.0125000
NODE_286_length_4331_cov_37.938800	2027	2107	99	8	80	0.1000000
NODE_286_length_4331_cov_37.938800	2027	2107	100	1	80	0.0125000
NODE_286_length_4331_cov_37.938800	2027	2107	103	1	80	0.0125000
NODE_286_length_4331_cov_37.938800	2027	2107	104	3	80	0.0375000
NODE_286_length_4331_cov_37.938800	2080	2160	34	10	80	0.1250000
NODE_286_length_4331_cov_37.938800	2080	2160	55	2	80	0.0250000
NODE_286_length_4331_cov_37.938800	2080	2160	56	13	80	0.1625000
NODE_286_length_4331_cov_37.938800	2080	2160	57	4	80	0.0500000
NODE_286_length_4331_cov_37.938800	2080	2160	69	3	80	0.0375000
NODE_286_length_4331_cov_37.938800	2080	2160	72	1	80	0.0125000
NODE_286_length_4331_cov_37.938800	2080	2160	77	2	80	0.0250000
NODE_286_length_4331_cov_37.938800	2080	2160	78	5	80	0.0625000
NODE_286_length_4331_cov_37.938800	2080	2160	80	2	80	0.0250000
NODE_286_length_4331_cov_37.938800	2080	2160	81	5	80	0.0625000
NODE_286_length_4331_cov_37.938800	2080	2160	82	2	80	0.0250000
NODE_286_length_4331_cov_37.938800	2080	2160	85	1	80	0.0125000
NODE_286_length_4331_cov_37.938800	2080	2160	87	6	80	0.0750000
NODE_286_length_4331_cov_37.938800	2080	2160	94	5	80	0.0625000
NODE_286_length_4331_cov_37.938800	2080	2160	96	5	80	0.0625000
NODE_286_length_4331_cov_37.938800	2080	2160	98	1	80	0.0125000
NODE_286_length_4331_cov_37.938800	2080	2160	99	8	80	0.1000000
NODE_286_length_4331_cov_37.938800	2080	2160	100	1	80	0.0125000
NODE_286_length_4331_cov_37.938800	2080	2160	103	1	80	0.0125000
NODE_286_length_4331_cov_37.938800	2080	2160	104	3	80	0.0375000
NODE_289_length_4320_cov_7.680881	442	522	0	80	80	1.0000000
NODE_289_length_4320_cov_7.680881	495	575	0	80	80	1.0000000
NODE_289_length_4320_cov_7.680881	571	651	0	80	80	1.0000000
NODE_289_length_4320_cov_7.680881	624	704	0	80	80	1.0000000
NODE_290_length_4314_cov_5.311507	1436	1516	0	80	80	1.0000000
NODE_290_length_4314_cov_5.311507	1489	1569	0	80	80	1.0000000
NODE_290_length_4314_cov_5.311507	3331	3400	0	46	69	0.6666667
NODE_290_length_4314_cov_5.311507	3331	3400	2	23	69	0.3333333
NODE_290_length_4314_cov_5.311507	3420	3482	0	13	62	0.2096774
NODE_290_length_4314_cov_5.311507	3420	3482	2	49	62	0.7903226
NODE_292_length_4311_cov_8.733381	92	171	14	7	79	0.0886076
NODE_292_length_4311_cov_8.733381	92	171	18	1	79	0.0126582
NODE_292_length_4311_cov_8.733381	92	171	20	5	79	0.0632911
NODE_292_length_4311_cov_8.733381	92	171	22	42	79	0.5316456
NODE_292_length_4311_cov_8.733381	92	171	24	3	79	0.0379747
NODE_292_length_4311_cov_8.733381	92	171	26	1	79	0.0126582
NODE_292_length_4311_cov_8.733381	92	171	28	20	79	0.2531646
NODE_292_length_4311_cov_8.733381	1925	2005	0	35	80	0.4375000
NODE_292_length_4311_cov_8.733381	1925	2005	2	45	80	0.5625000
NODE_292_length_4311_cov_8.733381	1978	2058	2	80	80	1.0000000
NODE_294_length_4293_cov_3.809251	244	326	0	82	82	1.0000000
NODE_294_length_4293_cov_3.809251	301	394	0	93	93	1.0000000
NODE_295_length_4284_cov_15.940263	3726	3806	0	80	80	1.0000000
NODE_295_length_4284_cov_15.940263	3779	3858	0	79	79	1.0000000
NODE_299_length_4277_cov_5.451173	3818	3898	4	2	80	0.0250000
NODE_299_length_4277_cov_5.451173	3818	3898	6	2	80	0.0250000
NODE_299_length_4277_cov_5.451173	3818	3898	8	4	80	0.0500000
NODE_299_length_4277_cov_5.451173	3818	3898	10	72	80	0.9000000
NODE_299_length_4277_cov_5.451173	3927	3995	0	23	68	0.3382353
NODE_299_length_4277_cov_5.451173	3927	3995	2	2	68	0.0294118
NODE_299_length_4277_cov_5.451173	3927	3995	3	1	68	0.0147059
NODE_299_length_4277_cov_5.451173	3927	3995	4	33	68	0.4852941
NODE_299_length_4277_cov_5.451173	3927	3995	8	9	68	0.1323529
NODE_299_length_4277_cov_5.451173	3968	4048	0	76	80	0.9500000
NODE_299_length_4277_cov_5.451173	3968	4048	2	2	80	0.0250000
NODE_299_length_4277_cov_5.451173	3968	4048	3	1	80	0.0125000
NODE_299_length_4277_cov_5.451173	3968	4048	4	1	80	0.0125000
NODE_300_length_4274_cov_18.943234	591	671	0	80	80	1.0000000
NODE_300_length_4274_cov_18.943234	644	724	0	80	80	1.0000000
NODE_301_length_4274_cov_16.160958	416	496	0	63	80	0.7875000
NODE_301_length_4274_cov_16.160958	416	496	2	17	80	0.2125000
NODE_301_length_4274_cov_16.160958	1034	1114	0	20	80	0.2500000
NODE_301_length_4274_cov_16.160958	1034	1114	1	60	80	0.7500000
NODE_301_length_4274_cov_16.160958	1087	1167	0	73	80	0.9125000
NODE_301_length_4274_cov_16.160958	1087	1167	1	7	80	0.0875000
NODE_301_length_4274_cov_16.160958	1163	1243	0	60	80	0.7500000
NODE_301_length_4274_cov_16.160958	1163	1243	4	20	80	0.2500000
NODE_301_length_4274_cov_16.160958	1216	1296	0	7	80	0.0875000
NODE_301_length_4274_cov_16.160958	1216	1296	4	73	80	0.9125000
NODE_301_length_4274_cov_16.160958	3411	3491	0	2	80	0.0250000
NODE_301_length_4274_cov_16.160958	3411	3491	2	18	80	0.2250000
NODE_301_length_4274_cov_16.160958	3411	3491	6	47	80	0.5875000
NODE_301_length_4274_cov_16.160958	3411	3491	8	2	80	0.0250000
NODE_301_length_4274_cov_16.160958	3411	3491	9	1	80	0.0125000
NODE_301_length_4274_cov_16.160958	3411	3491	11	3	80	0.0375000
NODE_301_length_4274_cov_16.160958	3411	3491	13	7	80	0.0875000
NODE_302_length_4270_cov_14.045792	3835	3915	120	1	80	0.0125000
NODE_302_length_4270_cov_14.045792	3835	3915	122	3	80	0.0375000
NODE_302_length_4270_cov_14.045792	3835	3915	123	1	80	0.0125000
NODE_302_length_4270_cov_14.045792	3835	3915	124	5	80	0.0625000
NODE_302_length_4270_cov_14.045792	3835	3915	126	1	80	0.0125000
NODE_302_length_4270_cov_14.045792	3835	3915	129	4	80	0.0500000
NODE_302_length_4270_cov_14.045792	3835	3915	133	1	80	0.0125000
NODE_302_length_4270_cov_14.045792	3835	3915	134	1	80	0.0125000
NODE_302_length_4270_cov_14.045792	3835	3915	135	2	80	0.0250000
NODE_302_length_4270_cov_14.045792	3835	3915	137	5	80	0.0625000
NODE_302_length_4270_cov_14.045792	3835	3915	138	5	80	0.0625000
NODE_302_length_4270_cov_14.045792	3835	3915	139	14	80	0.1750000
NODE_302_length_4270_cov_14.045792	3835	3915	140	8	80	0.1000000
NODE_302_length_4270_cov_14.045792	3835	3915	141	3	80	0.0375000
NODE_302_length_4270_cov_14.045792	3835	3915	142	3	80	0.0375000
NODE_302_length_4270_cov_14.045792	3835	3915	143	10	80	0.1250000
NODE_302_length_4270_cov_14.045792	3835	3915	144	6	80	0.0750000
NODE_302_length_4270_cov_14.045792	3835	3915	145	4	80	0.0500000
NODE_302_length_4270_cov_14.045792	3835	3915	147	3	80	0.0375000
NODE_302_length_4270_cov_14.045792	3888	3968	65	3	80	0.0375000
NODE_302_length_4270_cov_14.045792	3888	3968	67	2	80	0.0250000
NODE_302_length_4270_cov_14.045792	3888	3968	68	1	80	0.0125000
NODE_302_length_4270_cov_14.045792	3888	3968	71	3	80	0.0375000
NODE_302_length_4270_cov_14.045792	3888	3968	72	1	80	0.0125000
NODE_302_length_4270_cov_14.045792	3888	3968	73	1	80	0.0125000
NODE_302_length_4270_cov_14.045792	3888	3968	76	1	80	0.0125000
NODE_302_length_4270_cov_14.045792	3888	3968	78	2	80	0.0250000
NODE_302_length_4270_cov_14.045792	3888	3968	79	2	80	0.0250000
NODE_302_length_4270_cov_14.045792	3888	3968	80	3	80	0.0375000
NODE_302_length_4270_cov_14.045792	3888	3968	82	1	80	0.0125000
NODE_302_length_4270_cov_14.045792	3888	3968	84	2	80	0.0250000
NODE_302_length_4270_cov_14.045792	3888	3968	90	1	80	0.0125000
NODE_302_length_4270_cov_14.045792	3888	3968	95	3	80	0.0375000
NODE_302_length_4270_cov_14.045792	3888	3968	96	1	80	0.0125000
NODE_302_length_4270_cov_14.045792	3888	3968	97	5	80	0.0625000
NODE_302_length_4270_cov_14.045792	3888	3968	101	1	80	0.0125000
NODE_302_length_4270_cov_14.045792	3888	3968	103	4	80	0.0500000
NODE_302_length_4270_cov_14.045792	3888	3968	104	1	80	0.0125000
NODE_302_length_4270_cov_14.045792	3888	3968	111	2	80	0.0250000
NODE_302_length_4270_cov_14.045792	3888	3968	115	1	80	0.0125000
NODE_302_length_4270_cov_14.045792	3888	3968	117	1	80	0.0125000
NODE_302_length_4270_cov_14.045792	3888	3968	119	1	80	0.0125000
NODE_302_length_4270_cov_14.045792	3888	3968	120	1	80	0.0125000
NODE_302_length_4270_cov_14.045792	3888	3968	124	6	80	0.0750000
NODE_302_length_4270_cov_14.045792	3888	3968	125	4	80	0.0500000
NODE_302_length_4270_cov_14.045792	3888	3968	126	4	80	0.0500000
NODE_302_length_4270_cov_14.045792	3888	3968	127	1	80	0.0125000
NODE_302_length_4270_cov_14.045792	3888	3968	129	4	80	0.0500000
NODE_302_length_4270_cov_14.045792	3888	3968	134	1	80	0.0125000
NODE_302_length_4270_cov_14.045792	3888	3968	135	2	80	0.0250000
NODE_302_length_4270_cov_14.045792	3888	3968	137	5	80	0.0625000
NODE_302_length_4270_cov_14.045792	3888	3968	139	1	80	0.0125000
NODE_302_length_4270_cov_14.045792	3888	3968	140	2	80	0.0250000
NODE_302_length_4270_cov_14.045792	3888	3968	144	2	80	0.0250000
NODE_302_length_4270_cov_14.045792	3888	3968	145	1	80	0.0125000
NODE_302_length_4270_cov_14.045792	3888	3968	147	3	80	0.0375000
NODE_303_length_4260_cov_24.780822	244	311	2	34	67	0.5074627
NODE_303_length_4260_cov_24.780822	244	311	4	33	67	0.4925373
NODE_303_length_4260_cov_24.780822	244	311	2	34	67	0.5074627
NODE_303_length_4260_cov_24.780822	244	311	4	33	67	0.4925373
NODE_303_length_4260_cov_24.780822	263	311	2	34	48	0.7083333
NODE_303_length_4260_cov_24.780822	263	311	4	14	48	0.2916667
NODE_303_length_4260_cov_24.780822	1605	1633	2	9	28	0.3214286
NODE_303_length_4260_cov_24.780822	1605	1633	4	8	28	0.2857143
NODE_303_length_4260_cov_24.780822	1605	1633	6	2	28	0.0714286
NODE_303_length_4260_cov_24.780822	1605	1633	8	8	28	0.2857143
NODE_303_length_4260_cov_24.780822	1605	1633	14	1	28	0.0357143
NODE_303_length_4260_cov_24.780822	1660	1699	28	2	39	0.0512821
NODE_303_length_4260_cov_24.780822	1660	1699	30	2	39	0.0512821
NODE_303_length_4260_cov_24.780822	1660	1699	34	1	39	0.0256410
NODE_303_length_4260_cov_24.780822	1660	1699	38	4	39	0.1025641
NODE_303_length_4260_cov_24.780822	1660	1699	39	4	39	0.1025641
NODE_303_length_4260_cov_24.780822	1660	1699	41	1	39	0.0256410
NODE_303_length_4260_cov_24.780822	1660	1699	46	1	39	0.0256410
NODE_303_length_4260_cov_24.780822	1660	1699	50	5	39	0.1282051
NODE_303_length_4260_cov_24.780822	1660	1699	52	3	39	0.0769231
NODE_303_length_4260_cov_24.780822	1660	1699	54	2	39	0.0512821
NODE_303_length_4260_cov_24.780822	1660	1699	58	1	39	0.0256410
NODE_303_length_4260_cov_24.780822	1660	1699	59	4	39	0.1025641
NODE_303_length_4260_cov_24.780822	1660	1699	61	1	39	0.0256410
NODE_303_length_4260_cov_24.780822	1660	1699	62	3	39	0.0769231
NODE_303_length_4260_cov_24.780822	1660	1699	63	5	39	0.1282051
NODE_310_length_4207_cov_6.923564	3664	3722	18	46	58	0.7931035
NODE_310_length_4207_cov_6.923564	3664	3722	20	10	58	0.1724138
NODE_310_length_4207_cov_6.923564	3664	3722	21	1	58	0.0172414
NODE_310_length_4207_cov_6.923564	3664	3722	22	1	58	0.0172414
NODE_310_length_4207_cov_6.923564	3695	3775	10	7	80	0.0875000
NODE_310_length_4207_cov_6.923564	3695	3775	12	23	80	0.2875000
NODE_310_length_4207_cov_6.923564	3695	3775	13	4	80	0.0500000
NODE_310_length_4207_cov_6.923564	3695	3775	14	8	80	0.1000000
NODE_310_length_4207_cov_6.923564	3695	3775	17	1	80	0.0125000
NODE_310_length_4207_cov_6.923564	3695	3775	18	16	80	0.2000000
NODE_310_length_4207_cov_6.923564	3695	3775	20	19	80	0.2375000
NODE_310_length_4207_cov_6.923564	3695	3775	21	1	80	0.0125000
NODE_310_length_4207_cov_6.923564	3695	3775	22	1	80	0.0125000
NODE_311_length_4205_cov_6.121042	592	632	0	40	40	1.0000000
NODE_311_length_4205_cov_6.121042	605	685	0	80	80	1.0000000
NODE_311_length_4205_cov_6.121042	681	745	0	64	64	1.0000000
NODE_312_length_4196_cov_4.170857	340	420	0	80	80	1.0000000
NODE_312_length_4196_cov_4.170857	393	473	0	80	80	1.0000000
NODE_316_length_4179_cov_6.655882	1	65	0	2	64	0.0312500
NODE_316_length_4179_cov_6.655882	1	65	2	4	64	0.0625000
NODE_316_length_4179_cov_6.655882	1	65	4	4	64	0.0625000
NODE_316_length_4179_cov_6.655882	1	65	6	4	64	0.0625000
NODE_316_length_4179_cov_6.655882	1	65	8	12	64	0.1875000
NODE_316_length_4179_cov_6.655882	1	65	10	10	64	0.1562500
NODE_316_length_4179_cov_6.655882	1	65	12	28	64	0.4375000
NODE_316_length_4179_cov_6.655882	1087	1140	0	53	53	1.0000000
NODE_316_length_4179_cov_6.655882	1818	1898	0	80	80	1.0000000
NODE_319_length_4150_cov_10.600099	2827	2849	104	3	22	0.1363636
NODE_319_length_4150_cov_10.600099	2827	2849	106	6	22	0.2727273
NODE_319_length_4150_cov_10.600099	2827	2849	112	5	22	0.2272727
NODE_319_length_4150_cov_10.600099	2827	2849	114	8	22	0.3636364
NODE_319_length_4150_cov_10.600099	2973	3053	8	17	80	0.2125000
NODE_319_length_4150_cov_10.600099	2973	3053	12	16	80	0.2000000
NODE_319_length_4150_cov_10.600099	2973	3053	14	11	80	0.1375000
NODE_319_length_4150_cov_10.600099	2973	3053	18	6	80	0.0750000
NODE_319_length_4150_cov_10.600099	2973	3053	20	24	80	0.3000000
NODE_319_length_4150_cov_10.600099	2973	3053	24	6	80	0.0750000
NODE_319_length_4150_cov_10.600099	3026	3106	18	2	80	0.0250000
NODE_319_length_4150_cov_10.600099	3026	3106	20	25	80	0.3125000
NODE_319_length_4150_cov_10.600099	3026	3106	21	9	80	0.1125000
NODE_319_length_4150_cov_10.600099	3026	3106	22	17	80	0.2125000
NODE_319_length_4150_cov_10.600099	3026	3106	24	11	80	0.1375000
NODE_319_length_4150_cov_10.600099	3026	3106	26	14	80	0.1750000
NODE_319_length_4150_cov_10.600099	3026	3106	27	2	80	0.0250000
NODE_324_length_4119_cov_27.984328	2818	2898	53	3	80	0.0375000
NODE_324_length_4119_cov_27.984328	2818	2898	55	1	80	0.0125000
NODE_324_length_4119_cov_27.984328	2818	2898	57	1	80	0.0125000
NODE_324_length_4119_cov_27.984328	2818	2898	59	2	80	0.0250000
NODE_324_length_4119_cov_27.984328	2818	2898	61	6	80	0.0750000
NODE_324_length_4119_cov_27.984328	2818	2898	71	1	80	0.0125000
NODE_324_length_4119_cov_27.984328	2818	2898	77	3	80	0.0375000
NODE_324_length_4119_cov_27.984328	2818	2898	78	4	80	0.0500000
NODE_324_length_4119_cov_27.984328	2818	2898	79	7	80	0.0875000
NODE_324_length_4119_cov_27.984328	2818	2898	80	31	80	0.3875000
NODE_324_length_4119_cov_27.984328	2818	2898	81	10	80	0.1250000
NODE_324_length_4119_cov_27.984328	2818	2898	82	8	80	0.1000000
NODE_324_length_4119_cov_27.984328	2818	2898	83	3	80	0.0375000
NODE_325_length_4108_cov_14.755550	378	422	0	44	44	1.0000000
NODE_325_length_4108_cov_14.755550	3537	3617	0	80	80	1.0000000
NODE_325_length_4108_cov_14.755550	3590	3670	0	80	80	1.0000000
NODE_326_length_4107_cov_1.855539	207	287	0	80	80	1.0000000
NODE_328_length_4096_cov_31.197648	379	459	0	38	80	0.4750000
NODE_328_length_4096_cov_31.197648	379	459	2	8	80	0.1000000
NODE_328_length_4096_cov_31.197648	379	459	8	34	80	0.4250000
NODE_328_length_4096_cov_31.197648	432	512	6	32	80	0.4000000
NODE_328_length_4096_cov_31.197648	432	512	8	48	80	0.6000000
NODE_328_length_4096_cov_31.197648	3305	3385	0	80	80	1.0000000
NODE_328_length_4096_cov_31.197648	3358	3438	0	80	80	1.0000000
NODE_329_length_4081_cov_20.248870	3673	3753	0	80	80	1.0000000
NODE_329_length_4081_cov_20.248870	3726	3806	0	80	80	1.0000000
NODE_330_length_4076_cov_15.138044	1062	1142	0	80	80	1.0000000
NODE_330_length_4076_cov_15.138044	1115	1195	0	36	80	0.4500000
NODE_330_length_4076_cov_15.138044	1115	1195	2	44	80	0.5500000
NODE_331_length_4069_cov_14.261209	3871	3936	1	12	65	0.1846154
NODE_331_length_4069_cov_14.261209	3871	3936	3	14	65	0.2153846
NODE_331_length_4069_cov_14.261209	3871	3936	4	9	65	0.1384615
NODE_331_length_4069_cov_14.261209	3871	3936	6	30	65	0.4615385
NODE_333_length_4050_cov_31.044039	1703	1783	24	2	80	0.0250000
NODE_333_length_4050_cov_31.044039	1703	1783	26	9	80	0.1125000
NODE_333_length_4050_cov_31.044039	1703	1783	29	6	80	0.0750000
NODE_333_length_4050_cov_31.044039	1703	1783	30	2	80	0.0250000
NODE_333_length_4050_cov_31.044039	1703	1783	31	29	80	0.3625000
NODE_333_length_4050_cov_31.044039	1703	1783	33	6	80	0.0750000
NODE_333_length_4050_cov_31.044039	1703	1783	34	8	80	0.1000000
NODE_333_length_4050_cov_31.044039	1703	1783	35	7	80	0.0875000
NODE_333_length_4050_cov_31.044039	1703	1783	37	6	80	0.0750000
NODE_333_length_4050_cov_31.044039	1703	1783	40	5	80	0.0625000
NODE_335_length_4021_cov_34.619072	379	459	0	80	80	1.0000000
NODE_335_length_4021_cov_34.619072	432	512	0	80	80	1.0000000
NODE_336_length_4020_cov_5.130834	3455	3535	0	80	80	1.0000000
NODE_336_length_4020_cov_5.130834	3508	3588	0	80	80	1.0000000
NODE_339_length_4004_cov_9.718054	387	467	0	80	80	1.0000000
NODE_339_length_4004_cov_9.718054	440	520	0	80	80	1.0000000
NODE_339_length_4004_cov_9.718054	516	596	0	80	80	1.0000000
NODE_339_length_4004_cov_9.718054	569	649	0	80	80	1.0000000
NODE_341_length_3991_cov_18.617934	867	947	0	80	80	1.0000000
NODE_341_length_3991_cov_18.617934	920	1000	0	80	80	1.0000000
NODE_341_length_3991_cov_18.617934	996	1076	0	80	80	1.0000000
NODE_341_length_3991_cov_18.617934	1049	1124	0	75	75	1.0000000
NODE_348_length_3973_cov_6.906298	17	65	0	48	48	1.0000000
NODE_348_length_3973_cov_6.906298	1945	1995	0	8	50	0.1600000
NODE_348_length_3973_cov_6.906298	1945	1995	2	22	50	0.4400000
NODE_348_length_3973_cov_6.906298	1945	1995	6	3	50	0.0600000
NODE_348_length_3973_cov_6.906298	1945	1995	8	1	50	0.0200000
NODE_348_length_3973_cov_6.906298	1945	1995	9	9	50	0.1800000
NODE_348_length_3973_cov_6.906298	1945	1995	12	6	50	0.1200000
NODE_348_length_3973_cov_6.906298	1945	1995	24	1	50	0.0200000
NODE_350_length_3960_cov_6.246827	2673	2761	0	88	88	1.0000000
NODE_350_length_3960_cov_6.246827	3520	3600	0	80	80	1.0000000
NODE_350_length_3960_cov_6.246827	3573	3653	0	80	80	1.0000000
NODE_353_length_3952_cov_8.805346	826	906	0	80	80	1.0000000
NODE_353_length_3952_cov_8.805346	879	959	0	80	80	1.0000000
NODE_354_length_3928_cov_5.936798	2440	2521	0	81	81	1.0000000
NODE_354_length_3928_cov_5.936798	2493	2574	0	81	81	1.0000000
NODE_356_length_3923_cov_14.807793	3759	3800	0	24	41	0.5853658
NODE_356_length_3923_cov_14.807793	3759	3800	1	17	41	0.4146341
NODE_358_length_3922_cov_7.609731	1493	1573	27	4	80	0.0500000
NODE_358_length_3922_cov_7.609731	1493	1573	28	2	80	0.0250000
NODE_358_length_3922_cov_7.609731	1493	1573	32	1	80	0.0125000
NODE_358_length_3922_cov_7.609731	1493	1573	34	3	80	0.0375000
NODE_358_length_3922_cov_7.609731	1493	1573	35	6	80	0.0750000
NODE_358_length_3922_cov_7.609731	1493	1573	37	3	80	0.0375000
NODE_358_length_3922_cov_7.609731	1493	1573	38	2	80	0.0250000
NODE_358_length_3922_cov_7.609731	1493	1573	40	1	80	0.0125000
NODE_358_length_3922_cov_7.609731	1493	1573	42	2	80	0.0250000
NODE_358_length_3922_cov_7.609731	1493	1573	43	2	80	0.0250000
NODE_358_length_3922_cov_7.609731	1493	1573	45	3	80	0.0375000
NODE_358_length_3922_cov_7.609731	1493	1573	50	3	80	0.0375000
NODE_358_length_3922_cov_7.609731	1493	1573	52	10	80	0.1250000
NODE_358_length_3922_cov_7.609731	1493	1573	53	10	80	0.1250000
NODE_358_length_3922_cov_7.609731	1493	1573	54	23	80	0.2875000
NODE_358_length_3922_cov_7.609731	1493	1573	55	1	80	0.0125000
NODE_358_length_3922_cov_7.609731	1493	1573	56	4	80	0.0500000
NODE_358_length_3922_cov_7.609731	1546	1600	50	7	54	0.1296296
NODE_358_length_3922_cov_7.609731	1546	1600	52	7	54	0.1296296
NODE_358_length_3922_cov_7.609731	1546	1600	53	8	54	0.1481481
NODE_358_length_3922_cov_7.609731	1546	1600	54	14	54	0.2592593
NODE_358_length_3922_cov_7.609731	1546	1600	55	1	54	0.0185185
NODE_358_length_3922_cov_7.609731	1546	1600	56	4	54	0.0740741
NODE_358_length_3922_cov_7.609731	1546	1600	57	2	54	0.0370370
NODE_358_length_3922_cov_7.609731	1546	1600	61	3	54	0.0555556
NODE_358_length_3922_cov_7.609731	1546	1600	63	3	54	0.0555556
NODE_358_length_3922_cov_7.609731	1546	1600	65	5	54	0.0925926
NODE_359_length_3921_cov_9.943223	2936	3016	246	2	80	0.0250000
NODE_359_length_3921_cov_9.943223	2936	3016	252	2	80	0.0250000
NODE_359_length_3921_cov_9.943223	2936	3016	253	2	80	0.0250000
NODE_359_length_3921_cov_9.943223	2936	3016	255	2	80	0.0250000
NODE_359_length_3921_cov_9.943223	2936	3016	256	2	80	0.0250000
NODE_359_length_3921_cov_9.943223	2936	3016	258	3	80	0.0375000
NODE_359_length_3921_cov_9.943223	2936	3016	262	1	80	0.0125000
NODE_359_length_3921_cov_9.943223	2936	3016	264	2	80	0.0250000
NODE_359_length_3921_cov_9.943223	2936	3016	266	1	80	0.0125000
NODE_359_length_3921_cov_9.943223	2936	3016	270	3	80	0.0375000
NODE_359_length_3921_cov_9.943223	2936	3016	273	1	80	0.0125000
NODE_359_length_3921_cov_9.943223	2936	3016	275	1	80	0.0125000
NODE_359_length_3921_cov_9.943223	2936	3016	276	1	80	0.0125000
NODE_359_length_3921_cov_9.943223	2936	3016	285	1	80	0.0125000
NODE_359_length_3921_cov_9.943223	2936	3016	287	3	80	0.0375000
NODE_359_length_3921_cov_9.943223	2936	3016	289	1	80	0.0125000
NODE_359_length_3921_cov_9.943223	2936	3016	290	2	80	0.0250000
NODE_359_length_3921_cov_9.943223	2936	3016	294	2	80	0.0250000
NODE_359_length_3921_cov_9.943223	2936	3016	296	2	80	0.0250000
NODE_359_length_3921_cov_9.943223	2936	3016	298	2	80	0.0250000
NODE_359_length_3921_cov_9.943223	2936	3016	299	1	80	0.0125000
NODE_359_length_3921_cov_9.943223	2936	3016	300	2	80	0.0250000
NODE_359_length_3921_cov_9.943223	2936	3016	302	2	80	0.0250000
NODE_359_length_3921_cov_9.943223	2936	3016	303	1	80	0.0125000
NODE_359_length_3921_cov_9.943223	2936	3016	305	1	80	0.0125000
NODE_359_length_3921_cov_9.943223	2936	3016	307	1	80	0.0125000
NODE_359_length_3921_cov_9.943223	2936	3016	308	1	80	0.0125000
NODE_359_length_3921_cov_9.943223	2936	3016	309	5	80	0.0625000
NODE_359_length_3921_cov_9.943223	2936	3016	311	4	80	0.0500000
NODE_359_length_3921_cov_9.943223	2936	3016	312	3	80	0.0375000
NODE_359_length_3921_cov_9.943223	2936	3016	313	1	80	0.0125000
NODE_359_length_3921_cov_9.943223	2936	3016	315	2	80	0.0250000
NODE_359_length_3921_cov_9.943223	2936	3016	316	1	80	0.0125000
NODE_359_length_3921_cov_9.943223	2936	3016	318	3	80	0.0375000
NODE_359_length_3921_cov_9.943223	2936	3016	320	5	80	0.0625000
NODE_359_length_3921_cov_9.943223	2936	3016	321	1	80	0.0125000
NODE_359_length_3921_cov_9.943223	2936	3016	322	5	80	0.0625000
NODE_359_length_3921_cov_9.943223	2936	3016	324	1	80	0.0125000
NODE_359_length_3921_cov_9.943223	2936	3016	326	1	80	0.0125000
NODE_359_length_3921_cov_9.943223	2936	3016	328	3	80	0.0375000
NODE_359_length_3921_cov_9.943223	2989	3057	249	2	68	0.0294118
NODE_359_length_3921_cov_9.943223	2989	3057	253	1	68	0.0147059
NODE_359_length_3921_cov_9.943223	2989	3057	255	1	68	0.0147059
NODE_359_length_3921_cov_9.943223	2989	3057	259	2	68	0.0294118
NODE_359_length_3921_cov_9.943223	2989	3057	260	1	68	0.0147059
NODE_359_length_3921_cov_9.943223	2989	3057	261	1	68	0.0147059
NODE_359_length_3921_cov_9.943223	2989	3057	263	1	68	0.0147059
NODE_359_length_3921_cov_9.943223	2989	3057	264	1	68	0.0147059
NODE_359_length_3921_cov_9.943223	2989	3057	265	2	68	0.0294118
NODE_359_length_3921_cov_9.943223	2989	3057	266	1	68	0.0147059
NODE_359_length_3921_cov_9.943223	2989	3057	282	1	68	0.0147059
NODE_359_length_3921_cov_9.943223	2989	3057	288	1	68	0.0147059
NODE_359_length_3921_cov_9.943223	2989	3057	291	2	68	0.0294118
NODE_359_length_3921_cov_9.943223	2989	3057	292	1	68	0.0147059
NODE_359_length_3921_cov_9.943223	2989	3057	293	1	68	0.0147059
NODE_359_length_3921_cov_9.943223	2989	3057	294	1	68	0.0147059
NODE_359_length_3921_cov_9.943223	2989	3057	295	4	68	0.0588235
NODE_359_length_3921_cov_9.943223	2989	3057	296	4	68	0.0588235
NODE_359_length_3921_cov_9.943223	2989	3057	297	5	68	0.0735294
NODE_359_length_3921_cov_9.943223	2989	3057	299	6	68	0.0882353
NODE_359_length_3921_cov_9.943223	2989	3057	300	2	68	0.0294118
NODE_359_length_3921_cov_9.943223	2989	3057	302	1	68	0.0147059
NODE_359_length_3921_cov_9.943223	2989	3057	303	2	68	0.0294118
NODE_359_length_3921_cov_9.943223	2989	3057	309	2	68	0.0294118
NODE_359_length_3921_cov_9.943223	2989	3057	312	2	68	0.0294118
NODE_359_length_3921_cov_9.943223	2989	3057	316	1	68	0.0147059
NODE_359_length_3921_cov_9.943223	2989	3057	318	3	68	0.0441176
NODE_359_length_3921_cov_9.943223	2989	3057	320	5	68	0.0735294
NODE_359_length_3921_cov_9.943223	2989	3057	321	1	68	0.0147059
NODE_359_length_3921_cov_9.943223	2989	3057	322	5	68	0.0735294
NODE_359_length_3921_cov_9.943223	2989	3057	324	1	68	0.0147059
NODE_359_length_3921_cov_9.943223	2989	3057	326	1	68	0.0147059
NODE_359_length_3921_cov_9.943223	2989	3057	328	3	68	0.0441176
NODE_359_length_3921_cov_9.943223	3047	3066	203	1	19	0.0526316
NODE_359_length_3921_cov_9.943223	3047	3066	215	1	19	0.0526316
NODE_359_length_3921_cov_9.943223	3047	3066	228	2	19	0.1052632
NODE_359_length_3921_cov_9.943223	3047	3066	235	1	19	0.0526316
NODE_359_length_3921_cov_9.943223	3047	3066	236	1	19	0.0526316
NODE_359_length_3921_cov_9.943223	3047	3066	240	1	19	0.0526316
NODE_359_length_3921_cov_9.943223	3047	3066	245	1	19	0.0526316
NODE_359_length_3921_cov_9.943223	3047	3066	246	1	19	0.0526316
NODE_359_length_3921_cov_9.943223	3047	3066	249	2	19	0.1052632
NODE_359_length_3921_cov_9.943223	3047	3066	253	1	19	0.0526316
NODE_359_length_3921_cov_9.943223	3047	3066	255	1	19	0.0526316
NODE_359_length_3921_cov_9.943223	3047	3066	259	2	19	0.1052632
NODE_359_length_3921_cov_9.943223	3047	3066	261	1	19	0.0526316
NODE_359_length_3921_cov_9.943223	3047	3066	263	1	19	0.0526316
NODE_359_length_3921_cov_9.943223	3047	3066	265	2	19	0.1052632
NODE_363_length_3898_cov_40.033167	3296	3370	48	1	74	0.0135135
NODE_363_length_3898_cov_40.033167	3296	3370	50	1	74	0.0135135
NODE_363_length_3898_cov_40.033167	3296	3370	51	1	74	0.0135135
NODE_363_length_3898_cov_40.033167	3296	3370	53	1	74	0.0135135
NODE_363_length_3898_cov_40.033167	3296	3370	65	2	74	0.0270270
NODE_363_length_3898_cov_40.033167	3296	3370	73	1	74	0.0135135
NODE_363_length_3898_cov_40.033167	3296	3370	81	5	74	0.0675676
NODE_363_length_3898_cov_40.033167	3296	3370	85	9	74	0.1216216
NODE_363_length_3898_cov_40.033167	3296	3370	89	16	74	0.2162162
NODE_363_length_3898_cov_40.033167	3296	3370	90	6	74	0.0810811
NODE_363_length_3898_cov_40.033167	3296	3370	91	21	74	0.2837838
NODE_363_length_3898_cov_40.033167	3296	3370	92	1	74	0.0135135
NODE_363_length_3898_cov_40.033167	3296	3370	93	9	74	0.1216216
NODE_363_length_3898_cov_40.033167	3539	3619	12	4	80	0.0500000
NODE_363_length_3898_cov_40.033167	3539	3619	14	55	80	0.6875000
NODE_363_length_3898_cov_40.033167	3539	3619	16	21	80	0.2625000
NODE_364_length_3898_cov_7.550145	668	748	0	80	80	1.0000000
NODE_364_length_3898_cov_7.550145	721	801	0	74	80	0.9250000
NODE_364_length_3898_cov_7.550145	721	801	2	1	80	0.0125000
NODE_364_length_3898_cov_7.550145	721	801	3	3	80	0.0375000
NODE_364_length_3898_cov_7.550145	721	801	7	1	80	0.0125000
NODE_364_length_3898_cov_7.550145	721	801	12	1	80	0.0125000
NODE_367_length_3882_cov_4.166006	3244	3324	2	19	80	0.2375000
NODE_367_length_3882_cov_4.166006	3244	3324	4	61	80	0.7625000
NODE_367_length_3882_cov_4.166006	3282	3324	2	2	42	0.0476190
NODE_367_length_3882_cov_4.166006	3282	3324	4	40	42	0.9523810
NODE_367_length_3882_cov_4.166006	3297	3377	2	41	80	0.5125000
NODE_367_length_3882_cov_4.166006	3297	3377	4	31	80	0.3875000
NODE_367_length_3882_cov_4.166006	3297	3377	6	8	80	0.1000000
NODE_367_length_3882_cov_4.166006	3297	3377	2	41	80	0.5125000
NODE_367_length_3882_cov_4.166006	3297	3377	4	31	80	0.3875000
NODE_367_length_3882_cov_4.166006	3297	3377	6	8	80	0.1000000
NODE_367_length_3882_cov_4.166006	3373	3450	4	19	77	0.2467532
NODE_367_length_3882_cov_4.166006	3373	3450	6	58	77	0.7532467
NODE_374_length_3853_cov_18.816196	524	579	4	2	55	0.0363636
NODE_374_length_3853_cov_18.816196	524	579	11	17	55	0.3090909
NODE_374_length_3853_cov_18.816196	524	579	15	36	55	0.6545454
NODE_374_length_3853_cov_18.816196	559	639	2	5	80	0.0625000
NODE_374_length_3853_cov_18.816196	559	639	4	23	80	0.2875000
NODE_374_length_3853_cov_18.816196	559	639	6	34	80	0.4250000
NODE_374_length_3853_cov_18.816196	559	639	15	18	80	0.2250000
NODE_379_length_3829_cov_12.697319	515	595	0	80	80	1.0000000
NODE_379_length_3829_cov_12.697319	568	648	0	80	80	1.0000000
NODE_379_length_3829_cov_12.697319	644	724	0	80	80	1.0000000
NODE_379_length_3829_cov_12.697319	697	777	0	80	80	1.0000000
NODE_381_length_3815_cov_17.218784	399	479	0	80	80	1.0000000
NODE_381_length_3815_cov_17.218784	452	532	0	80	80	1.0000000
NODE_383_length_3812_cov_65.007272	840	903	8	1	63	0.0158730
NODE_383_length_3812_cov_65.007272	840	903	11	1	63	0.0158730
NODE_383_length_3812_cov_65.007272	840	903	13	1	63	0.0158730
NODE_383_length_3812_cov_65.007272	840	903	14	1	63	0.0158730
NODE_383_length_3812_cov_65.007272	840	903	15	1	63	0.0158730
NODE_383_length_3812_cov_65.007272	840	903	25	1	63	0.0158730
NODE_383_length_3812_cov_65.007272	840	903	26	1	63	0.0158730
NODE_383_length_3812_cov_65.007272	840	903	27	1	63	0.0158730
NODE_383_length_3812_cov_65.007272	840	903	29	1	63	0.0158730
NODE_383_length_3812_cov_65.007272	840	903	37	1	63	0.0158730
NODE_383_length_3812_cov_65.007272	840	903	39	2	63	0.0317460
NODE_383_length_3812_cov_65.007272	840	903	40	2	63	0.0317460
NODE_383_length_3812_cov_65.007272	840	903	41	1	63	0.0158730
NODE_383_length_3812_cov_65.007272	840	903	43	2	63	0.0317460
NODE_383_length_3812_cov_65.007272	840	903	45	1	63	0.0158730
NODE_383_length_3812_cov_65.007272	840	903	46	1	63	0.0158730
NODE_383_length_3812_cov_65.007272	840	903	47	1	63	0.0158730
NODE_383_length_3812_cov_65.007272	840	903	48	1	63	0.0158730
NODE_383_length_3812_cov_65.007272	840	903	52	1	63	0.0158730
NODE_383_length_3812_cov_65.007272	840	903	53	1	63	0.0158730
NODE_383_length_3812_cov_65.007272	840	903	54	1	63	0.0158730
NODE_383_length_3812_cov_65.007272	840	903	57	1	63	0.0158730
NODE_383_length_3812_cov_65.007272	840	903	70	2	63	0.0317460
NODE_383_length_3812_cov_65.007272	840	903	72	2	63	0.0317460
NODE_383_length_3812_cov_65.007272	840	903	78	1	63	0.0158730
NODE_383_length_3812_cov_65.007272	840	903	86	1	63	0.0158730
NODE_383_length_3812_cov_65.007272	840	903	87	1	63	0.0158730
NODE_383_length_3812_cov_65.007272	840	903	89	1	63	0.0158730
NODE_383_length_3812_cov_65.007272	840	903	90	1	63	0.0158730
NODE_383_length_3812_cov_65.007272	840	903	91	1	63	0.0158730
NODE_383_length_3812_cov_65.007272	840	903	92	2	63	0.0317460
NODE_383_length_3812_cov_65.007272	840	903	94	1	63	0.0158730
NODE_383_length_3812_cov_65.007272	840	903	95	2	63	0.0317460
NODE_383_length_3812_cov_65.007272	840	903	97	1	63	0.0158730
NODE_383_length_3812_cov_65.007272	840	903	98	1	63	0.0158730
NODE_383_length_3812_cov_65.007272	840	903	102	2	63	0.0317460
NODE_383_length_3812_cov_65.007272	840	903	103	3	63	0.0476190
NODE_383_length_3812_cov_65.007272	840	903	108	1	63	0.0158730
NODE_383_length_3812_cov_65.007272	840	903	116	1	63	0.0158730
NODE_383_length_3812_cov_65.007272	840	903	117	2	63	0.0317460
NODE_383_length_3812_cov_65.007272	840	903	119	1	63	0.0158730
NODE_383_length_3812_cov_65.007272	840	903	120	1	63	0.0158730
NODE_383_length_3812_cov_65.007272	840	903	121	1	63	0.0158730
NODE_383_length_3812_cov_65.007272	840	903	122	1	63	0.0158730
NODE_383_length_3812_cov_65.007272	840	903	124	1	63	0.0158730
NODE_383_length_3812_cov_65.007272	840	903	126	1	63	0.0158730
NODE_383_length_3812_cov_65.007272	840	903	130	1	63	0.0158730
NODE_383_length_3812_cov_65.007272	840	903	133	1	63	0.0158730
NODE_383_length_3812_cov_65.007272	840	903	137	1	63	0.0158730
NODE_383_length_3812_cov_65.007272	840	903	139	2	63	0.0317460
NODE_383_length_3812_cov_65.007272	840	903	142	1	63	0.0158730
NODE_384_length_3805_cov_9.533189	145	236	0	91	91	1.0000000
NODE_384_length_3805_cov_9.533189	209	279	0	70	70	1.0000000
NODE_386_length_3799_cov_10.046486	2944	3024	0	28	80	0.3500000
NODE_386_length_3799_cov_10.046486	2944	3024	3	52	80	0.6500000
NODE_386_length_3799_cov_10.046486	2997	3077	0	24	80	0.3000000
NODE_386_length_3799_cov_10.046486	2997	3077	3	8	80	0.1000000
NODE_386_length_3799_cov_10.046486	2997	3077	4	48	80	0.6000000
NODE_388_length_3795_cov_13.724297	3350	3430	0	3	80	0.0375000
NODE_388_length_3795_cov_13.724297	3350	3430	6	1	80	0.0125000
NODE_388_length_3795_cov_13.724297	3350	3430	7	76	80	0.9500000
NODE_388_length_3795_cov_13.724297	3403	3483	0	56	80	0.7000000
NODE_388_length_3795_cov_13.724297	3403	3483	6	1	80	0.0125000
NODE_388_length_3795_cov_13.724297	3403	3483	7	23	80	0.2875000
NODE_388_length_3795_cov_13.724297	3479	3562	0	6	83	0.0722892
NODE_388_length_3795_cov_13.724297	3479	3562	2	77	83	0.9277108
NODE_388_length_3795_cov_13.724297	3479	3562	0	6	83	0.0722892
NODE_388_length_3795_cov_13.724297	3479	3562	2	77	83	0.9277108
NODE_388_length_3795_cov_13.724297	3479	3552	0	6	73	0.0821918
NODE_388_length_3795_cov_13.724297	3479	3552	2	67	73	0.9178082
NODE_388_length_3795_cov_13.724297	3535	3586	2	51	51	1.0000000
NODE_388_length_3795_cov_13.724297	3535	3584	2	49	49	1.0000000
NODE_388_length_3795_cov_13.724297	3698	3721	70	14	23	0.6086956
NODE_388_length_3795_cov_13.724297	3698	3721	72	9	23	0.3913043
NODE_394_length_3774_cov_7.720544	538	595	2	26	57	0.4561403
NODE_394_length_3774_cov_7.720544	538	595	4	31	57	0.5438597
NODE_404_length_3747_cov_3.328947	2230	2292	0	27	62	0.4354839
NODE_404_length_3747_cov_3.328947	2230	2292	2	35	62	0.5645161
NODE_406_length_3743_cov_38.767014	1354	1434	0	80	80	1.0000000
NODE_406_length_3743_cov_38.767014	1407	1487	0	80	80	1.0000000
NODE_408_length_3733_cov_16.204458	186	249	0	51	63	0.8095238
NODE_408_length_3733_cov_16.204458	186	249	2	3	63	0.0476190
NODE_408_length_3733_cov_16.204458	186	249	13	3	63	0.0476190
NODE_408_length_3733_cov_16.204458	186	249	15	2	63	0.0317460
NODE_408_length_3733_cov_16.204458	186	249	16	4	63	0.0634921
NODE_413_length_3707_cov_56.575665	2387	2467	16	11	80	0.1375000
NODE_413_length_3707_cov_56.575665	2387	2467	18	31	80	0.3875000
NODE_413_length_3707_cov_56.575665	2387	2467	20	13	80	0.1625000
NODE_413_length_3707_cov_56.575665	2387	2467	22	25	80	0.3125000
NODE_413_length_3707_cov_56.575665	2440	2520	16	1	80	0.0125000
NODE_413_length_3707_cov_56.575665	2440	2520	18	6	80	0.0750000
NODE_413_length_3707_cov_56.575665	2440	2520	20	13	80	0.1625000
NODE_413_length_3707_cov_56.575665	2440	2520	21	2	80	0.0250000
NODE_413_length_3707_cov_56.575665	2440	2520	22	31	80	0.3875000
NODE_413_length_3707_cov_56.575665	2440	2520	24	24	80	0.3000000
NODE_413_length_3707_cov_56.575665	2440	2520	27	3	80	0.0375000
NODE_413_length_3707_cov_56.575665	2516	2596	18	4	80	0.0500000
NODE_413_length_3707_cov_56.575665	2516	2596	20	1	80	0.0125000
NODE_413_length_3707_cov_56.575665	2516	2596	22	18	80	0.2250000
NODE_413_length_3707_cov_56.575665	2516	2596	24	1	80	0.0125000
NODE_413_length_3707_cov_56.575665	2516	2596	27	21	80	0.2625000
NODE_413_length_3707_cov_56.575665	2516	2596	28	1	80	0.0125000
NODE_413_length_3707_cov_56.575665	2516	2596	31	3	80	0.0375000
NODE_413_length_3707_cov_56.575665	2516	2596	32	16	80	0.2000000
NODE_413_length_3707_cov_56.575665	2516	2596	33	8	80	0.1000000
NODE_413_length_3707_cov_56.575665	2516	2596	34	7	80	0.0875000
NODE_413_length_3707_cov_56.575665	2569	2649	4	2	80	0.0250000
NODE_413_length_3707_cov_56.575665	2569	2649	7	1	80	0.0125000
NODE_413_length_3707_cov_56.575665	2569	2649	8	28	80	0.3500000
NODE_413_length_3707_cov_56.575665	2569	2649	12	20	80	0.2500000
NODE_413_length_3707_cov_56.575665	2569	2649	16	1	80	0.0125000
NODE_413_length_3707_cov_56.575665	2569	2649	18	5	80	0.0625000
NODE_413_length_3707_cov_56.575665	2569	2649	20	1	80	0.0125000
NODE_413_length_3707_cov_56.575665	2569	2649	22	18	80	0.2250000
NODE_413_length_3707_cov_56.575665	2569	2649	28	1	80	0.0125000
NODE_413_length_3707_cov_56.575665	2569	2649	32	3	80	0.0375000
NODE_416_length_3690_cov_7.476190	723	792	0	69	69	1.0000000
NODE_416_length_3690_cov_7.476190	776	855	0	79	79	1.0000000
NODE_419_length_3685_cov_7.011154	1966	2046	85	2	80	0.0250000
NODE_419_length_3685_cov_7.011154	1966	2046	86	2	80	0.0250000
NODE_419_length_3685_cov_7.011154	1966	2046	100	3	80	0.0375000
NODE_419_length_3685_cov_7.011154	1966	2046	102	2	80	0.0250000
NODE_419_length_3685_cov_7.011154	1966	2046	103	7	80	0.0875000
NODE_419_length_3685_cov_7.011154	1966	2046	104	7	80	0.0875000
NODE_419_length_3685_cov_7.011154	1966	2046	112	2	80	0.0250000
NODE_419_length_3685_cov_7.011154	1966	2046	118	1	80	0.0125000
NODE_419_length_3685_cov_7.011154	1966	2046	120	2	80	0.0250000
NODE_419_length_3685_cov_7.011154	1966	2046	121	4	80	0.0500000
NODE_419_length_3685_cov_7.011154	1966	2046	122	1	80	0.0125000
NODE_419_length_3685_cov_7.011154	1966	2046	126	1	80	0.0125000
NODE_419_length_3685_cov_7.011154	1966	2046	135	4	80	0.0500000
NODE_419_length_3685_cov_7.011154	1966	2046	139	2	80	0.0250000
NODE_419_length_3685_cov_7.011154	1966	2046	141	8	80	0.1000000
NODE_419_length_3685_cov_7.011154	1966	2046	142	4	80	0.0500000
NODE_419_length_3685_cov_7.011154	1966	2046	143	2	80	0.0250000
NODE_419_length_3685_cov_7.011154	1966	2046	147	2	80	0.0250000
NODE_419_length_3685_cov_7.011154	1966	2046	149	4	80	0.0500000
NODE_419_length_3685_cov_7.011154	1966	2046	151	12	80	0.1500000
NODE_419_length_3685_cov_7.011154	1966	2046	152	2	80	0.0250000
NODE_419_length_3685_cov_7.011154	1966	2046	153	1	80	0.0125000
NODE_419_length_3685_cov_7.011154	1966	2046	154	5	80	0.0625000
NODE_419_length_3685_cov_7.011154	2019	2086	102	1	67	0.0149254
NODE_419_length_3685_cov_7.011154	2019	2086	104	1	67	0.0149254
NODE_419_length_3685_cov_7.011154	2019	2086	105	3	67	0.0447761
NODE_419_length_3685_cov_7.011154	2019	2086	106	3	67	0.0447761
NODE_419_length_3685_cov_7.011154	2019	2086	107	2	67	0.0298507
NODE_419_length_3685_cov_7.011154	2019	2086	110	2	67	0.0298507
NODE_419_length_3685_cov_7.011154	2019	2086	114	2	67	0.0298507
NODE_419_length_3685_cov_7.011154	2019	2086	115	2	67	0.0298507
NODE_419_length_3685_cov_7.011154	2019	2086	117	2	67	0.0298507
NODE_419_length_3685_cov_7.011154	2019	2086	121	1	67	0.0149254
NODE_419_length_3685_cov_7.011154	2019	2086	122	1	67	0.0149254
NODE_419_length_3685_cov_7.011154	2019	2086	123	2	67	0.0298507
NODE_419_length_3685_cov_7.011154	2019	2086	124	1	67	0.0149254
NODE_419_length_3685_cov_7.011154	2019	2086	126	3	67	0.0447761
NODE_419_length_3685_cov_7.011154	2019	2086	128	3	67	0.0447761
NODE_419_length_3685_cov_7.011154	2019	2086	129	2	67	0.0298507
NODE_419_length_3685_cov_7.011154	2019	2086	132	2	67	0.0298507
NODE_419_length_3685_cov_7.011154	2019	2086	134	2	67	0.0298507
NODE_419_length_3685_cov_7.011154	2019	2086	136	1	67	0.0149254
NODE_419_length_3685_cov_7.011154	2019	2086	139	2	67	0.0298507
NODE_419_length_3685_cov_7.011154	2019	2086	140	4	67	0.0597015
NODE_419_length_3685_cov_7.011154	2019	2086	141	4	67	0.0597015
NODE_419_length_3685_cov_7.011154	2019	2086	142	4	67	0.0597015
NODE_419_length_3685_cov_7.011154	2019	2086	147	1	67	0.0149254
NODE_419_length_3685_cov_7.011154	2019	2086	149	2	67	0.0298507
NODE_419_length_3685_cov_7.011154	2019	2086	151	12	67	0.1791045
NODE_419_length_3685_cov_7.011154	2019	2086	152	1	67	0.0149254
NODE_419_length_3685_cov_7.011154	2019	2086	153	1	67	0.0149254
NODE_426_length_3667_cov_1089.047365	1634	1705	3	11	71	0.1549296
NODE_426_length_3667_cov_1089.047365	1634	1705	5	2	71	0.0281690
NODE_426_length_3667_cov_1089.047365	1634	1705	8	29	71	0.4084507
NODE_426_length_3667_cov_1089.047365	1634	1705	9	29	71	0.4084507
NODE_426_length_3667_cov_1089.047365	1678	1758	2	41	80	0.5125000
NODE_426_length_3667_cov_1089.047365	1678	1758	3	14	80	0.1750000
NODE_426_length_3667_cov_1089.047365	1678	1758	4	9	80	0.1125000
NODE_426_length_3667_cov_1089.047365	1678	1758	5	2	80	0.0250000
NODE_426_length_3667_cov_1089.047365	1678	1758	9	14	80	0.1750000
NODE_428_length_3660_cov_79.447627	1806	1870	158	1	64	0.0156250
NODE_428_length_3660_cov_79.447627	1806	1870	160	1	64	0.0156250
NODE_428_length_3660_cov_79.447627	1806	1870	161	4	64	0.0625000
NODE_428_length_3660_cov_79.447627	1806	1870	163	1	64	0.0156250
NODE_428_length_3660_cov_79.447627	1806	1870	165	1	64	0.0156250
NODE_428_length_3660_cov_79.447627	1806	1870	175	1	64	0.0156250
NODE_428_length_3660_cov_79.447627	1806	1870	176	1	64	0.0156250
NODE_428_length_3660_cov_79.447627	1806	1870	177	1	64	0.0156250
NODE_428_length_3660_cov_79.447627	1806	1870	179	1	64	0.0156250
NODE_428_length_3660_cov_79.447627	1806	1870	181	1	64	0.0156250
NODE_428_length_3660_cov_79.447627	1806	1870	182	2	64	0.0312500
NODE_428_length_3660_cov_79.447627	1806	1870	193	1	64	0.0156250
NODE_428_length_3660_cov_79.447627	1806	1870	194	1	64	0.0156250
NODE_428_length_3660_cov_79.447627	1806	1870	201	1	64	0.0156250
NODE_428_length_3660_cov_79.447627	1806	1870	213	1	64	0.0156250
NODE_428_length_3660_cov_79.447627	1806	1870	221	1	64	0.0156250
NODE_428_length_3660_cov_79.447627	1806	1870	224	1	64	0.0156250
NODE_428_length_3660_cov_79.447627	1806	1870	234	1	64	0.0156250
NODE_428_length_3660_cov_79.447627	1806	1870	236	1	64	0.0156250
NODE_428_length_3660_cov_79.447627	1806	1870	238	1	64	0.0156250
NODE_428_length_3660_cov_79.447627	1806	1870	240	1	64	0.0156250
NODE_428_length_3660_cov_79.447627	1806	1870	246	1	64	0.0156250
NODE_428_length_3660_cov_79.447627	1806	1870	247	1	64	0.0156250
NODE_428_length_3660_cov_79.447627	1806	1870	251	2	64	0.0312500
NODE_428_length_3660_cov_79.447627	1806	1870	253	1	64	0.0156250
NODE_428_length_3660_cov_79.447627	1806	1870	257	1	64	0.0156250
NODE_428_length_3660_cov_79.447627	1806	1870	271	1	64	0.0156250
NODE_428_length_3660_cov_79.447627	1806	1870	278	1	64	0.0156250
NODE_428_length_3660_cov_79.447627	1806	1870	279	2	64	0.0312500
NODE_428_length_3660_cov_79.447627	1806	1870	280	3	64	0.0468750
NODE_428_length_3660_cov_79.447627	1806	1870	281	1	64	0.0156250
NODE_428_length_3660_cov_79.447627	1806	1870	282	1	64	0.0156250
NODE_428_length_3660_cov_79.447627	1806	1870	284	2	64	0.0312500
NODE_428_length_3660_cov_79.447627	1806	1870	285	3	64	0.0468750
NODE_428_length_3660_cov_79.447627	1806	1870	287	2	64	0.0312500
NODE_428_length_3660_cov_79.447627	1806	1870	288	2	64	0.0312500
NODE_428_length_3660_cov_79.447627	1806	1870	289	4	64	0.0625000
NODE_428_length_3660_cov_79.447627	1806	1870	291	1	64	0.0156250
NODE_428_length_3660_cov_79.447627	1806	1870	295	1	64	0.0156250
NODE_428_length_3660_cov_79.447627	1806	1870	296	2	64	0.0312500
NODE_428_length_3660_cov_79.447627	1806	1870	297	1	64	0.0156250
NODE_428_length_3660_cov_79.447627	1806	1870	298	2	64	0.0312500
NODE_428_length_3660_cov_79.447627	1806	1870	299	1	64	0.0156250
NODE_428_length_3660_cov_79.447627	1806	1870	301	2	64	0.0312500
NODE_428_length_3660_cov_79.447627	1806	1870	304	1	64	0.0156250
NODE_428_length_3660_cov_79.447627	1859	1906	281	1	47	0.0212766
NODE_428_length_3660_cov_79.447627	1859	1906	285	1	47	0.0212766
NODE_428_length_3660_cov_79.447627	1859	1906	287	1	47	0.0212766
NODE_428_length_3660_cov_79.447627	1859	1906	289	4	47	0.0851064
NODE_428_length_3660_cov_79.447627	1859	1906	295	1	47	0.0212766
NODE_428_length_3660_cov_79.447627	1859	1906	296	3	47	0.0638298
NODE_428_length_3660_cov_79.447627	1859	1906	298	2	47	0.0425532
NODE_428_length_3660_cov_79.447627	1859	1906	301	2	47	0.0425532
NODE_428_length_3660_cov_79.447627	1859	1906	302	1	47	0.0212766
NODE_428_length_3660_cov_79.447627	1859	1906	303	1	47	0.0212766
NODE_428_length_3660_cov_79.447627	1859	1906	304	1	47	0.0212766
NODE_428_length_3660_cov_79.447627	1859	1906	305	1	47	0.0212766
NODE_428_length_3660_cov_79.447627	1859	1906	308	2	47	0.0425532
NODE_428_length_3660_cov_79.447627	1859	1906	311	1	47	0.0212766
NODE_428_length_3660_cov_79.447627	1859	1906	312	2	47	0.0425532
NODE_428_length_3660_cov_79.447627	1859	1906	314	1	47	0.0212766
NODE_428_length_3660_cov_79.447627	1859	1906	316	1	47	0.0212766
NODE_428_length_3660_cov_79.447627	1859	1906	318	1	47	0.0212766
NODE_428_length_3660_cov_79.447627	1859	1906	323	1	47	0.0212766
NODE_428_length_3660_cov_79.447627	1859	1906	331	1	47	0.0212766
NODE_428_length_3660_cov_79.447627	1859	1906	335	1	47	0.0212766
NODE_428_length_3660_cov_79.447627	1859	1906	336	1	47	0.0212766
NODE_428_length_3660_cov_79.447627	1859	1906	337	2	47	0.0425532
NODE_428_length_3660_cov_79.447627	1859	1906	338	1	47	0.0212766
NODE_428_length_3660_cov_79.447627	1859	1906	339	1	47	0.0212766
NODE_428_length_3660_cov_79.447627	1859	1906	340	4	47	0.0851064
NODE_428_length_3660_cov_79.447627	1859	1906	342	2	47	0.0425532
NODE_428_length_3660_cov_79.447627	1859	1906	343	2	47	0.0425532
NODE_428_length_3660_cov_79.447627	1859	1906	344	2	47	0.0425532
NODE_428_length_3660_cov_79.447627	1859	1906	346	1	47	0.0212766
NODE_428_length_3660_cov_79.447627	1859	1906	348	1	47	0.0212766
NODE_428_length_3660_cov_79.447627	2358	2438	0	80	80	1.0000000
NODE_428_length_3660_cov_79.447627	2411	2491	0	80	80	1.0000000
NODE_428_length_3660_cov_79.447627	2487	2567	0	80	80	1.0000000
NODE_428_length_3660_cov_79.447627	2540	2620	0	80	80	1.0000000
NODE_430_length_3634_cov_34.913154	1499	1544	103	1	45	0.0222222
NODE_430_length_3634_cov_34.913154	1499	1544	109	1	45	0.0222222
NODE_430_length_3634_cov_34.913154	1499	1544	114	1	45	0.0222222
NODE_430_length_3634_cov_34.913154	1499	1544	142	1	45	0.0222222
NODE_430_length_3634_cov_34.913154	1499	1544	148	1	45	0.0222222
NODE_430_length_3634_cov_34.913154	1499	1544	150	1	45	0.0222222
NODE_430_length_3634_cov_34.913154	1499	1544	154	2	45	0.0444444
NODE_430_length_3634_cov_34.913154	1499	1544	158	1	45	0.0222222
NODE_430_length_3634_cov_34.913154	1499	1544	169	1	45	0.0222222
NODE_430_length_3634_cov_34.913154	1499	1544	176	2	45	0.0444444
NODE_430_length_3634_cov_34.913154	1499	1544	180	1	45	0.0222222
NODE_430_length_3634_cov_34.913154	1499	1544	184	1	45	0.0222222
NODE_430_length_3634_cov_34.913154	1499	1544	193	2	45	0.0444444
NODE_430_length_3634_cov_34.913154	1499	1544	197	2	45	0.0444444
NODE_430_length_3634_cov_34.913154	1499	1544	200	1	45	0.0222222
NODE_430_length_3634_cov_34.913154	1499	1544	205	1	45	0.0222222
NODE_430_length_3634_cov_34.913154	1499	1544	219	1	45	0.0222222
NODE_430_length_3634_cov_34.913154	1499	1544	231	1	45	0.0222222
NODE_430_length_3634_cov_34.913154	1499	1544	239	1	45	0.0222222
NODE_430_length_3634_cov_34.913154	1499	1544	240	1	45	0.0222222
NODE_430_length_3634_cov_34.913154	1499	1544	242	1	45	0.0222222
NODE_430_length_3634_cov_34.913154	1499	1544	254	1	45	0.0222222
NODE_430_length_3634_cov_34.913154	1499	1544	259	1	45	0.0222222
NODE_430_length_3634_cov_34.913154	1499	1544	285	1	45	0.0222222
NODE_430_length_3634_cov_34.913154	1499	1544	286	2	45	0.0444444
NODE_430_length_3634_cov_34.913154	1499	1544	290	1	45	0.0222222
NODE_430_length_3634_cov_34.913154	1499	1544	292	1	45	0.0222222
NODE_430_length_3634_cov_34.913154	1499	1544	301	1	45	0.0222222
NODE_430_length_3634_cov_34.913154	1499	1544	311	1	45	0.0222222
NODE_430_length_3634_cov_34.913154	1499	1544	316	1	45	0.0222222
NODE_430_length_3634_cov_34.913154	1499	1544	320	1	45	0.0222222
NODE_430_length_3634_cov_34.913154	1499	1544	321	1	45	0.0222222
NODE_430_length_3634_cov_34.913154	1499	1544	331	1	45	0.0222222
NODE_430_length_3634_cov_34.913154	1499	1544	334	1	45	0.0222222
NODE_430_length_3634_cov_34.913154	1499	1544	335	1	45	0.0222222
NODE_430_length_3634_cov_34.913154	1499	1544	336	1	45	0.0222222
NODE_430_length_3634_cov_34.913154	1499	1544	340	1	45	0.0222222
NODE_430_length_3634_cov_34.913154	1499	1544	352	1	45	0.0222222
NODE_430_length_3634_cov_34.913154	1499	1544	354	1	45	0.0222222
NODE_430_length_3634_cov_34.913154	1499	1544	356	1	45	0.0222222
NODE_430_length_3634_cov_34.913154	1517	1597	200	1	80	0.0125000
NODE_430_length_3634_cov_34.913154	1517	1597	205	1	80	0.0125000
NODE_430_length_3634_cov_34.913154	1517	1597	219	1	80	0.0125000
NODE_430_length_3634_cov_34.913154	1517	1597	231	1	80	0.0125000
NODE_430_length_3634_cov_34.913154	1517	1597	239	1	80	0.0125000
NODE_430_length_3634_cov_34.913154	1517	1597	240	1	80	0.0125000
NODE_430_length_3634_cov_34.913154	1517	1597	242	1	80	0.0125000
NODE_430_length_3634_cov_34.913154	1517	1597	254	1	80	0.0125000
NODE_430_length_3634_cov_34.913154	1517	1597	259	1	80	0.0125000
NODE_430_length_3634_cov_34.913154	1517	1597	285	1	80	0.0125000
NODE_430_length_3634_cov_34.913154	1517	1597	286	2	80	0.0250000
NODE_430_length_3634_cov_34.913154	1517	1597	290	1	80	0.0125000
NODE_430_length_3634_cov_34.913154	1517	1597	292	1	80	0.0125000
NODE_430_length_3634_cov_34.913154	1517	1597	301	1	80	0.0125000
NODE_430_length_3634_cov_34.913154	1517	1597	311	1	80	0.0125000
NODE_430_length_3634_cov_34.913154	1517	1597	316	1	80	0.0125000
NODE_430_length_3634_cov_34.913154	1517	1597	320	1	80	0.0125000
NODE_430_length_3634_cov_34.913154	1517	1597	321	1	80	0.0125000
NODE_430_length_3634_cov_34.913154	1517	1597	331	1	80	0.0125000
NODE_430_length_3634_cov_34.913154	1517	1597	334	1	80	0.0125000
NODE_430_length_3634_cov_34.913154	1517	1597	335	1	80	0.0125000
NODE_430_length_3634_cov_34.913154	1517	1597	336	1	80	0.0125000
NODE_430_length_3634_cov_34.913154	1517	1597	340	1	80	0.0125000
NODE_430_length_3634_cov_34.913154	1517	1597	352	1	80	0.0125000
NODE_430_length_3634_cov_34.913154	1517	1597	354	1	80	0.0125000
NODE_430_length_3634_cov_34.913154	1517	1597	356	1	80	0.0125000
NODE_430_length_3634_cov_34.913154	1517	1597	357	2	80	0.0250000
NODE_430_length_3634_cov_34.913154	1517	1597	359	2	80	0.0250000
NODE_430_length_3634_cov_34.913154	1517	1597	365	1	80	0.0125000
NODE_430_length_3634_cov_34.913154	1517	1597	368	1	80	0.0125000
NODE_430_length_3634_cov_34.913154	1517	1597	369	1	80	0.0125000
NODE_430_length_3634_cov_34.913154	1517	1597	373	1	80	0.0125000
NODE_430_length_3634_cov_34.913154	1517	1597	375	1	80	0.0125000
NODE_430_length_3634_cov_34.913154	1517	1597	382	1	80	0.0125000
NODE_430_length_3634_cov_34.913154	1517	1597	383	1	80	0.0125000
NODE_430_length_3634_cov_34.913154	1517	1597	385	2	80	0.0250000
NODE_430_length_3634_cov_34.913154	1517	1597	396	1	80	0.0125000
NODE_430_length_3634_cov_34.913154	1517	1597	408	1	80	0.0125000
NODE_430_length_3634_cov_34.913154	1517	1597	426	1	80	0.0125000
NODE_430_length_3634_cov_34.913154	1517	1597	438	1	80	0.0125000
NODE_430_length_3634_cov_34.913154	1517	1597	439	2	80	0.0250000
NODE_430_length_3634_cov_34.913154	1517	1597	444	1	80	0.0125000
NODE_430_length_3634_cov_34.913154	1517	1597	445	2	80	0.0250000
NODE_430_length_3634_cov_34.913154	1517	1597	451	1	80	0.0125000
NODE_430_length_3634_cov_34.913154	1517	1597	458	1	80	0.0125000
NODE_430_length_3634_cov_34.913154	1517	1597	460	2	80	0.0250000
NODE_430_length_3634_cov_34.913154	1517	1597	474	1	80	0.0125000
NODE_430_length_3634_cov_34.913154	1517	1597	480	1	80	0.0125000
NODE_430_length_3634_cov_34.913154	1517	1597	485	1	80	0.0125000
NODE_430_length_3634_cov_34.913154	1517	1597	488	1	80	0.0125000
NODE_430_length_3634_cov_34.913154	1517	1597	495	1	80	0.0125000
NODE_430_length_3634_cov_34.913154	1517	1597	502	1	80	0.0125000
NODE_430_length_3634_cov_34.913154	1517	1597	506	1	80	0.0125000
NODE_430_length_3634_cov_34.913154	1517	1597	512	1	80	0.0125000
NODE_430_length_3634_cov_34.913154	1517	1597	514	1	80	0.0125000
NODE_430_length_3634_cov_34.913154	1517	1597	519	1	80	0.0125000
NODE_430_length_3634_cov_34.913154	1517	1597	522	1	80	0.0125000
NODE_430_length_3634_cov_34.913154	1517	1597	525	3	80	0.0375000
NODE_430_length_3634_cov_34.913154	1517	1597	528	1	80	0.0125000
NODE_430_length_3634_cov_34.913154	1517	1597	535	1	80	0.0125000
NODE_430_length_3634_cov_34.913154	1517	1597	540	2	80	0.0250000
NODE_430_length_3634_cov_34.913154	1517	1597	541	2	80	0.0250000
NODE_430_length_3634_cov_34.913154	1517	1597	542	2	80	0.0250000
NODE_430_length_3634_cov_34.913154	1517	1597	543	2	80	0.0250000
NODE_430_length_3634_cov_34.913154	1517	1597	544	2	80	0.0250000
NODE_430_length_3634_cov_34.913154	1517	1597	547	1	80	0.0125000
NODE_430_length_3634_cov_34.913154	1978	2058	190	1	80	0.0125000
NODE_430_length_3634_cov_34.913154	1978	2058	200	1	80	0.0125000
NODE_430_length_3634_cov_34.913154	1978	2058	208	1	80	0.0125000
NODE_430_length_3634_cov_34.913154	1978	2058	214	1	80	0.0125000
NODE_430_length_3634_cov_34.913154	1978	2058	219	1	80	0.0125000
NODE_430_length_3634_cov_34.913154	1978	2058	231	1	80	0.0125000
NODE_430_length_3634_cov_34.913154	1978	2058	234	1	80	0.0125000
NODE_430_length_3634_cov_34.913154	1978	2058	239	1	80	0.0125000
NODE_430_length_3634_cov_34.913154	1978	2058	240	1	80	0.0125000
NODE_430_length_3634_cov_34.913154	1978	2058	245	1	80	0.0125000
NODE_430_length_3634_cov_34.913154	1978	2058	246	1	80	0.0125000
NODE_430_length_3634_cov_34.913154	1978	2058	252	1	80	0.0125000
NODE_430_length_3634_cov_34.913154	1978	2058	258	1	80	0.0125000
NODE_430_length_3634_cov_34.913154	1978	2058	263	2	80	0.0250000
NODE_430_length_3634_cov_34.913154	1978	2058	267	2	80	0.0250000
NODE_430_length_3634_cov_34.913154	1978	2058	268	1	80	0.0125000
NODE_430_length_3634_cov_34.913154	1978	2058	274	1	80	0.0125000
NODE_430_length_3634_cov_34.913154	1978	2058	286	1	80	0.0125000
NODE_430_length_3634_cov_34.913154	1978	2058	288	1	80	0.0125000
NODE_430_length_3634_cov_34.913154	1978	2058	294	1	80	0.0125000
NODE_430_length_3634_cov_34.913154	1978	2058	296	1	80	0.0125000
NODE_430_length_3634_cov_34.913154	1978	2058	301	1	80	0.0125000
NODE_430_length_3634_cov_34.913154	1978	2058	306	1	80	0.0125000
NODE_430_length_3634_cov_34.913154	1978	2058	307	1	80	0.0125000
NODE_430_length_3634_cov_34.913154	1978	2058	317	1	80	0.0125000
NODE_430_length_3634_cov_34.913154	1978	2058	320	2	80	0.0250000
NODE_430_length_3634_cov_34.913154	1978	2058	322	1	80	0.0125000
NODE_430_length_3634_cov_34.913154	1978	2058	326	1	80	0.0125000
NODE_430_length_3634_cov_34.913154	1978	2058	337	1	80	0.0125000
NODE_430_length_3634_cov_34.913154	1978	2058	338	3	80	0.0375000
NODE_430_length_3634_cov_34.913154	1978	2058	339	1	80	0.0125000
NODE_430_length_3634_cov_34.913154	1978	2058	342	1	80	0.0125000
NODE_430_length_3634_cov_34.913154	1978	2058	345	1	80	0.0125000
NODE_430_length_3634_cov_34.913154	1978	2058	351	1	80	0.0125000
NODE_430_length_3634_cov_34.913154	1978	2058	357	2	80	0.0250000
NODE_430_length_3634_cov_34.913154	1978	2058	363	2	80	0.0250000
NODE_430_length_3634_cov_34.913154	1978	2058	371	1	80	0.0125000
NODE_430_length_3634_cov_34.913154	1978	2058	376	1	80	0.0125000
NODE_430_length_3634_cov_34.913154	1978	2058	377	1	80	0.0125000
NODE_430_length_3634_cov_34.913154	1978	2058	380	1	80	0.0125000
NODE_430_length_3634_cov_34.913154	1978	2058	383	1	80	0.0125000
NODE_430_length_3634_cov_34.913154	1978	2058	384	2	80	0.0250000
NODE_430_length_3634_cov_34.913154	1978	2058	393	1	80	0.0125000
NODE_430_length_3634_cov_34.913154	1978	2058	397	1	80	0.0125000
NODE_430_length_3634_cov_34.913154	1978	2058	398	1	80	0.0125000
NODE_430_length_3634_cov_34.913154	1978	2058	399	1	80	0.0125000
NODE_430_length_3634_cov_34.913154	1978	2058	404	1	80	0.0125000
NODE_430_length_3634_cov_34.913154	1978	2058	407	1	80	0.0125000
NODE_430_length_3634_cov_34.913154	1978	2058	415	1	80	0.0125000
NODE_430_length_3634_cov_34.913154	1978	2058	424	1	80	0.0125000
NODE_430_length_3634_cov_34.913154	1978	2058	425	2	80	0.0250000
NODE_430_length_3634_cov_34.913154	1978	2058	431	1	80	0.0125000
NODE_430_length_3634_cov_34.913154	1978	2058	434	1	80	0.0125000
NODE_430_length_3634_cov_34.913154	1978	2058	442	1	80	0.0125000
NODE_430_length_3634_cov_34.913154	1978	2058	453	2	80	0.0250000
NODE_430_length_3634_cov_34.913154	1978	2058	470	1	80	0.0125000
NODE_430_length_3634_cov_34.913154	1978	2058	474	2	80	0.0250000
NODE_430_length_3634_cov_34.913154	1978	2058	476	1	80	0.0125000
NODE_430_length_3634_cov_34.913154	1978	2058	480	1	80	0.0125000
NODE_430_length_3634_cov_34.913154	1978	2058	491	1	80	0.0125000
NODE_430_length_3634_cov_34.913154	1978	2058	494	1	80	0.0125000
NODE_430_length_3634_cov_34.913154	1978	2058	507	1	80	0.0125000
NODE_430_length_3634_cov_34.913154	1978	2058	514	1	80	0.0125000
NODE_430_length_3634_cov_34.913154	1978	2058	524	1	80	0.0125000
NODE_430_length_3634_cov_34.913154	1978	2058	530	1	80	0.0125000
NODE_430_length_3634_cov_34.913154	1978	2058	545	1	80	0.0125000
NODE_430_length_3634_cov_34.913154	1978	2058	548	1	80	0.0125000
NODE_430_length_3634_cov_34.913154	1978	2058	567	1	80	0.0125000
NODE_430_length_3634_cov_34.913154	1978	2058	573	1	80	0.0125000
NODE_430_length_3634_cov_34.913154	2031	2077	60	1	46	0.0217391
NODE_430_length_3634_cov_34.913154	2031	2077	76	1	46	0.0217391
NODE_430_length_3634_cov_34.913154	2031	2077	84	1	46	0.0217391
NODE_430_length_3634_cov_34.913154	2031	2077	97	1	46	0.0217391
NODE_430_length_3634_cov_34.913154	2031	2077	107	2	46	0.0434783
NODE_430_length_3634_cov_34.913154	2031	2077	112	2	46	0.0434783
NODE_430_length_3634_cov_34.913154	2031	2077	122	1	46	0.0217391
NODE_430_length_3634_cov_34.913154	2031	2077	123	1	46	0.0217391
NODE_430_length_3634_cov_34.913154	2031	2077	127	1	46	0.0217391
NODE_430_length_3634_cov_34.913154	2031	2077	133	1	46	0.0217391
NODE_430_length_3634_cov_34.913154	2031	2077	138	1	46	0.0217391
NODE_430_length_3634_cov_34.913154	2031	2077	140	1	46	0.0217391
NODE_430_length_3634_cov_34.913154	2031	2077	146	2	46	0.0434783
NODE_430_length_3634_cov_34.913154	2031	2077	161	1	46	0.0217391
NODE_430_length_3634_cov_34.913154	2031	2077	168	1	46	0.0217391
NODE_430_length_3634_cov_34.913154	2031	2077	176	1	46	0.0217391
NODE_430_length_3634_cov_34.913154	2031	2077	190	1	46	0.0217391
NODE_430_length_3634_cov_34.913154	2031	2077	200	1	46	0.0217391
NODE_430_length_3634_cov_34.913154	2031	2077	208	1	46	0.0217391
NODE_430_length_3634_cov_34.913154	2031	2077	214	1	46	0.0217391
NODE_430_length_3634_cov_34.913154	2031	2077	219	1	46	0.0217391
NODE_430_length_3634_cov_34.913154	2031	2077	231	1	46	0.0217391
NODE_430_length_3634_cov_34.913154	2031	2077	234	1	46	0.0217391
NODE_430_length_3634_cov_34.913154	2031	2077	239	1	46	0.0217391
NODE_430_length_3634_cov_34.913154	2031	2077	240	1	46	0.0217391
NODE_430_length_3634_cov_34.913154	2031	2077	245	1	46	0.0217391
NODE_430_length_3634_cov_34.913154	2031	2077	246	1	46	0.0217391
NODE_430_length_3634_cov_34.913154	2031	2077	252	1	46	0.0217391
NODE_430_length_3634_cov_34.913154	2031	2077	258	1	46	0.0217391
NODE_430_length_3634_cov_34.913154	2031	2077	263	2	46	0.0434783
NODE_430_length_3634_cov_34.913154	2031	2077	267	2	46	0.0434783
NODE_430_length_3634_cov_34.913154	2031	2077	268	1	46	0.0217391
NODE_430_length_3634_cov_34.913154	2031	2077	274	1	46	0.0217391
NODE_430_length_3634_cov_34.913154	2031	2077	286	1	46	0.0217391
NODE_430_length_3634_cov_34.913154	2031	2077	288	1	46	0.0217391
NODE_430_length_3634_cov_34.913154	2031	2077	294	1	46	0.0217391
NODE_430_length_3634_cov_34.913154	2031	2077	296	1	46	0.0217391
NODE_430_length_3634_cov_34.913154	2031	2077	301	1	46	0.0217391
NODE_430_length_3634_cov_34.913154	2031	2077	306	1	46	0.0217391
NODE_430_length_3634_cov_34.913154	2031	2077	307	1	46	0.0217391
NODE_430_length_3634_cov_34.913154	2031	2077	317	1	46	0.0217391
NODE_435_length_3622_cov_29.112120	201	281	0	28	80	0.3500000
NODE_435_length_3622_cov_29.112120	201	281	2	52	80	0.6500000
NODE_435_length_3622_cov_29.112120	254	334	0	25	80	0.3125000
NODE_435_length_3622_cov_29.112120	254	334	2	55	80	0.6875000
NODE_435_length_3622_cov_29.112120	2310	2390	94	1	80	0.0125000
NODE_435_length_3622_cov_29.112120	2310	2390	99	2	80	0.0250000
NODE_435_length_3622_cov_29.112120	2310	2390	101	4	80	0.0500000
NODE_435_length_3622_cov_29.112120	2310	2390	103	3	80	0.0375000
NODE_435_length_3622_cov_29.112120	2310	2390	106	1	80	0.0125000
NODE_435_length_3622_cov_29.112120	2310	2390	112	3	80	0.0375000
NODE_435_length_3622_cov_29.112120	2310	2390	117	1	80	0.0125000
NODE_435_length_3622_cov_29.112120	2310	2390	118	1	80	0.0125000
NODE_435_length_3622_cov_29.112120	2310	2390	120	1	80	0.0125000
NODE_435_length_3622_cov_29.112120	2310	2390	123	1	80	0.0125000
NODE_435_length_3622_cov_29.112120	2310	2390	125	1	80	0.0125000
NODE_435_length_3622_cov_29.112120	2310	2390	127	1	80	0.0125000
NODE_435_length_3622_cov_29.112120	2310	2390	131	1	80	0.0125000
NODE_435_length_3622_cov_29.112120	2310	2390	136	1	80	0.0125000
NODE_435_length_3622_cov_29.112120	2310	2390	140	2	80	0.0250000
NODE_435_length_3622_cov_29.112120	2310	2390	144	1	80	0.0125000
NODE_435_length_3622_cov_29.112120	2310	2390	150	1	80	0.0125000
NODE_435_length_3622_cov_29.112120	2310	2390	154	2	80	0.0250000
NODE_435_length_3622_cov_29.112120	2310	2390	156	1	80	0.0125000
NODE_435_length_3622_cov_29.112120	2310	2390	158	1	80	0.0125000
NODE_435_length_3622_cov_29.112120	2310	2390	162	3	80	0.0375000
NODE_435_length_3622_cov_29.112120	2310	2390	166	1	80	0.0125000
NODE_435_length_3622_cov_29.112120	2310	2390	168	2	80	0.0250000
NODE_435_length_3622_cov_29.112120	2310	2390	170	1	80	0.0125000
NODE_435_length_3622_cov_29.112120	2310	2390	176	2	80	0.0250000
NODE_435_length_3622_cov_29.112120	2310	2390	178	1	80	0.0125000
NODE_435_length_3622_cov_29.112120	2310	2390	185	1	80	0.0125000
NODE_435_length_3622_cov_29.112120	2310	2390	191	1	80	0.0125000
NODE_435_length_3622_cov_29.112120	2310	2390	195	1	80	0.0125000
NODE_435_length_3622_cov_29.112120	2310	2390	199	1	80	0.0125000
NODE_435_length_3622_cov_29.112120	2310	2390	203	3	80	0.0375000
NODE_435_length_3622_cov_29.112120	2310	2390	205	1	80	0.0125000
NODE_435_length_3622_cov_29.112120	2310	2390	208	1	80	0.0125000
NODE_435_length_3622_cov_29.112120	2310	2390	209	1	80	0.0125000
NODE_435_length_3622_cov_29.112120	2310	2390	212	5	80	0.0625000
NODE_435_length_3622_cov_29.112120	2310	2390	213	2	80	0.0250000
NODE_435_length_3622_cov_29.112120	2310	2390	219	2	80	0.0250000
NODE_435_length_3622_cov_29.112120	2310	2390	220	4	80	0.0500000
NODE_435_length_3622_cov_29.112120	2310	2390	221	1	80	0.0125000
NODE_435_length_3622_cov_29.112120	2310	2390	222	3	80	0.0375000
NODE_435_length_3622_cov_29.112120	2310	2390	223	3	80	0.0375000
NODE_435_length_3622_cov_29.112120	2310	2390	224	6	80	0.0750000
NODE_435_length_3622_cov_29.112120	2310	2390	226	3	80	0.0375000
NODE_435_length_3622_cov_29.112120	2310	2390	227	1	80	0.0125000
NODE_435_length_3622_cov_29.112120	2363	2441	6	3	78	0.0384615
NODE_435_length_3622_cov_29.112120	2363	2441	8	1	78	0.0128205
NODE_435_length_3622_cov_29.112120	2363	2441	15	1	78	0.0128205
NODE_435_length_3622_cov_29.112120	2363	2441	23	2	78	0.0256410
NODE_435_length_3622_cov_29.112120	2363	2441	31	8	78	0.1025641
NODE_435_length_3622_cov_29.112120	2363	2441	33	2	78	0.0256410
NODE_435_length_3622_cov_29.112120	2363	2441	37	4	78	0.0512821
NODE_435_length_3622_cov_29.112120	2363	2441	38	2	78	0.0256410
NODE_435_length_3622_cov_29.112120	2363	2441	39	3	78	0.0384615
NODE_435_length_3622_cov_29.112120	2363	2441	41	1	78	0.0128205
NODE_435_length_3622_cov_29.112120	2363	2441	43	4	78	0.0512821
NODE_435_length_3622_cov_29.112120	2363	2441	45	1	78	0.0128205
NODE_435_length_3622_cov_29.112120	2363	2441	47	3	78	0.0384615
NODE_435_length_3622_cov_29.112120	2363	2441	48	3	78	0.0384615
NODE_435_length_3622_cov_29.112120	2363	2441	52	3	78	0.0384615
NODE_435_length_3622_cov_29.112120	2363	2441	66	2	78	0.0256410
NODE_435_length_3622_cov_29.112120	2363	2441	68	1	78	0.0128205
NODE_435_length_3622_cov_29.112120	2363	2441	69	1	78	0.0128205
NODE_435_length_3622_cov_29.112120	2363	2441	76	1	78	0.0128205
NODE_435_length_3622_cov_29.112120	2363	2441	79	1	78	0.0128205
NODE_435_length_3622_cov_29.112120	2363	2441	83	1	78	0.0128205
NODE_435_length_3622_cov_29.112120	2363	2441	86	1	78	0.0128205
NODE_435_length_3622_cov_29.112120	2363	2441	90	1	78	0.0128205
NODE_435_length_3622_cov_29.112120	2363	2441	94	2	78	0.0256410
NODE_435_length_3622_cov_29.112120	2363	2441	99	2	78	0.0256410
NODE_435_length_3622_cov_29.112120	2363	2441	101	4	78	0.0512821
NODE_435_length_3622_cov_29.112120	2363	2441	103	3	78	0.0384615
NODE_435_length_3622_cov_29.112120	2363	2441	106	1	78	0.0128205
NODE_435_length_3622_cov_29.112120	2363	2441	112	3	78	0.0384615
NODE_435_length_3622_cov_29.112120	2363	2441	117	1	78	0.0128205
NODE_435_length_3622_cov_29.112120	2363	2441	118	1	78	0.0128205
NODE_435_length_3622_cov_29.112120	2363	2441	120	1	78	0.0128205
NODE_435_length_3622_cov_29.112120	2363	2441	123	1	78	0.0128205
NODE_435_length_3622_cov_29.112120	2363	2441	125	1	78	0.0128205
NODE_435_length_3622_cov_29.112120	2363	2441	127	1	78	0.0128205
NODE_435_length_3622_cov_29.112120	2363	2441	131	1	78	0.0128205
NODE_435_length_3622_cov_29.112120	2363	2441	136	1	78	0.0128205
NODE_435_length_3622_cov_29.112120	2363	2441	140	2	78	0.0256410
NODE_435_length_3622_cov_29.112120	2363	2441	144	1	78	0.0128205
NODE_435_length_3622_cov_29.112120	2363	2441	150	1	78	0.0128205
NODE_435_length_3622_cov_29.112120	2363	2441	154	1	78	0.0128205
NODE_437_length_3610_cov_8.785816	294	340	6	7	46	0.1521739
NODE_437_length_3610_cov_8.785816	294	340	8	39	46	0.8478261
NODE_437_length_3610_cov_8.785816	313	393	8	80	80	1.0000000
NODE_444_length_3588_cov_16.296360	2421	2501	0	80	80	1.0000000
NODE_444_length_3588_cov_16.296360	2474	2539	0	65	65	1.0000000
NODE_447_length_3585_cov_2.283419	605	668	0	63	63	1.0000000
NODE_451_length_3567_cov_16.283160	410	429	0	19	19	1.0000000
NODE_451_length_3567_cov_16.283160	2259	2339	122	1	80	0.0125000
NODE_451_length_3567_cov_16.283160	2259	2339	126	2	80	0.0250000
NODE_451_length_3567_cov_16.283160	2259	2339	128	2	80	0.0250000
NODE_451_length_3567_cov_16.283160	2259	2339	132	2	80	0.0250000
NODE_451_length_3567_cov_16.283160	2259	2339	134	1	80	0.0125000
NODE_451_length_3567_cov_16.283160	2259	2339	136	7	80	0.0875000
NODE_451_length_3567_cov_16.283160	2259	2339	139	2	80	0.0250000
NODE_451_length_3567_cov_16.283160	2259	2339	140	3	80	0.0375000
NODE_451_length_3567_cov_16.283160	2259	2339	142	10	80	0.1250000
NODE_451_length_3567_cov_16.283160	2259	2339	143	20	80	0.2500000
NODE_451_length_3567_cov_16.283160	2259	2339	144	2	80	0.0250000
NODE_451_length_3567_cov_16.283160	2259	2339	145	21	80	0.2625000
NODE_451_length_3567_cov_16.283160	2259	2339	146	3	80	0.0375000
NODE_451_length_3567_cov_16.283160	2259	2339	147	3	80	0.0375000
NODE_451_length_3567_cov_16.283160	2259	2339	149	1	80	0.0125000
NODE_451_length_3567_cov_16.283160	2312	2379	3	1	67	0.0149254
NODE_451_length_3567_cov_16.283160	2312	2379	12	1	67	0.0149254
NODE_451_length_3567_cov_16.283160	2312	2379	17	2	67	0.0298507
NODE_451_length_3567_cov_16.283160	2312	2379	18	1	67	0.0149254
NODE_451_length_3567_cov_16.283160	2312	2379	37	1	67	0.0149254
NODE_451_length_3567_cov_16.283160	2312	2379	42	1	67	0.0149254
NODE_451_length_3567_cov_16.283160	2312	2379	46	1	67	0.0149254
NODE_451_length_3567_cov_16.283160	2312	2379	47	1	67	0.0149254
NODE_451_length_3567_cov_16.283160	2312	2379	49	1	67	0.0149254
NODE_451_length_3567_cov_16.283160	2312	2379	55	2	67	0.0298507
NODE_451_length_3567_cov_16.283160	2312	2379	56	1	67	0.0149254
NODE_451_length_3567_cov_16.283160	2312	2379	65	1	67	0.0149254
NODE_451_length_3567_cov_16.283160	2312	2379	67	1	67	0.0149254
NODE_451_length_3567_cov_16.283160	2312	2379	71	1	67	0.0149254
NODE_451_length_3567_cov_16.283160	2312	2379	72	1	67	0.0149254
NODE_451_length_3567_cov_16.283160	2312	2379	80	1	67	0.0149254
NODE_451_length_3567_cov_16.283160	2312	2379	82	1	67	0.0149254
NODE_451_length_3567_cov_16.283160	2312	2379	88	4	67	0.0597015
NODE_451_length_3567_cov_16.283160	2312	2379	98	1	67	0.0149254
NODE_451_length_3567_cov_16.283160	2312	2379	99	1	67	0.0149254
NODE_451_length_3567_cov_16.283160	2312	2379	101	1	67	0.0149254
NODE_451_length_3567_cov_16.283160	2312	2379	105	1	67	0.0149254
NODE_451_length_3567_cov_16.283160	2312	2379	107	2	67	0.0298507
NODE_451_length_3567_cov_16.283160	2312	2379	108	1	67	0.0149254
NODE_451_length_3567_cov_16.283160	2312	2379	112	1	67	0.0149254
NODE_451_length_3567_cov_16.283160	2312	2379	114	1	67	0.0149254
NODE_451_length_3567_cov_16.283160	2312	2379	116	1	67	0.0149254
NODE_451_length_3567_cov_16.283160	2312	2379	118	1	67	0.0149254
NODE_451_length_3567_cov_16.283160	2312	2379	119	3	67	0.0447761
NODE_451_length_3567_cov_16.283160	2312	2379	122	4	67	0.0597015
NODE_451_length_3567_cov_16.283160	2312	2379	126	2	67	0.0298507
NODE_451_length_3567_cov_16.283160	2312	2379	140	1	67	0.0149254
NODE_451_length_3567_cov_16.283160	2312	2379	142	8	67	0.1194030
NODE_451_length_3567_cov_16.283160	2312	2379	143	9	67	0.1343284
NODE_451_length_3567_cov_16.283160	2312	2379	145	6	67	0.0895522
NODE_454_length_3557_cov_12.423077	640	718	0	48	78	0.6153846
NODE_454_length_3557_cov_12.423077	640	718	2	30	78	0.3846154
NODE_454_length_3557_cov_12.423077	640	688	0	48	48	1.0000000
NODE_454_length_3557_cov_12.423077	640	688	0	48	48	1.0000000
NODE_454_length_3557_cov_12.423077	640	688	0	48	48	1.0000000
NODE_454_length_3557_cov_12.423077	640	688	0	48	48	1.0000000
NODE_454_length_3557_cov_12.423077	693	771	2	78	78	1.0000000
NODE_455_length_3548_cov_7.216295	554	634	0	80	80	1.0000000
NODE_455_length_3548_cov_7.216295	607	687	0	80	80	1.0000000
NODE_461_length_3518_cov_40.508336	1320	1400	0	80	80	1.0000000
NODE_461_length_3518_cov_40.508336	1373	1453	0	80	80	1.0000000
NODE_465_length_3497_cov_65.791348	3062	3142	624	2	80	0.0250000
NODE_465_length_3497_cov_65.791348	3062	3142	626	1	80	0.0125000
NODE_465_length_3497_cov_65.791348	3062	3142	634	1	80	0.0125000
NODE_465_length_3497_cov_65.791348	3062	3142	642	2	80	0.0250000
NODE_465_length_3497_cov_65.791348	3062	3142	644	2	80	0.0250000
NODE_465_length_3497_cov_65.791348	3062	3142	647	1	80	0.0125000
NODE_465_length_3497_cov_65.791348	3062	3142	661	1	80	0.0125000
NODE_465_length_3497_cov_65.791348	3062	3142	663	1	80	0.0125000
NODE_465_length_3497_cov_65.791348	3062	3142	670	1	80	0.0125000
NODE_465_length_3497_cov_65.791348	3062	3142	673	1	80	0.0125000
NODE_465_length_3497_cov_65.791348	3062	3142	678	1	80	0.0125000
NODE_465_length_3497_cov_65.791348	3062	3142	687	1	80	0.0125000
NODE_465_length_3497_cov_65.791348	3062	3142	695	1	80	0.0125000
NODE_465_length_3497_cov_65.791348	3062	3142	697	2	80	0.0250000
NODE_465_length_3497_cov_65.791348	3062	3142	699	1	80	0.0125000
NODE_465_length_3497_cov_65.791348	3062	3142	700	2	80	0.0250000
NODE_465_length_3497_cov_65.791348	3062	3142	701	1	80	0.0125000
NODE_465_length_3497_cov_65.791348	3062	3142	702	1	80	0.0125000
NODE_465_length_3497_cov_65.791348	3062	3142	706	1	80	0.0125000
NODE_465_length_3497_cov_65.791348	3062	3142	707	1	80	0.0125000
NODE_465_length_3497_cov_65.791348	3062	3142	709	2	80	0.0250000
NODE_465_length_3497_cov_65.791348	3062	3142	713	1	80	0.0125000
NODE_465_length_3497_cov_65.791348	3062	3142	714	1	80	0.0125000
NODE_465_length_3497_cov_65.791348	3062	3142	715	1	80	0.0125000
NODE_465_length_3497_cov_65.791348	3062	3142	717	1	80	0.0125000
NODE_465_length_3497_cov_65.791348	3062	3142	719	1	80	0.0125000
NODE_465_length_3497_cov_65.791348	3062	3142	725	1	80	0.0125000
NODE_465_length_3497_cov_65.791348	3062	3142	729	2	80	0.0250000
NODE_465_length_3497_cov_65.791348	3062	3142	736	1	80	0.0125000
NODE_465_length_3497_cov_65.791348	3062	3142	739	1	80	0.0125000
NODE_465_length_3497_cov_65.791348	3062	3142	751	1	80	0.0125000
NODE_465_length_3497_cov_65.791348	3062	3142	753	1	80	0.0125000
NODE_465_length_3497_cov_65.791348	3062	3142	755	1	80	0.0125000
NODE_465_length_3497_cov_65.791348	3062	3142	758	2	80	0.0250000
NODE_465_length_3497_cov_65.791348	3062	3142	759	2	80	0.0250000
NODE_465_length_3497_cov_65.791348	3062	3142	760	3	80	0.0375000
NODE_465_length_3497_cov_65.791348	3062	3142	761	2	80	0.0250000
NODE_465_length_3497_cov_65.791348	3062	3142	762	2	80	0.0250000
NODE_465_length_3497_cov_65.791348	3062	3142	763	1	80	0.0125000
NODE_465_length_3497_cov_65.791348	3062	3142	764	2	80	0.0250000
NODE_465_length_3497_cov_65.791348	3062	3142	765	1	80	0.0125000
NODE_465_length_3497_cov_65.791348	3062	3142	766	2	80	0.0250000
NODE_465_length_3497_cov_65.791348	3062	3142	767	1	80	0.0125000
NODE_465_length_3497_cov_65.791348	3062	3142	770	2	80	0.0250000
NODE_465_length_3497_cov_65.791348	3062	3142	773	2	80	0.0250000
NODE_465_length_3497_cov_65.791348	3062	3142	775	2	80	0.0250000
NODE_465_length_3497_cov_65.791348	3062	3142	776	1	80	0.0125000
NODE_465_length_3497_cov_65.791348	3062	3142	778	1	80	0.0125000
NODE_465_length_3497_cov_65.791348	3062	3142	781	1	80	0.0125000
NODE_465_length_3497_cov_65.791348	3062	3142	782	1	80	0.0125000
NODE_465_length_3497_cov_65.791348	3062	3142	783	2	80	0.0250000
NODE_465_length_3497_cov_65.791348	3062	3142	784	2	80	0.0250000
NODE_465_length_3497_cov_65.791348	3062	3142	785	2	80	0.0250000
NODE_465_length_3497_cov_65.791348	3062	3142	789	2	80	0.0250000
NODE_465_length_3497_cov_65.791348	3062	3142	790	2	80	0.0250000
NODE_465_length_3497_cov_65.791348	3062	3142	795	1	80	0.0125000
NODE_465_length_3497_cov_65.791348	3062	3142	799	1	80	0.0125000
NODE_466_length_3488_cov_2.243730	506	529	0	23	23	1.0000000
NODE_470_length_3483_cov_14.759456	360	440	0	80	80	1.0000000
NODE_470_length_3483_cov_14.759456	413	493	0	80	80	1.0000000
NODE_474_length_3471_cov_37.887604	2795	2875	0	80	80	1.0000000
NODE_474_length_3471_cov_37.887604	2848	2928	0	80	80	1.0000000
NODE_474_length_3471_cov_37.887604	2924	2943	0	19	19	1.0000000
NODE_474_length_3471_cov_37.887604	2924	3004	0	80	80	1.0000000
NODE_474_length_3471_cov_37.887604	2977	3057	0	80	80	1.0000000
NODE_479_length_3451_cov_29.833234	2973	3053	2	80	80	1.0000000
NODE_479_length_3451_cov_29.833234	3026	3106	1	21	80	0.2625000
NODE_479_length_3451_cov_29.833234	3026	3106	2	59	80	0.7375000
NODE_481_length_3446_cov_32.421273	3181	3261	30	12	80	0.1500000
NODE_481_length_3446_cov_32.421273	3181	3261	32	1	80	0.0125000
NODE_481_length_3446_cov_32.421273	3181	3261	34	8	80	0.1000000
NODE_481_length_3446_cov_32.421273	3181	3261	36	59	80	0.7375000
NODE_482_length_3444_cov_29.954858	792	872	0	52	80	0.6500000
NODE_482_length_3444_cov_29.954858	792	872	2	25	80	0.3125000
NODE_482_length_3444_cov_29.954858	792	872	4	3	80	0.0375000
NODE_482_length_3444_cov_29.954858	845	925	2	24	80	0.3000000
NODE_482_length_3444_cov_29.954858	845	925	4	46	80	0.5750000
NODE_482_length_3444_cov_29.954858	845	925	8	10	80	0.1250000
NODE_483_length_3442_cov_17.799880	3155	3220	6	1	65	0.0153846
NODE_483_length_3442_cov_17.799880	3155	3220	10	5	65	0.0769231
NODE_483_length_3442_cov_17.799880	3155	3220	13	1	65	0.0153846
NODE_483_length_3442_cov_17.799880	3155	3220	14	8	65	0.1230769
NODE_483_length_3442_cov_17.799880	3155	3220	16	3	65	0.0461538
NODE_483_length_3442_cov_17.799880	3155	3220	18	2	65	0.0307692
NODE_483_length_3442_cov_17.799880	3155	3220	20	1	65	0.0153846
NODE_483_length_3442_cov_17.799880	3155	3220	23	1	65	0.0153846
NODE_483_length_3442_cov_17.799880	3155	3220	27	1	65	0.0153846
NODE_483_length_3442_cov_17.799880	3155	3220	31	8	65	0.1230769
NODE_483_length_3442_cov_17.799880	3155	3220	35	3	65	0.0461538
NODE_483_length_3442_cov_17.799880	3155	3220	37	1	65	0.0153846
NODE_483_length_3442_cov_17.799880	3155	3220	39	2	65	0.0307692
NODE_483_length_3442_cov_17.799880	3155	3220	43	1	65	0.0153846
NODE_483_length_3442_cov_17.799880	3155	3220	45	2	65	0.0307692
NODE_483_length_3442_cov_17.799880	3155	3220	49	4	65	0.0615385
NODE_483_length_3442_cov_17.799880	3155	3220	50	2	65	0.0307692
NODE_483_length_3442_cov_17.799880	3155	3220	54	1	65	0.0153846
NODE_483_length_3442_cov_17.799880	3155	3220	56	2	65	0.0307692
NODE_483_length_3442_cov_17.799880	3155	3220	60	5	65	0.0769231
NODE_483_length_3442_cov_17.799880	3155	3220	66	2	65	0.0307692
NODE_483_length_3442_cov_17.799880	3155	3220	68	1	65	0.0153846
NODE_483_length_3442_cov_17.799880	3155	3220	74	2	65	0.0307692
NODE_483_length_3442_cov_17.799880	3155	3220	79	1	65	0.0153846
NODE_483_length_3442_cov_17.799880	3155	3220	84	2	65	0.0307692
NODE_483_length_3442_cov_17.799880	3155	3220	86	1	65	0.0153846
NODE_483_length_3442_cov_17.799880	3155	3220	88	2	65	0.0307692
NODE_483_length_3442_cov_17.799880	3208	3273	60	1	65	0.0153846
NODE_483_length_3442_cov_17.799880	3208	3273	66	2	65	0.0307692
NODE_483_length_3442_cov_17.799880	3208	3273	68	1	65	0.0153846
NODE_483_length_3442_cov_17.799880	3208	3273	74	2	65	0.0307692
NODE_483_length_3442_cov_17.799880	3208	3273	79	1	65	0.0153846
NODE_483_length_3442_cov_17.799880	3208	3273	84	2	65	0.0307692
NODE_483_length_3442_cov_17.799880	3208	3273	86	1	65	0.0153846
NODE_483_length_3442_cov_17.799880	3208	3273	88	2	65	0.0307692
NODE_483_length_3442_cov_17.799880	3208	3273	94	2	65	0.0307692
NODE_483_length_3442_cov_17.799880	3208	3273	96	3	65	0.0461538
NODE_483_length_3442_cov_17.799880	3208	3273	100	3	65	0.0461538
NODE_483_length_3442_cov_17.799880	3208	3273	103	1	65	0.0153846
NODE_483_length_3442_cov_17.799880	3208	3273	106	1	65	0.0153846
NODE_483_length_3442_cov_17.799880	3208	3273	114	1	65	0.0153846
NODE_483_length_3442_cov_17.799880	3208	3273	120	1	65	0.0153846
NODE_483_length_3442_cov_17.799880	3208	3273	122	1	65	0.0153846
NODE_483_length_3442_cov_17.799880	3208	3273	124	1	65	0.0153846
NODE_483_length_3442_cov_17.799880	3208	3273	125	1	65	0.0153846
NODE_483_length_3442_cov_17.799880	3208	3273	132	3	65	0.0461538
NODE_483_length_3442_cov_17.799880	3208	3273	134	1	65	0.0153846
NODE_483_length_3442_cov_17.799880	3208	3273	141	1	65	0.0153846
NODE_483_length_3442_cov_17.799880	3208	3273	142	1	65	0.0153846
NODE_483_length_3442_cov_17.799880	3208	3273	150	1	65	0.0153846
NODE_483_length_3442_cov_17.799880	3208	3273	152	1	65	0.0153846
NODE_483_length_3442_cov_17.799880	3208	3273	156	2	65	0.0307692
NODE_483_length_3442_cov_17.799880	3208	3273	162	2	65	0.0307692
NODE_483_length_3442_cov_17.799880	3208	3273	164	1	65	0.0153846
NODE_483_length_3442_cov_17.799880	3208	3273	165	1	65	0.0153846
NODE_483_length_3442_cov_17.799880	3208	3273	171	1	65	0.0153846
NODE_483_length_3442_cov_17.799880	3208	3273	174	1	65	0.0153846
NODE_483_length_3442_cov_17.799880	3208	3273	178	1	65	0.0153846
NODE_483_length_3442_cov_17.799880	3208	3273	184	3	65	0.0461538
NODE_483_length_3442_cov_17.799880	3208	3273	187	1	65	0.0153846
NODE_483_length_3442_cov_17.799880	3208	3273	190	2	65	0.0307692
NODE_483_length_3442_cov_17.799880	3208	3273	194	1	65	0.0153846
NODE_483_length_3442_cov_17.799880	3208	3273	196	1	65	0.0153846
NODE_483_length_3442_cov_17.799880	3208	3273	198	1	65	0.0153846
NODE_483_length_3442_cov_17.799880	3208	3273	200	1	65	0.0153846
NODE_483_length_3442_cov_17.799880	3208	3273	202	1	65	0.0153846
NODE_483_length_3442_cov_17.799880	3208	3273	207	1	65	0.0153846
NODE_483_length_3442_cov_17.799880	3208	3273	214	1	65	0.0153846
NODE_483_length_3442_cov_17.799880	3208	3273	217	1	65	0.0153846
NODE_483_length_3442_cov_17.799880	3208	3273	224	1	65	0.0153846
NODE_483_length_3442_cov_17.799880	3208	3273	230	1	65	0.0153846
NODE_483_length_3442_cov_17.799880	3208	3273	232	1	65	0.0153846
NODE_483_length_3442_cov_17.799880	3208	3273	235	1	65	0.0153846
NODE_483_length_3442_cov_17.799880	3208	3273	250	1	65	0.0153846
NODE_483_length_3442_cov_17.799880	3208	3273	252	2	65	0.0307692
NODE_486_length_3429_cov_5.070270	125	148	31	1	23	0.0434783
NODE_486_length_3429_cov_5.070270	125	148	32	19	23	0.8260869
NODE_486_length_3429_cov_5.070270	125	148	33	1	23	0.0434783
NODE_486_length_3429_cov_5.070270	125	148	36	2	23	0.0869565
NODE_493_length_3408_cov_2.406769	0	45	0	45	45	1.0000000
NODE_495_length_3405_cov_44.930127	2683	2759	0	76	76	1.0000000
NODE_495_length_3405_cov_44.930127	3116	3164	0	48	48	1.0000000
NODE_496_length_3402_cov_28.961550	128	183	0	55	55	1.0000000
NODE_496_length_3402_cov_28.961550	3154	3234	27	5	80	0.0625000
NODE_496_length_3402_cov_28.961550	3154	3234	31	3	80	0.0375000
NODE_496_length_3402_cov_28.961550	3154	3234	33	4	80	0.0500000
NODE_496_length_3402_cov_28.961550	3154	3234	38	6	80	0.0750000
NODE_496_length_3402_cov_28.961550	3154	3234	40	10	80	0.1250000
NODE_496_length_3402_cov_28.961550	3154	3234	41	19	80	0.2375000
NODE_496_length_3402_cov_28.961550	3154	3234	42	4	80	0.0500000
NODE_496_length_3402_cov_28.961550	3154	3234	43	6	80	0.0750000
NODE_496_length_3402_cov_28.961550	3154	3234	45	23	80	0.2875000
NODE_496_length_3402_cov_28.961550	3207	3287	2	10	80	0.1250000
NODE_496_length_3402_cov_28.961550	3207	3287	8	3	80	0.0375000
NODE_496_length_3402_cov_28.961550	3207	3287	14	4	80	0.0500000
NODE_496_length_3402_cov_28.961550	3207	3287	16	17	80	0.2125000
NODE_496_length_3402_cov_28.961550	3207	3287	18	7	80	0.0875000
NODE_496_length_3402_cov_28.961550	3207	3287	20	5	80	0.0625000
NODE_496_length_3402_cov_28.961550	3207	3287	21	4	80	0.0500000
NODE_496_length_3402_cov_28.961550	3207	3287	27	8	80	0.1000000
NODE_496_length_3402_cov_28.961550	3207	3287	31	3	80	0.0375000
NODE_496_length_3402_cov_28.961550	3207	3287	33	4	80	0.0500000
NODE_496_length_3402_cov_28.961550	3207	3287	38	6	80	0.0750000
NODE_496_length_3402_cov_28.961550	3207	3287	40	9	80	0.1125000
NODE_498_length_3393_cov_43.623558	1009	1075	10	1	66	0.0151515
NODE_498_length_3393_cov_43.623558	1009	1075	13	1	66	0.0151515
NODE_498_length_3393_cov_43.623558	1009	1075	18	1	66	0.0151515
NODE_498_length_3393_cov_43.623558	1009	1075	24	5	66	0.0757576
NODE_498_length_3393_cov_43.623558	1009	1075	30	2	66	0.0303030
NODE_498_length_3393_cov_43.623558	1009	1075	35	3	66	0.0454545
NODE_498_length_3393_cov_43.623558	1009	1075	38	1	66	0.0151515
NODE_498_length_3393_cov_43.623558	1009	1075	39	4	66	0.0606061
NODE_498_length_3393_cov_43.623558	1009	1075	44	1	66	0.0151515
NODE_498_length_3393_cov_43.623558	1009	1075	47	2	66	0.0303030
NODE_498_length_3393_cov_43.623558	1009	1075	49	4	66	0.0606061
NODE_498_length_3393_cov_43.623558	1009	1075	53	1	66	0.0151515
NODE_498_length_3393_cov_43.623558	1009	1075	55	4	66	0.0606061
NODE_498_length_3393_cov_43.623558	1009	1075	57	1	66	0.0151515
NODE_498_length_3393_cov_43.623558	1009	1075	59	1	66	0.0151515
NODE_498_length_3393_cov_43.623558	1009	1075	61	1	66	0.0151515
NODE_498_length_3393_cov_43.623558	1009	1075	62	3	66	0.0454545
NODE_498_length_3393_cov_43.623558	1009	1075	64	3	66	0.0454545
NODE_498_length_3393_cov_43.623558	1009	1075	68	1	66	0.0151515
NODE_498_length_3393_cov_43.623558	1009	1075	70	1	66	0.0151515
NODE_498_length_3393_cov_43.623558	1009	1075	72	4	66	0.0606061
NODE_498_length_3393_cov_43.623558	1009	1075	73	1	66	0.0151515
NODE_498_length_3393_cov_43.623558	1009	1075	75	6	66	0.0909091
NODE_498_length_3393_cov_43.623558	1009	1075	79	1	66	0.0151515
NODE_498_length_3393_cov_43.623558	1009	1075	82	5	66	0.0757576
NODE_498_length_3393_cov_43.623558	1009	1075	83	5	66	0.0757576
NODE_498_length_3393_cov_43.623558	1009	1075	85	2	66	0.0303030
NODE_498_length_3393_cov_43.623558	1009	1075	87	1	66	0.0151515
NODE_498_length_3393_cov_43.623558	1048	1128	0	32	80	0.4000000
NODE_498_length_3393_cov_43.623558	1048	1128	1	3	80	0.0375000
NODE_498_length_3393_cov_43.623558	1048	1128	3	15	80	0.1875000
NODE_498_length_3393_cov_43.623558	1048	1128	9	1	80	0.0125000
NODE_498_length_3393_cov_43.623558	1048	1128	10	3	80	0.0375000
NODE_498_length_3393_cov_43.623558	1048	1128	13	1	80	0.0125000
NODE_498_length_3393_cov_43.623558	1048	1128	18	1	80	0.0125000
NODE_498_length_3393_cov_43.623558	1048	1128	24	5	80	0.0625000
NODE_498_length_3393_cov_43.623558	1048	1128	30	2	80	0.0250000
NODE_498_length_3393_cov_43.623558	1048	1128	35	3	80	0.0375000
NODE_498_length_3393_cov_43.623558	1048	1128	38	1	80	0.0125000
NODE_498_length_3393_cov_43.623558	1048	1128	39	4	80	0.0500000
NODE_498_length_3393_cov_43.623558	1048	1128	44	1	80	0.0125000
NODE_498_length_3393_cov_43.623558	1048	1128	47	2	80	0.0250000
NODE_498_length_3393_cov_43.623558	1048	1128	49	4	80	0.0500000
NODE_498_length_3393_cov_43.623558	1048	1128	53	1	80	0.0125000
NODE_498_length_3393_cov_43.623558	1048	1128	55	1	80	0.0125000
NODE_498_length_3393_cov_43.623558	3086	3128	29	1	42	0.0238095
NODE_498_length_3393_cov_43.623558	3086	3128	93	1	42	0.0238095
NODE_498_length_3393_cov_43.623558	3086	3128	97	1	42	0.0238095
NODE_498_length_3393_cov_43.623558	3086	3128	154	1	42	0.0238095
NODE_498_length_3393_cov_43.623558	3086	3128	160	1	42	0.0238095
NODE_498_length_3393_cov_43.623558	3086	3128	178	1	42	0.0238095
NODE_498_length_3393_cov_43.623558	3086	3128	186	1	42	0.0238095
NODE_498_length_3393_cov_43.623558	3086	3128	196	2	42	0.0476190
NODE_498_length_3393_cov_43.623558	3086	3128	198	2	42	0.0476190
NODE_498_length_3393_cov_43.623558	3086	3128	200	3	42	0.0714286
NODE_498_length_3393_cov_43.623558	3086	3128	204	1	42	0.0238095
NODE_498_length_3393_cov_43.623558	3086	3128	214	2	42	0.0476190
NODE_498_length_3393_cov_43.623558	3086	3128	220	1	42	0.0238095
NODE_498_length_3393_cov_43.623558	3086	3128	221	1	42	0.0238095
NODE_498_length_3393_cov_43.623558	3086	3128	225	1	42	0.0238095
NODE_498_length_3393_cov_43.623558	3086	3128	232	1	42	0.0238095
NODE_498_length_3393_cov_43.623558	3086	3128	240	1	42	0.0238095
NODE_498_length_3393_cov_43.623558	3086	3128	245	1	42	0.0238095
NODE_498_length_3393_cov_43.623558	3086	3128	250	1	42	0.0238095
NODE_498_length_3393_cov_43.623558	3086	3128	259	1	42	0.0238095
NODE_498_length_3393_cov_43.623558	3086	3128	268	1	42	0.0238095
NODE_498_length_3393_cov_43.623558	3086	3128	279	1	42	0.0238095
NODE_498_length_3393_cov_43.623558	3086	3128	282	1	42	0.0238095
NODE_498_length_3393_cov_43.623558	3086	3128	285	1	42	0.0238095
NODE_498_length_3393_cov_43.623558	3086	3128	286	1	42	0.0238095
NODE_498_length_3393_cov_43.623558	3086	3128	291	1	42	0.0238095
NODE_498_length_3393_cov_43.623558	3086	3128	297	1	42	0.0238095
NODE_498_length_3393_cov_43.623558	3086	3128	302	1	42	0.0238095
NODE_498_length_3393_cov_43.623558	3086	3128	306	2	42	0.0476190
NODE_498_length_3393_cov_43.623558	3086	3128	311	1	42	0.0238095
NODE_498_length_3393_cov_43.623558	3086	3128	320	1	42	0.0238095
NODE_498_length_3393_cov_43.623558	3086	3128	324	1	42	0.0238095
NODE_498_length_3393_cov_43.623558	3086	3128	331	1	42	0.0238095
NODE_498_length_3393_cov_43.623558	3086	3128	333	1	42	0.0238095
NODE_498_length_3393_cov_43.623558	3086	3128	337	1	42	0.0238095
NODE_498_length_3393_cov_43.623558	3086	3128	338	1	42	0.0238095
NODE_498_length_3393_cov_43.623558	3293	3373	139	1	80	0.0125000
NODE_498_length_3393_cov_43.623558	3293	3373	148	1	80	0.0125000
NODE_498_length_3393_cov_43.623558	3293	3373	156	1	80	0.0125000
NODE_498_length_3393_cov_43.623558	3293	3373	163	1	80	0.0125000
NODE_498_length_3393_cov_43.623558	3293	3373	173	1	80	0.0125000
NODE_498_length_3393_cov_43.623558	3293	3373	185	1	80	0.0125000
NODE_498_length_3393_cov_43.623558	3293	3373	191	1	80	0.0125000
NODE_498_length_3393_cov_43.623558	3293	3373	192	1	80	0.0125000
NODE_498_length_3393_cov_43.623558	3293	3373	193	1	80	0.0125000
NODE_498_length_3393_cov_43.623558	3293	3373	198	1	80	0.0125000
NODE_498_length_3393_cov_43.623558	3293	3373	216	2	80	0.0250000
NODE_498_length_3393_cov_43.623558	3293	3373	230	1	80	0.0125000
NODE_498_length_3393_cov_43.623558	3293	3373	232	1	80	0.0125000
NODE_498_length_3393_cov_43.623558	3293	3373	242	1	80	0.0125000
NODE_498_length_3393_cov_43.623558	3293	3373	245	1	80	0.0125000
NODE_498_length_3393_cov_43.623558	3293	3373	251	1	80	0.0125000
NODE_498_length_3393_cov_43.623558	3293	3373	267	1	80	0.0125000
NODE_498_length_3393_cov_43.623558	3293	3373	286	1	80	0.0125000
NODE_498_length_3393_cov_43.623558	3293	3373	288	1	80	0.0125000
NODE_498_length_3393_cov_43.623558	3293	3373	294	1	80	0.0125000
NODE_498_length_3393_cov_43.623558	3293	3373	320	1	80	0.0125000
NODE_498_length_3393_cov_43.623558	3293	3373	329	1	80	0.0125000
NODE_498_length_3393_cov_43.623558	3293	3373	330	1	80	0.0125000
NODE_498_length_3393_cov_43.623558	3293	3373	335	1	80	0.0125000
NODE_498_length_3393_cov_43.623558	3293	3373	347	2	80	0.0250000
NODE_498_length_3393_cov_43.623558	3293	3373	351	2	80	0.0250000
NODE_498_length_3393_cov_43.623558	3293	3373	353	1	80	0.0125000
NODE_498_length_3393_cov_43.623558	3293	3373	355	2	80	0.0250000
NODE_498_length_3393_cov_43.623558	3293	3373	360	2	80	0.0250000
NODE_498_length_3393_cov_43.623558	3293	3373	362	2	80	0.0250000
NODE_498_length_3393_cov_43.623558	3293	3373	370	1	80	0.0125000
NODE_498_length_3393_cov_43.623558	3293	3373	373	1	80	0.0125000
NODE_498_length_3393_cov_43.623558	3293	3373	382	1	80	0.0125000
NODE_498_length_3393_cov_43.623558	3293	3373	389	1	80	0.0125000
NODE_498_length_3393_cov_43.623558	3293	3373	401	4	80	0.0500000
NODE_498_length_3393_cov_43.623558	3293	3373	402	1	80	0.0125000
NODE_498_length_3393_cov_43.623558	3293	3373	405	1	80	0.0125000
NODE_498_length_3393_cov_43.623558	3293	3373	408	2	80	0.0250000
NODE_498_length_3393_cov_43.623558	3293	3373	412	2	80	0.0250000
NODE_498_length_3393_cov_43.623558	3293	3373	414	2	80	0.0250000
NODE_498_length_3393_cov_43.623558	3293	3373	419	1	80	0.0125000
NODE_498_length_3393_cov_43.623558	3293	3373	421	1	80	0.0125000
NODE_498_length_3393_cov_43.623558	3293	3373	428	1	80	0.0125000
NODE_498_length_3393_cov_43.623558	3293	3373	430	1	80	0.0125000
NODE_498_length_3393_cov_43.623558	3293	3373	434	1	80	0.0125000
NODE_498_length_3393_cov_43.623558	3293	3373	436	1	80	0.0125000
NODE_498_length_3393_cov_43.623558	3293	3373	444	1	80	0.0125000
NODE_498_length_3393_cov_43.623558	3293	3373	450	1	80	0.0125000
NODE_498_length_3393_cov_43.623558	3293	3373	452	1	80	0.0125000
NODE_498_length_3393_cov_43.623558	3293	3373	456	1	80	0.0125000
NODE_498_length_3393_cov_43.623558	3293	3373	460	1	80	0.0125000
NODE_498_length_3393_cov_43.623558	3293	3373	465	1	80	0.0125000
NODE_498_length_3393_cov_43.623558	3293	3373	466	1	80	0.0125000
NODE_498_length_3393_cov_43.623558	3293	3373	467	2	80	0.0250000
NODE_498_length_3393_cov_43.623558	3293	3373	474	1	80	0.0125000
NODE_498_length_3393_cov_43.623558	3293	3373	478	1	80	0.0125000
NODE_498_length_3393_cov_43.623558	3293	3373	481	1	80	0.0125000
NODE_498_length_3393_cov_43.623558	3293	3373	482	2	80	0.0250000
NODE_498_length_3393_cov_43.623558	3293	3373	489	1	80	0.0125000
NODE_498_length_3393_cov_43.623558	3293	3373	491	1	80	0.0125000
NODE_498_length_3393_cov_43.623558	3293	3373	496	2	80	0.0250000
NODE_498_length_3393_cov_43.623558	3293	3373	500	2	80	0.0250000
NODE_498_length_3393_cov_43.623558	3293	3373	506	1	80	0.0125000
NODE_498_length_3393_cov_43.623558	3293	3373	510	1	80	0.0125000
NODE_499_length_3392_cov_41.514728	255	335	0	80	80	1.0000000
NODE_499_length_3392_cov_41.514728	308	388	0	80	80	1.0000000
NODE_499_length_3392_cov_41.514728	917	997	151	1	80	0.0125000
NODE_499_length_3392_cov_41.514728	917	997	153	1	80	0.0125000
NODE_499_length_3392_cov_41.514728	917	997	157	1	80	0.0125000
NODE_499_length_3392_cov_41.514728	917	997	162	1	80	0.0125000
NODE_499_length_3392_cov_41.514728	917	997	175	1	80	0.0125000
NODE_499_length_3392_cov_41.514728	917	997	191	1	80	0.0125000
NODE_499_length_3392_cov_41.514728	917	997	202	1	80	0.0125000
NODE_499_length_3392_cov_41.514728	917	997	208	1	80	0.0125000
NODE_499_length_3392_cov_41.514728	917	997	213	1	80	0.0125000
NODE_499_length_3392_cov_41.514728	917	997	220	1	80	0.0125000
NODE_499_length_3392_cov_41.514728	917	997	233	1	80	0.0125000
NODE_499_length_3392_cov_41.514728	917	997	240	1	80	0.0125000
NODE_499_length_3392_cov_41.514728	917	997	246	1	80	0.0125000
NODE_499_length_3392_cov_41.514728	917	997	250	1	80	0.0125000
NODE_499_length_3392_cov_41.514728	917	997	253	1	80	0.0125000
NODE_499_length_3392_cov_41.514728	917	997	258	1	80	0.0125000
NODE_499_length_3392_cov_41.514728	917	997	269	1	80	0.0125000
NODE_499_length_3392_cov_41.514728	917	997	272	1	80	0.0125000
NODE_499_length_3392_cov_41.514728	917	997	285	1	80	0.0125000
NODE_499_length_3392_cov_41.514728	917	997	311	1	80	0.0125000
NODE_499_length_3392_cov_41.514728	917	997	322	1	80	0.0125000
NODE_499_length_3392_cov_41.514728	917	997	323	1	80	0.0125000
NODE_499_length_3392_cov_41.514728	917	997	326	1	80	0.0125000
NODE_499_length_3392_cov_41.514728	917	997	328	1	80	0.0125000
NODE_499_length_3392_cov_41.514728	917	997	329	1	80	0.0125000
NODE_499_length_3392_cov_41.514728	917	997	334	1	80	0.0125000
NODE_499_length_3392_cov_41.514728	917	997	336	1	80	0.0125000
NODE_499_length_3392_cov_41.514728	917	997	338	1	80	0.0125000
NODE_499_length_3392_cov_41.514728	917	997	340	1	80	0.0125000
NODE_499_length_3392_cov_41.514728	917	997	346	1	80	0.0125000
NODE_499_length_3392_cov_41.514728	917	997	351	1	80	0.0125000
NODE_499_length_3392_cov_41.514728	917	997	360	1	80	0.0125000
NODE_499_length_3392_cov_41.514728	917	997	365	1	80	0.0125000
NODE_499_length_3392_cov_41.514728	917	997	370	1	80	0.0125000
NODE_499_length_3392_cov_41.514728	917	997	373	1	80	0.0125000
NODE_499_length_3392_cov_41.514728	917	997	381	1	80	0.0125000
NODE_499_length_3392_cov_41.514728	917	997	382	1	80	0.0125000
NODE_499_length_3392_cov_41.514728	917	997	394	1	80	0.0125000
NODE_499_length_3392_cov_41.514728	917	997	396	1	80	0.0125000
NODE_499_length_3392_cov_41.514728	917	997	409	1	80	0.0125000
NODE_499_length_3392_cov_41.514728	917	997	412	1	80	0.0125000
NODE_499_length_3392_cov_41.514728	917	997	418	2	80	0.0250000
NODE_499_length_3392_cov_41.514728	917	997	421	1	80	0.0125000
NODE_499_length_3392_cov_41.514728	917	997	422	1	80	0.0125000
NODE_499_length_3392_cov_41.514728	917	997	424	1	80	0.0125000
NODE_499_length_3392_cov_41.514728	917	997	442	1	80	0.0125000
NODE_499_length_3392_cov_41.514728	917	997	446	1	80	0.0125000
NODE_499_length_3392_cov_41.514728	917	997	458	1	80	0.0125000
NODE_499_length_3392_cov_41.514728	917	997	462	1	80	0.0125000
NODE_499_length_3392_cov_41.514728	917	997	466	1	80	0.0125000
NODE_499_length_3392_cov_41.514728	917	997	472	1	80	0.0125000
NODE_499_length_3392_cov_41.514728	917	997	475	2	80	0.0250000
NODE_499_length_3392_cov_41.514728	917	997	478	1	80	0.0125000
NODE_499_length_3392_cov_41.514728	917	997	487	1	80	0.0125000
NODE_499_length_3392_cov_41.514728	917	997	490	1	80	0.0125000
NODE_499_length_3392_cov_41.514728	917	997	496	1	80	0.0125000
NODE_499_length_3392_cov_41.514728	917	997	498	1	80	0.0125000
NODE_499_length_3392_cov_41.514728	917	997	509	1	80	0.0125000
NODE_499_length_3392_cov_41.514728	917	997	515	1	80	0.0125000
NODE_499_length_3392_cov_41.514728	917	997	528	1	80	0.0125000
NODE_499_length_3392_cov_41.514728	917	997	538	1	80	0.0125000
NODE_499_length_3392_cov_41.514728	917	997	551	1	80	0.0125000
NODE_499_length_3392_cov_41.514728	917	997	553	1	80	0.0125000
NODE_499_length_3392_cov_41.514728	917	997	557	1	80	0.0125000
NODE_499_length_3392_cov_41.514728	917	997	558	1	80	0.0125000
NODE_499_length_3392_cov_41.514728	917	997	559	1	80	0.0125000
NODE_499_length_3392_cov_41.514728	917	997	561	1	80	0.0125000
NODE_499_length_3392_cov_41.514728	917	997	562	1	80	0.0125000
NODE_499_length_3392_cov_41.514728	917	997	563	3	80	0.0375000
NODE_499_length_3392_cov_41.514728	917	997	565	3	80	0.0375000
NODE_499_length_3392_cov_41.514728	917	997	566	1	80	0.0125000
NODE_499_length_3392_cov_41.514728	917	997	567	1	80	0.0125000
NODE_499_length_3392_cov_41.514728	917	997	568	1	80	0.0125000
NODE_499_length_3392_cov_41.514728	917	997	572	1	80	0.0125000
NODE_499_length_3392_cov_41.514728	970	1053	92	2	83	0.0240964
NODE_499_length_3392_cov_41.514728	970	1053	96	2	83	0.0240964
NODE_499_length_3392_cov_41.514728	970	1053	100	3	83	0.0361446
NODE_499_length_3392_cov_41.514728	970	1053	104	1	83	0.0120482
NODE_499_length_3392_cov_41.514728	970	1053	106	1	83	0.0120482
NODE_499_length_3392_cov_41.514728	970	1053	109	1	83	0.0120482
NODE_499_length_3392_cov_41.514728	970	1053	110	1	83	0.0120482
NODE_499_length_3392_cov_41.514728	970	1053	111	2	83	0.0240964
NODE_499_length_3392_cov_41.514728	970	1053	112	4	83	0.0481928
NODE_499_length_3392_cov_41.514728	970	1053	113	3	83	0.0361446
NODE_499_length_3392_cov_41.514728	970	1053	115	5	83	0.0602410
NODE_499_length_3392_cov_41.514728	970	1053	116	1	83	0.0120482
NODE_499_length_3392_cov_41.514728	970	1053	117	3	83	0.0361446
NODE_499_length_3392_cov_41.514728	970	1053	118	1	83	0.0120482
NODE_499_length_3392_cov_41.514728	970	1053	120	1	83	0.0120482
NODE_499_length_3392_cov_41.514728	970	1053	124	1	83	0.0120482
NODE_499_length_3392_cov_41.514728	970	1053	125	1	83	0.0120482
NODE_499_length_3392_cov_41.514728	970	1053	127	3	83	0.0361446
NODE_499_length_3392_cov_41.514728	970	1053	129	1	83	0.0120482
NODE_499_length_3392_cov_41.514728	970	1053	130	2	83	0.0240964
NODE_499_length_3392_cov_41.514728	970	1053	132	4	83	0.0481928
NODE_499_length_3392_cov_41.514728	970	1053	137	1	83	0.0120482
NODE_499_length_3392_cov_41.514728	970	1053	138	2	83	0.0240964
NODE_499_length_3392_cov_41.514728	970	1053	140	1	83	0.0120482
NODE_499_length_3392_cov_41.514728	970	1053	146	2	83	0.0240964
NODE_499_length_3392_cov_41.514728	970	1053	147	1	83	0.0120482
NODE_499_length_3392_cov_41.514728	970	1053	148	1	83	0.0120482
NODE_499_length_3392_cov_41.514728	970	1053	151	3	83	0.0361446
NODE_499_length_3392_cov_41.514728	970	1053	152	2	83	0.0240964
NODE_499_length_3392_cov_41.514728	970	1053	153	1	83	0.0120482
NODE_499_length_3392_cov_41.514728	970	1053	155	1	83	0.0120482
NODE_499_length_3392_cov_41.514728	970	1053	157	1	83	0.0120482
NODE_499_length_3392_cov_41.514728	970	1053	162	1	83	0.0120482
NODE_499_length_3392_cov_41.514728	970	1053	175	1	83	0.0120482
NODE_499_length_3392_cov_41.514728	970	1053	191	1	83	0.0120482
NODE_499_length_3392_cov_41.514728	970	1053	202	1	83	0.0120482
NODE_499_length_3392_cov_41.514728	970	1053	208	1	83	0.0120482
NODE_499_length_3392_cov_41.514728	970	1053	213	1	83	0.0120482
NODE_499_length_3392_cov_41.514728	970	1053	220	1	83	0.0120482
NODE_499_length_3392_cov_41.514728	970	1053	233	1	83	0.0120482
NODE_499_length_3392_cov_41.514728	970	1053	240	1	83	0.0120482
NODE_499_length_3392_cov_41.514728	970	1053	246	1	83	0.0120482
NODE_499_length_3392_cov_41.514728	970	1053	250	1	83	0.0120482
NODE_499_length_3392_cov_41.514728	970	1053	253	1	83	0.0120482
NODE_499_length_3392_cov_41.514728	970	1053	258	1	83	0.0120482
NODE_499_length_3392_cov_41.514728	970	1053	269	1	83	0.0120482
NODE_499_length_3392_cov_41.514728	970	1053	272	1	83	0.0120482
NODE_499_length_3392_cov_41.514728	970	1053	285	1	83	0.0120482
NODE_499_length_3392_cov_41.514728	970	1053	311	1	83	0.0120482
NODE_499_length_3392_cov_41.514728	970	1053	322	1	83	0.0120482
NODE_499_length_3392_cov_41.514728	970	1053	323	1	83	0.0120482
NODE_499_length_3392_cov_41.514728	970	1053	326	1	83	0.0120482
NODE_499_length_3392_cov_41.514728	970	1053	328	1	83	0.0120482
NODE_499_length_3392_cov_41.514728	970	1053	329	1	83	0.0120482
NODE_499_length_3392_cov_41.514728	970	1053	334	1	83	0.0120482
NODE_499_length_3392_cov_41.514728	970	1053	340	1	83	0.0120482
NODE_501_length_3389_cov_8.244073	2159	2239	0	80	80	1.0000000
NODE_501_length_3389_cov_8.244073	2212	2292	0	80	80	1.0000000
NODE_506_length_3363_cov_4.412684	56	124	24	1	68	0.0147059
NODE_506_length_3363_cov_4.412684	56	124	26	2	68	0.0294118
NODE_506_length_3363_cov_4.412684	56	124	30	1	68	0.0147059
NODE_506_length_3363_cov_4.412684	56	124	34	2	68	0.0294118
NODE_506_length_3363_cov_4.412684	56	124	46	4	68	0.0588235
NODE_506_length_3363_cov_4.412684	56	124	56	1	68	0.0147059
NODE_506_length_3363_cov_4.412684	56	124	62	2	68	0.0294118
NODE_506_length_3363_cov_4.412684	56	124	64	1	68	0.0147059
NODE_506_length_3363_cov_4.412684	56	124	66	6	68	0.0882353
NODE_506_length_3363_cov_4.412684	56	124	68	48	68	0.7058824
NODE_510_length_3353_cov_2.687462	0	61	0	44	61	0.7213115
NODE_510_length_3353_cov_2.687462	0	61	2	17	61	0.2786885
NODE_510_length_3353_cov_2.687462	0	61	0	44	61	0.7213115
NODE_510_length_3353_cov_2.687462	0	61	2	17	61	0.2786885
NODE_510_length_3353_cov_2.687462	34	99	0	10	65	0.1538462
NODE_510_length_3353_cov_2.687462	34	99	2	55	65	0.8461539
NODE_513_length_3348_cov_243.959372	2473	2553	333	1	80	0.0125000
NODE_513_length_3348_cov_243.959372	2473	2553	337	2	80	0.0250000
NODE_513_length_3348_cov_243.959372	2473	2553	343	1	80	0.0125000
NODE_513_length_3348_cov_243.959372	2473	2553	345	1	80	0.0125000
NODE_513_length_3348_cov_243.959372	2473	2553	346	1	80	0.0125000
NODE_513_length_3348_cov_243.959372	2473	2553	347	1	80	0.0125000
NODE_513_length_3348_cov_243.959372	2473	2553	349	1	80	0.0125000
NODE_513_length_3348_cov_243.959372	2473	2553	353	1	80	0.0125000
NODE_513_length_3348_cov_243.959372	2473	2553	355	3	80	0.0375000
NODE_513_length_3348_cov_243.959372	2473	2553	356	6	80	0.0750000
NODE_513_length_3348_cov_243.959372	2473	2553	357	1	80	0.0125000
NODE_513_length_3348_cov_243.959372	2473	2553	360	2	80	0.0250000
NODE_513_length_3348_cov_243.959372	2473	2553	361	1	80	0.0125000
NODE_513_length_3348_cov_243.959372	2473	2553	363	3	80	0.0375000
NODE_513_length_3348_cov_243.959372	2473	2553	365	2	80	0.0250000
NODE_513_length_3348_cov_243.959372	2473	2553	366	1	80	0.0125000
NODE_513_length_3348_cov_243.959372	2473	2553	367	1	80	0.0125000
NODE_513_length_3348_cov_243.959372	2473	2553	368	2	80	0.0250000
NODE_513_length_3348_cov_243.959372	2473	2553	370	2	80	0.0250000
NODE_513_length_3348_cov_243.959372	2473	2553	373	1	80	0.0125000
NODE_513_length_3348_cov_243.959372	2473	2553	374	1	80	0.0125000
NODE_513_length_3348_cov_243.959372	2473	2553	375	2	80	0.0250000
NODE_513_length_3348_cov_243.959372	2473	2553	376	1	80	0.0125000
NODE_513_length_3348_cov_243.959372	2473	2553	377	1	80	0.0125000
NODE_513_length_3348_cov_243.959372	2473	2553	379	1	80	0.0125000
NODE_513_length_3348_cov_243.959372	2473	2553	380	2	80	0.0250000
NODE_513_length_3348_cov_243.959372	2473	2553	383	1	80	0.0125000
NODE_513_length_3348_cov_243.959372	2473	2553	395	1	80	0.0125000
NODE_513_length_3348_cov_243.959372	2473	2553	396	1	80	0.0125000
NODE_513_length_3348_cov_243.959372	2473	2553	397	2	80	0.0250000
NODE_513_length_3348_cov_243.959372	2473	2553	398	1	80	0.0125000
NODE_513_length_3348_cov_243.959372	2473	2553	399	2	80	0.0250000
NODE_513_length_3348_cov_243.959372	2473	2553	400	3	80	0.0375000
NODE_513_length_3348_cov_243.959372	2473	2553	406	1	80	0.0125000
NODE_513_length_3348_cov_243.959372	2473	2553	410	1	80	0.0125000
NODE_513_length_3348_cov_243.959372	2473	2553	413	2	80	0.0250000
NODE_513_length_3348_cov_243.959372	2473	2553	414	1	80	0.0125000
NODE_513_length_3348_cov_243.959372	2473	2553	415	2	80	0.0250000
NODE_513_length_3348_cov_243.959372	2473	2553	424	2	80	0.0250000
NODE_513_length_3348_cov_243.959372	2473	2553	426	1	80	0.0125000
NODE_513_length_3348_cov_243.959372	2473	2553	430	1	80	0.0125000
NODE_513_length_3348_cov_243.959372	2473	2553	433	2	80	0.0250000
NODE_513_length_3348_cov_243.959372	2473	2553	437	1	80	0.0125000
NODE_513_length_3348_cov_243.959372	2473	2553	438	1	80	0.0125000
NODE_513_length_3348_cov_243.959372	2473	2553	441	1	80	0.0125000
NODE_513_length_3348_cov_243.959372	2473	2553	442	1	80	0.0125000
NODE_513_length_3348_cov_243.959372	2473	2553	443	2	80	0.0250000
NODE_513_length_3348_cov_243.959372	2473	2553	444	1	80	0.0125000
NODE_513_length_3348_cov_243.959372	2473	2553	446	1	80	0.0125000
NODE_513_length_3348_cov_243.959372	2473	2553	448	1	80	0.0125000
NODE_513_length_3348_cov_243.959372	2473	2553	449	2	80	0.0250000
NODE_513_length_3348_cov_243.959372	2473	2553	451	1	80	0.0125000
NODE_513_length_3348_cov_243.959372	2473	2553	454	1	80	0.0125000
NODE_513_length_3348_cov_243.959372	2473	2553	460	1	80	0.0125000
NODE_513_length_3348_cov_243.959372	2526	2606	333	1	80	0.0125000
NODE_513_length_3348_cov_243.959372	2526	2606	337	2	80	0.0250000
NODE_513_length_3348_cov_243.959372	2526	2606	338	1	80	0.0125000
NODE_513_length_3348_cov_243.959372	2526	2606	339	1	80	0.0125000
NODE_513_length_3348_cov_243.959372	2526	2606	341	1	80	0.0125000
NODE_513_length_3348_cov_243.959372	2526	2606	342	1	80	0.0125000
NODE_513_length_3348_cov_243.959372	2526	2606	343	2	80	0.0250000
NODE_513_length_3348_cov_243.959372	2526	2606	344	1	80	0.0125000
NODE_513_length_3348_cov_243.959372	2526	2606	345	1	80	0.0125000
NODE_513_length_3348_cov_243.959372	2526	2606	346	1	80	0.0125000
NODE_513_length_3348_cov_243.959372	2526	2606	349	1	80	0.0125000
NODE_513_length_3348_cov_243.959372	2526	2606	355	1	80	0.0125000
NODE_513_length_3348_cov_243.959372	2526	2606	356	8	80	0.1000000
NODE_513_length_3348_cov_243.959372	2526	2606	357	1	80	0.0125000
NODE_513_length_3348_cov_243.959372	2526	2606	358	2	80	0.0250000
NODE_513_length_3348_cov_243.959372	2526	2606	359	1	80	0.0125000
NODE_513_length_3348_cov_243.959372	2526	2606	360	5	80	0.0625000
NODE_513_length_3348_cov_243.959372	2526	2606	361	2	80	0.0250000
NODE_513_length_3348_cov_243.959372	2526	2606	362	3	80	0.0375000
NODE_513_length_3348_cov_243.959372	2526	2606	363	7	80	0.0875000
NODE_513_length_3348_cov_243.959372	2526	2606	364	1	80	0.0125000
NODE_513_length_3348_cov_243.959372	2526	2606	365	3	80	0.0375000
NODE_513_length_3348_cov_243.959372	2526	2606	366	2	80	0.0250000
NODE_513_length_3348_cov_243.959372	2526	2606	367	1	80	0.0125000
NODE_513_length_3348_cov_243.959372	2526	2606	368	1	80	0.0125000
NODE_513_length_3348_cov_243.959372	2526	2606	369	2	80	0.0250000
NODE_513_length_3348_cov_243.959372	2526	2606	370	1	80	0.0125000
NODE_513_length_3348_cov_243.959372	2526	2606	371	2	80	0.0250000
NODE_513_length_3348_cov_243.959372	2526	2606	372	1	80	0.0125000
NODE_513_length_3348_cov_243.959372	2526	2606	373	1	80	0.0125000
NODE_513_length_3348_cov_243.959372	2526	2606	376	3	80	0.0375000
NODE_513_length_3348_cov_243.959372	2526	2606	379	1	80	0.0125000
NODE_513_length_3348_cov_243.959372	2526	2606	382	1	80	0.0125000
NODE_513_length_3348_cov_243.959372	2526	2606	383	2	80	0.0250000
NODE_513_length_3348_cov_243.959372	2526	2606	385	6	80	0.0750000
NODE_513_length_3348_cov_243.959372	2526	2606	388	2	80	0.0250000
NODE_513_length_3348_cov_243.959372	2526	2606	389	3	80	0.0375000
NODE_513_length_3348_cov_243.959372	2526	2606	391	1	80	0.0125000
NODE_513_length_3348_cov_243.959372	2526	2606	392	2	80	0.0250000
NODE_513_length_3348_cov_243.959372	2526	2606	395	1	80	0.0125000
NODE_514_length_3348_cov_31.953216	103	183	2	65	80	0.8125000
NODE_514_length_3348_cov_31.953216	103	183	4	15	80	0.1875000
NODE_514_length_3348_cov_31.953216	105	179	2	63	74	0.8513514
NODE_514_length_3348_cov_31.953216	105	179	4	11	74	0.1486486
NODE_514_length_3348_cov_31.953216	156	236	0	1	80	0.0125000
NODE_514_length_3348_cov_31.953216	156	236	2	34	80	0.4250000
NODE_514_length_3348_cov_31.953216	156	236	4	45	80	0.5625000
NODE_514_length_3348_cov_31.953216	156	236	0	1	80	0.0125000
NODE_514_length_3348_cov_31.953216	156	236	2	34	80	0.4250000
NODE_514_length_3348_cov_31.953216	156	236	4	45	80	0.5625000
NODE_514_length_3348_cov_31.953216	2405	2476	44	1	71	0.0140845
NODE_514_length_3348_cov_31.953216	2405	2476	46	2	71	0.0281690
NODE_514_length_3348_cov_31.953216	2405	2476	48	1	71	0.0140845
NODE_514_length_3348_cov_31.953216	2405	2476	50	1	71	0.0140845
NODE_514_length_3348_cov_31.953216	2405	2476	51	2	71	0.0281690
NODE_514_length_3348_cov_31.953216	2405	2476	52	4	71	0.0563380
NODE_514_length_3348_cov_31.953216	2405	2476	53	4	71	0.0563380
NODE_514_length_3348_cov_31.953216	2405	2476	56	1	71	0.0140845
NODE_514_length_3348_cov_31.953216	2405	2476	62	2	71	0.0281690
NODE_514_length_3348_cov_31.953216	2405	2476	63	1	71	0.0140845
NODE_514_length_3348_cov_31.953216	2405	2476	65	1	71	0.0140845
NODE_514_length_3348_cov_31.953216	2405	2476	68	2	71	0.0281690
NODE_514_length_3348_cov_31.953216	2405	2476	69	4	71	0.0563380
NODE_514_length_3348_cov_31.953216	2405	2476	70	8	71	0.1126761
NODE_514_length_3348_cov_31.953216	2405	2476	71	3	71	0.0422535
NODE_514_length_3348_cov_31.953216	2405	2476	74	1	71	0.0140845
NODE_514_length_3348_cov_31.953216	2405	2476	78	2	71	0.0281690
NODE_514_length_3348_cov_31.953216	2405	2476	79	2	71	0.0281690
NODE_514_length_3348_cov_31.953216	2405	2476	95	2	71	0.0281690
NODE_514_length_3348_cov_31.953216	2405	2476	96	2	71	0.0281690
NODE_514_length_3348_cov_31.953216	2405	2476	98	1	71	0.0140845
NODE_514_length_3348_cov_31.953216	2405	2476	99	1	71	0.0140845
NODE_514_length_3348_cov_31.953216	2405	2476	101	1	71	0.0140845
NODE_514_length_3348_cov_31.953216	2405	2476	105	1	71	0.0140845
NODE_514_length_3348_cov_31.953216	2405	2476	107	1	71	0.0140845
NODE_514_length_3348_cov_31.953216	2405	2476	109	2	71	0.0281690
NODE_514_length_3348_cov_31.953216	2405	2476	110	1	71	0.0140845
NODE_514_length_3348_cov_31.953216	2405	2476	113	4	71	0.0563380
NODE_514_length_3348_cov_31.953216	2405	2476	115	1	71	0.0140845
NODE_514_length_3348_cov_31.953216	2405	2476	121	1	71	0.0140845
NODE_514_length_3348_cov_31.953216	2405	2476	123	4	71	0.0563380
NODE_514_length_3348_cov_31.953216	2405	2476	129	1	71	0.0140845
NODE_514_length_3348_cov_31.953216	2405	2476	131	1	71	0.0140845
NODE_514_length_3348_cov_31.953216	2405	2476	133	2	71	0.0281690
NODE_514_length_3348_cov_31.953216	2405	2476	135	1	71	0.0140845
NODE_514_length_3348_cov_31.953216	2405	2476	137	1	71	0.0140845
NODE_514_length_3348_cov_31.953216	2405	2476	139	1	71	0.0140845
NODE_514_length_3348_cov_31.953216	2458	2529	110	1	71	0.0140845
NODE_514_length_3348_cov_31.953216	2458	2529	113	4	71	0.0563380
NODE_514_length_3348_cov_31.953216	2458	2529	115	1	71	0.0140845
NODE_514_length_3348_cov_31.953216	2458	2529	121	1	71	0.0140845
NODE_514_length_3348_cov_31.953216	2458	2529	123	4	71	0.0563380
NODE_514_length_3348_cov_31.953216	2458	2529	129	1	71	0.0140845
NODE_514_length_3348_cov_31.953216	2458	2529	131	1	71	0.0140845
NODE_514_length_3348_cov_31.953216	2458	2529	133	2	71	0.0281690
NODE_514_length_3348_cov_31.953216	2458	2529	135	1	71	0.0140845
NODE_514_length_3348_cov_31.953216	2458	2529	137	1	71	0.0140845
NODE_514_length_3348_cov_31.953216	2458	2529	139	1	71	0.0140845
NODE_514_length_3348_cov_31.953216	2458	2529	141	3	71	0.0422535
NODE_514_length_3348_cov_31.953216	2458	2529	148	1	71	0.0140845
NODE_514_length_3348_cov_31.953216	2458	2529	149	5	71	0.0704225
NODE_514_length_3348_cov_31.953216	2458	2529	151	4	71	0.0563380
NODE_514_length_3348_cov_31.953216	2458	2529	153	3	71	0.0422535
NODE_514_length_3348_cov_31.953216	2458	2529	155	1	71	0.0140845
NODE_514_length_3348_cov_31.953216	2458	2529	156	1	71	0.0140845
NODE_514_length_3348_cov_31.953216	2458	2529	161	2	71	0.0281690
NODE_514_length_3348_cov_31.953216	2458	2529	167	1	71	0.0140845
NODE_514_length_3348_cov_31.953216	2458	2529	171	2	71	0.0281690
NODE_514_length_3348_cov_31.953216	2458	2529	172	1	71	0.0140845
NODE_514_length_3348_cov_31.953216	2458	2529	173	3	71	0.0422535
NODE_514_length_3348_cov_31.953216	2458	2529	175	1	71	0.0140845
NODE_514_length_3348_cov_31.953216	2458	2529	176	2	71	0.0281690
NODE_514_length_3348_cov_31.953216	2458	2529	177	1	71	0.0140845
NODE_514_length_3348_cov_31.953216	2458	2529	178	6	71	0.0845070
NODE_514_length_3348_cov_31.953216	2458	2529	179	3	71	0.0422535
NODE_514_length_3348_cov_31.953216	2458	2529	180	5	71	0.0704225
NODE_514_length_3348_cov_31.953216	2458	2529	181	5	71	0.0704225
NODE_514_length_3348_cov_31.953216	2458	2529	182	2	71	0.0281690
NODE_514_length_3348_cov_31.953216	2458	2529	183	1	71	0.0140845
NODE_517_length_3335_cov_19.649567	2100	2180	2	80	80	1.0000000
NODE_517_length_3335_cov_19.649567	2153	2233	0	38	80	0.4750000
NODE_517_length_3335_cov_19.649567	2153	2233	2	42	80	0.5250000
NODE_517_length_3335_cov_19.649567	2229	2309	0	80	80	1.0000000
NODE_517_length_3335_cov_19.649567	2282	2362	0	80	80	1.0000000
NODE_518_length_3333_cov_24.805504	734	814	0	27	80	0.3375000
NODE_518_length_3333_cov_24.805504	734	814	2	53	80	0.6625000
NODE_518_length_3333_cov_24.805504	787	867	0	33	80	0.4125000
NODE_518_length_3333_cov_24.805504	787	867	2	47	80	0.5875000
NODE_523_length_3312_cov_6.996576	85	165	0	80	80	1.0000000
NODE_523_length_3312_cov_6.996576	138	218	0	80	80	1.0000000
NODE_525_length_3302_cov_3.859195	3184	3262	6	44	78	0.5641026
NODE_525_length_3302_cov_3.859195	3184	3262	12	34	78	0.4358974
NODE_525_length_3302_cov_3.859195	3184	3253	6	35	69	0.5072464
NODE_525_length_3302_cov_3.859195	3184	3253	12	34	69	0.4927536
NODE_526_length_3299_cov_6.014687	1632	1688	0	56	56	1.0000000
NODE_530_length_3290_cov_17.805390	773	853	4	33	80	0.4125000
NODE_530_length_3290_cov_17.805390	773	853	10	31	80	0.3875000
NODE_530_length_3290_cov_17.805390	773	853	12	16	80	0.2000000
NODE_530_length_3290_cov_17.805390	826	906	10	21	80	0.2625000
NODE_530_length_3290_cov_17.805390	826	906	12	30	80	0.3750000
NODE_530_length_3290_cov_17.805390	826	906	13	25	80	0.3125000
NODE_530_length_3290_cov_17.805390	826	906	14	4	80	0.0500000
NODE_531_length_3290_cov_12.352554	2749	2829	0	80	80	1.0000000
NODE_531_length_3290_cov_12.352554	2802	2882	0	80	80	1.0000000
NODE_532_length_3286_cov_5.973015	0	50	0	11	50	0.2200000
NODE_532_length_3286_cov_5.973015	0	50	6	39	50	0.7800000
NODE_532_length_3286_cov_5.973015	0	50	0	11	50	0.2200000
NODE_532_length_3286_cov_5.973015	0	50	6	39	50	0.7800000
NODE_532_length_3286_cov_5.973015	0	50	0	11	50	0.2200000
NODE_532_length_3286_cov_5.973015	0	50	6	39	50	0.7800000
NODE_532_length_3286_cov_5.973015	23	89	6	66	66	1.0000000
NODE_532_length_3286_cov_5.973015	23	94	6	71	71	1.0000000
NODE_533_length_3284_cov_6.453689	313	392	6	79	79	1.0000000
NODE_533_length_3284_cov_6.453689	365	445	0	10	80	0.1250000
NODE_533_length_3284_cov_6.453689	365	445	2	1	80	0.0125000
NODE_533_length_3284_cov_6.453689	365	445	4	37	80	0.4625000
NODE_533_length_3284_cov_6.453689	365	445	6	32	80	0.4000000
NODE_541_length_3267_cov_12.768624	11	91	2	25	80	0.3125000
NODE_541_length_3267_cov_12.768624	11	91	4	15	80	0.1875000
NODE_541_length_3267_cov_12.768624	11	91	6	2	80	0.0250000
NODE_541_length_3267_cov_12.768624	11	91	10	3	80	0.0375000
NODE_541_length_3267_cov_12.768624	11	91	14	17	80	0.2125000
NODE_541_length_3267_cov_12.768624	11	91	16	10	80	0.1250000
NODE_541_length_3267_cov_12.768624	11	91	18	8	80	0.1000000
NODE_542_length_3266_cov_14.108304	2620	2684	23	32	64	0.5000000
NODE_542_length_3266_cov_14.108304	2620	2684	27	4	64	0.0625000
NODE_542_length_3266_cov_14.108304	2620	2684	30	1	64	0.0156250
NODE_542_length_3266_cov_14.108304	2620	2684	31	27	64	0.4218750
NODE_542_length_3266_cov_14.108304	2620	2684	23	32	64	0.5000000
NODE_542_length_3266_cov_14.108304	2620	2684	27	4	64	0.0625000
NODE_542_length_3266_cov_14.108304	2620	2684	30	1	64	0.0156250
NODE_542_length_3266_cov_14.108304	2620	2684	31	27	64	0.4218750
NODE_542_length_3266_cov_14.108304	2620	2684	23	32	64	0.5000000
NODE_542_length_3266_cov_14.108304	2620	2684	27	4	64	0.0625000
NODE_542_length_3266_cov_14.108304	2620	2684	30	1	64	0.0156250
NODE_542_length_3266_cov_14.108304	2620	2684	31	27	64	0.4218750
NODE_547_length_3242_cov_12.407891	391	471	0	1	80	0.0125000
NODE_547_length_3242_cov_12.407891	391	471	8	79	80	0.9875000
NODE_547_length_3242_cov_12.407891	444	524	2	5	80	0.0625000
NODE_547_length_3242_cov_12.407891	444	524	8	30	80	0.3750000
NODE_547_length_3242_cov_12.407891	444	524	9	2	80	0.0250000
NODE_547_length_3242_cov_12.407891	444	524	10	43	80	0.5375000
NODE_550_length_3233_cov_19.903957	411	491	0	80	80	1.0000000
NODE_550_length_3233_cov_19.903957	411	491	0	80	80	1.0000000
NODE_550_length_3233_cov_19.903957	464	544	0	80	80	1.0000000
NODE_552_length_3232_cov_11.378870	2586	2621	0	35	35	1.0000000
NODE_555_length_3214_cov_22.853291	2090	2170	8	2	80	0.0250000
NODE_555_length_3214_cov_22.853291	2090	2170	10	11	80	0.1375000
NODE_555_length_3214_cov_22.853291	2090	2170	12	42	80	0.5250000
NODE_555_length_3214_cov_22.853291	2090	2170	13	4	80	0.0500000
NODE_555_length_3214_cov_22.853291	2090	2170	14	21	80	0.2625000
NODE_555_length_3214_cov_22.853291	2143	2223	8	2	80	0.0250000
NODE_555_length_3214_cov_22.853291	2143	2223	10	12	80	0.1500000
NODE_555_length_3214_cov_22.853291	2143	2223	11	10	80	0.1250000
NODE_555_length_3214_cov_22.853291	2143	2223	12	19	80	0.2375000
NODE_555_length_3214_cov_22.853291	2143	2223	13	22	80	0.2750000
NODE_555_length_3214_cov_22.853291	2143	2223	14	14	80	0.1750000
NODE_555_length_3214_cov_22.853291	2143	2223	15	1	80	0.0125000
NODE_555_length_3214_cov_22.853291	3028	3086	9	3	58	0.0517241
NODE_555_length_3214_cov_22.853291	3028	3086	11	1	58	0.0172414
NODE_555_length_3214_cov_22.853291	3028	3086	12	8	58	0.1379310
NODE_555_length_3214_cov_22.853291	3028	3086	14	14	58	0.2413793
NODE_555_length_3214_cov_22.853291	3028	3086	16	4	58	0.0689655
NODE_555_length_3214_cov_22.853291	3028	3086	17	1	58	0.0172414
NODE_555_length_3214_cov_22.853291	3028	3086	19	1	58	0.0172414
NODE_555_length_3214_cov_22.853291	3028	3086	23	2	58	0.0344828
NODE_555_length_3214_cov_22.853291	3028	3086	25	4	58	0.0689655
NODE_555_length_3214_cov_22.853291	3028	3086	29	2	58	0.0344828
NODE_555_length_3214_cov_22.853291	3028	3086	31	4	58	0.0689655
NODE_555_length_3214_cov_22.853291	3028	3086	32	4	58	0.0689655
NODE_555_length_3214_cov_22.853291	3028	3086	34	4	58	0.0689655
NODE_555_length_3214_cov_22.853291	3028	3086	36	5	58	0.0862069
NODE_555_length_3214_cov_22.853291	3028	3086	38	1	58	0.0172414
NODE_556_length_3211_cov_1.921915	95	175	4	8	80	0.1000000
NODE_556_length_3211_cov_1.921915	95	175	8	2	80	0.0250000
NODE_556_length_3211_cov_1.921915	95	175	10	13	80	0.1625000
NODE_556_length_3211_cov_1.921915	95	175	11	1	80	0.0125000
NODE_556_length_3211_cov_1.921915	95	175	12	6	80	0.0750000
NODE_556_length_3211_cov_1.921915	95	175	14	1	80	0.0125000
NODE_556_length_3211_cov_1.921915	95	175	18	22	80	0.2750000
NODE_556_length_3211_cov_1.921915	95	175	20	8	80	0.1000000
NODE_556_length_3211_cov_1.921915	95	175	22	19	80	0.2375000
NODE_556_length_3211_cov_1.921915	148	178	4	11	30	0.3666667
NODE_556_length_3211_cov_1.921915	148	178	8	2	30	0.0666667
NODE_556_length_3211_cov_1.921915	148	178	10	13	30	0.4333333
NODE_556_length_3211_cov_1.921915	148	178	11	1	30	0.0333333
NODE_556_length_3211_cov_1.921915	148	178	12	3	30	0.1000000
NODE_557_length_3210_cov_7.428480	2040	2111	2	14	71	0.1971831
NODE_557_length_3210_cov_7.428480	2040	2111	5	18	71	0.2535211
NODE_557_length_3210_cov_7.428480	2040	2111	6	39	71	0.5492958
NODE_557_length_3210_cov_7.428480	2084	2164	5	32	80	0.4000000
NODE_557_length_3210_cov_7.428480	2084	2164	6	48	80	0.6000000
NODE_557_length_3210_cov_7.428480	2715	2797	1	20	82	0.2439024
NODE_557_length_3210_cov_7.428480	2715	2797	2	62	82	0.7560976
NODE_557_length_3210_cov_7.428480	2770	2850	1	42	80	0.5250000
NODE_557_length_3210_cov_7.428480	2770	2850	2	38	80	0.4750000
NODE_562_length_3201_cov_3.591231	3120	3200	0	80	80	1.0000000
NODE_566_length_3189_cov_69.446602	137	188	0	51	51	1.0000000
NODE_567_length_3188_cov_7.233085	1663	1743	2	29	80	0.3625000
NODE_567_length_3188_cov_7.233085	1663	1743	5	13	80	0.1625000
NODE_567_length_3188_cov_7.233085	1663	1743	7	38	80	0.4750000
NODE_567_length_3188_cov_7.233085	1716	1796	5	12	80	0.1500000
NODE_567_length_3188_cov_7.233085	1716	1796	7	42	80	0.5250000
NODE_567_length_3188_cov_7.233085	1716	1796	8	26	80	0.3250000
NODE_570_length_3177_cov_2.789474	2021	2042	0	21	21	1.0000000
NODE_575_length_3158_cov_19.018960	840	920	0	36	80	0.4500000
NODE_575_length_3158_cov_19.018960	840	920	2	14	80	0.1750000
NODE_575_length_3158_cov_19.018960	840	920	4	13	80	0.1625000
NODE_575_length_3158_cov_19.018960	840	920	6	17	80	0.2125000
NODE_575_length_3158_cov_19.018960	893	973	4	10	80	0.1250000
NODE_575_length_3158_cov_19.018960	893	973	6	70	80	0.8750000
NODE_575_length_3158_cov_19.018960	2833	2915	0	82	82	1.0000000
NODE_575_length_3158_cov_19.018960	2888	2959	0	71	71	1.0000000
NODE_576_length_3150_cov_26.520813	770	850	6	23	80	0.2875000
NODE_576_length_3150_cov_26.520813	770	850	8	36	80	0.4500000
NODE_576_length_3150_cov_26.520813	770	850	10	21	80	0.2625000
NODE_576_length_3150_cov_26.520813	823	901	4	33	78	0.4230769
NODE_576_length_3150_cov_26.520813	823	901	5	5	78	0.0641026
NODE_576_length_3150_cov_26.520813	823	901	6	6	78	0.0769231
NODE_576_length_3150_cov_26.520813	823	901	8	34	78	0.4358974
NODE_576_length_3150_cov_26.520813	2616	2696	0	80	80	1.0000000
NODE_576_length_3150_cov_26.520813	2669	2749	0	80	80	1.0000000
NODE_577_length_3150_cov_5.923959	2313	2393	0	2	80	0.0250000
NODE_577_length_3150_cov_5.923959	2313	2393	2	13	80	0.1625000
NODE_577_length_3150_cov_5.923959	2313	2393	24	1	80	0.0125000
NODE_577_length_3150_cov_5.923959	2313	2393	26	64	80	0.8000000
NODE_579_length_3148_cov_2.313873	3053	3105	0	45	52	0.8653846
NODE_579_length_3148_cov_2.313873	3053	3105	2	7	52	0.1346154
NODE_581_length_3146_cov_18.277322	2418	2498	0	80	80	1.0000000
NODE_581_length_3146_cov_18.277322	2471	2551	0	80	80	1.0000000
NODE_581_length_3146_cov_18.277322	2547	2627	0	73	80	0.9125000
NODE_581_length_3146_cov_18.277322	2547	2627	4	7	80	0.0875000
NODE_581_length_3146_cov_18.277322	2600	2680	0	20	80	0.2500000
NODE_581_length_3146_cov_18.277322	2600	2680	4	40	80	0.5000000
NODE_581_length_3146_cov_18.277322	2600	2680	8	13	80	0.1625000
NODE_581_length_3146_cov_18.277322	2600	2680	10	7	80	0.0875000
NODE_581_length_3146_cov_18.277322	2975	3055	2	4	80	0.0500000
NODE_581_length_3146_cov_18.277322	2975	3055	3	3	80	0.0375000
NODE_581_length_3146_cov_18.277322	2975	3055	4	4	80	0.0500000
NODE_581_length_3146_cov_18.277322	2975	3055	5	2	80	0.0250000
NODE_581_length_3146_cov_18.277322	2975	3055	8	4	80	0.0500000
NODE_581_length_3146_cov_18.277322	2975	3055	9	2	80	0.0250000
NODE_581_length_3146_cov_18.277322	2975	3055	10	3	80	0.0375000
NODE_581_length_3146_cov_18.277322	2975	3055	12	25	80	0.3125000
NODE_581_length_3146_cov_18.277322	2975	3055	14	33	80	0.4125000
NODE_585_length_3134_cov_8.717957	1290	1362	4	35	72	0.4861111
NODE_585_length_3134_cov_8.717957	1290	1362	17	4	72	0.0555556
NODE_585_length_3134_cov_8.717957	1290	1362	19	11	72	0.1527778
NODE_585_length_3134_cov_8.717957	1290	1362	27	5	72	0.0694444
NODE_585_length_3134_cov_8.717957	1290	1362	35	5	72	0.0694444
NODE_585_length_3134_cov_8.717957	1290	1362	39	8	72	0.1111111
NODE_585_length_3134_cov_8.717957	1290	1362	41	4	72	0.0555556
NODE_585_length_3134_cov_8.717957	1335	1415	19	5	80	0.0625000
NODE_585_length_3134_cov_8.717957	1335	1415	27	5	80	0.0625000
NODE_585_length_3134_cov_8.717957	1335	1415	35	5	80	0.0625000
NODE_585_length_3134_cov_8.717957	1335	1415	37	15	80	0.1875000
NODE_585_length_3134_cov_8.717957	1335	1415	38	37	80	0.4625000
NODE_585_length_3134_cov_8.717957	1335	1415	39	9	80	0.1125000
NODE_585_length_3134_cov_8.717957	1335	1415	41	4	80	0.0500000
NODE_586_length_3131_cov_26.910620	232	312	0	80	80	1.0000000
NODE_586_length_3131_cov_26.910620	285	364	0	79	79	1.0000000
NODE_586_length_3131_cov_26.910620	2151	2231	0	80	80	1.0000000
NODE_586_length_3131_cov_26.910620	2155	2227	0	72	72	1.0000000
NODE_586_length_3131_cov_26.910620	2204	2284	0	80	80	1.0000000
NODE_586_length_3131_cov_26.910620	2208	2284	0	76	76	1.0000000
NODE_586_length_3131_cov_26.910620	2280	2360	0	80	80	1.0000000
NODE_586_length_3131_cov_26.910620	2333	2413	0	80	80	1.0000000
NODE_590_length_3118_cov_5.059622	367	445	0	78	78	1.0000000
NODE_590_length_3118_cov_5.059622	418	498	0	80	80	1.0000000
NODE_591_length_3117_cov_5.938038	2525	2605	0	80	80	1.0000000
NODE_591_length_3117_cov_5.938038	2578	2658	0	80	80	1.0000000
NODE_595_length_3110_cov_31.733643	2864	2923	0	59	59	1.0000000
NODE_602_length_3093_cov_54.559786	571	651	0	80	80	1.0000000
NODE_602_length_3093_cov_54.559786	624	704	0	80	80	1.0000000
NODE_602_length_3093_cov_54.559786	2901	2981	34	5	80	0.0625000
NODE_602_length_3093_cov_54.559786	2901	2981	36	1	80	0.0125000
NODE_602_length_3093_cov_54.559786	2901	2981	39	1	80	0.0125000
NODE_602_length_3093_cov_54.559786	2901	2981	41	2	80	0.0250000
NODE_602_length_3093_cov_54.559786	2901	2981	45	9	80	0.1125000
NODE_602_length_3093_cov_54.559786	2901	2981	46	4	80	0.0500000
NODE_602_length_3093_cov_54.559786	2901	2981	49	1	80	0.0125000
NODE_602_length_3093_cov_54.559786	2901	2981	50	15	80	0.1875000
NODE_602_length_3093_cov_54.559786	2901	2981	51	1	80	0.0125000
NODE_602_length_3093_cov_54.559786	2901	2981	52	1	80	0.0125000
NODE_602_length_3093_cov_54.559786	2901	2981	53	10	80	0.1250000
NODE_602_length_3093_cov_54.559786	2901	2981	54	7	80	0.0875000
NODE_602_length_3093_cov_54.559786	2901	2981	56	5	80	0.0625000
NODE_602_length_3093_cov_54.559786	2901	2981	57	6	80	0.0750000
NODE_602_length_3093_cov_54.559786	2901	2981	58	12	80	0.1500000
NODE_602_length_3093_cov_54.559786	2954	3034	21	13	80	0.1625000
NODE_602_length_3093_cov_54.559786	2954	3034	32	8	80	0.1000000
NODE_602_length_3093_cov_54.559786	2954	3034	34	3	80	0.0375000
NODE_602_length_3093_cov_54.559786	2954	3034	40	1	80	0.0125000
NODE_602_length_3093_cov_54.559786	2954	3034	43	3	80	0.0375000
NODE_602_length_3093_cov_54.559786	2954	3034	45	6	80	0.0750000
NODE_602_length_3093_cov_54.559786	2954	3034	49	9	80	0.1125000
NODE_602_length_3093_cov_54.559786	2954	3034	51	4	80	0.0500000
NODE_602_length_3093_cov_54.559786	2954	3034	53	16	80	0.2000000
NODE_602_length_3093_cov_54.559786	2954	3034	54	4	80	0.0500000
NODE_602_length_3093_cov_54.559786	2954	3034	57	1	80	0.0125000
NODE_602_length_3093_cov_54.559786	2954	3034	58	12	80	0.1500000
NODE_603_length_3091_cov_35.895722	1743	1804	0	61	61	1.0000000
NODE_603_length_3091_cov_35.895722	1777	1857	0	80	80	1.0000000
NODE_603_length_3091_cov_35.895722	2472	2535	0	63	63	1.0000000
NODE_603_length_3091_cov_35.895722	2508	2553	0	45	45	1.0000000
NODE_603_length_3091_cov_35.895722	2534	2604	0	37	70	0.5285714
NODE_603_length_3091_cov_35.895722	2534	2604	2	16	70	0.2285714
NODE_603_length_3091_cov_35.895722	2534	2604	4	17	70	0.2428571
NODE_603_length_3091_cov_35.895722	2578	2618	2	9	40	0.2250000
NODE_603_length_3091_cov_35.895722	2578	2618	4	31	40	0.7750000
NODE_603_length_3091_cov_35.895722	2586	2623	2	1	37	0.0270270
NODE_603_length_3091_cov_35.895722	2586	2623	4	36	37	0.9729730
NODE_603_length_3091_cov_35.895722	2626	2671	2	28	45	0.6222222
NODE_603_length_3091_cov_35.895722	2626	2671	4	17	45	0.3777778
NODE_603_length_3091_cov_35.895722	2682	2730	0	48	48	1.0000000
NODE_603_length_3091_cov_35.895722	2918	2969	0	51	51	1.0000000
NODE_603_length_3091_cov_35.895722	2942	2987	0	45	45	1.0000000
NODE_603_length_3091_cov_35.895722	2994	3039	0	45	45	1.0000000
NODE_607_length_3079_cov_7.081879	2340	2420	4	7	80	0.0875000
NODE_607_length_3079_cov_7.081879	2340	2420	8	29	80	0.3625000
NODE_607_length_3079_cov_7.081879	2340	2420	10	44	80	0.5500000
NODE_607_length_3079_cov_7.081879	2886	2938	10	5	52	0.0961538
NODE_607_length_3079_cov_7.081879	2886	2938	28	17	52	0.3269231
NODE_607_length_3079_cov_7.081879	2886	2938	29	5	52	0.0961538
NODE_607_length_3079_cov_7.081879	2886	2938	33	5	52	0.0961538
NODE_607_length_3079_cov_7.081879	2886	2938	38	5	52	0.0961538
NODE_607_length_3079_cov_7.081879	2886	2938	42	4	52	0.0769231
NODE_607_length_3079_cov_7.081879	2886	2938	43	5	52	0.0961538
NODE_607_length_3079_cov_7.081879	2886	2938	44	3	52	0.0576923
NODE_607_length_3079_cov_7.081879	2886	2938	48	3	52	0.0576923
NODE_607_length_3079_cov_7.081879	2893	2959	28	15	66	0.2272727
NODE_607_length_3079_cov_7.081879	2893	2959	29	5	66	0.0757576
NODE_607_length_3079_cov_7.081879	2893	2959	33	5	66	0.0757576
NODE_607_length_3079_cov_7.081879	2893	2959	38	5	66	0.0757576
NODE_607_length_3079_cov_7.081879	2893	2959	42	4	66	0.0606061
NODE_607_length_3079_cov_7.081879	2893	2959	43	5	66	0.0757576
NODE_607_length_3079_cov_7.081879	2893	2959	44	3	66	0.0454545
NODE_607_length_3079_cov_7.081879	2893	2959	48	3	66	0.0454545
NODE_607_length_3079_cov_7.081879	2893	2959	56	4	66	0.0606061
NODE_607_length_3079_cov_7.081879	2893	2959	68	1	66	0.0151515
NODE_607_length_3079_cov_7.081879	2893	2959	70	1	66	0.0151515
NODE_607_length_3079_cov_7.081879	2893	2959	73	1	66	0.0151515
NODE_607_length_3079_cov_7.081879	2893	2959	78	1	66	0.0151515
NODE_607_length_3079_cov_7.081879	2893	2959	80	3	66	0.0454545
NODE_607_length_3079_cov_7.081879	2893	2959	84	3	66	0.0454545
NODE_607_length_3079_cov_7.081879	2893	2959	86	2	66	0.0303030
NODE_607_length_3079_cov_7.081879	2893	2959	87	4	66	0.0606061
NODE_607_length_3079_cov_7.081879	2893	2959	88	1	66	0.0151515
NODE_607_length_3079_cov_7.081879	2932	2993	42	3	61	0.0491803
NODE_607_length_3079_cov_7.081879	2932	2993	48	3	61	0.0491803
NODE_607_length_3079_cov_7.081879	2932	2993	56	4	61	0.0655738
NODE_607_length_3079_cov_7.081879	2932	2993	68	1	61	0.0163934
NODE_607_length_3079_cov_7.081879	2932	2993	70	1	61	0.0163934
NODE_607_length_3079_cov_7.081879	2932	2993	73	1	61	0.0163934
NODE_607_length_3079_cov_7.081879	2932	2993	78	1	61	0.0163934
NODE_607_length_3079_cov_7.081879	2932	2993	80	3	61	0.0491803
NODE_607_length_3079_cov_7.081879	2932	2993	83	2	61	0.0327869
NODE_607_length_3079_cov_7.081879	2932	2993	84	4	61	0.0655738
NODE_607_length_3079_cov_7.081879	2932	2993	85	1	61	0.0163934
NODE_607_length_3079_cov_7.081879	2932	2993	86	2	61	0.0327869
NODE_607_length_3079_cov_7.081879	2932	2993	87	14	61	0.2295082
NODE_607_length_3079_cov_7.081879	2932	2993	88	1	61	0.0163934
NODE_607_length_3079_cov_7.081879	2932	2993	91	20	61	0.3278688
NODE_607_length_3079_cov_7.081879	2932	2995	42	3	63	0.0476190
NODE_607_length_3079_cov_7.081879	2932	2995	48	3	63	0.0476190
NODE_607_length_3079_cov_7.081879	2932	2995	56	4	63	0.0634921
NODE_607_length_3079_cov_7.081879	2932	2995	68	1	63	0.0158730
NODE_607_length_3079_cov_7.081879	2932	2995	70	1	63	0.0158730
NODE_607_length_3079_cov_7.081879	2932	2995	73	1	63	0.0158730
NODE_607_length_3079_cov_7.081879	2932	2995	78	1	63	0.0158730
NODE_607_length_3079_cov_7.081879	2932	2995	80	3	63	0.0476190
NODE_607_length_3079_cov_7.081879	2932	2995	83	2	63	0.0317460
NODE_607_length_3079_cov_7.081879	2932	2995	84	4	63	0.0634921
NODE_607_length_3079_cov_7.081879	2932	2995	85	1	63	0.0158730
NODE_607_length_3079_cov_7.081879	2932	2995	86	2	63	0.0317460
NODE_607_length_3079_cov_7.081879	2932	2995	87	14	63	0.2222222
NODE_607_length_3079_cov_7.081879	2932	2995	88	1	63	0.0158730
NODE_607_length_3079_cov_7.081879	2932	2995	91	22	63	0.3492064
NODE_607_length_3079_cov_7.081879	2932	2995	42	3	63	0.0476190
NODE_607_length_3079_cov_7.081879	2932	2995	48	3	63	0.0476190
NODE_607_length_3079_cov_7.081879	2932	2995	56	4	63	0.0634921
NODE_607_length_3079_cov_7.081879	2932	2995	68	1	63	0.0158730
NODE_607_length_3079_cov_7.081879	2932	2995	70	1	63	0.0158730
NODE_607_length_3079_cov_7.081879	2932	2995	73	1	63	0.0158730
NODE_607_length_3079_cov_7.081879	2932	2995	78	1	63	0.0158730
NODE_607_length_3079_cov_7.081879	2932	2995	80	3	63	0.0476190
NODE_607_length_3079_cov_7.081879	2932	2995	83	2	63	0.0317460
NODE_607_length_3079_cov_7.081879	2932	2995	84	4	63	0.0634921
NODE_607_length_3079_cov_7.081879	2932	2995	85	1	63	0.0158730
NODE_607_length_3079_cov_7.081879	2932	2995	86	2	63	0.0317460
NODE_607_length_3079_cov_7.081879	2932	2995	87	14	63	0.2222222
NODE_607_length_3079_cov_7.081879	2932	2995	88	1	63	0.0158730
NODE_607_length_3079_cov_7.081879	2932	2995	91	22	63	0.3492064
NODE_608_length_3077_cov_23.535259	1244	1321	0	77	77	1.0000000
NODE_608_length_3077_cov_23.535259	1911	1991	0	80	80	1.0000000
NODE_608_length_3077_cov_23.535259	1964	2016	0	52	52	1.0000000
NODE_608_length_3077_cov_23.535259	2028	2114	0	46	86	0.5348837
NODE_608_length_3077_cov_23.535259	2028	2114	4	40	86	0.4651163
NODE_609_length_3077_cov_8.693083	1157	1237	0	27	80	0.3375000
NODE_609_length_3077_cov_8.693083	1157	1237	2	33	80	0.4125000
NODE_609_length_3077_cov_8.693083	1157	1237	4	18	80	0.2250000
NODE_609_length_3077_cov_8.693083	1157	1237	6	1	80	0.0125000
NODE_609_length_3077_cov_8.693083	1157	1237	8	1	80	0.0125000
NODE_609_length_3077_cov_8.693083	1161	1184	0	23	23	1.0000000
NODE_609_length_3077_cov_8.693083	1233	1313	4	2	80	0.0250000
NODE_609_length_3077_cov_8.693083	1233	1313	6	1	80	0.0125000
NODE_609_length_3077_cov_8.693083	1233	1313	8	5	80	0.0625000
NODE_609_length_3077_cov_8.693083	1233	1313	10	30	80	0.3750000
NODE_609_length_3077_cov_8.693083	1233	1313	12	1	80	0.0125000
NODE_609_length_3077_cov_8.693083	1233	1313	14	1	80	0.0125000
NODE_609_length_3077_cov_8.693083	1233	1313	15	13	80	0.1625000
NODE_609_length_3077_cov_8.693083	1233	1313	17	6	80	0.0750000
NODE_609_length_3077_cov_8.693083	1233	1313	18	7	80	0.0875000
NODE_609_length_3077_cov_8.693083	1233	1313	19	4	80	0.0500000
NODE_609_length_3077_cov_8.693083	1233	1313	20	8	80	0.1000000
NODE_609_length_3077_cov_8.693083	1233	1313	21	2	80	0.0250000
NODE_609_length_3077_cov_8.693083	1286	1352	16	3	66	0.0454545
NODE_609_length_3077_cov_8.693083	1286	1352	17	10	66	0.1515152
NODE_609_length_3077_cov_8.693083	1286	1352	18	19	66	0.2878788
NODE_609_length_3077_cov_8.693083	1286	1352	19	23	66	0.3484848
NODE_609_length_3077_cov_8.693083	1286	1352	20	9	66	0.1363636
NODE_609_length_3077_cov_8.693083	1286	1352	21	2	66	0.0303030
NODE_609_length_3077_cov_8.693083	2672	2757	0	39	85	0.4588235
NODE_609_length_3077_cov_8.693083	2672	2757	2	46	85	0.5411765
NODE_611_length_3074_cov_2.996303	2561	2629	56	2	68	0.0294118
NODE_611_length_3074_cov_2.996303	2561	2629	57	1	68	0.0147059
NODE_611_length_3074_cov_2.996303	2561	2629	64	1	68	0.0147059
NODE_611_length_3074_cov_2.996303	2561	2629	77	1	68	0.0147059
NODE_611_length_3074_cov_2.996303	2561	2629	86	1	68	0.0147059
NODE_611_length_3074_cov_2.996303	2561	2629	92	1	68	0.0147059
NODE_611_length_3074_cov_2.996303	2561	2629	114	1	68	0.0147059
NODE_611_length_3074_cov_2.996303	2561	2629	117	1	68	0.0147059
NODE_611_length_3074_cov_2.996303	2561	2629	130	1	68	0.0147059
NODE_611_length_3074_cov_2.996303	2561	2629	132	1	68	0.0147059
NODE_611_length_3074_cov_2.996303	2561	2629	136	1	68	0.0147059
NODE_611_length_3074_cov_2.996303	2561	2629	137	2	68	0.0294118
NODE_611_length_3074_cov_2.996303	2561	2629	144	1	68	0.0147059
NODE_611_length_3074_cov_2.996303	2561	2629	145	1	68	0.0147059
NODE_611_length_3074_cov_2.996303	2561	2629	152	1	68	0.0147059
NODE_611_length_3074_cov_2.996303	2561	2629	156	1	68	0.0147059
NODE_611_length_3074_cov_2.996303	2561	2629	164	1	68	0.0147059
NODE_611_length_3074_cov_2.996303	2561	2629	171	1	68	0.0147059
NODE_611_length_3074_cov_2.996303	2561	2629	186	1	68	0.0147059
NODE_611_length_3074_cov_2.996303	2561	2629	190	1	68	0.0147059
NODE_611_length_3074_cov_2.996303	2561	2629	197	3	68	0.0441176
NODE_611_length_3074_cov_2.996303	2561	2629	209	1	68	0.0147059
NODE_611_length_3074_cov_2.996303	2561	2629	213	1	68	0.0147059
NODE_611_length_3074_cov_2.996303	2561	2629	216	1	68	0.0147059
NODE_611_length_3074_cov_2.996303	2561	2629	218	1	68	0.0147059
NODE_611_length_3074_cov_2.996303	2561	2629	220	2	68	0.0294118
NODE_611_length_3074_cov_2.996303	2561	2629	223	2	68	0.0294118
NODE_611_length_3074_cov_2.996303	2561	2629	224	1	68	0.0147059
NODE_611_length_3074_cov_2.996303	2561	2629	228	1	68	0.0147059
NODE_611_length_3074_cov_2.996303	2561	2629	230	2	68	0.0294118
NODE_611_length_3074_cov_2.996303	2561	2629	237	1	68	0.0147059
NODE_611_length_3074_cov_2.996303	2561	2629	254	1	68	0.0147059
NODE_611_length_3074_cov_2.996303	2561	2629	256	1	68	0.0147059
NODE_611_length_3074_cov_2.996303	2561	2629	263	1	68	0.0147059
NODE_611_length_3074_cov_2.996303	2561	2629	272	1	68	0.0147059
NODE_611_length_3074_cov_2.996303	2561	2629	274	1	68	0.0147059
NODE_611_length_3074_cov_2.996303	2561	2629	276	1	68	0.0147059
NODE_611_length_3074_cov_2.996303	2561	2629	279	2	68	0.0294118
NODE_611_length_3074_cov_2.996303	2561	2629	286	1	68	0.0147059
NODE_611_length_3074_cov_2.996303	2561	2629	292	1	68	0.0147059
NODE_611_length_3074_cov_2.996303	2561	2629	305	1	68	0.0147059
NODE_611_length_3074_cov_2.996303	2561	2629	312	1	68	0.0147059
NODE_611_length_3074_cov_2.996303	2561	2629	320	1	68	0.0147059
NODE_611_length_3074_cov_2.996303	2561	2629	324	1	68	0.0147059
NODE_611_length_3074_cov_2.996303	2561	2629	328	1	68	0.0147059
NODE_611_length_3074_cov_2.996303	2561	2629	331	1	68	0.0147059
NODE_611_length_3074_cov_2.996303	2561	2629	335	1	68	0.0147059
NODE_611_length_3074_cov_2.996303	2561	2629	342	1	68	0.0147059
NODE_611_length_3074_cov_2.996303	2561	2629	349	1	68	0.0147059
NODE_611_length_3074_cov_2.996303	2561	2629	362	1	68	0.0147059
NODE_611_length_3074_cov_2.996303	2561	2629	369	1	68	0.0147059
NODE_611_length_3074_cov_2.996303	2561	2629	380	1	68	0.0147059
NODE_611_length_3074_cov_2.996303	2561	2629	386	1	68	0.0147059
NODE_611_length_3074_cov_2.996303	2561	2629	401	1	68	0.0147059
NODE_611_length_3074_cov_2.996303	2561	2629	406	1	68	0.0147059
NODE_611_length_3074_cov_2.996303	2561	2629	414	1	68	0.0147059
NODE_611_length_3074_cov_2.996303	2561	2629	416	1	68	0.0147059
NODE_611_length_3074_cov_2.996303	2561	2629	442	1	68	0.0147059
NODE_611_length_3074_cov_2.996303	2561	2629	446	1	68	0.0147059
NODE_611_length_3074_cov_2.996303	2561	2629	451	1	68	0.0147059
NODE_615_length_3069_cov_2.448822	2948	2991	0	17	43	0.3953488
NODE_615_length_3069_cov_2.448822	2948	2991	2	17	43	0.3953488
NODE_615_length_3069_cov_2.448822	2948	2991	4	9	43	0.2093023
NODE_616_length_3059_cov_20.037500	346	426	5	40	80	0.5000000
NODE_616_length_3059_cov_20.037500	346	426	7	24	80	0.3000000
NODE_616_length_3059_cov_20.037500	346	426	8	1	80	0.0125000
NODE_616_length_3059_cov_20.037500	346	426	10	4	80	0.0500000
NODE_616_length_3059_cov_20.037500	346	426	11	11	80	0.1375000
NODE_616_length_3059_cov_20.037500	399	479	6	5	80	0.0625000
NODE_616_length_3059_cov_20.037500	399	479	7	38	80	0.4750000
NODE_616_length_3059_cov_20.037500	399	479	8	13	80	0.1625000
NODE_616_length_3059_cov_20.037500	399	479	10	4	80	0.0500000
NODE_616_length_3059_cov_20.037500	399	479	11	20	80	0.2500000
NODE_616_length_3059_cov_20.037500	1317	1397	0	39	80	0.4875000
NODE_616_length_3059_cov_20.037500	1317	1397	6	41	80	0.5125000
NODE_616_length_3059_cov_20.037500	1370	1447	0	77	77	1.0000000
NODE_616_length_3059_cov_20.037500	2514	2594	0	80	80	1.0000000
NODE_616_length_3059_cov_20.037500	2567	2647	0	80	80	1.0000000
NODE_617_length_3058_cov_21.767489	2802	2882	0	58	80	0.7250000
NODE_617_length_3058_cov_21.767489	2802	2882	4	17	80	0.2125000
NODE_617_length_3058_cov_21.767489	2802	2882	6	5	80	0.0625000
NODE_617_length_3058_cov_21.767489	2855	2930	0	5	75	0.0666667
NODE_617_length_3058_cov_21.767489	2855	2930	4	17	75	0.2266667
NODE_617_length_3058_cov_21.767489	2855	2930	6	28	75	0.3733333
NODE_617_length_3058_cov_21.767489	2855	2930	8	14	75	0.1866667
NODE_617_length_3058_cov_21.767489	2855	2930	10	10	75	0.1333333
NODE_617_length_3058_cov_21.767489	2855	2930	12	1	75	0.0133333
NODE_621_length_3047_cov_47.232361	418	489	0	71	71	1.0000000
NODE_621_length_3047_cov_47.232361	758	801	2	8	43	0.1860465
NODE_621_length_3047_cov_47.232361	758	801	3	1	43	0.0232558
NODE_621_length_3047_cov_47.232361	758	801	4	9	43	0.2093023
NODE_621_length_3047_cov_47.232361	758	801	6	1	43	0.0232558
NODE_621_length_3047_cov_47.232361	758	801	7	9	43	0.2093023
NODE_621_length_3047_cov_47.232361	758	801	9	2	43	0.0465116
NODE_621_length_3047_cov_47.232361	758	801	13	8	43	0.1860465
NODE_621_length_3047_cov_47.232361	758	801	16	1	43	0.0232558
NODE_621_length_3047_cov_47.232361	758	801	18	3	43	0.0697674
NODE_621_length_3047_cov_47.232361	758	801	20	1	43	0.0232558
NODE_623_length_3044_cov_38.951783	1702	1782	0	80	80	1.0000000
NODE_623_length_3044_cov_38.951783	1755	1835	0	41	80	0.5125000
NODE_623_length_3044_cov_38.951783	1755	1835	2	39	80	0.4875000
NODE_623_length_3044_cov_38.951783	1831	1911	2	79	80	0.9875000
NODE_623_length_3044_cov_38.951783	1831	1911	4	1	80	0.0125000
NODE_623_length_3044_cov_38.951783	1884	1964	0	3	80	0.0375000
NODE_623_length_3044_cov_38.951783	1884	1964	2	76	80	0.9500000
NODE_623_length_3044_cov_38.951783	1884	1964	4	1	80	0.0125000
NODE_623_length_3044_cov_38.951783	2556	2636	0	80	80	1.0000000
NODE_623_length_3044_cov_38.951783	2609	2689	0	80	80	1.0000000
NODE_625_length_3039_cov_3.258163	261	337	0	76	76	1.0000000
NODE_625_length_3039_cov_3.258163	261	336	0	75	75	1.0000000
NODE_625_length_3039_cov_3.258163	261	337	0	76	76	1.0000000
NODE_625_length_3039_cov_3.258163	270	337	0	67	67	1.0000000
NODE_627_length_3036_cov_8.968676	2303	2367	0	43	64	0.6718750
NODE_627_length_3036_cov_8.968676	2303	2367	2	21	64	0.3281250
NODE_627_length_3036_cov_8.968676	2340	2420	0	6	80	0.0750000
NODE_627_length_3036_cov_8.968676	2340	2420	2	74	80	0.9250000
NODE_627_length_3036_cov_8.968676	2416	2496	2	71	80	0.8875000
NODE_627_length_3036_cov_8.968676	2416	2496	4	9	80	0.1125000
NODE_627_length_3036_cov_8.968676	2469	2549	0	41	80	0.5125000
NODE_627_length_3036_cov_8.968676	2469	2549	2	39	80	0.4875000
NODE_629_length_3032_cov_7.470849	1026	1068	11	12	42	0.2857143
NODE_629_length_3032_cov_7.470849	1026	1068	12	2	42	0.0476190
NODE_629_length_3032_cov_7.470849	1026	1068	15	10	42	0.2380952
NODE_629_length_3032_cov_7.470849	1026	1068	16	18	42	0.4285714
NODE_630_length_3025_cov_11.862611	2371	2451	0	80	80	1.0000000
NODE_630_length_3025_cov_11.862611	2424	2504	0	80	80	1.0000000
NODE_630_length_3025_cov_11.862611	2500	2580	0	80	80	1.0000000
NODE_630_length_3025_cov_11.862611	2553	2633	0	80	80	1.0000000
NODE_635_length_3012_cov_33.100240	2379	2459	0	80	80	1.0000000
NODE_635_length_3012_cov_33.100240	2432	2512	0	80	80	1.0000000
NODE_637_length_3007_cov_11.843535	2641	2721	0	15	80	0.1875000
NODE_637_length_3007_cov_11.843535	2641	2721	1	2	80	0.0250000
NODE_637_length_3007_cov_11.843535	2641	2721	2	63	80	0.7875000
NODE_643_length_2992_cov_2.636709	2032	2112	0	75	80	0.9375000
NODE_643_length_2992_cov_2.636709	2032	2112	2	5	80	0.0625000
NODE_643_length_2992_cov_2.636709	2085	2165	0	22	80	0.2750000
NODE_643_length_2992_cov_2.636709	2085	2165	2	58	80	0.7250000
NODE_646_length_2978_cov_4.883293	382	452	0	70	70	1.0000000
NODE_646_length_2978_cov_4.883293	1858	1938	0	68	80	0.8500000
NODE_646_length_2978_cov_4.883293	1858	1938	6	12	80	0.1500000
NODE_646_length_2978_cov_4.883293	1926	1991	6	65	65	1.0000000
NODE_646_length_2978_cov_4.883293	1987	2066	0	35	79	0.4430380
NODE_646_length_2978_cov_4.883293	1987	2066	6	44	79	0.5569620
NODE_646_length_2978_cov_4.883293	2040	2079	0	39	39	1.0000000
NODE_647_length_2976_cov_24.683003	1764	1844	0	80	80	1.0000000
NODE_647_length_2976_cov_24.683003	1817	1897	0	80	80	1.0000000
NODE_647_length_2976_cov_24.683003	1893	1973	0	80	80	1.0000000
NODE_647_length_2976_cov_24.683003	1946	2026	0	80	80	1.0000000
NODE_651_length_2967_cov_16.146095	238	318	0	80	80	1.0000000
NODE_651_length_2967_cov_16.146095	291	371	0	80	80	1.0000000
NODE_651_length_2967_cov_16.146095	367	447	0	80	80	1.0000000
NODE_651_length_2967_cov_16.146095	420	500	0	80	80	1.0000000
NODE_653_length_2965_cov_19.913468	92	134	10	1	42	0.0238095
NODE_653_length_2965_cov_19.913468	92	134	12	7	42	0.1666667
NODE_653_length_2965_cov_19.913468	92	134	18	4	42	0.0952381
NODE_653_length_2965_cov_19.913468	92	134	20	4	42	0.0952381
NODE_653_length_2965_cov_19.913468	92	134	26	1	42	0.0238095
NODE_653_length_2965_cov_19.913468	92	134	28	1	42	0.0238095
NODE_653_length_2965_cov_19.913468	92	134	36	1	42	0.0238095
NODE_653_length_2965_cov_19.913468	92	134	38	1	42	0.0238095
NODE_653_length_2965_cov_19.913468	92	134	44	22	42	0.5238096
NODE_653_length_2965_cov_19.913468	109	178	6	25	69	0.3623188
NODE_653_length_2965_cov_19.913468	109	178	8	10	69	0.1449275
NODE_653_length_2965_cov_19.913468	109	178	10	10	69	0.1449275
NODE_653_length_2965_cov_19.913468	109	178	12	7	69	0.1014493
NODE_653_length_2965_cov_19.913468	109	178	18	4	69	0.0579710
NODE_653_length_2965_cov_19.913468	109	178	20	4	69	0.0579710
NODE_653_length_2965_cov_19.913468	109	178	26	1	69	0.0144928
NODE_653_length_2965_cov_19.913468	109	178	28	1	69	0.0144928
NODE_653_length_2965_cov_19.913468	109	178	36	1	69	0.0144928
NODE_653_length_2965_cov_19.913468	109	178	38	1	69	0.0144928
NODE_653_length_2965_cov_19.913468	109	178	44	5	69	0.0724638
NODE_653_length_2965_cov_19.913468	109	178	6	25	69	0.3623188
NODE_653_length_2965_cov_19.913468	109	178	8	10	69	0.1449275
NODE_653_length_2965_cov_19.913468	109	178	10	10	69	0.1449275
NODE_653_length_2965_cov_19.913468	109	178	12	7	69	0.1014493
NODE_653_length_2965_cov_19.913468	109	178	18	4	69	0.0579710
NODE_653_length_2965_cov_19.913468	109	178	20	4	69	0.0579710
NODE_653_length_2965_cov_19.913468	109	178	26	1	69	0.0144928
NODE_653_length_2965_cov_19.913468	109	178	28	1	69	0.0144928
NODE_653_length_2965_cov_19.913468	109	178	36	1	69	0.0144928
NODE_653_length_2965_cov_19.913468	109	178	38	1	69	0.0144928
NODE_653_length_2965_cov_19.913468	109	178	44	5	69	0.0724638
NODE_653_length_2965_cov_19.913468	2298	2378	0	19	80	0.2375000
NODE_653_length_2965_cov_19.913468	2298	2378	2	61	80	0.7625000
NODE_653_length_2965_cov_19.913468	2351	2431	0	72	80	0.9000000
NODE_653_length_2965_cov_19.913468	2351	2431	2	8	80	0.1000000
NODE_653_length_2965_cov_19.913468	2427	2507	0	80	80	1.0000000
NODE_653_length_2965_cov_19.913468	2480	2560	0	80	80	1.0000000
NODE_656_length_2960_cov_35.741699	459	539	0	80	80	1.0000000
NODE_656_length_2960_cov_35.741699	512	592	0	80	80	1.0000000
NODE_659_length_2951_cov_7.195652	1100	1141	196	1	41	0.0243902
NODE_659_length_2951_cov_7.195652	1100	1141	201	2	41	0.0487805
NODE_659_length_2951_cov_7.195652	1100	1141	232	1	41	0.0243902
NODE_659_length_2951_cov_7.195652	1100	1141	238	1	41	0.0243902
NODE_659_length_2951_cov_7.195652	1100	1141	251	1	41	0.0243902
NODE_659_length_2951_cov_7.195652	1100	1141	258	1	41	0.0243902
NODE_659_length_2951_cov_7.195652	1100	1141	259	1	41	0.0243902
NODE_659_length_2951_cov_7.195652	1100	1141	264	1	41	0.0243902
NODE_659_length_2951_cov_7.195652	1100	1141	274	1	41	0.0243902
NODE_659_length_2951_cov_7.195652	1100	1141	275	1	41	0.0243902
NODE_659_length_2951_cov_7.195652	1100	1141	276	1	41	0.0243902
NODE_659_length_2951_cov_7.195652	1100	1141	282	1	41	0.0243902
NODE_659_length_2951_cov_7.195652	1100	1141	292	1	41	0.0243902
NODE_659_length_2951_cov_7.195652	1100	1141	297	1	41	0.0243902
NODE_659_length_2951_cov_7.195652	1100	1141	299	1	41	0.0243902
NODE_659_length_2951_cov_7.195652	1100	1141	302	1	41	0.0243902
NODE_659_length_2951_cov_7.195652	1100	1141	306	1	41	0.0243902
NODE_659_length_2951_cov_7.195652	1100	1141	312	1	41	0.0243902
NODE_659_length_2951_cov_7.195652	1100	1141	318	1	41	0.0243902
NODE_659_length_2951_cov_7.195652	1100	1141	322	1	41	0.0243902
NODE_659_length_2951_cov_7.195652	1100	1141	332	1	41	0.0243902
NODE_659_length_2951_cov_7.195652	1100	1141	336	1	41	0.0243902
NODE_659_length_2951_cov_7.195652	1100	1141	342	1	41	0.0243902
NODE_659_length_2951_cov_7.195652	1100	1141	343	1	41	0.0243902
NODE_659_length_2951_cov_7.195652	1100	1141	353	1	41	0.0243902
NODE_659_length_2951_cov_7.195652	1100	1141	358	1	41	0.0243902
NODE_659_length_2951_cov_7.195652	1100	1141	361	2	41	0.0487805
NODE_659_length_2951_cov_7.195652	1100	1141	369	1	41	0.0243902
NODE_659_length_2951_cov_7.195652	1100	1141	375	2	41	0.0487805
NODE_659_length_2951_cov_7.195652	1100	1141	376	1	41	0.0243902
NODE_659_length_2951_cov_7.195652	1100	1141	378	1	41	0.0243902
NODE_659_length_2951_cov_7.195652	1100	1141	381	1	41	0.0243902
NODE_659_length_2951_cov_7.195652	1100	1141	383	1	41	0.0243902
NODE_659_length_2951_cov_7.195652	1100	1141	384	1	41	0.0243902
NODE_659_length_2951_cov_7.195652	1100	1141	391	1	41	0.0243902
NODE_659_length_2951_cov_7.195652	1100	1141	392	1	41	0.0243902
NODE_659_length_2951_cov_7.195652	1100	1141	410	1	41	0.0243902
NODE_659_length_2951_cov_7.195652	1100	1141	411	1	41	0.0243902
NODE_665_length_2935_cov_37.693230	1492	1572	36	3	80	0.0375000
NODE_665_length_2935_cov_37.693230	1492	1572	38	1	80	0.0125000
NODE_665_length_2935_cov_37.693230	1492	1572	42	5	80	0.0625000
NODE_665_length_2935_cov_37.693230	1492	1572	44	7	80	0.0875000
NODE_665_length_2935_cov_37.693230	1492	1572	46	2	80	0.0250000
NODE_665_length_2935_cov_37.693230	1492	1572	49	3	80	0.0375000
NODE_665_length_2935_cov_37.693230	1492	1572	51	4	80	0.0500000
NODE_665_length_2935_cov_37.693230	1492	1572	52	17	80	0.2125000
NODE_665_length_2935_cov_37.693230	1492	1572	54	38	80	0.4750000
NODE_665_length_2935_cov_37.693230	1534	1589	38	3	55	0.0545455
NODE_665_length_2935_cov_37.693230	1534	1589	39	2	55	0.0363636
NODE_665_length_2935_cov_37.693230	1534	1589	41	2	55	0.0363636
NODE_665_length_2935_cov_37.693230	1534	1589	45	1	55	0.0181818
NODE_665_length_2935_cov_37.693230	1534	1589	46	1	55	0.0181818
NODE_665_length_2935_cov_37.693230	1534	1589	47	1	55	0.0181818
NODE_665_length_2935_cov_37.693230	1534	1589	48	3	55	0.0545455
NODE_665_length_2935_cov_37.693230	1534	1589	49	7	55	0.1272727
NODE_665_length_2935_cov_37.693230	1534	1589	51	4	55	0.0727273
NODE_665_length_2935_cov_37.693230	1534	1589	52	15	55	0.2727273
NODE_665_length_2935_cov_37.693230	1534	1589	54	16	55	0.2909091
NODE_665_length_2935_cov_37.693230	1545	1619	14	3	74	0.0405405
NODE_665_length_2935_cov_37.693230	1545	1619	21	3	74	0.0405405
NODE_665_length_2935_cov_37.693230	1545	1619	29	9	74	0.1216216
NODE_665_length_2935_cov_37.693230	1545	1619	30	9	74	0.1216216
NODE_665_length_2935_cov_37.693230	1545	1619	31	1	74	0.0135135
NODE_665_length_2935_cov_37.693230	1545	1619	32	1	74	0.0135135
NODE_665_length_2935_cov_37.693230	1545	1619	34	1	74	0.0135135
NODE_665_length_2935_cov_37.693230	1545	1619	37	3	74	0.0405405
NODE_665_length_2935_cov_37.693230	1545	1619	38	3	74	0.0405405
NODE_665_length_2935_cov_37.693230	1545	1619	39	2	74	0.0270270
NODE_665_length_2935_cov_37.693230	1545	1619	41	2	74	0.0270270
NODE_665_length_2935_cov_37.693230	1545	1619	45	1	74	0.0135135
NODE_665_length_2935_cov_37.693230	1545	1619	46	1	74	0.0135135
NODE_665_length_2935_cov_37.693230	1545	1619	47	1	74	0.0135135
NODE_665_length_2935_cov_37.693230	1545	1619	48	3	74	0.0405405
NODE_665_length_2935_cov_37.693230	1545	1619	49	7	74	0.0945946
NODE_665_length_2935_cov_37.693230	1545	1619	51	4	74	0.0540541
NODE_665_length_2935_cov_37.693230	1545	1619	52	15	74	0.2027027
NODE_665_length_2935_cov_37.693230	1545	1619	54	5	74	0.0675676
NODE_665_length_2935_cov_37.693230	1625	1701	6	14	76	0.1842105
NODE_665_length_2935_cov_37.693230	1625	1701	8	49	76	0.6447368
NODE_665_length_2935_cov_37.693230	1625	1701	10	5	76	0.0657895
NODE_665_length_2935_cov_37.693230	1625	1701	12	7	76	0.0921053
NODE_665_length_2935_cov_37.693230	1625	1701	16	1	76	0.0131579
NODE_665_length_2935_cov_37.693230	2863	2906	0	43	43	1.0000000
NODE_675_length_2913_cov_4.376688	2664	2739	10	6	75	0.0800000
NODE_675_length_2913_cov_4.376688	2664	2739	12	69	75	0.9200000
NODE_675_length_2913_cov_4.376688	2664	2723	12	59	59	1.0000000
NODE_675_length_2913_cov_4.376688	2664	2739	10	6	75	0.0800000
NODE_675_length_2913_cov_4.376688	2664	2739	12	69	75	0.9200000
NODE_675_length_2913_cov_4.376688	2664	2739	10	6	75	0.0800000
NODE_675_length_2913_cov_4.376688	2664	2739	12	69	75	0.9200000
NODE_675_length_2913_cov_4.376688	2673	2739	10	6	66	0.0909091
NODE_675_length_2913_cov_4.376688	2673	2739	12	60	66	0.9090909
NODE_675_length_2913_cov_4.376688	2717	2780	0	41	63	0.6507937
NODE_675_length_2913_cov_4.376688	2717	2780	10	6	63	0.0952381
NODE_675_length_2913_cov_4.376688	2717	2780	12	16	63	0.2539683
NODE_675_length_2913_cov_4.376688	2745	2778	0	33	33	1.0000000
NODE_677_length_2909_cov_71.975089	2090	2174	32	3	84	0.0357143
NODE_677_length_2909_cov_71.975089	2090	2174	33	5	84	0.0595238
NODE_677_length_2909_cov_71.975089	2090	2174	34	4	84	0.0476190
NODE_677_length_2909_cov_71.975089	2090	2174	35	2	84	0.0238095
NODE_677_length_2909_cov_71.975089	2090	2174	36	2	84	0.0238095
NODE_677_length_2909_cov_71.975089	2090	2174	38	6	84	0.0714286
NODE_677_length_2909_cov_71.975089	2090	2174	41	3	84	0.0357143
NODE_677_length_2909_cov_71.975089	2090	2174	47	1	84	0.0119048
NODE_677_length_2909_cov_71.975089	2090	2174	51	2	84	0.0238095
NODE_677_length_2909_cov_71.975089	2090	2174	52	1	84	0.0119048
NODE_677_length_2909_cov_71.975089	2090	2174	53	3	84	0.0357143
NODE_677_length_2909_cov_71.975089	2090	2174	54	7	84	0.0833333
NODE_677_length_2909_cov_71.975089	2090	2174	60	2	84	0.0238095
NODE_677_length_2909_cov_71.975089	2090	2174	63	2	84	0.0238095
NODE_677_length_2909_cov_71.975089	2090	2174	64	7	84	0.0833333
NODE_677_length_2909_cov_71.975089	2090	2174	68	2	84	0.0238095
NODE_677_length_2909_cov_71.975089	2090	2174	70	1	84	0.0119048
NODE_677_length_2909_cov_71.975089	2090	2174	72	3	84	0.0357143
NODE_677_length_2909_cov_71.975089	2090	2174	76	2	84	0.0238095
NODE_677_length_2909_cov_71.975089	2090	2174	78	1	84	0.0119048
NODE_677_length_2909_cov_71.975089	2090	2174	80	1	84	0.0119048
NODE_677_length_2909_cov_71.975089	2090	2174	84	1	84	0.0119048
NODE_677_length_2909_cov_71.975089	2090	2174	86	2	84	0.0238095
NODE_677_length_2909_cov_71.975089	2090	2174	92	3	84	0.0357143
NODE_677_length_2909_cov_71.975089	2090	2174	96	3	84	0.0357143
NODE_677_length_2909_cov_71.975089	2090	2174	98	1	84	0.0119048
NODE_677_length_2909_cov_71.975089	2090	2174	99	1	84	0.0119048
NODE_677_length_2909_cov_71.975089	2090	2174	100	1	84	0.0119048
NODE_677_length_2909_cov_71.975089	2090	2174	101	7	84	0.0833333
NODE_677_length_2909_cov_71.975089	2090	2174	102	2	84	0.0238095
NODE_677_length_2909_cov_71.975089	2090	2174	103	2	84	0.0238095
NODE_677_length_2909_cov_71.975089	2090	2174	110	1	84	0.0119048
NODE_678_length_2908_cov_5.937344	2495	2575	0	80	80	1.0000000
NODE_678_length_2908_cov_5.937344	2548	2628	0	80	80	1.0000000
NODE_678_length_2908_cov_5.937344	2624	2704	0	80	80	1.0000000
NODE_678_length_2908_cov_5.937344	2677	2757	0	80	80	1.0000000
NODE_679_length_2905_cov_12.777619	2358	2419	0	57	61	0.9344262
NODE_679_length_2905_cov_12.777619	2358	2419	2	1	61	0.0163934
NODE_679_length_2905_cov_12.777619	2358	2419	8	3	61	0.0491803
NODE_679_length_2905_cov_12.777619	2358	2419	0	57	61	0.9344262
NODE_679_length_2905_cov_12.777619	2358	2419	2	1	61	0.0163934
NODE_679_length_2905_cov_12.777619	2358	2419	8	3	61	0.0491803
NODE_679_length_2905_cov_12.777619	2358	2419	0	57	61	0.9344262
NODE_679_length_2905_cov_12.777619	2358	2419	2	1	61	0.0163934
NODE_679_length_2905_cov_12.777619	2358	2419	8	3	61	0.0491803
NODE_679_length_2905_cov_12.777619	2392	2472	0	80	80	1.0000000
NODE_680_length_2903_cov_5.474322	2423	2464	8	15	41	0.3658537
NODE_680_length_2903_cov_5.474322	2423	2464	10	26	41	0.6341463
NODE_684_length_2898_cov_5.786352	0	74	0	18	74	0.2432432
NODE_684_length_2898_cov_5.786352	0	74	2	29	74	0.3918919
NODE_684_length_2898_cov_5.786352	0	74	4	27	74	0.3648649
NODE_684_length_2898_cov_5.786352	47	124	0	6	77	0.0779221
NODE_684_length_2898_cov_5.786352	47	124	2	10	77	0.1298701
NODE_684_length_2898_cov_5.786352	47	124	4	61	77	0.7922078
NODE_686_length_2895_cov_8.519313	869	949	0	80	80	1.0000000
NODE_686_length_2895_cov_8.519313	922	1002	0	80	80	1.0000000
NODE_688_length_2894_cov_2.036136	2677	2757	14	1	80	0.0125000
NODE_688_length_2894_cov_2.036136	2677	2757	16	1	80	0.0125000
NODE_688_length_2894_cov_2.036136	2677	2757	18	2	80	0.0250000
NODE_688_length_2894_cov_2.036136	2677	2757	20	3	80	0.0375000
NODE_688_length_2894_cov_2.036136	2677	2757	21	57	80	0.7125000
NODE_688_length_2894_cov_2.036136	2677	2757	22	16	80	0.2000000
NODE_689_length_2891_cov_7.938037	193	275	2	19	82	0.2317073
NODE_689_length_2891_cov_7.938037	193	275	4	7	82	0.0853659
NODE_689_length_2891_cov_7.938037	193	275	6	4	82	0.0487805
NODE_689_length_2891_cov_7.938037	193	275	9	2	82	0.0243902
NODE_689_length_2891_cov_7.938037	193	275	10	17	82	0.2073171
NODE_689_length_2891_cov_7.938037	193	275	11	1	82	0.0121951
NODE_689_length_2891_cov_7.938037	193	275	13	1	82	0.0121951
NODE_689_length_2891_cov_7.938037	193	275	15	2	82	0.0243902
NODE_689_length_2891_cov_7.938037	193	275	19	14	82	0.1707317
NODE_689_length_2891_cov_7.938037	193	275	21	7	82	0.0853659
NODE_689_length_2891_cov_7.938037	193	275	23	8	82	0.0975610
NODE_691_length_2889_cov_11.426882	407	487	0	33	80	0.4125000
NODE_691_length_2889_cov_11.426882	407	487	4	47	80	0.5875000
NODE_691_length_2889_cov_11.426882	460	540	0	27	80	0.3375000
NODE_691_length_2889_cov_11.426882	460	540	4	53	80	0.6625000
NODE_691_length_2889_cov_11.426882	1006	1086	2	2	80	0.0250000
NODE_691_length_2889_cov_11.426882	1006	1086	4	3	80	0.0375000
NODE_691_length_2889_cov_11.426882	1006	1086	6	1	80	0.0125000
NODE_691_length_2889_cov_11.426882	1006	1086	8	3	80	0.0375000
NODE_691_length_2889_cov_11.426882	1006	1086	10	3	80	0.0375000
NODE_691_length_2889_cov_11.426882	1006	1086	13	8	80	0.1000000
NODE_691_length_2889_cov_11.426882	1006	1086	16	45	80	0.5625000
NODE_691_length_2889_cov_11.426882	1006	1086	18	15	80	0.1875000
NODE_691_length_2889_cov_11.426882	1007	1086	2	2	79	0.0253165
NODE_691_length_2889_cov_11.426882	1007	1086	4	3	79	0.0379747
NODE_691_length_2889_cov_11.426882	1007	1086	6	1	79	0.0126582
NODE_691_length_2889_cov_11.426882	1007	1086	8	3	79	0.0379747
NODE_691_length_2889_cov_11.426882	1007	1086	10	3	79	0.0379747
NODE_691_length_2889_cov_11.426882	1007	1086	13	8	79	0.1012658
NODE_691_length_2889_cov_11.426882	1007	1086	16	45	79	0.5696203
NODE_691_length_2889_cov_11.426882	1007	1086	18	14	79	0.1772152
NODE_691_length_2889_cov_11.426882	1059	1138	0	47	79	0.5949367
NODE_691_length_2889_cov_11.426882	1059	1138	2	7	79	0.0886076
NODE_691_length_2889_cov_11.426882	1059	1138	4	3	79	0.0379747
NODE_691_length_2889_cov_11.426882	1059	1138	6	1	79	0.0126582
NODE_691_length_2889_cov_11.426882	1059	1138	8	3	79	0.0379747
NODE_691_length_2889_cov_11.426882	1059	1138	10	3	79	0.0379747
NODE_691_length_2889_cov_11.426882	1059	1138	13	8	79	0.1012658
NODE_691_length_2889_cov_11.426882	1059	1138	16	7	79	0.0886076
NODE_691_length_2889_cov_11.426882	1059	1138	0	47	79	0.5949367
NODE_691_length_2889_cov_11.426882	1059	1138	2	7	79	0.0886076
NODE_691_length_2889_cov_11.426882	1059	1138	4	3	79	0.0379747
NODE_691_length_2889_cov_11.426882	1059	1138	6	1	79	0.0126582
NODE_691_length_2889_cov_11.426882	1059	1138	8	3	79	0.0379747
NODE_691_length_2889_cov_11.426882	1059	1138	10	3	79	0.0379747
NODE_691_length_2889_cov_11.426882	1059	1138	13	8	79	0.1012658
NODE_691_length_2889_cov_11.426882	1059	1138	16	7	79	0.0886076
NODE_693_length_2888_cov_3.789172	992	1072	8	10	80	0.1250000
NODE_693_length_2888_cov_3.789172	992	1072	10	38	80	0.4750000
NODE_693_length_2888_cov_3.789172	992	1072	12	32	80	0.4000000
NODE_693_length_2888_cov_3.789172	1045	1087	2	6	42	0.1428571
NODE_693_length_2888_cov_3.789172	1045	1087	4	3	42	0.0714286
NODE_693_length_2888_cov_3.789172	1045	1087	8	4	42	0.0952381
NODE_693_length_2888_cov_3.789172	1045	1087	10	20	42	0.4761905
NODE_693_length_2888_cov_3.789172	1045	1087	12	9	42	0.2142857
NODE_697_length_2878_cov_6.277798	2712	2781	8	1	69	0.0144928
NODE_697_length_2878_cov_6.277798	2712	2781	10	19	69	0.2753623
NODE_697_length_2878_cov_6.277798	2712	2781	12	8	69	0.1159420
NODE_697_length_2878_cov_6.277798	2712	2781	14	25	69	0.3623188
NODE_697_length_2878_cov_6.277798	2712	2781	18	16	69	0.2318841
NODE_703_length_2862_cov_9.060803	2409	2489	0	13	80	0.1625000
NODE_703_length_2862_cov_9.060803	2409	2489	2	67	80	0.8375000
NODE_703_length_2862_cov_9.060803	2462	2542	0	54	80	0.6750000
NODE_703_length_2862_cov_9.060803	2462	2542	2	26	80	0.3250000
NODE_712_length_2840_cov_2.079533	1660	1740	4	80	80	1.0000000
NODE_713_length_2839_cov_16.762044	327	402	0	75	75	1.0000000
NODE_713_length_2839_cov_16.762044	380	468	0	88	88	1.0000000
NODE_713_length_2839_cov_16.762044	1021	1101	0	80	80	1.0000000
NODE_713_length_2839_cov_16.762044	1074	1154	0	80	80	1.0000000
NODE_714_length_2835_cov_29.691520	1552	1581	68	7	29	0.2413793
NODE_714_length_2835_cov_29.691520	1552	1581	70	3	29	0.1034483
NODE_714_length_2835_cov_29.691520	1552	1581	73	5	29	0.1724138
NODE_714_length_2835_cov_29.691520	1552	1581	75	1	29	0.0344828
NODE_714_length_2835_cov_29.691520	1552	1581	77	7	29	0.2413793
NODE_714_length_2835_cov_29.691520	1552	1581	79	3	29	0.1034483
NODE_714_length_2835_cov_29.691520	1552	1581	81	3	29	0.1034483
NODE_714_length_2835_cov_29.691520	1554	1629	22	2	75	0.0266667
NODE_714_length_2835_cov_29.691520	1554	1629	24	1	75	0.0133333
NODE_714_length_2835_cov_29.691520	1554	1629	27	1	75	0.0133333
NODE_714_length_2835_cov_29.691520	1554	1629	31	6	75	0.0800000
NODE_714_length_2835_cov_29.691520	1554	1629	37	1	75	0.0133333
NODE_714_length_2835_cov_29.691520	1554	1629	39	1	75	0.0133333
NODE_714_length_2835_cov_29.691520	1554	1629	41	2	75	0.0266667
NODE_714_length_2835_cov_29.691520	1554	1629	42	2	75	0.0266667
NODE_714_length_2835_cov_29.691520	1554	1629	43	1	75	0.0133333
NODE_714_length_2835_cov_29.691520	1554	1629	45	4	75	0.0533333
NODE_714_length_2835_cov_29.691520	1554	1629	47	2	75	0.0266667
NODE_714_length_2835_cov_29.691520	1554	1629	51	4	75	0.0533333
NODE_714_length_2835_cov_29.691520	1554	1629	57	2	75	0.0266667
NODE_714_length_2835_cov_29.691520	1554	1629	58	5	75	0.0666667
NODE_714_length_2835_cov_29.691520	1554	1629	60	2	75	0.0266667
NODE_714_length_2835_cov_29.691520	1554	1629	62	1	75	0.0133333
NODE_714_length_2835_cov_29.691520	1554	1629	64	2	75	0.0266667
NODE_714_length_2835_cov_29.691520	1554	1629	66	1	75	0.0133333
NODE_714_length_2835_cov_29.691520	1554	1629	68	15	75	0.2000000
NODE_714_length_2835_cov_29.691520	1554	1629	70	3	75	0.0400000
NODE_714_length_2835_cov_29.691520	1554	1629	73	5	75	0.0666667
NODE_714_length_2835_cov_29.691520	1554	1629	75	1	75	0.0133333
NODE_714_length_2835_cov_29.691520	1554	1629	77	7	75	0.0933333
NODE_714_length_2835_cov_29.691520	1554	1629	79	3	75	0.0400000
NODE_714_length_2835_cov_29.691520	1554	1629	81	1	75	0.0133333
NODE_720_length_2825_cov_9.731108	487	567	0	80	80	1.0000000
NODE_720_length_2825_cov_9.731108	540	620	0	80	80	1.0000000
NODE_726_length_2810_cov_2.844338	206	289	20	1	83	0.0120482
NODE_726_length_2810_cov_2.844338	206	289	22	4	83	0.0481928
NODE_726_length_2810_cov_2.844338	206	289	24	1	83	0.0120482
NODE_726_length_2810_cov_2.844338	206	289	26	1	83	0.0120482
NODE_726_length_2810_cov_2.844338	206	289	28	2	83	0.0240964
NODE_726_length_2810_cov_2.844338	206	289	30	1	83	0.0120482
NODE_726_length_2810_cov_2.844338	206	289	31	14	83	0.1686747
NODE_726_length_2810_cov_2.844338	206	289	33	1	83	0.0120482
NODE_726_length_2810_cov_2.844338	206	289	35	6	83	0.0722892
NODE_726_length_2810_cov_2.844338	206	289	37	17	83	0.2048193
NODE_726_length_2810_cov_2.844338	206	289	38	4	83	0.0481928
NODE_726_length_2810_cov_2.844338	206	289	40	4	83	0.0481928
NODE_726_length_2810_cov_2.844338	206	289	42	3	83	0.0361446
NODE_726_length_2810_cov_2.844338	206	289	44	7	83	0.0843373
NODE_726_length_2810_cov_2.844338	206	289	45	5	83	0.0602410
NODE_726_length_2810_cov_2.844338	206	289	46	2	83	0.0240964
NODE_726_length_2810_cov_2.844338	206	289	47	4	83	0.0481928
NODE_726_length_2810_cov_2.844338	206	289	51	3	83	0.0361446
NODE_726_length_2810_cov_2.844338	206	289	55	2	83	0.0240964
NODE_726_length_2810_cov_2.844338	206	289	56	1	83	0.0120482
NODE_728_length_2808_cov_2.867110	140	163	6	18	23	0.7826087
NODE_728_length_2808_cov_2.867110	140	163	8	1	23	0.0434783
NODE_728_length_2808_cov_2.867110	140	163	9	4	23	0.1739130
NODE_729_length_2807_cov_8.423191	125	205	0	80	80	1.0000000
NODE_729_length_2807_cov_8.423191	178	258	0	80	80	1.0000000
NODE_729_length_2807_cov_8.423191	2451	2515	1	64	64	1.0000000
NODE_735_length_2801_cov_26.131384	461	521	0	20	60	0.3333333
NODE_735_length_2801_cov_26.131384	461	521	2	40	60	0.6666667
NODE_735_length_2801_cov_26.131384	494	574	0	73	80	0.9125000
NODE_735_length_2801_cov_26.131384	494	574	2	7	80	0.0875000
NODE_735_length_2801_cov_26.131384	1536	1596	13	2	60	0.0333333
NODE_735_length_2801_cov_26.131384	1536	1596	19	7	60	0.1166667
NODE_735_length_2801_cov_26.131384	1536	1596	34	7	60	0.1166667
NODE_735_length_2801_cov_26.131384	1536	1596	36	4	60	0.0666667
NODE_735_length_2801_cov_26.131384	1536	1596	37	7	60	0.1166667
NODE_735_length_2801_cov_26.131384	1536	1596	39	1	60	0.0166667
NODE_735_length_2801_cov_26.131384	1536	1596	41	10	60	0.1666667
NODE_735_length_2801_cov_26.131384	1536	1596	43	1	60	0.0166667
NODE_735_length_2801_cov_26.131384	1536	1596	45	2	60	0.0333333
NODE_735_length_2801_cov_26.131384	1536	1596	47	1	60	0.0166667
NODE_735_length_2801_cov_26.131384	1536	1596	48	9	60	0.1500000
NODE_735_length_2801_cov_26.131384	1536	1596	49	1	60	0.0166667
NODE_735_length_2801_cov_26.131384	1536	1596	51	8	60	0.1333333
NODE_735_length_2801_cov_26.131384	1815	1881	0	66	66	1.0000000
NODE_735_length_2801_cov_26.131384	1854	1934	0	80	80	1.0000000
NODE_736_length_2801_cov_3.594375	2589	2645	0	56	56	1.0000000
NODE_738_length_2796_cov_94.511680	1090	1137	20	1	47	0.0212766
NODE_738_length_2796_cov_94.511680	1090	1137	27	2	47	0.0425532
NODE_738_length_2796_cov_94.511680	1090	1137	29	1	47	0.0212766
NODE_738_length_2796_cov_94.511680	1090	1137	33	3	47	0.0638298
NODE_738_length_2796_cov_94.511680	1090	1137	35	1	47	0.0212766
NODE_738_length_2796_cov_94.511680	1090	1137	39	1	47	0.0212766
NODE_738_length_2796_cov_94.511680	1090	1137	41	2	47	0.0425532
NODE_738_length_2796_cov_94.511680	1090	1137	43	3	47	0.0638298
NODE_738_length_2796_cov_94.511680	1090	1137	47	2	47	0.0425532
NODE_738_length_2796_cov_94.511680	1090	1137	51	1	47	0.0212766
NODE_738_length_2796_cov_94.511680	1090	1137	53	2	47	0.0425532
NODE_738_length_2796_cov_94.511680	1090	1137	55	1	47	0.0212766
NODE_738_length_2796_cov_94.511680	1090	1137	57	1	47	0.0212766
NODE_738_length_2796_cov_94.511680	1090	1137	61	2	47	0.0425532
NODE_738_length_2796_cov_94.511680	1090	1137	62	2	47	0.0425532
NODE_738_length_2796_cov_94.511680	1090	1137	64	1	47	0.0212766
NODE_738_length_2796_cov_94.511680	1090	1137	70	2	47	0.0425532
NODE_738_length_2796_cov_94.511680	1090	1137	76	1	47	0.0212766
NODE_738_length_2796_cov_94.511680	1090	1137	79	2	47	0.0425532
NODE_738_length_2796_cov_94.511680	1090	1137	89	2	47	0.0425532
NODE_738_length_2796_cov_94.511680	1090	1137	90	1	47	0.0212766
NODE_738_length_2796_cov_94.511680	1090	1137	92	1	47	0.0212766
NODE_738_length_2796_cov_94.511680	1090	1137	95	2	47	0.0425532
NODE_738_length_2796_cov_94.511680	1090	1137	103	1	47	0.0212766
NODE_738_length_2796_cov_94.511680	1090	1137	105	1	47	0.0212766
NODE_738_length_2796_cov_94.511680	1090	1137	109	1	47	0.0212766
NODE_738_length_2796_cov_94.511680	1090	1137	111	2	47	0.0425532
NODE_738_length_2796_cov_94.511680	1090	1137	112	1	47	0.0212766
NODE_738_length_2796_cov_94.511680	1090	1137	119	1	47	0.0212766
NODE_738_length_2796_cov_94.511680	1090	1137	121	1	47	0.0212766
NODE_738_length_2796_cov_94.511680	1090	1137	127	2	47	0.0425532
NODE_738_length_2796_cov_94.511680	2717	2796	0	79	79	1.0000000
NODE_744_length_2791_cov_9.997028	310	390	0	80	80	1.0000000
NODE_744_length_2791_cov_9.997028	363	443	0	80	80	1.0000000
NODE_752_length_2778_cov_31.340799	2241	2321	0	80	80	1.0000000
NODE_752_length_2778_cov_31.340799	2294	2374	0	80	80	1.0000000
NODE_752_length_2778_cov_31.340799	2370	2450	0	80	80	1.0000000
NODE_752_length_2778_cov_31.340799	2423	2503	0	80	80	1.0000000
NODE_752_length_2778_cov_31.340799	2564	2620	4	44	56	0.7857143
NODE_752_length_2778_cov_31.340799	2564	2620	6	12	56	0.2142857
NODE_758_length_2767_cov_12.450150	1941	2021	0	80	80	1.0000000
NODE_758_length_2767_cov_12.450150	1994	2074	0	80	80	1.0000000
NODE_767_length_2745_cov_5.322751	511	583	4	53	72	0.7361111
NODE_767_length_2745_cov_5.322751	511	583	6	19	72	0.2638889
NODE_777_length_2720_cov_25.561618	2213	2293	0	80	80	1.0000000
NODE_777_length_2720_cov_25.561618	2266	2346	0	80	80	1.0000000
NODE_782_length_2716_cov_39.885747	715	795	2	44	80	0.5500000
NODE_782_length_2716_cov_39.885747	715	795	4	36	80	0.4500000
NODE_782_length_2716_cov_39.885747	768	848	2	80	80	1.0000000
NODE_782_length_2716_cov_39.885747	844	924	0	21	80	0.2625000
NODE_782_length_2716_cov_39.885747	844	924	2	7	80	0.0875000
NODE_782_length_2716_cov_39.885747	844	924	4	52	80	0.6500000
NODE_782_length_2716_cov_39.885747	897	977	2	3	80	0.0375000
NODE_782_length_2716_cov_39.885747	897	977	4	28	80	0.3500000
NODE_782_length_2716_cov_39.885747	897	977	6	49	80	0.6125000
NODE_785_length_2710_cov_10.896974	2410	2446	0	13	36	0.3611111
NODE_785_length_2710_cov_10.896974	2410	2446	2	7	36	0.1944444
NODE_785_length_2710_cov_10.896974	2410	2446	3	15	36	0.4166667
NODE_785_length_2710_cov_10.896974	2410	2446	9	1	36	0.0277778
NODE_785_length_2710_cov_10.896974	2419	2499	0	4	80	0.0500000
NODE_785_length_2710_cov_10.896974	2419	2499	2	7	80	0.0875000
NODE_785_length_2710_cov_10.896974	2419	2499	3	15	80	0.1875000
NODE_785_length_2710_cov_10.896974	2419	2499	8	15	80	0.1875000
NODE_785_length_2710_cov_10.896974	2419	2499	9	26	80	0.3250000
NODE_785_length_2710_cov_10.896974	2419	2499	10	13	80	0.1625000
NODE_788_length_2708_cov_25.097355	2289	2369	0	80	80	1.0000000
NODE_788_length_2708_cov_25.097355	2342	2422	0	80	80	1.0000000
NODE_789_length_2708_cov_14.569950	18	98	118	1	80	0.0125000
NODE_789_length_2708_cov_14.569950	18	98	120	2	80	0.0250000
NODE_789_length_2708_cov_14.569950	18	98	123	4	80	0.0500000
NODE_789_length_2708_cov_14.569950	18	98	129	1	80	0.0125000
NODE_789_length_2708_cov_14.569950	18	98	137	2	80	0.0250000
NODE_789_length_2708_cov_14.569950	18	98	139	1	80	0.0125000
NODE_789_length_2708_cov_14.569950	18	98	142	1	80	0.0125000
NODE_789_length_2708_cov_14.569950	18	98	143	2	80	0.0250000
NODE_789_length_2708_cov_14.569950	18	98	151	3	80	0.0375000
NODE_789_length_2708_cov_14.569950	18	98	153	2	80	0.0250000
NODE_789_length_2708_cov_14.569950	18	98	154	61	80	0.7625000
NODE_789_length_2708_cov_14.569950	71	134	6	1	63	0.0158730
NODE_789_length_2708_cov_14.569950	71	134	34	1	63	0.0158730
NODE_789_length_2708_cov_14.569950	71	134	44	1	63	0.0158730
NODE_789_length_2708_cov_14.569950	71	134	56	1	63	0.0158730
NODE_789_length_2708_cov_14.569950	71	134	78	1	63	0.0158730
NODE_789_length_2708_cov_14.569950	71	134	89	1	63	0.0158730
NODE_789_length_2708_cov_14.569950	71	134	99	1	63	0.0158730
NODE_789_length_2708_cov_14.569950	71	134	103	1	63	0.0158730
NODE_789_length_2708_cov_14.569950	71	134	106	1	63	0.0158730
NODE_789_length_2708_cov_14.569950	71	134	108	2	63	0.0317460
NODE_789_length_2708_cov_14.569950	71	134	113	1	63	0.0158730
NODE_789_length_2708_cov_14.569950	71	134	116	1	63	0.0158730
NODE_789_length_2708_cov_14.569950	71	134	120	2	63	0.0317460
NODE_789_length_2708_cov_14.569950	71	134	122	2	63	0.0317460
NODE_789_length_2708_cov_14.569950	71	134	123	1	63	0.0158730
NODE_789_length_2708_cov_14.569950	71	134	124	2	63	0.0317460
NODE_789_length_2708_cov_14.569950	71	134	130	4	63	0.0634921
NODE_789_length_2708_cov_14.569950	71	134	136	1	63	0.0158730
NODE_789_length_2708_cov_14.569950	71	134	138	1	63	0.0158730
NODE_789_length_2708_cov_14.569950	71	134	140	1	63	0.0158730
NODE_789_length_2708_cov_14.569950	71	134	144	2	63	0.0317460
NODE_789_length_2708_cov_14.569950	71	134	145	1	63	0.0158730
NODE_789_length_2708_cov_14.569950	71	134	148	1	63	0.0158730
NODE_789_length_2708_cov_14.569950	71	134	154	32	63	0.5079365
NODE_797_length_2691_cov_35.457948	401	481	0	80	80	1.0000000
NODE_797_length_2691_cov_35.457948	454	534	0	80	80	1.0000000
NODE_803_length_2684_cov_17.345068	146	194	0	47	48	0.9791667
NODE_803_length_2684_cov_17.345068	146	194	2	1	48	0.0208333
NODE_803_length_2684_cov_17.345068	146	194	0	47	48	0.9791667
NODE_803_length_2684_cov_17.345068	146	194	2	1	48	0.0208333
NODE_803_length_2684_cov_17.345068	146	194	0	47	48	0.9791667
NODE_803_length_2684_cov_17.345068	146	194	2	1	48	0.0208333
NODE_803_length_2684_cov_17.345068	146	194	0	47	48	0.9791667
NODE_803_length_2684_cov_17.345068	146	194	2	1	48	0.0208333
NODE_803_length_2684_cov_17.345068	146	194	0	47	48	0.9791667
NODE_803_length_2684_cov_17.345068	146	194	2	1	48	0.0208333
NODE_805_length_2682_cov_43.500581	913	992	260	1	79	0.0126582
NODE_805_length_2682_cov_43.500581	913	992	262	1	79	0.0126582
NODE_805_length_2682_cov_43.500581	913	992	263	1	79	0.0126582
NODE_805_length_2682_cov_43.500581	913	992	264	1	79	0.0126582
NODE_805_length_2682_cov_43.500581	913	992	265	1	79	0.0126582
NODE_805_length_2682_cov_43.500581	913	992	266	1	79	0.0126582
NODE_805_length_2682_cov_43.500581	913	992	267	1	79	0.0126582
NODE_805_length_2682_cov_43.500581	913	992	269	4	79	0.0506329
NODE_805_length_2682_cov_43.500581	913	992	283	1	79	0.0126582
NODE_805_length_2682_cov_43.500581	913	992	297	1	79	0.0126582
NODE_805_length_2682_cov_43.500581	913	992	307	3	79	0.0379747
NODE_805_length_2682_cov_43.500581	913	992	315	1	79	0.0126582
NODE_805_length_2682_cov_43.500581	913	992	323	1	79	0.0126582
NODE_805_length_2682_cov_43.500581	913	992	330	1	79	0.0126582
NODE_805_length_2682_cov_43.500581	913	992	331	1	79	0.0126582
NODE_805_length_2682_cov_43.500581	913	992	333	1	79	0.0126582
NODE_805_length_2682_cov_43.500581	913	992	345	1	79	0.0126582
NODE_805_length_2682_cov_43.500581	913	992	346	1	79	0.0126582
NODE_805_length_2682_cov_43.500581	913	992	348	1	79	0.0126582
NODE_805_length_2682_cov_43.500581	913	992	349	1	79	0.0126582
NODE_805_length_2682_cov_43.500581	913	992	350	1	79	0.0126582
NODE_805_length_2682_cov_43.500581	913	992	354	1	79	0.0126582
NODE_805_length_2682_cov_43.500581	913	992	361	2	79	0.0253165
NODE_805_length_2682_cov_43.500581	913	992	388	1	79	0.0126582
NODE_805_length_2682_cov_43.500581	913	992	391	1	79	0.0126582
NODE_805_length_2682_cov_43.500581	913	992	393	1	79	0.0126582
NODE_805_length_2682_cov_43.500581	913	992	396	1	79	0.0126582
NODE_805_length_2682_cov_43.500581	913	992	397	4	79	0.0506329
NODE_805_length_2682_cov_43.500581	913	992	400	1	79	0.0126582
NODE_805_length_2682_cov_43.500581	913	992	402	1	79	0.0126582
NODE_805_length_2682_cov_43.500581	913	992	403	1	79	0.0126582
NODE_805_length_2682_cov_43.500581	913	992	404	1	79	0.0126582
NODE_805_length_2682_cov_43.500581	913	992	409	1	79	0.0126582
NODE_805_length_2682_cov_43.500581	913	992	415	2	79	0.0253165
NODE_805_length_2682_cov_43.500581	913	992	418	1	79	0.0126582
NODE_805_length_2682_cov_43.500581	913	992	430	1	79	0.0126582
NODE_805_length_2682_cov_43.500581	913	992	431	2	79	0.0253165
NODE_805_length_2682_cov_43.500581	913	992	433	1	79	0.0126582
NODE_805_length_2682_cov_43.500581	913	992	437	2	79	0.0253165
NODE_805_length_2682_cov_43.500581	913	992	439	1	79	0.0126582
NODE_805_length_2682_cov_43.500581	913	992	444	1	79	0.0126582
NODE_805_length_2682_cov_43.500581	913	992	447	1	79	0.0126582
NODE_805_length_2682_cov_43.500581	913	992	448	1	79	0.0126582
NODE_805_length_2682_cov_43.500581	913	992	449	2	79	0.0253165
NODE_805_length_2682_cov_43.500581	913	992	463	1	79	0.0126582
NODE_805_length_2682_cov_43.500581	913	992	464	1	79	0.0126582
NODE_805_length_2682_cov_43.500581	913	992	467	2	79	0.0253165
NODE_805_length_2682_cov_43.500581	913	992	468	1	79	0.0126582
NODE_805_length_2682_cov_43.500581	913	992	469	2	79	0.0253165
NODE_805_length_2682_cov_43.500581	913	992	470	1	79	0.0126582
NODE_805_length_2682_cov_43.500581	913	992	472	1	79	0.0126582
NODE_805_length_2682_cov_43.500581	913	992	474	1	79	0.0126582
NODE_805_length_2682_cov_43.500581	913	992	476	3	79	0.0379747
NODE_805_length_2682_cov_43.500581	913	992	478	1	79	0.0126582
NODE_805_length_2682_cov_43.500581	913	992	484	1	79	0.0126582
NODE_805_length_2682_cov_43.500581	913	992	487	1	79	0.0126582
NODE_805_length_2682_cov_43.500581	913	992	494	1	79	0.0126582
NODE_805_length_2682_cov_43.500581	913	992	502	1	79	0.0126582
NODE_805_length_2682_cov_43.500581	913	992	515	1	79	0.0126582
NODE_805_length_2682_cov_43.500581	913	992	530	1	79	0.0126582
NODE_805_length_2682_cov_43.500581	913	992	540	1	79	0.0126582
NODE_805_length_2682_cov_43.500581	913	992	547	1	79	0.0126582
NODE_805_length_2682_cov_43.500581	965	1002	243	1	37	0.0270270
NODE_805_length_2682_cov_43.500581	965	1002	245	1	37	0.0270270
NODE_805_length_2682_cov_43.500581	965	1002	246	2	37	0.0540541
NODE_805_length_2682_cov_43.500581	965	1002	248	1	37	0.0270270
NODE_805_length_2682_cov_43.500581	965	1002	250	2	37	0.0540541
NODE_805_length_2682_cov_43.500581	965	1002	251	2	37	0.0540541
NODE_805_length_2682_cov_43.500581	965	1002	255	1	37	0.0270270
NODE_805_length_2682_cov_43.500581	965	1002	260	1	37	0.0270270
NODE_805_length_2682_cov_43.500581	965	1002	262	1	37	0.0270270
NODE_805_length_2682_cov_43.500581	965	1002	263	1	37	0.0270270
NODE_805_length_2682_cov_43.500581	965	1002	264	1	37	0.0270270
NODE_805_length_2682_cov_43.500581	965	1002	265	1	37	0.0270270
NODE_805_length_2682_cov_43.500581	965	1002	266	1	37	0.0270270
NODE_805_length_2682_cov_43.500581	965	1002	267	1	37	0.0270270
NODE_805_length_2682_cov_43.500581	965	1002	269	4	37	0.1081081
NODE_805_length_2682_cov_43.500581	965	1002	283	1	37	0.0270270
NODE_805_length_2682_cov_43.500581	965	1002	297	1	37	0.0270270
NODE_805_length_2682_cov_43.500581	965	1002	307	3	37	0.0810811
NODE_805_length_2682_cov_43.500581	965	1002	315	1	37	0.0270270
NODE_805_length_2682_cov_43.500581	965	1002	323	1	37	0.0270270
NODE_805_length_2682_cov_43.500581	965	1002	330	1	37	0.0270270
NODE_805_length_2682_cov_43.500581	965	1002	331	1	37	0.0270270
NODE_805_length_2682_cov_43.500581	965	1002	333	1	37	0.0270270
NODE_805_length_2682_cov_43.500581	965	1002	345	1	37	0.0270270
NODE_805_length_2682_cov_43.500581	965	1002	346	1	37	0.0270270
NODE_805_length_2682_cov_43.500581	965	1002	348	1	37	0.0270270
NODE_805_length_2682_cov_43.500581	965	1002	349	1	37	0.0270270
NODE_805_length_2682_cov_43.500581	965	1002	350	1	37	0.0270270
NODE_805_length_2682_cov_43.500581	965	1002	354	1	37	0.0270270
NODE_808_length_2675_cov_10.369565	209	289	16	6	80	0.0750000
NODE_808_length_2675_cov_10.369565	209	289	18	10	80	0.1250000
NODE_808_length_2675_cov_10.369565	209	289	20	6	80	0.0750000
NODE_808_length_2675_cov_10.369565	209	289	22	1	80	0.0125000
NODE_808_length_2675_cov_10.369565	209	289	24	7	80	0.0875000
NODE_808_length_2675_cov_10.369565	209	289	26	24	80	0.3000000
NODE_808_length_2675_cov_10.369565	209	289	28	26	80	0.3250000
NODE_813_length_2670_cov_17.489304	1995	2075	0	80	80	1.0000000
NODE_813_length_2670_cov_17.489304	2048	2128	0	80	80	1.0000000
NODE_813_length_2670_cov_17.489304	2124	2204	0	37	80	0.4625000
NODE_813_length_2670_cov_17.489304	2124	2204	2	43	80	0.5375000
NODE_813_length_2670_cov_17.489304	2177	2257	2	80	80	1.0000000
NODE_815_length_2665_cov_19.145752	548	628	0	80	80	1.0000000
NODE_815_length_2665_cov_19.145752	601	681	0	80	80	1.0000000
NODE_815_length_2665_cov_19.145752	2099	2176	0	77	77	1.0000000
NODE_815_length_2665_cov_19.145752	2172	2252	0	80	80	1.0000000
NODE_815_length_2665_cov_19.145752	2172	2252	0	80	80	1.0000000
NODE_815_length_2665_cov_19.145752	2225	2267	0	42	42	1.0000000
NODE_816_length_2664_cov_4.175049	2005	2085	0	80	80	1.0000000
NODE_816_length_2664_cov_4.175049	2058	2138	0	80	80	1.0000000
NODE_822_length_2650_cov_19.800862	800	880	8	9	80	0.1125000
NODE_822_length_2650_cov_19.800862	800	880	18	18	80	0.2250000
NODE_822_length_2650_cov_19.800862	800	880	20	12	80	0.1500000
NODE_822_length_2650_cov_19.800862	800	880	22	41	80	0.5125000
NODE_824_length_2645_cov_8.618225	931	1011	0	41	80	0.5125000
NODE_824_length_2645_cov_8.618225	931	1011	2	39	80	0.4875000
NODE_824_length_2645_cov_8.618225	984	1064	0	26	80	0.3250000
NODE_824_length_2645_cov_8.618225	984	1064	2	54	80	0.6750000
NODE_827_length_2640_cov_16.462810	94	164	256	1	70	0.0142857
NODE_827_length_2640_cov_16.462810	94	164	264	1	70	0.0142857
NODE_827_length_2640_cov_16.462810	94	164	270	1	70	0.0142857
NODE_827_length_2640_cov_16.462810	94	164	271	1	70	0.0142857
NODE_827_length_2640_cov_16.462810	94	164	277	1	70	0.0142857
NODE_827_length_2640_cov_16.462810	94	164	283	1	70	0.0142857
NODE_827_length_2640_cov_16.462810	94	164	287	1	70	0.0142857
NODE_827_length_2640_cov_16.462810	94	164	289	2	70	0.0285714
NODE_827_length_2640_cov_16.462810	94	164	291	1	70	0.0142857
NODE_827_length_2640_cov_16.462810	94	164	296	1	70	0.0142857
NODE_827_length_2640_cov_16.462810	94	164	298	1	70	0.0142857
NODE_827_length_2640_cov_16.462810	94	164	299	1	70	0.0142857
NODE_827_length_2640_cov_16.462810	94	164	301	1	70	0.0142857
NODE_827_length_2640_cov_16.462810	94	164	305	1	70	0.0142857
NODE_827_length_2640_cov_16.462810	94	164	307	1	70	0.0142857
NODE_827_length_2640_cov_16.462810	94	164	309	1	70	0.0142857
NODE_827_length_2640_cov_16.462810	94	164	319	1	70	0.0142857
NODE_827_length_2640_cov_16.462810	94	164	323	2	70	0.0285714
NODE_827_length_2640_cov_16.462810	94	164	330	1	70	0.0142857
NODE_827_length_2640_cov_16.462810	94	164	332	1	70	0.0142857
NODE_827_length_2640_cov_16.462810	94	164	338	1	70	0.0142857
NODE_827_length_2640_cov_16.462810	94	164	364	2	70	0.0285714
NODE_827_length_2640_cov_16.462810	94	164	369	1	70	0.0142857
NODE_827_length_2640_cov_16.462810	94	164	372	1	70	0.0142857
NODE_827_length_2640_cov_16.462810	94	164	374	1	70	0.0142857
NODE_827_length_2640_cov_16.462810	94	164	375	1	70	0.0142857
NODE_827_length_2640_cov_16.462810	94	164	377	1	70	0.0142857
NODE_827_length_2640_cov_16.462810	94	164	381	1	70	0.0142857
NODE_827_length_2640_cov_16.462810	94	164	382	2	70	0.0285714
NODE_827_length_2640_cov_16.462810	94	164	384	2	70	0.0285714
NODE_827_length_2640_cov_16.462810	94	164	385	1	70	0.0142857
NODE_827_length_2640_cov_16.462810	94	164	386	1	70	0.0142857
NODE_827_length_2640_cov_16.462810	94	164	388	2	70	0.0285714
NODE_827_length_2640_cov_16.462810	94	164	390	1	70	0.0142857
NODE_827_length_2640_cov_16.462810	94	164	394	1	70	0.0142857
NODE_827_length_2640_cov_16.462810	94	164	398	2	70	0.0285714
NODE_827_length_2640_cov_16.462810	94	164	399	1	70	0.0142857
NODE_827_length_2640_cov_16.462810	94	164	409	1	70	0.0142857
NODE_827_length_2640_cov_16.462810	94	164	411	1	70	0.0142857
NODE_827_length_2640_cov_16.462810	94	164	419	1	70	0.0142857
NODE_827_length_2640_cov_16.462810	94	164	422	1	70	0.0142857
NODE_827_length_2640_cov_16.462810	94	164	423	1	70	0.0142857
NODE_827_length_2640_cov_16.462810	94	164	425	1	70	0.0142857
NODE_827_length_2640_cov_16.462810	94	164	426	5	70	0.0714286
NODE_827_length_2640_cov_16.462810	94	164	427	3	70	0.0428571
NODE_827_length_2640_cov_16.462810	94	164	428	4	70	0.0571429
NODE_827_length_2640_cov_16.462810	94	164	429	4	70	0.0571429
NODE_827_length_2640_cov_16.462810	94	164	430	1	70	0.0142857
NODE_827_length_2640_cov_16.462810	94	164	431	1	70	0.0142857
NODE_827_length_2640_cov_16.462810	94	164	432	1	70	0.0142857
NODE_827_length_2640_cov_16.462810	94	164	436	1	70	0.0142857
NODE_827_length_2640_cov_16.462810	147	209	166	1	62	0.0161290
NODE_827_length_2640_cov_16.462810	147	209	167	1	62	0.0161290
NODE_827_length_2640_cov_16.462810	147	209	168	1	62	0.0161290
NODE_827_length_2640_cov_16.462810	147	209	169	2	62	0.0322581
NODE_827_length_2640_cov_16.462810	147	209	172	2	62	0.0322581
NODE_827_length_2640_cov_16.462810	147	209	176	1	62	0.0161290
NODE_827_length_2640_cov_16.462810	147	209	178	1	62	0.0161290
NODE_827_length_2640_cov_16.462810	147	209	179	4	62	0.0645161
NODE_827_length_2640_cov_16.462810	147	209	180	2	62	0.0322581
NODE_827_length_2640_cov_16.462810	147	209	181	2	62	0.0322581
NODE_827_length_2640_cov_16.462810	147	209	183	3	62	0.0483871
NODE_827_length_2640_cov_16.462810	147	209	185	3	62	0.0483871
NODE_827_length_2640_cov_16.462810	147	209	188	1	62	0.0161290
NODE_827_length_2640_cov_16.462810	147	209	189	1	62	0.0161290
NODE_827_length_2640_cov_16.462810	147	209	194	1	62	0.0161290
NODE_827_length_2640_cov_16.462810	147	209	204	1	62	0.0161290
NODE_827_length_2640_cov_16.462810	147	209	209	1	62	0.0161290
NODE_827_length_2640_cov_16.462810	147	209	210	1	62	0.0161290
NODE_827_length_2640_cov_16.462810	147	209	216	2	62	0.0322581
NODE_827_length_2640_cov_16.462810	147	209	218	2	62	0.0322581
NODE_827_length_2640_cov_16.462810	147	209	219	1	62	0.0161290
NODE_827_length_2640_cov_16.462810	147	209	229	1	62	0.0161290
NODE_827_length_2640_cov_16.462810	147	209	233	1	62	0.0161290
NODE_827_length_2640_cov_16.462810	147	209	235	2	62	0.0322581
NODE_827_length_2640_cov_16.462810	147	209	242	3	62	0.0483871
NODE_827_length_2640_cov_16.462810	147	209	244	1	62	0.0161290
NODE_827_length_2640_cov_16.462810	147	209	248	2	62	0.0322581
NODE_827_length_2640_cov_16.462810	147	209	256	2	62	0.0322581
NODE_827_length_2640_cov_16.462810	147	209	264	1	62	0.0161290
NODE_827_length_2640_cov_16.462810	147	209	270	1	62	0.0161290
NODE_827_length_2640_cov_16.462810	147	209	271	1	62	0.0161290
NODE_827_length_2640_cov_16.462810	147	209	277	1	62	0.0161290
NODE_827_length_2640_cov_16.462810	147	209	283	1	62	0.0161290
NODE_827_length_2640_cov_16.462810	147	209	287	1	62	0.0161290
NODE_827_length_2640_cov_16.462810	147	209	289	2	62	0.0322581
NODE_827_length_2640_cov_16.462810	147	209	291	1	62	0.0161290
NODE_827_length_2640_cov_16.462810	147	209	296	1	62	0.0161290
NODE_827_length_2640_cov_16.462810	147	209	298	1	62	0.0161290
NODE_827_length_2640_cov_16.462810	147	209	299	1	62	0.0161290
NODE_827_length_2640_cov_16.462810	147	209	301	1	62	0.0161290
NODE_827_length_2640_cov_16.462810	147	209	305	1	62	0.0161290
NODE_827_length_2640_cov_16.462810	147	209	307	1	62	0.0161290
NODE_827_length_2640_cov_16.462810	147	209	309	1	62	0.0161290
NODE_828_length_2636_cov_200.191171	561	641	141	1	80	0.0125000
NODE_828_length_2636_cov_200.191171	561	641	144	2	80	0.0250000
NODE_828_length_2636_cov_200.191171	561	641	156	2	80	0.0250000
NODE_828_length_2636_cov_200.191171	561	641	158	1	80	0.0125000
NODE_828_length_2636_cov_200.191171	561	641	170	1	80	0.0125000
NODE_828_length_2636_cov_200.191171	561	641	173	2	80	0.0250000
NODE_828_length_2636_cov_200.191171	561	641	174	3	80	0.0375000
NODE_828_length_2636_cov_200.191171	561	641	182	2	80	0.0250000
NODE_828_length_2636_cov_200.191171	561	641	183	3	80	0.0375000
NODE_828_length_2636_cov_200.191171	561	641	186	4	80	0.0500000
NODE_828_length_2636_cov_200.191171	561	641	187	2	80	0.0250000
NODE_828_length_2636_cov_200.191171	561	641	188	6	80	0.0750000
NODE_828_length_2636_cov_200.191171	561	641	189	14	80	0.1750000
NODE_828_length_2636_cov_200.191171	561	641	190	3	80	0.0375000
NODE_828_length_2636_cov_200.191171	561	641	191	6	80	0.0750000
NODE_828_length_2636_cov_200.191171	561	641	192	1	80	0.0125000
NODE_828_length_2636_cov_200.191171	561	641	193	1	80	0.0125000
NODE_828_length_2636_cov_200.191171	561	641	195	1	80	0.0125000
NODE_828_length_2636_cov_200.191171	561	641	196	1	80	0.0125000
NODE_828_length_2636_cov_200.191171	561	641	197	6	80	0.0750000
NODE_828_length_2636_cov_200.191171	561	641	198	2	80	0.0250000
NODE_828_length_2636_cov_200.191171	561	641	200	12	80	0.1500000
NODE_828_length_2636_cov_200.191171	561	641	203	4	80	0.0500000
NODE_828_length_2636_cov_200.191171	614	695	57	1	81	0.0123457
NODE_828_length_2636_cov_200.191171	614	695	59	5	81	0.0617284
NODE_828_length_2636_cov_200.191171	614	695	61	1	81	0.0123457
NODE_828_length_2636_cov_200.191171	614	695	63	1	81	0.0123457
NODE_828_length_2636_cov_200.191171	614	695	71	5	81	0.0617284
NODE_828_length_2636_cov_200.191171	614	695	72	4	81	0.0493827
NODE_828_length_2636_cov_200.191171	614	695	73	2	81	0.0246914
NODE_828_length_2636_cov_200.191171	614	695	77	1	81	0.0123457
NODE_828_length_2636_cov_200.191171	614	695	79	1	81	0.0123457
NODE_828_length_2636_cov_200.191171	614	695	81	1	81	0.0123457
NODE_828_length_2636_cov_200.191171	614	695	84	1	81	0.0123457
NODE_828_length_2636_cov_200.191171	614	695	85	1	81	0.0123457
NODE_828_length_2636_cov_200.191171	614	695	89	1	81	0.0123457
NODE_828_length_2636_cov_200.191171	614	695	90	1	81	0.0123457
NODE_828_length_2636_cov_200.191171	614	695	98	1	81	0.0123457
NODE_828_length_2636_cov_200.191171	614	695	110	1	81	0.0123457
NODE_828_length_2636_cov_200.191171	614	695	114	1	81	0.0123457
NODE_828_length_2636_cov_200.191171	614	695	117	1	81	0.0123457
NODE_828_length_2636_cov_200.191171	614	695	125	5	81	0.0617284
NODE_828_length_2636_cov_200.191171	614	695	129	1	81	0.0123457
NODE_828_length_2636_cov_200.191171	614	695	133	3	81	0.0370370
NODE_828_length_2636_cov_200.191171	614	695	136	2	81	0.0246914
NODE_828_length_2636_cov_200.191171	614	695	159	1	81	0.0123457
NODE_828_length_2636_cov_200.191171	614	695	166	1	81	0.0123457
NODE_828_length_2636_cov_200.191171	614	695	168	1	81	0.0123457
NODE_828_length_2636_cov_200.191171	614	695	169	1	81	0.0123457
NODE_828_length_2636_cov_200.191171	614	695	170	1	81	0.0123457
NODE_828_length_2636_cov_200.191171	614	695	172	1	81	0.0123457
NODE_828_length_2636_cov_200.191171	614	695	173	1	81	0.0123457
NODE_828_length_2636_cov_200.191171	614	695	177	5	81	0.0617284
NODE_828_length_2636_cov_200.191171	614	695	179	1	81	0.0123457
NODE_828_length_2636_cov_200.191171	614	695	182	1	81	0.0123457
NODE_828_length_2636_cov_200.191171	614	695	183	3	81	0.0370370
NODE_828_length_2636_cov_200.191171	614	695	186	3	81	0.0370370
NODE_828_length_2636_cov_200.191171	614	695	187	2	81	0.0246914
NODE_828_length_2636_cov_200.191171	614	695	188	2	81	0.0246914
NODE_828_length_2636_cov_200.191171	614	695	189	11	81	0.1358025
NODE_828_length_2636_cov_200.191171	614	695	190	1	81	0.0123457
NODE_828_length_2636_cov_200.191171	614	695	191	4	81	0.0493827
NODE_830_length_2631_cov_10.831754	446	526	0	80	80	1.0000000
NODE_830_length_2631_cov_10.831754	499	572	0	73	73	1.0000000
NODE_833_length_2622_cov_63.057471	1877	1953	139	1	76	0.0131579
NODE_833_length_2622_cov_63.057471	1877	1953	141	4	76	0.0526316
NODE_833_length_2622_cov_63.057471	1877	1953	143	1	76	0.0131579
NODE_833_length_2622_cov_63.057471	1877	1953	145	3	76	0.0394737
NODE_833_length_2622_cov_63.057471	1877	1953	149	3	76	0.0394737
NODE_833_length_2622_cov_63.057471	1877	1953	151	1	76	0.0131579
NODE_833_length_2622_cov_63.057471	1877	1953	153	4	76	0.0526316
NODE_833_length_2622_cov_63.057471	1877	1953	160	1	76	0.0131579
NODE_833_length_2622_cov_63.057471	1877	1953	162	4	76	0.0526316
NODE_833_length_2622_cov_63.057471	1877	1953	166	1	76	0.0131579
NODE_833_length_2622_cov_63.057471	1877	1953	167	1	76	0.0131579
NODE_833_length_2622_cov_63.057471	1877	1953	169	2	76	0.0263158
NODE_833_length_2622_cov_63.057471	1877	1953	173	4	76	0.0526316
NODE_833_length_2622_cov_63.057471	1877	1953	177	2	76	0.0263158
NODE_833_length_2622_cov_63.057471	1877	1953	182	1	76	0.0131579
NODE_833_length_2622_cov_63.057471	1877	1953	185	1	76	0.0131579
NODE_833_length_2622_cov_63.057471	1877	1953	187	3	76	0.0394737
NODE_833_length_2622_cov_63.057471	1877	1953	189	4	76	0.0526316
NODE_833_length_2622_cov_63.057471	1877	1953	191	3	76	0.0394737
NODE_833_length_2622_cov_63.057471	1877	1953	193	3	76	0.0394737
NODE_833_length_2622_cov_63.057471	1877	1953	196	5	76	0.0657895
NODE_833_length_2622_cov_63.057471	1877	1953	198	3	76	0.0394737
NODE_833_length_2622_cov_63.057471	1877	1953	202	3	76	0.0394737
NODE_833_length_2622_cov_63.057471	1877	1953	205	1	76	0.0131579
NODE_833_length_2622_cov_63.057471	1877	1953	206	5	76	0.0657895
NODE_833_length_2622_cov_63.057471	1877	1953	207	3	76	0.0394737
NODE_833_length_2622_cov_63.057471	1877	1953	208	7	76	0.0921053
NODE_833_length_2622_cov_63.057471	1877	1953	209	2	76	0.0263158
NODE_833_length_2622_cov_63.057471	2426	2506	32	1	80	0.0125000
NODE_833_length_2622_cov_63.057471	2426	2506	34	5	80	0.0625000
NODE_833_length_2622_cov_63.057471	2426	2506	35	2	80	0.0250000
NODE_833_length_2622_cov_63.057471	2426	2506	36	8	80	0.1000000
NODE_833_length_2622_cov_63.057471	2426	2506	38	8	80	0.1000000
NODE_833_length_2622_cov_63.057471	2426	2506	39	12	80	0.1500000
NODE_833_length_2622_cov_63.057471	2426	2506	40	2	80	0.0250000
NODE_833_length_2622_cov_63.057471	2426	2506	41	1	80	0.0125000
NODE_833_length_2622_cov_63.057471	2426	2506	42	3	80	0.0375000
NODE_833_length_2622_cov_63.057471	2426	2506	44	2	80	0.0250000
NODE_833_length_2622_cov_63.057471	2426	2506	46	4	80	0.0500000
NODE_833_length_2622_cov_63.057471	2426	2506	48	3	80	0.0375000
NODE_833_length_2622_cov_63.057471	2426	2506	52	3	80	0.0375000
NODE_833_length_2622_cov_63.057471	2426	2506	54	3	80	0.0375000
NODE_833_length_2622_cov_63.057471	2426	2506	55	5	80	0.0625000
NODE_833_length_2622_cov_63.057471	2426	2506	56	1	80	0.0125000
NODE_833_length_2622_cov_63.057471	2426	2506	57	3	80	0.0375000
NODE_833_length_2622_cov_63.057471	2426	2506	58	9	80	0.1125000
NODE_833_length_2622_cov_63.057471	2426	2506	59	1	80	0.0125000
NODE_833_length_2622_cov_63.057471	2426	2506	60	1	80	0.0125000
NODE_833_length_2622_cov_63.057471	2426	2506	61	1	80	0.0125000
NODE_833_length_2622_cov_63.057471	2426	2506	65	2	80	0.0250000
NODE_833_length_2622_cov_63.057471	2479	2559	52	1	80	0.0125000
NODE_833_length_2622_cov_63.057471	2479	2559	54	3	80	0.0375000
NODE_833_length_2622_cov_63.057471	2479	2559	55	5	80	0.0625000
NODE_833_length_2622_cov_63.057471	2479	2559	56	1	80	0.0125000
NODE_833_length_2622_cov_63.057471	2479	2559	57	20	80	0.2500000
NODE_833_length_2622_cov_63.057471	2479	2559	58	9	80	0.1125000
NODE_833_length_2622_cov_63.057471	2479	2559	59	37	80	0.4625000
NODE_833_length_2622_cov_63.057471	2479	2559	60	1	80	0.0125000
NODE_833_length_2622_cov_63.057471	2479	2559	61	1	80	0.0125000
NODE_833_length_2622_cov_63.057471	2479	2559	65	2	80	0.0250000
NODE_836_length_2617_cov_16.817315	1404	1448	2	44	44	1.0000000
NODE_836_length_2617_cov_16.817315	1467	1521	0	22	54	0.4074074
NODE_836_length_2617_cov_16.817315	1467	1521	2	32	54	0.5925926
NODE_839_length_2610_cov_2.232577	2127	2163	0	36	36	1.0000000
NODE_840_length_2609_cov_13.245418	2066	2146	0	80	80	1.0000000
NODE_840_length_2609_cov_13.245418	2119	2199	0	80	80	1.0000000
NODE_840_length_2609_cov_13.245418	2195	2275	0	80	80	1.0000000
NODE_840_length_2609_cov_13.245418	2248	2328	0	80	80	1.0000000
NODE_845_length_2595_cov_5.638622	2157	2237	0	80	80	1.0000000
NODE_847_length_2594_cov_109.880160	386	450	67	1	64	0.0156250
NODE_847_length_2594_cov_109.880160	386	450	71	3	64	0.0468750
NODE_847_length_2594_cov_109.880160	386	450	76	2	64	0.0312500
NODE_847_length_2594_cov_109.880160	386	450	79	2	64	0.0312500
NODE_847_length_2594_cov_109.880160	386	450	91	3	64	0.0468750
NODE_847_length_2594_cov_109.880160	386	450	92	1	64	0.0156250
NODE_847_length_2594_cov_109.880160	386	450	102	1	64	0.0156250
NODE_847_length_2594_cov_109.880160	386	450	104	2	64	0.0312500
NODE_847_length_2594_cov_109.880160	386	450	107	1	64	0.0156250
NODE_847_length_2594_cov_109.880160	386	450	114	1	64	0.0156250
NODE_847_length_2594_cov_109.880160	386	450	132	1	64	0.0156250
NODE_847_length_2594_cov_109.880160	386	450	144	1	64	0.0156250
NODE_847_length_2594_cov_109.880160	386	450	146	1	64	0.0156250
NODE_847_length_2594_cov_109.880160	386	450	153	1	64	0.0156250
NODE_847_length_2594_cov_109.880160	386	450	156	1	64	0.0156250
NODE_847_length_2594_cov_109.880160	386	450	157	1	64	0.0156250
NODE_847_length_2594_cov_109.880160	386	450	161	1	64	0.0156250
NODE_847_length_2594_cov_109.880160	386	450	162	4	64	0.0625000
NODE_847_length_2594_cov_109.880160	386	450	164	4	64	0.0625000
NODE_847_length_2594_cov_109.880160	386	450	170	2	64	0.0312500
NODE_847_length_2594_cov_109.880160	386	450	172	3	64	0.0468750
NODE_847_length_2594_cov_109.880160	386	450	177	3	64	0.0468750
NODE_847_length_2594_cov_109.880160	386	450	181	1	64	0.0156250
NODE_847_length_2594_cov_109.880160	386	450	186	1	64	0.0156250
NODE_847_length_2594_cov_109.880160	386	450	206	1	64	0.0156250
NODE_847_length_2594_cov_109.880160	386	450	208	1	64	0.0156250
NODE_847_length_2594_cov_109.880160	386	450	219	2	64	0.0312500
NODE_847_length_2594_cov_109.880160	386	450	221	1	64	0.0156250
NODE_847_length_2594_cov_109.880160	386	450	222	3	64	0.0468750
NODE_847_length_2594_cov_109.880160	386	450	223	4	64	0.0625000
NODE_847_length_2594_cov_109.880160	386	450	225	4	64	0.0625000
NODE_847_length_2594_cov_109.880160	386	450	229	3	64	0.0468750
NODE_847_length_2594_cov_109.880160	386	450	237	3	64	0.0468750
NODE_856_length_2575_cov_4.890549	1860	1912	0	48	52	0.9230769
NODE_856_length_2575_cov_4.890549	1860	1912	2	4	52	0.0769231
NODE_857_length_2572_cov_46.828548	302	382	0	58	80	0.7250000
NODE_857_length_2572_cov_46.828548	302	382	2	22	80	0.2750000
NODE_857_length_2572_cov_46.828548	355	435	0	5	80	0.0625000
NODE_857_length_2572_cov_46.828548	355	435	2	75	80	0.9375000
NODE_868_length_2551_cov_40.721860	1104	1150	6	42	46	0.9130435
NODE_868_length_2551_cov_40.721860	1104	1150	8	4	46	0.0869565
NODE_868_length_2551_cov_40.721860	1199	1259	0	30	60	0.5000000
NODE_868_length_2551_cov_40.721860	1199	1259	2	30	60	0.5000000
NODE_870_length_2547_cov_218.062908	436	486	0	25	50	0.5000000
NODE_870_length_2547_cov_218.062908	436	486	2	2	50	0.0400000
NODE_870_length_2547_cov_218.062908	436	486	4	6	50	0.1200000
NODE_870_length_2547_cov_218.062908	436	486	5	3	50	0.0600000
NODE_870_length_2547_cov_218.062908	436	486	6	2	50	0.0400000
NODE_870_length_2547_cov_218.062908	436	486	8	1	50	0.0200000
NODE_870_length_2547_cov_218.062908	436	486	10	2	50	0.0400000
NODE_870_length_2547_cov_218.062908	436	486	12	1	50	0.0200000
NODE_870_length_2547_cov_218.062908	436	486	16	1	50	0.0200000
NODE_870_length_2547_cov_218.062908	436	486	18	1	50	0.0200000
NODE_870_length_2547_cov_218.062908	436	486	22	1	50	0.0200000
NODE_870_length_2547_cov_218.062908	436	486	23	1	50	0.0200000
NODE_870_length_2547_cov_218.062908	436	486	27	3	50	0.0600000
NODE_870_length_2547_cov_218.062908	436	486	29	1	50	0.0200000
NODE_879_length_2527_cov_27.275947	503	548	55	1	45	0.0222222
NODE_879_length_2527_cov_27.275947	503	548	57	1	45	0.0222222
NODE_879_length_2527_cov_27.275947	503	548	59	7	45	0.1555556
NODE_879_length_2527_cov_27.275947	503	548	60	10	45	0.2222222
NODE_879_length_2527_cov_27.275947	503	548	62	2	45	0.0444444
NODE_879_length_2527_cov_27.275947	503	548	63	9	45	0.2000000
NODE_879_length_2527_cov_27.275947	503	548	64	4	45	0.0888889
NODE_879_length_2527_cov_27.275947	503	548	65	4	45	0.0888889
NODE_879_length_2527_cov_27.275947	503	548	66	1	45	0.0222222
NODE_879_length_2527_cov_27.275947	503	548	67	1	45	0.0222222
NODE_879_length_2527_cov_27.275947	503	548	68	5	45	0.1111111
NODE_884_length_2519_cov_15.991322	2122	2202	0	80	80	1.0000000
NODE_884_length_2519_cov_15.991322	2175	2255	0	80	80	1.0000000
NODE_885_length_2518_cov_7.035965	62	142	27	1	80	0.0125000
NODE_885_length_2518_cov_7.035965	62	142	28	12	80	0.1500000
NODE_885_length_2518_cov_7.035965	62	142	30	10	80	0.1250000
NODE_885_length_2518_cov_7.035965	62	142	34	36	80	0.4500000
NODE_885_length_2518_cov_7.035965	62	142	36	21	80	0.2625000
NODE_885_length_2518_cov_7.035965	2005	2085	0	80	80	1.0000000
NODE_885_length_2518_cov_7.035965	2058	2138	0	80	80	1.0000000
NODE_887_length_2515_cov_37.984272	393	473	0	80	80	1.0000000
NODE_887_length_2515_cov_37.984272	446	526	0	80	80	1.0000000
NODE_887_length_2515_cov_37.984272	1896	1976	0	71	80	0.8875000
NODE_887_length_2515_cov_37.984272	1896	1976	4	9	80	0.1125000
NODE_887_length_2515_cov_37.984272	1949	2029	0	18	80	0.2250000
NODE_887_length_2515_cov_37.984272	1949	2029	4	62	80	0.7750000
NODE_887_length_2515_cov_37.984272	2025	2105	0	10	80	0.1250000
NODE_887_length_2515_cov_37.984272	2025	2105	4	70	80	0.8750000
NODE_887_length_2515_cov_37.984272	2025	2104	0	9	79	0.1139240
NODE_887_length_2515_cov_37.984272	2025	2104	4	70	79	0.8860760
NODE_887_length_2515_cov_37.984272	2078	2158	0	34	80	0.4250000
NODE_887_length_2515_cov_37.984272	2078	2158	2	29	80	0.3625000
NODE_887_length_2515_cov_37.984272	2078	2158	4	17	80	0.2125000
NODE_888_length_2512_cov_48.259428	1299	1379	10	6	80	0.0750000
NODE_888_length_2512_cov_48.259428	1299	1379	12	15	80	0.1875000
NODE_888_length_2512_cov_48.259428	1299	1379	14	23	80	0.2875000
NODE_888_length_2512_cov_48.259428	1299	1379	16	6	80	0.0750000
NODE_888_length_2512_cov_48.259428	1299	1379	17	20	80	0.2500000
NODE_888_length_2512_cov_48.259428	1299	1379	18	7	80	0.0875000
NODE_888_length_2512_cov_48.259428	1299	1379	20	1	80	0.0125000
NODE_888_length_2512_cov_48.259428	1299	1379	23	2	80	0.0250000
NODE_888_length_2512_cov_48.259428	1352	1432	8	22	80	0.2750000
NODE_888_length_2512_cov_48.259428	1352	1432	14	52	80	0.6500000
NODE_888_length_2512_cov_48.259428	1352	1432	16	6	80	0.0750000
NODE_888_length_2512_cov_48.259428	1428	1512	6	2	84	0.0238095
NODE_888_length_2512_cov_48.259428	1428	1512	8	6	84	0.0714286
NODE_888_length_2512_cov_48.259428	1428	1512	10	7	84	0.0833333
NODE_888_length_2512_cov_48.259428	1428	1512	12	11	84	0.1309524
NODE_888_length_2512_cov_48.259428	1428	1512	14	23	84	0.2738095
NODE_888_length_2512_cov_48.259428	1428	1512	16	5	84	0.0595238
NODE_888_length_2512_cov_48.259428	1428	1512	18	30	84	0.3571429
NODE_888_length_2512_cov_48.259428	1485	1565	12	8	80	0.1000000
NODE_888_length_2512_cov_48.259428	1485	1565	14	2	80	0.0250000
NODE_888_length_2512_cov_48.259428	1485	1565	16	10	80	0.1250000
NODE_888_length_2512_cov_48.259428	1485	1565	18	43	80	0.5375000
NODE_888_length_2512_cov_48.259428	1485	1565	20	17	80	0.2125000
NODE_891_length_2505_cov_102.009975	390	470	0	38	80	0.4750000
NODE_891_length_2505_cov_102.009975	390	470	2	7	80	0.0875000
NODE_891_length_2505_cov_102.009975	390	470	4	35	80	0.4375000
NODE_891_length_2505_cov_102.009975	443	510	0	67	67	1.0000000
NODE_894_length_2499_cov_2.655417	2325	2375	5	10	50	0.2000000
NODE_894_length_2499_cov_2.655417	2325	2375	11	40	50	0.8000000
NODE_895_length_2498_cov_9.614840	239	281	0	19	42	0.4523810
NODE_895_length_2498_cov_9.614840	239	281	4	23	42	0.5476190
NODE_895_length_2498_cov_9.614840	254	335	0	73	81	0.9012346
NODE_895_length_2498_cov_9.614840	254	335	4	8	81	0.0987654
NODE_895_length_2498_cov_9.614840	254	335	0	73	81	0.9012346
NODE_895_length_2498_cov_9.614840	254	335	4	8	81	0.0987654
NODE_895_length_2498_cov_9.614840	331	411	0	80	80	1.0000000
NODE_895_length_2498_cov_9.614840	384	464	0	80	80	1.0000000
NODE_898_length_2495_cov_5.151085	2395	2444	0	49	49	1.0000000
NODE_898_length_2495_cov_5.151085	2395	2444	0	49	49	1.0000000
NODE_898_length_2495_cov_5.151085	2396	2444	0	48	48	1.0000000
NODE_898_length_2495_cov_5.151085	2396	2444	0	48	48	1.0000000
NODE_898_length_2495_cov_5.151085	2396	2444	0	48	48	1.0000000
NODE_900_length_2492_cov_43.645215	408	488	0	80	80	1.0000000
NODE_903_length_2489_cov_15.105021	204	234	0	30	30	1.0000000
NODE_905_length_2488_cov_2.434910	2141	2200	12	11	59	0.1864407
NODE_905_length_2488_cov_2.434910	2141	2200	13	24	59	0.4067796
NODE_905_length_2488_cov_2.434910	2141	2200	15	6	59	0.1016949
NODE_905_length_2488_cov_2.434910	2141	2200	17	2	59	0.0338983
NODE_905_length_2488_cov_2.434910	2141	2200	24	9	59	0.1525424
NODE_905_length_2488_cov_2.434910	2141	2200	25	7	59	0.1186441
NODE_906_length_2484_cov_335.301887	224	279	905	1	55	0.0181818
NODE_906_length_2484_cov_335.301887	224	279	906	1	55	0.0181818
NODE_906_length_2484_cov_335.301887	224	279	910	1	55	0.0181818
NODE_906_length_2484_cov_335.301887	224	279	914	1	55	0.0181818
NODE_906_length_2484_cov_335.301887	224	279	918	1	55	0.0181818
NODE_906_length_2484_cov_335.301887	224	279	931	1	55	0.0181818
NODE_906_length_2484_cov_335.301887	224	279	934	1	55	0.0181818
NODE_906_length_2484_cov_335.301887	224	279	937	1	55	0.0181818
NODE_906_length_2484_cov_335.301887	224	279	942	1	55	0.0181818
NODE_906_length_2484_cov_335.301887	224	279	944	1	55	0.0181818
NODE_906_length_2484_cov_335.301887	224	279	951	1	55	0.0181818
NODE_906_length_2484_cov_335.301887	224	279	955	1	55	0.0181818
NODE_906_length_2484_cov_335.301887	224	279	956	1	55	0.0181818
NODE_906_length_2484_cov_335.301887	224	279	957	3	55	0.0545455
NODE_906_length_2484_cov_335.301887	224	279	958	1	55	0.0181818
NODE_906_length_2484_cov_335.301887	224	279	960	1	55	0.0181818
NODE_906_length_2484_cov_335.301887	224	279	961	1	55	0.0181818
NODE_906_length_2484_cov_335.301887	224	279	962	1	55	0.0181818
NODE_906_length_2484_cov_335.301887	224	279	963	2	55	0.0363636
NODE_906_length_2484_cov_335.301887	224	279	964	1	55	0.0181818
NODE_906_length_2484_cov_335.301887	224	279	971	1	55	0.0181818
NODE_906_length_2484_cov_335.301887	224	279	974	2	55	0.0363636
NODE_906_length_2484_cov_335.301887	224	279	975	1	55	0.0181818
NODE_906_length_2484_cov_335.301887	224	279	976	1	55	0.0181818
NODE_906_length_2484_cov_335.301887	224	279	979	1	55	0.0181818
NODE_906_length_2484_cov_335.301887	224	279	991	1	55	0.0181818
NODE_906_length_2484_cov_335.301887	224	279	993	1	55	0.0181818
NODE_906_length_2484_cov_335.301887	224	279	998	1	55	0.0181818
NODE_906_length_2484_cov_335.301887	224	279	1002	1	55	0.0181818
NODE_906_length_2484_cov_335.301887	224	279	1004	1	55	0.0181818
NODE_906_length_2484_cov_335.301887	224	279	1012	1	55	0.0181818
NODE_906_length_2484_cov_335.301887	224	279	1014	1	55	0.0181818
NODE_906_length_2484_cov_335.301887	224	279	1016	1	55	0.0181818
NODE_906_length_2484_cov_335.301887	224	279	1017	2	55	0.0363636
NODE_906_length_2484_cov_335.301887	224	279	1018	1	55	0.0181818
NODE_906_length_2484_cov_335.301887	224	279	1019	1	55	0.0181818
NODE_906_length_2484_cov_335.301887	224	279	1020	1	55	0.0181818
NODE_906_length_2484_cov_335.301887	224	279	1021	1	55	0.0181818
NODE_906_length_2484_cov_335.301887	224	279	1022	1	55	0.0181818
NODE_906_length_2484_cov_335.301887	224	279	1024	1	55	0.0181818
NODE_906_length_2484_cov_335.301887	224	279	1026	1	55	0.0181818
NODE_906_length_2484_cov_335.301887	224	279	1027	1	55	0.0181818
NODE_906_length_2484_cov_335.301887	224	279	1031	1	55	0.0181818
NODE_906_length_2484_cov_335.301887	224	279	1035	1	55	0.0181818
NODE_906_length_2484_cov_335.301887	224	279	1036	1	55	0.0181818
NODE_906_length_2484_cov_335.301887	224	279	1038	1	55	0.0181818
NODE_906_length_2484_cov_335.301887	224	279	1040	1	55	0.0181818
NODE_906_length_2484_cov_335.301887	224	279	1042	1	55	0.0181818
NODE_906_length_2484_cov_335.301887	224	279	1050	1	55	0.0181818
NODE_906_length_2484_cov_335.301887	224	279	1061	1	55	0.0181818
NODE_906_length_2484_cov_335.301887	252	332	810	1	80	0.0125000
NODE_906_length_2484_cov_335.301887	252	332	819	1	80	0.0125000
NODE_906_length_2484_cov_335.301887	252	332	820	1	80	0.0125000
NODE_906_length_2484_cov_335.301887	252	332	830	1	80	0.0125000
NODE_906_length_2484_cov_335.301887	252	332	832	1	80	0.0125000
NODE_906_length_2484_cov_335.301887	252	332	834	1	80	0.0125000
NODE_906_length_2484_cov_335.301887	252	332	835	1	80	0.0125000
NODE_906_length_2484_cov_335.301887	252	332	843	1	80	0.0125000
NODE_906_length_2484_cov_335.301887	252	332	857	1	80	0.0125000
NODE_906_length_2484_cov_335.301887	252	332	860	1	80	0.0125000
NODE_906_length_2484_cov_335.301887	252	332	864	1	80	0.0125000
NODE_906_length_2484_cov_335.301887	252	332	882	1	80	0.0125000
NODE_906_length_2484_cov_335.301887	252	332	887	1	80	0.0125000
NODE_906_length_2484_cov_335.301887	252	332	897	1	80	0.0125000
NODE_906_length_2484_cov_335.301887	252	332	916	1	80	0.0125000
NODE_906_length_2484_cov_335.301887	252	332	930	1	80	0.0125000
NODE_906_length_2484_cov_335.301887	252	332	955	1	80	0.0125000
NODE_906_length_2484_cov_335.301887	252	332	956	1	80	0.0125000
NODE_906_length_2484_cov_335.301887	252	332	959	1	80	0.0125000
NODE_906_length_2484_cov_335.301887	252	332	970	1	80	0.0125000
NODE_906_length_2484_cov_335.301887	252	332	979	1	80	0.0125000
NODE_906_length_2484_cov_335.301887	252	332	980	1	80	0.0125000
NODE_906_length_2484_cov_335.301887	252	332	991	1	80	0.0125000
NODE_906_length_2484_cov_335.301887	252	332	993	1	80	0.0125000
NODE_906_length_2484_cov_335.301887	252	332	997	1	80	0.0125000
NODE_906_length_2484_cov_335.301887	252	332	998	1	80	0.0125000
NODE_906_length_2484_cov_335.301887	252	332	1002	1	80	0.0125000
NODE_906_length_2484_cov_335.301887	252	332	1003	1	80	0.0125000
NODE_906_length_2484_cov_335.301887	252	332	1004	1	80	0.0125000
NODE_906_length_2484_cov_335.301887	252	332	1011	1	80	0.0125000
NODE_906_length_2484_cov_335.301887	252	332	1012	1	80	0.0125000
NODE_906_length_2484_cov_335.301887	252	332	1014	1	80	0.0125000
NODE_906_length_2484_cov_335.301887	252	332	1016	1	80	0.0125000
NODE_906_length_2484_cov_335.301887	252	332	1017	3	80	0.0375000
NODE_906_length_2484_cov_335.301887	252	332	1018	2	80	0.0250000
NODE_906_length_2484_cov_335.301887	252	332	1019	1	80	0.0125000
NODE_906_length_2484_cov_335.301887	252	332	1020	1	80	0.0125000
NODE_906_length_2484_cov_335.301887	252	332	1021	1	80	0.0125000
NODE_906_length_2484_cov_335.301887	252	332	1022	1	80	0.0125000
NODE_906_length_2484_cov_335.301887	252	332	1023	1	80	0.0125000
NODE_906_length_2484_cov_335.301887	252	332	1024	2	80	0.0250000
NODE_906_length_2484_cov_335.301887	252	332	1026	3	80	0.0375000
NODE_906_length_2484_cov_335.301887	252	332	1027	4	80	0.0500000
NODE_906_length_2484_cov_335.301887	252	332	1030	2	80	0.0250000
NODE_906_length_2484_cov_335.301887	252	332	1031	4	80	0.0500000
NODE_906_length_2484_cov_335.301887	252	332	1032	1	80	0.0125000
NODE_906_length_2484_cov_335.301887	252	332	1033	1	80	0.0125000
NODE_906_length_2484_cov_335.301887	252	332	1035	2	80	0.0250000
NODE_906_length_2484_cov_335.301887	252	332	1036	1	80	0.0125000
NODE_906_length_2484_cov_335.301887	252	332	1037	2	80	0.0250000
NODE_906_length_2484_cov_335.301887	252	332	1038	1	80	0.0125000
NODE_906_length_2484_cov_335.301887	252	332	1039	1	80	0.0125000
NODE_906_length_2484_cov_335.301887	252	332	1040	1	80	0.0125000
NODE_906_length_2484_cov_335.301887	252	332	1042	2	80	0.0250000
NODE_906_length_2484_cov_335.301887	252	332	1043	2	80	0.0250000
NODE_906_length_2484_cov_335.301887	252	332	1044	1	80	0.0125000
NODE_906_length_2484_cov_335.301887	252	332	1045	1	80	0.0125000
NODE_906_length_2484_cov_335.301887	252	332	1047	2	80	0.0250000
NODE_906_length_2484_cov_335.301887	252	332	1050	2	80	0.0250000
NODE_906_length_2484_cov_335.301887	252	332	1055	1	80	0.0125000
NODE_906_length_2484_cov_335.301887	252	332	1061	1	80	0.0125000
NODE_912_length_2479_cov_90.381092	369	449	0	80	80	1.0000000
NODE_912_length_2479_cov_90.381092	422	499	0	77	77	1.0000000
NODE_912_length_2479_cov_90.381092	1610	1685	110	1	75	0.0133333
NODE_912_length_2479_cov_90.381092	1610	1685	161	1	75	0.0133333
NODE_912_length_2479_cov_90.381092	1610	1685	171	3	75	0.0400000
NODE_912_length_2479_cov_90.381092	1610	1685	175	1	75	0.0133333
NODE_912_length_2479_cov_90.381092	1610	1685	179	2	75	0.0266667
NODE_912_length_2479_cov_90.381092	1610	1685	187	1	75	0.0133333
NODE_912_length_2479_cov_90.381092	1610	1685	188	1	75	0.0133333
NODE_912_length_2479_cov_90.381092	1610	1685	190	2	75	0.0266667
NODE_912_length_2479_cov_90.381092	1610	1685	192	1	75	0.0133333
NODE_912_length_2479_cov_90.381092	1610	1685	193	1	75	0.0133333
NODE_912_length_2479_cov_90.381092	1610	1685	206	1	75	0.0133333
NODE_912_length_2479_cov_90.381092	1610	1685	207	2	75	0.0266667
NODE_912_length_2479_cov_90.381092	1610	1685	213	1	75	0.0133333
NODE_912_length_2479_cov_90.381092	1610	1685	217	1	75	0.0133333
NODE_912_length_2479_cov_90.381092	1610	1685	230	1	75	0.0133333
NODE_912_length_2479_cov_90.381092	1610	1685	231	1	75	0.0133333
NODE_912_length_2479_cov_90.381092	1610	1685	235	1	75	0.0133333
NODE_912_length_2479_cov_90.381092	1610	1685	247	1	75	0.0133333
NODE_912_length_2479_cov_90.381092	1610	1685	248	1	75	0.0133333
NODE_912_length_2479_cov_90.381092	1610	1685	255	2	75	0.0266667
NODE_912_length_2479_cov_90.381092	1610	1685	263	1	75	0.0133333
NODE_912_length_2479_cov_90.381092	1610	1685	264	2	75	0.0266667
NODE_912_length_2479_cov_90.381092	1610	1685	266	1	75	0.0133333
NODE_912_length_2479_cov_90.381092	1610	1685	268	1	75	0.0133333
NODE_912_length_2479_cov_90.381092	1610	1685	269	1	75	0.0133333
NODE_912_length_2479_cov_90.381092	1610	1685	277	1	75	0.0133333
NODE_912_length_2479_cov_90.381092	1610	1685	279	1	75	0.0133333
NODE_912_length_2479_cov_90.381092	1610	1685	280	4	75	0.0533333
NODE_912_length_2479_cov_90.381092	1610	1685	282	1	75	0.0133333
NODE_912_length_2479_cov_90.381092	1610	1685	286	1	75	0.0133333
NODE_912_length_2479_cov_90.381092	1610	1685	293	1	75	0.0133333
NODE_912_length_2479_cov_90.381092	1610	1685	302	1	75	0.0133333
NODE_912_length_2479_cov_90.381092	1610	1685	319	1	75	0.0133333
NODE_912_length_2479_cov_90.381092	1610	1685	321	1	75	0.0133333
NODE_912_length_2479_cov_90.381092	1610	1685	330	1	75	0.0133333
NODE_912_length_2479_cov_90.381092	1610	1685	333	1	75	0.0133333
NODE_912_length_2479_cov_90.381092	1610	1685	340	2	75	0.0266667
NODE_912_length_2479_cov_90.381092	1610	1685	349	2	75	0.0266667
NODE_912_length_2479_cov_90.381092	1610	1685	354	1	75	0.0133333
NODE_912_length_2479_cov_90.381092	1610	1685	359	1	75	0.0133333
NODE_912_length_2479_cov_90.381092	1610	1685	360	1	75	0.0133333
NODE_912_length_2479_cov_90.381092	1610	1685	365	1	75	0.0133333
NODE_912_length_2479_cov_90.381092	1610	1685	366	2	75	0.0266667
NODE_912_length_2479_cov_90.381092	1610	1685	367	1	75	0.0133333
NODE_912_length_2479_cov_90.381092	1610	1685	375	1	75	0.0133333
NODE_912_length_2479_cov_90.381092	1610	1685	378	1	75	0.0133333
NODE_912_length_2479_cov_90.381092	1610	1685	381	1	75	0.0133333
NODE_912_length_2479_cov_90.381092	1610	1685	384	1	75	0.0133333
NODE_912_length_2479_cov_90.381092	1610	1685	386	2	75	0.0266667
NODE_912_length_2479_cov_90.381092	1610	1685	387	1	75	0.0133333
NODE_912_length_2479_cov_90.381092	1610	1685	388	1	75	0.0133333
NODE_912_length_2479_cov_90.381092	1610	1685	390	2	75	0.0266667
NODE_912_length_2479_cov_90.381092	1610	1685	391	1	75	0.0133333
NODE_912_length_2479_cov_90.381092	1610	1685	395	3	75	0.0400000
NODE_912_length_2479_cov_90.381092	1610	1685	397	1	75	0.0133333
NODE_912_length_2479_cov_90.381092	1610	1685	399	1	75	0.0133333
NODE_912_length_2479_cov_90.381092	1610	1685	401	2	75	0.0266667
NODE_912_length_2479_cov_90.381092	1658	1730	349	2	72	0.0277778
NODE_912_length_2479_cov_90.381092	1658	1730	354	1	72	0.0138889
NODE_912_length_2479_cov_90.381092	1658	1730	359	1	72	0.0138889
NODE_912_length_2479_cov_90.381092	1658	1730	360	1	72	0.0138889
NODE_912_length_2479_cov_90.381092	1658	1730	365	1	72	0.0138889
NODE_912_length_2479_cov_90.381092	1658	1730	366	2	72	0.0277778
NODE_912_length_2479_cov_90.381092	1658	1730	367	1	72	0.0138889
NODE_912_length_2479_cov_90.381092	1658	1730	375	1	72	0.0138889
NODE_912_length_2479_cov_90.381092	1658	1730	378	1	72	0.0138889
NODE_912_length_2479_cov_90.381092	1658	1730	381	1	72	0.0138889
NODE_912_length_2479_cov_90.381092	1658	1730	384	1	72	0.0138889
NODE_912_length_2479_cov_90.381092	1658	1730	386	2	72	0.0277778
NODE_912_length_2479_cov_90.381092	1658	1730	387	1	72	0.0138889
NODE_912_length_2479_cov_90.381092	1658	1730	388	1	72	0.0138889
NODE_912_length_2479_cov_90.381092	1658	1730	390	2	72	0.0277778
NODE_912_length_2479_cov_90.381092	1658	1730	391	1	72	0.0138889
NODE_912_length_2479_cov_90.381092	1658	1730	395	3	72	0.0416667
NODE_912_length_2479_cov_90.381092	1658	1730	397	1	72	0.0138889
NODE_912_length_2479_cov_90.381092	1658	1730	399	1	72	0.0138889
NODE_912_length_2479_cov_90.381092	1658	1730	401	3	72	0.0416667
NODE_912_length_2479_cov_90.381092	1658	1730	403	1	72	0.0138889
NODE_912_length_2479_cov_90.381092	1658	1730	406	1	72	0.0138889
NODE_912_length_2479_cov_90.381092	1658	1730	407	1	72	0.0138889
NODE_912_length_2479_cov_90.381092	1658	1730	408	3	72	0.0416667
NODE_912_length_2479_cov_90.381092	1658	1730	409	2	72	0.0277778
NODE_912_length_2479_cov_90.381092	1658	1730	410	2	72	0.0277778
NODE_912_length_2479_cov_90.381092	1658	1730	411	1	72	0.0138889
NODE_912_length_2479_cov_90.381092	1658	1730	412	1	72	0.0138889
NODE_912_length_2479_cov_90.381092	1658	1730	413	4	72	0.0555556
NODE_912_length_2479_cov_90.381092	1658	1730	414	1	72	0.0138889
NODE_912_length_2479_cov_90.381092	1658	1730	415	1	72	0.0138889
NODE_912_length_2479_cov_90.381092	1658	1730	416	3	72	0.0416667
NODE_912_length_2479_cov_90.381092	1658	1730	417	3	72	0.0416667
NODE_912_length_2479_cov_90.381092	1658	1730	418	1	72	0.0138889
NODE_912_length_2479_cov_90.381092	1658	1730	419	1	72	0.0138889
NODE_912_length_2479_cov_90.381092	1658	1730	420	4	72	0.0555556
NODE_912_length_2479_cov_90.381092	1658	1730	422	4	72	0.0555556
NODE_912_length_2479_cov_90.381092	1658	1730	425	2	72	0.0277778
NODE_912_length_2479_cov_90.381092	1658	1730	428	2	72	0.0277778
NODE_912_length_2479_cov_90.381092	1658	1730	432	3	72	0.0416667
NODE_912_length_2479_cov_90.381092	1658	1730	434	2	72	0.0277778
NODE_912_length_2479_cov_90.381092	1658	1730	436	1	72	0.0138889
NODE_913_length_2479_cov_3.433193	2379	2426	0	47	47	1.0000000
NODE_913_length_2479_cov_3.433193	2399	2479	0	80	80	1.0000000
NODE_915_length_2474_cov_7.237895	399	479	0	80	80	1.0000000
NODE_915_length_2474_cov_7.237895	452	532	0	80	80	1.0000000
NODE_922_length_2465_cov_3.098056	2133	2213	0	80	80	1.0000000
NODE_922_length_2465_cov_3.098056	2191	2253	0	62	62	1.0000000
NODE_923_length_2464_cov_24.562791	331	409	10	9	78	0.1153846
NODE_923_length_2464_cov_24.562791	331	409	11	14	78	0.1794872
NODE_923_length_2464_cov_24.562791	331	409	12	28	78	0.3589744
NODE_923_length_2464_cov_24.562791	331	409	13	27	78	0.3461539
NODE_923_length_2464_cov_24.562791	382	462	2	36	80	0.4500000
NODE_923_length_2464_cov_24.562791	382	462	4	1	80	0.0125000
NODE_923_length_2464_cov_24.562791	382	462	9	12	80	0.1500000
NODE_923_length_2464_cov_24.562791	382	462	11	3	80	0.0375000
NODE_923_length_2464_cov_24.562791	382	462	12	12	80	0.1500000
NODE_923_length_2464_cov_24.562791	382	462	13	16	80	0.2000000
NODE_924_length_2461_cov_2.696444	292	372	0	11	80	0.1375000
NODE_924_length_2461_cov_2.696444	292	372	2	44	80	0.5500000
NODE_924_length_2461_cov_2.696444	292	372	3	7	80	0.0875000
NODE_924_length_2461_cov_2.696444	292	372	4	18	80	0.2250000
NODE_924_length_2461_cov_2.696444	345	425	0	64	80	0.8000000
NODE_924_length_2461_cov_2.696444	345	425	2	16	80	0.2000000
NODE_938_length_2447_cov_16.079216	2344	2424	18	2	80	0.0250000
NODE_938_length_2447_cov_16.079216	2344	2424	20	4	80	0.0500000
NODE_938_length_2447_cov_16.079216	2344	2424	22	1	80	0.0125000
NODE_938_length_2447_cov_16.079216	2344	2424	23	2	80	0.0250000
NODE_938_length_2447_cov_16.079216	2344	2424	27	1	80	0.0125000
NODE_938_length_2447_cov_16.079216	2344	2424	29	1	80	0.0125000
NODE_938_length_2447_cov_16.079216	2344	2424	30	9	80	0.1125000
NODE_938_length_2447_cov_16.079216	2344	2424	32	10	80	0.1250000
NODE_938_length_2447_cov_16.079216	2344	2424	34	8	80	0.1000000
NODE_938_length_2447_cov_16.079216	2344	2424	36	5	80	0.0625000
NODE_938_length_2447_cov_16.079216	2344	2424	40	9	80	0.1125000
NODE_938_length_2447_cov_16.079216	2344	2424	42	3	80	0.0375000
NODE_938_length_2447_cov_16.079216	2344	2424	44	1	80	0.0125000
NODE_938_length_2447_cov_16.079216	2344	2424	46	2	80	0.0250000
NODE_938_length_2447_cov_16.079216	2344	2424	48	2	80	0.0250000
NODE_938_length_2447_cov_16.079216	2344	2424	50	11	80	0.1375000
NODE_938_length_2447_cov_16.079216	2344	2424	52	1	80	0.0125000
NODE_938_length_2447_cov_16.079216	2344	2424	54	1	80	0.0125000
NODE_938_length_2447_cov_16.079216	2344	2424	56	7	80	0.0875000
NODE_938_length_2447_cov_16.079216	2397	2447	9	2	50	0.0400000
NODE_938_length_2447_cov_16.079216	2397	2447	11	4	50	0.0800000
NODE_938_length_2447_cov_16.079216	2397	2447	15	9	50	0.1800000
NODE_938_length_2447_cov_16.079216	2397	2447	16	7	50	0.1400000
NODE_938_length_2447_cov_16.079216	2397	2447	18	3	50	0.0600000
NODE_938_length_2447_cov_16.079216	2397	2447	20	4	50	0.0800000
NODE_938_length_2447_cov_16.079216	2397	2447	22	1	50	0.0200000
NODE_938_length_2447_cov_16.079216	2397	2447	23	2	50	0.0400000
NODE_938_length_2447_cov_16.079216	2397	2447	27	1	50	0.0200000
NODE_938_length_2447_cov_16.079216	2397	2447	29	1	50	0.0200000
NODE_938_length_2447_cov_16.079216	2397	2447	30	9	50	0.1800000
NODE_938_length_2447_cov_16.079216	2397	2447	32	7	50	0.1400000
NODE_940_length_2446_cov_2.341287	1521	1578	0	57	57	1.0000000
NODE_940_length_2446_cov_2.341287	1551	1593	0	42	42	1.0000000
NODE_949_length_2437_cov_13.341745	418	498	0	80	80	1.0000000
NODE_949_length_2437_cov_13.341745	471	551	0	61	80	0.7625000
NODE_949_length_2437_cov_13.341745	471	551	1	9	80	0.1125000
NODE_949_length_2437_cov_13.341745	471	551	2	4	80	0.0500000
NODE_949_length_2437_cov_13.341745	471	551	6	1	80	0.0125000
NODE_949_length_2437_cov_13.341745	471	551	9	1	80	0.0125000
NODE_949_length_2437_cov_13.341745	471	551	18	2	80	0.0250000
NODE_949_length_2437_cov_13.341745	471	551	24	2	80	0.0250000
NODE_951_length_2432_cov_70.360909	1875	1955	0	80	80	1.0000000
NODE_951_length_2432_cov_70.360909	1928	2008	0	57	80	0.7125000
NODE_951_length_2432_cov_70.360909	1928	2008	2	23	80	0.2875000
NODE_955_length_2430_cov_19.835264	0	68	22	1	68	0.0147059
NODE_955_length_2430_cov_19.835264	0	68	23	1	68	0.0147059
NODE_955_length_2430_cov_19.835264	0	68	25	1	68	0.0147059
NODE_955_length_2430_cov_19.835264	0	68	39	1	68	0.0147059
NODE_955_length_2430_cov_19.835264	0	68	47	1	68	0.0147059
NODE_955_length_2430_cov_19.835264	0	68	53	1	68	0.0147059
NODE_955_length_2430_cov_19.835264	0	68	56	1	68	0.0147059
NODE_955_length_2430_cov_19.835264	0	68	57	2	68	0.0294118
NODE_955_length_2430_cov_19.835264	0	68	61	1	68	0.0147059
NODE_955_length_2430_cov_19.835264	0	68	64	1	68	0.0147059
NODE_955_length_2430_cov_19.835264	0	68	66	1	68	0.0147059
NODE_955_length_2430_cov_19.835264	0	68	69	1	68	0.0147059
NODE_955_length_2430_cov_19.835264	0	68	74	1	68	0.0147059
NODE_955_length_2430_cov_19.835264	0	68	76	1	68	0.0147059
NODE_955_length_2430_cov_19.835264	0	68	78	1	68	0.0147059
NODE_955_length_2430_cov_19.835264	0	68	81	1	68	0.0147059
NODE_955_length_2430_cov_19.835264	0	68	86	1	68	0.0147059
NODE_955_length_2430_cov_19.835264	0	68	88	1	68	0.0147059
NODE_955_length_2430_cov_19.835264	0	68	90	3	68	0.0441176
NODE_955_length_2430_cov_19.835264	0	68	91	2	68	0.0294118
NODE_955_length_2430_cov_19.835264	0	68	95	2	68	0.0294118
NODE_955_length_2430_cov_19.835264	0	68	99	1	68	0.0147059
NODE_955_length_2430_cov_19.835264	0	68	100	1	68	0.0147059
NODE_955_length_2430_cov_19.835264	0	68	101	4	68	0.0588235
NODE_955_length_2430_cov_19.835264	0	68	103	1	68	0.0147059
NODE_955_length_2430_cov_19.835264	0	68	105	1	68	0.0147059
NODE_955_length_2430_cov_19.835264	0	68	111	2	68	0.0294118
NODE_955_length_2430_cov_19.835264	0	68	115	1	68	0.0147059
NODE_955_length_2430_cov_19.835264	0	68	116	1	68	0.0147059
NODE_955_length_2430_cov_19.835264	0	68	120	1	68	0.0147059
NODE_955_length_2430_cov_19.835264	0	68	122	1	68	0.0147059
NODE_955_length_2430_cov_19.835264	0	68	124	1	68	0.0147059
NODE_955_length_2430_cov_19.835264	0	68	127	1	68	0.0147059
NODE_955_length_2430_cov_19.835264	0	68	129	1	68	0.0147059
NODE_955_length_2430_cov_19.835264	0	68	130	1	68	0.0147059
NODE_955_length_2430_cov_19.835264	0	68	131	2	68	0.0294118
NODE_955_length_2430_cov_19.835264	0	68	133	2	68	0.0294118
NODE_955_length_2430_cov_19.835264	0	68	135	2	68	0.0294118
NODE_955_length_2430_cov_19.835264	0	68	136	2	68	0.0294118
NODE_955_length_2430_cov_19.835264	0	68	138	1	68	0.0147059
NODE_955_length_2430_cov_19.835264	0	68	142	1	68	0.0147059
NODE_955_length_2430_cov_19.835264	0	68	143	1	68	0.0147059
NODE_955_length_2430_cov_19.835264	0	68	144	1	68	0.0147059
NODE_955_length_2430_cov_19.835264	0	68	146	1	68	0.0147059
NODE_955_length_2430_cov_19.835264	0	68	150	1	68	0.0147059
NODE_955_length_2430_cov_19.835264	0	68	154	1	68	0.0147059
NODE_955_length_2430_cov_19.835264	0	68	155	1	68	0.0147059
NODE_955_length_2430_cov_19.835264	0	68	159	1	68	0.0147059
NODE_955_length_2430_cov_19.835264	0	68	167	1	68	0.0147059
NODE_955_length_2430_cov_19.835264	0	68	169	1	68	0.0147059
NODE_955_length_2430_cov_19.835264	0	68	174	1	68	0.0147059
NODE_955_length_2430_cov_19.835264	0	68	176	3	68	0.0441176
NODE_955_length_2430_cov_19.835264	0	68	180	1	68	0.0147059
NODE_955_length_2430_cov_19.835264	0	24	22	1	24	0.0416667
NODE_955_length_2430_cov_19.835264	0	24	23	1	24	0.0416667
NODE_955_length_2430_cov_19.835264	0	24	25	1	24	0.0416667
NODE_955_length_2430_cov_19.835264	0	24	39	1	24	0.0416667
NODE_955_length_2430_cov_19.835264	0	24	47	1	24	0.0416667
NODE_955_length_2430_cov_19.835264	0	24	53	1	24	0.0416667
NODE_955_length_2430_cov_19.835264	0	24	56	1	24	0.0416667
NODE_955_length_2430_cov_19.835264	0	24	57	2	24	0.0833333
NODE_955_length_2430_cov_19.835264	0	24	61	1	24	0.0416667
NODE_955_length_2430_cov_19.835264	0	24	64	1	24	0.0416667
NODE_955_length_2430_cov_19.835264	0	24	66	1	24	0.0416667
NODE_955_length_2430_cov_19.835264	0	24	69	1	24	0.0416667
NODE_955_length_2430_cov_19.835264	0	24	74	1	24	0.0416667
NODE_955_length_2430_cov_19.835264	0	24	76	1	24	0.0416667
NODE_955_length_2430_cov_19.835264	0	24	78	1	24	0.0416667
NODE_955_length_2430_cov_19.835264	0	24	81	1	24	0.0416667
NODE_955_length_2430_cov_19.835264	0	24	86	1	24	0.0416667
NODE_955_length_2430_cov_19.835264	0	24	88	1	24	0.0416667
NODE_955_length_2430_cov_19.835264	0	24	90	3	24	0.1250000
NODE_955_length_2430_cov_19.835264	0	24	91	2	24	0.0833333
NODE_956_length_2428_cov_179.842422	538	618	0	80	80	1.0000000
NODE_956_length_2428_cov_179.842422	591	671	0	80	80	1.0000000
NODE_956_length_2428_cov_179.842422	667	747	0	80	80	1.0000000
NODE_956_length_2428_cov_179.842422	720	800	0	80	80	1.0000000
NODE_956_length_2428_cov_179.842422	1308	1388	0	80	80	1.0000000
NODE_956_length_2428_cov_179.842422	1361	1441	0	80	80	1.0000000
NODE_956_length_2428_cov_179.842422	1437	1517	0	80	80	1.0000000
NODE_956_length_2428_cov_179.842422	1490	1570	0	80	80	1.0000000
NODE_956_length_2428_cov_179.842422	1986	2026	917	1	40	0.0250000
NODE_956_length_2428_cov_179.842422	1986	2026	925	1	40	0.0250000
NODE_956_length_2428_cov_179.842422	1986	2026	929	1	40	0.0250000
NODE_956_length_2428_cov_179.842422	1986	2026	936	1	40	0.0250000
NODE_956_length_2428_cov_179.842422	1986	2026	939	1	40	0.0250000
NODE_956_length_2428_cov_179.842422	1986	2026	940	1	40	0.0250000
NODE_956_length_2428_cov_179.842422	1986	2026	941	1	40	0.0250000
NODE_956_length_2428_cov_179.842422	1986	2026	944	1	40	0.0250000
NODE_956_length_2428_cov_179.842422	1986	2026	945	1	40	0.0250000
NODE_956_length_2428_cov_179.842422	1986	2026	950	2	40	0.0500000
NODE_956_length_2428_cov_179.842422	1986	2026	951	1	40	0.0250000
NODE_956_length_2428_cov_179.842422	1986	2026	952	2	40	0.0500000
NODE_956_length_2428_cov_179.842422	1986	2026	955	1	40	0.0250000
NODE_956_length_2428_cov_179.842422	1986	2026	956	4	40	0.1000000
NODE_956_length_2428_cov_179.842422	1986	2026	957	1	40	0.0250000
NODE_956_length_2428_cov_179.842422	1986	2026	958	2	40	0.0500000
NODE_956_length_2428_cov_179.842422	1986	2026	960	2	40	0.0500000
NODE_956_length_2428_cov_179.842422	1986	2026	961	2	40	0.0500000
NODE_956_length_2428_cov_179.842422	1986	2026	962	1	40	0.0250000
NODE_956_length_2428_cov_179.842422	1986	2026	963	1	40	0.0250000
NODE_956_length_2428_cov_179.842422	1986	2026	969	2	40	0.0500000
NODE_956_length_2428_cov_179.842422	1986	2026	981	1	40	0.0250000
NODE_956_length_2428_cov_179.842422	1986	2026	989	1	40	0.0250000
NODE_956_length_2428_cov_179.842422	1986	2026	996	1	40	0.0250000
NODE_956_length_2428_cov_179.842422	1986	2026	1002	1	40	0.0250000
NODE_956_length_2428_cov_179.842422	1986	2026	1007	1	40	0.0250000
NODE_956_length_2428_cov_179.842422	1986	2026	1020	1	40	0.0250000
NODE_956_length_2428_cov_179.842422	1986	2026	1027	1	40	0.0250000
NODE_956_length_2428_cov_179.842422	1986	2026	1035	1	40	0.0250000
NODE_956_length_2428_cov_179.842422	1986	2026	1037	1	40	0.0250000
NODE_956_length_2428_cov_179.842422	1986	2026	1046	1	40	0.0250000
NODE_959_length_2422_cov_6.665088	197	255	0	17	58	0.2931035
NODE_959_length_2422_cov_6.665088	197	255	1	4	58	0.0689655
NODE_959_length_2422_cov_6.665088	197	255	2	23	58	0.3965517
NODE_959_length_2422_cov_6.665088	197	255	4	14	58	0.2413793
NODE_963_length_2414_cov_32.871706	411	491	0	80	80	1.0000000
NODE_963_length_2414_cov_32.871706	464	544	0	80	80	1.0000000
NODE_964_length_2414_cov_2.105832	2349	2390	2	41	41	1.0000000
NODE_968_length_2410_cov_9.107313	1874	1954	0	80	80	1.0000000
NODE_968_length_2410_cov_9.107313	1927	2007	0	80	80	1.0000000
NODE_977_length_2390_cov_20.371454	1753	1833	0	80	80	1.0000000
NODE_977_length_2390_cov_20.371454	1806	1886	0	80	80	1.0000000
NODE_979_length_2389_cov_17.904803	1601	1681	0	80	80	1.0000000
NODE_979_length_2389_cov_17.904803	1654	1734	0	80	80	1.0000000
NODE_979_length_2389_cov_17.904803	1730	1810	0	80	80	1.0000000
NODE_979_length_2389_cov_17.904803	1783	1863	0	80	80	1.0000000
NODE_988_length_2381_cov_32.280894	398	478	0	80	80	1.0000000
NODE_988_length_2381_cov_32.280894	451	531	0	80	80	1.0000000
NODE_988_length_2381_cov_32.280894	527	607	0	80	80	1.0000000
NODE_988_length_2381_cov_32.280894	580	660	0	80	80	1.0000000
NODE_988_length_2381_cov_32.280894	2288	2368	0	8	80	0.1000000
NODE_988_length_2381_cov_32.280894	2288	2368	2	72	80	0.9000000
NODE_997_length_2369_cov_4.896916	241	321	0	80	80	1.0000000
NODE_997_length_2369_cov_4.896916	294	374	0	80	80	1.0000000
NODE_1002_length_2364_cov_2.482561	0	79	0	79	79	1.0000000
NODE_1004_length_2360_cov_8.620080	587	651	31	23	64	0.3593750
NODE_1004_length_2360_cov_8.620080	587	651	35	1	64	0.0156250
NODE_1004_length_2360_cov_8.620080	587	651	37	14	64	0.2187500
NODE_1004_length_2360_cov_8.620080	587	651	38	23	64	0.3593750
NODE_1004_length_2360_cov_8.620080	587	651	39	3	64	0.0468750
NODE_1004_length_2360_cov_8.620080	587	651	31	23	64	0.3593750
NODE_1004_length_2360_cov_8.620080	587	651	35	1	64	0.0156250
NODE_1004_length_2360_cov_8.620080	587	651	37	14	64	0.2187500
NODE_1004_length_2360_cov_8.620080	587	651	38	23	64	0.3593750
NODE_1004_length_2360_cov_8.620080	587	651	39	3	64	0.0468750
NODE_1004_length_2360_cov_8.620080	624	684	8	4	60	0.0666667
NODE_1004_length_2360_cov_8.620080	624	684	10	1	60	0.0166667
NODE_1004_length_2360_cov_8.620080	624	684	19	22	60	0.3666667
NODE_1004_length_2360_cov_8.620080	624	684	23	1	60	0.0166667
NODE_1004_length_2360_cov_8.620080	624	684	31	2	60	0.0333333
NODE_1004_length_2360_cov_8.620080	624	684	37	17	60	0.2833333
NODE_1004_length_2360_cov_8.620080	624	684	38	10	60	0.1666667
NODE_1004_length_2360_cov_8.620080	624	684	39	3	60	0.0500000
NODE_1004_length_2360_cov_8.620080	1827	1907	0	30	80	0.3750000
NODE_1004_length_2360_cov_8.620080	1827	1907	4	50	80	0.6250000
NODE_1004_length_2360_cov_8.620080	1880	1960	0	26	80	0.3250000
NODE_1004_length_2360_cov_8.620080	1880	1960	4	54	80	0.6750000
NODE_1005_length_2359_cov_22.317257	958	1038	0	80	80	1.0000000
NODE_1005_length_2359_cov_22.317257	1011	1091	0	80	80	1.0000000
NODE_1008_length_2357_cov_25.711249	716	796	0	58	80	0.7250000
NODE_1008_length_2357_cov_25.711249	716	796	4	22	80	0.2750000
NODE_1008_length_2357_cov_25.711249	769	849	0	80	80	1.0000000
NODE_1015_length_2345_cov_5.386465	1845	1925	0	80	80	1.0000000
NODE_1015_length_2345_cov_5.386465	1898	1978	0	80	80	1.0000000
NODE_1016_length_2344_cov_6.236526	1208	1269	6	61	61	1.0000000
NODE_1016_length_2344_cov_6.236526	1208	1269	6	61	61	1.0000000
NODE_1016_length_2344_cov_6.236526	1208	1269	6	61	61	1.0000000
NODE_1016_length_2344_cov_6.236526	1208	1267	6	59	59	1.0000000
NODE_1023_length_2332_cov_4.725929	34	101	0	65	67	0.9701493
NODE_1023_length_2332_cov_4.725929	34	101	6	2	67	0.0298507
NODE_1027_length_2327_cov_18.210952	2213	2293	2	2	80	0.0250000
NODE_1027_length_2327_cov_18.210952	2213	2293	8	2	80	0.0250000
NODE_1027_length_2327_cov_18.210952	2213	2293	9	1	80	0.0125000
NODE_1027_length_2327_cov_18.210952	2213	2293	10	75	80	0.9375000
NODE_1027_length_2327_cov_18.210952	2266	2327	2	36	61	0.5901639
NODE_1027_length_2327_cov_18.210952	2266	2327	10	25	61	0.4098361
NODE_1028_length_2326_cov_15.583745	1709	1789	0	80	80	1.0000000
NODE_1028_length_2326_cov_15.583745	1762	1842	0	80	80	1.0000000
NODE_1030_length_2325_cov_14.998652	553	633	0	80	80	1.0000000
NODE_1030_length_2325_cov_14.998652	606	686	0	80	80	1.0000000
NODE_1034_length_2317_cov_11.956718	920	1000	0	53	80	0.6625000
NODE_1034_length_2317_cov_11.956718	920	1000	1	27	80	0.3375000
NODE_1034_length_2317_cov_11.956718	973	1053	1	80	80	1.0000000
NODE_1034_length_2317_cov_11.956718	1049	1129	0	6	80	0.0750000
NODE_1034_length_2317_cov_11.956718	1049	1129	1	74	80	0.9250000
NODE_1034_length_2317_cov_11.956718	1102	1184	0	56	82	0.6829268
NODE_1034_length_2317_cov_11.956718	1102	1184	1	26	82	0.3170732
NODE_1037_length_2316_cov_8.556608	168	247	108	2	79	0.0253165
NODE_1037_length_2316_cov_8.556608	168	247	110	3	79	0.0379747
NODE_1037_length_2316_cov_8.556608	168	247	112	1	79	0.0126582
NODE_1037_length_2316_cov_8.556608	168	247	114	2	79	0.0253165
NODE_1037_length_2316_cov_8.556608	168	247	115	3	79	0.0379747
NODE_1037_length_2316_cov_8.556608	168	247	116	2	79	0.0253165
NODE_1037_length_2316_cov_8.556608	168	247	117	4	79	0.0506329
NODE_1037_length_2316_cov_8.556608	168	247	119	1	79	0.0126582
NODE_1037_length_2316_cov_8.556608	168	247	121	3	79	0.0379747
NODE_1037_length_2316_cov_8.556608	168	247	123	3	79	0.0379747
NODE_1037_length_2316_cov_8.556608	168	247	125	2	79	0.0253165
NODE_1037_length_2316_cov_8.556608	168	247	129	2	79	0.0253165
NODE_1037_length_2316_cov_8.556608	168	247	133	1	79	0.0126582
NODE_1037_length_2316_cov_8.556608	168	247	135	3	79	0.0379747
NODE_1037_length_2316_cov_8.556608	168	247	136	1	79	0.0126582
NODE_1037_length_2316_cov_8.556608	168	247	137	6	79	0.0759494
NODE_1037_length_2316_cov_8.556608	168	247	138	4	79	0.0506329
NODE_1037_length_2316_cov_8.556608	168	247	139	4	79	0.0506329
NODE_1037_length_2316_cov_8.556608	168	247	140	2	79	0.0253165
NODE_1037_length_2316_cov_8.556608	168	247	142	1	79	0.0126582
NODE_1037_length_2316_cov_8.556608	168	247	144	2	79	0.0253165
NODE_1037_length_2316_cov_8.556608	168	247	146	5	79	0.0632911
NODE_1037_length_2316_cov_8.556608	168	247	147	2	79	0.0253165
NODE_1037_length_2316_cov_8.556608	168	247	150	2	79	0.0253165
NODE_1037_length_2316_cov_8.556608	168	247	151	2	79	0.0253165
NODE_1037_length_2316_cov_8.556608	168	247	152	1	79	0.0126582
NODE_1037_length_2316_cov_8.556608	168	247	153	8	79	0.1012658
NODE_1037_length_2316_cov_8.556608	168	247	157	7	79	0.0886076
NODE_1037_length_2316_cov_8.556608	1117	1198	26	3	81	0.0370370
NODE_1037_length_2316_cov_8.556608	1117	1198	27	8	81	0.0987654
NODE_1037_length_2316_cov_8.556608	1117	1198	28	1	81	0.0123457
NODE_1037_length_2316_cov_8.556608	1117	1198	29	7	81	0.0864198
NODE_1037_length_2316_cov_8.556608	1117	1198	30	4	81	0.0493827
NODE_1037_length_2316_cov_8.556608	1117	1198	31	20	81	0.2469136
NODE_1037_length_2316_cov_8.556608	1117	1198	32	5	81	0.0617284
NODE_1037_length_2316_cov_8.556608	1117	1198	34	2	81	0.0246914
NODE_1037_length_2316_cov_8.556608	1117	1198	35	1	81	0.0123457
NODE_1037_length_2316_cov_8.556608	1117	1198	36	25	81	0.3086420
NODE_1037_length_2316_cov_8.556608	1117	1198	38	5	81	0.0617284
NODE_1037_length_2316_cov_8.556608	1369	1412	118	5	43	0.1162791
NODE_1037_length_2316_cov_8.556608	1369	1412	124	2	43	0.0465116
NODE_1037_length_2316_cov_8.556608	1369	1412	128	3	43	0.0697674
NODE_1037_length_2316_cov_8.556608	1369	1412	133	2	43	0.0465116
NODE_1037_length_2316_cov_8.556608	1369	1412	135	1	43	0.0232558
NODE_1037_length_2316_cov_8.556608	1369	1412	137	1	43	0.0232558
NODE_1037_length_2316_cov_8.556608	1369	1412	139	4	43	0.0930233
NODE_1037_length_2316_cov_8.556608	1369	1412	143	1	43	0.0232558
NODE_1037_length_2316_cov_8.556608	1369	1412	145	6	43	0.1395349
NODE_1037_length_2316_cov_8.556608	1369	1412	147	1	43	0.0232558
NODE_1037_length_2316_cov_8.556608	1369	1412	149	1	43	0.0232558
NODE_1037_length_2316_cov_8.556608	1369	1412	151	2	43	0.0465116
NODE_1037_length_2316_cov_8.556608	1369	1412	159	2	43	0.0465116
NODE_1037_length_2316_cov_8.556608	1369	1412	161	2	43	0.0465116
NODE_1037_length_2316_cov_8.556608	1369	1412	165	2	43	0.0465116
NODE_1037_length_2316_cov_8.556608	1369	1412	166	1	43	0.0232558
NODE_1037_length_2316_cov_8.556608	1369	1412	168	1	43	0.0232558
NODE_1037_length_2316_cov_8.556608	1369	1412	183	2	43	0.0465116
NODE_1037_length_2316_cov_8.556608	1369	1412	185	1	43	0.0232558
NODE_1037_length_2316_cov_8.556608	1369	1412	191	2	43	0.0465116
NODE_1037_length_2316_cov_8.556608	1369	1412	193	1	43	0.0232558
NODE_1040_length_2311_cov_2.821881	2121	2201	0	33	80	0.4125000
NODE_1040_length_2311_cov_2.821881	2121	2201	4	47	80	0.5875000
NODE_1040_length_2311_cov_2.821881	2174	2225	4	51	51	1.0000000
NODE_1044_length_2306_cov_17.347984	995	1075	0	80	80	1.0000000
NODE_1044_length_2306_cov_17.347984	1048	1128	0	80	80	1.0000000
NODE_1052_length_2300_cov_9.803271	934	1014	0	80	80	1.0000000
NODE_1052_length_2300_cov_9.803271	1892	1965	0	73	73	1.0000000
NODE_1059_length_2289_cov_17.807306	968	1026	69	2	58	0.0344828
NODE_1059_length_2289_cov_17.807306	968	1026	71	7	58	0.1206897
NODE_1059_length_2289_cov_17.807306	968	1026	73	1	58	0.0172414
NODE_1059_length_2289_cov_17.807306	968	1026	75	2	58	0.0344828
NODE_1059_length_2289_cov_17.807306	968	1026	77	3	58	0.0517241
NODE_1059_length_2289_cov_17.807306	968	1026	78	2	58	0.0344828
NODE_1059_length_2289_cov_17.807306	968	1026	79	7	58	0.1206897
NODE_1059_length_2289_cov_17.807306	968	1026	81	7	58	0.1206897
NODE_1059_length_2289_cov_17.807306	968	1026	83	7	58	0.1206897
NODE_1059_length_2289_cov_17.807306	968	1026	84	2	58	0.0344828
NODE_1059_length_2289_cov_17.807306	968	1026	85	4	58	0.0689655
NODE_1059_length_2289_cov_17.807306	968	1026	86	2	58	0.0344828
NODE_1059_length_2289_cov_17.807306	968	1026	88	5	58	0.0862069
NODE_1059_length_2289_cov_17.807306	968	1026	89	2	58	0.0344828
NODE_1059_length_2289_cov_17.807306	968	1026	91	1	58	0.0172414
NODE_1059_length_2289_cov_17.807306	968	1026	92	3	58	0.0517241
NODE_1059_length_2289_cov_17.807306	968	1026	94	1	58	0.0172414
NODE_1059_length_2289_cov_17.807306	1021	1079	46	5	58	0.0862069
NODE_1059_length_2289_cov_17.807306	1021	1079	48	8	58	0.1379310
NODE_1059_length_2289_cov_17.807306	1021	1079	49	2	58	0.0344828
NODE_1059_length_2289_cov_17.807306	1021	1079	51	5	58	0.0862069
NODE_1059_length_2289_cov_17.807306	1021	1079	53	3	58	0.0517241
NODE_1059_length_2289_cov_17.807306	1021	1079	57	1	58	0.0172414
NODE_1059_length_2289_cov_17.807306	1021	1079	63	5	58	0.0862069
NODE_1059_length_2289_cov_17.807306	1021	1079	65	8	58	0.1379310
NODE_1059_length_2289_cov_17.807306	1021	1079	66	6	58	0.1034483
NODE_1059_length_2289_cov_17.807306	1021	1079	67	3	58	0.0517241
NODE_1059_length_2289_cov_17.807306	1021	1079	69	4	58	0.0689655
NODE_1059_length_2289_cov_17.807306	1021	1079	70	2	58	0.0344828
NODE_1059_length_2289_cov_17.807306	1021	1079	71	3	58	0.0517241
NODE_1059_length_2289_cov_17.807306	1021	1079	72	3	58	0.0517241
NODE_1060_length_2289_cov_7.736986	2161	2218	82	1	57	0.0175439
NODE_1060_length_2289_cov_7.736986	2161	2218	98	2	57	0.0350877
NODE_1060_length_2289_cov_7.736986	2161	2218	104	2	57	0.0350877
NODE_1060_length_2289_cov_7.736986	2161	2218	109	1	57	0.0175439
NODE_1060_length_2289_cov_7.736986	2161	2218	110	1	57	0.0175439
NODE_1060_length_2289_cov_7.736986	2161	2218	116	1	57	0.0175439
NODE_1060_length_2289_cov_7.736986	2161	2218	122	1	57	0.0175439
NODE_1060_length_2289_cov_7.736986	2161	2218	126	1	57	0.0175439
NODE_1060_length_2289_cov_7.736986	2161	2218	132	2	57	0.0350877
NODE_1060_length_2289_cov_7.736986	2161	2218	136	1	57	0.0175439
NODE_1060_length_2289_cov_7.736986	2161	2218	138	6	57	0.1052632
NODE_1060_length_2289_cov_7.736986	2161	2218	146	1	57	0.0175439
NODE_1060_length_2289_cov_7.736986	2161	2218	156	3	57	0.0526316
NODE_1060_length_2289_cov_7.736986	2161	2218	158	2	57	0.0350877
NODE_1060_length_2289_cov_7.736986	2161	2218	166	32	57	0.5614035
NODE_1060_length_2289_cov_7.736986	2191	2271	112	2	80	0.0250000
NODE_1060_length_2289_cov_7.736986	2191	2271	114	1	80	0.0125000
NODE_1060_length_2289_cov_7.736986	2191	2271	130	1	80	0.0125000
NODE_1060_length_2289_cov_7.736986	2191	2271	134	1	80	0.0125000
NODE_1060_length_2289_cov_7.736986	2191	2271	150	3	80	0.0375000
NODE_1060_length_2289_cov_7.736986	2191	2271	154	1	80	0.0125000
NODE_1060_length_2289_cov_7.736986	2191	2271	158	1	80	0.0125000
NODE_1060_length_2289_cov_7.736986	2191	2271	160	1	80	0.0125000
NODE_1060_length_2289_cov_7.736986	2191	2271	162	3	80	0.0375000
NODE_1060_length_2289_cov_7.736986	2191	2271	166	66	80	0.8250000
NODE_1061_length_2288_cov_8.539973	340	420	0	53	80	0.6625000
NODE_1061_length_2288_cov_8.539973	340	420	6	25	80	0.3125000
NODE_1061_length_2288_cov_8.539973	340	420	8	2	80	0.0250000
NODE_1061_length_2288_cov_8.539973	393	473	0	80	80	1.0000000
NODE_1065_length_2278_cov_19.655805	450	530	0	80	80	1.0000000
NODE_1065_length_2278_cov_19.655805	503	583	0	80	80	1.0000000
NODE_1065_length_2278_cov_19.655805	579	659	0	27	80	0.3375000
NODE_1065_length_2278_cov_19.655805	579	659	8	53	80	0.6625000
NODE_1065_length_2278_cov_19.655805	632	712	0	24	80	0.3000000
NODE_1065_length_2278_cov_19.655805	632	712	8	56	80	0.7000000
NODE_1071_length_2272_cov_26.123792	226	306	0	80	80	1.0000000
NODE_1071_length_2272_cov_26.123792	279	359	0	80	80	1.0000000
NODE_1071_length_2272_cov_26.123792	1684	1731	20	2	47	0.0425532
NODE_1071_length_2272_cov_26.123792	1684	1731	32	1	47	0.0212766
NODE_1071_length_2272_cov_26.123792	1684	1731	47	1	47	0.0212766
NODE_1071_length_2272_cov_26.123792	1684	1731	71	1	47	0.0212766
NODE_1071_length_2272_cov_26.123792	1684	1731	73	1	47	0.0212766
NODE_1071_length_2272_cov_26.123792	1684	1731	82	1	47	0.0212766
NODE_1071_length_2272_cov_26.123792	1684	1731	84	2	47	0.0425532
NODE_1071_length_2272_cov_26.123792	1684	1731	86	1	47	0.0212766
NODE_1071_length_2272_cov_26.123792	1684	1731	87	2	47	0.0425532
NODE_1071_length_2272_cov_26.123792	1684	1731	93	1	47	0.0212766
NODE_1071_length_2272_cov_26.123792	1684	1731	96	1	47	0.0212766
NODE_1071_length_2272_cov_26.123792	1684	1731	97	2	47	0.0425532
NODE_1071_length_2272_cov_26.123792	1684	1731	100	1	47	0.0212766
NODE_1071_length_2272_cov_26.123792	1684	1731	108	2	47	0.0425532
NODE_1071_length_2272_cov_26.123792	1684	1731	110	1	47	0.0212766
NODE_1071_length_2272_cov_26.123792	1684	1731	112	1	47	0.0212766
NODE_1071_length_2272_cov_26.123792	1684	1731	114	1	47	0.0212766
NODE_1071_length_2272_cov_26.123792	1684	1731	121	1	47	0.0212766
NODE_1071_length_2272_cov_26.123792	1684	1731	123	2	47	0.0425532
NODE_1071_length_2272_cov_26.123792	1684	1731	126	1	47	0.0212766
NODE_1071_length_2272_cov_26.123792	1684	1731	128	1	47	0.0212766
NODE_1071_length_2272_cov_26.123792	1684	1731	131	1	47	0.0212766
NODE_1071_length_2272_cov_26.123792	1684	1731	139	1	47	0.0212766
NODE_1071_length_2272_cov_26.123792	1684	1731	143	1	47	0.0212766
NODE_1071_length_2272_cov_26.123792	1684	1731	145	1	47	0.0212766
NODE_1071_length_2272_cov_26.123792	1684	1731	150	1	47	0.0212766
NODE_1071_length_2272_cov_26.123792	1684	1731	152	1	47	0.0212766
NODE_1071_length_2272_cov_26.123792	1684	1731	153	1	47	0.0212766
NODE_1071_length_2272_cov_26.123792	1684	1731	157	1	47	0.0212766
NODE_1071_length_2272_cov_26.123792	1684	1731	160	1	47	0.0212766
NODE_1071_length_2272_cov_26.123792	1684	1731	168	1	47	0.0212766
NODE_1071_length_2272_cov_26.123792	1684	1731	176	2	47	0.0425532
NODE_1071_length_2272_cov_26.123792	1684	1731	184	2	47	0.0425532
NODE_1071_length_2272_cov_26.123792	1684	1731	192	1	47	0.0212766
NODE_1071_length_2272_cov_26.123792	1684	1731	201	1	47	0.0212766
NODE_1071_length_2272_cov_26.123792	1684	1731	203	1	47	0.0212766
NODE_1071_length_2272_cov_26.123792	1684	1731	209	1	47	0.0212766
NODE_1071_length_2272_cov_26.123792	1684	1731	212	1	47	0.0212766
NODE_1071_length_2272_cov_26.123792	1684	1731	213	1	47	0.0212766
NODE_1071_length_2272_cov_26.123792	1694	1725	82	1	31	0.0322581
NODE_1071_length_2272_cov_26.123792	1694	1725	84	2	31	0.0645161
NODE_1071_length_2272_cov_26.123792	1694	1725	86	1	31	0.0322581
NODE_1071_length_2272_cov_26.123792	1694	1725	87	2	31	0.0645161
NODE_1071_length_2272_cov_26.123792	1694	1725	93	1	31	0.0322581
NODE_1071_length_2272_cov_26.123792	1694	1725	96	1	31	0.0322581
NODE_1071_length_2272_cov_26.123792	1694	1725	97	2	31	0.0645161
NODE_1071_length_2272_cov_26.123792	1694	1725	100	1	31	0.0322581
NODE_1071_length_2272_cov_26.123792	1694	1725	108	2	31	0.0645161
NODE_1071_length_2272_cov_26.123792	1694	1725	110	1	31	0.0322581
NODE_1071_length_2272_cov_26.123792	1694	1725	112	1	31	0.0322581
NODE_1071_length_2272_cov_26.123792	1694	1725	114	1	31	0.0322581
NODE_1071_length_2272_cov_26.123792	1694	1725	121	1	31	0.0322581
NODE_1071_length_2272_cov_26.123792	1694	1725	123	2	31	0.0645161
NODE_1071_length_2272_cov_26.123792	1694	1725	126	1	31	0.0322581
NODE_1071_length_2272_cov_26.123792	1694	1725	128	1	31	0.0322581
NODE_1071_length_2272_cov_26.123792	1694	1725	131	1	31	0.0322581
NODE_1071_length_2272_cov_26.123792	1694	1725	139	1	31	0.0322581
NODE_1071_length_2272_cov_26.123792	1694	1725	143	1	31	0.0322581
NODE_1071_length_2272_cov_26.123792	1694	1725	145	1	31	0.0322581
NODE_1071_length_2272_cov_26.123792	1694	1725	150	1	31	0.0322581
NODE_1071_length_2272_cov_26.123792	1694	1725	152	1	31	0.0322581
NODE_1071_length_2272_cov_26.123792	1694	1725	153	1	31	0.0322581
NODE_1071_length_2272_cov_26.123792	1694	1725	157	1	31	0.0322581
NODE_1071_length_2272_cov_26.123792	1694	1725	160	1	31	0.0322581
NODE_1071_length_2272_cov_26.123792	1694	1725	168	1	31	0.0322581
NODE_1071_length_2272_cov_26.123792	1759	1833	0	74	74	1.0000000
NODE_1071_length_2272_cov_26.123792	1812	1892	0	80	80	1.0000000
NODE_1072_length_2272_cov_8.175334	213	293	43	5	80	0.0625000
NODE_1072_length_2272_cov_8.175334	213	293	44	6	80	0.0750000
NODE_1072_length_2272_cov_8.175334	213	293	45	9	80	0.1125000
NODE_1072_length_2272_cov_8.175334	213	293	46	7	80	0.0875000
NODE_1072_length_2272_cov_8.175334	213	293	47	2	80	0.0250000
NODE_1072_length_2272_cov_8.175334	213	293	48	5	80	0.0625000
NODE_1072_length_2272_cov_8.175334	213	293	49	2	80	0.0250000
NODE_1072_length_2272_cov_8.175334	213	293	50	5	80	0.0625000
NODE_1072_length_2272_cov_8.175334	213	293	51	1	80	0.0125000
NODE_1072_length_2272_cov_8.175334	213	293	52	3	80	0.0375000
NODE_1072_length_2272_cov_8.175334	213	293	53	3	80	0.0375000
NODE_1072_length_2272_cov_8.175334	213	293	56	1	80	0.0125000
NODE_1072_length_2272_cov_8.175334	213	293	59	13	80	0.1625000
NODE_1072_length_2272_cov_8.175334	213	293	61	13	80	0.1625000
NODE_1072_length_2272_cov_8.175334	213	293	65	5	80	0.0625000
NODE_1072_length_2272_cov_8.175334	266	346	6	2	80	0.0250000
NODE_1072_length_2272_cov_8.175334	266	346	18	5	80	0.0625000
NODE_1072_length_2272_cov_8.175334	266	346	22	3	80	0.0375000
NODE_1072_length_2272_cov_8.175334	266	346	26	5	80	0.0625000
NODE_1072_length_2272_cov_8.175334	266	346	28	6	80	0.0750000
NODE_1072_length_2272_cov_8.175334	266	346	29	2	80	0.0250000
NODE_1072_length_2272_cov_8.175334	266	346	30	9	80	0.1125000
NODE_1072_length_2272_cov_8.175334	266	346	34	2	80	0.0250000
NODE_1072_length_2272_cov_8.175334	266	346	35	1	80	0.0125000
NODE_1072_length_2272_cov_8.175334	266	346	39	6	80	0.0750000
NODE_1072_length_2272_cov_8.175334	266	346	41	7	80	0.0875000
NODE_1072_length_2272_cov_8.175334	266	346	42	2	80	0.0250000
NODE_1072_length_2272_cov_8.175334	266	346	44	9	80	0.1125000
NODE_1072_length_2272_cov_8.175334	266	346	46	7	80	0.0875000
NODE_1072_length_2272_cov_8.175334	266	346	48	5	80	0.0625000
NODE_1072_length_2272_cov_8.175334	266	346	50	5	80	0.0625000
NODE_1072_length_2272_cov_8.175334	266	346	52	3	80	0.0375000
NODE_1072_length_2272_cov_8.175334	266	346	56	1	80	0.0125000
NODE_1077_length_2266_cov_13.206276	359	439	0	30	80	0.3750000
NODE_1077_length_2266_cov_13.206276	359	439	2	48	80	0.6000000
NODE_1077_length_2266_cov_13.206276	359	439	4	2	80	0.0250000
NODE_1077_length_2266_cov_13.206276	412	492	0	39	80	0.4875000
NODE_1077_length_2266_cov_13.206276	412	492	3	29	80	0.3625000
NODE_1077_length_2266_cov_13.206276	412	492	5	12	80	0.1500000
NODE_1077_length_2266_cov_13.206276	488	568	4	2	80	0.0250000
NODE_1077_length_2266_cov_13.206276	488	568	5	28	80	0.3500000
NODE_1077_length_2266_cov_13.206276	488	568	6	33	80	0.4125000
NODE_1077_length_2266_cov_13.206276	488	568	8	1	80	0.0125000
NODE_1077_length_2266_cov_13.206276	488	568	10	16	80	0.2000000
NODE_1077_length_2266_cov_13.206276	541	627	2	21	86	0.2441860
NODE_1077_length_2266_cov_13.206276	541	627	4	33	86	0.3837209
NODE_1077_length_2266_cov_13.206276	541	627	6	24	86	0.2790698
NODE_1077_length_2266_cov_13.206276	541	627	10	8	86	0.0930233
NODE_1078_length_2262_cov_11.759131	413	493	0	80	80	1.0000000
NODE_1078_length_2262_cov_11.759131	466	546	0	80	80	1.0000000
NODE_1079_length_2260_cov_37.814901	219	299	0	80	80	1.0000000
NODE_1079_length_2260_cov_37.814901	742	822	0	12	80	0.1500000
NODE_1079_length_2260_cov_37.814901	742	822	2	68	80	0.8500000
NODE_1079_length_2260_cov_37.814901	795	875	0	65	80	0.8125000
NODE_1079_length_2260_cov_37.814901	795	875	2	15	80	0.1875000
NODE_1079_length_2260_cov_37.814901	1533	1613	6	6	80	0.0750000
NODE_1079_length_2260_cov_37.814901	1533	1613	8	74	80	0.9250000
NODE_1079_length_2260_cov_37.814901	1586	1666	0	48	80	0.6000000
NODE_1079_length_2260_cov_37.814901	1586	1666	2	4	80	0.0500000
NODE_1079_length_2260_cov_37.814901	1586	1666	8	28	80	0.3500000
NODE_1079_length_2260_cov_37.814901	1662	1742	0	80	80	1.0000000
NODE_1079_length_2260_cov_37.814901	1715	1795	0	80	80	1.0000000
NODE_1082_length_2253_cov_8.904828	472	552	13	1	80	0.0125000
NODE_1082_length_2253_cov_8.904828	472	552	14	21	80	0.2625000
NODE_1082_length_2253_cov_8.904828	472	552	16	8	80	0.1000000
NODE_1082_length_2253_cov_8.904828	472	552	18	30	80	0.3750000
NODE_1082_length_2253_cov_8.904828	472	552	20	6	80	0.0750000
NODE_1082_length_2253_cov_8.904828	472	552	22	7	80	0.0875000
NODE_1082_length_2253_cov_8.904828	472	552	24	7	80	0.0875000
NODE_1085_length_2252_cov_2.801208	1128	1170	0	3	42	0.0714286
NODE_1085_length_2252_cov_2.801208	1128	1170	2	25	42	0.5952381
NODE_1085_length_2252_cov_2.801208	1128	1170	4	14	42	0.3333333
NODE_1085_length_2252_cov_2.801208	1137	1172	2	19	35	0.5428572
NODE_1085_length_2252_cov_2.801208	1137	1172	4	16	35	0.4571429
NODE_1086_length_2252_cov_2.078031	13	62	0	49	49	1.0000000
NODE_1086_length_2252_cov_2.078031	13	61	0	48	48	1.0000000
NODE_1086_length_2252_cov_2.078031	13	62	0	49	49	1.0000000
NODE_1086_length_2252_cov_2.078031	13	62	0	49	49	1.0000000
NODE_1086_length_2252_cov_2.078031	13	61	0	48	48	1.0000000
NODE_1087_length_2251_cov_15.458178	1443	1506	0	62	63	0.9841270
NODE_1087_length_2251_cov_15.458178	1443	1506	4	1	63	0.0158730
NODE_1087_length_2251_cov_15.458178	1496	1550	0	23	54	0.4259259
NODE_1087_length_2251_cov_15.458178	1496	1550	2	1	54	0.0185185
NODE_1087_length_2251_cov_15.458178	1496	1550	3	3	54	0.0555556
NODE_1087_length_2251_cov_15.458178	1496	1550	5	1	54	0.0185185
NODE_1087_length_2251_cov_15.458178	1496	1550	7	2	54	0.0370370
NODE_1087_length_2251_cov_15.458178	1496	1550	9	1	54	0.0185185
NODE_1087_length_2251_cov_15.458178	1496	1550	11	1	54	0.0185185
NODE_1087_length_2251_cov_15.458178	1496	1550	12	3	54	0.0555556
NODE_1087_length_2251_cov_15.458178	1496	1550	13	3	54	0.0555556
NODE_1087_length_2251_cov_15.458178	1496	1550	14	9	54	0.1666667
NODE_1087_length_2251_cov_15.458178	1496	1550	16	3	54	0.0555556
NODE_1087_length_2251_cov_15.458178	1496	1550	22	1	54	0.0185185
NODE_1087_length_2251_cov_15.458178	1496	1550	24	2	54	0.0370370
NODE_1087_length_2251_cov_15.458178	1496	1550	30	1	54	0.0185185
NODE_1089_length_2250_cov_18.370990	1658	1738	0	16	80	0.2000000
NODE_1089_length_2250_cov_18.370990	1658	1738	8	64	80	0.8000000
NODE_1089_length_2250_cov_18.370990	1711	1791	0	7	80	0.0875000
NODE_1089_length_2250_cov_18.370990	1711	1791	7	1	80	0.0125000
NODE_1089_length_2250_cov_18.370990	1711	1791	8	72	80	0.9000000
NODE_1090_length_2250_cov_5.331474	1844	1924	0	72	80	0.9000000
NODE_1090_length_2250_cov_5.331474	1844	1924	2	8	80	0.1000000
NODE_1093_length_2247_cov_7.906890	364	436	0	72	72	1.0000000
NODE_1095_length_2246_cov_7.612948	1992	2055	6	19	63	0.3015873
NODE_1095_length_2246_cov_7.612948	1992	2055	7	12	63	0.1904762
NODE_1095_length_2246_cov_7.612948	1992	2055	8	21	63	0.3333333
NODE_1095_length_2246_cov_7.612948	1992	2055	9	6	63	0.0952381
NODE_1095_length_2246_cov_7.612948	1992	2055	10	5	63	0.0793651
NODE_1095_length_2246_cov_7.612948	2045	2108	4	3	63	0.0476190
NODE_1095_length_2246_cov_7.612948	2045	2108	7	6	63	0.0952381
NODE_1095_length_2246_cov_7.612948	2045	2108	9	39	63	0.6190476
NODE_1095_length_2246_cov_7.612948	2045	2108	10	15	63	0.2380952
NODE_1104_length_2233_cov_35.127460	1517	1597	0	47	80	0.5875000
NODE_1104_length_2233_cov_35.127460	1517	1597	3	1	80	0.0125000
NODE_1104_length_2233_cov_35.127460	1517	1597	4	32	80	0.4000000
NODE_1104_length_2233_cov_35.127460	1570	1650	4	80	80	1.0000000
NODE_1105_length_2231_cov_45.701689	315	396	2	18	81	0.2222222
NODE_1105_length_2231_cov_45.701689	315	396	4	3	81	0.0370370
NODE_1105_length_2231_cov_45.701689	315	396	6	1	81	0.0123457
NODE_1105_length_2231_cov_45.701689	315	396	8	57	81	0.7037037
NODE_1105_length_2231_cov_45.701689	315	396	10	2	81	0.0246914
NODE_1105_length_2231_cov_45.701689	369	449	0	51	80	0.6375000
NODE_1105_length_2231_cov_45.701689	369	449	2	20	80	0.2500000
NODE_1105_length_2231_cov_45.701689	369	449	4	3	80	0.0375000
NODE_1105_length_2231_cov_45.701689	369	449	6	1	80	0.0125000
NODE_1105_length_2231_cov_45.701689	369	449	8	5	80	0.0625000
NODE_1105_length_2231_cov_45.701689	496	576	0	80	80	1.0000000
NODE_1105_length_2231_cov_45.701689	582	662	0	80	80	1.0000000
NODE_1105_length_2231_cov_45.701689	625	705	0	80	80	1.0000000
NODE_1105_length_2231_cov_45.701689	711	791	0	80	80	1.0000000
NODE_1105_length_2231_cov_45.701689	1141	1186	12	6	45	0.1333333
NODE_1105_length_2231_cov_45.701689	1141	1186	14	1	45	0.0222222
NODE_1105_length_2231_cov_45.701689	1141	1186	18	6	45	0.1333333
NODE_1105_length_2231_cov_45.701689	1141	1186	20	2	45	0.0444444
NODE_1105_length_2231_cov_45.701689	1141	1186	22	6	45	0.1333333
NODE_1105_length_2231_cov_45.701689	1141	1186	26	24	45	0.5333334
NODE_1105_length_2231_cov_45.701689	1787	1867	0	80	80	1.0000000
NODE_1105_length_2231_cov_45.701689	1840	1920	0	80	80	1.0000000
NODE_1106_length_2230_cov_12.608634	1520	1600	0	80	80	1.0000000
NODE_1106_length_2230_cov_12.608634	1573	1653	0	80	80	1.0000000
NODE_1112_length_2218_cov_5.292591	1427	1497	2	42	70	0.6000000
NODE_1112_length_2218_cov_5.292591	1427	1497	4	28	70	0.4000000
NODE_1112_length_2218_cov_5.292591	1470	1536	4	54	66	0.8181818
NODE_1112_length_2218_cov_5.292591	1470	1536	10	12	66	0.1818182
NODE_1115_length_2215_cov_51.865784	108	188	0	80	80	1.0000000
NODE_1115_length_2215_cov_51.865784	161	241	0	80	80	1.0000000
NODE_1115_length_2215_cov_51.865784	237	317	0	80	80	1.0000000
NODE_1115_length_2215_cov_51.865784	290	370	0	80	80	1.0000000
NODE_1115_length_2215_cov_51.865784	1030	1102	8	1	72	0.0138889
NODE_1115_length_2215_cov_51.865784	1030	1102	14	6	72	0.0833333
NODE_1115_length_2215_cov_51.865784	1030	1102	16	23	72	0.3194444
NODE_1115_length_2215_cov_51.865784	1030	1102	18	11	72	0.1527778
NODE_1115_length_2215_cov_51.865784	1030	1102	20	2	72	0.0277778
NODE_1115_length_2215_cov_51.865784	1030	1102	28	2	72	0.0277778
NODE_1115_length_2215_cov_51.865784	1030	1102	29	3	72	0.0416667
NODE_1115_length_2215_cov_51.865784	1030	1102	30	1	72	0.0138889
NODE_1115_length_2215_cov_51.865784	1030	1102	32	1	72	0.0138889
NODE_1115_length_2215_cov_51.865784	1030	1102	34	3	72	0.0416667
NODE_1115_length_2215_cov_51.865784	1030	1102	36	9	72	0.1250000
NODE_1115_length_2215_cov_51.865784	1030	1102	37	3	72	0.0416667
NODE_1115_length_2215_cov_51.865784	1030	1102	39	5	72	0.0694444
NODE_1115_length_2215_cov_51.865784	1030	1102	43	2	72	0.0277778
NODE_1115_length_2215_cov_51.865784	1571	1651	0	80	80	1.0000000
NODE_1115_length_2215_cov_51.865784	1624	1704	0	80	80	1.0000000
NODE_1117_length_2212_cov_63.988168	459	539	0	11	80	0.1375000
NODE_1117_length_2212_cov_63.988168	459	539	2	69	80	0.8625000
NODE_1117_length_2212_cov_63.988168	512	592	0	54	80	0.6750000
NODE_1117_length_2212_cov_63.988168	512	592	2	26	80	0.3250000
NODE_1117_length_2212_cov_63.988168	588	668	0	80	80	1.0000000
NODE_1117_length_2212_cov_63.988168	641	721	0	40	80	0.5000000
NODE_1117_length_2212_cov_63.988168	641	721	2	40	80	0.5000000
NODE_1119_length_2212_cov_4.632750	1479	1559	0	80	80	1.0000000
NODE_1119_length_2212_cov_4.632750	1532	1612	0	80	80	1.0000000
NODE_1122_length_2211_cov_16.247159	1808	1888	0	49	80	0.6125000
NODE_1122_length_2211_cov_16.247159	1808	1888	2	31	80	0.3875000
NODE_1124_length_2207_cov_46.766129	1273	1348	112	1	75	0.0133333
NODE_1124_length_2207_cov_46.766129	1273	1348	114	1	75	0.0133333
NODE_1124_length_2207_cov_46.766129	1273	1348	115	1	75	0.0133333
NODE_1124_length_2207_cov_46.766129	1273	1348	117	2	75	0.0266667
NODE_1124_length_2207_cov_46.766129	1273	1348	119	3	75	0.0400000
NODE_1124_length_2207_cov_46.766129	1273	1348	121	1	75	0.0133333
NODE_1124_length_2207_cov_46.766129	1273	1348	124	2	75	0.0266667
NODE_1124_length_2207_cov_46.766129	1273	1348	126	3	75	0.0400000
NODE_1124_length_2207_cov_46.766129	1273	1348	127	2	75	0.0266667
NODE_1124_length_2207_cov_46.766129	1273	1348	128	4	75	0.0533333
NODE_1124_length_2207_cov_46.766129	1273	1348	129	2	75	0.0266667
NODE_1124_length_2207_cov_46.766129	1273	1348	130	1	75	0.0133333
NODE_1124_length_2207_cov_46.766129	1273	1348	139	1	75	0.0133333
NODE_1124_length_2207_cov_46.766129	1273	1348	140	1	75	0.0133333
NODE_1124_length_2207_cov_46.766129	1273	1348	141	1	75	0.0133333
NODE_1124_length_2207_cov_46.766129	1273	1348	144	1	75	0.0133333
NODE_1124_length_2207_cov_46.766129	1273	1348	147	5	75	0.0666667
NODE_1124_length_2207_cov_46.766129	1273	1348	149	1	75	0.0133333
NODE_1124_length_2207_cov_46.766129	1273	1348	151	2	75	0.0266667
NODE_1124_length_2207_cov_46.766129	1273	1348	154	2	75	0.0266667
NODE_1124_length_2207_cov_46.766129	1273	1348	157	1	75	0.0133333
NODE_1124_length_2207_cov_46.766129	1273	1348	159	1	75	0.0133333
NODE_1124_length_2207_cov_46.766129	1273	1348	161	2	75	0.0266667
NODE_1124_length_2207_cov_46.766129	1273	1348	162	3	75	0.0400000
NODE_1124_length_2207_cov_46.766129	1273	1348	163	8	75	0.1066667
NODE_1124_length_2207_cov_46.766129	1273	1348	165	3	75	0.0400000
NODE_1124_length_2207_cov_46.766129	1273	1348	166	5	75	0.0666667
NODE_1124_length_2207_cov_46.766129	1273	1348	167	3	75	0.0400000
NODE_1124_length_2207_cov_46.766129	1273	1348	168	1	75	0.0133333
NODE_1124_length_2207_cov_46.766129	1273	1348	169	1	75	0.0133333
NODE_1124_length_2207_cov_46.766129	1273	1348	170	4	75	0.0533333
NODE_1124_length_2207_cov_46.766129	1273	1348	172	2	75	0.0266667
NODE_1124_length_2207_cov_46.766129	1273	1348	174	3	75	0.0400000
NODE_1124_length_2207_cov_46.766129	1273	1348	176	1	75	0.0133333
NODE_1124_length_2207_cov_46.766129	1324	1401	58	1	77	0.0129870
NODE_1124_length_2207_cov_46.766129	1324	1401	59	1	77	0.0129870
NODE_1124_length_2207_cov_46.766129	1324	1401	61	1	77	0.0129870
NODE_1124_length_2207_cov_46.766129	1324	1401	62	3	77	0.0389610
NODE_1124_length_2207_cov_46.766129	1324	1401	63	1	77	0.0129870
NODE_1124_length_2207_cov_46.766129	1324	1401	65	3	77	0.0389610
NODE_1124_length_2207_cov_46.766129	1324	1401	67	1	77	0.0129870
NODE_1124_length_2207_cov_46.766129	1324	1401	69	5	77	0.0649351
NODE_1124_length_2207_cov_46.766129	1324	1401	71	5	77	0.0649351
NODE_1124_length_2207_cov_46.766129	1324	1401	72	1	77	0.0129870
NODE_1124_length_2207_cov_46.766129	1324	1401	74	3	77	0.0389610
NODE_1124_length_2207_cov_46.766129	1324	1401	76	4	77	0.0519481
NODE_1124_length_2207_cov_46.766129	1324	1401	82	1	77	0.0129870
NODE_1124_length_2207_cov_46.766129	1324	1401	84	3	77	0.0389610
NODE_1124_length_2207_cov_46.766129	1324	1401	91	2	77	0.0259740
NODE_1124_length_2207_cov_46.766129	1324	1401	95	2	77	0.0259740
NODE_1124_length_2207_cov_46.766129	1324	1401	97	3	77	0.0389610
NODE_1124_length_2207_cov_46.766129	1324	1401	99	3	77	0.0389610
NODE_1124_length_2207_cov_46.766129	1324	1401	100	4	77	0.0519481
NODE_1124_length_2207_cov_46.766129	1324	1401	102	1	77	0.0129870
NODE_1124_length_2207_cov_46.766129	1324	1401	106	2	77	0.0259740
NODE_1124_length_2207_cov_46.766129	1324	1401	110	2	77	0.0259740
NODE_1124_length_2207_cov_46.766129	1324	1401	112	2	77	0.0259740
NODE_1124_length_2207_cov_46.766129	1324	1401	114	1	77	0.0129870
NODE_1124_length_2207_cov_46.766129	1324	1401	115	1	77	0.0129870
NODE_1124_length_2207_cov_46.766129	1324	1401	117	2	77	0.0259740
NODE_1124_length_2207_cov_46.766129	1324	1401	119	3	77	0.0389610
NODE_1124_length_2207_cov_46.766129	1324	1401	121	1	77	0.0129870
NODE_1124_length_2207_cov_46.766129	1324	1401	124	2	77	0.0259740
NODE_1124_length_2207_cov_46.766129	1324	1401	126	3	77	0.0389610
NODE_1124_length_2207_cov_46.766129	1324	1401	127	2	77	0.0259740
NODE_1124_length_2207_cov_46.766129	1324	1401	128	4	77	0.0519481
NODE_1124_length_2207_cov_46.766129	1324	1401	129	2	77	0.0259740
NODE_1124_length_2207_cov_46.766129	1324	1401	130	1	77	0.0129870
NODE_1124_length_2207_cov_46.766129	1324	1401	139	1	77	0.0129870
NODE_1127_length_2205_cov_12.762108	1818	1898	0	80	80	1.0000000
NODE_1127_length_2205_cov_12.762108	1871	1951	0	80	80	1.0000000
NODE_1127_length_2205_cov_12.762108	1872	1951	0	79	79	1.0000000
NODE_1127_length_2205_cov_12.762108	1947	2020	0	73	73	1.0000000
NODE_1128_length_2202_cov_8.687114	1848	1912	0	64	64	1.0000000
NODE_1130_length_2200_cov_10.639695	1461	1541	0	80	80	1.0000000
NODE_1130_length_2200_cov_10.639695	1514	1594	0	80	80	1.0000000
NODE_1131_length_2199_cov_10.839524	1709	1789	0	80	80	1.0000000
NODE_1131_length_2199_cov_10.839524	1762	1842	0	80	80	1.0000000
NODE_1135_length_2196_cov_64.718646	885	965	0	16	80	0.2000000
NODE_1135_length_2196_cov_64.718646	885	965	4	64	80	0.8000000
NODE_1135_length_2196_cov_64.718646	938	1018	0	50	80	0.6250000
NODE_1135_length_2196_cov_64.718646	938	1018	4	30	80	0.3750000
NODE_1138_length_2195_cov_8.443225	114	136	0	22	22	1.0000000
NODE_1139_length_2195_cov_6.113550	1245	1330	0	85	85	1.0000000
NODE_1139_length_2195_cov_6.113550	1306	1352	0	46	46	1.0000000
NODE_1141_length_2194_cov_1.366587	15	77	0	62	62	1.0000000
NODE_1142_length_2193_cov_8.320917	374	454	0	80	80	1.0000000
NODE_1142_length_2193_cov_8.320917	427	502	0	75	75	1.0000000
NODE_1146_length_2189_cov_36.884689	383	463	0	80	80	1.0000000
NODE_1146_length_2189_cov_36.884689	436	516	0	80	80	1.0000000
NODE_1146_length_2189_cov_36.884689	1257	1337	0	80	80	1.0000000
NODE_1146_length_2189_cov_36.884689	1310	1390	0	80	80	1.0000000
NODE_1146_length_2189_cov_36.884689	1427	1507	0	80	80	1.0000000
NODE_1146_length_2189_cov_36.884689	1480	1560	0	80	80	1.0000000
NODE_1152_length_2184_cov_9.464748	1536	1616	8	80	80	1.0000000
NODE_1152_length_2184_cov_9.464748	1589	1669	0	5	80	0.0625000
NODE_1152_length_2184_cov_9.464748	1589	1669	3	3	80	0.0375000
NODE_1152_length_2184_cov_9.464748	1589	1669	4	43	80	0.5375000
NODE_1152_length_2184_cov_9.464748	1589	1669	8	29	80	0.3625000
NODE_1154_length_2183_cov_45.471209	1632	1712	2	48	80	0.6000000
NODE_1154_length_2183_cov_45.471209	1632	1712	4	32	80	0.4000000
NODE_1154_length_2183_cov_45.471209	1685	1765	0	32	80	0.4000000
NODE_1154_length_2183_cov_45.471209	1685	1765	2	48	80	0.6000000
NODE_1159_length_2176_cov_47.338950	0	52	0	52	52	1.0000000
NODE_1162_length_2174_cov_40.560964	1638	1718	0	80	80	1.0000000
NODE_1162_length_2174_cov_40.560964	1691	1771	0	80	80	1.0000000
NODE_1163_length_2174_cov_35.399518	284	364	0	51	80	0.6375000
NODE_1163_length_2174_cov_35.399518	284	364	2	29	80	0.3625000
NODE_1163_length_2174_cov_35.399518	337	414	0	48	77	0.6233766
NODE_1163_length_2174_cov_35.399518	337	414	1	8	77	0.1038961
NODE_1163_length_2174_cov_35.399518	337	414	2	8	77	0.1038961
NODE_1163_length_2174_cov_35.399518	337	414	4	13	77	0.1688312
NODE_1163_length_2174_cov_35.399518	1542	1620	112	1	78	0.0128205
NODE_1163_length_2174_cov_35.399518	1542	1620	114	2	78	0.0256410
NODE_1163_length_2174_cov_35.399518	1542	1620	116	2	78	0.0256410
NODE_1163_length_2174_cov_35.399518	1542	1620	118	3	78	0.0384615
NODE_1163_length_2174_cov_35.399518	1542	1620	119	7	78	0.0897436
NODE_1163_length_2174_cov_35.399518	1542	1620	120	5	78	0.0641026
NODE_1163_length_2174_cov_35.399518	1542	1620	121	3	78	0.0384615
NODE_1163_length_2174_cov_35.399518	1542	1620	122	6	78	0.0769231
NODE_1163_length_2174_cov_35.399518	1542	1620	124	1	78	0.0128205
NODE_1163_length_2174_cov_35.399518	1542	1620	125	1	78	0.0128205
NODE_1163_length_2174_cov_35.399518	1542	1620	126	3	78	0.0384615
NODE_1163_length_2174_cov_35.399518	1542	1620	128	1	78	0.0128205
NODE_1163_length_2174_cov_35.399518	1542	1620	129	2	78	0.0256410
NODE_1163_length_2174_cov_35.399518	1542	1620	130	1	78	0.0128205
NODE_1163_length_2174_cov_35.399518	1542	1620	135	1	78	0.0128205
NODE_1163_length_2174_cov_35.399518	1542	1620	136	1	78	0.0128205
NODE_1163_length_2174_cov_35.399518	1542	1620	137	1	78	0.0128205
NODE_1163_length_2174_cov_35.399518	1542	1620	138	1	78	0.0128205
NODE_1163_length_2174_cov_35.399518	1542	1620	139	2	78	0.0256410
NODE_1163_length_2174_cov_35.399518	1542	1620	141	1	78	0.0128205
NODE_1163_length_2174_cov_35.399518	1542	1620	142	2	78	0.0256410
NODE_1163_length_2174_cov_35.399518	1542	1620	143	2	78	0.0256410
NODE_1163_length_2174_cov_35.399518	1542	1620	144	1	78	0.0128205
NODE_1163_length_2174_cov_35.399518	1542	1620	145	1	78	0.0128205
NODE_1163_length_2174_cov_35.399518	1542	1620	146	5	78	0.0641026
NODE_1163_length_2174_cov_35.399518	1542	1620	147	6	78	0.0769231
NODE_1163_length_2174_cov_35.399518	1542	1620	148	3	78	0.0384615
NODE_1163_length_2174_cov_35.399518	1542	1620	149	2	78	0.0256410
NODE_1163_length_2174_cov_35.399518	1542	1620	150	2	78	0.0256410
NODE_1163_length_2174_cov_35.399518	1542	1620	151	2	78	0.0256410
NODE_1163_length_2174_cov_35.399518	1542	1620	152	1	78	0.0128205
NODE_1163_length_2174_cov_35.399518	1542	1620	153	1	78	0.0128205
NODE_1163_length_2174_cov_35.399518	1542	1620	154	2	78	0.0256410
NODE_1163_length_2174_cov_35.399518	1542	1620	155	2	78	0.0256410
NODE_1163_length_2174_cov_35.399518	1542	1620	157	1	78	0.0128205
NODE_1163_length_2174_cov_35.399518	1593	1673	112	1	80	0.0125000
NODE_1163_length_2174_cov_35.399518	1593	1673	114	2	80	0.0250000
NODE_1163_length_2174_cov_35.399518	1593	1673	116	2	80	0.0250000
NODE_1163_length_2174_cov_35.399518	1593	1673	118	3	80	0.0375000
NODE_1163_length_2174_cov_35.399518	1593	1673	119	4	80	0.0500000
NODE_1163_length_2174_cov_35.399518	1593	1673	120	3	80	0.0375000
NODE_1163_length_2174_cov_35.399518	1593	1673	121	3	80	0.0375000
NODE_1163_length_2174_cov_35.399518	1593	1673	122	3	80	0.0375000
NODE_1163_length_2174_cov_35.399518	1593	1673	125	1	80	0.0125000
NODE_1163_length_2174_cov_35.399518	1593	1673	126	6	80	0.0750000
NODE_1163_length_2174_cov_35.399518	1593	1673	128	1	80	0.0125000
NODE_1163_length_2174_cov_35.399518	1593	1673	130	3	80	0.0375000
NODE_1163_length_2174_cov_35.399518	1593	1673	132	1	80	0.0125000
NODE_1163_length_2174_cov_35.399518	1593	1673	135	1	80	0.0125000
NODE_1163_length_2174_cov_35.399518	1593	1673	136	2	80	0.0250000
NODE_1163_length_2174_cov_35.399518	1593	1673	137	1	80	0.0125000
NODE_1163_length_2174_cov_35.399518	1593	1673	139	1	80	0.0125000
NODE_1163_length_2174_cov_35.399518	1593	1673	140	1	80	0.0125000
NODE_1163_length_2174_cov_35.399518	1593	1673	142	2	80	0.0250000
NODE_1163_length_2174_cov_35.399518	1593	1673	143	1	80	0.0125000
NODE_1163_length_2174_cov_35.399518	1593	1673	144	3	80	0.0375000
NODE_1163_length_2174_cov_35.399518	1593	1673	147	1	80	0.0125000
NODE_1163_length_2174_cov_35.399518	1593	1673	149	1	80	0.0125000
NODE_1163_length_2174_cov_35.399518	1593	1673	150	1	80	0.0125000
NODE_1163_length_2174_cov_35.399518	1593	1673	152	2	80	0.0250000
NODE_1163_length_2174_cov_35.399518	1593	1673	153	2	80	0.0250000
NODE_1163_length_2174_cov_35.399518	1593	1673	154	2	80	0.0250000
NODE_1163_length_2174_cov_35.399518	1593	1673	157	1	80	0.0125000
NODE_1163_length_2174_cov_35.399518	1593	1673	159	1	80	0.0125000
NODE_1163_length_2174_cov_35.399518	1593	1673	160	1	80	0.0125000
NODE_1163_length_2174_cov_35.399518	1593	1673	162	1	80	0.0125000
NODE_1163_length_2174_cov_35.399518	1593	1673	164	2	80	0.0250000
NODE_1163_length_2174_cov_35.399518	1593	1673	165	1	80	0.0125000
NODE_1163_length_2174_cov_35.399518	1593	1673	166	1	80	0.0125000
NODE_1163_length_2174_cov_35.399518	1593	1673	167	4	80	0.0500000
NODE_1163_length_2174_cov_35.399518	1593	1673	169	6	80	0.0750000
NODE_1163_length_2174_cov_35.399518	1593	1673	171	6	80	0.0750000
NODE_1163_length_2174_cov_35.399518	1593	1673	173	2	80	0.0250000
NODE_1163_length_2174_cov_35.399518	2075	2152	239	6	77	0.0779221
NODE_1163_length_2174_cov_35.399518	2075	2152	240	1	77	0.0129870
NODE_1163_length_2174_cov_35.399518	2075	2152	243	2	77	0.0259740
NODE_1163_length_2174_cov_35.399518	2075	2152	244	2	77	0.0259740
NODE_1163_length_2174_cov_35.399518	2075	2152	245	2	77	0.0259740
NODE_1163_length_2174_cov_35.399518	2075	2152	247	1	77	0.0129870
NODE_1163_length_2174_cov_35.399518	2075	2152	248	63	77	0.8181818
NODE_1163_length_2174_cov_35.399518	2075	2152	239	6	77	0.0779221
NODE_1163_length_2174_cov_35.399518	2075	2152	240	1	77	0.0129870
NODE_1163_length_2174_cov_35.399518	2075	2152	243	2	77	0.0259740
NODE_1163_length_2174_cov_35.399518	2075	2152	244	2	77	0.0259740
NODE_1163_length_2174_cov_35.399518	2075	2152	245	2	77	0.0259740
NODE_1163_length_2174_cov_35.399518	2075	2152	247	1	77	0.0129870
NODE_1163_length_2174_cov_35.399518	2075	2152	248	63	77	0.8181818
NODE_1163_length_2174_cov_35.399518	2075	2152	239	6	77	0.0779221
NODE_1163_length_2174_cov_35.399518	2075	2152	240	1	77	0.0129870
NODE_1163_length_2174_cov_35.399518	2075	2152	243	2	77	0.0259740
NODE_1163_length_2174_cov_35.399518	2075	2152	244	2	77	0.0259740
NODE_1163_length_2174_cov_35.399518	2075	2152	245	2	77	0.0259740
NODE_1163_length_2174_cov_35.399518	2075	2152	247	1	77	0.0129870
NODE_1163_length_2174_cov_35.399518	2075	2152	248	63	77	0.8181818
NODE_1163_length_2174_cov_35.399518	2125	2174	11	1	49	0.0204082
NODE_1163_length_2174_cov_35.399518	2125	2174	132	3	49	0.0612245
NODE_1163_length_2174_cov_35.399518	2125	2174	136	2	49	0.0408163
NODE_1163_length_2174_cov_35.399518	2125	2174	167	1	49	0.0204082
NODE_1163_length_2174_cov_35.399518	2125	2174	194	1	49	0.0204082
NODE_1163_length_2174_cov_35.399518	2125	2174	198	2	49	0.0408163
NODE_1163_length_2174_cov_35.399518	2125	2174	209	1	49	0.0204082
NODE_1163_length_2174_cov_35.399518	2125	2174	213	2	49	0.0408163
NODE_1163_length_2174_cov_35.399518	2125	2174	218	2	49	0.0408163
NODE_1163_length_2174_cov_35.399518	2125	2174	229	1	49	0.0204082
NODE_1163_length_2174_cov_35.399518	2125	2174	232	1	49	0.0204082
NODE_1163_length_2174_cov_35.399518	2125	2174	239	11	49	0.2244898
NODE_1163_length_2174_cov_35.399518	2125	2174	240	1	49	0.0204082
NODE_1163_length_2174_cov_35.399518	2125	2174	243	2	49	0.0408163
NODE_1163_length_2174_cov_35.399518	2125	2174	244	2	49	0.0408163
NODE_1163_length_2174_cov_35.399518	2125	2174	245	2	49	0.0408163
NODE_1163_length_2174_cov_35.399518	2125	2174	247	1	49	0.0204082
NODE_1163_length_2174_cov_35.399518	2125	2174	248	13	49	0.2653061
NODE_1163_length_2174_cov_35.399518	2128	2174	11	1	46	0.0217391
NODE_1163_length_2174_cov_35.399518	2128	2174	132	3	46	0.0652174
NODE_1163_length_2174_cov_35.399518	2128	2174	136	2	46	0.0434783
NODE_1163_length_2174_cov_35.399518	2128	2174	167	1	46	0.0217391
NODE_1163_length_2174_cov_35.399518	2128	2174	194	1	46	0.0217391
NODE_1163_length_2174_cov_35.399518	2128	2174	198	2	46	0.0434783
NODE_1163_length_2174_cov_35.399518	2128	2174	209	1	46	0.0217391
NODE_1163_length_2174_cov_35.399518	2128	2174	213	2	46	0.0434783
NODE_1163_length_2174_cov_35.399518	2128	2174	218	2	46	0.0434783
NODE_1163_length_2174_cov_35.399518	2128	2174	229	1	46	0.0217391
NODE_1163_length_2174_cov_35.399518	2128	2174	232	1	46	0.0217391
NODE_1163_length_2174_cov_35.399518	2128	2174	239	11	46	0.2391304
NODE_1163_length_2174_cov_35.399518	2128	2174	240	1	46	0.0217391
NODE_1163_length_2174_cov_35.399518	2128	2174	243	2	46	0.0434783
NODE_1163_length_2174_cov_35.399518	2128	2174	244	2	46	0.0434783
NODE_1163_length_2174_cov_35.399518	2128	2174	245	2	46	0.0434783
NODE_1163_length_2174_cov_35.399518	2128	2174	247	1	46	0.0217391
NODE_1163_length_2174_cov_35.399518	2128	2174	248	10	46	0.2173913
NODE_1163_length_2174_cov_35.399518	2130	2174	11	1	44	0.0227273
NODE_1163_length_2174_cov_35.399518	2130	2174	132	3	44	0.0681818
NODE_1163_length_2174_cov_35.399518	2130	2174	136	2	44	0.0454545
NODE_1163_length_2174_cov_35.399518	2130	2174	167	1	44	0.0227273
NODE_1163_length_2174_cov_35.399518	2130	2174	194	1	44	0.0227273
NODE_1163_length_2174_cov_35.399518	2130	2174	198	2	44	0.0454545
NODE_1163_length_2174_cov_35.399518	2130	2174	209	1	44	0.0227273
NODE_1163_length_2174_cov_35.399518	2130	2174	213	2	44	0.0454545
NODE_1163_length_2174_cov_35.399518	2130	2174	218	2	44	0.0454545
NODE_1163_length_2174_cov_35.399518	2130	2174	229	1	44	0.0227273
NODE_1163_length_2174_cov_35.399518	2130	2174	232	1	44	0.0227273
NODE_1163_length_2174_cov_35.399518	2130	2174	239	11	44	0.2500000
NODE_1163_length_2174_cov_35.399518	2130	2174	240	1	44	0.0227273
NODE_1163_length_2174_cov_35.399518	2130	2174	243	2	44	0.0454545
NODE_1163_length_2174_cov_35.399518	2130	2174	244	2	44	0.0454545
NODE_1163_length_2174_cov_35.399518	2130	2174	245	2	44	0.0454545
NODE_1163_length_2174_cov_35.399518	2130	2174	247	1	44	0.0227273
NODE_1163_length_2174_cov_35.399518	2130	2174	248	8	44	0.1818182
NODE_1164_length_2172_cov_44.861553	1110	1190	0	80	80	1.0000000
NODE_1164_length_2172_cov_44.861553	1163	1243	0	80	80	1.0000000
NODE_1164_length_2172_cov_44.861553	1239	1319	0	80	80	1.0000000
NODE_1164_length_2172_cov_44.861553	1292	1372	0	80	80	1.0000000
NODE_1166_length_2167_cov_33.133946	414	494	0	80	80	1.0000000
NODE_1166_length_2167_cov_33.133946	467	547	0	80	80	1.0000000
NODE_1166_length_2167_cov_33.133946	543	623	0	80	80	1.0000000
NODE_1166_length_2167_cov_33.133946	596	676	0	66	80	0.8250000
NODE_1166_length_2167_cov_33.133946	596	676	2	14	80	0.1750000
NODE_1169_length_2165_cov_21.460794	980	1060	0	80	80	1.0000000
NODE_1169_length_2165_cov_21.460794	1033	1113	0	80	80	1.0000000
NODE_1176_length_2157_cov_22.284257	989	1069	0	25	80	0.3125000
NODE_1176_length_2157_cov_22.284257	989	1069	2	55	80	0.6875000
NODE_1176_length_2157_cov_22.284257	1042	1122	0	78	80	0.9750000
NODE_1176_length_2157_cov_22.284257	1042	1122	2	2	80	0.0250000
NODE_1176_length_2157_cov_22.284257	1118	1198	0	80	80	1.0000000
NODE_1176_length_2157_cov_22.284257	1171	1251	0	80	80	1.0000000
NODE_1177_length_2157_cov_8.830418	867	947	0	1	80	0.0125000
NODE_1177_length_2157_cov_8.830418	867	947	2	79	80	0.9875000
NODE_1177_length_2157_cov_8.830418	920	1000	0	54	80	0.6750000
NODE_1177_length_2157_cov_8.830418	920	1000	2	26	80	0.3250000
NODE_1177_length_2157_cov_8.830418	996	1076	0	80	80	1.0000000
NODE_1177_length_2157_cov_8.830418	1049	1129	0	44	80	0.5500000
NODE_1177_length_2157_cov_8.830418	1049	1129	2	36	80	0.4500000
NODE_1178_length_2156_cov_25.065630	0	41	15	11	41	0.2682927
NODE_1178_length_2156_cov_25.065630	0	41	19	6	41	0.1463415
NODE_1178_length_2156_cov_25.065630	0	41	21	1	41	0.0243902
NODE_1178_length_2156_cov_25.065630	0	41	22	3	41	0.0731707
NODE_1178_length_2156_cov_25.065630	0	41	24	7	41	0.1707317
NODE_1178_length_2156_cov_25.065630	0	41	26	5	41	0.1219512
NODE_1178_length_2156_cov_25.065630	0	41	28	3	41	0.0731707
NODE_1178_length_2156_cov_25.065630	0	41	29	1	41	0.0243902
NODE_1178_length_2156_cov_25.065630	0	41	31	4	41	0.0975610
NODE_1178_length_2156_cov_25.065630	14	94	19	3	80	0.0375000
NODE_1178_length_2156_cov_25.065630	14	94	21	1	80	0.0125000
NODE_1178_length_2156_cov_25.065630	14	94	22	3	80	0.0375000
NODE_1178_length_2156_cov_25.065630	14	94	24	7	80	0.0875000
NODE_1178_length_2156_cov_25.065630	14	94	26	5	80	0.0625000
NODE_1178_length_2156_cov_25.065630	14	94	28	3	80	0.0375000
NODE_1178_length_2156_cov_25.065630	14	94	29	1	80	0.0125000
NODE_1178_length_2156_cov_25.065630	14	94	31	4	80	0.0500000
NODE_1178_length_2156_cov_25.065630	14	94	32	1	80	0.0125000
NODE_1178_length_2156_cov_25.065630	14	94	35	2	80	0.0250000
NODE_1178_length_2156_cov_25.065630	14	94	37	2	80	0.0250000
NODE_1178_length_2156_cov_25.065630	14	94	38	4	80	0.0500000
NODE_1178_length_2156_cov_25.065630	14	94	40	6	80	0.0750000
NODE_1178_length_2156_cov_25.065630	14	94	41	7	80	0.0875000
NODE_1178_length_2156_cov_25.065630	14	94	43	4	80	0.0500000
NODE_1178_length_2156_cov_25.065630	14	94	44	2	80	0.0250000
NODE_1178_length_2156_cov_25.065630	14	94	46	6	80	0.0750000
NODE_1178_length_2156_cov_25.065630	14	94	47	19	80	0.2375000
NODE_1181_length_2156_cov_3.216334	1890	1970	0	80	80	1.0000000
NODE_1181_length_2156_cov_3.216334	1943	2023	0	80	80	1.0000000
NODE_1184_length_2153_cov_11.610029	1968	2048	0	4	80	0.0500000
NODE_1184_length_2153_cov_11.610029	1968	2048	2	14	80	0.1750000
NODE_1184_length_2153_cov_11.610029	1968	2048	3	28	80	0.3500000
NODE_1184_length_2153_cov_11.610029	1968	2048	4	26	80	0.3250000
NODE_1184_length_2153_cov_11.610029	1968	2048	8	1	80	0.0125000
NODE_1184_length_2153_cov_11.610029	1968	2048	12	4	80	0.0500000
NODE_1184_length_2153_cov_11.610029	1968	2048	14	3	80	0.0375000
NODE_1184_length_2153_cov_11.610029	1977	2048	2	9	71	0.1267606
NODE_1184_length_2153_cov_11.610029	1977	2048	3	28	71	0.3943662
NODE_1184_length_2153_cov_11.610029	1977	2048	4	26	71	0.3661972
NODE_1184_length_2153_cov_11.610029	1977	2048	8	1	71	0.0140845
NODE_1184_length_2153_cov_11.610029	1977	2048	12	4	71	0.0563380
NODE_1184_length_2153_cov_11.610029	1977	2048	14	3	71	0.0422535
NODE_1190_length_2147_cov_25.116211	814	894	6	20	80	0.2500000
NODE_1190_length_2147_cov_25.116211	814	894	7	4	80	0.0500000
NODE_1190_length_2147_cov_25.116211	814	894	9	9	80	0.1125000
NODE_1190_length_2147_cov_25.116211	814	894	10	32	80	0.4000000
NODE_1190_length_2147_cov_25.116211	814	894	12	5	80	0.0625000
NODE_1190_length_2147_cov_25.116211	814	894	13	6	80	0.0750000
NODE_1190_length_2147_cov_25.116211	814	894	14	4	80	0.0500000
NODE_1190_length_2147_cov_25.116211	867	947	7	4	80	0.0500000
NODE_1190_length_2147_cov_25.116211	867	947	9	8	80	0.1000000
NODE_1190_length_2147_cov_25.116211	867	947	12	5	80	0.0625000
NODE_1190_length_2147_cov_25.116211	867	947	13	6	80	0.0750000
NODE_1190_length_2147_cov_25.116211	867	947	14	22	80	0.2750000
NODE_1190_length_2147_cov_25.116211	867	947	16	35	80	0.4375000
NODE_1197_length_2136_cov_16.947472	279	359	0	7	80	0.0875000
NODE_1197_length_2136_cov_16.947472	279	359	2	73	80	0.9125000
NODE_1197_length_2136_cov_16.947472	332	412	0	42	80	0.5250000
NODE_1197_length_2136_cov_16.947472	332	412	2	38	80	0.4750000
NODE_1197_length_2136_cov_16.947472	408	488	0	80	80	1.0000000
NODE_1197_length_2136_cov_16.947472	461	541	0	80	80	1.0000000
NODE_1199_length_2133_cov_15.038840	498	578	0	80	80	1.0000000
NODE_1199_length_2133_cov_15.038840	551	631	0	80	80	1.0000000
NODE_1199_length_2133_cov_15.038840	627	707	0	80	80	1.0000000
NODE_1199_length_2133_cov_15.038840	680	722	0	42	42	1.0000000
NODE_1204_length_2128_cov_11.799409	1698	1778	0	80	80	1.0000000
NODE_1204_length_2128_cov_11.799409	1751	1831	0	80	80	1.0000000
NODE_1206_length_2126_cov_6.854465	1614	1694	4	35	80	0.4375000
NODE_1206_length_2126_cov_6.854465	1614	1694	6	45	80	0.5625000
NODE_1206_length_2126_cov_6.854465	1667	1747	0	40	80	0.5000000
NODE_1206_length_2126_cov_6.854465	1667	1747	4	40	80	0.5000000
NODE_1209_length_2123_cov_12.668478	102	143	6	41	41	1.0000000
NODE_1209_length_2123_cov_12.668478	1474	1500	4	26	26	1.0000000
NODE_1209_length_2123_cov_12.668478	1552	1601	0	46	49	0.9387755
NODE_1209_length_2123_cov_12.668478	1552	1601	4	3	49	0.0612245
NODE_1209_length_2123_cov_12.668478	1574	1654	0	24	80	0.3000000
NODE_1209_length_2123_cov_12.668478	1574	1654	4	25	80	0.3125000
NODE_1209_length_2123_cov_12.668478	1574	1654	6	31	80	0.3875000
NODE_1211_length_2121_cov_10.101879	497	577	0	80	80	1.0000000
NODE_1211_length_2121_cov_10.101879	550	630	0	80	80	1.0000000
NODE_1211_length_2121_cov_10.101879	1935	2008	0	4	73	0.0547945
NODE_1211_length_2121_cov_10.101879	1935	2008	2	69	73	0.9452055
NODE_1212_length_2121_cov_9.964886	1523	1603	0	3	80	0.0375000
NODE_1212_length_2121_cov_9.964886	1523	1603	2	77	80	0.9625000
NODE_1212_length_2121_cov_9.964886	1576	1656	2	80	80	1.0000000
NODE_1213_length_2120_cov_24.609599	25	92	0	67	67	1.0000000
NODE_1215_length_2119_cov_18.446040	366	446	0	80	80	1.0000000
NODE_1215_length_2119_cov_18.446040	419	499	0	80	80	1.0000000
NODE_1215_length_2119_cov_18.446040	1239	1319	0	80	80	1.0000000
NODE_1215_length_2119_cov_18.446040	1292	1372	0	80	80	1.0000000
NODE_1225_length_2110_cov_8.668324	1755	1835	0	80	80	1.0000000
NODE_1225_length_2110_cov_8.668324	1808	1888	0	80	80	1.0000000
NODE_1227_length_2106_cov_14.643747	1579	1659	0	80	80	1.0000000
NODE_1227_length_2106_cov_14.643747	1632	1712	0	80	80	1.0000000
NODE_1227_length_2106_cov_14.643747	1708	1786	0	78	78	1.0000000
NODE_1227_length_2106_cov_14.643747	1759	1839	0	80	80	1.0000000
NODE_1228_length_2106_cov_3.173393	48	96	0	48	48	1.0000000
NODE_1228_length_2106_cov_3.173393	48	96	0	48	48	1.0000000
NODE_1228_length_2106_cov_3.173393	48	96	0	48	48	1.0000000
NODE_1228_length_2106_cov_3.173393	48	96	0	48	48	1.0000000
NODE_1228_length_2106_cov_3.173393	48	96	0	48	48	1.0000000
NODE_1229_length_2102_cov_23.872192	390	470	0	80	80	1.0000000
NODE_1229_length_2102_cov_23.872192	443	523	0	80	80	1.0000000
NODE_1229_length_2102_cov_23.872192	519	599	0	80	80	1.0000000
NODE_1229_length_2102_cov_23.872192	572	652	0	80	80	1.0000000
NODE_1229_length_2102_cov_23.872192	1049	1101	393	1	52	0.0192308
NODE_1229_length_2102_cov_23.872192	1049	1101	394	1	52	0.0192308
NODE_1229_length_2102_cov_23.872192	1049	1101	395	4	52	0.0769231
NODE_1229_length_2102_cov_23.872192	1049	1101	410	2	52	0.0384615
NODE_1229_length_2102_cov_23.872192	1049	1101	411	2	52	0.0384615
NODE_1229_length_2102_cov_23.872192	1049	1101	412	2	52	0.0384615
NODE_1229_length_2102_cov_23.872192	1049	1101	417	1	52	0.0192308
NODE_1229_length_2102_cov_23.872192	1049	1101	418	1	52	0.0192308
NODE_1229_length_2102_cov_23.872192	1049	1101	424	1	52	0.0192308
NODE_1229_length_2102_cov_23.872192	1049	1101	426	1	52	0.0192308
NODE_1229_length_2102_cov_23.872192	1049	1101	432	1	52	0.0192308
NODE_1229_length_2102_cov_23.872192	1049	1101	438	3	52	0.0576923
NODE_1229_length_2102_cov_23.872192	1049	1101	439	1	52	0.0192308
NODE_1229_length_2102_cov_23.872192	1049	1101	443	1	52	0.0192308
NODE_1229_length_2102_cov_23.872192	1049	1101	445	1	52	0.0192308
NODE_1229_length_2102_cov_23.872192	1049	1101	447	1	52	0.0192308
NODE_1229_length_2102_cov_23.872192	1049	1101	449	1	52	0.0192308
NODE_1229_length_2102_cov_23.872192	1049	1101	450	3	52	0.0576923
NODE_1229_length_2102_cov_23.872192	1049	1101	452	1	52	0.0192308
NODE_1229_length_2102_cov_23.872192	1049	1101	454	1	52	0.0192308
NODE_1229_length_2102_cov_23.872192	1049	1101	460	1	52	0.0192308
NODE_1229_length_2102_cov_23.872192	1049	1101	464	1	52	0.0192308
NODE_1229_length_2102_cov_23.872192	1049	1101	465	1	52	0.0192308
NODE_1229_length_2102_cov_23.872192	1049	1101	466	1	52	0.0192308
NODE_1229_length_2102_cov_23.872192	1049	1101	467	3	52	0.0576923
NODE_1229_length_2102_cov_23.872192	1049	1101	468	3	52	0.0576923
NODE_1229_length_2102_cov_23.872192	1049	1101	469	2	52	0.0384615
NODE_1229_length_2102_cov_23.872192	1049	1101	472	2	52	0.0384615
NODE_1229_length_2102_cov_23.872192	1049	1101	475	2	52	0.0384615
NODE_1229_length_2102_cov_23.872192	1049	1101	478	2	52	0.0384615
NODE_1229_length_2102_cov_23.872192	1049	1101	479	1	52	0.0192308
NODE_1229_length_2102_cov_23.872192	1049	1101	480	2	52	0.0384615
NODE_1229_length_2102_cov_23.872192	1049	1101	481	1	52	0.0192308
NODE_1231_length_2100_cov_21.504248	450	530	0	80	80	1.0000000
NODE_1231_length_2100_cov_21.504248	503	578	0	75	75	1.0000000
NODE_1231_length_2100_cov_21.504248	579	659	0	80	80	1.0000000
NODE_1231_length_2100_cov_21.504248	632	712	0	80	80	1.0000000
NODE_1231_length_2100_cov_21.504248	1420	1500	0	80	80	1.0000000
NODE_1231_length_2100_cov_21.504248	1473	1553	0	80	80	1.0000000
NODE_1232_length_2100_cov_6.399300	1510	1590	0	80	80	1.0000000
NODE_1232_length_2100_cov_6.399300	1559	1590	0	31	31	1.0000000
NODE_1232_length_2100_cov_6.399300	1563	1644	0	81	81	1.0000000
NODE_1232_length_2100_cov_6.399300	1563	1644	0	81	81	1.0000000
NODE_1234_length_2099_cov_40.603500	960	1040	0	80	80	1.0000000
NODE_1234_length_2099_cov_40.603500	1013	1093	0	80	80	1.0000000
NODE_1234_length_2099_cov_40.603500	1089	1169	0	71	80	0.8875000
NODE_1234_length_2099_cov_40.603500	1089	1169	2	9	80	0.1125000
NODE_1234_length_2099_cov_40.603500	1142	1222	0	18	80	0.2250000
NODE_1234_length_2099_cov_40.603500	1142	1222	2	62	80	0.7750000
NODE_1235_length_2098_cov_62.733867	1042	1122	0	7	80	0.0875000
NODE_1235_length_2098_cov_62.733867	1042	1122	2	42	80	0.5250000
NODE_1235_length_2098_cov_62.733867	1042	1122	4	31	80	0.3875000
NODE_1235_length_2098_cov_62.733867	1095	1175	2	11	80	0.1375000
NODE_1235_length_2098_cov_62.733867	1095	1175	4	69	80	0.8625000
NODE_1235_length_2098_cov_62.733867	1171	1251	0	60	80	0.7500000
NODE_1235_length_2098_cov_62.733867	1171	1251	1	4	80	0.0500000
NODE_1235_length_2098_cov_62.733867	1171	1251	2	16	80	0.2000000
NODE_1235_length_2098_cov_62.733867	1224	1304	0	23	80	0.2875000
NODE_1235_length_2098_cov_62.733867	1224	1304	1	57	80	0.7125000
NODE_1236_length_2098_cov_20.220110	550	630	0	80	80	1.0000000
NODE_1236_length_2098_cov_20.220110	603	683	0	80	80	1.0000000
NODE_1236_length_2098_cov_20.220110	1571	1651	0	80	80	1.0000000
NODE_1236_length_2098_cov_20.220110	1624	1704	0	80	80	1.0000000
NODE_1237_length_2098_cov_8.261631	324	404	0	80	80	1.0000000
NODE_1239_length_2095_cov_29.930862	1128	1209	81	1	81	0.0123457
NODE_1239_length_2095_cov_29.930862	1128	1209	88	1	81	0.0123457
NODE_1239_length_2095_cov_29.930862	1128	1209	102	1	81	0.0123457
NODE_1239_length_2095_cov_29.930862	1128	1209	106	1	81	0.0123457
NODE_1239_length_2095_cov_29.930862	1128	1209	108	1	81	0.0123457
NODE_1239_length_2095_cov_29.930862	1128	1209	114	1	81	0.0123457
NODE_1239_length_2095_cov_29.930862	1128	1209	116	1	81	0.0123457
NODE_1239_length_2095_cov_29.930862	1128	1209	118	1	81	0.0123457
NODE_1239_length_2095_cov_29.930862	1128	1209	130	2	81	0.0246914
NODE_1239_length_2095_cov_29.930862	1128	1209	132	1	81	0.0123457
NODE_1239_length_2095_cov_29.930862	1128	1209	136	1	81	0.0123457
NODE_1239_length_2095_cov_29.930862	1128	1209	138	2	81	0.0246914
NODE_1239_length_2095_cov_29.930862	1128	1209	153	1	81	0.0123457
NODE_1239_length_2095_cov_29.930862	1128	1209	155	3	81	0.0370370
NODE_1239_length_2095_cov_29.930862	1128	1209	157	3	81	0.0370370
NODE_1239_length_2095_cov_29.930862	1128	1209	159	2	81	0.0246914
NODE_1239_length_2095_cov_29.930862	1128	1209	163	2	81	0.0246914
NODE_1239_length_2095_cov_29.930862	1128	1209	166	1	81	0.0123457
NODE_1239_length_2095_cov_29.930862	1128	1209	167	1	81	0.0123457
NODE_1239_length_2095_cov_29.930862	1128	1209	177	1	81	0.0123457
NODE_1239_length_2095_cov_29.930862	1128	1209	180	1	81	0.0123457
NODE_1239_length_2095_cov_29.930862	1128	1209	182	1	81	0.0123457
NODE_1239_length_2095_cov_29.930862	1128	1209	186	3	81	0.0370370
NODE_1239_length_2095_cov_29.930862	1128	1209	190	1	81	0.0123457
NODE_1239_length_2095_cov_29.930862	1128	1209	192	1	81	0.0123457
NODE_1239_length_2095_cov_29.930862	1128	1209	197	1	81	0.0123457
NODE_1239_length_2095_cov_29.930862	1128	1209	198	2	81	0.0246914
NODE_1239_length_2095_cov_29.930862	1128	1209	200	1	81	0.0123457
NODE_1239_length_2095_cov_29.930862	1128	1209	205	1	81	0.0123457
NODE_1239_length_2095_cov_29.930862	1128	1209	207	2	81	0.0246914
NODE_1239_length_2095_cov_29.930862	1128	1209	212	1	81	0.0123457
NODE_1239_length_2095_cov_29.930862	1128	1209	217	2	81	0.0246914
NODE_1239_length_2095_cov_29.930862	1128	1209	218	1	81	0.0123457
NODE_1239_length_2095_cov_29.930862	1128	1209	220	1	81	0.0123457
NODE_1239_length_2095_cov_29.930862	1128	1209	227	1	81	0.0123457
NODE_1239_length_2095_cov_29.930862	1128	1209	231	1	81	0.0123457
NODE_1239_length_2095_cov_29.930862	1128	1209	232	2	81	0.0246914
NODE_1239_length_2095_cov_29.930862	1128	1209	238	1	81	0.0123457
NODE_1239_length_2095_cov_29.930862	1128	1209	243	1	81	0.0123457
NODE_1239_length_2095_cov_29.930862	1128	1209	246	3	81	0.0370370
NODE_1239_length_2095_cov_29.930862	1128	1209	247	1	81	0.0123457
NODE_1239_length_2095_cov_29.930862	1128	1209	262	1	81	0.0123457
NODE_1239_length_2095_cov_29.930862	1128	1209	266	1	81	0.0123457
NODE_1239_length_2095_cov_29.930862	1128	1209	270	1	81	0.0123457
NODE_1239_length_2095_cov_29.930862	1128	1209	274	1	81	0.0123457
NODE_1239_length_2095_cov_29.930862	1128	1209	282	1	81	0.0123457
NODE_1239_length_2095_cov_29.930862	1128	1209	284	1	81	0.0123457
NODE_1239_length_2095_cov_29.930862	1128	1209	297	2	81	0.0246914
NODE_1239_length_2095_cov_29.930862	1128	1209	313	1	81	0.0123457
NODE_1239_length_2095_cov_29.930862	1128	1209	315	1	81	0.0123457
NODE_1239_length_2095_cov_29.930862	1128	1209	317	1	81	0.0123457
NODE_1239_length_2095_cov_29.930862	1128	1209	319	1	81	0.0123457
NODE_1239_length_2095_cov_29.930862	1128	1209	320	1	81	0.0123457
NODE_1239_length_2095_cov_29.930862	1128	1209	330	1	81	0.0123457
NODE_1239_length_2095_cov_29.930862	1128	1209	336	2	81	0.0246914
NODE_1239_length_2095_cov_29.930862	1128	1209	338	3	81	0.0370370
NODE_1239_length_2095_cov_29.930862	1128	1209	343	2	81	0.0246914
NODE_1239_length_2095_cov_29.930862	1128	1209	347	1	81	0.0123457
NODE_1239_length_2095_cov_29.930862	1128	1209	349	2	81	0.0246914
NODE_1239_length_2095_cov_29.930862	1204	1258	343	2	54	0.0370370
NODE_1239_length_2095_cov_29.930862	1204	1258	347	1	54	0.0185185
NODE_1239_length_2095_cov_29.930862	1204	1258	349	2	54	0.0370370
NODE_1239_length_2095_cov_29.930862	1204	1258	365	1	54	0.0185185
NODE_1239_length_2095_cov_29.930862	1204	1258	376	1	54	0.0185185
NODE_1239_length_2095_cov_29.930862	1204	1258	377	1	54	0.0185185
NODE_1239_length_2095_cov_29.930862	1204	1258	378	1	54	0.0185185
NODE_1239_length_2095_cov_29.930862	1204	1258	381	1	54	0.0185185
NODE_1239_length_2095_cov_29.930862	1204	1258	382	1	54	0.0185185
NODE_1239_length_2095_cov_29.930862	1204	1258	383	1	54	0.0185185
NODE_1239_length_2095_cov_29.930862	1204	1258	385	2	54	0.0370370
NODE_1239_length_2095_cov_29.930862	1204	1258	386	2	54	0.0370370
NODE_1239_length_2095_cov_29.930862	1204	1258	387	4	54	0.0740741
NODE_1239_length_2095_cov_29.930862	1204	1258	388	2	54	0.0370370
NODE_1239_length_2095_cov_29.930862	1204	1258	389	3	54	0.0555556
NODE_1239_length_2095_cov_29.930862	1204	1258	390	1	54	0.0185185
NODE_1239_length_2095_cov_29.930862	1204	1258	391	3	54	0.0555556
NODE_1239_length_2095_cov_29.930862	1204	1258	392	4	54	0.0740741
NODE_1239_length_2095_cov_29.930862	1204	1258	393	2	54	0.0370370
NODE_1239_length_2095_cov_29.930862	1204	1258	395	1	54	0.0185185
NODE_1239_length_2095_cov_29.930862	1204	1258	396	1	54	0.0185185
NODE_1239_length_2095_cov_29.930862	1204	1258	397	1	54	0.0185185
NODE_1239_length_2095_cov_29.930862	1204	1258	398	2	54	0.0370370
NODE_1239_length_2095_cov_29.930862	1204	1258	399	2	54	0.0370370
NODE_1239_length_2095_cov_29.930862	1204	1258	401	1	54	0.0185185
NODE_1239_length_2095_cov_29.930862	1204	1258	402	3	54	0.0555556
NODE_1239_length_2095_cov_29.930862	1204	1258	403	1	54	0.0185185
NODE_1239_length_2095_cov_29.930862	1204	1258	404	1	54	0.0185185
NODE_1239_length_2095_cov_29.930862	1204	1258	405	2	54	0.0370370
NODE_1239_length_2095_cov_29.930862	1204	1258	406	3	54	0.0555556
NODE_1239_length_2095_cov_29.930862	1204	1258	409	1	54	0.0185185
NODE_1251_length_2084_cov_1.720403	959	1039	0	80	80	1.0000000
NODE_1251_length_2084_cov_1.720403	1012	1092	0	52	80	0.6500000
NODE_1251_length_2084_cov_1.720403	1012	1092	3	19	80	0.2375000
NODE_1251_length_2084_cov_1.720403	1012	1092	4	1	80	0.0125000
NODE_1251_length_2084_cov_1.720403	1012	1092	5	8	80	0.1000000
NODE_1252_length_2083_cov_5.864415	419	499	0	80	80	1.0000000
NODE_1252_length_2083_cov_5.864415	472	552	0	80	80	1.0000000
NODE_1252_length_2083_cov_5.864415	548	628	0	80	80	1.0000000
NODE_1252_length_2083_cov_5.864415	601	681	0	80	80	1.0000000
NODE_1256_length_2078_cov_47.394644	311	391	0	80	80	1.0000000
NODE_1256_length_2078_cov_47.394644	364	444	0	80	80	1.0000000
NODE_1256_length_2078_cov_47.394644	440	520	0	42	80	0.5250000
NODE_1256_length_2078_cov_47.394644	440	520	2	38	80	0.4750000
NODE_1256_length_2078_cov_47.394644	493	573	2	80	80	1.0000000
NODE_1267_length_2067_cov_13.647866	1349	1429	2	75	80	0.9375000
NODE_1267_length_2067_cov_13.647866	1349	1429	6	5	80	0.0625000
NODE_1267_length_2067_cov_13.647866	1402	1482	2	22	80	0.2750000
NODE_1267_length_2067_cov_13.647866	1402	1482	4	10	80	0.1250000
NODE_1267_length_2067_cov_13.647866	1402	1482	5	23	80	0.2875000
NODE_1267_length_2067_cov_13.647866	1402	1482	6	25	80	0.3125000
NODE_1269_length_2066_cov_19.127605	1497	1577	0	47	80	0.5875000
NODE_1269_length_2066_cov_19.127605	1497	1577	4	33	80	0.4125000
NODE_1269_length_2066_cov_19.127605	1550	1630	0	11	80	0.1375000
NODE_1269_length_2066_cov_19.127605	1550	1630	4	69	80	0.8625000
NODE_1274_length_2061_cov_43.187054	364	444	0	80	80	1.0000000
NODE_1274_length_2061_cov_43.187054	417	497	0	80	80	1.0000000
NODE_1275_length_2061_cov_3.251784	981	1033	0	52	52	1.0000000
NODE_1275_length_2061_cov_3.251784	1006	1086	0	80	80	1.0000000
NODE_1277_length_2058_cov_4.531394	1844	1875	0	31	31	1.0000000
NODE_1277_length_2058_cov_4.531394	1848	1928	0	80	80	1.0000000
NODE_1279_length_2056_cov_20.525805	749	829	0	80	80	1.0000000
NODE_1279_length_2056_cov_20.525805	802	882	0	74	80	0.9250000
NODE_1279_length_2056_cov_20.525805	802	882	1	6	80	0.0750000
NODE_1279_length_2056_cov_20.525805	878	958	1	23	80	0.2875000
NODE_1279_length_2056_cov_20.525805	878	958	2	55	80	0.6875000
NODE_1279_length_2056_cov_20.525805	878	958	6	2	80	0.0250000
NODE_1279_length_2056_cov_20.525805	931	1011	2	25	80	0.3125000
NODE_1279_length_2056_cov_20.525805	931	1011	6	55	80	0.6875000
NODE_1281_length_2055_cov_10.047546	1468	1548	0	80	80	1.0000000
NODE_1281_length_2055_cov_10.047546	1521	1601	0	80	80	1.0000000
NODE_1286_length_2049_cov_6.846154	270	350	0	80	80	1.0000000
NODE_1286_length_2049_cov_6.846154	323	403	0	80	80	1.0000000
NODE_1286_length_2049_cov_6.846154	1595	1674	0	79	79	1.0000000
NODE_1286_length_2049_cov_6.846154	1648	1712	0	64	64	1.0000000
NODE_1293_length_2045_cov_46.790339	876	956	4	34	80	0.4250000
NODE_1293_length_2045_cov_46.790339	876	956	10	19	80	0.2375000
NODE_1293_length_2045_cov_46.790339	876	956	12	12	80	0.1500000
NODE_1293_length_2045_cov_46.790339	876	956	14	15	80	0.1875000
NODE_1293_length_2045_cov_46.790339	929	1009	0	8	80	0.1000000
NODE_1293_length_2045_cov_46.790339	929	1009	2	22	80	0.2750000
NODE_1293_length_2045_cov_46.790339	929	1009	4	50	80	0.6250000
NODE_1293_length_2045_cov_46.790339	1005	1085	4	54	80	0.6750000
NODE_1293_length_2045_cov_46.790339	1005	1085	6	8	80	0.1000000
NODE_1293_length_2045_cov_46.790339	1005	1085	8	18	80	0.2250000
NODE_1293_length_2045_cov_46.790339	1058	1138	4	43	80	0.5375000
NODE_1293_length_2045_cov_46.790339	1058	1138	6	18	80	0.2250000
NODE_1293_length_2045_cov_46.790339	1058	1138	8	19	80	0.2375000
NODE_1298_length_2042_cov_4.447761	241	315	4	74	74	1.0000000
NODE_1301_length_2040_cov_30.109737	1760	1844	168	1	84	0.0119048
NODE_1301_length_2040_cov_30.109737	1760	1844	169	1	84	0.0119048
NODE_1301_length_2040_cov_30.109737	1760	1844	170	4	84	0.0476190
NODE_1301_length_2040_cov_30.109737	1760	1844	171	3	84	0.0357143
NODE_1301_length_2040_cov_30.109737	1760	1844	173	1	84	0.0119048
NODE_1301_length_2040_cov_30.109737	1760	1844	177	7	84	0.0833333
NODE_1301_length_2040_cov_30.109737	1760	1844	179	3	84	0.0357143
NODE_1301_length_2040_cov_30.109737	1760	1844	181	1	84	0.0119048
NODE_1301_length_2040_cov_30.109737	1760	1844	182	1	84	0.0119048
NODE_1301_length_2040_cov_30.109737	1760	1844	183	4	84	0.0476190
NODE_1301_length_2040_cov_30.109737	1760	1844	185	3	84	0.0357143
NODE_1301_length_2040_cov_30.109737	1760	1844	186	4	84	0.0476190
NODE_1301_length_2040_cov_30.109737	1760	1844	187	3	84	0.0357143
NODE_1301_length_2040_cov_30.109737	1760	1844	191	3	84	0.0357143
NODE_1301_length_2040_cov_30.109737	1760	1844	193	2	84	0.0238095
NODE_1301_length_2040_cov_30.109737	1760	1844	194	1	84	0.0119048
NODE_1301_length_2040_cov_30.109737	1760	1844	195	4	84	0.0476190
NODE_1301_length_2040_cov_30.109737	1760	1844	197	1	84	0.0119048
NODE_1301_length_2040_cov_30.109737	1760	1844	198	1	84	0.0119048
NODE_1301_length_2040_cov_30.109737	1760	1844	199	4	84	0.0476190
NODE_1301_length_2040_cov_30.109737	1760	1844	200	4	84	0.0476190
NODE_1301_length_2040_cov_30.109737	1760	1844	201	2	84	0.0238095
NODE_1301_length_2040_cov_30.109737	1760	1844	202	1	84	0.0119048
NODE_1301_length_2040_cov_30.109737	1760	1844	203	3	84	0.0357143
NODE_1301_length_2040_cov_30.109737	1760	1844	204	3	84	0.0357143
NODE_1301_length_2040_cov_30.109737	1760	1844	205	2	84	0.0238095
NODE_1301_length_2040_cov_30.109737	1760	1844	206	6	84	0.0714286
NODE_1301_length_2040_cov_30.109737	1760	1844	207	2	84	0.0238095
NODE_1301_length_2040_cov_30.109737	1760	1844	208	1	84	0.0119048
NODE_1301_length_2040_cov_30.109737	1760	1844	210	5	84	0.0595238
NODE_1301_length_2040_cov_30.109737	1760	1844	212	2	84	0.0238095
NODE_1301_length_2040_cov_30.109737	1760	1844	213	1	84	0.0119048
NODE_1306_length_2036_cov_11.672173	369	449	0	80	80	1.0000000
NODE_1306_length_2036_cov_11.672173	422	502	0	80	80	1.0000000
NODE_1312_length_2032_cov_11.188308	416	496	0	80	80	1.0000000
NODE_1312_length_2032_cov_11.188308	469	549	0	80	80	1.0000000
NODE_1318_length_2027_cov_43.702282	1129	1209	0	66	80	0.8250000
NODE_1318_length_2027_cov_43.702282	1129	1209	2	14	80	0.1750000
NODE_1318_length_2027_cov_43.702282	1182	1262	0	13	80	0.1625000
NODE_1318_length_2027_cov_43.702282	1182	1262	2	67	80	0.8375000
NODE_1318_length_2027_cov_43.702282	1258	1338	0	68	80	0.8500000
NODE_1318_length_2027_cov_43.702282	1258	1338	2	12	80	0.1500000
NODE_1318_length_2027_cov_43.702282	1311	1391	0	80	80	1.0000000
NODE_1319_length_2027_cov_6.558610	229	303	0	74	74	1.0000000
NODE_1319_length_2027_cov_6.558610	229	303	0	74	74	1.0000000
NODE_1319_length_2027_cov_6.558610	276	356	0	80	80	1.0000000
NODE_1320_length_2026_cov_18.457706	688	768	0	80	80	1.0000000
NODE_1320_length_2026_cov_18.457706	741	821	0	80	80	1.0000000
NODE_1324_length_2025_cov_10.711319	617	697	0	36	80	0.4500000
NODE_1324_length_2025_cov_10.711319	617	697	2	44	80	0.5500000
NODE_1324_length_2025_cov_10.711319	712	783	0	36	71	0.5070422
NODE_1324_length_2025_cov_10.711319	712	783	2	35	71	0.4929577
NODE_1324_length_2025_cov_10.711319	756	829	0	73	73	1.0000000
NODE_1325_length_2024_cov_33.891948	1045	1125	0	80	80	1.0000000
NODE_1325_length_2024_cov_33.891948	1098	1178	0	80	80	1.0000000
NODE_1331_length_2018_cov_33.742053	1215	1295	198	2	80	0.0250000
NODE_1331_length_2018_cov_33.742053	1215	1295	200	1	80	0.0125000
NODE_1331_length_2018_cov_33.742053	1215	1295	203	1	80	0.0125000
NODE_1331_length_2018_cov_33.742053	1215	1295	206	1	80	0.0125000
NODE_1331_length_2018_cov_33.742053	1215	1295	210	2	80	0.0250000
NODE_1331_length_2018_cov_33.742053	1215	1295	212	1	80	0.0125000
NODE_1331_length_2018_cov_33.742053	1215	1295	223	1	80	0.0125000
NODE_1331_length_2018_cov_33.742053	1215	1295	229	1	80	0.0125000
NODE_1331_length_2018_cov_33.742053	1215	1295	231	2	80	0.0250000
NODE_1331_length_2018_cov_33.742053	1215	1295	239	1	80	0.0125000
NODE_1331_length_2018_cov_33.742053	1215	1295	244	1	80	0.0125000
NODE_1331_length_2018_cov_33.742053	1215	1295	249	1	80	0.0125000
NODE_1331_length_2018_cov_33.742053	1215	1295	253	1	80	0.0125000
NODE_1331_length_2018_cov_33.742053	1215	1295	255	1	80	0.0125000
NODE_1331_length_2018_cov_33.742053	1215	1295	257	2	80	0.0250000
NODE_1331_length_2018_cov_33.742053	1215	1295	263	1	80	0.0125000
NODE_1331_length_2018_cov_33.742053	1215	1295	271	1	80	0.0125000
NODE_1331_length_2018_cov_33.742053	1215	1295	273	2	80	0.0250000
NODE_1331_length_2018_cov_33.742053	1215	1295	276	2	80	0.0250000
NODE_1331_length_2018_cov_33.742053	1215	1295	279	1	80	0.0125000
NODE_1331_length_2018_cov_33.742053	1215	1295	280	1	80	0.0125000
NODE_1331_length_2018_cov_33.742053	1215	1295	281	1	80	0.0125000
NODE_1331_length_2018_cov_33.742053	1215	1295	284	1	80	0.0125000
NODE_1331_length_2018_cov_33.742053	1215	1295	285	2	80	0.0250000
NODE_1331_length_2018_cov_33.742053	1215	1295	286	1	80	0.0125000
NODE_1331_length_2018_cov_33.742053	1215	1295	295	2	80	0.0250000
NODE_1331_length_2018_cov_33.742053	1215	1295	297	2	80	0.0250000
NODE_1331_length_2018_cov_33.742053	1215	1295	303	1	80	0.0125000
NODE_1331_length_2018_cov_33.742053	1215	1295	310	1	80	0.0125000
NODE_1331_length_2018_cov_33.742053	1215	1295	313	1	80	0.0125000
NODE_1331_length_2018_cov_33.742053	1215	1295	314	2	80	0.0250000
NODE_1331_length_2018_cov_33.742053	1215	1295	316	1	80	0.0125000
NODE_1331_length_2018_cov_33.742053	1215	1295	317	1	80	0.0125000
NODE_1331_length_2018_cov_33.742053	1215	1295	318	1	80	0.0125000
NODE_1331_length_2018_cov_33.742053	1215	1295	320	1	80	0.0125000
NODE_1331_length_2018_cov_33.742053	1215	1295	325	4	80	0.0500000
NODE_1331_length_2018_cov_33.742053	1215	1295	327	2	80	0.0250000
NODE_1331_length_2018_cov_33.742053	1215	1295	328	1	80	0.0125000
NODE_1331_length_2018_cov_33.742053	1215	1295	329	1	80	0.0125000
NODE_1331_length_2018_cov_33.742053	1215	1295	331	3	80	0.0375000
NODE_1331_length_2018_cov_33.742053	1215	1295	332	2	80	0.0250000
NODE_1331_length_2018_cov_33.742053	1215	1295	333	8	80	0.1000000
NODE_1331_length_2018_cov_33.742053	1215	1295	334	3	80	0.0375000
NODE_1331_length_2018_cov_33.742053	1215	1295	335	6	80	0.0750000
NODE_1331_length_2018_cov_33.742053	1215	1295	336	4	80	0.0500000
NODE_1331_length_2018_cov_33.742053	1215	1295	338	1	80	0.0125000
NODE_1331_length_2018_cov_33.742053	1268	1298	325	3	30	0.1000000
NODE_1331_length_2018_cov_33.742053	1268	1298	326	1	30	0.0333333
NODE_1331_length_2018_cov_33.742053	1268	1298	327	3	30	0.1000000
NODE_1331_length_2018_cov_33.742053	1268	1298	330	1	30	0.0333333
NODE_1331_length_2018_cov_33.742053	1268	1298	331	1	30	0.0333333
NODE_1331_length_2018_cov_33.742053	1268	1298	333	8	30	0.2666667
NODE_1331_length_2018_cov_33.742053	1268	1298	334	2	30	0.0666667
NODE_1331_length_2018_cov_33.742053	1268	1298	335	6	30	0.2000000
NODE_1331_length_2018_cov_33.742053	1268	1298	336	4	30	0.1333333
NODE_1331_length_2018_cov_33.742053	1268	1298	338	1	30	0.0333333
NODE_1331_length_2018_cov_33.742053	1876	1942	179	1	66	0.0151515
NODE_1331_length_2018_cov_33.742053	1876	1942	191	1	66	0.0151515
NODE_1331_length_2018_cov_33.742053	1876	1942	194	1	66	0.0151515
NODE_1331_length_2018_cov_33.742053	1876	1942	198	1	66	0.0151515
NODE_1331_length_2018_cov_33.742053	1876	1942	200	1	66	0.0151515
NODE_1331_length_2018_cov_33.742053	1876	1942	206	1	66	0.0151515
NODE_1331_length_2018_cov_33.742053	1876	1942	211	1	66	0.0151515
NODE_1331_length_2018_cov_33.742053	1876	1942	220	2	66	0.0303030
NODE_1331_length_2018_cov_33.742053	1876	1942	222	1	66	0.0151515
NODE_1331_length_2018_cov_33.742053	1876	1942	230	1	66	0.0151515
NODE_1331_length_2018_cov_33.742053	1876	1942	258	1	66	0.0151515
NODE_1331_length_2018_cov_33.742053	1876	1942	262	1	66	0.0151515
NODE_1331_length_2018_cov_33.742053	1876	1942	265	2	66	0.0303030
NODE_1331_length_2018_cov_33.742053	1876	1942	281	1	66	0.0151515
NODE_1331_length_2018_cov_33.742053	1876	1942	285	1	66	0.0151515
NODE_1331_length_2018_cov_33.742053	1876	1942	286	1	66	0.0151515
NODE_1331_length_2018_cov_33.742053	1876	1942	287	3	66	0.0454545
NODE_1331_length_2018_cov_33.742053	1876	1942	288	2	66	0.0303030
NODE_1331_length_2018_cov_33.742053	1876	1942	289	1	66	0.0151515
NODE_1331_length_2018_cov_33.742053	1876	1942	295	1	66	0.0151515
NODE_1331_length_2018_cov_33.742053	1876	1942	297	1	66	0.0151515
NODE_1331_length_2018_cov_33.742053	1876	1942	305	1	66	0.0151515
NODE_1331_length_2018_cov_33.742053	1876	1942	307	1	66	0.0151515
NODE_1331_length_2018_cov_33.742053	1876	1942	322	1	66	0.0151515
NODE_1331_length_2018_cov_33.742053	1876	1942	326	1	66	0.0151515
NODE_1331_length_2018_cov_33.742053	1876	1942	327	1	66	0.0151515
NODE_1331_length_2018_cov_33.742053	1876	1942	328	1	66	0.0151515
NODE_1331_length_2018_cov_33.742053	1876	1942	333	1	66	0.0151515
NODE_1331_length_2018_cov_33.742053	1876	1942	337	1	66	0.0151515
NODE_1331_length_2018_cov_33.742053	1876	1942	347	1	66	0.0151515
NODE_1331_length_2018_cov_33.742053	1876	1942	348	1	66	0.0151515
NODE_1331_length_2018_cov_33.742053	1876	1942	358	1	66	0.0151515
NODE_1331_length_2018_cov_33.742053	1876	1942	372	1	66	0.0151515
NODE_1331_length_2018_cov_33.742053	1876	1942	400	1	66	0.0151515
NODE_1331_length_2018_cov_33.742053	1876	1942	401	1	66	0.0151515
NODE_1331_length_2018_cov_33.742053	1876	1942	406	1	66	0.0151515
NODE_1331_length_2018_cov_33.742053	1876	1942	412	1	66	0.0151515
NODE_1331_length_2018_cov_33.742053	1876	1942	414	1	66	0.0151515
NODE_1331_length_2018_cov_33.742053	1876	1942	417	1	66	0.0151515
NODE_1331_length_2018_cov_33.742053	1876	1942	421	1	66	0.0151515
NODE_1331_length_2018_cov_33.742053	1876	1942	428	1	66	0.0151515
NODE_1331_length_2018_cov_33.742053	1876	1942	440	1	66	0.0151515
NODE_1331_length_2018_cov_33.742053	1876	1942	459	1	66	0.0151515
NODE_1331_length_2018_cov_33.742053	1876	1942	463	1	66	0.0151515
NODE_1331_length_2018_cov_33.742053	1876	1942	467	1	66	0.0151515
NODE_1331_length_2018_cov_33.742053	1876	1942	469	1	66	0.0151515
NODE_1331_length_2018_cov_33.742053	1876	1942	473	1	66	0.0151515
NODE_1331_length_2018_cov_33.742053	1876	1942	483	2	66	0.0303030
NODE_1331_length_2018_cov_33.742053	1876	1942	487	1	66	0.0151515
NODE_1331_length_2018_cov_33.742053	1876	1942	490	1	66	0.0151515
NODE_1331_length_2018_cov_33.742053	1876	1942	497	1	66	0.0151515
NODE_1331_length_2018_cov_33.742053	1876	1942	501	1	66	0.0151515
NODE_1331_length_2018_cov_33.742053	1876	1942	502	1	66	0.0151515
NODE_1331_length_2018_cov_33.742053	1876	1942	503	1	66	0.0151515
NODE_1331_length_2018_cov_33.742053	1876	1942	504	1	66	0.0151515
NODE_1331_length_2018_cov_33.742053	1876	1942	507	1	66	0.0151515
NODE_1331_length_2018_cov_33.742053	1876	1942	508	1	66	0.0151515
NODE_1331_length_2018_cov_33.742053	1876	1942	514	1	66	0.0151515
NODE_1331_length_2018_cov_33.742053	1876	1942	516	1	66	0.0151515
NODE_1331_length_2018_cov_33.742053	1876	1942	522	1	66	0.0151515
NODE_1331_length_2018_cov_33.742053	1915	1995	14	4	80	0.0500000
NODE_1331_length_2018_cov_33.742053	1915	1995	17	1	80	0.0125000
NODE_1331_length_2018_cov_33.742053	1915	1995	22	1	80	0.0125000
NODE_1331_length_2018_cov_33.742053	1915	1995	23	3	80	0.0375000
NODE_1331_length_2018_cov_33.742053	1915	1995	25	1	80	0.0125000
NODE_1331_length_2018_cov_33.742053	1915	1995	27	1	80	0.0125000
NODE_1331_length_2018_cov_33.742053	1915	1995	29	2	80	0.0250000
NODE_1331_length_2018_cov_33.742053	1915	1995	30	1	80	0.0125000
NODE_1331_length_2018_cov_33.742053	1915	1995	33	1	80	0.0125000
NODE_1331_length_2018_cov_33.742053	1915	1995	41	1	80	0.0125000
NODE_1331_length_2018_cov_33.742053	1915	1995	42	1	80	0.0125000
NODE_1331_length_2018_cov_33.742053	1915	1995	43	2	80	0.0250000
NODE_1331_length_2018_cov_33.742053	1915	1995	46	1	80	0.0125000
NODE_1331_length_2018_cov_33.742053	1915	1995	48	1	80	0.0125000
NODE_1331_length_2018_cov_33.742053	1915	1995	53	1	80	0.0125000
NODE_1331_length_2018_cov_33.742053	1915	1995	56	1	80	0.0125000
NODE_1331_length_2018_cov_33.742053	1915	1995	59	1	80	0.0125000
NODE_1331_length_2018_cov_33.742053	1915	1995	62	1	80	0.0125000
NODE_1331_length_2018_cov_33.742053	1915	1995	67	2	80	0.0250000
NODE_1331_length_2018_cov_33.742053	1915	1995	71	1	80	0.0125000
NODE_1331_length_2018_cov_33.742053	1915	1995	74	1	80	0.0125000
NODE_1331_length_2018_cov_33.742053	1915	1995	80	1	80	0.0125000
NODE_1331_length_2018_cov_33.742053	1915	1995	83	1	80	0.0125000
NODE_1331_length_2018_cov_33.742053	1915	1995	88	1	80	0.0125000
NODE_1331_length_2018_cov_33.742053	1915	1995	107	1	80	0.0125000
NODE_1331_length_2018_cov_33.742053	1915	1995	113	1	80	0.0125000
NODE_1331_length_2018_cov_33.742053	1915	1995	118	1	80	0.0125000
NODE_1331_length_2018_cov_33.742053	1915	1995	122	1	80	0.0125000
NODE_1331_length_2018_cov_33.742053	1915	1995	127	1	80	0.0125000
NODE_1331_length_2018_cov_33.742053	1915	1995	129	1	80	0.0125000
NODE_1331_length_2018_cov_33.742053	1915	1995	136	1	80	0.0125000
NODE_1331_length_2018_cov_33.742053	1915	1995	140	1	80	0.0125000
NODE_1331_length_2018_cov_33.742053	1915	1995	142	1	80	0.0125000
NODE_1331_length_2018_cov_33.742053	1915	1995	146	2	80	0.0250000
NODE_1331_length_2018_cov_33.742053	1915	1995	150	1	80	0.0125000
NODE_1331_length_2018_cov_33.742053	1915	1995	154	1	80	0.0125000
NODE_1331_length_2018_cov_33.742053	1915	1995	160	1	80	0.0125000
NODE_1331_length_2018_cov_33.742053	1915	1995	163	1	80	0.0125000
NODE_1331_length_2018_cov_33.742053	1915	1995	164	1	80	0.0125000
NODE_1331_length_2018_cov_33.742053	1915	1995	169	3	80	0.0375000
NODE_1331_length_2018_cov_33.742053	1915	1995	173	2	80	0.0250000
NODE_1331_length_2018_cov_33.742053	1915	1995	179	1	80	0.0125000
NODE_1331_length_2018_cov_33.742053	1915	1995	191	1	80	0.0125000
NODE_1331_length_2018_cov_33.742053	1915	1995	194	1	80	0.0125000
NODE_1331_length_2018_cov_33.742053	1915	1995	198	1	80	0.0125000
NODE_1331_length_2018_cov_33.742053	1915	1995	200	1	80	0.0125000
NODE_1331_length_2018_cov_33.742053	1915	1995	206	1	80	0.0125000
NODE_1331_length_2018_cov_33.742053	1915	1995	211	1	80	0.0125000
NODE_1331_length_2018_cov_33.742053	1915	1995	220	2	80	0.0250000
NODE_1331_length_2018_cov_33.742053	1915	1995	222	1	80	0.0125000
NODE_1331_length_2018_cov_33.742053	1915	1995	230	1	80	0.0125000
NODE_1331_length_2018_cov_33.742053	1915	1995	258	1	80	0.0125000
NODE_1331_length_2018_cov_33.742053	1915	1995	262	1	80	0.0125000
NODE_1331_length_2018_cov_33.742053	1915	1995	265	2	80	0.0250000
NODE_1331_length_2018_cov_33.742053	1915	1995	281	1	80	0.0125000
NODE_1331_length_2018_cov_33.742053	1915	1995	285	1	80	0.0125000
NODE_1331_length_2018_cov_33.742053	1915	1995	286	1	80	0.0125000
NODE_1331_length_2018_cov_33.742053	1915	1995	287	3	80	0.0375000
NODE_1331_length_2018_cov_33.742053	1915	1995	288	2	80	0.0250000
NODE_1331_length_2018_cov_33.742053	1915	1995	289	1	80	0.0125000
NODE_1331_length_2018_cov_33.742053	1915	1995	295	1	80	0.0125000
NODE_1331_length_2018_cov_33.742053	1915	1995	297	1	80	0.0125000
NODE_1331_length_2018_cov_33.742053	1915	1995	305	1	80	0.0125000
NODE_1337_length_2011_cov_22.430439	434	514	0	80	80	1.0000000
NODE_1337_length_2011_cov_22.430439	487	567	0	80	80	1.0000000
NODE_1337_length_2011_cov_22.430439	1124	1204	0	80	80	1.0000000
NODE_1337_length_2011_cov_22.430439	1177	1257	0	80	80	1.0000000
NODE_1343_length_2001_cov_10.416404	692	772	0	80	80	1.0000000
NODE_1343_length_2001_cov_10.416404	745	825	0	80	80	1.0000000
NODE_1350_length_1991_cov_112.926533	212	292	123	10	80	0.1250000
NODE_1350_length_1991_cov_112.926533	212	292	128	2	80	0.0250000
NODE_1350_length_1991_cov_112.926533	212	292	129	13	80	0.1625000
NODE_1350_length_1991_cov_112.926533	212	292	130	1	80	0.0125000
NODE_1350_length_1991_cov_112.926533	212	292	131	9	80	0.1125000
NODE_1350_length_1991_cov_112.926533	212	292	132	1	80	0.0125000
NODE_1350_length_1991_cov_112.926533	212	292	133	1	80	0.0125000
NODE_1350_length_1991_cov_112.926533	212	292	137	1	80	0.0125000
NODE_1350_length_1991_cov_112.926533	212	292	138	1	80	0.0125000
NODE_1350_length_1991_cov_112.926533	212	292	139	10	80	0.1250000
NODE_1350_length_1991_cov_112.926533	212	292	140	1	80	0.0125000
NODE_1350_length_1991_cov_112.926533	212	292	141	7	80	0.0875000
NODE_1350_length_1991_cov_112.926533	212	292	142	2	80	0.0250000
NODE_1350_length_1991_cov_112.926533	212	292	144	4	80	0.0500000
NODE_1350_length_1991_cov_112.926533	212	292	145	6	80	0.0750000
NODE_1350_length_1991_cov_112.926533	212	292	146	1	80	0.0125000
NODE_1350_length_1991_cov_112.926533	212	292	147	9	80	0.1125000
NODE_1350_length_1991_cov_112.926533	212	292	149	1	80	0.0125000
NODE_1352_length_1988_cov_13.736368	865	945	0	80	80	1.0000000
NODE_1352_length_1988_cov_13.736368	918	998	0	80	80	1.0000000
NODE_1353_length_1988_cov_9.980413	1616	1696	0	80	80	1.0000000
NODE_1353_length_1988_cov_9.980413	1669	1749	0	80	80	1.0000000
NODE_1356_length_1983_cov_17.332803	494	574	0	80	80	1.0000000
NODE_1356_length_1983_cov_17.332803	547	627	0	63	80	0.7875000
NODE_1356_length_1983_cov_17.332803	547	627	2	17	80	0.2125000
NODE_1356_length_1983_cov_17.332803	1600	1680	0	80	80	1.0000000
NODE_1356_length_1983_cov_17.332803	1653	1733	0	80	80	1.0000000
NODE_1359_length_1982_cov_17.164100	457	537	0	80	80	1.0000000
NODE_1359_length_1982_cov_17.164100	510	590	0	80	80	1.0000000
NODE_1359_length_1982_cov_17.164100	586	666	0	80	80	1.0000000
NODE_1359_length_1982_cov_17.164100	639	723	0	84	84	1.0000000
NODE_1360_length_1981_cov_46.444208	0	70	0	70	70	1.0000000
NODE_1362_length_1979_cov_1.630851	1554	1634	0	80	80	1.0000000
NODE_1364_length_1976_cov_1.959510	154	215	0	61	61	1.0000000
NODE_1364_length_1976_cov_1.959510	154	215	0	61	61	1.0000000
NODE_1364_length_1976_cov_1.959510	154	213	0	59	59	1.0000000
NODE_1365_length_1974_cov_8.058133	617	697	2	1	80	0.0125000
NODE_1365_length_1974_cov_8.058133	617	697	4	79	80	0.9875000
NODE_1365_length_1974_cov_8.058133	670	750	0	35	80	0.4375000
NODE_1365_length_1974_cov_8.058133	670	750	2	19	80	0.2375000
NODE_1365_length_1974_cov_8.058133	670	750	4	26	80	0.3250000
NODE_1366_length_1973_cov_14.885272	640	726	0	48	86	0.5581396
NODE_1366_length_1973_cov_14.885272	640	726	2	38	86	0.4418605
NODE_1366_length_1973_cov_14.885272	699	779	0	29	80	0.3625000
NODE_1366_length_1973_cov_14.885272	699	779	2	51	80	0.6375000
NODE_1366_length_1973_cov_14.885272	1389	1469	0	80	80	1.0000000
NODE_1366_length_1973_cov_14.885272	1442	1522	0	67	80	0.8375000
NODE_1366_length_1973_cov_14.885272	1442	1522	2	13	80	0.1625000
NODE_1372_length_1971_cov_3.126068	1662	1742	18	8	80	0.1000000
NODE_1372_length_1971_cov_3.126068	1662	1742	20	6	80	0.0750000
NODE_1372_length_1971_cov_3.126068	1662	1742	27	4	80	0.0500000
NODE_1372_length_1971_cov_3.126068	1662	1742	29	4	80	0.0500000
NODE_1372_length_1971_cov_3.126068	1662	1742	34	11	80	0.1375000
NODE_1372_length_1971_cov_3.126068	1662	1742	35	1	80	0.0125000
NODE_1372_length_1971_cov_3.126068	1662	1742	36	27	80	0.3375000
NODE_1372_length_1971_cov_3.126068	1662	1742	37	6	80	0.0750000
NODE_1372_length_1971_cov_3.126068	1662	1742	38	3	80	0.0375000
NODE_1372_length_1971_cov_3.126068	1662	1742	39	10	80	0.1250000
NODE_1372_length_1971_cov_3.126068	1715	1799	20	1	84	0.0119048
NODE_1372_length_1971_cov_3.126068	1715	1799	22	9	84	0.1071429
NODE_1372_length_1971_cov_3.126068	1715	1799	24	15	84	0.1785714
NODE_1372_length_1971_cov_3.126068	1715	1799	26	4	84	0.0476190
NODE_1372_length_1971_cov_3.126068	1715	1799	28	3	84	0.0357143
NODE_1372_length_1971_cov_3.126068	1715	1799	30	8	84	0.0952381
NODE_1372_length_1971_cov_3.126068	1715	1799	32	14	84	0.1666667
NODE_1372_length_1971_cov_3.126068	1715	1799	34	14	84	0.1666667
NODE_1372_length_1971_cov_3.126068	1715	1799	36	16	84	0.1904762
NODE_1386_length_1962_cov_23.774557	281	311	0	15	30	0.5000000
NODE_1386_length_1962_cov_23.774557	281	311	2	15	30	0.5000000
NODE_1386_length_1962_cov_23.774557	329	355	0	26	26	1.0000000
NODE_1386_length_1962_cov_23.774557	408	487	0	79	79	1.0000000
NODE_1386_length_1962_cov_23.774557	460	540	0	80	80	1.0000000
NODE_1386_length_1962_cov_23.774557	1417	1497	0	80	80	1.0000000
NODE_1386_length_1962_cov_23.774557	1470	1550	0	80	80	1.0000000
NODE_1386_length_1962_cov_23.774557	1607	1640	0	33	33	1.0000000
NODE_1395_length_1953_cov_26.183927	1	81	0	9	80	0.1125000
NODE_1395_length_1953_cov_26.183927	1	81	4	2	80	0.0250000
NODE_1395_length_1953_cov_26.183927	1	81	7	13	80	0.1625000
NODE_1395_length_1953_cov_26.183927	1	81	9	12	80	0.1500000
NODE_1395_length_1953_cov_26.183927	1	81	13	30	80	0.3750000
NODE_1395_length_1953_cov_26.183927	1	81	14	14	80	0.1750000
NODE_1395_length_1953_cov_26.183927	6	28	0	4	22	0.1818182
NODE_1395_length_1953_cov_26.183927	6	28	4	2	22	0.0909091
NODE_1395_length_1953_cov_26.183927	6	28	7	13	22	0.5909091
NODE_1395_length_1953_cov_26.183927	6	28	9	3	22	0.1363636
NODE_1395_length_1953_cov_26.183927	152	232	0	76	80	0.9500000
NODE_1395_length_1953_cov_26.183927	152	232	1	4	80	0.0500000
NODE_1395_length_1953_cov_26.183927	205	257	0	23	52	0.4423077
NODE_1395_length_1953_cov_26.183927	205	257	1	28	52	0.5384616
NODE_1395_length_1953_cov_26.183927	205	257	3	1	52	0.0192308
NODE_1405_length_1943_cov_11.218547	516	596	0	80	80	1.0000000
NODE_1405_length_1943_cov_11.218547	569	649	0	80	80	1.0000000
NODE_1408_length_1941_cov_14.407709	891	921	0	30	30	1.0000000
NODE_1408_length_1941_cov_14.407709	894	964	0	70	70	1.0000000
NODE_1408_length_1941_cov_14.407709	1878	1941	0	63	63	1.0000000
NODE_1409_length_1941_cov_9.632465	139	213	0	74	74	1.0000000
NODE_1409_length_1941_cov_9.632465	139	219	0	80	80	1.0000000
NODE_1409_length_1941_cov_9.632465	139	194	0	55	55	1.0000000
NODE_1409_length_1941_cov_9.632465	192	272	0	80	80	1.0000000
NODE_1414_length_1936_cov_13.338596	679	759	0	80	80	1.0000000
NODE_1414_length_1936_cov_13.338596	732	812	0	80	80	1.0000000
NODE_1414_length_1936_cov_13.338596	738	812	0	74	74	1.0000000
NODE_1414_length_1936_cov_13.338596	738	759	0	21	21	1.0000000
NODE_1415_length_1936_cov_12.592814	102	153	0	28	51	0.5490196
NODE_1415_length_1936_cov_12.592814	102	153	2	23	51	0.4509804
NODE_1415_length_1936_cov_12.592814	154	230	0	5	76	0.0657895
NODE_1415_length_1936_cov_12.592814	154	230	4	5	76	0.0657895
NODE_1415_length_1936_cov_12.592814	154	230	6	2	76	0.0263158
NODE_1415_length_1936_cov_12.592814	154	230	8	2	76	0.0263158
NODE_1415_length_1936_cov_12.592814	154	230	10	50	76	0.6578947
NODE_1415_length_1936_cov_12.592814	154	230	14	12	76	0.1578947
NODE_1415_length_1936_cov_12.592814	211	251	8	13	40	0.3250000
NODE_1415_length_1936_cov_12.592814	211	251	10	15	40	0.3750000
NODE_1415_length_1936_cov_12.592814	211	251	14	12	40	0.3000000
NODE_1416_length_1933_cov_86.724646	1044	1124	0	1	80	0.0125000
NODE_1416_length_1933_cov_86.724646	1044	1124	3	79	80	0.9875000
NODE_1416_length_1933_cov_86.724646	1097	1177	0	10	80	0.1250000
NODE_1416_length_1933_cov_86.724646	1097	1177	3	70	80	0.8750000
NODE_1416_length_1933_cov_86.724646	1173	1253	3	80	80	1.0000000
NODE_1416_length_1933_cov_86.724646	1226	1306	2	23	80	0.2875000
NODE_1416_length_1933_cov_86.724646	1226	1306	3	56	80	0.7000000
NODE_1416_length_1933_cov_86.724646	1226	1306	5	1	80	0.0125000
NODE_1419_length_1932_cov_5.905074	1534	1614	0	80	80	1.0000000
NODE_1422_length_1930_cov_3.005461	1700	1780	60	4	80	0.0500000
NODE_1422_length_1930_cov_3.005461	1700	1780	62	6	80	0.0750000
NODE_1422_length_1930_cov_3.005461	1700	1780	63	2	80	0.0250000
NODE_1422_length_1930_cov_3.005461	1700	1780	64	6	80	0.0750000
NODE_1422_length_1930_cov_3.005461	1700	1780	66	7	80	0.0875000
NODE_1422_length_1930_cov_3.005461	1700	1780	68	55	80	0.6875000
NODE_1427_length_1928_cov_2.580098	74	131	30	16	57	0.2807018
NODE_1427_length_1928_cov_2.580098	74	131	32	12	57	0.2105263
NODE_1427_length_1928_cov_2.580098	74	131	34	29	57	0.5087720
NODE_1427_length_1928_cov_2.580098	127	184	13	1	57	0.0175439
NODE_1427_length_1928_cov_2.580098	127	184	15	12	57	0.2105263
NODE_1427_length_1928_cov_2.580098	127	184	17	7	57	0.1228070
NODE_1427_length_1928_cov_2.580098	127	184	21	1	57	0.0175439
NODE_1427_length_1928_cov_2.580098	127	184	24	10	57	0.1754386
NODE_1427_length_1928_cov_2.580098	127	184	26	22	57	0.3859649
NODE_1427_length_1928_cov_2.580098	127	184	30	4	57	0.0701754
NODE_1434_length_1919_cov_17.901099	454	529	2	9	75	0.1200000
NODE_1434_length_1919_cov_17.901099	454	529	8	66	75	0.8800000
NODE_1434_length_1919_cov_17.901099	507	558	4	2	51	0.0392157
NODE_1434_length_1919_cov_17.901099	507	558	6	15	51	0.2941177
NODE_1434_length_1919_cov_17.901099	507	558	8	33	51	0.6470588
NODE_1434_length_1919_cov_17.901099	507	558	11	1	51	0.0196078
NODE_1436_length_1918_cov_14.876855	314	396	6	43	82	0.5243902
NODE_1436_length_1918_cov_14.876855	314	396	10	39	82	0.4756097
NODE_1438_length_1918_cov_3.493128	9	55	0	4	46	0.0869565
NODE_1438_length_1918_cov_3.493128	9	55	5	12	46	0.2608696
NODE_1438_length_1918_cov_3.493128	9	55	6	6	46	0.1304348
NODE_1438_length_1918_cov_3.493128	9	55	7	1	46	0.0217391
NODE_1438_length_1918_cov_3.493128	9	55	9	2	46	0.0434783
NODE_1438_length_1918_cov_3.493128	9	55	10	5	46	0.1086956
NODE_1438_length_1918_cov_3.493128	9	55	14	16	46	0.3478261
NODE_1438_length_1918_cov_3.493128	1480	1561	2	81	81	1.0000000
NODE_1440_length_1916_cov_4.426527	162	192	9	19	30	0.6333333
NODE_1440_length_1916_cov_4.426527	162	192	10	11	30	0.3666667
NODE_1442_length_1915_cov_35.787996	106	186	10	2	80	0.0250000
NODE_1442_length_1915_cov_35.787996	106	186	16	2	80	0.0250000
NODE_1442_length_1915_cov_35.787996	106	186	18	1	80	0.0125000
NODE_1442_length_1915_cov_35.787996	106	186	20	3	80	0.0375000
NODE_1442_length_1915_cov_35.787996	106	186	22	7	80	0.0875000
NODE_1442_length_1915_cov_35.787996	106	186	24	3	80	0.0375000
NODE_1442_length_1915_cov_35.787996	106	186	26	2	80	0.0250000
NODE_1442_length_1915_cov_35.787996	106	186	30	1	80	0.0125000
NODE_1442_length_1915_cov_35.787996	106	186	34	3	80	0.0375000
NODE_1442_length_1915_cov_35.787996	106	186	36	7	80	0.0875000
NODE_1442_length_1915_cov_35.787996	106	186	40	1	80	0.0125000
NODE_1442_length_1915_cov_35.787996	106	186	42	7	80	0.0875000
NODE_1442_length_1915_cov_35.787996	106	186	45	1	80	0.0125000
NODE_1442_length_1915_cov_35.787996	106	186	46	2	80	0.0250000
NODE_1442_length_1915_cov_35.787996	106	186	48	6	80	0.0750000
NODE_1442_length_1915_cov_35.787996	106	186	49	3	80	0.0375000
NODE_1442_length_1915_cov_35.787996	106	186	50	9	80	0.1125000
NODE_1442_length_1915_cov_35.787996	106	186	51	20	80	0.2500000
NODE_1451_length_1905_cov_18.464563	740	820	0	80	80	1.0000000
NODE_1451_length_1905_cov_18.464563	793	873	0	80	80	1.0000000
NODE_1451_length_1905_cov_18.464563	869	949	0	80	80	1.0000000
NODE_1451_length_1905_cov_18.464563	922	1010	0	88	88	1.0000000
NODE_1452_length_1905_cov_7.197121	596	676	0	80	80	1.0000000
NODE_1452_length_1905_cov_7.197121	649	682	0	33	33	1.0000000
NODE_1455_length_1902_cov_1.633943	1728	1792	8	2	64	0.0312500
NODE_1455_length_1902_cov_1.633943	1728	1792	12	1	64	0.0156250
NODE_1455_length_1902_cov_1.633943	1728	1792	14	4	64	0.0625000
NODE_1455_length_1902_cov_1.633943	1728	1792	18	7	64	0.1093750
NODE_1455_length_1902_cov_1.633943	1728	1792	19	6	64	0.0937500
NODE_1455_length_1902_cov_1.633943	1728	1792	23	6	64	0.0937500
NODE_1455_length_1902_cov_1.633943	1728	1792	25	3	64	0.0468750
NODE_1455_length_1902_cov_1.633943	1728	1792	26	8	64	0.1250000
NODE_1455_length_1902_cov_1.633943	1728	1792	28	5	64	0.0781250
NODE_1455_length_1902_cov_1.633943	1728	1792	32	11	64	0.1718750
NODE_1455_length_1902_cov_1.633943	1728	1792	34	5	64	0.0781250
NODE_1455_length_1902_cov_1.633943	1728	1792	36	6	64	0.0937500
NODE_1458_length_1900_cov_1.081066	1805	1851	2	46	46	1.0000000
NODE_1458_length_1900_cov_1.081066	1824	1900	0	45	76	0.5921053
NODE_1458_length_1900_cov_1.081066	1824	1900	2	31	76	0.4078947
NODE_1461_length_1895_cov_17.940980	1070	1150	4	56	80	0.7000000
NODE_1461_length_1895_cov_17.940980	1070	1150	5	24	80	0.3000000
NODE_1461_length_1895_cov_17.940980	1123	1203	1	19	80	0.2375000
NODE_1461_length_1895_cov_17.940980	1123	1203	2	32	80	0.4000000
NODE_1461_length_1895_cov_17.940980	1123	1203	4	3	80	0.0375000
NODE_1461_length_1895_cov_17.940980	1123	1203	5	26	80	0.3250000
NODE_1466_length_1893_cov_3.299331	918	998	0	80	80	1.0000000
NODE_1467_length_1892_cov_5.158394	317	397	0	80	80	1.0000000
NODE_1467_length_1892_cov_5.158394	370	445	0	75	75	1.0000000
NODE_1469_length_1889_cov_4.049162	1652	1686	0	34	34	1.0000000
NODE_1470_length_1889_cov_3.888268	960	1040	0	80	80	1.0000000
NODE_1470_length_1889_cov_3.888268	1013	1093	0	80	80	1.0000000
NODE_1472_length_1888_cov_17.106764	15	96	21	1	81	0.0123457
NODE_1472_length_1888_cov_17.106764	15	96	22	1	81	0.0123457
NODE_1472_length_1888_cov_17.106764	15	96	24	4	81	0.0493827
NODE_1472_length_1888_cov_17.106764	15	96	28	1	81	0.0123457
NODE_1472_length_1888_cov_17.106764	15	96	32	1	81	0.0123457
NODE_1472_length_1888_cov_17.106764	15	96	34	2	81	0.0246914
NODE_1472_length_1888_cov_17.106764	15	96	38	1	81	0.0123457
NODE_1472_length_1888_cov_17.106764	15	96	39	3	81	0.0370370
NODE_1472_length_1888_cov_17.106764	15	96	40	14	81	0.1728395
NODE_1472_length_1888_cov_17.106764	15	96	41	14	81	0.1728395
NODE_1472_length_1888_cov_17.106764	15	96	47	30	81	0.3703704
NODE_1472_length_1888_cov_17.106764	15	96	48	6	81	0.0740741
NODE_1472_length_1888_cov_17.106764	15	96	49	2	81	0.0246914
NODE_1472_length_1888_cov_17.106764	15	96	51	1	81	0.0123457
NODE_1472_length_1888_cov_17.106764	68	143	14	4	75	0.0533333
NODE_1472_length_1888_cov_17.106764	68	143	16	8	75	0.1066667
NODE_1472_length_1888_cov_17.106764	68	143	22	7	75	0.0933333
NODE_1472_length_1888_cov_17.106764	68	143	27	1	75	0.0133333
NODE_1472_length_1888_cov_17.106764	68	143	28	1	75	0.0133333
NODE_1472_length_1888_cov_17.106764	68	143	30	2	75	0.0266667
NODE_1472_length_1888_cov_17.106764	68	143	35	3	75	0.0400000
NODE_1472_length_1888_cov_17.106764	68	143	36	3	75	0.0400000
NODE_1472_length_1888_cov_17.106764	68	143	39	2	75	0.0266667
NODE_1472_length_1888_cov_17.106764	68	143	45	2	75	0.0266667
NODE_1472_length_1888_cov_17.106764	68	143	47	19	75	0.2533333
NODE_1472_length_1888_cov_17.106764	68	143	48	7	75	0.0933333
NODE_1472_length_1888_cov_17.106764	68	143	49	3	75	0.0400000
NODE_1472_length_1888_cov_17.106764	68	143	51	13	75	0.1733333
NODE_1477_length_1885_cov_4.439530	441	521	0	80	80	1.0000000
NODE_1477_length_1885_cov_4.439530	494	574	0	80	80	1.0000000
NODE_1483_length_1882_cov_5.884464	1499	1579	0	80	80	1.0000000
NODE_1483_length_1882_cov_5.884464	1552	1632	0	80	80	1.0000000
NODE_1493_length_1875_cov_3.974662	1650	1730	12	6	80	0.0750000
NODE_1493_length_1875_cov_3.974662	1650	1730	13	4	80	0.0500000
NODE_1493_length_1875_cov_3.974662	1650	1730	14	7	80	0.0875000
NODE_1493_length_1875_cov_3.974662	1650	1730	15	3	80	0.0375000
NODE_1493_length_1875_cov_3.974662	1650	1730	21	1	80	0.0125000
NODE_1493_length_1875_cov_3.974662	1650	1730	22	19	80	0.2375000
NODE_1493_length_1875_cov_3.974662	1650	1730	23	20	80	0.2500000
NODE_1493_length_1875_cov_3.974662	1650	1730	24	13	80	0.1625000
NODE_1493_length_1875_cov_3.974662	1650	1730	26	2	80	0.0250000
NODE_1493_length_1875_cov_3.974662	1650	1730	27	5	80	0.0625000
NODE_1497_length_1872_cov_21.355330	153	201	0	48	48	1.0000000
NODE_1503_length_1868_cov_96.046919	1018	1098	5	11	80	0.1375000
NODE_1503_length_1868_cov_96.046919	1018	1098	7	26	80	0.3250000
NODE_1503_length_1868_cov_96.046919	1018	1098	15	6	80	0.0750000
NODE_1503_length_1868_cov_96.046919	1018	1098	19	23	80	0.2875000
NODE_1503_length_1868_cov_96.046919	1018	1098	23	3	80	0.0375000
NODE_1503_length_1868_cov_96.046919	1018	1098	25	5	80	0.0625000
NODE_1503_length_1868_cov_96.046919	1018	1098	27	6	80	0.0750000
NODE_1503_length_1868_cov_96.046919	1071	1151	19	13	80	0.1625000
NODE_1503_length_1868_cov_96.046919	1071	1151	21	2	80	0.0250000
NODE_1503_length_1868_cov_96.046919	1071	1151	23	3	80	0.0375000
NODE_1503_length_1868_cov_96.046919	1071	1151	24	6	80	0.0750000
NODE_1503_length_1868_cov_96.046919	1071	1151	25	5	80	0.0625000
NODE_1503_length_1868_cov_96.046919	1071	1151	27	13	80	0.1625000
NODE_1503_length_1868_cov_96.046919	1071	1151	28	5	80	0.0625000
NODE_1503_length_1868_cov_96.046919	1071	1151	29	10	80	0.1250000
NODE_1503_length_1868_cov_96.046919	1071	1151	32	12	80	0.1500000
NODE_1503_length_1868_cov_96.046919	1071	1151	33	11	80	0.1375000
NODE_1508_length_1866_cov_53.869270	1149	1229	0	80	80	1.0000000
NODE_1508_length_1866_cov_53.869270	1202	1282	0	80	80	1.0000000
NODE_1508_length_1866_cov_53.869270	1278	1358	0	80	80	1.0000000
NODE_1508_length_1866_cov_53.869270	1331	1411	0	80	80	1.0000000
NODE_1510_length_1866_cov_3.347482	888	966	0	78	78	1.0000000
NODE_1510_length_1866_cov_3.347482	939	1019	0	80	80	1.0000000
NODE_1513_length_1863_cov_11.265306	698	778	0	80	80	1.0000000
NODE_1513_length_1863_cov_11.265306	751	831	0	80	80	1.0000000
NODE_1518_length_1858_cov_19.019329	23	85	0	62	62	1.0000000
NODE_1518_length_1858_cov_19.019329	1125	1205	0	80	80	1.0000000
NODE_1518_length_1858_cov_19.019329	1178	1256	0	78	78	1.0000000
NODE_1518_length_1858_cov_19.019329	1387	1464	0	77	77	1.0000000
NODE_1518_length_1858_cov_19.019329	1440	1503	0	63	63	1.0000000
NODE_1519_length_1857_cov_18.402730	1282	1348	18	37	66	0.5606061
NODE_1519_length_1857_cov_18.402730	1282	1348	20	29	66	0.4393939
NODE_1519_length_1857_cov_18.402730	1321	1401	2	42	80	0.5250000
NODE_1519_length_1857_cov_18.402730	1321	1401	8	2	80	0.0250000
NODE_1519_length_1857_cov_18.402730	1321	1401	16	1	80	0.0125000
NODE_1519_length_1857_cov_18.402730	1321	1401	18	27	80	0.3375000
NODE_1519_length_1857_cov_18.402730	1321	1401	20	8	80	0.1000000
NODE_1519_length_1857_cov_18.402730	1397	1477	0	61	80	0.7625000
NODE_1519_length_1857_cov_18.402730	1397	1477	2	19	80	0.2375000
NODE_1519_length_1857_cov_18.402730	1450	1530	0	80	80	1.0000000
NODE_1531_length_1845_cov_12.653494	473	553	6	80	80	1.0000000
NODE_1531_length_1845_cov_12.653494	526	606	0	7	80	0.0875000
NODE_1531_length_1845_cov_12.653494	526	606	3	17	80	0.2125000
NODE_1531_length_1845_cov_12.653494	526	606	6	56	80	0.7000000
NODE_1546_length_1833_cov_31.337947	810	888	0	57	78	0.7307692
NODE_1546_length_1833_cov_31.337947	810	888	2	21	78	0.2692308
NODE_1546_length_1833_cov_31.337947	861	941	0	6	80	0.0750000
NODE_1546_length_1833_cov_31.337947	861	941	2	22	80	0.2750000
NODE_1546_length_1833_cov_31.337947	861	941	4	7	80	0.0875000
NODE_1546_length_1833_cov_31.337947	861	941	6	45	80	0.5625000
NODE_1546_length_1833_cov_31.337947	937	1017	0	20	80	0.2500000
NODE_1546_length_1833_cov_31.337947	937	1017	2	41	80	0.5125000
NODE_1546_length_1833_cov_31.337947	937	1017	4	19	80	0.2375000
NODE_1546_length_1833_cov_31.337947	990	1070	0	47	80	0.5875000
NODE_1546_length_1833_cov_31.337947	990	1070	2	33	80	0.4125000
NODE_1550_length_1831_cov_3.065820	112	154	6	4	42	0.0952381
NODE_1550_length_1831_cov_3.065820	112	154	14	1	42	0.0238095
NODE_1550_length_1831_cov_3.065820	112	154	18	6	42	0.1428571
NODE_1550_length_1831_cov_3.065820	112	154	24	2	42	0.0476190
NODE_1550_length_1831_cov_3.065820	112	154	28	8	42	0.1904762
NODE_1550_length_1831_cov_3.065820	112	154	30	1	42	0.0238095
NODE_1550_length_1831_cov_3.065820	112	154	32	1	42	0.0238095
NODE_1550_length_1831_cov_3.065820	112	154	34	1	42	0.0238095
NODE_1550_length_1831_cov_3.065820	112	154	36	2	42	0.0476190
NODE_1550_length_1831_cov_3.065820	112	154	40	8	42	0.1904762
NODE_1550_length_1831_cov_3.065820	112	154	46	8	42	0.1904762
NODE_1553_length_1830_cov_2.512998	123	203	0	80	80	1.0000000
NODE_1553_length_1830_cov_2.512998	176	256	0	80	80	1.0000000
NODE_1553_length_1830_cov_2.512998	308	357	4	49	49	1.0000000
NODE_1554_length_1828_cov_40.437825	789	869	0	22	80	0.2750000
NODE_1554_length_1828_cov_40.437825	789	869	2	58	80	0.7250000
NODE_1554_length_1828_cov_40.437825	842	922	0	19	80	0.2375000
NODE_1554_length_1828_cov_40.437825	842	922	2	61	80	0.7625000
NODE_1554_length_1828_cov_40.437825	918	998	2	80	80	1.0000000
NODE_1554_length_1828_cov_40.437825	971	1051	0	22	80	0.2750000
NODE_1554_length_1828_cov_40.437825	971	1051	2	58	80	0.7250000
NODE_1559_length_1825_cov_6.652955	641	689	0	48	48	1.0000000
NODE_1559_length_1825_cov_6.652955	694	744	0	50	50	1.0000000
NODE_1562_length_1824_cov_10.152464	685	765	6	30	80	0.3750000
NODE_1562_length_1824_cov_10.152464	685	765	10	2	80	0.0250000
NODE_1562_length_1824_cov_10.152464	685	765	14	1	80	0.0125000
NODE_1562_length_1824_cov_10.152464	685	765	18	1	80	0.0125000
NODE_1562_length_1824_cov_10.152464	685	765	19	1	80	0.0125000
NODE_1562_length_1824_cov_10.152464	685	765	20	35	80	0.4375000
NODE_1562_length_1824_cov_10.152464	685	765	22	2	80	0.0250000
NODE_1562_length_1824_cov_10.152464	685	765	24	3	80	0.0375000
NODE_1562_length_1824_cov_10.152464	685	765	26	3	80	0.0375000
NODE_1562_length_1824_cov_10.152464	685	765	28	2	80	0.0250000
NODE_1562_length_1824_cov_10.152464	738	818	14	16	80	0.2000000
NODE_1562_length_1824_cov_10.152464	738	818	18	2	80	0.0250000
NODE_1562_length_1824_cov_10.152464	738	818	20	38	80	0.4750000
NODE_1562_length_1824_cov_10.152464	738	818	22	7	80	0.0875000
NODE_1562_length_1824_cov_10.152464	738	818	24	12	80	0.1500000
NODE_1562_length_1824_cov_10.152464	738	818	26	3	80	0.0375000
NODE_1562_length_1824_cov_10.152464	738	818	28	2	80	0.0250000
NODE_1562_length_1824_cov_10.152464	1412	1433	0	21	21	1.0000000
NODE_1564_length_1821_cov_7.682346	953	1033	0	80	80	1.0000000
NODE_1564_length_1821_cov_7.682346	1006	1086	0	80	80	1.0000000
NODE_1566_length_1820_cov_12.061592	477	557	0	80	80	1.0000000
NODE_1566_length_1820_cov_12.061592	530	610	0	80	80	1.0000000
NODE_1566_length_1820_cov_12.061592	1232	1312	0	80	80	1.0000000
NODE_1566_length_1820_cov_12.061592	1285	1365	0	80	80	1.0000000
NODE_1572_length_1817_cov_8.302095	63	122	0	30	59	0.5084746
NODE_1572_length_1817_cov_8.302095	63	122	2	29	59	0.4915254
NODE_1572_length_1817_cov_8.302095	1195	1275	4	80	80	1.0000000
NODE_1572_length_1817_cov_8.302095	1248	1328	0	38	80	0.4750000
NODE_1572_length_1817_cov_8.302095	1248	1328	4	42	80	0.5250000
NODE_1573_length_1816_cov_25.489225	1059	1139	0	80	80	1.0000000
NODE_1573_length_1816_cov_25.489225	1112	1192	0	80	80	1.0000000
NODE_1578_length_1812_cov_11.453006	398	427	0	29	29	1.0000000
NODE_1578_length_1812_cov_11.453006	400	480	0	80	80	1.0000000
NODE_1586_length_1807_cov_3.977752	1743	1807	0	64	64	1.0000000
NODE_1590_length_1806_cov_2.681312	1461	1541	0	6	80	0.0750000
NODE_1590_length_1806_cov_2.681312	1461	1541	8	3	80	0.0375000
NODE_1590_length_1806_cov_2.681312	1461	1541	9	10	80	0.1250000
NODE_1590_length_1806_cov_2.681312	1461	1541	10	5	80	0.0625000
NODE_1590_length_1806_cov_2.681312	1461	1541	12	2	80	0.0250000
NODE_1590_length_1806_cov_2.681312	1461	1541	14	3	80	0.0375000
NODE_1590_length_1806_cov_2.681312	1461	1541	17	1	80	0.0125000
NODE_1590_length_1806_cov_2.681312	1461	1541	19	4	80	0.0500000
NODE_1590_length_1806_cov_2.681312	1461	1541	20	5	80	0.0625000
NODE_1590_length_1806_cov_2.681312	1461	1541	22	9	80	0.1125000
NODE_1590_length_1806_cov_2.681312	1461	1541	24	8	80	0.1000000
NODE_1590_length_1806_cov_2.681312	1461	1541	27	22	80	0.2750000
NODE_1590_length_1806_cov_2.681312	1461	1541	30	2	80	0.0250000
NODE_1590_length_1806_cov_2.681312	1517	1594	0	59	77	0.7662337
NODE_1590_length_1806_cov_2.681312	1517	1594	8	3	77	0.0389610
NODE_1590_length_1806_cov_2.681312	1517	1594	9	10	77	0.1298701
NODE_1590_length_1806_cov_2.681312	1517	1594	10	5	77	0.0649351
NODE_1593_length_1805_cov_10.271395	258	329	0	71	71	1.0000000
NODE_1593_length_1805_cov_10.271395	311	391	0	80	80	1.0000000
NODE_1598_length_1802_cov_11.546682	1284	1364	0	80	80	1.0000000
NODE_1598_length_1802_cov_11.546682	1337	1417	0	80	80	1.0000000
NODE_1600_length_1801_cov_12.145711	85	165	6	4	80	0.0500000
NODE_1600_length_1801_cov_12.145711	85	165	8	7	80	0.0875000
NODE_1600_length_1801_cov_12.145711	85	165	14	8	80	0.1000000
NODE_1600_length_1801_cov_12.145711	85	165	18	16	80	0.2000000
NODE_1600_length_1801_cov_12.145711	85	165	19	9	80	0.1125000
NODE_1600_length_1801_cov_12.145711	85	165	20	25	80	0.3125000
NODE_1600_length_1801_cov_12.145711	85	165	22	11	80	0.1375000
NODE_1600_length_1801_cov_12.145711	138	218	4	7	80	0.0875000
NODE_1600_length_1801_cov_12.145711	138	218	7	3	80	0.0375000
NODE_1600_length_1801_cov_12.145711	138	218	13	1	80	0.0125000
NODE_1600_length_1801_cov_12.145711	138	218	14	5	80	0.0625000
NODE_1600_length_1801_cov_12.145711	138	218	16	13	80	0.1625000
NODE_1600_length_1801_cov_12.145711	138	218	20	16	80	0.2000000
NODE_1600_length_1801_cov_12.145711	138	218	22	35	80	0.4375000
NODE_1601_length_1801_cov_9.793184	1010	1090	0	80	80	1.0000000
NODE_1601_length_1801_cov_9.793184	1063	1143	0	80	80	1.0000000
NODE_1604_length_1800_cov_15.074662	695	775	0	80	80	1.0000000
NODE_1604_length_1800_cov_15.074662	755	826	0	71	71	1.0000000
NODE_1605_length_1800_cov_7.281599	10	74	64	12	64	0.1875000
NODE_1605_length_1800_cov_7.281599	10	74	67	1	64	0.0156250
NODE_1605_length_1800_cov_7.281599	10	74	70	11	64	0.1718750
NODE_1605_length_1800_cov_7.281599	10	74	78	1	64	0.0156250
NODE_1605_length_1800_cov_7.281599	10	74	94	2	64	0.0312500
NODE_1605_length_1800_cov_7.281599	10	74	96	2	64	0.0312500
NODE_1605_length_1800_cov_7.281599	10	74	98	4	64	0.0625000
NODE_1605_length_1800_cov_7.281599	10	74	99	8	64	0.1250000
NODE_1605_length_1800_cov_7.281599	10	74	100	6	64	0.0937500
NODE_1605_length_1800_cov_7.281599	10	74	102	3	64	0.0468750
NODE_1605_length_1800_cov_7.281599	10	74	104	1	64	0.0156250
NODE_1605_length_1800_cov_7.281599	10	74	112	1	64	0.0156250
NODE_1605_length_1800_cov_7.281599	10	74	114	2	64	0.0312500
NODE_1605_length_1800_cov_7.281599	10	74	118	4	64	0.0625000
NODE_1605_length_1800_cov_7.281599	10	74	124	4	64	0.0625000
NODE_1605_length_1800_cov_7.281599	10	74	128	1	64	0.0156250
NODE_1605_length_1800_cov_7.281599	10	74	139	1	64	0.0156250
NODE_1605_length_1800_cov_7.281599	10	74	64	12	64	0.1875000
NODE_1605_length_1800_cov_7.281599	10	74	67	1	64	0.0156250
NODE_1605_length_1800_cov_7.281599	10	74	70	11	64	0.1718750
NODE_1605_length_1800_cov_7.281599	10	74	78	1	64	0.0156250
NODE_1605_length_1800_cov_7.281599	10	74	94	2	64	0.0312500
NODE_1605_length_1800_cov_7.281599	10	74	96	2	64	0.0312500
NODE_1605_length_1800_cov_7.281599	10	74	98	4	64	0.0625000
NODE_1605_length_1800_cov_7.281599	10	74	99	8	64	0.1250000
NODE_1605_length_1800_cov_7.281599	10	74	100	6	64	0.0937500
NODE_1605_length_1800_cov_7.281599	10	74	102	3	64	0.0468750
NODE_1605_length_1800_cov_7.281599	10	74	104	1	64	0.0156250
NODE_1605_length_1800_cov_7.281599	10	74	112	1	64	0.0156250
NODE_1605_length_1800_cov_7.281599	10	74	114	2	64	0.0312500
NODE_1605_length_1800_cov_7.281599	10	74	118	4	64	0.0625000
NODE_1605_length_1800_cov_7.281599	10	74	124	4	64	0.0625000
NODE_1605_length_1800_cov_7.281599	10	74	128	1	64	0.0156250
NODE_1605_length_1800_cov_7.281599	10	74	139	1	64	0.0156250
NODE_1605_length_1800_cov_7.281599	10	74	64	12	64	0.1875000
NODE_1605_length_1800_cov_7.281599	10	74	67	1	64	0.0156250
NODE_1605_length_1800_cov_7.281599	10	74	70	11	64	0.1718750
NODE_1605_length_1800_cov_7.281599	10	74	78	1	64	0.0156250
NODE_1605_length_1800_cov_7.281599	10	74	94	2	64	0.0312500
NODE_1605_length_1800_cov_7.281599	10	74	96	2	64	0.0312500
NODE_1605_length_1800_cov_7.281599	10	74	98	4	64	0.0625000
NODE_1605_length_1800_cov_7.281599	10	74	99	8	64	0.1250000
NODE_1605_length_1800_cov_7.281599	10	74	100	6	64	0.0937500
NODE_1605_length_1800_cov_7.281599	10	74	102	3	64	0.0468750
NODE_1605_length_1800_cov_7.281599	10	74	104	1	64	0.0156250
NODE_1605_length_1800_cov_7.281599	10	74	112	1	64	0.0156250
NODE_1605_length_1800_cov_7.281599	10	74	114	2	64	0.0312500
NODE_1605_length_1800_cov_7.281599	10	74	118	4	64	0.0625000
NODE_1605_length_1800_cov_7.281599	10	74	124	4	64	0.0625000
NODE_1605_length_1800_cov_7.281599	10	74	128	1	64	0.0156250
NODE_1605_length_1800_cov_7.281599	10	74	139	1	64	0.0156250
NODE_1605_length_1800_cov_7.281599	47	127	99	4	80	0.0500000
NODE_1605_length_1800_cov_7.281599	47	127	100	6	80	0.0750000
NODE_1605_length_1800_cov_7.281599	47	127	102	3	80	0.0375000
NODE_1605_length_1800_cov_7.281599	47	127	104	1	80	0.0125000
NODE_1605_length_1800_cov_7.281599	47	127	112	1	80	0.0125000
NODE_1605_length_1800_cov_7.281599	47	127	114	2	80	0.0250000
NODE_1605_length_1800_cov_7.281599	47	127	118	4	80	0.0500000
NODE_1605_length_1800_cov_7.281599	47	127	124	4	80	0.0500000
NODE_1605_length_1800_cov_7.281599	47	127	128	1	80	0.0125000
NODE_1605_length_1800_cov_7.281599	47	127	139	3	80	0.0375000
NODE_1605_length_1800_cov_7.281599	47	127	143	2	80	0.0250000
NODE_1605_length_1800_cov_7.281599	47	127	145	11	80	0.1375000
NODE_1605_length_1800_cov_7.281599	47	127	147	17	80	0.2125000
NODE_1605_length_1800_cov_7.281599	47	127	150	1	80	0.0125000
NODE_1605_length_1800_cov_7.281599	47	127	151	3	80	0.0375000
NODE_1605_length_1800_cov_7.281599	47	127	156	15	80	0.1875000
NODE_1605_length_1800_cov_7.281599	47	127	157	2	80	0.0250000
NODE_1605_length_1800_cov_7.281599	63	126	114	1	63	0.0158730
NODE_1605_length_1800_cov_7.281599	63	126	118	4	63	0.0634921
NODE_1605_length_1800_cov_7.281599	63	126	124	4	63	0.0634921
NODE_1605_length_1800_cov_7.281599	63	126	128	1	63	0.0158730
NODE_1605_length_1800_cov_7.281599	63	126	139	3	63	0.0476190
NODE_1605_length_1800_cov_7.281599	63	126	143	1	63	0.0158730
NODE_1605_length_1800_cov_7.281599	63	126	145	11	63	0.1746032
NODE_1605_length_1800_cov_7.281599	63	126	147	17	63	0.2698413
NODE_1605_length_1800_cov_7.281599	63	126	150	1	63	0.0158730
NODE_1605_length_1800_cov_7.281599	63	126	151	3	63	0.0476190
NODE_1605_length_1800_cov_7.281599	63	126	156	15	63	0.2380952
NODE_1605_length_1800_cov_7.281599	63	126	157	2	63	0.0317460
NODE_1616_length_1793_cov_16.161157	539	619	0	80	80	1.0000000
NODE_1616_length_1793_cov_16.161157	592	672	0	80	80	1.0000000
NODE_1616_length_1793_cov_16.161157	1202	1281	0	79	79	1.0000000
NODE_1616_length_1793_cov_16.161157	1254	1335	0	81	81	1.0000000
NODE_1617_length_1793_cov_14.322904	521	601	0	80	80	1.0000000
NODE_1617_length_1793_cov_14.322904	574	654	0	80	80	1.0000000
NODE_1617_length_1793_cov_14.322904	1230	1310	0	80	80	1.0000000
NODE_1618_length_1791_cov_5.516548	1190	1261	0	71	71	1.0000000
NODE_1621_length_1790_cov_4.282082	684	764	0	80	80	1.0000000
NODE_1621_length_1790_cov_4.282082	737	817	0	80	80	1.0000000
NODE_1623_length_1788_cov_39.558911	385	465	0	80	80	1.0000000
NODE_1623_length_1788_cov_39.558911	438	518	0	80	80	1.0000000
NODE_1623_length_1788_cov_39.558911	514	594	0	80	80	1.0000000
NODE_1623_length_1788_cov_39.558911	567	647	0	80	80	1.0000000
NODE_1624_length_1787_cov_44.927133	530	610	45	5	80	0.0625000
NODE_1624_length_1787_cov_44.927133	530	610	47	2	80	0.0250000
NODE_1624_length_1787_cov_44.927133	530	610	50	3	80	0.0375000
NODE_1624_length_1787_cov_44.927133	530	610	51	1	80	0.0125000
NODE_1624_length_1787_cov_44.927133	530	610	52	2	80	0.0250000
NODE_1624_length_1787_cov_44.927133	530	610	53	3	80	0.0375000
NODE_1624_length_1787_cov_44.927133	530	610	55	8	80	0.1000000
NODE_1624_length_1787_cov_44.927133	530	610	57	3	80	0.0375000
NODE_1624_length_1787_cov_44.927133	530	610	59	2	80	0.0250000
NODE_1624_length_1787_cov_44.927133	530	610	61	2	80	0.0250000
NODE_1624_length_1787_cov_44.927133	530	610	63	2	80	0.0250000
NODE_1624_length_1787_cov_44.927133	530	610	65	1	80	0.0125000
NODE_1624_length_1787_cov_44.927133	530	610	68	2	80	0.0250000
NODE_1624_length_1787_cov_44.927133	530	610	69	1	80	0.0125000
NODE_1624_length_1787_cov_44.927133	530	610	70	2	80	0.0250000
NODE_1624_length_1787_cov_44.927133	530	610	71	2	80	0.0250000
NODE_1624_length_1787_cov_44.927133	530	610	72	4	80	0.0500000
NODE_1624_length_1787_cov_44.927133	530	610	76	2	80	0.0250000
NODE_1624_length_1787_cov_44.927133	530	610	77	7	80	0.0875000
NODE_1624_length_1787_cov_44.927133	530	610	78	2	80	0.0250000
NODE_1624_length_1787_cov_44.927133	530	610	79	2	80	0.0250000
NODE_1624_length_1787_cov_44.927133	530	610	83	1	80	0.0125000
NODE_1624_length_1787_cov_44.927133	530	610	85	3	80	0.0375000
NODE_1624_length_1787_cov_44.927133	530	610	87	2	80	0.0250000
NODE_1624_length_1787_cov_44.927133	530	610	89	2	80	0.0250000
NODE_1624_length_1787_cov_44.927133	530	610	93	2	80	0.0250000
NODE_1624_length_1787_cov_44.927133	530	610	95	9	80	0.1125000
NODE_1624_length_1787_cov_44.927133	530	610	96	1	80	0.0125000
NODE_1624_length_1787_cov_44.927133	530	610	97	1	80	0.0125000
NODE_1624_length_1787_cov_44.927133	530	610	100	1	80	0.0125000
NODE_1625_length_1787_cov_2.752370	675	755	0	70	80	0.8750000
NODE_1625_length_1787_cov_2.752370	675	755	2	10	80	0.1250000
NODE_1625_length_1787_cov_2.752370	728	806	0	17	78	0.2179487
NODE_1625_length_1787_cov_2.752370	728	806	2	61	78	0.7820513
NODE_1626_length_1786_cov_13.459395	523	603	0	36	80	0.4500000
NODE_1626_length_1786_cov_13.459395	523	603	4	44	80	0.5500000
NODE_1626_length_1786_cov_13.459395	576	656	0	10	80	0.1250000
NODE_1626_length_1786_cov_13.459395	576	656	4	70	80	0.8750000
NODE_1633_length_1784_cov_40.769733	358	438	0	80	80	1.0000000
NODE_1633_length_1784_cov_40.769733	411	491	0	80	80	1.0000000
NODE_1633_length_1784_cov_40.769733	1057	1137	0	80	80	1.0000000
NODE_1633_length_1784_cov_40.769733	1110	1190	0	80	80	1.0000000
NODE_1633_length_1784_cov_40.769733	1186	1266	0	80	80	1.0000000
NODE_1633_length_1784_cov_40.769733	1239	1319	0	80	80	1.0000000
NODE_1634_length_1784_cov_6.049258	1646	1725	0	79	79	1.0000000
NODE_1637_length_1783_cov_45.569477	600	680	1	60	80	0.7500000
NODE_1637_length_1783_cov_45.569477	600	680	2	20	80	0.2500000
NODE_1637_length_1783_cov_45.569477	653	733	1	7	80	0.0875000
NODE_1637_length_1783_cov_45.569477	653	733	2	73	80	0.9125000
NODE_1640_length_1780_cov_21.089233	361	441	0	80	80	1.0000000
NODE_1640_length_1780_cov_21.089233	414	494	0	80	80	1.0000000
NODE_1640_length_1780_cov_21.089233	1031	1104	9	3	73	0.0410959
NODE_1640_length_1780_cov_21.089233	1031	1104	11	5	73	0.0684932
NODE_1640_length_1780_cov_21.089233	1031	1104	12	1	73	0.0136986
NODE_1640_length_1780_cov_21.089233	1031	1104	13	4	73	0.0547945
NODE_1640_length_1780_cov_21.089233	1031	1104	17	1	73	0.0136986
NODE_1640_length_1780_cov_21.089233	1031	1104	19	4	73	0.0547945
NODE_1640_length_1780_cov_21.089233	1031	1104	21	3	73	0.0410959
NODE_1640_length_1780_cov_21.089233	1031	1104	25	2	73	0.0273973
NODE_1640_length_1780_cov_21.089233	1031	1104	27	3	73	0.0410959
NODE_1640_length_1780_cov_21.089233	1031	1104	29	1	73	0.0136986
NODE_1640_length_1780_cov_21.089233	1031	1104	35	5	73	0.0684932
NODE_1640_length_1780_cov_21.089233	1031	1104	37	1	73	0.0136986
NODE_1640_length_1780_cov_21.089233	1031	1104	38	6	73	0.0821918
NODE_1640_length_1780_cov_21.089233	1031	1104	39	1	73	0.0136986
NODE_1640_length_1780_cov_21.089233	1031	1104	41	4	73	0.0547945
NODE_1640_length_1780_cov_21.089233	1031	1104	43	5	73	0.0684932
NODE_1640_length_1780_cov_21.089233	1031	1104	45	4	73	0.0547945
NODE_1640_length_1780_cov_21.089233	1031	1104	49	4	73	0.0547945
NODE_1640_length_1780_cov_21.089233	1031	1104	55	3	73	0.0410959
NODE_1640_length_1780_cov_21.089233	1031	1104	58	1	73	0.0136986
NODE_1640_length_1780_cov_21.089233	1031	1104	63	2	73	0.0273973
NODE_1640_length_1780_cov_21.089233	1031	1104	70	3	73	0.0410959
NODE_1640_length_1780_cov_21.089233	1031	1104	72	6	73	0.0821918
NODE_1640_length_1780_cov_21.089233	1031	1104	73	1	73	0.0136986
NODE_1640_length_1780_cov_21.089233	1071	1112	41	4	41	0.0975610
NODE_1640_length_1780_cov_21.089233	1071	1112	43	5	41	0.1219512
NODE_1640_length_1780_cov_21.089233	1071	1112	45	4	41	0.0975610
NODE_1640_length_1780_cov_21.089233	1071	1112	49	4	41	0.0975610
NODE_1640_length_1780_cov_21.089233	1071	1112	55	3	41	0.0731707
NODE_1640_length_1780_cov_21.089233	1071	1112	58	1	41	0.0243902
NODE_1640_length_1780_cov_21.089233	1071	1112	63	2	41	0.0487805
NODE_1640_length_1780_cov_21.089233	1071	1112	70	6	41	0.1463415
NODE_1640_length_1780_cov_21.089233	1071	1112	72	7	41	0.1707317
NODE_1640_length_1780_cov_21.089233	1071	1112	73	1	41	0.0243902
NODE_1640_length_1780_cov_21.089233	1071	1112	75	1	41	0.0243902
NODE_1640_length_1780_cov_21.089233	1071	1112	77	2	41	0.0487805
NODE_1640_length_1780_cov_21.089233	1071	1112	83	1	41	0.0243902
NODE_1641_length_1780_cov_7.837597	1682	1747	0	65	65	1.0000000
NODE_1649_length_1778_cov_52.804050	1528	1568	0	3	40	0.0750000
NODE_1649_length_1778_cov_52.804050	1528	1568	12	2	40	0.0500000
NODE_1649_length_1778_cov_52.804050	1528	1568	18	5	40	0.1250000
NODE_1649_length_1778_cov_52.804050	1528	1568	20	30	40	0.7500000
NODE_1649_length_1778_cov_52.804050	1541	1621	20	61	80	0.7625000
NODE_1649_length_1778_cov_52.804050	1541	1621	28	14	80	0.1750000
NODE_1649_length_1778_cov_52.804050	1541	1621	32	5	80	0.0625000
NODE_1649_length_1778_cov_52.804050	1541	1621	20	61	80	0.7625000
NODE_1649_length_1778_cov_52.804050	1541	1621	28	14	80	0.1750000
NODE_1649_length_1778_cov_52.804050	1541	1621	32	5	80	0.0625000
NODE_1649_length_1778_cov_52.804050	1541	1621	20	61	80	0.7625000
NODE_1649_length_1778_cov_52.804050	1541	1621	28	14	80	0.1750000
NODE_1649_length_1778_cov_52.804050	1541	1621	32	5	80	0.0625000
NODE_1649_length_1778_cov_52.804050	1541	1621	20	61	80	0.7625000
NODE_1649_length_1778_cov_52.804050	1541	1621	28	14	80	0.1750000
NODE_1649_length_1778_cov_52.804050	1541	1621	32	5	80	0.0625000
NODE_1649_length_1778_cov_52.804050	1541	1621	20	61	80	0.7625000
NODE_1649_length_1778_cov_52.804050	1541	1621	28	14	80	0.1750000
NODE_1649_length_1778_cov_52.804050	1541	1621	32	5	80	0.0625000
NODE_1649_length_1778_cov_52.804050	1541	1621	20	61	80	0.7625000
NODE_1649_length_1778_cov_52.804050	1541	1621	28	14	80	0.1750000
NODE_1649_length_1778_cov_52.804050	1541	1621	32	5	80	0.0625000
NODE_1649_length_1778_cov_52.804050	1617	1697	32	12	80	0.1500000
NODE_1649_length_1778_cov_52.804050	1617	1697	33	1	80	0.0125000
NODE_1649_length_1778_cov_52.804050	1617	1697	47	1	80	0.0125000
NODE_1649_length_1778_cov_52.804050	1617	1697	49	2	80	0.0250000
NODE_1649_length_1778_cov_52.804050	1617	1697	50	2	80	0.0250000
NODE_1649_length_1778_cov_52.804050	1617	1697	60	8	80	0.1000000
NODE_1649_length_1778_cov_52.804050	1617	1697	68	10	80	0.1250000
NODE_1649_length_1778_cov_52.804050	1617	1697	70	6	80	0.0750000
NODE_1649_length_1778_cov_52.804050	1617	1697	72	4	80	0.0500000
NODE_1649_length_1778_cov_52.804050	1617	1697	74	24	80	0.3000000
NODE_1649_length_1778_cov_52.804050	1617	1697	76	3	80	0.0375000
NODE_1649_length_1778_cov_52.804050	1617	1697	79	1	80	0.0125000
NODE_1649_length_1778_cov_52.804050	1617	1697	80	3	80	0.0375000
NODE_1649_length_1778_cov_52.804050	1617	1697	81	1	80	0.0125000
NODE_1649_length_1778_cov_52.804050	1617	1697	87	1	80	0.0125000
NODE_1649_length_1778_cov_52.804050	1617	1697	88	1	80	0.0125000
NODE_1649_length_1778_cov_52.804050	1617	1697	32	12	80	0.1500000
NODE_1649_length_1778_cov_52.804050	1617	1697	33	1	80	0.0125000
NODE_1649_length_1778_cov_52.804050	1617	1697	47	1	80	0.0125000
NODE_1649_length_1778_cov_52.804050	1617	1697	49	2	80	0.0250000
NODE_1649_length_1778_cov_52.804050	1617	1697	50	2	80	0.0250000
NODE_1649_length_1778_cov_52.804050	1617	1697	60	8	80	0.1000000
NODE_1649_length_1778_cov_52.804050	1617	1697	68	10	80	0.1250000
NODE_1649_length_1778_cov_52.804050	1617	1697	70	6	80	0.0750000
NODE_1649_length_1778_cov_52.804050	1617	1697	72	4	80	0.0500000
NODE_1649_length_1778_cov_52.804050	1617	1697	74	24	80	0.3000000
NODE_1649_length_1778_cov_52.804050	1617	1697	76	3	80	0.0375000
NODE_1649_length_1778_cov_52.804050	1617	1697	79	1	80	0.0125000
NODE_1649_length_1778_cov_52.804050	1617	1697	80	3	80	0.0375000
NODE_1649_length_1778_cov_52.804050	1617	1697	81	1	80	0.0125000
NODE_1649_length_1778_cov_52.804050	1617	1697	87	1	80	0.0125000
NODE_1649_length_1778_cov_52.804050	1617	1697	88	1	80	0.0125000
NODE_1649_length_1778_cov_52.804050	1617	1697	32	12	80	0.1500000
NODE_1649_length_1778_cov_52.804050	1617	1697	33	1	80	0.0125000
NODE_1649_length_1778_cov_52.804050	1617	1697	47	1	80	0.0125000
NODE_1649_length_1778_cov_52.804050	1617	1697	49	2	80	0.0250000
NODE_1649_length_1778_cov_52.804050	1617	1697	50	2	80	0.0250000
NODE_1649_length_1778_cov_52.804050	1617	1697	60	8	80	0.1000000
NODE_1649_length_1778_cov_52.804050	1617	1697	68	10	80	0.1250000
NODE_1649_length_1778_cov_52.804050	1617	1697	70	6	80	0.0750000
NODE_1649_length_1778_cov_52.804050	1617	1697	72	4	80	0.0500000
NODE_1649_length_1778_cov_52.804050	1617	1697	74	24	80	0.3000000
NODE_1649_length_1778_cov_52.804050	1617	1697	76	3	80	0.0375000
NODE_1649_length_1778_cov_52.804050	1617	1697	79	1	80	0.0125000
NODE_1649_length_1778_cov_52.804050	1617	1697	80	3	80	0.0375000
NODE_1649_length_1778_cov_52.804050	1617	1697	81	1	80	0.0125000
NODE_1649_length_1778_cov_52.804050	1617	1697	87	1	80	0.0125000
NODE_1649_length_1778_cov_52.804050	1617	1697	88	1	80	0.0125000
NODE_1649_length_1778_cov_52.804050	1617	1697	32	12	80	0.1500000
NODE_1649_length_1778_cov_52.804050	1617	1697	33	1	80	0.0125000
NODE_1649_length_1778_cov_52.804050	1617	1697	47	1	80	0.0125000
NODE_1649_length_1778_cov_52.804050	1617	1697	49	2	80	0.0250000
NODE_1649_length_1778_cov_52.804050	1617	1697	50	2	80	0.0250000
NODE_1649_length_1778_cov_52.804050	1617	1697	60	8	80	0.1000000
NODE_1649_length_1778_cov_52.804050	1617	1697	68	10	80	0.1250000
NODE_1649_length_1778_cov_52.804050	1617	1697	70	6	80	0.0750000
NODE_1649_length_1778_cov_52.804050	1617	1697	72	4	80	0.0500000
NODE_1649_length_1778_cov_52.804050	1617	1697	74	24	80	0.3000000
NODE_1649_length_1778_cov_52.804050	1617	1697	76	3	80	0.0375000
NODE_1649_length_1778_cov_52.804050	1617	1697	79	1	80	0.0125000
NODE_1649_length_1778_cov_52.804050	1617	1697	80	3	80	0.0375000
NODE_1649_length_1778_cov_52.804050	1617	1697	81	1	80	0.0125000
NODE_1649_length_1778_cov_52.804050	1617	1697	87	1	80	0.0125000
NODE_1649_length_1778_cov_52.804050	1617	1697	88	1	80	0.0125000
NODE_1649_length_1778_cov_52.804050	1670	1750	47	2	80	0.0250000
NODE_1649_length_1778_cov_52.804050	1670	1750	48	1	80	0.0125000
NODE_1649_length_1778_cov_52.804050	1670	1750	58	4	80	0.0500000
NODE_1649_length_1778_cov_52.804050	1670	1750	60	1	80	0.0125000
NODE_1649_length_1778_cov_52.804050	1670	1750	62	12	80	0.1500000
NODE_1649_length_1778_cov_52.804050	1670	1750	66	19	80	0.2375000
NODE_1649_length_1778_cov_52.804050	1670	1750	72	3	80	0.0375000
NODE_1649_length_1778_cov_52.804050	1670	1750	74	38	80	0.4750000
NODE_1649_length_1778_cov_52.804050	1670	1750	47	2	80	0.0250000
NODE_1649_length_1778_cov_52.804050	1670	1750	48	1	80	0.0125000
NODE_1649_length_1778_cov_52.804050	1670	1750	58	4	80	0.0500000
NODE_1649_length_1778_cov_52.804050	1670	1750	60	1	80	0.0125000
NODE_1649_length_1778_cov_52.804050	1670	1750	62	12	80	0.1500000
NODE_1649_length_1778_cov_52.804050	1670	1750	66	19	80	0.2375000
NODE_1649_length_1778_cov_52.804050	1670	1750	72	3	80	0.0375000
NODE_1649_length_1778_cov_52.804050	1670	1750	74	38	80	0.4750000
NODE_1649_length_1778_cov_52.804050	1670	1750	47	2	80	0.0250000
NODE_1649_length_1778_cov_52.804050	1670	1750	48	1	80	0.0125000
NODE_1649_length_1778_cov_52.804050	1670	1750	58	4	80	0.0500000
NODE_1649_length_1778_cov_52.804050	1670	1750	60	1	80	0.0125000
NODE_1649_length_1778_cov_52.804050	1670	1750	62	12	80	0.1500000
NODE_1649_length_1778_cov_52.804050	1670	1750	66	19	80	0.2375000
NODE_1649_length_1778_cov_52.804050	1670	1750	72	3	80	0.0375000
NODE_1649_length_1778_cov_52.804050	1670	1750	74	38	80	0.4750000
NODE_1649_length_1778_cov_52.804050	1670	1741	62	11	71	0.1549296
NODE_1649_length_1778_cov_52.804050	1670	1741	66	19	71	0.2676056
NODE_1649_length_1778_cov_52.804050	1670	1741	72	3	71	0.0422535
NODE_1649_length_1778_cov_52.804050	1670	1741	74	38	71	0.5352113
NODE_1649_length_1778_cov_52.804050	1673	1743	60	1	70	0.0142857
NODE_1649_length_1778_cov_52.804050	1673	1743	62	12	70	0.1714286
NODE_1649_length_1778_cov_52.804050	1673	1743	66	19	70	0.2714286
NODE_1649_length_1778_cov_52.804050	1673	1743	74	38	70	0.5428572
NODE_1649_length_1778_cov_52.804050	1679	1750	47	2	71	0.0281690
NODE_1649_length_1778_cov_52.804050	1679	1750	48	1	71	0.0140845
NODE_1649_length_1778_cov_52.804050	1679	1750	58	4	71	0.0563380
NODE_1649_length_1778_cov_52.804050	1679	1750	60	1	71	0.0140845
NODE_1649_length_1778_cov_52.804050	1679	1750	62	12	71	0.1690141
NODE_1649_length_1778_cov_52.804050	1679	1750	66	19	71	0.2676056
NODE_1649_length_1778_cov_52.804050	1679	1750	74	32	71	0.4507042
NODE_1651_length_1776_cov_43.081694	1246	1308	0	8	62	0.1290323
NODE_1651_length_1776_cov_43.081694	1246	1308	2	52	62	0.8387097
NODE_1651_length_1776_cov_43.081694	1246	1308	3	1	62	0.0161290
NODE_1651_length_1776_cov_43.081694	1246	1308	12	1	62	0.0161290
NODE_1651_length_1776_cov_43.081694	1281	1361	0	61	80	0.7625000
NODE_1651_length_1776_cov_43.081694	1281	1361	2	19	80	0.2375000
NODE_1652_length_1776_cov_9.256410	1120	1200	1	80	80	1.0000000
NODE_1652_length_1776_cov_9.256410	1173	1253	0	33	80	0.4125000
NODE_1652_length_1776_cov_9.256410	1173	1253	1	47	80	0.5875000
NODE_1652_length_1776_cov_9.256410	1249	1329	0	80	80	1.0000000
NODE_1652_length_1776_cov_9.256410	1302	1382	0	80	80	1.0000000
NODE_1657_length_1775_cov_54.208234	1103	1167	126	2	64	0.0312500
NODE_1657_length_1775_cov_54.208234	1103	1167	128	2	64	0.0312500
NODE_1657_length_1775_cov_54.208234	1103	1167	139	2	64	0.0312500
NODE_1657_length_1775_cov_54.208234	1103	1167	141	1	64	0.0156250
NODE_1657_length_1775_cov_54.208234	1103	1167	146	1	64	0.0156250
NODE_1657_length_1775_cov_54.208234	1103	1167	149	2	64	0.0312500
NODE_1657_length_1775_cov_54.208234	1103	1167	153	3	64	0.0468750
NODE_1657_length_1775_cov_54.208234	1103	1167	154	1	64	0.0156250
NODE_1657_length_1775_cov_54.208234	1103	1167	155	4	64	0.0625000
NODE_1657_length_1775_cov_54.208234	1103	1167	158	1	64	0.0156250
NODE_1657_length_1775_cov_54.208234	1103	1167	161	2	64	0.0312500
NODE_1657_length_1775_cov_54.208234	1103	1167	162	1	64	0.0156250
NODE_1657_length_1775_cov_54.208234	1103	1167	167	1	64	0.0156250
NODE_1657_length_1775_cov_54.208234	1103	1167	169	1	64	0.0156250
NODE_1657_length_1775_cov_54.208234	1103	1167	170	1	64	0.0156250
NODE_1657_length_1775_cov_54.208234	1103	1167	175	2	64	0.0312500
NODE_1657_length_1775_cov_54.208234	1103	1167	176	7	64	0.1093750
NODE_1657_length_1775_cov_54.208234	1103	1167	177	3	64	0.0468750
NODE_1657_length_1775_cov_54.208234	1103	1167	179	3	64	0.0468750
NODE_1657_length_1775_cov_54.208234	1103	1167	181	2	64	0.0312500
NODE_1657_length_1775_cov_54.208234	1103	1167	185	3	64	0.0468750
NODE_1657_length_1775_cov_54.208234	1103	1167	186	2	64	0.0312500
NODE_1657_length_1775_cov_54.208234	1103	1167	188	8	64	0.1250000
NODE_1657_length_1775_cov_54.208234	1103	1167	189	1	64	0.0156250
NODE_1657_length_1775_cov_54.208234	1103	1167	190	3	64	0.0468750
NODE_1657_length_1775_cov_54.208234	1103	1167	191	2	64	0.0312500
NODE_1657_length_1775_cov_54.208234	1103	1167	192	2	64	0.0312500
NODE_1657_length_1775_cov_54.208234	1103	1167	193	1	64	0.0156250
NODE_1657_length_1775_cov_54.208234	1103	1167	126	2	64	0.0312500
NODE_1657_length_1775_cov_54.208234	1103	1167	128	2	64	0.0312500
NODE_1657_length_1775_cov_54.208234	1103	1167	139	2	64	0.0312500
NODE_1657_length_1775_cov_54.208234	1103	1167	141	1	64	0.0156250
NODE_1657_length_1775_cov_54.208234	1103	1167	146	1	64	0.0156250
NODE_1657_length_1775_cov_54.208234	1103	1167	149	2	64	0.0312500
NODE_1657_length_1775_cov_54.208234	1103	1167	153	3	64	0.0468750
NODE_1657_length_1775_cov_54.208234	1103	1167	154	1	64	0.0156250
NODE_1657_length_1775_cov_54.208234	1103	1167	155	4	64	0.0625000
NODE_1657_length_1775_cov_54.208234	1103	1167	158	1	64	0.0156250
NODE_1657_length_1775_cov_54.208234	1103	1167	161	2	64	0.0312500
NODE_1657_length_1775_cov_54.208234	1103	1167	162	1	64	0.0156250
NODE_1657_length_1775_cov_54.208234	1103	1167	167	1	64	0.0156250
NODE_1657_length_1775_cov_54.208234	1103	1167	169	1	64	0.0156250
NODE_1657_length_1775_cov_54.208234	1103	1167	170	1	64	0.0156250
NODE_1657_length_1775_cov_54.208234	1103	1167	175	2	64	0.0312500
NODE_1657_length_1775_cov_54.208234	1103	1167	176	7	64	0.1093750
NODE_1657_length_1775_cov_54.208234	1103	1167	177	3	64	0.0468750
NODE_1657_length_1775_cov_54.208234	1103	1167	179	3	64	0.0468750
NODE_1657_length_1775_cov_54.208234	1103	1167	181	2	64	0.0312500
NODE_1657_length_1775_cov_54.208234	1103	1167	185	3	64	0.0468750
NODE_1657_length_1775_cov_54.208234	1103	1167	186	2	64	0.0312500
NODE_1657_length_1775_cov_54.208234	1103	1167	188	8	64	0.1250000
NODE_1657_length_1775_cov_54.208234	1103	1167	189	1	64	0.0156250
NODE_1657_length_1775_cov_54.208234	1103	1167	190	3	64	0.0468750
NODE_1657_length_1775_cov_54.208234	1103	1167	191	2	64	0.0312500
NODE_1657_length_1775_cov_54.208234	1103	1167	192	2	64	0.0312500
NODE_1657_length_1775_cov_54.208234	1103	1167	193	1	64	0.0156250
NODE_1657_length_1775_cov_54.208234	1140	1200	80	2	60	0.0333333
NODE_1657_length_1775_cov_54.208234	1140	1200	84	6	60	0.1000000
NODE_1657_length_1775_cov_54.208234	1140	1200	86	1	60	0.0166667
NODE_1657_length_1775_cov_54.208234	1140	1200	87	3	60	0.0500000
NODE_1657_length_1775_cov_54.208234	1140	1200	91	5	60	0.0833333
NODE_1657_length_1775_cov_54.208234	1140	1200	92	1	60	0.0166667
NODE_1657_length_1775_cov_54.208234	1140	1200	93	3	60	0.0500000
NODE_1657_length_1775_cov_54.208234	1140	1200	101	1	60	0.0166667
NODE_1657_length_1775_cov_54.208234	1140	1200	107	5	60	0.0833333
NODE_1657_length_1775_cov_54.208234	1140	1200	109	1	60	0.0166667
NODE_1657_length_1775_cov_54.208234	1140	1200	112	1	60	0.0166667
NODE_1657_length_1775_cov_54.208234	1140	1200	113	1	60	0.0166667
NODE_1657_length_1775_cov_54.208234	1140	1200	117	3	60	0.0500000
NODE_1657_length_1775_cov_54.208234	1140	1200	126	2	60	0.0333333
NODE_1657_length_1775_cov_54.208234	1140	1200	128	2	60	0.0333333
NODE_1657_length_1775_cov_54.208234	1140	1200	139	2	60	0.0333333
NODE_1657_length_1775_cov_54.208234	1140	1200	141	1	60	0.0166667
NODE_1657_length_1775_cov_54.208234	1140	1200	146	1	60	0.0166667
NODE_1657_length_1775_cov_54.208234	1140	1200	149	2	60	0.0333333
NODE_1657_length_1775_cov_54.208234	1140	1200	153	3	60	0.0500000
NODE_1657_length_1775_cov_54.208234	1140	1200	154	1	60	0.0166667
NODE_1657_length_1775_cov_54.208234	1140	1200	155	4	60	0.0666667
NODE_1657_length_1775_cov_54.208234	1140	1200	158	1	60	0.0166667
NODE_1657_length_1775_cov_54.208234	1140	1200	161	2	60	0.0333333
NODE_1657_length_1775_cov_54.208234	1140	1200	162	1	60	0.0166667
NODE_1657_length_1775_cov_54.208234	1140	1200	167	1	60	0.0166667
NODE_1657_length_1775_cov_54.208234	1140	1200	169	1	60	0.0166667
NODE_1657_length_1775_cov_54.208234	1140	1200	170	1	60	0.0166667
NODE_1657_length_1775_cov_54.208234	1140	1200	179	1	60	0.0166667
NODE_1657_length_1775_cov_54.208234	1140	1200	181	1	60	0.0166667
NODE_1658_length_1775_cov_13.181981	1170	1250	0	43	80	0.5375000
NODE_1658_length_1775_cov_13.181981	1170	1250	2	37	80	0.4625000
NODE_1658_length_1775_cov_13.181981	1223	1303	0	80	80	1.0000000
NODE_1659_length_1775_cov_4.218974	1304	1384	0	80	80	1.0000000
NODE_1659_length_1775_cov_4.218974	1357	1437	0	80	80	1.0000000
NODE_1660_length_1774_cov_48.617313	345	425	0	80	80	1.0000000
NODE_1660_length_1774_cov_48.617313	398	478	0	80	80	1.0000000
NODE_1660_length_1774_cov_48.617313	474	554	0	80	80	1.0000000
NODE_1660_length_1774_cov_48.617313	527	607	0	80	80	1.0000000
NODE_1660_length_1774_cov_48.617313	1027	1107	0	62	80	0.7750000
NODE_1660_length_1774_cov_48.617313	1027	1107	2	18	80	0.2250000
NODE_1660_length_1774_cov_48.617313	1080	1160	0	80	80	1.0000000
NODE_1660_length_1774_cov_48.617313	1156	1236	0	80	80	1.0000000
NODE_1660_length_1774_cov_48.617313	1209	1289	0	80	80	1.0000000
NODE_1662_length_1774_cov_8.011343	1655	1735	0	80	80	1.0000000
NODE_1663_length_1773_cov_5.547192	433	513	0	80	80	1.0000000
NODE_1663_length_1773_cov_5.547192	486	566	0	80	80	1.0000000
NODE_1664_length_1773_cov_3.925329	267	347	0	80	80	1.0000000
NODE_1664_length_1773_cov_3.925329	320	400	0	80	80	1.0000000
NODE_1666_length_1770_cov_9.912029	369	437	0	68	68	1.0000000
NODE_1666_length_1770_cov_9.912029	388	431	0	43	43	1.0000000
NODE_1666_length_1770_cov_9.912029	509	577	0	68	68	1.0000000
NODE_1666_length_1770_cov_9.912029	515	571	0	56	56	1.0000000
NODE_1666_length_1770_cov_9.912029	579	618	0	39	39	1.0000000
NODE_1666_length_1770_cov_9.912029	697	776	0	79	79	1.0000000
NODE_1666_length_1770_cov_9.912029	714	794	0	80	80	1.0000000
NODE_1666_length_1770_cov_9.912029	767	819	0	52	52	1.0000000
NODE_1666_length_1770_cov_9.912029	785	819	0	34	34	1.0000000
NODE_1667_length_1768_cov_9.134811	687	736	55	2	49	0.0408163
NODE_1667_length_1768_cov_9.134811	687	736	57	4	49	0.0816327
NODE_1667_length_1768_cov_9.134811	687	736	62	1	49	0.0204082
NODE_1667_length_1768_cov_9.134811	687	736	64	2	49	0.0408163
NODE_1667_length_1768_cov_9.134811	687	736	66	2	49	0.0408163
NODE_1667_length_1768_cov_9.134811	687	736	70	1	49	0.0204082
NODE_1667_length_1768_cov_9.134811	687	736	72	2	49	0.0408163
NODE_1667_length_1768_cov_9.134811	687	736	74	2	49	0.0408163
NODE_1667_length_1768_cov_9.134811	687	736	76	3	49	0.0612245
NODE_1667_length_1768_cov_9.134811	687	736	77	7	49	0.1428571
NODE_1667_length_1768_cov_9.134811	687	736	79	7	49	0.1428571
NODE_1667_length_1768_cov_9.134811	687	736	81	6	49	0.1224490
NODE_1667_length_1768_cov_9.134811	687	736	82	2	49	0.0408163
NODE_1667_length_1768_cov_9.134811	687	736	83	6	49	0.1224490
NODE_1667_length_1768_cov_9.134811	687	736	85	2	49	0.0408163
NODE_1668_length_1768_cov_6.605153	1207	1287	0	80	80	1.0000000
NODE_1668_length_1768_cov_6.605153	1260	1340	0	80	80	1.0000000
NODE_1668_length_1768_cov_6.605153	1336	1416	0	80	80	1.0000000
NODE_1668_length_1768_cov_6.605153	1389	1469	0	69	80	0.8625000
NODE_1668_length_1768_cov_6.605153	1389	1469	1	11	80	0.1375000
NODE_1669_length_1767_cov_5.475420	508	588	0	17	80	0.2125000
NODE_1669_length_1767_cov_5.475420	508	588	2	63	80	0.7875000
NODE_1680_length_1762_cov_18.673482	606	686	0	80	80	1.0000000
NODE_1680_length_1762_cov_18.673482	659	739	0	80	80	1.0000000
NODE_1680_length_1762_cov_18.673482	735	815	0	80	80	1.0000000
NODE_1680_length_1762_cov_18.673482	788	868	0	80	80	1.0000000
NODE_1681_length_1762_cov_6.760072	1033	1113	0	80	80	1.0000000
NODE_1681_length_1762_cov_6.760072	1086	1166	0	80	80	1.0000000
NODE_1685_length_1760_cov_8.064419	941	1021	0	42	80	0.5250000
NODE_1685_length_1760_cov_8.064419	941	1021	1	38	80	0.4750000
NODE_1685_length_1760_cov_8.064419	994	1074	1	80	80	1.0000000
NODE_1692_length_1758_cov_99.869198	599	679	2	31	80	0.3875000
NODE_1692_length_1758_cov_99.869198	599	679	4	31	80	0.3875000
NODE_1692_length_1758_cov_99.869198	599	679	6	16	80	0.2000000
NODE_1692_length_1758_cov_99.869198	599	679	58	1	80	0.0125000
NODE_1692_length_1758_cov_99.869198	599	679	62	1	80	0.0125000
NODE_1692_length_1758_cov_99.869198	652	732	4	25	80	0.3125000
NODE_1692_length_1758_cov_99.869198	652	732	58	1	80	0.0125000
NODE_1692_length_1758_cov_99.869198	652	732	62	14	80	0.1750000
NODE_1692_length_1758_cov_99.869198	652	732	63	18	80	0.2250000
NODE_1692_length_1758_cov_99.869198	652	732	64	7	80	0.0875000
NODE_1692_length_1758_cov_99.869198	652	732	66	6	80	0.0750000
NODE_1692_length_1758_cov_99.869198	652	732	73	1	80	0.0125000
NODE_1692_length_1758_cov_99.869198	652	732	74	8	80	0.1000000
NODE_1692_length_1758_cov_99.869198	728	808	70	3	80	0.0375000
NODE_1692_length_1758_cov_99.869198	728	808	74	15	80	0.1875000
NODE_1692_length_1758_cov_99.869198	728	808	75	13	80	0.1625000
NODE_1692_length_1758_cov_99.869198	728	808	76	3	80	0.0375000
NODE_1692_length_1758_cov_99.869198	728	808	77	2	80	0.0250000
NODE_1692_length_1758_cov_99.869198	728	808	78	22	80	0.2750000
NODE_1692_length_1758_cov_99.869198	728	808	79	8	80	0.1000000
NODE_1692_length_1758_cov_99.869198	728	808	80	14	80	0.1750000
NODE_1692_length_1758_cov_99.869198	781	861	1	27	80	0.3375000
NODE_1692_length_1758_cov_99.869198	781	861	11	5	80	0.0625000
NODE_1692_length_1758_cov_99.869198	781	861	19	8	80	0.1000000
NODE_1692_length_1758_cov_99.869198	781	861	73	1	80	0.0125000
NODE_1692_length_1758_cov_99.869198	781	861	74	1	80	0.0125000
NODE_1692_length_1758_cov_99.869198	781	861	75	24	80	0.3000000
NODE_1692_length_1758_cov_99.869198	781	861	76	3	80	0.0375000
NODE_1692_length_1758_cov_99.869198	781	861	78	1	80	0.0125000
NODE_1692_length_1758_cov_99.869198	781	861	79	3	80	0.0375000
NODE_1692_length_1758_cov_99.869198	781	861	80	7	80	0.0875000
NODE_1693_length_1757_cov_3.126659	49	121	0	72	72	1.0000000
NODE_1696_length_1755_cov_9.938406	231	311	0	80	80	1.0000000
NODE_1696_length_1755_cov_9.938406	284	364	0	80	80	1.0000000
NODE_1698_length_1755_cov_3.614130	171	222	2	29	51	0.5686275
NODE_1698_length_1755_cov_3.614130	171	222	4	22	51	0.4313726
NODE_1699_length_1754_cov_8.523263	0	77	0	77	77	1.0000000
NODE_1699_length_1754_cov_8.523263	0	77	0	77	77	1.0000000
NODE_1699_length_1754_cov_8.523263	0	77	0	77	77	1.0000000
NODE_1699_length_1754_cov_8.523263	50	99	0	49	49	1.0000000
NODE_1699_length_1754_cov_8.523263	53	99	0	46	46	1.0000000
NODE_1699_length_1754_cov_8.523263	55	99	0	44	44	1.0000000
NODE_1700_length_1753_cov_26.851874	356	436	0	80	80	1.0000000
NODE_1700_length_1753_cov_26.851874	409	489	0	80	80	1.0000000
NODE_1701_length_1753_cov_12.297461	355	435	0	80	80	1.0000000
NODE_1701_length_1753_cov_12.297461	408	488	0	80	80	1.0000000
NODE_1705_length_1750_cov_90.732283	1191	1254	96	1	63	0.0158730
NODE_1705_length_1750_cov_90.732283	1191	1254	97	1	63	0.0158730
NODE_1705_length_1750_cov_90.732283	1191	1254	98	3	63	0.0476190
NODE_1705_length_1750_cov_90.732283	1191	1254	100	1	63	0.0158730
NODE_1705_length_1750_cov_90.732283	1191	1254	102	10	63	0.1587302
NODE_1705_length_1750_cov_90.732283	1191	1254	105	1	63	0.0158730
NODE_1705_length_1750_cov_90.732283	1191	1254	110	2	63	0.0317460
NODE_1705_length_1750_cov_90.732283	1191	1254	112	2	63	0.0317460
NODE_1705_length_1750_cov_90.732283	1191	1254	114	1	63	0.0158730
NODE_1705_length_1750_cov_90.732283	1191	1254	116	3	63	0.0476190
NODE_1705_length_1750_cov_90.732283	1191	1254	118	2	63	0.0317460
NODE_1705_length_1750_cov_90.732283	1191	1254	119	1	63	0.0158730
NODE_1705_length_1750_cov_90.732283	1191	1254	120	2	63	0.0317460
NODE_1705_length_1750_cov_90.732283	1191	1254	121	2	63	0.0317460
NODE_1705_length_1750_cov_90.732283	1191	1254	122	2	63	0.0317460
NODE_1705_length_1750_cov_90.732283	1191	1254	124	3	63	0.0476190
NODE_1705_length_1750_cov_90.732283	1191	1254	125	1	63	0.0158730
NODE_1705_length_1750_cov_90.732283	1191	1254	126	1	63	0.0158730
NODE_1705_length_1750_cov_90.732283	1191	1254	127	2	63	0.0317460
NODE_1705_length_1750_cov_90.732283	1191	1254	128	1	63	0.0158730
NODE_1705_length_1750_cov_90.732283	1191	1254	129	2	63	0.0317460
NODE_1705_length_1750_cov_90.732283	1191	1254	131	1	63	0.0158730
NODE_1705_length_1750_cov_90.732283	1191	1254	140	1	63	0.0158730
NODE_1705_length_1750_cov_90.732283	1191	1254	143	1	63	0.0158730
NODE_1705_length_1750_cov_90.732283	1191	1254	147	6	63	0.0952381
NODE_1705_length_1750_cov_90.732283	1191	1254	148	4	63	0.0634921
NODE_1705_length_1750_cov_90.732283	1191	1254	149	1	63	0.0158730
NODE_1705_length_1750_cov_90.732283	1191	1254	150	1	63	0.0158730
NODE_1705_length_1750_cov_90.732283	1191	1254	162	2	63	0.0317460
NODE_1705_length_1750_cov_90.732283	1191	1254	176	2	63	0.0317460
NODE_1705_length_1750_cov_90.732283	1239	1310	147	5	71	0.0704225
NODE_1705_length_1750_cov_90.732283	1239	1310	148	4	71	0.0563380
NODE_1705_length_1750_cov_90.732283	1239	1310	149	1	71	0.0140845
NODE_1705_length_1750_cov_90.732283	1239	1310	150	1	71	0.0140845
NODE_1705_length_1750_cov_90.732283	1239	1310	162	2	71	0.0281690
NODE_1705_length_1750_cov_90.732283	1239	1310	176	3	71	0.0422535
NODE_1705_length_1750_cov_90.732283	1239	1310	178	1	71	0.0140845
NODE_1705_length_1750_cov_90.732283	1239	1310	179	2	71	0.0281690
NODE_1705_length_1750_cov_90.732283	1239	1310	181	2	71	0.0281690
NODE_1705_length_1750_cov_90.732283	1239	1310	184	2	71	0.0281690
NODE_1705_length_1750_cov_90.732283	1239	1310	186	1	71	0.0140845
NODE_1705_length_1750_cov_90.732283	1239	1310	187	1	71	0.0140845
NODE_1705_length_1750_cov_90.732283	1239	1310	188	1	71	0.0140845
NODE_1705_length_1750_cov_90.732283	1239	1310	189	2	71	0.0281690
NODE_1705_length_1750_cov_90.732283	1239	1310	192	1	71	0.0140845
NODE_1705_length_1750_cov_90.732283	1239	1310	196	1	71	0.0140845
NODE_1705_length_1750_cov_90.732283	1239	1310	198	4	71	0.0563380
NODE_1705_length_1750_cov_90.732283	1239	1310	199	1	71	0.0140845
NODE_1705_length_1750_cov_90.732283	1239	1310	200	2	71	0.0281690
NODE_1705_length_1750_cov_90.732283	1239	1310	205	1	71	0.0140845
NODE_1705_length_1750_cov_90.732283	1239	1310	211	3	71	0.0422535
NODE_1705_length_1750_cov_90.732283	1239	1310	216	2	71	0.0281690
NODE_1705_length_1750_cov_90.732283	1239	1310	222	2	71	0.0281690
NODE_1705_length_1750_cov_90.732283	1239	1310	223	1	71	0.0140845
NODE_1705_length_1750_cov_90.732283	1239	1310	224	6	71	0.0845070
NODE_1705_length_1750_cov_90.732283	1239	1310	225	1	71	0.0140845
NODE_1705_length_1750_cov_90.732283	1239	1310	226	4	71	0.0563380
NODE_1705_length_1750_cov_90.732283	1239	1310	229	1	71	0.0140845
NODE_1705_length_1750_cov_90.732283	1239	1310	230	1	71	0.0140845
NODE_1705_length_1750_cov_90.732283	1239	1310	231	4	71	0.0563380
NODE_1705_length_1750_cov_90.732283	1239	1310	232	3	71	0.0422535
NODE_1705_length_1750_cov_90.732283	1239	1310	233	2	71	0.0281690
NODE_1705_length_1750_cov_90.732283	1239	1310	236	2	71	0.0281690
NODE_1705_length_1750_cov_90.732283	1239	1310	248	1	71	0.0140845
NODE_1711_length_1746_cov_3.095932	458	524	0	66	66	1.0000000
NODE_1712_length_1745_cov_7.646416	430	510	0	80	80	1.0000000
NODE_1712_length_1745_cov_7.646416	483	563	0	80	80	1.0000000
NODE_1715_length_1744_cov_10.144681	1213	1289	0	25	76	0.3289474
NODE_1715_length_1744_cov_10.144681	1213	1289	1	5	76	0.0657895
NODE_1715_length_1744_cov_10.144681	1213	1289	2	46	76	0.6052632
NODE_1715_length_1744_cov_10.144681	1262	1342	2	80	80	1.0000000
NODE_1719_length_1742_cov_18.923311	699	776	0	77	77	1.0000000
NODE_1719_length_1742_cov_18.923311	749	829	0	80	80	1.0000000
NODE_1722_length_1741_cov_7.657734	1234	1314	0	80	80	1.0000000
NODE_1722_length_1741_cov_7.657734	1287	1367	0	80	80	1.0000000
NODE_1722_length_1741_cov_7.657734	1363	1443	0	80	80	1.0000000
NODE_1722_length_1741_cov_7.657734	1416	1496	0	80	80	1.0000000
NODE_1726_length_1740_cov_38.411335	517	597	0	38	80	0.4750000
NODE_1726_length_1740_cov_38.411335	517	597	10	42	80	0.5250000
NODE_1726_length_1740_cov_38.411335	570	650	0	80	80	1.0000000
NODE_1726_length_1740_cov_38.411335	646	726	0	80	80	1.0000000
NODE_1726_length_1740_cov_38.411335	699	779	0	80	80	1.0000000
NODE_1727_length_1740_cov_10.843388	552	632	0	16	80	0.2000000
NODE_1727_length_1740_cov_10.843388	552	632	2	64	80	0.8000000
NODE_1727_length_1740_cov_10.843388	708	788	0	80	80	1.0000000
NODE_1727_length_1740_cov_10.843388	708	788	0	80	80	1.0000000
NODE_1727_length_1740_cov_10.843388	708	788	0	80	80	1.0000000
NODE_1727_length_1740_cov_10.843388	761	841	0	54	80	0.6750000
NODE_1727_length_1740_cov_10.843388	761	841	2	26	80	0.3250000
NODE_1727_length_1740_cov_10.843388	761	808	0	47	47	1.0000000
NODE_1727_length_1740_cov_10.843388	761	808	0	47	47	1.0000000
NODE_1737_length_1736_cov_71.959682	841	901	44	8	60	0.1333333
NODE_1737_length_1736_cov_71.959682	841	901	46	4	60	0.0666667
NODE_1737_length_1736_cov_71.959682	841	901	55	1	60	0.0166667
NODE_1737_length_1736_cov_71.959682	841	901	59	1	60	0.0166667
NODE_1737_length_1736_cov_71.959682	841	901	61	1	60	0.0166667
NODE_1737_length_1736_cov_71.959682	841	901	62	1	60	0.0166667
NODE_1737_length_1736_cov_71.959682	841	901	68	2	60	0.0333333
NODE_1737_length_1736_cov_71.959682	841	901	70	6	60	0.1000000
NODE_1737_length_1736_cov_71.959682	841	901	74	2	60	0.0333333
NODE_1737_length_1736_cov_71.959682	841	901	75	5	60	0.0833333
NODE_1737_length_1736_cov_71.959682	841	901	76	1	60	0.0166667
NODE_1737_length_1736_cov_71.959682	841	901	81	4	60	0.0666667
NODE_1737_length_1736_cov_71.959682	841	901	82	2	60	0.0333333
NODE_1737_length_1736_cov_71.959682	841	901	83	1	60	0.0166667
NODE_1737_length_1736_cov_71.959682	841	901	84	2	60	0.0333333
NODE_1737_length_1736_cov_71.959682	841	901	85	2	60	0.0333333
NODE_1737_length_1736_cov_71.959682	841	901	86	17	60	0.2833333
NODE_1738_length_1736_cov_29.174710	1361	1390	125	4	29	0.1379310
NODE_1738_length_1736_cov_29.174710	1361	1390	126	1	29	0.0344828
NODE_1738_length_1736_cov_29.174710	1361	1390	127	1	29	0.0344828
NODE_1738_length_1736_cov_29.174710	1361	1390	130	3	29	0.1034483
NODE_1738_length_1736_cov_29.174710	1361	1390	132	2	29	0.0689655
NODE_1738_length_1736_cov_29.174710	1361	1390	134	2	29	0.0689655
NODE_1738_length_1736_cov_29.174710	1361	1390	135	1	29	0.0344828
NODE_1738_length_1736_cov_29.174710	1361	1390	136	5	29	0.1724138
NODE_1738_length_1736_cov_29.174710	1361	1390	138	4	29	0.1379310
NODE_1738_length_1736_cov_29.174710	1361	1390	140	2	29	0.0689655
NODE_1738_length_1736_cov_29.174710	1361	1390	141	2	29	0.0689655
NODE_1738_length_1736_cov_29.174710	1361	1390	143	2	29	0.0689655
NODE_1738_length_1736_cov_29.174710	1566	1628	233	1	62	0.0161290
NODE_1738_length_1736_cov_29.174710	1566	1628	235	2	62	0.0322581
NODE_1738_length_1736_cov_29.174710	1566	1628	237	2	62	0.0322581
NODE_1738_length_1736_cov_29.174710	1566	1628	238	1	62	0.0161290
NODE_1738_length_1736_cov_29.174710	1566	1628	239	4	62	0.0645161
NODE_1738_length_1736_cov_29.174710	1566	1628	240	1	62	0.0161290
NODE_1738_length_1736_cov_29.174710	1566	1628	242	1	62	0.0161290
NODE_1738_length_1736_cov_29.174710	1566	1628	243	2	62	0.0322581
NODE_1738_length_1736_cov_29.174710	1566	1628	245	4	62	0.0645161
NODE_1738_length_1736_cov_29.174710	1566	1628	246	6	62	0.0967742
NODE_1738_length_1736_cov_29.174710	1566	1628	247	3	62	0.0483871
NODE_1738_length_1736_cov_29.174710	1566	1628	248	2	62	0.0322581
NODE_1738_length_1736_cov_29.174710	1566	1628	249	1	62	0.0161290
NODE_1738_length_1736_cov_29.174710	1566	1628	251	1	62	0.0161290
NODE_1738_length_1736_cov_29.174710	1566	1628	252	2	62	0.0322581
NODE_1738_length_1736_cov_29.174710	1566	1628	253	1	62	0.0161290
NODE_1738_length_1736_cov_29.174710	1566	1628	254	4	62	0.0645161
NODE_1738_length_1736_cov_29.174710	1566	1628	256	1	62	0.0161290
NODE_1738_length_1736_cov_29.174710	1566	1628	257	1	62	0.0161290
NODE_1738_length_1736_cov_29.174710	1566	1628	258	1	62	0.0161290
NODE_1738_length_1736_cov_29.174710	1566	1628	259	1	62	0.0161290
NODE_1738_length_1736_cov_29.174710	1566	1628	260	1	62	0.0161290
NODE_1738_length_1736_cov_29.174710	1566	1628	262	1	62	0.0161290
NODE_1738_length_1736_cov_29.174710	1566	1628	264	2	62	0.0322581
NODE_1738_length_1736_cov_29.174710	1566	1628	265	2	62	0.0322581
NODE_1738_length_1736_cov_29.174710	1566	1628	266	1	62	0.0161290
NODE_1738_length_1736_cov_29.174710	1566	1628	268	1	62	0.0161290
NODE_1738_length_1736_cov_29.174710	1566	1628	269	3	62	0.0483871
NODE_1738_length_1736_cov_29.174710	1566	1628	270	1	62	0.0161290
NODE_1738_length_1736_cov_29.174710	1566	1628	272	2	62	0.0322581
NODE_1738_length_1736_cov_29.174710	1566	1628	273	2	62	0.0322581
NODE_1738_length_1736_cov_29.174710	1566	1628	275	1	62	0.0161290
NODE_1738_length_1736_cov_29.174710	1566	1628	281	3	62	0.0483871
NODE_1743_length_1732_cov_6.162890	807	887	2	80	80	1.0000000
NODE_1743_length_1732_cov_6.162890	860	940	0	47	80	0.5875000
NODE_1743_length_1732_cov_6.162890	860	940	2	33	80	0.4125000
NODE_1749_length_1729_cov_23.708589	364	443	6	35	79	0.4430380
NODE_1749_length_1729_cov_23.708589	364	443	8	38	79	0.4810127
NODE_1749_length_1729_cov_23.708589	364	443	11	6	79	0.0759494
NODE_1749_length_1729_cov_23.708589	416	496	5	9	80	0.1125000
NODE_1749_length_1729_cov_23.708589	416	496	6	21	80	0.2625000
NODE_1749_length_1729_cov_23.708589	416	496	10	1	80	0.0125000
NODE_1749_length_1729_cov_23.708589	416	496	11	49	80	0.6125000
NODE_1749_length_1729_cov_23.708589	492	572	0	28	80	0.3500000
NODE_1749_length_1729_cov_23.708589	492	572	5	15	80	0.1875000
NODE_1749_length_1729_cov_23.708589	492	572	6	37	80	0.4625000
NODE_1749_length_1729_cov_23.708589	545	625	0	80	80	1.0000000
NODE_1753_length_1728_cov_26.505832	259	339	0	80	80	1.0000000
NODE_1753_length_1728_cov_26.505832	312	392	0	80	80	1.0000000
NODE_1757_length_1725_cov_142.158057	767	814	524	1	47	0.0212766
NODE_1757_length_1725_cov_142.158057	767	814	531	1	47	0.0212766
NODE_1757_length_1725_cov_142.158057	767	814	532	1	47	0.0212766
NODE_1757_length_1725_cov_142.158057	767	814	536	1	47	0.0212766
NODE_1757_length_1725_cov_142.158057	767	814	540	2	47	0.0425532
NODE_1757_length_1725_cov_142.158057	767	814	551	1	47	0.0212766
NODE_1757_length_1725_cov_142.158057	767	814	552	1	47	0.0212766
NODE_1757_length_1725_cov_142.158057	767	814	553	2	47	0.0425532
NODE_1757_length_1725_cov_142.158057	767	814	556	1	47	0.0212766
NODE_1757_length_1725_cov_142.158057	767	814	557	1	47	0.0212766
NODE_1757_length_1725_cov_142.158057	767	814	565	1	47	0.0212766
NODE_1757_length_1725_cov_142.158057	767	814	568	1	47	0.0212766
NODE_1757_length_1725_cov_142.158057	767	814	574	1	47	0.0212766
NODE_1757_length_1725_cov_142.158057	767	814	580	1	47	0.0212766
NODE_1757_length_1725_cov_142.158057	767	814	587	1	47	0.0212766
NODE_1757_length_1725_cov_142.158057	767	814	588	1	47	0.0212766
NODE_1757_length_1725_cov_142.158057	767	814	599	1	47	0.0212766
NODE_1757_length_1725_cov_142.158057	767	814	613	1	47	0.0212766
NODE_1757_length_1725_cov_142.158057	767	814	624	1	47	0.0212766
NODE_1757_length_1725_cov_142.158057	767	814	626	1	47	0.0212766
NODE_1757_length_1725_cov_142.158057	767	814	629	1	47	0.0212766
NODE_1757_length_1725_cov_142.158057	767	814	635	1	47	0.0212766
NODE_1757_length_1725_cov_142.158057	767	814	651	2	47	0.0425532
NODE_1757_length_1725_cov_142.158057	767	814	652	1	47	0.0212766
NODE_1757_length_1725_cov_142.158057	767	814	662	1	47	0.0212766
NODE_1757_length_1725_cov_142.158057	767	814	663	1	47	0.0212766
NODE_1757_length_1725_cov_142.158057	767	814	664	1	47	0.0212766
NODE_1757_length_1725_cov_142.158057	767	814	665	1	47	0.0212766
NODE_1757_length_1725_cov_142.158057	767	814	666	1	47	0.0212766
NODE_1757_length_1725_cov_142.158057	767	814	668	1	47	0.0212766
NODE_1757_length_1725_cov_142.158057	767	814	682	1	47	0.0212766
NODE_1757_length_1725_cov_142.158057	767	814	684	1	47	0.0212766
NODE_1757_length_1725_cov_142.158057	767	814	689	2	47	0.0425532
NODE_1757_length_1725_cov_142.158057	767	814	691	2	47	0.0425532
NODE_1757_length_1725_cov_142.158057	767	814	692	2	47	0.0425532
NODE_1757_length_1725_cov_142.158057	767	814	694	1	47	0.0212766
NODE_1757_length_1725_cov_142.158057	767	814	695	1	47	0.0212766
NODE_1757_length_1725_cov_142.158057	767	814	696	3	47	0.0638298
NODE_1757_length_1725_cov_142.158057	767	814	697	1	47	0.0212766
NODE_1757_length_1725_cov_142.158057	803	867	542	1	64	0.0156250
NODE_1757_length_1725_cov_142.158057	803	867	544	1	64	0.0156250
NODE_1757_length_1725_cov_142.158057	803	867	548	1	64	0.0156250
NODE_1757_length_1725_cov_142.158057	803	867	563	1	64	0.0156250
NODE_1757_length_1725_cov_142.158057	803	867	568	1	64	0.0156250
NODE_1757_length_1725_cov_142.158057	803	867	572	1	64	0.0156250
NODE_1757_length_1725_cov_142.158057	803	867	576	1	64	0.0156250
NODE_1757_length_1725_cov_142.158057	803	867	578	1	64	0.0156250
NODE_1757_length_1725_cov_142.158057	803	867	580	1	64	0.0156250
NODE_1757_length_1725_cov_142.158057	803	867	585	1	64	0.0156250
NODE_1757_length_1725_cov_142.158057	803	867	590	1	64	0.0156250
NODE_1757_length_1725_cov_142.158057	803	867	592	1	64	0.0156250
NODE_1757_length_1725_cov_142.158057	803	867	593	1	64	0.0156250
NODE_1757_length_1725_cov_142.158057	803	867	594	1	64	0.0156250
NODE_1757_length_1725_cov_142.158057	803	867	598	1	64	0.0156250
NODE_1757_length_1725_cov_142.158057	803	867	607	1	64	0.0156250
NODE_1757_length_1725_cov_142.158057	803	867	612	1	64	0.0156250
NODE_1757_length_1725_cov_142.158057	803	867	613	1	64	0.0156250
NODE_1757_length_1725_cov_142.158057	803	867	621	2	64	0.0312500
NODE_1757_length_1725_cov_142.158057	803	867	625	1	64	0.0156250
NODE_1757_length_1725_cov_142.158057	803	867	641	2	64	0.0312500
NODE_1757_length_1725_cov_142.158057	803	867	647	1	64	0.0156250
NODE_1757_length_1725_cov_142.158057	803	867	649	1	64	0.0156250
NODE_1757_length_1725_cov_142.158057	803	867	657	1	64	0.0156250
NODE_1757_length_1725_cov_142.158057	803	867	659	1	64	0.0156250
NODE_1757_length_1725_cov_142.158057	803	867	660	2	64	0.0312500
NODE_1757_length_1725_cov_142.158057	803	867	661	1	64	0.0156250
NODE_1757_length_1725_cov_142.158057	803	867	665	1	64	0.0156250
NODE_1757_length_1725_cov_142.158057	803	867	666	1	64	0.0156250
NODE_1757_length_1725_cov_142.158057	803	867	670	1	64	0.0156250
NODE_1757_length_1725_cov_142.158057	803	867	674	1	64	0.0156250
NODE_1757_length_1725_cov_142.158057	803	867	676	1	64	0.0156250
NODE_1757_length_1725_cov_142.158057	803	867	678	2	64	0.0312500
NODE_1757_length_1725_cov_142.158057	803	867	683	1	64	0.0156250
NODE_1757_length_1725_cov_142.158057	803	867	689	4	64	0.0625000
NODE_1757_length_1725_cov_142.158057	803	867	690	1	64	0.0156250
NODE_1757_length_1725_cov_142.158057	803	867	691	3	64	0.0468750
NODE_1757_length_1725_cov_142.158057	803	867	692	2	64	0.0312500
NODE_1757_length_1725_cov_142.158057	803	867	693	4	64	0.0625000
NODE_1757_length_1725_cov_142.158057	803	867	694	2	64	0.0312500
NODE_1757_length_1725_cov_142.158057	803	867	695	3	64	0.0468750
NODE_1757_length_1725_cov_142.158057	803	867	696	4	64	0.0625000
NODE_1757_length_1725_cov_142.158057	803	867	697	2	64	0.0312500
NODE_1757_length_1725_cov_142.158057	803	867	699	1	64	0.0156250
NODE_1759_length_1724_cov_17.931077	677	746	0	69	69	1.0000000
NODE_1759_length_1724_cov_17.931077	788	850	0	62	62	1.0000000
NODE_1761_length_1723_cov_35.355296	1174	1254	0	80	80	1.0000000
NODE_1761_length_1723_cov_35.355296	1227	1307	0	80	80	1.0000000
NODE_1763_length_1722_cov_13.235367	708	788	0	80	80	1.0000000
NODE_1763_length_1722_cov_13.235367	761	841	0	80	80	1.0000000
NODE_1763_length_1722_cov_13.235367	1319	1399	0	80	80	1.0000000
NODE_1763_length_1722_cov_13.235367	1372	1452	0	80	80	1.0000000
NODE_1765_length_1720_cov_27.328192	1248	1307	49	1	59	0.0169492
NODE_1765_length_1720_cov_27.328192	1248	1307	51	1	59	0.0169492
NODE_1765_length_1720_cov_27.328192	1248	1307	53	52	59	0.8813559
NODE_1765_length_1720_cov_27.328192	1248	1307	55	1	59	0.0169492
NODE_1765_length_1720_cov_27.328192	1248	1307	57	4	59	0.0677966
NODE_1765_length_1720_cov_27.328192	1280	1360	43	6	80	0.0750000
NODE_1765_length_1720_cov_27.328192	1280	1360	53	22	80	0.2750000
NODE_1765_length_1720_cov_27.328192	1280	1360	54	41	80	0.5125000
NODE_1765_length_1720_cov_27.328192	1280	1360	55	3	80	0.0375000
NODE_1765_length_1720_cov_27.328192	1280	1360	56	1	80	0.0125000
NODE_1765_length_1720_cov_27.328192	1280	1360	57	7	80	0.0875000
NODE_1766_length_1720_cov_4.129550	241	321	0	80	80	1.0000000
NODE_1766_length_1720_cov_4.129550	294	374	0	80	80	1.0000000
NODE_1768_length_1719_cov_9.878395	410	490	0	78	80	0.9750000
NODE_1768_length_1719_cov_9.878395	410	490	2	2	80	0.0250000
NODE_1768_length_1719_cov_9.878395	463	543	0	25	80	0.3125000
NODE_1768_length_1719_cov_9.878395	463	543	2	55	80	0.6875000
NODE_1768_length_1719_cov_9.878395	539	619	0	74	80	0.9250000
NODE_1768_length_1719_cov_9.878395	539	619	2	6	80	0.0750000
NODE_1768_length_1719_cov_9.878395	592	672	0	80	80	1.0000000
NODE_1772_length_1717_cov_5.159456	145	219	4	2	74	0.0270270
NODE_1772_length_1717_cov_5.159456	145	219	6	3	74	0.0405405
NODE_1772_length_1717_cov_5.159456	145	219	8	1	74	0.0135135
NODE_1772_length_1717_cov_5.159456	145	219	10	5	74	0.0675676
NODE_1772_length_1717_cov_5.159456	145	219	12	12	74	0.1621622
NODE_1772_length_1717_cov_5.159456	145	219	14	2	74	0.0270270
NODE_1772_length_1717_cov_5.159456	145	219	19	3	74	0.0405405
NODE_1772_length_1717_cov_5.159456	145	219	21	2	74	0.0270270
NODE_1772_length_1717_cov_5.159456	145	219	23	2	74	0.0270270
NODE_1772_length_1717_cov_5.159456	145	219	25	3	74	0.0405405
NODE_1772_length_1717_cov_5.159456	145	219	27	1	74	0.0135135
NODE_1772_length_1717_cov_5.159456	145	219	31	3	74	0.0405405
NODE_1772_length_1717_cov_5.159456	145	219	33	6	74	0.0810811
NODE_1772_length_1717_cov_5.159456	145	219	36	1	74	0.0135135
NODE_1772_length_1717_cov_5.159456	145	219	37	2	74	0.0270270
NODE_1772_length_1717_cov_5.159456	145	219	39	12	74	0.1621622
NODE_1772_length_1717_cov_5.159456	145	219	43	7	74	0.0945946
NODE_1772_length_1717_cov_5.159456	145	219	45	7	74	0.0945946
NODE_1772_length_1717_cov_5.159456	1450	1508	0	58	58	1.0000000
NODE_1772_length_1717_cov_5.159456	1503	1561	0	21	58	0.3620690
NODE_1772_length_1717_cov_5.159456	1503	1561	2	37	58	0.6379310
NODE_1778_length_1715_cov_12.607054	555	635	0	80	80	1.0000000
NODE_1778_length_1715_cov_12.607054	608	688	0	80	80	1.0000000
NODE_1778_length_1715_cov_12.607054	684	764	0	80	80	1.0000000
NODE_1778_length_1715_cov_12.607054	737	817	0	80	80	1.0000000
NODE_1788_length_1707_cov_16.909204	397	477	0	29	80	0.3625000
NODE_1788_length_1707_cov_16.909204	397	477	2	51	80	0.6375000
NODE_1788_length_1707_cov_16.909204	450	530	0	5	80	0.0625000
NODE_1788_length_1707_cov_16.909204	450	530	2	75	80	0.9375000
NODE_1788_length_1707_cov_16.909204	1151	1231	0	80	80	1.0000000
NODE_1788_length_1707_cov_16.909204	1204	1284	0	80	80	1.0000000
NODE_1792_length_1705_cov_19.645081	451	531	0	80	80	1.0000000
NODE_1792_length_1705_cov_19.645081	504	584	0	80	80	1.0000000
NODE_1792_length_1705_cov_19.645081	580	660	0	80	80	1.0000000
NODE_1792_length_1705_cov_19.645081	633	714	0	81	81	1.0000000
NODE_1792_length_1705_cov_19.645081	1315	1395	0	65	80	0.8125000
NODE_1792_length_1705_cov_19.645081	1315	1395	2	15	80	0.1875000
NODE_1792_length_1705_cov_19.645081	1368	1448	0	17	80	0.2125000
NODE_1792_length_1705_cov_19.645081	1368	1448	2	63	80	0.7875000
NODE_1796_length_1703_cov_26.016833	1201	1264	0	52	63	0.8253968
NODE_1796_length_1703_cov_26.016833	1201	1264	12	3	63	0.0476190
NODE_1796_length_1703_cov_26.016833	1201	1264	35	1	63	0.0158730
NODE_1796_length_1703_cov_26.016833	1201	1264	39	1	63	0.0158730
NODE_1796_length_1703_cov_26.016833	1201	1264	43	1	63	0.0158730
NODE_1796_length_1703_cov_26.016833	1201	1264	47	1	63	0.0158730
NODE_1796_length_1703_cov_26.016833	1201	1264	49	4	63	0.0634921
NODE_1796_length_1703_cov_26.016833	1207	1264	0	52	57	0.9122807
NODE_1796_length_1703_cov_26.016833	1207	1264	12	3	57	0.0526316
NODE_1796_length_1703_cov_26.016833	1207	1264	35	1	57	0.0175439
NODE_1796_length_1703_cov_26.016833	1207	1264	39	1	57	0.0175439
NODE_1796_length_1703_cov_26.016833	1207	1264	0	52	57	0.9122807
NODE_1796_length_1703_cov_26.016833	1207	1264	12	3	57	0.0526316
NODE_1796_length_1703_cov_26.016833	1207	1264	35	1	57	0.0175439
NODE_1796_length_1703_cov_26.016833	1207	1264	39	1	57	0.0175439
NODE_1799_length_1701_cov_15.969413	1490	1565	24	3	75	0.0400000
NODE_1799_length_1701_cov_15.969413	1490	1565	26	1	75	0.0133333
NODE_1799_length_1701_cov_15.969413	1490	1565	31	1	75	0.0133333
NODE_1799_length_1701_cov_15.969413	1490	1565	32	6	75	0.0800000
NODE_1799_length_1701_cov_15.969413	1490	1565	33	1	75	0.0133333
NODE_1799_length_1701_cov_15.969413	1490	1565	36	2	75	0.0266667
NODE_1799_length_1701_cov_15.969413	1490	1565	38	4	75	0.0533333
NODE_1799_length_1701_cov_15.969413	1490	1565	42	9	75	0.1200000
NODE_1799_length_1701_cov_15.969413	1490	1565	44	2	75	0.0266667
NODE_1799_length_1701_cov_15.969413	1490	1565	51	10	75	0.1333333
NODE_1799_length_1701_cov_15.969413	1490	1565	53	19	75	0.2533333
NODE_1799_length_1701_cov_15.969413	1490	1565	55	1	75	0.0133333
NODE_1799_length_1701_cov_15.969413	1490	1565	57	1	75	0.0133333
NODE_1799_length_1701_cov_15.969413	1490	1565	61	1	75	0.0133333
NODE_1799_length_1701_cov_15.969413	1490	1565	67	6	75	0.0800000
NODE_1799_length_1701_cov_15.969413	1490	1565	69	3	75	0.0400000
NODE_1799_length_1701_cov_15.969413	1490	1565	76	1	75	0.0133333
NODE_1799_length_1701_cov_15.969413	1490	1565	78	2	75	0.0266667
NODE_1799_length_1701_cov_15.969413	1490	1565	83	1	75	0.0133333
NODE_1799_length_1701_cov_15.969413	1490	1565	87	1	75	0.0133333
NODE_1799_length_1701_cov_15.969413	1538	1603	53	10	65	0.1538462
NODE_1799_length_1701_cov_15.969413	1538	1603	55	1	65	0.0153846
NODE_1799_length_1701_cov_15.969413	1538	1603	57	1	65	0.0153846
NODE_1799_length_1701_cov_15.969413	1538	1603	61	1	65	0.0153846
NODE_1799_length_1701_cov_15.969413	1538	1603	67	6	65	0.0923077
NODE_1799_length_1701_cov_15.969413	1538	1603	69	3	65	0.0461538
NODE_1799_length_1701_cov_15.969413	1538	1603	76	1	65	0.0153846
NODE_1799_length_1701_cov_15.969413	1538	1603	78	2	65	0.0307692
NODE_1799_length_1701_cov_15.969413	1538	1603	83	1	65	0.0153846
NODE_1799_length_1701_cov_15.969413	1538	1603	87	3	65	0.0461538
NODE_1799_length_1701_cov_15.969413	1538	1603	89	7	65	0.1076923
NODE_1799_length_1701_cov_15.969413	1538	1603	91	2	65	0.0307692
NODE_1799_length_1701_cov_15.969413	1538	1603	93	2	65	0.0307692
NODE_1799_length_1701_cov_15.969413	1538	1603	99	5	65	0.0769231
NODE_1799_length_1701_cov_15.969413	1538	1603	101	3	65	0.0461538
NODE_1799_length_1701_cov_15.969413	1538	1603	102	3	65	0.0461538
NODE_1799_length_1701_cov_15.969413	1538	1603	103	3	65	0.0461538
NODE_1799_length_1701_cov_15.969413	1538	1603	104	8	65	0.1230769
NODE_1799_length_1701_cov_15.969413	1538	1603	105	3	65	0.0461538
NODE_1800_length_1701_cov_13.549313	607	687	1	54	80	0.6750000
NODE_1800_length_1701_cov_13.549313	607	687	3	26	80	0.3250000
NODE_1800_length_1701_cov_13.549313	660	740	1	80	80	1.0000000
NODE_1805_length_1700_cov_20.003123	1168	1197	261	2	29	0.0689655
NODE_1805_length_1700_cov_20.003123	1168	1197	263	2	29	0.0689655
NODE_1805_length_1700_cov_20.003123	1168	1197	266	2	29	0.0689655
NODE_1805_length_1700_cov_20.003123	1168	1197	267	3	29	0.1034483
NODE_1805_length_1700_cov_20.003123	1168	1197	269	1	29	0.0344828
NODE_1805_length_1700_cov_20.003123	1168	1197	271	1	29	0.0344828
NODE_1805_length_1700_cov_20.003123	1168	1197	274	2	29	0.0689655
NODE_1805_length_1700_cov_20.003123	1168	1197	275	1	29	0.0344828
NODE_1805_length_1700_cov_20.003123	1168	1197	278	1	29	0.0344828
NODE_1805_length_1700_cov_20.003123	1168	1197	284	1	29	0.0344828
NODE_1805_length_1700_cov_20.003123	1168	1197	286	1	29	0.0344828
NODE_1805_length_1700_cov_20.003123	1168	1197	290	1	29	0.0344828
NODE_1805_length_1700_cov_20.003123	1168	1197	297	1	29	0.0344828
NODE_1805_length_1700_cov_20.003123	1168	1197	299	1	29	0.0344828
NODE_1805_length_1700_cov_20.003123	1168	1197	300	1	29	0.0344828
NODE_1805_length_1700_cov_20.003123	1168	1197	303	1	29	0.0344828
NODE_1805_length_1700_cov_20.003123	1168	1197	307	1	29	0.0344828
NODE_1805_length_1700_cov_20.003123	1168	1197	312	1	29	0.0344828
NODE_1805_length_1700_cov_20.003123	1168	1197	313	1	29	0.0344828
NODE_1805_length_1700_cov_20.003123	1168	1197	316	2	29	0.0689655
NODE_1805_length_1700_cov_20.003123	1168	1197	318	1	29	0.0344828
NODE_1805_length_1700_cov_20.003123	1168	1197	322	1	29	0.0344828
NODE_1805_length_1700_cov_20.003123	1184	1263	238	1	79	0.0126582
NODE_1805_length_1700_cov_20.003123	1184	1263	239	2	79	0.0253165
NODE_1805_length_1700_cov_20.003123	1184	1263	240	2	79	0.0253165
NODE_1805_length_1700_cov_20.003123	1184	1263	243	3	79	0.0379747
NODE_1805_length_1700_cov_20.003123	1184	1263	244	1	79	0.0126582
NODE_1805_length_1700_cov_20.003123	1184	1263	246	2	79	0.0253165
NODE_1805_length_1700_cov_20.003123	1184	1263	247	1	79	0.0126582
NODE_1805_length_1700_cov_20.003123	1184	1263	248	1	79	0.0126582
NODE_1805_length_1700_cov_20.003123	1184	1263	249	1	79	0.0126582
NODE_1805_length_1700_cov_20.003123	1184	1263	251	1	79	0.0126582
NODE_1805_length_1700_cov_20.003123	1184	1263	252	1	79	0.0126582
NODE_1805_length_1700_cov_20.003123	1184	1263	254	5	79	0.0632911
NODE_1805_length_1700_cov_20.003123	1184	1263	257	3	79	0.0379747
NODE_1805_length_1700_cov_20.003123	1184	1263	260	1	79	0.0126582
NODE_1805_length_1700_cov_20.003123	1184	1263	261	2	79	0.0253165
NODE_1805_length_1700_cov_20.003123	1184	1263	262	3	79	0.0379747
NODE_1805_length_1700_cov_20.003123	1184	1263	263	3	79	0.0379747
NODE_1805_length_1700_cov_20.003123	1184	1263	266	2	79	0.0253165
NODE_1805_length_1700_cov_20.003123	1184	1263	267	3	79	0.0379747
NODE_1805_length_1700_cov_20.003123	1184	1263	268	1	79	0.0126582
NODE_1805_length_1700_cov_20.003123	1184	1263	269	1	79	0.0126582
NODE_1805_length_1700_cov_20.003123	1184	1263	271	4	79	0.0506329
NODE_1805_length_1700_cov_20.003123	1184	1263	272	2	79	0.0253165
NODE_1805_length_1700_cov_20.003123	1184	1263	273	1	79	0.0126582
NODE_1805_length_1700_cov_20.003123	1184	1263	274	2	79	0.0253165
NODE_1805_length_1700_cov_20.003123	1184	1263	275	4	79	0.0506329
NODE_1805_length_1700_cov_20.003123	1184	1263	276	4	79	0.0506329
NODE_1805_length_1700_cov_20.003123	1184	1263	277	3	79	0.0379747
NODE_1805_length_1700_cov_20.003123	1184	1263	279	3	79	0.0379747
NODE_1805_length_1700_cov_20.003123	1184	1263	281	2	79	0.0253165
NODE_1805_length_1700_cov_20.003123	1184	1263	283	2	79	0.0253165
NODE_1805_length_1700_cov_20.003123	1184	1263	284	2	79	0.0253165
NODE_1805_length_1700_cov_20.003123	1184	1263	285	3	79	0.0379747
NODE_1805_length_1700_cov_20.003123	1184	1263	286	2	79	0.0253165
NODE_1805_length_1700_cov_20.003123	1184	1263	287	3	79	0.0379747
NODE_1805_length_1700_cov_20.003123	1184	1263	289	1	79	0.0126582
NODE_1805_length_1700_cov_20.003123	1184	1263	290	1	79	0.0126582
NODE_1810_length_1698_cov_19.175735	1001	1081	0	80	80	1.0000000
NODE_1810_length_1698_cov_19.175735	1054	1134	0	80	80	1.0000000
NODE_1814_length_1696_cov_11.494678	590	670	0	80	80	1.0000000
NODE_1814_length_1696_cov_11.494678	643	723	0	80	80	1.0000000
NODE_1815_length_1696_cov_6.620539	369	449	0	80	80	1.0000000
NODE_1815_length_1696_cov_6.620539	422	502	0	80	80	1.0000000
NODE_1816_length_1695_cov_27.783208	399	479	0	80	80	1.0000000
NODE_1816_length_1695_cov_27.783208	452	532	0	80	80	1.0000000
NODE_1817_length_1695_cov_12.084586	1047	1127	0	80	80	1.0000000
NODE_1817_length_1695_cov_12.084586	1100	1180	0	80	80	1.0000000
NODE_1825_length_1692_cov_4.557439	727	807	0	80	80	1.0000000
NODE_1825_length_1692_cov_4.557439	780	860	0	80	80	1.0000000
NODE_1830_length_1689_cov_5.844025	1210	1285	0	29	75	0.3866667
NODE_1830_length_1689_cov_5.844025	1210	1285	2	46	75	0.6133333
NODE_1830_length_1689_cov_5.844025	1260	1338	0	78	78	1.0000000
NODE_1837_length_1682_cov_14.416930	1183	1263	0	80	80	1.0000000
NODE_1837_length_1682_cov_14.416930	1236	1315	0	79	79	1.0000000
NODE_1843_length_1678_cov_23.965168	636	716	0	80	80	1.0000000
NODE_1843_length_1678_cov_23.965168	689	769	0	80	80	1.0000000
NODE_1843_length_1678_cov_23.965168	1145	1225	0	80	80	1.0000000
NODE_1843_length_1678_cov_23.965168	1198	1278	0	80	80	1.0000000
NODE_1846_length_1677_cov_3.578580	407	487	0	80	80	1.0000000
NODE_1846_length_1677_cov_3.578580	460	530	0	70	70	1.0000000
NODE_1846_length_1677_cov_3.578580	666	724	0	58	58	1.0000000
NODE_1856_length_1670_cov_29.264163	741	821	0	80	80	1.0000000
NODE_1856_length_1670_cov_29.264163	794	874	0	80	80	1.0000000
NODE_1857_length_1669_cov_5.913376	246	326	0	80	80	1.0000000
NODE_1857_length_1669_cov_5.913376	299	379	0	80	80	1.0000000
NODE_1860_length_1668_cov_18.372212	1100	1180	0	80	80	1.0000000
NODE_1860_length_1668_cov_18.372212	1153	1233	0	80	80	1.0000000
NODE_1861_length_1667_cov_15.651786	902	982	2	21	80	0.2625000
NODE_1861_length_1667_cov_15.651786	902	982	6	49	80	0.6125000
NODE_1861_length_1667_cov_15.651786	902	982	8	10	80	0.1250000
NODE_1861_length_1667_cov_15.651786	955	1035	0	25	80	0.3125000
NODE_1861_length_1667_cov_15.651786	955	1035	6	55	80	0.6875000
NODE_1862_length_1667_cov_3.661352	649	679	0	30	30	1.0000000
NODE_1865_length_1666_cov_4.601149	1541	1623	0	50	82	0.6097561
NODE_1865_length_1666_cov_4.601149	1541	1623	1	32	82	0.3902439
NODE_1865_length_1666_cov_4.601149	1553	1613	0	40	60	0.6666667
NODE_1865_length_1666_cov_4.601149	1553	1613	1	20	60	0.3333333
NODE_1865_length_1666_cov_4.601149	1553	1613	0	40	60	0.6666667
NODE_1865_length_1666_cov_4.601149	1553	1613	1	20	60	0.3333333
NODE_1865_length_1666_cov_4.601149	1557	1623	0	50	66	0.7575758
NODE_1865_length_1666_cov_4.601149	1557	1623	1	16	66	0.2424242
NODE_1865_length_1666_cov_4.601149	1596	1666	0	70	70	1.0000000
NODE_1865_length_1666_cov_4.601149	1596	1666	0	70	70	1.0000000
NODE_1865_length_1666_cov_4.601149	1596	1666	0	70	70	1.0000000
NODE_1872_length_1662_cov_16.638516	538	618	0	6	80	0.0750000
NODE_1872_length_1662_cov_16.638516	538	618	2	74	80	0.9250000
NODE_1872_length_1662_cov_16.638516	591	671	2	80	80	1.0000000
NODE_1872_length_1662_cov_16.638516	667	747	0	65	80	0.8125000
NODE_1872_length_1662_cov_16.638516	667	747	2	15	80	0.1875000
NODE_1872_length_1662_cov_16.638516	720	800	0	80	80	1.0000000
NODE_1876_length_1660_cov_28.297886	415	495	0	80	80	1.0000000
NODE_1876_length_1660_cov_28.297886	468	548	0	80	80	1.0000000
NODE_1886_length_1654_cov_17.245016	631	711	0	55	80	0.6875000
NODE_1886_length_1654_cov_17.245016	631	711	2	25	80	0.3125000
NODE_1886_length_1654_cov_17.245016	684	764	0	2	80	0.0250000
NODE_1886_length_1654_cov_17.245016	684	764	2	78	80	0.9750000
NODE_1888_length_1653_cov_34.827542	0	41	0	41	41	1.0000000
NODE_1888_length_1653_cov_34.827542	14	44	0	30	30	1.0000000
NODE_1888_length_1653_cov_34.827542	1081	1161	4	19	80	0.2375000
NODE_1888_length_1653_cov_34.827542	1081	1161	6	29	80	0.3625000
NODE_1888_length_1653_cov_34.827542	1081	1161	8	32	80	0.4000000
NODE_1888_length_1653_cov_34.827542	1134	1214	4	9	80	0.1125000
NODE_1888_length_1653_cov_34.827542	1134	1214	6	32	80	0.4000000
NODE_1888_length_1653_cov_34.827542	1134	1214	8	38	80	0.4750000
NODE_1888_length_1653_cov_34.827542	1134	1214	10	1	80	0.0125000
NODE_1888_length_1653_cov_34.827542	1210	1290	4	31	80	0.3875000
NODE_1888_length_1653_cov_34.827542	1210	1290	6	28	80	0.3500000
NODE_1888_length_1653_cov_34.827542	1210	1290	8	21	80	0.2625000
NODE_1888_length_1653_cov_34.827542	1263	1339	2	48	76	0.6315789
NODE_1888_length_1653_cov_34.827542	1263	1339	4	20	76	0.2631579
NODE_1888_length_1653_cov_34.827542	1263	1339	6	8	76	0.1052632
NODE_1892_length_1652_cov_23.939472	1352	1432	0	80	80	1.0000000
NODE_1892_length_1652_cov_23.939472	1405	1485	0	80	80	1.0000000
NODE_1894_length_1651_cov_3.916881	1552	1617	0	65	65	1.0000000
NODE_1899_length_1649_cov_7.480000	774	854	0	80	80	1.0000000
NODE_1899_length_1649_cov_7.480000	827	907	0	80	80	1.0000000
NODE_1903_length_1647_cov_3.534238	1012	1075	0	63	63	1.0000000
NODE_1906_length_1645_cov_16.040103	155	235	0	80	80	1.0000000
NODE_1906_length_1645_cov_16.040103	208	288	0	80	80	1.0000000
NODE_1906_length_1645_cov_16.040103	1090	1170	2	62	80	0.7750000
NODE_1906_length_1645_cov_16.040103	1090	1170	3	5	80	0.0625000
NODE_1906_length_1645_cov_16.040103	1090	1170	4	13	80	0.1625000
NODE_1906_length_1645_cov_16.040103	1143	1222	0	30	79	0.3797468
NODE_1906_length_1645_cov_16.040103	1143	1222	1	2	79	0.0253165
NODE_1906_length_1645_cov_16.040103	1143	1222	2	47	79	0.5949367
NODE_1908_length_1644_cov_2.902913	1160	1240	2	80	80	1.0000000
NODE_1917_length_1641_cov_34.032425	487	567	0	80	80	1.0000000
NODE_1917_length_1641_cov_34.032425	540	620	0	80	80	1.0000000
NODE_1917_length_1641_cov_34.032425	616	696	0	80	80	1.0000000
NODE_1917_length_1641_cov_34.032425	669	749	0	80	80	1.0000000
NODE_1917_length_1641_cov_34.032425	1168	1248	0	80	80	1.0000000
NODE_1917_length_1641_cov_34.032425	1219	1301	0	82	82	1.0000000
NODE_1918_length_1641_cov_7.042802	339	390	0	51	51	1.0000000
NODE_1922_length_1640_cov_33.097339	943	1023	0	80	80	1.0000000
NODE_1922_length_1640_cov_33.097339	996	1076	0	80	80	1.0000000
NODE_1922_length_1640_cov_33.097339	1072	1152	0	80	80	1.0000000
NODE_1922_length_1640_cov_33.097339	1125	1206	0	81	81	1.0000000
NODE_1923_length_1640_cov_18.519143	471	551	0	80	80	1.0000000
NODE_1923_length_1640_cov_18.519143	524	604	0	80	80	1.0000000
NODE_1925_length_1639_cov_6.585714	975	1056	0	81	81	1.0000000
NODE_1925_length_1639_cov_6.585714	1028	1109	0	81	81	1.0000000
NODE_1926_length_1639_cov_2.163636	1260	1334	0	74	74	1.0000000
NODE_1926_length_1639_cov_2.163636	1312	1387	0	75	75	1.0000000
NODE_1928_length_1638_cov_18.598441	443	523	0	25	80	0.3125000
NODE_1928_length_1638_cov_18.598441	443	523	2	55	80	0.6875000
NODE_1928_length_1638_cov_18.598441	496	576	0	36	80	0.4500000
NODE_1928_length_1638_cov_18.598441	496	576	2	44	80	0.5500000
NODE_1928_length_1638_cov_18.598441	1157	1237	0	80	80	1.0000000
NODE_1928_length_1638_cov_18.598441	1210	1290	0	63	80	0.7875000
NODE_1928_length_1638_cov_18.598441	1210	1290	2	17	80	0.2125000
NODE_1932_length_1637_cov_12.048765	410	490	0	41	80	0.5125000
NODE_1932_length_1637_cov_12.048765	410	490	4	39	80	0.4875000
NODE_1932_length_1637_cov_12.048765	463	543	0	8	80	0.1000000
NODE_1932_length_1637_cov_12.048765	463	543	4	72	80	0.9000000
NODE_1932_length_1637_cov_12.048765	1081	1161	0	80	80	1.0000000
NODE_1932_length_1637_cov_12.048765	1134	1214	0	80	80	1.0000000
NODE_1934_length_1635_cov_21.022786	958	1038	0	80	80	1.0000000
NODE_1934_length_1635_cov_21.022786	1011	1091	0	80	80	1.0000000
NODE_1934_length_1635_cov_21.022786	1087	1167	0	80	80	1.0000000
NODE_1934_length_1635_cov_21.022786	1140	1220	0	80	80	1.0000000
NODE_1936_length_1633_cov_16.743807	1067	1147	2	80	80	1.0000000
NODE_1936_length_1633_cov_16.743807	1120	1200	0	45	80	0.5625000
NODE_1936_length_1633_cov_16.743807	1120	1200	2	35	80	0.4375000
NODE_1937_length_1633_cov_14.271838	977	1057	0	80	80	1.0000000
NODE_1937_length_1633_cov_14.271838	1030	1110	0	80	80	1.0000000
NODE_1937_length_1633_cov_14.271838	1106	1186	0	80	80	1.0000000
NODE_1937_length_1633_cov_14.271838	1159	1239	0	80	80	1.0000000
NODE_1939_length_1631_cov_25.881201	424	504	4	60	80	0.7500000
NODE_1939_length_1631_cov_25.881201	424	504	5	12	80	0.1500000
NODE_1939_length_1631_cov_25.881201	424	504	6	8	80	0.1000000
NODE_1939_length_1631_cov_25.881201	477	557	0	26	80	0.3250000
NODE_1939_length_1631_cov_25.881201	477	557	2	13	80	0.1625000
NODE_1939_length_1631_cov_25.881201	477	557	4	41	80	0.5125000
NODE_1939_length_1631_cov_25.881201	553	633	0	80	80	1.0000000
NODE_1939_length_1631_cov_25.881201	606	686	0	80	80	1.0000000
NODE_1943_length_1629_cov_32.733987	518	598	1	80	80	1.0000000
NODE_1943_length_1629_cov_32.733987	635	715	1	80	80	1.0000000
NODE_1943_length_1629_cov_32.733987	688	768	0	5	80	0.0625000
NODE_1943_length_1629_cov_32.733987	688	768	1	75	80	0.9375000
NODE_1946_length_1628_cov_15.551995	1454	1518	91	1	64	0.0156250
NODE_1946_length_1628_cov_15.551995	1454	1518	100	1	64	0.0156250
NODE_1946_length_1628_cov_15.551995	1454	1518	104	2	64	0.0312500
NODE_1946_length_1628_cov_15.551995	1454	1518	109	1	64	0.0156250
NODE_1946_length_1628_cov_15.551995	1454	1518	111	1	64	0.0156250
NODE_1946_length_1628_cov_15.551995	1454	1518	114	1	64	0.0156250
NODE_1946_length_1628_cov_15.551995	1454	1518	119	1	64	0.0156250
NODE_1946_length_1628_cov_15.551995	1454	1518	121	1	64	0.0156250
NODE_1946_length_1628_cov_15.551995	1454	1518	126	1	64	0.0156250
NODE_1946_length_1628_cov_15.551995	1454	1518	127	1	64	0.0156250
NODE_1946_length_1628_cov_15.551995	1454	1518	131	1	64	0.0156250
NODE_1946_length_1628_cov_15.551995	1454	1518	134	1	64	0.0156250
NODE_1946_length_1628_cov_15.551995	1454	1518	138	3	64	0.0468750
NODE_1946_length_1628_cov_15.551995	1454	1518	146	1	64	0.0156250
NODE_1946_length_1628_cov_15.551995	1454	1518	152	1	64	0.0156250
NODE_1946_length_1628_cov_15.551995	1454	1518	155	1	64	0.0156250
NODE_1946_length_1628_cov_15.551995	1454	1518	158	1	64	0.0156250
NODE_1946_length_1628_cov_15.551995	1454	1518	162	1	64	0.0156250
NODE_1946_length_1628_cov_15.551995	1454	1518	164	1	64	0.0156250
NODE_1946_length_1628_cov_15.551995	1454	1518	166	1	64	0.0156250
NODE_1946_length_1628_cov_15.551995	1454	1518	168	2	64	0.0312500
NODE_1946_length_1628_cov_15.551995	1454	1518	172	2	64	0.0312500
NODE_1946_length_1628_cov_15.551995	1454	1518	176	1	64	0.0156250
NODE_1946_length_1628_cov_15.551995	1454	1518	182	1	64	0.0156250
NODE_1946_length_1628_cov_15.551995	1454	1518	183	1	64	0.0156250
NODE_1946_length_1628_cov_15.551995	1454	1518	187	1	64	0.0156250
NODE_1946_length_1628_cov_15.551995	1454	1518	189	3	64	0.0468750
NODE_1946_length_1628_cov_15.551995	1454	1518	191	3	64	0.0468750
NODE_1946_length_1628_cov_15.551995	1454	1518	195	2	64	0.0312500
NODE_1946_length_1628_cov_15.551995	1454	1518	196	3	64	0.0468750
NODE_1946_length_1628_cov_15.551995	1454	1518	198	1	64	0.0156250
NODE_1946_length_1628_cov_15.551995	1454	1518	199	2	64	0.0312500
NODE_1946_length_1628_cov_15.551995	1454	1518	205	1	64	0.0156250
NODE_1946_length_1628_cov_15.551995	1454	1518	209	1	64	0.0156250
NODE_1946_length_1628_cov_15.551995	1454	1518	211	1	64	0.0156250
NODE_1946_length_1628_cov_15.551995	1454	1518	215	1	64	0.0156250
NODE_1946_length_1628_cov_15.551995	1454	1518	219	1	64	0.0156250
NODE_1946_length_1628_cov_15.551995	1454	1518	221	3	64	0.0468750
NODE_1946_length_1628_cov_15.551995	1454	1518	223	3	64	0.0468750
NODE_1946_length_1628_cov_15.551995	1454	1518	225	1	64	0.0156250
NODE_1946_length_1628_cov_15.551995	1454	1518	227	1	64	0.0156250
NODE_1946_length_1628_cov_15.551995	1454	1518	229	6	64	0.0937500
NODE_1947_length_1628_cov_4.852845	81	163	16	5	82	0.0609756
NODE_1947_length_1628_cov_4.852845	81	163	20	3	82	0.0365854
NODE_1947_length_1628_cov_4.852845	81	163	21	9	82	0.1097561
NODE_1947_length_1628_cov_4.852845	81	163	22	56	82	0.6829268
NODE_1947_length_1628_cov_4.852845	81	163	24	9	82	0.1097561
NODE_1952_length_1626_cov_20.549443	495	575	0	29	80	0.3625000
NODE_1952_length_1626_cov_20.549443	495	575	1	31	80	0.3875000
NODE_1952_length_1626_cov_20.549443	495	575	2	20	80	0.2500000
NODE_1952_length_1626_cov_20.549443	548	628	0	80	80	1.0000000
NODE_1953_length_1626_cov_6.552718	1189	1269	0	80	80	1.0000000
NODE_1953_length_1626_cov_6.552718	1242	1321	0	79	79	1.0000000
NODE_1954_length_1626_cov_4.728880	247	329	0	15	82	0.1829268
NODE_1954_length_1626_cov_4.728880	247	329	2	67	82	0.8170732
NODE_1954_length_1626_cov_4.728880	302	382	0	54	80	0.6750000
NODE_1954_length_1626_cov_4.728880	302	382	2	26	80	0.3250000
NODE_1956_length_1625_cov_20.598952	938	1018	0	80	80	1.0000000
NODE_1956_length_1625_cov_20.598952	991	1071	0	80	80	1.0000000
NODE_1962_length_1623_cov_28.551181	416	486	6	7	70	0.1000000
NODE_1962_length_1623_cov_28.551181	416	486	8	63	70	0.9000000
NODE_1962_length_1623_cov_28.551181	459	507	0	6	48	0.1250000
NODE_1962_length_1623_cov_28.551181	459	507	1	4	48	0.0833333
NODE_1962_length_1623_cov_28.551181	459	507	5	8	48	0.1666667
NODE_1962_length_1623_cov_28.551181	459	507	6	10	48	0.2083333
NODE_1962_length_1623_cov_28.551181	459	507	8	20	48	0.4166667
NODE_1965_length_1622_cov_7.969140	645	725	0	80	80	1.0000000
NODE_1965_length_1622_cov_7.969140	698	778	0	80	80	1.0000000
NODE_1970_length_1621_cov_2.192510	330	401	2	7	71	0.0985916
NODE_1970_length_1621_cov_2.192510	330	401	6	64	71	0.9014084
NODE_1975_length_1618_cov_44.138907	361	441	0	1	80	0.0125000
NODE_1975_length_1618_cov_44.138907	361	441	2	79	80	0.9875000
NODE_1975_length_1618_cov_44.138907	414	494	0	54	80	0.6750000
NODE_1975_length_1618_cov_44.138907	414	494	2	26	80	0.3250000
NODE_1975_length_1618_cov_44.138907	1063	1143	0	80	80	1.0000000
NODE_1975_length_1618_cov_44.138907	1116	1196	0	80	80	1.0000000
NODE_1976_length_1618_cov_5.779460	332	414	6	82	82	1.0000000
NODE_1976_length_1618_cov_5.779460	387	467	0	43	80	0.5375000
NODE_1976_length_1618_cov_5.779460	387	467	6	37	80	0.4625000
NODE_1976_length_1618_cov_5.779460	972	1028	2	49	56	0.8750000
NODE_1976_length_1618_cov_5.779460	972	1028	3	1	56	0.0178571
NODE_1976_length_1618_cov_5.779460	972	1028	4	6	56	0.1071429
NODE_1980_length_1616_cov_5.313777	589	669	0	38	80	0.4750000
NODE_1980_length_1616_cov_5.313777	589	669	2	42	80	0.5250000
NODE_1980_length_1616_cov_5.313777	642	722	0	80	80	1.0000000
NODE_1981_length_1615_cov_12.575858	1032	1112	0	21	80	0.2625000
NODE_1981_length_1615_cov_12.575858	1032	1112	4	59	80	0.7375000
NODE_1981_length_1615_cov_12.575858	1085	1162	0	71	77	0.9220779
NODE_1981_length_1615_cov_12.575858	1085	1162	4	6	77	0.0779221
NODE_1981_length_1615_cov_12.575858	1158	1238	0	80	80	1.0000000
NODE_1981_length_1615_cov_12.575858	1211	1291	0	79	80	0.9875000
NODE_1981_length_1615_cov_12.575858	1211	1291	4	1	80	0.0125000
NODE_1983_length_1614_cov_94.900990	0	46	0	15	46	0.3260870
NODE_1983_length_1614_cov_94.900990	0	46	8	31	46	0.6739131
NODE_1983_length_1614_cov_94.900990	23	99	8	76	76	1.0000000
NODE_1984_length_1614_cov_18.799340	655	735	0	48	80	0.6000000
NODE_1984_length_1614_cov_18.799340	655	735	2	32	80	0.4000000
NODE_1984_length_1614_cov_18.799340	708	788	2	80	80	1.0000000
NODE_1986_length_1613_cov_6.865258	1128	1203	4	32	75	0.4266667
NODE_1986_length_1613_cov_6.865258	1128	1203	6	15	75	0.2000000
NODE_1986_length_1613_cov_6.865258	1128	1203	8	28	75	0.3733333
NODE_1986_length_1613_cov_6.865258	1176	1256	0	14	80	0.1750000
NODE_1986_length_1613_cov_6.865258	1176	1256	4	43	80	0.5375000
NODE_1986_length_1613_cov_6.865258	1176	1256	6	15	80	0.1875000
NODE_1986_length_1613_cov_6.865258	1176	1256	8	8	80	0.1000000
NODE_1993_length_1610_cov_18.014560	1035	1115	0	80	80	1.0000000
NODE_1993_length_1610_cov_18.014560	1088	1168	0	80	80	1.0000000
NODE_2001_length_1603_cov_9.128324	1109	1189	0	80	80	1.0000000
NODE_2001_length_1603_cov_9.128324	1162	1242	0	80	80	1.0000000
NODE_2003_length_1602_cov_79.840319	1378	1445	92	4	67	0.0597015
NODE_2003_length_1602_cov_79.840319	1378	1445	94	7	67	0.1044776
NODE_2003_length_1602_cov_79.840319	1378	1445	96	1	67	0.0149254
NODE_2003_length_1602_cov_79.840319	1378	1445	98	1	67	0.0149254
NODE_2003_length_1602_cov_79.840319	1378	1445	106	1	67	0.0149254
NODE_2003_length_1602_cov_79.840319	1378	1445	108	1	67	0.0149254
NODE_2003_length_1602_cov_79.840319	1378	1445	110	1	67	0.0149254
NODE_2003_length_1602_cov_79.840319	1378	1445	113	2	67	0.0298507
NODE_2003_length_1602_cov_79.840319	1378	1445	114	1	67	0.0149254
NODE_2003_length_1602_cov_79.840319	1378	1445	118	2	67	0.0298507
NODE_2003_length_1602_cov_79.840319	1378	1445	120	1	67	0.0149254
NODE_2003_length_1602_cov_79.840319	1378	1445	122	1	67	0.0149254
NODE_2003_length_1602_cov_79.840319	1378	1445	124	1	67	0.0149254
NODE_2003_length_1602_cov_79.840319	1378	1445	125	1	67	0.0149254
NODE_2003_length_1602_cov_79.840319	1378	1445	128	1	67	0.0149254
NODE_2003_length_1602_cov_79.840319	1378	1445	135	2	67	0.0298507
NODE_2003_length_1602_cov_79.840319	1378	1445	136	1	67	0.0149254
NODE_2003_length_1602_cov_79.840319	1378	1445	137	2	67	0.0298507
NODE_2003_length_1602_cov_79.840319	1378	1445	142	1	67	0.0149254
NODE_2003_length_1602_cov_79.840319	1378	1445	146	1	67	0.0149254
NODE_2003_length_1602_cov_79.840319	1378	1445	148	1	67	0.0149254
NODE_2003_length_1602_cov_79.840319	1378	1445	150	2	67	0.0298507
NODE_2003_length_1602_cov_79.840319	1378	1445	153	2	67	0.0298507
NODE_2003_length_1602_cov_79.840319	1378	1445	159	3	67	0.0447761
NODE_2003_length_1602_cov_79.840319	1378	1445	166	1	67	0.0149254
NODE_2003_length_1602_cov_79.840319	1378	1445	168	1	67	0.0149254
NODE_2003_length_1602_cov_79.840319	1378	1445	170	1	67	0.0149254
NODE_2003_length_1602_cov_79.840319	1378	1445	172	2	67	0.0298507
NODE_2003_length_1602_cov_79.840319	1378	1445	177	1	67	0.0149254
NODE_2003_length_1602_cov_79.840319	1378	1445	178	1	67	0.0149254
NODE_2003_length_1602_cov_79.840319	1378	1445	179	1	67	0.0149254
NODE_2003_length_1602_cov_79.840319	1378	1445	180	1	67	0.0149254
NODE_2003_length_1602_cov_79.840319	1378	1445	189	2	67	0.0298507
NODE_2003_length_1602_cov_79.840319	1378	1445	191	4	67	0.0597015
NODE_2003_length_1602_cov_79.840319	1378	1445	193	1	67	0.0149254
NODE_2003_length_1602_cov_79.840319	1378	1445	194	2	67	0.0298507
NODE_2003_length_1602_cov_79.840319	1378	1445	195	1	67	0.0149254
NODE_2003_length_1602_cov_79.840319	1378	1445	197	1	67	0.0149254
NODE_2003_length_1602_cov_79.840319	1378	1445	198	1	67	0.0149254
NODE_2003_length_1602_cov_79.840319	1378	1445	199	2	67	0.0298507
NODE_2003_length_1602_cov_79.840319	1378	1445	200	2	67	0.0298507
NODE_2003_length_1602_cov_79.840319	1378	1445	204	1	67	0.0149254
NODE_2003_length_1602_cov_79.840319	1462	1508	41	1	46	0.0217391
NODE_2003_length_1602_cov_79.840319	1462	1508	42	1	46	0.0217391
NODE_2003_length_1602_cov_79.840319	1462	1508	46	1	46	0.0217391
NODE_2003_length_1602_cov_79.840319	1462	1508	50	6	46	0.1304348
NODE_2003_length_1602_cov_79.840319	1462	1508	51	5	46	0.1086956
NODE_2003_length_1602_cov_79.840319	1462	1508	52	1	46	0.0217391
NODE_2003_length_1602_cov_79.840319	1462	1508	54	1	46	0.0217391
NODE_2003_length_1602_cov_79.840319	1462	1508	55	1	46	0.0217391
NODE_2003_length_1602_cov_79.840319	1462	1508	58	2	46	0.0434783
NODE_2003_length_1602_cov_79.840319	1462	1508	60	8	46	0.1739130
NODE_2003_length_1602_cov_79.840319	1462	1508	61	1	46	0.0217391
NODE_2003_length_1602_cov_79.840319	1462	1508	63	11	46	0.2391304
NODE_2003_length_1602_cov_79.840319	1462	1508	65	3	46	0.0652174
NODE_2003_length_1602_cov_79.840319	1462	1508	67	1	46	0.0217391
NODE_2003_length_1602_cov_79.840319	1462	1508	70	1	46	0.0217391
NODE_2003_length_1602_cov_79.840319	1462	1508	72	2	46	0.0434783
NODE_2004_length_1602_cov_2.701264	1490	1570	0	6	80	0.0750000
NODE_2004_length_1602_cov_2.701264	1490	1570	6	74	80	0.9250000
NODE_2009_length_1600_cov_34.988008	785	865	0	80	80	1.0000000
NODE_2009_length_1600_cov_34.988008	838	918	0	80	80	1.0000000
NODE_2009_length_1600_cov_34.988008	914	994	0	80	80	1.0000000
NODE_2009_length_1600_cov_34.988008	967	1047	0	80	80	1.0000000
NODE_2011_length_1600_cov_11.383744	0	72	0	72	72	1.0000000
NODE_2011_length_1600_cov_11.383744	45	99	0	54	54	1.0000000
NODE_2011_length_1600_cov_11.383744	891	971	0	80	80	1.0000000
NODE_2011_length_1600_cov_11.383744	944	1024	0	80	80	1.0000000
NODE_2013_length_1600_cov_7.236509	1037	1109	0	72	72	1.0000000
NODE_2013_length_1600_cov_7.236509	1090	1160	0	70	70	1.0000000
NODE_2018_length_1598_cov_29.337558	335	415	0	30	80	0.3750000
NODE_2018_length_1598_cov_29.337558	335	415	1	50	80	0.6250000
NODE_2018_length_1598_cov_29.337558	388	468	0	73	80	0.9125000
NODE_2018_length_1598_cov_29.337558	388	468	1	7	80	0.0875000
NODE_2018_length_1598_cov_29.337558	464	516	1	8	52	0.1538462
NODE_2018_length_1598_cov_29.337558	464	516	3	44	52	0.8461539
NODE_2018_length_1598_cov_29.337558	1026	1106	0	80	80	1.0000000
NODE_2018_length_1598_cov_29.337558	1079	1159	0	80	80	1.0000000
NODE_2019_length_1598_cov_3.730487	1117	1197	0	80	80	1.0000000
NODE_2021_length_1597_cov_7.434579	1373	1453	16	3	80	0.0375000
NODE_2021_length_1597_cov_7.434579	1373	1453	18	11	80	0.1375000
NODE_2021_length_1597_cov_7.434579	1373	1453	22	15	80	0.1875000
NODE_2021_length_1597_cov_7.434579	1373	1453	23	2	80	0.0250000
NODE_2021_length_1597_cov_7.434579	1373	1453	25	4	80	0.0500000
NODE_2021_length_1597_cov_7.434579	1373	1453	26	8	80	0.1000000
NODE_2021_length_1597_cov_7.434579	1373	1453	28	5	80	0.0625000
NODE_2021_length_1597_cov_7.434579	1373	1453	32	2	80	0.0250000
NODE_2021_length_1597_cov_7.434579	1373	1453	33	3	80	0.0375000
NODE_2021_length_1597_cov_7.434579	1373	1453	35	2	80	0.0250000
NODE_2021_length_1597_cov_7.434579	1373	1453	37	6	80	0.0750000
NODE_2021_length_1597_cov_7.434579	1373	1453	88	1	80	0.0125000
NODE_2021_length_1597_cov_7.434579	1373	1453	89	1	80	0.0125000
NODE_2021_length_1597_cov_7.434579	1373	1453	111	1	80	0.0125000
NODE_2021_length_1597_cov_7.434579	1373	1453	112	1	80	0.0125000
NODE_2021_length_1597_cov_7.434579	1373	1453	122	1	80	0.0125000
NODE_2021_length_1597_cov_7.434579	1373	1453	128	1	80	0.0125000
NODE_2021_length_1597_cov_7.434579	1373	1453	130	3	80	0.0375000
NODE_2021_length_1597_cov_7.434579	1373	1453	139	1	80	0.0125000
NODE_2021_length_1597_cov_7.434579	1373	1453	148	1	80	0.0125000
NODE_2021_length_1597_cov_7.434579	1373	1453	155	1	80	0.0125000
NODE_2021_length_1597_cov_7.434579	1373	1453	171	1	80	0.0125000
NODE_2021_length_1597_cov_7.434579	1373	1453	173	1	80	0.0125000
NODE_2021_length_1597_cov_7.434579	1373	1453	185	1	80	0.0125000
NODE_2021_length_1597_cov_7.434579	1373	1453	189	1	80	0.0125000
NODE_2021_length_1597_cov_7.434579	1373	1453	191	3	80	0.0375000
NODE_2021_length_1597_cov_7.434579	1382	1453	18	5	71	0.0704225
NODE_2021_length_1597_cov_7.434579	1382	1453	22	15	71	0.2112676
NODE_2021_length_1597_cov_7.434579	1382	1453	23	2	71	0.0281690
NODE_2021_length_1597_cov_7.434579	1382	1453	25	4	71	0.0563380
NODE_2021_length_1597_cov_7.434579	1382	1453	26	8	71	0.1126761
NODE_2021_length_1597_cov_7.434579	1382	1453	28	5	71	0.0704225
NODE_2021_length_1597_cov_7.434579	1382	1453	32	2	71	0.0281690
NODE_2021_length_1597_cov_7.434579	1382	1453	33	3	71	0.0422535
NODE_2021_length_1597_cov_7.434579	1382	1453	35	2	71	0.0281690
NODE_2021_length_1597_cov_7.434579	1382	1453	37	6	71	0.0845070
NODE_2021_length_1597_cov_7.434579	1382	1453	88	1	71	0.0140845
NODE_2021_length_1597_cov_7.434579	1382	1453	89	1	71	0.0140845
NODE_2021_length_1597_cov_7.434579	1382	1453	111	1	71	0.0140845
NODE_2021_length_1597_cov_7.434579	1382	1453	112	1	71	0.0140845
NODE_2021_length_1597_cov_7.434579	1382	1453	122	1	71	0.0140845
NODE_2021_length_1597_cov_7.434579	1382	1453	128	1	71	0.0140845
NODE_2021_length_1597_cov_7.434579	1382	1453	130	3	71	0.0422535
NODE_2021_length_1597_cov_7.434579	1382	1453	139	1	71	0.0140845
NODE_2021_length_1597_cov_7.434579	1382	1453	148	1	71	0.0140845
NODE_2021_length_1597_cov_7.434579	1382	1453	155	1	71	0.0140845
NODE_2021_length_1597_cov_7.434579	1382	1453	171	1	71	0.0140845
NODE_2021_length_1597_cov_7.434579	1382	1453	173	1	71	0.0140845
NODE_2021_length_1597_cov_7.434579	1382	1453	185	1	71	0.0140845
NODE_2021_length_1597_cov_7.434579	1382	1453	189	1	71	0.0140845
NODE_2021_length_1597_cov_7.434579	1382	1453	191	3	71	0.0422535
NODE_2022_length_1595_cov_16.788770	215	267	5	2	52	0.0384615
NODE_2022_length_1595_cov_16.788770	215	267	10	50	52	0.9615384
NODE_2022_length_1595_cov_16.788770	614	673	4	10	59	0.1694915
NODE_2022_length_1595_cov_16.788770	614	673	6	49	59	0.8305085
NODE_2025_length_1593_cov_22.412316	144	224	0	5	80	0.0625000
NODE_2025_length_1593_cov_22.412316	144	224	2	75	80	0.9375000
NODE_2025_length_1593_cov_22.412316	197	277	0	58	80	0.7250000
NODE_2025_length_1593_cov_22.412316	197	277	2	22	80	0.2750000
NODE_2025_length_1593_cov_22.412316	1192	1272	0	5	80	0.0625000
NODE_2025_length_1593_cov_22.412316	1192	1272	5	2	80	0.0250000
NODE_2025_length_1593_cov_22.412316	1192	1272	6	67	80	0.8375000
NODE_2025_length_1593_cov_22.412316	1192	1272	8	6	80	0.0750000
NODE_2025_length_1593_cov_22.412316	1245	1325	2	4	80	0.0500000
NODE_2025_length_1593_cov_22.412316	1245	1325	4	15	80	0.1875000
NODE_2025_length_1593_cov_22.412316	1245	1325	6	21	80	0.2625000
NODE_2025_length_1593_cov_22.412316	1245	1325	8	28	80	0.3500000
NODE_2025_length_1593_cov_22.412316	1245	1325	10	12	80	0.1500000
NODE_2026_length_1593_cov_14.092369	357	437	0	80	80	1.0000000
NODE_2026_length_1593_cov_14.092369	410	490	0	80	80	1.0000000
NODE_2026_length_1593_cov_14.092369	1061	1141	4	2	80	0.0250000
NODE_2026_length_1593_cov_14.092369	1061	1141	8	78	80	0.9750000
NODE_2026_length_1593_cov_14.092369	1114	1194	8	80	80	1.0000000
NODE_2031_length_1592_cov_4.576691	277	357	0	80	80	1.0000000
NODE_2031_length_1592_cov_4.576691	330	410	0	80	80	1.0000000
NODE_2034_length_1591_cov_15.481233	841	921	0	80	80	1.0000000
NODE_2034_length_1591_cov_15.481233	894	974	0	68	80	0.8500000
NODE_2034_length_1591_cov_15.481233	894	974	2	12	80	0.1500000
NODE_2035_length_1591_cov_4.040885	35	65	0	30	30	1.0000000
NODE_2035_length_1591_cov_4.040885	38	99	0	56	61	0.9180328
NODE_2035_length_1591_cov_4.040885	38	99	2	2	61	0.0327869
NODE_2035_length_1591_cov_4.040885	38	99	4	1	61	0.0163934
NODE_2035_length_1591_cov_4.040885	38	99	6	2	61	0.0327869
NODE_2042_length_1589_cov_10.184564	379	459	0	80	80	1.0000000
NODE_2042_length_1589_cov_10.184564	432	512	0	80	80	1.0000000
NODE_2042_length_1589_cov_10.184564	473	512	0	39	39	1.0000000
NODE_2042_length_1589_cov_10.184564	508	588	0	80	80	1.0000000
NODE_2042_length_1589_cov_10.184564	561	641	0	80	80	1.0000000
NODE_2043_length_1588_cov_9.955675	415	495	0	80	80	1.0000000
NODE_2043_length_1588_cov_9.955675	468	548	0	80	80	1.0000000
NODE_2046_length_1587_cov_7.942204	710	790	0	80	80	1.0000000
NODE_2046_length_1587_cov_7.942204	763	843	0	80	80	1.0000000
NODE_2049_length_1586_cov_6.488231	447	474	0	27	27	1.0000000
NODE_2049_length_1586_cov_6.488231	447	527	0	80	80	1.0000000
NODE_2049_length_1586_cov_6.488231	500	580	0	80	80	1.0000000
NODE_2056_length_1583_cov_27.825472	800	880	0	80	80	1.0000000
NODE_2056_length_1583_cov_27.825472	853	933	0	80	80	1.0000000
NODE_2056_length_1583_cov_27.825472	929	1009	0	80	80	1.0000000
NODE_2056_length_1583_cov_27.825472	982	1062	0	80	80	1.0000000
NODE_2060_length_1581_cov_10.610661	457	537	0	80	80	1.0000000
NODE_2060_length_1581_cov_10.610661	510	590	0	80	80	1.0000000
NODE_2065_length_1579_cov_7.395946	5	80	0	75	75	1.0000000
NODE_2065_length_1579_cov_7.395946	58	126	0	68	68	1.0000000
NODE_2066_length_1579_cov_7.152027	1331	1409	0	78	78	1.0000000
NODE_2066_length_1579_cov_7.152027	1382	1462	0	80	80	1.0000000
NODE_2067_length_1579_cov_6.741892	4	52	101	7	48	0.1458333
NODE_2067_length_1579_cov_6.741892	4	52	103	1	48	0.0208333
NODE_2067_length_1579_cov_6.741892	4	52	104	1	48	0.0208333
NODE_2067_length_1579_cov_6.741892	4	52	123	1	48	0.0208333
NODE_2067_length_1579_cov_6.741892	4	52	134	1	48	0.0208333
NODE_2067_length_1579_cov_6.741892	4	52	140	1	48	0.0208333
NODE_2067_length_1579_cov_6.741892	4	52	142	8	48	0.1666667
NODE_2067_length_1579_cov_6.741892	4	52	146	5	48	0.1041667
NODE_2067_length_1579_cov_6.741892	4	52	148	3	48	0.0625000
NODE_2067_length_1579_cov_6.741892	4	52	150	2	48	0.0416667
NODE_2067_length_1579_cov_6.741892	4	52	151	1	48	0.0208333
NODE_2067_length_1579_cov_6.741892	4	52	156	10	48	0.2083333
NODE_2067_length_1579_cov_6.741892	4	52	158	7	48	0.1458333
NODE_2067_length_1579_cov_6.741892	4	52	101	7	48	0.1458333
NODE_2067_length_1579_cov_6.741892	4	52	103	1	48	0.0208333
NODE_2067_length_1579_cov_6.741892	4	52	104	1	48	0.0208333
NODE_2067_length_1579_cov_6.741892	4	52	123	1	48	0.0208333
NODE_2067_length_1579_cov_6.741892	4	52	134	1	48	0.0208333
NODE_2067_length_1579_cov_6.741892	4	52	140	1	48	0.0208333
NODE_2067_length_1579_cov_6.741892	4	52	142	8	48	0.1666667
NODE_2067_length_1579_cov_6.741892	4	52	146	5	48	0.1041667
NODE_2067_length_1579_cov_6.741892	4	52	148	3	48	0.0625000
NODE_2067_length_1579_cov_6.741892	4	52	150	2	48	0.0416667
NODE_2067_length_1579_cov_6.741892	4	52	151	1	48	0.0208333
NODE_2067_length_1579_cov_6.741892	4	52	156	10	48	0.2083333
NODE_2067_length_1579_cov_6.741892	4	52	158	7	48	0.1458333
NODE_2067_length_1579_cov_6.741892	4	52	101	7	48	0.1458333
NODE_2067_length_1579_cov_6.741892	4	52	103	1	48	0.0208333
NODE_2067_length_1579_cov_6.741892	4	52	104	1	48	0.0208333
NODE_2067_length_1579_cov_6.741892	4	52	123	1	48	0.0208333
NODE_2067_length_1579_cov_6.741892	4	52	134	1	48	0.0208333
NODE_2067_length_1579_cov_6.741892	4	52	140	1	48	0.0208333
NODE_2067_length_1579_cov_6.741892	4	52	142	8	48	0.1666667
NODE_2067_length_1579_cov_6.741892	4	52	146	5	48	0.1041667
NODE_2067_length_1579_cov_6.741892	4	52	148	3	48	0.0625000
NODE_2067_length_1579_cov_6.741892	4	52	150	2	48	0.0416667
NODE_2067_length_1579_cov_6.741892	4	52	151	1	48	0.0208333
NODE_2067_length_1579_cov_6.741892	4	52	156	10	48	0.2083333
NODE_2067_length_1579_cov_6.741892	4	52	158	7	48	0.1458333
NODE_2067_length_1579_cov_6.741892	25	105	146	4	80	0.0500000
NODE_2067_length_1579_cov_6.741892	25	105	148	3	80	0.0375000
NODE_2067_length_1579_cov_6.741892	25	105	150	2	80	0.0250000
NODE_2067_length_1579_cov_6.741892	25	105	151	1	80	0.0125000
NODE_2067_length_1579_cov_6.741892	25	105	156	10	80	0.1250000
NODE_2067_length_1579_cov_6.741892	25	105	158	9	80	0.1125000
NODE_2067_length_1579_cov_6.741892	25	105	161	3	80	0.0375000
NODE_2067_length_1579_cov_6.741892	25	105	162	1	80	0.0125000
NODE_2067_length_1579_cov_6.741892	25	105	167	1	80	0.0125000
NODE_2067_length_1579_cov_6.741892	25	105	174	3	80	0.0375000
NODE_2067_length_1579_cov_6.741892	25	105	176	1	80	0.0125000
NODE_2067_length_1579_cov_6.741892	25	105	178	7	80	0.0875000
NODE_2067_length_1579_cov_6.741892	25	105	181	5	80	0.0625000
NODE_2067_length_1579_cov_6.741892	25	105	182	2	80	0.0250000
NODE_2067_length_1579_cov_6.741892	25	105	183	1	80	0.0125000
NODE_2067_length_1579_cov_6.741892	25	105	186	4	80	0.0500000
NODE_2067_length_1579_cov_6.741892	25	105	187	23	80	0.2875000
NODE_2067_length_1579_cov_6.741892	25	91	146	4	66	0.0606061
NODE_2067_length_1579_cov_6.741892	25	91	148	3	66	0.0454545
NODE_2067_length_1579_cov_6.741892	25	91	150	2	66	0.0303030
NODE_2067_length_1579_cov_6.741892	25	91	151	1	66	0.0151515
NODE_2067_length_1579_cov_6.741892	25	91	156	10	66	0.1515152
NODE_2067_length_1579_cov_6.741892	25	91	158	9	66	0.1363636
NODE_2067_length_1579_cov_6.741892	25	91	161	3	66	0.0454545
NODE_2067_length_1579_cov_6.741892	25	91	162	1	66	0.0151515
NODE_2067_length_1579_cov_6.741892	25	91	167	1	66	0.0151515
NODE_2067_length_1579_cov_6.741892	25	91	174	3	66	0.0454545
NODE_2067_length_1579_cov_6.741892	25	91	176	1	66	0.0151515
NODE_2067_length_1579_cov_6.741892	25	91	178	7	66	0.1060606
NODE_2067_length_1579_cov_6.741892	25	91	181	5	66	0.0757576
NODE_2067_length_1579_cov_6.741892	25	91	182	2	66	0.0303030
NODE_2067_length_1579_cov_6.741892	25	91	183	1	66	0.0151515
NODE_2067_length_1579_cov_6.741892	25	91	186	4	66	0.0606061
NODE_2067_length_1579_cov_6.741892	25	91	187	9	66	0.1363636
NODE_2067_length_1579_cov_6.741892	25	96	146	4	71	0.0563380
NODE_2067_length_1579_cov_6.741892	25	96	148	3	71	0.0422535
NODE_2067_length_1579_cov_6.741892	25	96	150	2	71	0.0281690
NODE_2067_length_1579_cov_6.741892	25	96	151	1	71	0.0140845
NODE_2067_length_1579_cov_6.741892	25	96	156	10	71	0.1408451
NODE_2067_length_1579_cov_6.741892	25	96	158	9	71	0.1267606
NODE_2067_length_1579_cov_6.741892	25	96	161	3	71	0.0422535
NODE_2067_length_1579_cov_6.741892	25	96	162	1	71	0.0140845
NODE_2067_length_1579_cov_6.741892	25	96	167	1	71	0.0140845
NODE_2067_length_1579_cov_6.741892	25	96	174	3	71	0.0422535
NODE_2067_length_1579_cov_6.741892	25	96	176	1	71	0.0140845
NODE_2067_length_1579_cov_6.741892	25	96	178	7	71	0.0985916
NODE_2067_length_1579_cov_6.741892	25	96	181	5	71	0.0704225
NODE_2067_length_1579_cov_6.741892	25	96	182	2	71	0.0281690
NODE_2067_length_1579_cov_6.741892	25	96	183	1	71	0.0140845
NODE_2067_length_1579_cov_6.741892	25	96	186	4	71	0.0563380
NODE_2067_length_1579_cov_6.741892	25	96	187	14	71	0.1971831
NODE_2076_length_1575_cov_4.250000	993	1073	0	80	80	1.0000000
NODE_2076_length_1575_cov_4.250000	1046	1126	0	80	80	1.0000000
NODE_2078_length_1574_cov_40.682034	551	631	0	80	80	1.0000000
NODE_2078_length_1574_cov_40.682034	604	684	0	80	80	1.0000000
NODE_2078_length_1574_cov_40.682034	680	760	0	42	80	0.5250000
NODE_2078_length_1574_cov_40.682034	680	760	2	30	80	0.3750000
NODE_2078_length_1574_cov_40.682034	680	760	4	8	80	0.1000000
NODE_2078_length_1574_cov_40.682034	733	813	2	45	80	0.5625000
NODE_2078_length_1574_cov_40.682034	733	813	4	35	80	0.4375000
NODE_2079_length_1574_cov_7.572203	1306	1386	0	80	80	1.0000000
NODE_2079_length_1574_cov_7.572203	1359	1439	0	80	80	1.0000000
NODE_2081_length_1573_cov_16.107191	437	512	0	75	75	1.0000000
NODE_2081_length_1573_cov_16.107191	485	565	0	80	80	1.0000000
NODE_2081_length_1573_cov_16.107191	561	639	0	78	78	1.0000000
NODE_2081_length_1573_cov_16.107191	612	692	0	80	80	1.0000000
NODE_2085_length_1572_cov_25.966735	359	404	132	1	45	0.0222222
NODE_2085_length_1572_cov_25.966735	359	404	134	5	45	0.1111111
NODE_2085_length_1572_cov_25.966735	359	404	136	2	45	0.0444444
NODE_2085_length_1572_cov_25.966735	359	404	138	3	45	0.0666667
NODE_2085_length_1572_cov_25.966735	359	404	140	2	45	0.0444444
NODE_2085_length_1572_cov_25.966735	359	404	143	2	45	0.0444444
NODE_2085_length_1572_cov_25.966735	359	404	148	1	45	0.0222222
NODE_2085_length_1572_cov_25.966735	359	404	150	1	45	0.0222222
NODE_2085_length_1572_cov_25.966735	359	404	157	2	45	0.0444444
NODE_2085_length_1572_cov_25.966735	359	404	165	1	45	0.0222222
NODE_2085_length_1572_cov_25.966735	359	404	169	1	45	0.0222222
NODE_2085_length_1572_cov_25.966735	359	404	180	2	45	0.0444444
NODE_2085_length_1572_cov_25.966735	359	404	181	2	45	0.0444444
NODE_2085_length_1572_cov_25.966735	359	404	182	1	45	0.0222222
NODE_2085_length_1572_cov_25.966735	359	404	190	1	45	0.0222222
NODE_2085_length_1572_cov_25.966735	359	404	194	1	45	0.0222222
NODE_2085_length_1572_cov_25.966735	359	404	195	1	45	0.0222222
NODE_2085_length_1572_cov_25.966735	359	404	196	1	45	0.0222222
NODE_2085_length_1572_cov_25.966735	359	404	198	1	45	0.0222222
NODE_2085_length_1572_cov_25.966735	359	404	200	2	45	0.0444444
NODE_2085_length_1572_cov_25.966735	359	404	203	2	45	0.0444444
NODE_2085_length_1572_cov_25.966735	359	404	208	1	45	0.0222222
NODE_2085_length_1572_cov_25.966735	359	404	210	1	45	0.0222222
NODE_2085_length_1572_cov_25.966735	359	404	211	1	45	0.0222222
NODE_2085_length_1572_cov_25.966735	359	404	216	2	45	0.0444444
NODE_2085_length_1572_cov_25.966735	359	404	217	1	45	0.0222222
NODE_2085_length_1572_cov_25.966735	359	404	218	1	45	0.0222222
NODE_2085_length_1572_cov_25.966735	359	404	219	1	45	0.0222222
NODE_2085_length_1572_cov_25.966735	359	404	224	1	45	0.0222222
NODE_2085_length_1572_cov_25.966735	359	404	229	1	45	0.0222222
NODE_2085_length_1572_cov_25.966735	405	477	96	7	72	0.0972222
NODE_2085_length_1572_cov_25.966735	405	477	97	1	72	0.0138889
NODE_2085_length_1572_cov_25.966735	405	477	98	3	72	0.0416667
NODE_2085_length_1572_cov_25.966735	405	477	99	3	72	0.0416667
NODE_2085_length_1572_cov_25.966735	405	477	100	5	72	0.0694444
NODE_2085_length_1572_cov_25.966735	405	477	101	1	72	0.0138889
NODE_2085_length_1572_cov_25.966735	405	477	104	4	72	0.0555556
NODE_2085_length_1572_cov_25.966735	405	477	106	2	72	0.0277778
NODE_2085_length_1572_cov_25.966735	405	477	107	4	72	0.0555556
NODE_2085_length_1572_cov_25.966735	405	477	108	2	72	0.0277778
NODE_2085_length_1572_cov_25.966735	405	477	109	1	72	0.0138889
NODE_2085_length_1572_cov_25.966735	405	477	110	3	72	0.0416667
NODE_2085_length_1572_cov_25.966735	405	477	111	2	72	0.0277778
NODE_2085_length_1572_cov_25.966735	405	477	112	1	72	0.0138889
NODE_2085_length_1572_cov_25.966735	405	477	113	2	72	0.0277778
NODE_2085_length_1572_cov_25.966735	405	477	114	1	72	0.0138889
NODE_2085_length_1572_cov_25.966735	405	477	116	2	72	0.0277778
NODE_2085_length_1572_cov_25.966735	405	477	117	2	72	0.0277778
NODE_2085_length_1572_cov_25.966735	405	477	118	1	72	0.0138889
NODE_2085_length_1572_cov_25.966735	405	477	119	1	72	0.0138889
NODE_2085_length_1572_cov_25.966735	405	477	120	1	72	0.0138889
NODE_2085_length_1572_cov_25.966735	405	477	121	1	72	0.0138889
NODE_2085_length_1572_cov_25.966735	405	477	122	2	72	0.0277778
NODE_2085_length_1572_cov_25.966735	405	477	123	1	72	0.0138889
NODE_2085_length_1572_cov_25.966735	405	477	124	2	72	0.0277778
NODE_2085_length_1572_cov_25.966735	405	477	126	2	72	0.0277778
NODE_2085_length_1572_cov_25.966735	405	477	128	5	72	0.0694444
NODE_2085_length_1572_cov_25.966735	405	477	129	3	72	0.0416667
NODE_2085_length_1572_cov_25.966735	405	477	130	2	72	0.0277778
NODE_2085_length_1572_cov_25.966735	405	477	132	1	72	0.0138889
NODE_2085_length_1572_cov_25.966735	405	477	133	2	72	0.0277778
NODE_2085_length_1572_cov_25.966735	405	477	136	1	72	0.0138889
NODE_2085_length_1572_cov_25.966735	405	477	139	1	72	0.0138889
NODE_2085_length_1572_cov_25.966735	1016	1096	0	80	80	1.0000000
NODE_2085_length_1572_cov_25.966735	1069	1149	0	80	80	1.0000000
NODE_2086_length_1572_cov_3.513238	1386	1462	0	8	76	0.1052632
NODE_2086_length_1572_cov_3.513238	1386	1462	1	4	76	0.0526316
NODE_2086_length_1572_cov_3.513238	1386	1462	2	43	76	0.5657895
NODE_2086_length_1572_cov_3.513238	1386	1462	4	10	76	0.1315790
NODE_2086_length_1572_cov_3.513238	1386	1462	6	11	76	0.1447368
NODE_2090_length_1570_cov_21.745071	700	780	0	3	80	0.0375000
NODE_2090_length_1570_cov_21.745071	700	780	2	77	80	0.9625000
NODE_2090_length_1570_cov_21.745071	753	833	0	56	80	0.7000000
NODE_2090_length_1570_cov_21.745071	753	833	2	24	80	0.3000000
NODE_2091_length_1570_cov_3.276003	387	467	0	80	80	1.0000000
NODE_2091_length_1570_cov_3.276003	440	520	0	80	80	1.0000000
NODE_2093_length_1569_cov_53.941497	741	821	0	12	80	0.1500000
NODE_2093_length_1569_cov_53.941497	741	821	1	68	80	0.8500000
NODE_2093_length_1569_cov_53.941497	794	874	1	80	80	1.0000000
NODE_2093_length_1569_cov_53.941497	870	950	1	61	80	0.7625000
NODE_2093_length_1569_cov_53.941497	870	950	2	19	80	0.2375000
NODE_2093_length_1569_cov_53.941497	923	1003	1	80	80	1.0000000
NODE_2094_length_1569_cov_12.426531	640	720	12	80	80	1.0000000
NODE_2094_length_1569_cov_12.426531	693	773	2	12	80	0.1500000
NODE_2094_length_1569_cov_12.426531	693	773	8	19	80	0.2375000
NODE_2094_length_1569_cov_12.426531	693	773	12	32	80	0.4000000
NODE_2094_length_1569_cov_12.426531	693	773	13	1	80	0.0125000
NODE_2094_length_1569_cov_12.426531	693	773	14	16	80	0.2000000
NODE_2094_length_1569_cov_12.426531	769	849	0	63	80	0.7875000
NODE_2094_length_1569_cov_12.426531	769	849	2	17	80	0.2125000
NODE_2094_length_1569_cov_12.426531	822	902	0	80	80	1.0000000
NODE_2095_length_1569_cov_12.365986	450	530	2	79	80	0.9875000
NODE_2095_length_1569_cov_12.365986	450	530	4	1	80	0.0125000
NODE_2095_length_1569_cov_12.365986	450	530	2	79	80	0.9875000
NODE_2095_length_1569_cov_12.365986	450	530	4	1	80	0.0125000
NODE_2095_length_1569_cov_12.365986	503	564	2	61	61	1.0000000
NODE_2095_length_1569_cov_12.365986	503	556	2	53	53	1.0000000
NODE_2096_length_1569_cov_11.599320	798	878	0	53	80	0.6625000
NODE_2096_length_1569_cov_11.599320	798	878	2	27	80	0.3375000
NODE_2096_length_1569_cov_11.599320	851	931	0	80	80	1.0000000
NODE_2097_length_1569_cov_10.917687	521	601	0	80	80	1.0000000
NODE_2097_length_1569_cov_10.917687	574	654	0	80	80	1.0000000
NODE_2108_length_1563_cov_15.357240	590	670	0	80	80	1.0000000
NODE_2108_length_1563_cov_15.357240	643	723	0	80	80	1.0000000
NODE_2110_length_1561_cov_18.420657	354	434	0	80	80	1.0000000
NODE_2110_length_1561_cov_18.420657	407	487	0	80	80	1.0000000
NODE_2110_length_1561_cov_18.420657	483	563	0	80	80	1.0000000
NODE_2110_length_1561_cov_18.420657	536	616	0	80	80	1.0000000
NODE_2116_length_1559_cov_7.071233	347	427	0	80	80	1.0000000
NODE_2116_length_1559_cov_7.071233	400	478	0	78	78	1.0000000
NODE_2116_length_1559_cov_7.071233	1187	1238	0	50	51	0.9803922
NODE_2116_length_1559_cov_7.071233	1187	1238	2	1	51	0.0196078
NODE_2118_length_1558_cov_3.486635	338	418	0	80	80	1.0000000
NODE_2118_length_1558_cov_3.486635	391	471	0	80	80	1.0000000
NODE_2119_length_1557_cov_17.089163	542	622	0	16	80	0.2000000
NODE_2119_length_1557_cov_17.089163	542	622	1	64	80	0.8000000
NODE_2119_length_1557_cov_17.089163	595	675	1	80	80	1.0000000
NODE_2120_length_1557_cov_4.639918	0	56	0	56	56	1.0000000
NODE_2120_length_1557_cov_4.639918	49	112	0	63	63	1.0000000
NODE_2120_length_1557_cov_4.639918	85	161	0	76	76	1.0000000
NODE_2123_length_1556_cov_23.289636	456	536	0	80	80	1.0000000
NODE_2123_length_1556_cov_23.289636	509	589	0	80	80	1.0000000
NODE_2123_length_1556_cov_23.289636	681	761	0	80	80	1.0000000
NODE_2123_length_1556_cov_23.289636	734	814	0	80	80	1.0000000
NODE_2123_length_1556_cov_23.289636	1445	1525	91	2	80	0.0250000
NODE_2123_length_1556_cov_23.289636	1445	1525	93	2	80	0.0250000
NODE_2123_length_1556_cov_23.289636	1445	1525	95	4	80	0.0500000
NODE_2123_length_1556_cov_23.289636	1445	1525	99	72	80	0.9000000
NODE_2124_length_1556_cov_7.494166	300	380	0	36	80	0.4500000
NODE_2124_length_1556_cov_7.494166	300	380	6	44	80	0.5500000
NODE_2124_length_1556_cov_7.494166	353	433	0	29	80	0.3625000
NODE_2124_length_1556_cov_7.494166	353	433	6	51	80	0.6375000
NODE_2126_length_1555_cov_13.461538	666	746	0	80	80	1.0000000
NODE_2126_length_1555_cov_13.461538	719	799	0	80	80	1.0000000
NODE_2127_length_1554_cov_30.239175	144	226	0	82	82	1.0000000
NODE_2127_length_1554_cov_30.239175	199	279	0	31	80	0.3875000
NODE_2127_length_1554_cov_30.239175	199	279	2	15	80	0.1875000
NODE_2127_length_1554_cov_30.239175	199	279	4	13	80	0.1625000
NODE_2127_length_1554_cov_30.239175	199	279	8	2	80	0.0250000
NODE_2127_length_1554_cov_30.239175	199	279	10	3	80	0.0375000
NODE_2127_length_1554_cov_30.239175	199	279	14	1	80	0.0125000
NODE_2127_length_1554_cov_30.239175	199	279	18	1	80	0.0125000
NODE_2127_length_1554_cov_30.239175	199	279	19	14	80	0.1750000
NODE_2127_length_1554_cov_30.239175	877	903	0	26	26	1.0000000
NODE_2127_length_1554_cov_30.239175	930	1010	0	80	80	1.0000000
NODE_2127_length_1554_cov_30.239175	983	1063	0	80	80	1.0000000
NODE_2128_length_1554_cov_5.381443	1494	1554	0	2	60	0.0333333
NODE_2128_length_1554_cov_5.381443	1494	1554	11	1	60	0.0166667
NODE_2128_length_1554_cov_5.381443	1494	1554	15	4	60	0.0666667
NODE_2128_length_1554_cov_5.381443	1494	1554	20	8	60	0.1333333
NODE_2128_length_1554_cov_5.381443	1494	1554	22	35	60	0.5833333
NODE_2128_length_1554_cov_5.381443	1494	1554	26	10	60	0.1666667
NODE_2132_length_1552_cov_11.367515	379	445	0	66	66	1.0000000
NODE_2132_length_1552_cov_11.367515	418	484	0	66	66	1.0000000
NODE_2138_length_1549_cov_15.480000	1288	1368	0	80	80	1.0000000
NODE_2138_length_1549_cov_15.480000	1341	1421	0	80	80	1.0000000
NODE_2142_length_1548_cov_12.789510	770	850	0	80	80	1.0000000
NODE_2142_length_1548_cov_12.789510	823	903	0	80	80	1.0000000
NODE_2149_length_1546_cov_24.069800	775	855	0	80	80	1.0000000
NODE_2149_length_1546_cov_24.069800	828	908	0	80	80	1.0000000
NODE_2150_length_1546_cov_10.911541	417	497	0	28	80	0.3500000
NODE_2150_length_1546_cov_10.911541	417	497	2	52	80	0.6500000
NODE_2150_length_1546_cov_10.911541	470	550	0	80	80	1.0000000
NODE_2150_length_1546_cov_10.911541	1065	1145	0	80	80	1.0000000
NODE_2150_length_1546_cov_10.911541	1118	1198	0	80	80	1.0000000
NODE_2155_length_1543_cov_10.400970	480	560	0	80	80	1.0000000
NODE_2155_length_1543_cov_10.400970	533	613	0	80	80	1.0000000
NODE_2156_length_1543_cov_4.532548	43	98	0	55	55	1.0000000
NODE_2162_length_1541_cov_7.316921	523	603	6	80	80	1.0000000
NODE_2162_length_1541_cov_7.316921	576	658	2	16	82	0.1951219
NODE_2162_length_1541_cov_7.316921	576	658	3	1	82	0.0121951
NODE_2162_length_1541_cov_7.316921	576	658	5	10	82	0.1219512
NODE_2162_length_1541_cov_7.316921	576	658	6	51	82	0.6219512
NODE_2162_length_1541_cov_7.316921	576	658	7	2	82	0.0243902
NODE_2162_length_1541_cov_7.316921	576	658	8	2	82	0.0243902
NODE_2165_length_1539_cov_19.067361	334	414	0	80	80	1.0000000
NODE_2165_length_1539_cov_19.067361	387	467	0	80	80	1.0000000
NODE_2165_length_1539_cov_19.067361	463	543	0	80	80	1.0000000
NODE_2165_length_1539_cov_19.067361	516	596	0	80	80	1.0000000
NODE_2171_length_1538_cov_68.273801	604	684	0	14	80	0.1750000
NODE_2171_length_1538_cov_68.273801	604	684	27	2	80	0.0250000
NODE_2171_length_1538_cov_68.273801	604	684	28	57	80	0.7125000
NODE_2171_length_1538_cov_68.273801	604	684	29	3	80	0.0375000
NODE_2171_length_1538_cov_68.273801	604	684	30	4	80	0.0500000
NODE_2171_length_1538_cov_68.273801	657	737	28	20	80	0.2500000
NODE_2171_length_1538_cov_68.273801	657	737	29	50	80	0.6250000
NODE_2171_length_1538_cov_68.273801	657	737	30	10	80	0.1250000
NODE_2172_length_1538_cov_2.402363	1456	1499	0	43	43	1.0000000
NODE_2173_length_1537_cov_39.413074	782	862	0	80	80	1.0000000
NODE_2173_length_1537_cov_39.413074	835	915	0	80	80	1.0000000
NODE_2173_length_1537_cov_39.413074	911	991	0	80	80	1.0000000
NODE_2173_length_1537_cov_39.413074	964	1044	0	80	80	1.0000000
NODE_2174_length_1537_cov_30.412378	739	819	0	80	80	1.0000000
NODE_2174_length_1537_cov_30.412378	792	872	0	80	80	1.0000000
NODE_2174_length_1537_cov_30.412378	868	948	0	80	80	1.0000000
NODE_2174_length_1537_cov_30.412378	921	1001	0	32	80	0.4000000
NODE_2174_length_1537_cov_30.412378	921	1001	2	48	80	0.6000000
NODE_2175_length_1537_cov_18.707232	669	749	1	77	80	0.9625000
NODE_2175_length_1537_cov_18.707232	669	749	2	3	80	0.0375000
NODE_2175_length_1537_cov_18.707232	722	802	0	49	80	0.6125000
NODE_2175_length_1537_cov_18.707232	722	802	1	31	80	0.3875000
NODE_2176_length_1536_cov_24.991649	832	912	0	80	80	1.0000000
NODE_2176_length_1536_cov_24.991649	885	965	0	80	80	1.0000000
NODE_2176_length_1536_cov_24.991649	961	1041	0	80	80	1.0000000
NODE_2176_length_1536_cov_24.991649	1014	1094	0	80	80	1.0000000
NODE_2183_length_1535_cov_46.662256	992	1072	0	80	80	1.0000000
NODE_2183_length_1535_cov_46.662256	1045	1125	0	80	80	1.0000000
NODE_2183_length_1535_cov_46.662256	1127	1203	0	76	76	1.0000000
NODE_2183_length_1535_cov_46.662256	1176	1256	0	80	80	1.0000000
NODE_2184_length_1535_cov_32.610724	992	1072	0	80	80	1.0000000
NODE_2184_length_1535_cov_32.610724	1045	1125	0	62	80	0.7750000
NODE_2184_length_1535_cov_32.610724	1045	1125	9	1	80	0.0125000
NODE_2184_length_1535_cov_32.610724	1045	1125	10	17	80	0.2125000
NODE_2184_length_1535_cov_32.610724	1121	1201	10	80	80	1.0000000
NODE_2184_length_1535_cov_32.610724	1174	1254	0	33	80	0.4125000
NODE_2184_length_1535_cov_32.610724	1174	1254	10	47	80	0.5875000
NODE_2185_length_1535_cov_25.406685	619	699	0	80	80	1.0000000
NODE_2185_length_1535_cov_25.406685	672	752	0	80	80	1.0000000
NODE_2190_length_1534_cov_13.542857	439	519	0	80	80	1.0000000
NODE_2190_length_1534_cov_13.542857	492	567	0	75	75	1.0000000
NODE_2197_length_1531_cov_17.336592	324	404	2	41	80	0.5125000
NODE_2197_length_1531_cov_17.336592	324	404	6	18	80	0.2250000
NODE_2197_length_1531_cov_17.336592	324	404	8	21	80	0.2625000
NODE_2198_length_1531_cov_6.267458	606	686	0	80	80	1.0000000
NODE_2198_length_1531_cov_6.267458	659	739	0	80	80	1.0000000
NODE_2199_length_1530_cov_13.514326	323	403	0	80	80	1.0000000
NODE_2199_length_1530_cov_13.514326	376	456	0	80	80	1.0000000
NODE_2199_length_1530_cov_13.514326	1465	1513	0	48	48	1.0000000
NODE_2200_length_1530_cov_9.012579	637	717	0	16	80	0.2000000
NODE_2200_length_1530_cov_9.012579	637	717	4	27	80	0.3375000
NODE_2200_length_1530_cov_9.012579	637	717	6	37	80	0.4625000
NODE_2200_length_1530_cov_9.012579	690	770	0	69	80	0.8625000
NODE_2200_length_1530_cov_9.012579	690	770	4	11	80	0.1375000
NODE_2203_length_1529_cov_21.061538	983	1063	0	80	80	1.0000000
NODE_2203_length_1529_cov_21.061538	1036	1116	0	80	80	1.0000000
NODE_2205_length_1529_cov_1.380420	219	282	0	63	63	1.0000000
NODE_2205_length_1529_cov_1.380420	272	323	0	51	51	1.0000000
NODE_2206_length_1528_cov_8.578027	449	529	0	80	80	1.0000000
NODE_2206_length_1528_cov_8.578027	502	582	0	80	80	1.0000000
NODE_2210_length_1526_cov_92.265592	986	1066	0	80	80	1.0000000
NODE_2210_length_1526_cov_92.265592	1039	1119	0	80	80	1.0000000
NODE_2211_length_1526_cov_4.051857	291	370	2	10	79	0.1265823
NODE_2211_length_1526_cov_4.051857	291	370	3	19	79	0.2405063
NODE_2211_length_1526_cov_4.051857	291	370	4	48	79	0.6075949
NODE_2211_length_1526_cov_4.051857	291	370	5	2	79	0.0253165
NODE_2213_length_1525_cov_20.232118	1014	1090	182	1	76	0.0131579
NODE_2213_length_1525_cov_20.232118	1014	1090	190	1	76	0.0131579
NODE_2213_length_1525_cov_20.232118	1014	1090	191	3	76	0.0394737
NODE_2213_length_1525_cov_20.232118	1014	1090	195	1	76	0.0131579
NODE_2213_length_1525_cov_20.232118	1014	1090	198	2	76	0.0263158
NODE_2213_length_1525_cov_20.232118	1014	1090	199	1	76	0.0131579
NODE_2213_length_1525_cov_20.232118	1014	1090	201	2	76	0.0263158
NODE_2213_length_1525_cov_20.232118	1014	1090	202	3	76	0.0394737
NODE_2213_length_1525_cov_20.232118	1014	1090	203	1	76	0.0131579
NODE_2213_length_1525_cov_20.232118	1014	1090	206	2	76	0.0263158
NODE_2213_length_1525_cov_20.232118	1014	1090	207	2	76	0.0263158
NODE_2213_length_1525_cov_20.232118	1014	1090	209	1	76	0.0131579
NODE_2213_length_1525_cov_20.232118	1014	1090	210	1	76	0.0131579
NODE_2213_length_1525_cov_20.232118	1014	1090	211	1	76	0.0131579
NODE_2213_length_1525_cov_20.232118	1014	1090	213	1	76	0.0131579
NODE_2213_length_1525_cov_20.232118	1014	1090	214	1	76	0.0131579
NODE_2213_length_1525_cov_20.232118	1014	1090	217	5	76	0.0657895
NODE_2213_length_1525_cov_20.232118	1014	1090	219	2	76	0.0263158
NODE_2213_length_1525_cov_20.232118	1014	1090	220	1	76	0.0131579
NODE_2213_length_1525_cov_20.232118	1014	1090	221	1	76	0.0131579
NODE_2213_length_1525_cov_20.232118	1014	1090	222	7	76	0.0921053
NODE_2213_length_1525_cov_20.232118	1014	1090	223	3	76	0.0394737
NODE_2213_length_1525_cov_20.232118	1014	1090	224	3	76	0.0394737
NODE_2213_length_1525_cov_20.232118	1014	1090	225	2	76	0.0263158
NODE_2213_length_1525_cov_20.232118	1014	1090	226	2	76	0.0263158
NODE_2213_length_1525_cov_20.232118	1014	1090	227	4	76	0.0526316
NODE_2213_length_1525_cov_20.232118	1014	1090	228	1	76	0.0131579
NODE_2213_length_1525_cov_20.232118	1014	1090	232	2	76	0.0263158
NODE_2213_length_1525_cov_20.232118	1014	1090	233	7	76	0.0921053
NODE_2213_length_1525_cov_20.232118	1014	1090	238	2	76	0.0263158
NODE_2213_length_1525_cov_20.232118	1014	1090	239	3	76	0.0394737
NODE_2213_length_1525_cov_20.232118	1014	1090	243	2	76	0.0263158
NODE_2213_length_1525_cov_20.232118	1014	1090	244	2	76	0.0263158
NODE_2213_length_1525_cov_20.232118	1014	1090	245	3	76	0.0394737
NODE_2213_length_1525_cov_20.232118	1281	1338	0	57	57	1.0000000
NODE_2214_length_1525_cov_11.421459	804	884	0	19	80	0.2375000
NODE_2214_length_1525_cov_11.421459	804	884	9	9	80	0.1125000
NODE_2214_length_1525_cov_11.421459	804	884	17	1	80	0.0125000
NODE_2214_length_1525_cov_11.421459	804	884	18	11	80	0.1375000
NODE_2214_length_1525_cov_11.421459	804	884	19	1	80	0.0125000
NODE_2214_length_1525_cov_11.421459	804	884	20	39	80	0.4875000
NODE_2214_length_1525_cov_11.421459	857	937	18	3	80	0.0375000
NODE_2214_length_1525_cov_11.421459	857	937	20	77	80	0.9625000
NODE_2217_length_1524_cov_130.874386	171	243	336	1	72	0.0138889
NODE_2217_length_1524_cov_130.874386	171	243	338	1	72	0.0138889
NODE_2217_length_1524_cov_130.874386	171	243	339	2	72	0.0277778
NODE_2217_length_1524_cov_130.874386	171	243	341	1	72	0.0138889
NODE_2217_length_1524_cov_130.874386	171	243	343	2	72	0.0277778
NODE_2217_length_1524_cov_130.874386	171	243	344	1	72	0.0138889
NODE_2217_length_1524_cov_130.874386	171	243	354	1	72	0.0138889
NODE_2217_length_1524_cov_130.874386	171	243	367	1	72	0.0138889
NODE_2217_length_1524_cov_130.874386	171	243	369	1	72	0.0138889
NODE_2217_length_1524_cov_130.874386	171	243	382	1	72	0.0138889
NODE_2217_length_1524_cov_130.874386	171	243	384	1	72	0.0138889
NODE_2217_length_1524_cov_130.874386	171	243	386	1	72	0.0138889
NODE_2217_length_1524_cov_130.874386	171	243	394	3	72	0.0416667
NODE_2217_length_1524_cov_130.874386	171	243	396	1	72	0.0138889
NODE_2217_length_1524_cov_130.874386	171	243	404	1	72	0.0138889
NODE_2217_length_1524_cov_130.874386	171	243	406	1	72	0.0138889
NODE_2217_length_1524_cov_130.874386	171	243	408	1	72	0.0138889
NODE_2217_length_1524_cov_130.874386	171	243	418	1	72	0.0138889
NODE_2217_length_1524_cov_130.874386	171	243	437	1	72	0.0138889
NODE_2217_length_1524_cov_130.874386	171	243	440	1	72	0.0138889
NODE_2217_length_1524_cov_130.874386	171	243	446	1	72	0.0138889
NODE_2217_length_1524_cov_130.874386	171	243	459	1	72	0.0138889
NODE_2217_length_1524_cov_130.874386	171	243	462	1	72	0.0138889
NODE_2217_length_1524_cov_130.874386	171	243	463	1	72	0.0138889
NODE_2217_length_1524_cov_130.874386	171	243	464	1	72	0.0138889
NODE_2217_length_1524_cov_130.874386	171	243	483	1	72	0.0138889
NODE_2217_length_1524_cov_130.874386	171	243	491	2	72	0.0277778
NODE_2217_length_1524_cov_130.874386	171	243	494	1	72	0.0138889
NODE_2217_length_1524_cov_130.874386	171	243	496	2	72	0.0277778
NODE_2217_length_1524_cov_130.874386	171	243	497	1	72	0.0138889
NODE_2217_length_1524_cov_130.874386	171	243	498	3	72	0.0416667
NODE_2217_length_1524_cov_130.874386	171	243	500	1	72	0.0138889
NODE_2217_length_1524_cov_130.874386	171	243	501	3	72	0.0416667
NODE_2217_length_1524_cov_130.874386	171	243	502	2	72	0.0277778
NODE_2217_length_1524_cov_130.874386	171	243	503	1	72	0.0138889
NODE_2217_length_1524_cov_130.874386	171	243	504	3	72	0.0416667
NODE_2217_length_1524_cov_130.874386	171	243	506	2	72	0.0277778
NODE_2217_length_1524_cov_130.874386	171	243	507	3	72	0.0416667
NODE_2217_length_1524_cov_130.874386	171	243	508	2	72	0.0277778
NODE_2217_length_1524_cov_130.874386	171	243	509	2	72	0.0277778
NODE_2217_length_1524_cov_130.874386	171	243	512	2	72	0.0277778
NODE_2217_length_1524_cov_130.874386	171	243	514	1	72	0.0138889
NODE_2217_length_1524_cov_130.874386	171	243	515	1	72	0.0138889
NODE_2217_length_1524_cov_130.874386	171	243	516	1	72	0.0138889
NODE_2217_length_1524_cov_130.874386	171	243	517	1	72	0.0138889
NODE_2217_length_1524_cov_130.874386	171	243	519	1	72	0.0138889
NODE_2217_length_1524_cov_130.874386	171	243	521	1	72	0.0138889
NODE_2217_length_1524_cov_130.874386	171	243	525	1	72	0.0138889
NODE_2217_length_1524_cov_130.874386	171	243	526	1	72	0.0138889
NODE_2217_length_1524_cov_130.874386	171	243	527	2	72	0.0277778
NODE_2217_length_1524_cov_130.874386	171	243	528	2	72	0.0277778
NODE_2217_length_1524_cov_130.874386	191	247	408	1	56	0.0178571
NODE_2217_length_1524_cov_130.874386	191	247	418	1	56	0.0178571
NODE_2217_length_1524_cov_130.874386	191	247	437	1	56	0.0178571
NODE_2217_length_1524_cov_130.874386	191	247	440	1	56	0.0178571
NODE_2217_length_1524_cov_130.874386	191	247	446	1	56	0.0178571
NODE_2217_length_1524_cov_130.874386	191	247	459	1	56	0.0178571
NODE_2217_length_1524_cov_130.874386	191	247	462	1	56	0.0178571
NODE_2217_length_1524_cov_130.874386	191	247	463	1	56	0.0178571
NODE_2217_length_1524_cov_130.874386	191	247	464	1	56	0.0178571
NODE_2217_length_1524_cov_130.874386	191	247	480	1	56	0.0178571
NODE_2217_length_1524_cov_130.874386	191	247	483	3	56	0.0535714
NODE_2217_length_1524_cov_130.874386	191	247	491	2	56	0.0357143
NODE_2217_length_1524_cov_130.874386	191	247	494	1	56	0.0178571
NODE_2217_length_1524_cov_130.874386	191	247	495	1	56	0.0178571
NODE_2217_length_1524_cov_130.874386	191	247	496	2	56	0.0357143
NODE_2217_length_1524_cov_130.874386	191	247	497	1	56	0.0178571
NODE_2217_length_1524_cov_130.874386	191	247	498	3	56	0.0535714
NODE_2217_length_1524_cov_130.874386	191	247	500	1	56	0.0178571
NODE_2217_length_1524_cov_130.874386	191	247	501	3	56	0.0535714
NODE_2217_length_1524_cov_130.874386	191	247	502	2	56	0.0357143
NODE_2217_length_1524_cov_130.874386	191	247	503	1	56	0.0178571
NODE_2217_length_1524_cov_130.874386	191	247	504	3	56	0.0535714
NODE_2217_length_1524_cov_130.874386	191	247	506	2	56	0.0357143
NODE_2217_length_1524_cov_130.874386	191	247	507	3	56	0.0535714
NODE_2217_length_1524_cov_130.874386	191	247	508	2	56	0.0357143
NODE_2217_length_1524_cov_130.874386	191	247	509	2	56	0.0357143
NODE_2217_length_1524_cov_130.874386	191	247	512	2	56	0.0357143
NODE_2217_length_1524_cov_130.874386	191	247	514	1	56	0.0178571
NODE_2217_length_1524_cov_130.874386	191	247	515	1	56	0.0178571
NODE_2217_length_1524_cov_130.874386	191	247	516	1	56	0.0178571
NODE_2217_length_1524_cov_130.874386	191	247	517	1	56	0.0178571
NODE_2217_length_1524_cov_130.874386	191	247	519	1	56	0.0178571
NODE_2217_length_1524_cov_130.874386	191	247	521	1	56	0.0178571
NODE_2217_length_1524_cov_130.874386	191	247	525	1	56	0.0178571
NODE_2217_length_1524_cov_130.874386	191	247	526	1	56	0.0178571
NODE_2217_length_1524_cov_130.874386	191	247	527	2	56	0.0357143
NODE_2217_length_1524_cov_130.874386	191	247	528	2	56	0.0357143
NODE_2217_length_1524_cov_130.874386	219	296	286	1	77	0.0129870
NODE_2217_length_1524_cov_130.874386	219	296	297	1	77	0.0129870
NODE_2217_length_1524_cov_130.874386	219	296	306	1	77	0.0129870
NODE_2217_length_1524_cov_130.874386	219	296	316	1	77	0.0129870
NODE_2217_length_1524_cov_130.874386	219	296	317	1	77	0.0129870
NODE_2217_length_1524_cov_130.874386	219	296	338	1	77	0.0129870
NODE_2217_length_1524_cov_130.874386	219	296	346	1	77	0.0129870
NODE_2217_length_1524_cov_130.874386	219	296	348	1	77	0.0129870
NODE_2217_length_1524_cov_130.874386	219	296	353	1	77	0.0129870
NODE_2217_length_1524_cov_130.874386	219	296	363	1	77	0.0129870
NODE_2217_length_1524_cov_130.874386	219	296	372	1	77	0.0129870
NODE_2217_length_1524_cov_130.874386	219	296	374	1	77	0.0129870
NODE_2217_length_1524_cov_130.874386	219	296	378	2	77	0.0259740
NODE_2217_length_1524_cov_130.874386	219	296	384	1	77	0.0129870
NODE_2217_length_1524_cov_130.874386	219	296	386	1	77	0.0129870
NODE_2217_length_1524_cov_130.874386	219	296	405	1	77	0.0129870
NODE_2217_length_1524_cov_130.874386	219	296	406	1	77	0.0129870
NODE_2217_length_1524_cov_130.874386	219	296	407	1	77	0.0129870
NODE_2217_length_1524_cov_130.874386	219	296	409	1	77	0.0129870
NODE_2217_length_1524_cov_130.874386	219	296	417	1	77	0.0129870
NODE_2217_length_1524_cov_130.874386	219	296	419	1	77	0.0129870
NODE_2217_length_1524_cov_130.874386	219	296	423	1	77	0.0129870
NODE_2217_length_1524_cov_130.874386	219	296	427	1	77	0.0129870
NODE_2217_length_1524_cov_130.874386	219	296	428	1	77	0.0129870
NODE_2217_length_1524_cov_130.874386	219	296	430	2	77	0.0259740
NODE_2217_length_1524_cov_130.874386	219	296	431	1	77	0.0129870
NODE_2217_length_1524_cov_130.874386	219	296	433	1	77	0.0129870
NODE_2217_length_1524_cov_130.874386	219	296	434	1	77	0.0129870
NODE_2217_length_1524_cov_130.874386	219	296	436	1	77	0.0129870
NODE_2217_length_1524_cov_130.874386	219	296	437	1	77	0.0129870
NODE_2217_length_1524_cov_130.874386	219	296	439	1	77	0.0129870
NODE_2217_length_1524_cov_130.874386	219	296	441	3	77	0.0389610
NODE_2217_length_1524_cov_130.874386	219	296	443	1	77	0.0129870
NODE_2217_length_1524_cov_130.874386	219	296	447	1	77	0.0129870
NODE_2217_length_1524_cov_130.874386	219	296	456	1	77	0.0129870
NODE_2217_length_1524_cov_130.874386	219	296	459	1	77	0.0129870
NODE_2217_length_1524_cov_130.874386	219	296	461	1	77	0.0129870
NODE_2217_length_1524_cov_130.874386	219	296	462	1	77	0.0129870
NODE_2217_length_1524_cov_130.874386	219	296	466	1	77	0.0129870
NODE_2217_length_1524_cov_130.874386	219	296	474	1	77	0.0129870
NODE_2217_length_1524_cov_130.874386	219	296	477	1	77	0.0129870
NODE_2217_length_1524_cov_130.874386	219	296	479	1	77	0.0129870
NODE_2217_length_1524_cov_130.874386	219	296	480	1	77	0.0129870
NODE_2217_length_1524_cov_130.874386	219	296	481	1	77	0.0129870
NODE_2217_length_1524_cov_130.874386	219	296	483	5	77	0.0649351
NODE_2217_length_1524_cov_130.874386	219	296	491	1	77	0.0129870
NODE_2217_length_1524_cov_130.874386	219	296	495	1	77	0.0129870
NODE_2217_length_1524_cov_130.874386	219	296	496	2	77	0.0259740
NODE_2217_length_1524_cov_130.874386	219	296	497	1	77	0.0129870
NODE_2217_length_1524_cov_130.874386	219	296	498	3	77	0.0389610
NODE_2217_length_1524_cov_130.874386	219	296	500	1	77	0.0129870
NODE_2217_length_1524_cov_130.874386	219	296	501	3	77	0.0389610
NODE_2217_length_1524_cov_130.874386	219	296	502	2	77	0.0259740
NODE_2217_length_1524_cov_130.874386	219	296	503	1	77	0.0129870
NODE_2217_length_1524_cov_130.874386	219	296	504	3	77	0.0389610
NODE_2217_length_1524_cov_130.874386	219	296	507	2	77	0.0259740
NODE_2217_length_1524_cov_130.874386	219	296	508	1	77	0.0129870
NODE_2217_length_1524_cov_130.874386	219	296	509	1	77	0.0129870
NODE_2217_length_1524_cov_130.874386	219	296	512	1	77	0.0129870
NODE_2217_length_1524_cov_130.874386	219	296	515	1	77	0.0129870
NODE_2217_length_1524_cov_130.874386	253	333	134	1	80	0.0125000
NODE_2217_length_1524_cov_130.874386	253	333	140	2	80	0.0250000
NODE_2217_length_1524_cov_130.874386	253	333	142	1	80	0.0125000
NODE_2217_length_1524_cov_130.874386	253	333	144	1	80	0.0125000
NODE_2217_length_1524_cov_130.874386	253	333	152	1	80	0.0125000
NODE_2217_length_1524_cov_130.874386	253	333	158	3	80	0.0375000
NODE_2217_length_1524_cov_130.874386	253	333	159	2	80	0.0250000
NODE_2217_length_1524_cov_130.874386	253	333	161	1	80	0.0125000
NODE_2217_length_1524_cov_130.874386	253	333	162	2	80	0.0250000
NODE_2217_length_1524_cov_130.874386	253	333	166	1	80	0.0125000
NODE_2217_length_1524_cov_130.874386	253	333	170	2	80	0.0250000
NODE_2217_length_1524_cov_130.874386	253	333	175	1	80	0.0125000
NODE_2217_length_1524_cov_130.874386	253	333	177	1	80	0.0125000
NODE_2217_length_1524_cov_130.874386	253	333	180	1	80	0.0125000
NODE_2217_length_1524_cov_130.874386	253	333	183	1	80	0.0125000
NODE_2217_length_1524_cov_130.874386	253	333	193	1	80	0.0125000
NODE_2217_length_1524_cov_130.874386	253	333	200	1	80	0.0125000
NODE_2217_length_1524_cov_130.874386	253	333	201	1	80	0.0125000
NODE_2217_length_1524_cov_130.874386	253	333	210	1	80	0.0125000
NODE_2217_length_1524_cov_130.874386	253	333	216	1	80	0.0125000
NODE_2217_length_1524_cov_130.874386	253	333	226	1	80	0.0125000
NODE_2217_length_1524_cov_130.874386	253	333	228	1	80	0.0125000
NODE_2217_length_1524_cov_130.874386	253	333	236	1	80	0.0125000
NODE_2217_length_1524_cov_130.874386	253	333	248	2	80	0.0250000
NODE_2217_length_1524_cov_130.874386	253	333	256	2	80	0.0250000
NODE_2217_length_1524_cov_130.874386	253	333	262	1	80	0.0125000
NODE_2217_length_1524_cov_130.874386	253	333	264	2	80	0.0250000
NODE_2217_length_1524_cov_130.874386	253	333	275	1	80	0.0125000
NODE_2217_length_1524_cov_130.874386	253	333	286	1	80	0.0125000
NODE_2217_length_1524_cov_130.874386	253	333	297	1	80	0.0125000
NODE_2217_length_1524_cov_130.874386	253	333	306	1	80	0.0125000
NODE_2217_length_1524_cov_130.874386	253	333	316	1	80	0.0125000
NODE_2217_length_1524_cov_130.874386	253	333	317	1	80	0.0125000
NODE_2217_length_1524_cov_130.874386	253	333	338	1	80	0.0125000
NODE_2217_length_1524_cov_130.874386	253	333	346	1	80	0.0125000
NODE_2217_length_1524_cov_130.874386	253	333	348	1	80	0.0125000
NODE_2217_length_1524_cov_130.874386	253	333	353	1	80	0.0125000
NODE_2217_length_1524_cov_130.874386	253	333	363	1	80	0.0125000
NODE_2217_length_1524_cov_130.874386	253	333	372	1	80	0.0125000
NODE_2217_length_1524_cov_130.874386	253	333	374	1	80	0.0125000
NODE_2217_length_1524_cov_130.874386	253	333	378	2	80	0.0250000
NODE_2217_length_1524_cov_130.874386	253	333	384	1	80	0.0125000
NODE_2217_length_1524_cov_130.874386	253	333	386	1	80	0.0125000
NODE_2217_length_1524_cov_130.874386	253	333	405	1	80	0.0125000
NODE_2217_length_1524_cov_130.874386	253	333	406	1	80	0.0125000
NODE_2217_length_1524_cov_130.874386	253	333	407	1	80	0.0125000
NODE_2217_length_1524_cov_130.874386	253	333	409	1	80	0.0125000
NODE_2217_length_1524_cov_130.874386	253	333	417	1	80	0.0125000
NODE_2217_length_1524_cov_130.874386	253	333	419	1	80	0.0125000
NODE_2217_length_1524_cov_130.874386	253	333	423	1	80	0.0125000
NODE_2217_length_1524_cov_130.874386	253	333	427	1	80	0.0125000
NODE_2217_length_1524_cov_130.874386	253	333	428	1	80	0.0125000
NODE_2217_length_1524_cov_130.874386	253	333	430	2	80	0.0250000
NODE_2217_length_1524_cov_130.874386	253	333	431	1	80	0.0125000
NODE_2217_length_1524_cov_130.874386	253	333	433	1	80	0.0125000
NODE_2217_length_1524_cov_130.874386	253	333	434	1	80	0.0125000
NODE_2217_length_1524_cov_130.874386	253	333	436	1	80	0.0125000
NODE_2217_length_1524_cov_130.874386	253	333	437	1	80	0.0125000
NODE_2217_length_1524_cov_130.874386	253	333	439	1	80	0.0125000
NODE_2217_length_1524_cov_130.874386	253	333	441	3	80	0.0375000
NODE_2217_length_1524_cov_130.874386	253	333	443	1	80	0.0125000
NODE_2217_length_1524_cov_130.874386	253	333	447	1	80	0.0125000
NODE_2217_length_1524_cov_130.874386	253	333	456	1	80	0.0125000
NODE_2217_length_1524_cov_130.874386	253	333	459	1	80	0.0125000
NODE_2217_length_1524_cov_130.874386	253	333	461	1	80	0.0125000
NODE_2217_length_1524_cov_130.874386	253	333	462	1	80	0.0125000
NODE_2217_length_1524_cov_130.874386	253	333	466	1	80	0.0125000
NODE_2217_length_1524_cov_130.874386	306	386	49	1	80	0.0125000
NODE_2217_length_1524_cov_130.874386	306	386	50	1	80	0.0125000
NODE_2217_length_1524_cov_130.874386	306	386	51	2	80	0.0250000
NODE_2217_length_1524_cov_130.874386	306	386	52	1	80	0.0125000
NODE_2217_length_1524_cov_130.874386	306	386	58	1	80	0.0125000
NODE_2217_length_1524_cov_130.874386	306	386	60	2	80	0.0250000
NODE_2217_length_1524_cov_130.874386	306	386	63	1	80	0.0125000
NODE_2217_length_1524_cov_130.874386	306	386	64	1	80	0.0125000
NODE_2217_length_1524_cov_130.874386	306	386	65	2	80	0.0250000
NODE_2217_length_1524_cov_130.874386	306	386	71	1	80	0.0125000
NODE_2217_length_1524_cov_130.874386	306	386	73	2	80	0.0250000
NODE_2217_length_1524_cov_130.874386	306	386	75	3	80	0.0375000
NODE_2217_length_1524_cov_130.874386	306	386	83	3	80	0.0375000
NODE_2217_length_1524_cov_130.874386	306	386	84	2	80	0.0250000
NODE_2217_length_1524_cov_130.874386	306	386	85	3	80	0.0375000
NODE_2217_length_1524_cov_130.874386	306	386	91	1	80	0.0125000
NODE_2217_length_1524_cov_130.874386	306	386	93	1	80	0.0125000
NODE_2217_length_1524_cov_130.874386	306	386	94	1	80	0.0125000
NODE_2217_length_1524_cov_130.874386	306	386	96	1	80	0.0125000
NODE_2217_length_1524_cov_130.874386	306	386	97	1	80	0.0125000
NODE_2217_length_1524_cov_130.874386	306	386	100	1	80	0.0125000
NODE_2217_length_1524_cov_130.874386	306	386	107	3	80	0.0375000
NODE_2217_length_1524_cov_130.874386	306	386	109	1	80	0.0125000
NODE_2217_length_1524_cov_130.874386	306	386	115	1	80	0.0125000
NODE_2217_length_1524_cov_130.874386	306	386	117	1	80	0.0125000
NODE_2217_length_1524_cov_130.874386	306	386	119	2	80	0.0250000
NODE_2217_length_1524_cov_130.874386	306	386	125	1	80	0.0125000
NODE_2217_length_1524_cov_130.874386	306	386	126	1	80	0.0125000
NODE_2217_length_1524_cov_130.874386	306	386	128	1	80	0.0125000
NODE_2217_length_1524_cov_130.874386	306	386	130	1	80	0.0125000
NODE_2217_length_1524_cov_130.874386	306	386	132	7	80	0.0875000
NODE_2217_length_1524_cov_130.874386	306	386	133	2	80	0.0250000
NODE_2217_length_1524_cov_130.874386	306	386	134	1	80	0.0125000
NODE_2217_length_1524_cov_130.874386	306	386	140	2	80	0.0250000
NODE_2217_length_1524_cov_130.874386	306	386	142	1	80	0.0125000
NODE_2217_length_1524_cov_130.874386	306	386	144	1	80	0.0125000
NODE_2217_length_1524_cov_130.874386	306	386	152	1	80	0.0125000
NODE_2217_length_1524_cov_130.874386	306	386	158	3	80	0.0375000
NODE_2217_length_1524_cov_130.874386	306	386	159	2	80	0.0250000
NODE_2217_length_1524_cov_130.874386	306	386	161	1	80	0.0125000
NODE_2217_length_1524_cov_130.874386	306	386	162	2	80	0.0250000
NODE_2217_length_1524_cov_130.874386	306	386	166	1	80	0.0125000
NODE_2217_length_1524_cov_130.874386	306	386	170	2	80	0.0250000
NODE_2217_length_1524_cov_130.874386	306	386	175	1	80	0.0125000
NODE_2217_length_1524_cov_130.874386	306	386	177	1	80	0.0125000
NODE_2217_length_1524_cov_130.874386	306	386	180	1	80	0.0125000
NODE_2217_length_1524_cov_130.874386	306	386	183	1	80	0.0125000
NODE_2217_length_1524_cov_130.874386	306	386	193	1	80	0.0125000
NODE_2217_length_1524_cov_130.874386	306	386	200	1	80	0.0125000
NODE_2217_length_1524_cov_130.874386	306	386	201	1	80	0.0125000
NODE_2217_length_1524_cov_130.874386	306	386	210	1	80	0.0125000
NODE_2217_length_1524_cov_130.874386	306	386	216	1	80	0.0125000
NODE_2217_length_1524_cov_130.874386	306	386	226	1	80	0.0125000
NODE_2219_length_1523_cov_24.115169	366	446	0	15	80	0.1875000
NODE_2219_length_1523_cov_24.115169	366	446	4	65	80	0.8125000
NODE_2219_length_1523_cov_24.115169	419	499	0	68	80	0.8500000
NODE_2219_length_1523_cov_24.115169	419	499	4	12	80	0.1500000
NODE_2219_length_1523_cov_24.115169	495	575	0	80	80	1.0000000
NODE_2219_length_1523_cov_24.115169	548	628	0	80	80	1.0000000
NODE_2223_length_1522_cov_13.278988	361	441	0	80	80	1.0000000
NODE_2223_length_1522_cov_13.278988	414	494	0	80	80	1.0000000
NODE_2225_length_1521_cov_20.965541	772	852	0	80	80	1.0000000
NODE_2225_length_1521_cov_20.965541	825	905	0	80	80	1.0000000
NODE_2226_length_1521_cov_15.381153	907	987	0	80	80	1.0000000
NODE_2226_length_1521_cov_15.381153	960	1040	0	80	80	1.0000000
NODE_2226_length_1521_cov_15.381153	988	1040	0	52	52	1.0000000
NODE_2227_length_1521_cov_7.682138	525	605	0	80	80	1.0000000
NODE_2227_length_1521_cov_7.682138	578	658	0	80	80	1.0000000
NODE_2236_length_1519_cov_20.792958	714	794	4	29	80	0.3625000
NODE_2236_length_1519_cov_20.792958	714	794	8	51	80	0.6375000
NODE_2236_length_1519_cov_20.792958	767	847	0	15	80	0.1875000
NODE_2236_length_1519_cov_20.792958	767	847	4	65	80	0.8125000
NODE_2239_length_1517_cov_24.074048	413	450	0	37	37	1.0000000
NODE_2239_length_1517_cov_24.074048	842	922	0	80	80	1.0000000
NODE_2239_length_1517_cov_24.074048	895	975	0	80	80	1.0000000
NODE_2240_length_1517_cov_22.897743	383	463	0	80	80	1.0000000
NODE_2240_length_1517_cov_22.897743	436	516	0	80	80	1.0000000
NODE_2241_length_1517_cov_11.781382	381	461	4	80	80	1.0000000
NODE_2241_length_1517_cov_11.781382	434	514	0	14	80	0.1750000
NODE_2241_length_1517_cov_11.781382	434	514	4	66	80	0.8250000
NODE_2243_length_1517_cov_4.944993	393	473	0	80	80	1.0000000
NODE_2243_length_1517_cov_4.944993	446	526	0	80	80	1.0000000
NODE_2247_length_1516_cov_11.177135	230	310	0	80	80	1.0000000
NODE_2247_length_1516_cov_11.177135	283	363	0	80	80	1.0000000
NODE_2248_length_1516_cov_8.608327	580	660	0	63	80	0.7875000
NODE_2248_length_1516_cov_8.608327	580	660	2	17	80	0.2125000
NODE_2248_length_1516_cov_8.608327	633	713	0	80	80	1.0000000
NODE_2250_length_1515_cov_16.990819	333	413	2	25	80	0.3125000
NODE_2250_length_1515_cov_16.990819	333	413	4	4	80	0.0500000
NODE_2250_length_1515_cov_16.990819	333	413	6	5	80	0.0625000
NODE_2250_length_1515_cov_16.990819	333	413	8	1	80	0.0125000
NODE_2250_length_1515_cov_16.990819	333	413	9	1	80	0.0125000
NODE_2250_length_1515_cov_16.990819	333	413	11	14	80	0.1750000
NODE_2250_length_1515_cov_16.990819	333	413	13	1	80	0.0125000
NODE_2250_length_1515_cov_16.990819	333	413	15	2	80	0.0250000
NODE_2250_length_1515_cov_16.990819	333	413	17	5	80	0.0625000
NODE_2250_length_1515_cov_16.990819	333	413	18	12	80	0.1500000
NODE_2250_length_1515_cov_16.990819	333	413	20	2	80	0.0250000
NODE_2250_length_1515_cov_16.990819	333	413	22	1	80	0.0125000
NODE_2250_length_1515_cov_16.990819	333	413	24	4	80	0.0500000
NODE_2250_length_1515_cov_16.990819	333	413	26	1	80	0.0125000
NODE_2250_length_1515_cov_16.990819	333	413	28	1	80	0.0125000
NODE_2250_length_1515_cov_16.990819	333	413	30	1	80	0.0125000
NODE_2250_length_1515_cov_16.990819	386	448	2	60	62	0.9677419
NODE_2250_length_1515_cov_16.990819	386	448	4	2	62	0.0322581
NODE_2258_length_1512_cov_5.111819	506	560	0	54	54	1.0000000
NODE_2258_length_1512_cov_5.111819	677	698	0	21	21	1.0000000
NODE_2258_length_1512_cov_5.111819	677	698	0	21	21	1.0000000
NODE_2258_length_1512_cov_5.111819	1057	1137	0	80	80	1.0000000
NODE_2258_length_1512_cov_5.111819	1110	1190	0	80	80	1.0000000
NODE_2258_length_1512_cov_5.111819	1144	1190	0	46	46	1.0000000
NODE_2259_length_1512_cov_4.251946	132	204	0	72	72	1.0000000
NODE_2262_length_1511_cov_30.963173	787	867	0	8	80	0.1000000
NODE_2262_length_1511_cov_30.963173	787	867	1	26	80	0.3250000
NODE_2262_length_1511_cov_30.963173	787	867	3	46	80	0.5750000
NODE_2262_length_1511_cov_30.963173	840	920	1	34	80	0.4250000
NODE_2262_length_1511_cov_30.963173	840	920	3	46	80	0.5750000
NODE_2262_length_1511_cov_30.963173	916	996	0	27	80	0.3375000
NODE_2262_length_1511_cov_30.963173	916	996	1	53	80	0.6625000
NODE_2262_length_1511_cov_30.963173	969	1059	0	90	90	1.0000000
NODE_2265_length_1510_cov_24.184975	434	514	0	15	80	0.1875000
NODE_2265_length_1510_cov_24.184975	434	514	2	65	80	0.8125000
NODE_2265_length_1510_cov_24.184975	487	567	0	25	80	0.3125000
NODE_2265_length_1510_cov_24.184975	487	567	2	55	80	0.6875000
NODE_2265_length_1510_cov_24.184975	563	643	0	80	80	1.0000000
NODE_2265_length_1510_cov_24.184975	616	696	0	80	80	1.0000000
NODE_2269_length_1509_cov_51.836170	655	735	0	80	80	1.0000000
NODE_2269_length_1509_cov_51.836170	708	788	0	57	80	0.7125000
NODE_2269_length_1509_cov_51.836170	708	788	2	23	80	0.2875000
NODE_2269_length_1509_cov_51.836170	784	864	0	27	80	0.3375000
NODE_2269_length_1509_cov_51.836170	784	864	2	53	80	0.6625000
NODE_2269_length_1509_cov_51.836170	837	917	0	57	80	0.7125000
NODE_2269_length_1509_cov_51.836170	837	917	2	23	80	0.2875000
NODE_2270_length_1509_cov_16.010638	497	577	0	80	80	1.0000000
NODE_2270_length_1509_cov_16.010638	550	630	0	62	80	0.7750000
NODE_2270_length_1509_cov_16.010638	550	630	1	18	80	0.2250000
NODE_2270_length_1509_cov_16.010638	626	706	1	80	80	1.0000000
NODE_2270_length_1509_cov_16.010638	679	759	1	34	80	0.4250000
NODE_2270_length_1509_cov_16.010638	679	759	2	46	80	0.5750000
NODE_2271_length_1509_cov_8.883688	252	332	2	45	80	0.5625000
NODE_2271_length_1509_cov_8.883688	252	332	8	3	80	0.0375000
NODE_2271_length_1509_cov_8.883688	252	332	11	1	80	0.0125000
NODE_2271_length_1509_cov_8.883688	252	332	12	31	80	0.3875000
NODE_2271_length_1509_cov_8.883688	305	385	0	30	80	0.3750000
NODE_2271_length_1509_cov_8.883688	305	385	2	50	80	0.6250000
NODE_2271_length_1509_cov_8.883688	327	385	0	30	58	0.5172414
NODE_2271_length_1509_cov_8.883688	327	385	2	28	58	0.4827586
NODE_2271_length_1509_cov_8.883688	381	461	0	80	80	1.0000000
NODE_2271_length_1509_cov_8.883688	434	514	0	80	80	1.0000000
NODE_2272_length_1509_cov_5.826950	1029	1109	0	80	80	1.0000000
NODE_2272_length_1509_cov_5.826950	1082	1162	0	59	80	0.7375000
NODE_2272_length_1509_cov_5.826950	1082	1162	2	21	80	0.2625000
NODE_2277_length_1508_cov_24.176011	765	845	0	80	80	1.0000000
NODE_2277_length_1508_cov_24.176011	818	898	0	80	80	1.0000000
NODE_2290_length_1504_cov_17.449822	596	676	0	80	80	1.0000000
NODE_2290_length_1504_cov_17.449822	649	729	0	80	80	1.0000000
NODE_2293_length_1502_cov_42.989309	559	639	0	8	80	0.1000000
NODE_2293_length_1502_cov_42.989309	559	639	1	72	80	0.9000000
NODE_2293_length_1502_cov_42.989309	612	692	0	12	80	0.1500000
NODE_2293_length_1502_cov_42.989309	612	692	1	68	80	0.8500000
NODE_2294_length_1501_cov_22.828816	421	500	0	79	79	1.0000000
NODE_2294_length_1501_cov_22.828816	473	553	0	80	80	1.0000000
NODE_2294_length_1501_cov_22.828816	549	629	0	80	80	1.0000000
NODE_2294_length_1501_cov_22.828816	602	682	0	80	80	1.0000000
NODE_2295_length_1501_cov_14.422254	973	1053	0	80	80	1.0000000
NODE_2295_length_1501_cov_14.422254	1026	1106	0	80	80	1.0000000
NODE_2296_length_1501_cov_14.060628	225	305	0	80	80	1.0000000
NODE_2296_length_1501_cov_14.060628	278	358	0	80	80	1.0000000
NODE_2296_length_1501_cov_14.060628	986	1066	0	80	80	1.0000000
NODE_2296_length_1501_cov_14.060628	1039	1119	0	80	80	1.0000000
NODE_2300_length_1500_cov_40.056388	619	699	0	80	80	1.0000000
NODE_2300_length_1500_cov_40.056388	672	752	0	80	80	1.0000000
NODE_2305_length_1497_cov_38.344063	1401	1481	35	4	80	0.0500000
NODE_2305_length_1497_cov_38.344063	1401	1481	37	6	80	0.0750000
NODE_2305_length_1497_cov_38.344063	1401	1481	41	1	80	0.0125000
NODE_2305_length_1497_cov_38.344063	1401	1481	43	4	80	0.0500000
NODE_2305_length_1497_cov_38.344063	1401	1481	47	1	80	0.0125000
NODE_2305_length_1497_cov_38.344063	1401	1481	49	20	80	0.2500000
NODE_2305_length_1497_cov_38.344063	1401	1481	51	13	80	0.1625000
NODE_2305_length_1497_cov_38.344063	1401	1481	54	1	80	0.0125000
NODE_2305_length_1497_cov_38.344063	1401	1481	56	3	80	0.0375000
NODE_2305_length_1497_cov_38.344063	1401	1481	60	1	80	0.0125000
NODE_2305_length_1497_cov_38.344063	1401	1481	63	1	80	0.0125000
NODE_2305_length_1497_cov_38.344063	1401	1481	64	4	80	0.0500000
NODE_2305_length_1497_cov_38.344063	1401	1481	68	1	80	0.0125000
NODE_2305_length_1497_cov_38.344063	1401	1481	73	1	80	0.0125000
NODE_2305_length_1497_cov_38.344063	1401	1481	75	1	80	0.0125000
NODE_2305_length_1497_cov_38.344063	1401	1481	79	4	80	0.0500000
NODE_2305_length_1497_cov_38.344063	1401	1481	83	1	80	0.0125000
NODE_2305_length_1497_cov_38.344063	1401	1481	88	7	80	0.0875000
NODE_2305_length_1497_cov_38.344063	1401	1481	90	1	80	0.0125000
NODE_2305_length_1497_cov_38.344063	1401	1481	91	1	80	0.0125000
NODE_2305_length_1497_cov_38.344063	1401	1481	93	1	80	0.0125000
NODE_2305_length_1497_cov_38.344063	1401	1481	95	1	80	0.0125000
NODE_2305_length_1497_cov_38.344063	1401	1481	97	2	80	0.0250000
NODE_2308_length_1496_cov_3.936292	0	44	0	44	44	1.0000000
NODE_2308_length_1496_cov_3.936292	17	97	0	80	80	1.0000000
NODE_2311_length_1496_cov_1.103794	405	428	0	23	23	1.0000000
NODE_2313_length_1494_cov_65.437276	460	540	0	11	80	0.1375000
NODE_2313_length_1494_cov_65.437276	460	540	2	69	80	0.8625000
NODE_2313_length_1494_cov_65.437276	513	594	0	37	81	0.4567901
NODE_2313_length_1494_cov_65.437276	513	594	2	44	81	0.5432099
NODE_2313_length_1494_cov_65.437276	787	854	0	18	67	0.2686567
NODE_2313_length_1494_cov_65.437276	787	854	2	49	67	0.7313433
NODE_2313_length_1494_cov_65.437276	827	907	0	16	80	0.2000000
NODE_2313_length_1494_cov_65.437276	827	907	2	64	80	0.8000000
NODE_2316_length_1493_cov_100.467719	947	1028	103	2	81	0.0246914
NODE_2316_length_1493_cov_100.467719	947	1028	105	1	81	0.0123457
NODE_2316_length_1493_cov_100.467719	947	1028	109	1	81	0.0123457
NODE_2316_length_1493_cov_100.467719	947	1028	116	1	81	0.0123457
NODE_2316_length_1493_cov_100.467719	947	1028	118	1	81	0.0123457
NODE_2316_length_1493_cov_100.467719	947	1028	119	1	81	0.0123457
NODE_2316_length_1493_cov_100.467719	947	1028	120	1	81	0.0123457
NODE_2316_length_1493_cov_100.467719	947	1028	127	1	81	0.0123457
NODE_2316_length_1493_cov_100.467719	947	1028	129	1	81	0.0123457
NODE_2316_length_1493_cov_100.467719	947	1028	131	1	81	0.0123457
NODE_2316_length_1493_cov_100.467719	947	1028	138	1	81	0.0123457
NODE_2316_length_1493_cov_100.467719	947	1028	142	1	81	0.0123457
NODE_2316_length_1493_cov_100.467719	947	1028	144	1	81	0.0123457
NODE_2316_length_1493_cov_100.467719	947	1028	147	1	81	0.0123457
NODE_2316_length_1493_cov_100.467719	947	1028	153	1	81	0.0123457
NODE_2316_length_1493_cov_100.467719	947	1028	157	1	81	0.0123457
NODE_2316_length_1493_cov_100.467719	947	1028	166	3	81	0.0370370
NODE_2316_length_1493_cov_100.467719	947	1028	167	2	81	0.0246914
NODE_2316_length_1493_cov_100.467719	947	1028	168	1	81	0.0123457
NODE_2316_length_1493_cov_100.467719	947	1028	169	1	81	0.0123457
NODE_2316_length_1493_cov_100.467719	947	1028	172	1	81	0.0123457
NODE_2316_length_1493_cov_100.467719	947	1028	182	1	81	0.0123457
NODE_2316_length_1493_cov_100.467719	947	1028	184	1	81	0.0123457
NODE_2316_length_1493_cov_100.467719	947	1028	192	1	81	0.0123457
NODE_2316_length_1493_cov_100.467719	947	1028	199	1	81	0.0123457
NODE_2316_length_1493_cov_100.467719	947	1028	201	1	81	0.0123457
NODE_2316_length_1493_cov_100.467719	947	1028	203	1	81	0.0123457
NODE_2316_length_1493_cov_100.467719	947	1028	210	2	81	0.0246914
NODE_2316_length_1493_cov_100.467719	947	1028	217	1	81	0.0123457
NODE_2316_length_1493_cov_100.467719	947	1028	225	1	81	0.0123457
NODE_2316_length_1493_cov_100.467719	947	1028	226	1	81	0.0123457
NODE_2316_length_1493_cov_100.467719	947	1028	228	1	81	0.0123457
NODE_2316_length_1493_cov_100.467719	947	1028	229	1	81	0.0123457
NODE_2316_length_1493_cov_100.467719	947	1028	230	2	81	0.0246914
NODE_2316_length_1493_cov_100.467719	947	1028	233	6	81	0.0740741
NODE_2316_length_1493_cov_100.467719	947	1028	234	6	81	0.0740741
NODE_2316_length_1493_cov_100.467719	947	1028	235	7	81	0.0864198
NODE_2316_length_1493_cov_100.467719	947	1028	236	1	81	0.0123457
NODE_2316_length_1493_cov_100.467719	947	1028	237	2	81	0.0246914
NODE_2316_length_1493_cov_100.467719	947	1028	238	2	81	0.0246914
NODE_2316_length_1493_cov_100.467719	947	1028	239	2	81	0.0246914
NODE_2316_length_1493_cov_100.467719	947	1028	240	3	81	0.0370370
NODE_2316_length_1493_cov_100.467719	947	1028	243	2	81	0.0246914
NODE_2316_length_1493_cov_100.467719	947	1028	246	1	81	0.0123457
NODE_2316_length_1493_cov_100.467719	947	1028	249	2	81	0.0246914
NODE_2316_length_1493_cov_100.467719	947	1028	259	1	81	0.0123457
NODE_2316_length_1493_cov_100.467719	947	1028	262	1	81	0.0123457
NODE_2316_length_1493_cov_100.467719	947	1028	268	1	81	0.0123457
NODE_2316_length_1493_cov_100.467719	947	1028	283	1	81	0.0123457
NODE_2316_length_1493_cov_100.467719	947	1028	286	1	81	0.0123457
NODE_2316_length_1493_cov_100.467719	947	1028	295	2	81	0.0246914
NODE_2316_length_1493_cov_100.467719	1001	1071	233	1	70	0.0142857
NODE_2316_length_1493_cov_100.467719	1001	1071	234	3	70	0.0428571
NODE_2316_length_1493_cov_100.467719	1001	1071	235	5	70	0.0714286
NODE_2316_length_1493_cov_100.467719	1001	1071	236	1	70	0.0142857
NODE_2316_length_1493_cov_100.467719	1001	1071	238	1	70	0.0142857
NODE_2316_length_1493_cov_100.467719	1001	1071	239	2	70	0.0285714
NODE_2316_length_1493_cov_100.467719	1001	1071	240	2	70	0.0285714
NODE_2316_length_1493_cov_100.467719	1001	1071	243	2	70	0.0285714
NODE_2316_length_1493_cov_100.467719	1001	1071	246	1	70	0.0142857
NODE_2316_length_1493_cov_100.467719	1001	1071	249	2	70	0.0285714
NODE_2316_length_1493_cov_100.467719	1001	1071	259	1	70	0.0142857
NODE_2316_length_1493_cov_100.467719	1001	1071	262	1	70	0.0142857
NODE_2316_length_1493_cov_100.467719	1001	1071	268	1	70	0.0142857
NODE_2316_length_1493_cov_100.467719	1001	1071	283	1	70	0.0142857
NODE_2316_length_1493_cov_100.467719	1001	1071	286	1	70	0.0142857
NODE_2316_length_1493_cov_100.467719	1001	1071	295	2	70	0.0285714
NODE_2316_length_1493_cov_100.467719	1001	1071	309	1	70	0.0142857
NODE_2316_length_1493_cov_100.467719	1001	1071	313	1	70	0.0142857
NODE_2316_length_1493_cov_100.467719	1001	1071	323	3	70	0.0428571
NODE_2316_length_1493_cov_100.467719	1001	1071	325	2	70	0.0285714
NODE_2316_length_1493_cov_100.467719	1001	1071	327	3	70	0.0428571
NODE_2316_length_1493_cov_100.467719	1001	1071	328	1	70	0.0142857
NODE_2316_length_1493_cov_100.467719	1001	1071	329	2	70	0.0285714
NODE_2316_length_1493_cov_100.467719	1001	1071	331	1	70	0.0142857
NODE_2316_length_1493_cov_100.467719	1001	1071	341	1	70	0.0142857
NODE_2316_length_1493_cov_100.467719	1001	1071	343	1	70	0.0142857
NODE_2316_length_1493_cov_100.467719	1001	1071	345	1	70	0.0142857
NODE_2316_length_1493_cov_100.467719	1001	1071	365	1	70	0.0142857
NODE_2316_length_1493_cov_100.467719	1001	1071	379	1	70	0.0142857
NODE_2316_length_1493_cov_100.467719	1001	1071	390	1	70	0.0142857
NODE_2316_length_1493_cov_100.467719	1001	1071	391	2	70	0.0285714
NODE_2316_length_1493_cov_100.467719	1001	1071	393	1	70	0.0142857
NODE_2316_length_1493_cov_100.467719	1001	1071	394	1	70	0.0142857
NODE_2316_length_1493_cov_100.467719	1001	1071	395	1	70	0.0142857
NODE_2316_length_1493_cov_100.467719	1001	1071	399	1	70	0.0142857
NODE_2316_length_1493_cov_100.467719	1001	1071	400	4	70	0.0571429
NODE_2316_length_1493_cov_100.467719	1001	1071	401	1	70	0.0142857
NODE_2316_length_1493_cov_100.467719	1001	1071	402	1	70	0.0142857
NODE_2316_length_1493_cov_100.467719	1001	1071	406	1	70	0.0142857
NODE_2316_length_1493_cov_100.467719	1001	1071	418	2	70	0.0285714
NODE_2316_length_1493_cov_100.467719	1001	1071	420	1	70	0.0142857
NODE_2316_length_1493_cov_100.467719	1001	1071	422	1	70	0.0142857
NODE_2316_length_1493_cov_100.467719	1001	1071	424	2	70	0.0285714
NODE_2316_length_1493_cov_100.467719	1001	1071	425	1	70	0.0142857
NODE_2316_length_1493_cov_100.467719	1001	1071	430	2	70	0.0285714
NODE_2316_length_1493_cov_100.467719	1001	1071	431	1	70	0.0142857
NODE_2316_length_1493_cov_100.467719	1077	1157	450	2	80	0.0250000
NODE_2316_length_1493_cov_100.467719	1077	1157	453	2	80	0.0250000
NODE_2316_length_1493_cov_100.467719	1077	1157	460	1	80	0.0125000
NODE_2316_length_1493_cov_100.467719	1077	1157	473	1	80	0.0125000
NODE_2316_length_1493_cov_100.467719	1077	1157	477	1	80	0.0125000
NODE_2316_length_1493_cov_100.467719	1077	1157	478	1	80	0.0125000
NODE_2316_length_1493_cov_100.467719	1077	1157	479	1	80	0.0125000
NODE_2316_length_1493_cov_100.467719	1077	1157	480	3	80	0.0375000
NODE_2316_length_1493_cov_100.467719	1077	1157	481	3	80	0.0375000
NODE_2316_length_1493_cov_100.467719	1077	1157	482	1	80	0.0125000
NODE_2316_length_1493_cov_100.467719	1077	1157	483	2	80	0.0250000
NODE_2316_length_1493_cov_100.467719	1077	1157	485	4	80	0.0500000
NODE_2316_length_1493_cov_100.467719	1077	1157	486	1	80	0.0125000
NODE_2316_length_1493_cov_100.467719	1077	1157	488	1	80	0.0125000
NODE_2316_length_1493_cov_100.467719	1077	1157	492	1	80	0.0125000
NODE_2316_length_1493_cov_100.467719	1077	1157	507	1	80	0.0125000
NODE_2316_length_1493_cov_100.467719	1077	1157	512	1	80	0.0125000
NODE_2316_length_1493_cov_100.467719	1077	1157	531	1	80	0.0125000
NODE_2316_length_1493_cov_100.467719	1077	1157	538	1	80	0.0125000
NODE_2316_length_1493_cov_100.467719	1077	1157	543	2	80	0.0250000
NODE_2316_length_1493_cov_100.467719	1077	1157	544	3	80	0.0375000
NODE_2316_length_1493_cov_100.467719	1077	1157	545	1	80	0.0125000
NODE_2316_length_1493_cov_100.467719	1077	1157	546	4	80	0.0500000
NODE_2316_length_1493_cov_100.467719	1077	1157	547	4	80	0.0500000
NODE_2316_length_1493_cov_100.467719	1077	1157	548	2	80	0.0250000
NODE_2316_length_1493_cov_100.467719	1077	1157	551	1	80	0.0125000
NODE_2316_length_1493_cov_100.467719	1077	1157	553	1	80	0.0125000
NODE_2316_length_1493_cov_100.467719	1077	1157	557	1	80	0.0125000
NODE_2316_length_1493_cov_100.467719	1077	1157	561	1	80	0.0125000
NODE_2316_length_1493_cov_100.467719	1077	1157	563	2	80	0.0250000
NODE_2316_length_1493_cov_100.467719	1077	1157	567	1	80	0.0125000
NODE_2316_length_1493_cov_100.467719	1077	1157	574	1	80	0.0125000
NODE_2316_length_1493_cov_100.467719	1077	1157	588	1	80	0.0125000
NODE_2316_length_1493_cov_100.467719	1077	1157	591	1	80	0.0125000
NODE_2316_length_1493_cov_100.467719	1077	1157	607	2	80	0.0250000
NODE_2316_length_1493_cov_100.467719	1077	1157	611	2	80	0.0250000
NODE_2316_length_1493_cov_100.467719	1077	1157	613	1	80	0.0125000
NODE_2316_length_1493_cov_100.467719	1077	1157	619	1	80	0.0125000
NODE_2316_length_1493_cov_100.467719	1077	1157	622	1	80	0.0125000
NODE_2316_length_1493_cov_100.467719	1077	1157	624	2	80	0.0250000
NODE_2316_length_1493_cov_100.467719	1077	1157	627	2	80	0.0250000
NODE_2316_length_1493_cov_100.467719	1077	1157	642	1	80	0.0125000
NODE_2316_length_1493_cov_100.467719	1077	1157	651	1	80	0.0125000
NODE_2316_length_1493_cov_100.467719	1077	1157	657	2	80	0.0250000
NODE_2316_length_1493_cov_100.467719	1077	1157	660	1	80	0.0125000
NODE_2316_length_1493_cov_100.467719	1077	1157	664	2	80	0.0250000
NODE_2316_length_1493_cov_100.467719	1077	1157	667	1	80	0.0125000
NODE_2316_length_1493_cov_100.467719	1077	1157	670	1	80	0.0125000
NODE_2316_length_1493_cov_100.467719	1077	1157	672	1	80	0.0125000
NODE_2316_length_1493_cov_100.467719	1077	1157	675	2	80	0.0250000
NODE_2316_length_1493_cov_100.467719	1077	1157	681	1	80	0.0125000
NODE_2316_length_1493_cov_100.467719	1077	1157	683	1	80	0.0125000
NODE_2316_length_1493_cov_100.467719	1130	1210	588	1	80	0.0125000
NODE_2316_length_1493_cov_100.467719	1130	1210	591	1	80	0.0125000
NODE_2316_length_1493_cov_100.467719	1130	1210	607	2	80	0.0250000
NODE_2316_length_1493_cov_100.467719	1130	1210	611	2	80	0.0250000
NODE_2316_length_1493_cov_100.467719	1130	1210	613	1	80	0.0125000
NODE_2316_length_1493_cov_100.467719	1130	1210	619	1	80	0.0125000
NODE_2316_length_1493_cov_100.467719	1130	1210	621	2	80	0.0250000
NODE_2316_length_1493_cov_100.467719	1130	1210	622	2	80	0.0250000
NODE_2316_length_1493_cov_100.467719	1130	1210	623	2	80	0.0250000
NODE_2316_length_1493_cov_100.467719	1130	1210	624	2	80	0.0250000
NODE_2316_length_1493_cov_100.467719	1130	1210	625	1	80	0.0125000
NODE_2316_length_1493_cov_100.467719	1130	1210	626	1	80	0.0125000
NODE_2316_length_1493_cov_100.467719	1130	1210	627	4	80	0.0500000
NODE_2316_length_1493_cov_100.467719	1130	1210	628	1	80	0.0125000
NODE_2316_length_1493_cov_100.467719	1130	1210	629	1	80	0.0125000
NODE_2316_length_1493_cov_100.467719	1130	1210	632	2	80	0.0250000
NODE_2316_length_1493_cov_100.467719	1130	1210	635	1	80	0.0125000
NODE_2316_length_1493_cov_100.467719	1130	1210	640	1	80	0.0125000
NODE_2316_length_1493_cov_100.467719	1130	1210	642	1	80	0.0125000
NODE_2316_length_1493_cov_100.467719	1130	1210	644	1	80	0.0125000
NODE_2316_length_1493_cov_100.467719	1130	1210	645	1	80	0.0125000
NODE_2316_length_1493_cov_100.467719	1130	1210	650	2	80	0.0250000
NODE_2316_length_1493_cov_100.467719	1130	1210	651	3	80	0.0375000
NODE_2316_length_1493_cov_100.467719	1130	1210	654	3	80	0.0375000
NODE_2316_length_1493_cov_100.467719	1130	1210	657	4	80	0.0500000
NODE_2316_length_1493_cov_100.467719	1130	1210	658	1	80	0.0125000
NODE_2316_length_1493_cov_100.467719	1130	1210	660	2	80	0.0250000
NODE_2316_length_1493_cov_100.467719	1130	1210	664	2	80	0.0250000
NODE_2316_length_1493_cov_100.467719	1130	1210	666	1	80	0.0125000
NODE_2316_length_1493_cov_100.467719	1130	1210	667	3	80	0.0375000
NODE_2316_length_1493_cov_100.467719	1130	1210	670	1	80	0.0125000
NODE_2316_length_1493_cov_100.467719	1130	1210	672	1	80	0.0125000
NODE_2316_length_1493_cov_100.467719	1130	1210	673	1	80	0.0125000
NODE_2316_length_1493_cov_100.467719	1130	1210	675	2	80	0.0250000
NODE_2316_length_1493_cov_100.467719	1130	1210	676	2	80	0.0250000
NODE_2316_length_1493_cov_100.467719	1130	1210	677	1	80	0.0125000
NODE_2316_length_1493_cov_100.467719	1130	1210	678	1	80	0.0125000
NODE_2316_length_1493_cov_100.467719	1130	1210	680	2	80	0.0250000
NODE_2316_length_1493_cov_100.467719	1130	1210	681	3	80	0.0375000
NODE_2316_length_1493_cov_100.467719	1130	1210	682	6	80	0.0750000
NODE_2316_length_1493_cov_100.467719	1130	1210	683	2	80	0.0250000
NODE_2316_length_1493_cov_100.467719	1130	1210	686	3	80	0.0375000
NODE_2316_length_1493_cov_100.467719	1130	1210	687	2	80	0.0250000
NODE_2316_length_1493_cov_100.467719	1130	1210	690	1	80	0.0125000
NODE_2321_length_1493_cov_1.138451	1341	1420	0	34	79	0.4303797
NODE_2321_length_1493_cov_1.138451	1341	1420	4	45	79	0.5696203
NODE_2321_length_1493_cov_1.138451	1341	1420	0	34	79	0.4303797
NODE_2321_length_1493_cov_1.138451	1341	1420	4	45	79	0.5696203
NODE_2321_length_1493_cov_1.138451	1393	1459	4	66	66	1.0000000
NODE_2332_length_1490_cov_5.726096	233	295	0	12	62	0.1935484
NODE_2332_length_1490_cov_5.726096	233	295	2	1	62	0.0161290
NODE_2332_length_1490_cov_5.726096	233	295	3	2	62	0.0322581
NODE_2332_length_1490_cov_5.726096	233	295	7	2	62	0.0322581
NODE_2332_length_1490_cov_5.726096	233	295	8	45	62	0.7258065
NODE_2332_length_1490_cov_5.726096	1065	1149	0	84	84	1.0000000
NODE_2333_length_1490_cov_4.687275	318	399	0	81	81	1.0000000
NODE_2333_length_1490_cov_4.687275	372	452	0	80	80	1.0000000
NODE_2338_length_1488_cov_3.734341	1141	1221	0	80	80	1.0000000
NODE_2340_length_1487_cov_19.332133	673	753	0	55	80	0.6875000
NODE_2340_length_1487_cov_19.332133	673	753	4	25	80	0.3125000
NODE_2340_length_1487_cov_19.332133	726	806	0	2	80	0.0250000
NODE_2340_length_1487_cov_19.332133	726	806	4	78	80	0.9750000
NODE_2348_length_1484_cov_38.342960	706	786	0	68	80	0.8500000
NODE_2348_length_1484_cov_38.342960	706	786	1	12	80	0.1500000
NODE_2348_length_1484_cov_38.342960	759	839	0	80	80	1.0000000
NODE_2349_length_1484_cov_21.260650	348	428	0	80	80	1.0000000
NODE_2349_length_1484_cov_21.260650	401	481	0	80	80	1.0000000
NODE_2349_length_1484_cov_21.260650	978	1058	0	80	80	1.0000000
NODE_2349_length_1484_cov_21.260650	1031	1111	0	80	80	1.0000000
NODE_2350_length_1484_cov_19.243321	952	1032	8	43	80	0.5375000
NODE_2350_length_1484_cov_19.243321	952	1032	14	37	80	0.4625000
NODE_2350_length_1484_cov_19.243321	1005	1085	6	11	80	0.1375000
NODE_2350_length_1484_cov_19.243321	1005	1085	14	69	80	0.8625000
NODE_2351_length_1484_cov_9.085199	314	394	0	80	80	1.0000000
NODE_2351_length_1484_cov_9.085199	367	447	0	80	80	1.0000000
NODE_2353_length_1483_cov_21.207370	555	635	0	80	80	1.0000000
NODE_2353_length_1483_cov_21.207370	608	688	0	80	80	1.0000000
NODE_2359_length_1482_cov_20.177874	430	510	0	60	80	0.7500000
NODE_2359_length_1482_cov_20.177874	430	510	2	20	80	0.2500000
NODE_2359_length_1482_cov_20.177874	483	563	0	80	80	1.0000000
NODE_2359_length_1482_cov_20.177874	559	639	0	80	80	1.0000000
NODE_2359_length_1482_cov_20.177874	612	692	0	80	80	1.0000000
NODE_2360_length_1482_cov_13.644252	1000	1080	0	80	80	1.0000000
NODE_2360_length_1482_cov_13.644252	1053	1133	0	80	80	1.0000000
NODE_2361_length_1482_cov_6.157628	525	605	0	80	80	1.0000000
NODE_2361_length_1482_cov_6.157628	578	658	0	80	80	1.0000000
NODE_2361_length_1482_cov_6.157628	1306	1388	10	1	82	0.0121951
NODE_2361_length_1482_cov_6.157628	1306	1388	21	1	82	0.0121951
NODE_2361_length_1482_cov_6.157628	1306	1388	23	3	82	0.0365854
NODE_2361_length_1482_cov_6.157628	1306	1388	25	2	82	0.0243902
NODE_2361_length_1482_cov_6.157628	1306	1388	29	2	82	0.0243902
NODE_2361_length_1482_cov_6.157628	1306	1388	31	7	82	0.0853659
NODE_2361_length_1482_cov_6.157628	1306	1388	32	10	82	0.1219512
NODE_2361_length_1482_cov_6.157628	1306	1388	33	17	82	0.2073171
NODE_2361_length_1482_cov_6.157628	1306	1388	39	39	82	0.4756097
NODE_2364_length_1481_cov_19.238784	480	560	0	26	80	0.3250000
NODE_2364_length_1481_cov_19.238784	480	560	2	54	80	0.6750000
NODE_2364_length_1481_cov_19.238784	533	613	0	40	80	0.5000000
NODE_2364_length_1481_cov_19.238784	533	613	2	40	80	0.5000000
NODE_2365_length_1481_cov_18.139653	706	786	0	11	80	0.1375000
NODE_2365_length_1481_cov_18.139653	706	786	2	5	80	0.0625000
NODE_2365_length_1481_cov_18.139653	706	786	4	64	80	0.8000000
NODE_2365_length_1481_cov_18.139653	759	839	0	24	80	0.3000000
NODE_2365_length_1481_cov_18.139653	759	839	2	7	80	0.0875000
NODE_2365_length_1481_cov_18.139653	759	839	4	49	80	0.6125000
NODE_2367_length_1480_cov_27.552498	762	842	0	80	80	1.0000000
NODE_2367_length_1480_cov_27.552498	815	895	0	80	80	1.0000000
NODE_2367_length_1480_cov_27.552498	891	971	0	20	80	0.2500000
NODE_2367_length_1480_cov_27.552498	891	971	2	60	80	0.7500000
NODE_2367_length_1480_cov_27.552498	944	1024	2	80	80	1.0000000
NODE_2367_length_1480_cov_27.552498	1171	1222	4	2	51	0.0392157
NODE_2367_length_1480_cov_27.552498	1171	1222	6	9	51	0.1764706
NODE_2367_length_1480_cov_27.552498	1171	1222	12	3	51	0.0588235
NODE_2367_length_1480_cov_27.552498	1171	1222	14	4	51	0.0784314
NODE_2367_length_1480_cov_27.552498	1171	1222	20	3	51	0.0588235
NODE_2367_length_1480_cov_27.552498	1171	1222	25	7	51	0.1372549
NODE_2367_length_1480_cov_27.552498	1171	1222	27	11	51	0.2156863
NODE_2367_length_1480_cov_27.552498	1171	1222	29	1	51	0.0196078
NODE_2367_length_1480_cov_27.552498	1171	1222	33	7	51	0.1372549
NODE_2367_length_1480_cov_27.552498	1171	1222	35	4	51	0.0784314
NODE_2369_length_1480_cov_12.535844	466	546	0	80	80	1.0000000
NODE_2369_length_1480_cov_12.535844	519	599	0	80	80	1.0000000
NODE_2373_length_1479_cov_17.035507	708	788	0	80	80	1.0000000
NODE_2373_length_1479_cov_17.035507	761	841	0	80	80	1.0000000
NODE_2373_length_1479_cov_17.035507	837	917	0	80	80	1.0000000
NODE_2373_length_1479_cov_17.035507	890	970	0	80	80	1.0000000
NODE_2374_length_1479_cov_16.448551	908	988	0	80	80	1.0000000
NODE_2374_length_1479_cov_16.448551	961	1041	0	80	80	1.0000000
NODE_2375_length_1479_cov_5.285507	123	185	20	1	62	0.0161290
NODE_2375_length_1479_cov_5.285507	123	185	29	5	62	0.0806452
NODE_2375_length_1479_cov_5.285507	123	185	31	2	62	0.0322581
NODE_2375_length_1479_cov_5.285507	123	185	43	6	62	0.0967742
NODE_2375_length_1479_cov_5.285507	123	185	47	1	62	0.0161290
NODE_2375_length_1479_cov_5.285507	123	185	48	1	62	0.0161290
NODE_2375_length_1479_cov_5.285507	123	185	49	2	62	0.0322581
NODE_2375_length_1479_cov_5.285507	123	185	52	1	62	0.0161290
NODE_2375_length_1479_cov_5.285507	123	185	55	1	62	0.0161290
NODE_2375_length_1479_cov_5.285507	123	185	57	3	62	0.0483871
NODE_2375_length_1479_cov_5.285507	123	185	60	4	62	0.0645161
NODE_2375_length_1479_cov_5.285507	123	185	62	2	62	0.0322581
NODE_2375_length_1479_cov_5.285507	123	185	65	1	62	0.0161290
NODE_2375_length_1479_cov_5.285507	123	185	69	1	62	0.0161290
NODE_2375_length_1479_cov_5.285507	123	185	70	3	62	0.0483871
NODE_2375_length_1479_cov_5.285507	123	185	72	2	62	0.0322581
NODE_2375_length_1479_cov_5.285507	123	185	80	1	62	0.0161290
NODE_2375_length_1479_cov_5.285507	123	185	84	2	62	0.0322581
NODE_2375_length_1479_cov_5.285507	123	185	86	1	62	0.0161290
NODE_2375_length_1479_cov_5.285507	123	185	88	1	62	0.0161290
NODE_2375_length_1479_cov_5.285507	123	185	89	2	62	0.0322581
NODE_2375_length_1479_cov_5.285507	123	185	91	1	62	0.0161290
NODE_2375_length_1479_cov_5.285507	123	185	93	2	62	0.0322581
NODE_2375_length_1479_cov_5.285507	123	185	95	1	62	0.0161290
NODE_2375_length_1479_cov_5.285507	123	185	96	1	62	0.0161290
NODE_2375_length_1479_cov_5.285507	123	185	101	1	62	0.0161290
NODE_2375_length_1479_cov_5.285507	123	185	108	5	62	0.0806452
NODE_2375_length_1479_cov_5.285507	123	185	109	6	62	0.0967742
NODE_2375_length_1479_cov_5.285507	123	185	114	2	62	0.0322581
NODE_2376_length_1479_cov_2.018841	881	967	0	86	86	1.0000000
NODE_2377_length_1478_cov_32.050761	411	491	0	80	80	1.0000000
NODE_2377_length_1478_cov_32.050761	464	544	0	80	80	1.0000000
NODE_2377_length_1478_cov_32.050761	540	620	0	80	80	1.0000000
NODE_2377_length_1478_cov_32.050761	593	673	0	80	80	1.0000000
NODE_2378_length_1478_cov_27.414793	817	897	0	80	80	1.0000000
NODE_2378_length_1478_cov_27.414793	870	950	0	80	80	1.0000000
NODE_2379_length_1478_cov_23.472081	1212	1241	77	1	29	0.0344828
NODE_2379_length_1478_cov_23.472081	1212	1241	78	6	29	0.2068966
NODE_2379_length_1478_cov_23.472081	1212	1241	80	1	29	0.0344828
NODE_2379_length_1478_cov_23.472081	1212	1241	81	4	29	0.1379310
NODE_2379_length_1478_cov_23.472081	1212	1241	82	1	29	0.0344828
NODE_2379_length_1478_cov_23.472081	1212	1241	83	2	29	0.0689655
NODE_2379_length_1478_cov_23.472081	1212	1241	84	5	29	0.1724138
NODE_2379_length_1478_cov_23.472081	1212	1241	86	3	29	0.1034483
NODE_2379_length_1478_cov_23.472081	1212	1241	87	3	29	0.1034483
NODE_2379_length_1478_cov_23.472081	1212	1241	88	3	29	0.1034483
NODE_2380_length_1478_cov_10.746193	678	758	0	80	80	1.0000000
NODE_2380_length_1478_cov_10.746193	731	811	0	80	80	1.0000000
NODE_2380_length_1478_cov_10.746193	807	892	0	85	85	1.0000000
NODE_2380_length_1478_cov_10.746193	860	945	0	85	85	1.0000000
NODE_2384_length_1476_cov_6.522150	791	871	0	80	80	1.0000000
NODE_2384_length_1476_cov_6.522150	844	924	0	80	80	1.0000000
NODE_2392_length_1474_cov_11.209455	515	595	3	55	80	0.6875000
NODE_2392_length_1474_cov_11.209455	515	595	4	25	80	0.3125000
NODE_2392_length_1474_cov_11.209455	568	648	1	31	80	0.3875000
NODE_2392_length_1474_cov_11.209455	568	648	3	49	80	0.6125000
NODE_2397_length_1472_cov_22.159505	428	508	6	10	80	0.1250000
NODE_2397_length_1472_cov_22.159505	428	508	8	65	80	0.8125000
NODE_2397_length_1472_cov_22.159505	428	508	10	1	80	0.0125000
NODE_2397_length_1472_cov_22.159505	428	508	12	4	80	0.0500000
NODE_2397_length_1472_cov_22.159505	428	508	6	10	80	0.1250000
NODE_2397_length_1472_cov_22.159505	428	508	8	65	80	0.8125000
NODE_2397_length_1472_cov_22.159505	428	508	10	1	80	0.0125000
NODE_2397_length_1472_cov_22.159505	428	508	12	4	80	0.0500000
NODE_2397_length_1472_cov_22.159505	481	561	4	16	80	0.2000000
NODE_2397_length_1472_cov_22.159505	481	561	6	14	80	0.1750000
NODE_2397_length_1472_cov_22.159505	481	561	8	22	80	0.2750000
NODE_2397_length_1472_cov_22.159505	481	561	10	8	80	0.1000000
NODE_2397_length_1472_cov_22.159505	481	561	12	4	80	0.0500000
NODE_2397_length_1472_cov_22.159505	481	561	18	2	80	0.0250000
NODE_2397_length_1472_cov_22.159505	481	561	20	4	80	0.0500000
NODE_2397_length_1472_cov_22.159505	481	561	22	4	80	0.0500000
NODE_2397_length_1472_cov_22.159505	481	561	25	2	80	0.0250000
NODE_2397_length_1472_cov_22.159505	481	561	27	2	80	0.0250000
NODE_2397_length_1472_cov_22.159505	481	561	29	2	80	0.0250000
NODE_2397_length_1472_cov_22.159505	913	993	0	80	80	1.0000000
NODE_2397_length_1472_cov_22.159505	966	1046	0	80	80	1.0000000
NODE_2397_length_1472_cov_22.159505	1042	1122	0	80	80	1.0000000
NODE_2397_length_1472_cov_22.159505	1095	1175	0	80	80	1.0000000
NODE_2398_length_1472_cov_22.018208	523	590	0	67	67	1.0000000
NODE_2398_length_1472_cov_22.018208	563	643	0	80	80	1.0000000
NODE_2398_length_1472_cov_22.018208	639	719	0	80	80	1.0000000
NODE_2398_length_1472_cov_22.018208	692	772	0	55	80	0.6875000
NODE_2398_length_1472_cov_22.018208	692	772	3	25	80	0.3125000
NODE_2404_length_1470_cov_7.042305	5	57	20	9	52	0.1730769
NODE_2404_length_1470_cov_7.042305	5	57	24	6	52	0.1153846
NODE_2404_length_1470_cov_7.042305	5	57	25	1	52	0.0192308
NODE_2404_length_1470_cov_7.042305	5	57	26	36	52	0.6923077
NODE_2405_length_1470_cov_2.185266	199	245	4	46	46	1.0000000
NODE_2407_length_1469_cov_5.683942	834	914	0	80	80	1.0000000
NODE_2407_length_1469_cov_5.683942	887	967	0	80	80	1.0000000
NODE_2410_length_1467_cov_31.231725	1048	1131	0	83	83	1.0000000
NODE_2411_length_1467_cov_19.731725	485	565	0	80	80	1.0000000
NODE_2411_length_1467_cov_19.731725	538	618	0	80	80	1.0000000
NODE_2412_length_1467_cov_11.807749	180	242	7	4	62	0.0645161
NODE_2412_length_1467_cov_11.807749	180	242	9	2	62	0.0322581
NODE_2412_length_1467_cov_11.807749	180	242	11	5	62	0.0806452
NODE_2412_length_1467_cov_11.807749	180	242	13	3	62	0.0483871
NODE_2412_length_1467_cov_11.807749	180	242	15	2	62	0.0322581
NODE_2412_length_1467_cov_11.807749	180	242	17	46	62	0.7419355
NODE_2412_length_1467_cov_11.807749	264	293	7	3	29	0.1034483
NODE_2412_length_1467_cov_11.807749	264	293	9	3	29	0.1034483
NODE_2412_length_1467_cov_11.807749	264	293	11	8	29	0.2758621
NODE_2412_length_1467_cov_11.807749	264	293	13	3	29	0.1034483
NODE_2412_length_1467_cov_11.807749	264	293	15	12	29	0.4137931
NODE_2412_length_1467_cov_11.807749	930	1010	0	80	80	1.0000000
NODE_2412_length_1467_cov_11.807749	983	1063	0	80	80	1.0000000
NODE_2414_length_1466_cov_41.326993	664	744	0	80	80	1.0000000
NODE_2414_length_1466_cov_41.326993	717	797	0	80	80	1.0000000
NODE_2414_length_1466_cov_41.326993	793	873	0	80	80	1.0000000
NODE_2414_length_1466_cov_41.326993	846	926	0	80	80	1.0000000
NODE_2420_length_1464_cov_6.726740	137	204	4	12	67	0.1791045
NODE_2420_length_1464_cov_6.726740	137	204	6	20	67	0.2985075
NODE_2420_length_1464_cov_6.726740	137	204	10	35	67	0.5223880
NODE_2422_length_1464_cov_2.198535	1301	1363	5	7	62	0.1129032
NODE_2422_length_1464_cov_2.198535	1301	1363	6	1	62	0.0161290
NODE_2422_length_1464_cov_2.198535	1301	1363	7	8	62	0.1290323
NODE_2422_length_1464_cov_2.198535	1301	1363	13	3	62	0.0483871
NODE_2422_length_1464_cov_2.198535	1301	1363	15	2	62	0.0322581
NODE_2422_length_1464_cov_2.198535	1301	1363	16	8	62	0.1290323
NODE_2422_length_1464_cov_2.198535	1301	1363	20	1	62	0.0161290
NODE_2422_length_1464_cov_2.198535	1301	1363	22	1	62	0.0161290
NODE_2422_length_1464_cov_2.198535	1301	1363	24	2	62	0.0322581
NODE_2422_length_1464_cov_2.198535	1301	1363	26	5	62	0.0806452
NODE_2422_length_1464_cov_2.198535	1301	1363	28	24	62	0.3870968
NODE_2425_length_1463_cov_15.345308	314	394	5	70	80	0.8750000
NODE_2425_length_1463_cov_15.345308	314	394	9	1	80	0.0125000
NODE_2425_length_1463_cov_15.345308	314	394	10	9	80	0.1125000
NODE_2425_length_1463_cov_15.345308	367	447	0	51	80	0.6375000
NODE_2425_length_1463_cov_15.345308	367	447	5	29	80	0.3625000
NODE_2427_length_1462_cov_18.082172	418	498	0	80	80	1.0000000
NODE_2427_length_1462_cov_18.082172	471	551	0	80	80	1.0000000
NODE_2427_length_1462_cov_18.082172	1036	1116	0	80	80	1.0000000
NODE_2427_length_1462_cov_18.082172	1089	1169	0	59	80	0.7375000
NODE_2427_length_1462_cov_18.082172	1089	1169	2	21	80	0.2625000
NODE_2428_length_1462_cov_1.792370	1247	1319	0	72	72	1.0000000
NODE_2428_length_1462_cov_1.792370	1305	1374	0	69	69	1.0000000
NODE_2433_length_1460_cov_23.927994	852	932	17	55	80	0.6875000
NODE_2433_length_1460_cov_23.927994	852	932	22	17	80	0.2125000
NODE_2433_length_1460_cov_23.927994	852	932	23	8	80	0.1000000
NODE_2433_length_1460_cov_23.927994	905	985	0	3	80	0.0375000
NODE_2433_length_1460_cov_23.927994	905	985	7	1	80	0.0125000
NODE_2433_length_1460_cov_23.927994	905	985	9	3	80	0.0375000
NODE_2433_length_1460_cov_23.927994	905	985	17	14	80	0.1750000
NODE_2433_length_1460_cov_23.927994	905	985	18	2	80	0.0250000
NODE_2433_length_1460_cov_23.927994	905	985	22	17	80	0.2125000
NODE_2433_length_1460_cov_23.927994	905	985	23	40	80	0.5000000
NODE_2436_length_1459_cov_43.600000	535	615	0	80	80	1.0000000
NODE_2436_length_1459_cov_43.600000	588	668	0	80	80	1.0000000
NODE_2436_length_1459_cov_43.600000	664	744	0	80	80	1.0000000
NODE_2436_length_1459_cov_43.600000	717	797	0	80	80	1.0000000
NODE_2437_length_1459_cov_32.276471	865	945	0	77	80	0.9625000
NODE_2437_length_1459_cov_32.276471	865	945	2	3	80	0.0375000
NODE_2437_length_1459_cov_32.276471	918	998	0	24	80	0.3000000
NODE_2437_length_1459_cov_32.276471	918	998	2	56	80	0.7000000
NODE_2437_length_1459_cov_32.276471	994	1074	0	38	80	0.4750000
NODE_2437_length_1459_cov_32.276471	994	1074	2	42	80	0.5250000
NODE_2437_length_1459_cov_32.276471	1047	1127	0	80	80	1.0000000
NODE_2441_length_1458_cov_2.184695	1361	1441	0	80	80	1.0000000
NODE_2442_length_1457_cov_19.687040	834	914	0	80	80	1.0000000
NODE_2442_length_1457_cov_19.687040	887	967	0	80	80	1.0000000
NODE_2442_length_1457_cov_19.687040	963	1043	0	21	80	0.2625000
NODE_2442_length_1457_cov_19.687040	963	1043	6	59	80	0.7375000
NODE_2442_length_1457_cov_19.687040	1016	1096	0	18	80	0.2250000
NODE_2442_length_1457_cov_19.687040	1016	1096	6	62	80	0.7750000
NODE_2444_length_1457_cov_14.944772	754	834	0	14	80	0.1750000
NODE_2444_length_1457_cov_14.944772	754	834	2	66	80	0.8250000
NODE_2444_length_1457_cov_14.944772	807	887	0	67	80	0.8375000
NODE_2444_length_1457_cov_14.944772	807	887	2	13	80	0.1625000
NODE_2445_length_1457_cov_10.168630	827	907	0	80	80	1.0000000
NODE_2445_length_1457_cov_10.168630	880	960	0	80	80	1.0000000
NODE_2445_length_1457_cov_10.168630	956	1036	0	80	80	1.0000000
NODE_2445_length_1457_cov_10.168630	1009	1089	0	80	80	1.0000000
NODE_2448_length_1456_cov_13.675755	557	637	0	80	80	1.0000000
NODE_2448_length_1456_cov_13.675755	610	690	0	80	80	1.0000000
NODE_2449_length_1456_cov_11.109064	951	1031	0	80	80	1.0000000
NODE_2449_length_1456_cov_11.109064	1004	1084	0	80	80	1.0000000
NODE_2452_length_1456_cov_3.137067	374	410	5	5	36	0.1388889
NODE_2452_length_1456_cov_3.137067	374	410	8	3	36	0.0833333
NODE_2452_length_1456_cov_3.137067	374	410	9	7	36	0.1944444
NODE_2452_length_1456_cov_3.137067	374	410	10	21	36	0.5833333
NODE_2454_length_1456_cov_1.889462	35	99	0	63	64	0.9843750
NODE_2454_length_1456_cov_1.889462	35	99	2	1	64	0.0156250
NODE_2456_length_1455_cov_60.874631	369	449	0	80	80	1.0000000
NODE_2456_length_1455_cov_60.874631	422	502	0	80	80	1.0000000
NODE_2456_length_1455_cov_60.874631	498	578	0	80	80	1.0000000
NODE_2456_length_1455_cov_60.874631	551	631	0	80	80	1.0000000
NODE_2458_length_1455_cov_35.253687	615	695	0	80	80	1.0000000
NODE_2458_length_1455_cov_35.253687	668	748	0	33	80	0.4125000
NODE_2458_length_1455_cov_35.253687	668	748	2	47	80	0.5875000
NODE_2458_length_1455_cov_35.253687	744	824	0	47	80	0.5875000
NODE_2458_length_1455_cov_35.253687	744	824	2	33	80	0.4125000
NODE_2458_length_1455_cov_35.253687	797	877	0	80	80	1.0000000
NODE_2465_length_1452_cov_7.101256	976	1056	0	80	80	1.0000000
NODE_2465_length_1452_cov_7.101256	1029	1109	0	80	80	1.0000000
NODE_2465_length_1452_cov_7.101256	1105	1185	0	80	80	1.0000000
NODE_2465_length_1452_cov_7.101256	1158	1238	0	80	80	1.0000000
NODE_2470_length_1451_cov_23.880178	439	520	8	5	81	0.0617284
NODE_2470_length_1451_cov_23.880178	439	520	10	32	81	0.3950617
NODE_2470_length_1451_cov_23.880178	439	520	14	44	81	0.5432099
NODE_2470_length_1451_cov_23.880178	493	573	4	11	80	0.1375000
NODE_2470_length_1451_cov_23.880178	493	573	8	2	80	0.0250000
NODE_2470_length_1451_cov_23.880178	493	573	10	23	80	0.2875000
NODE_2470_length_1451_cov_23.880178	493	573	13	1	80	0.0125000
NODE_2470_length_1451_cov_23.880178	493	573	14	43	80	0.5375000
NODE_2471_length_1451_cov_16.249260	422	502	0	80	80	1.0000000
NODE_2471_length_1451_cov_16.249260	475	555	0	80	80	1.0000000
NODE_2472_length_1451_cov_8.663462	908	988	0	80	80	1.0000000
NODE_2472_length_1451_cov_8.663462	961	1040	0	79	79	1.0000000
NODE_2474_length_1451_cov_5.219675	897	977	0	20	80	0.2500000
NODE_2474_length_1451_cov_5.219675	897	977	4	60	80	0.7500000
NODE_2474_length_1451_cov_5.219675	950	1030	0	73	80	0.9125000
NODE_2474_length_1451_cov_5.219675	950	1030	4	7	80	0.0875000
NODE_2477_length_1450_cov_20.371577	611	691	0	80	80	1.0000000
NODE_2477_length_1450_cov_20.371577	664	744	0	80	80	1.0000000
NODE_2482_length_1449_cov_24.665926	432	512	0	80	80	1.0000000
NODE_2482_length_1449_cov_24.665926	485	565	0	80	80	1.0000000
NODE_2482_length_1449_cov_24.665926	561	643	0	82	82	1.0000000
NODE_2482_length_1449_cov_24.665926	616	696	0	80	80	1.0000000
NODE_2485_length_1448_cov_20.587102	904	984	0	80	80	1.0000000
NODE_2485_length_1448_cov_20.587102	957	1037	0	80	80	1.0000000
NODE_2487_length_1448_cov_8.693847	537	617	0	80	80	1.0000000
NODE_2487_length_1448_cov_8.693847	590	670	0	80	80	1.0000000
NODE_2488_length_1447_cov_21.391691	519	599	0	80	80	1.0000000
NODE_2488_length_1447_cov_21.391691	572	652	0	80	80	1.0000000
NODE_2488_length_1447_cov_21.391691	648	728	0	78	80	0.9750000
NODE_2488_length_1447_cov_21.391691	648	728	2	2	80	0.0250000
NODE_2488_length_1447_cov_21.391691	701	781	0	25	80	0.3125000
NODE_2488_length_1447_cov_21.391691	701	781	2	55	80	0.6875000
NODE_2491_length_1447_cov_2.262611	1268	1325	18	1	57	0.0175439
NODE_2491_length_1447_cov_2.262611	1268	1325	22	4	57	0.0701754
NODE_2491_length_1447_cov_2.262611	1268	1325	24	1	57	0.0175439
NODE_2491_length_1447_cov_2.262611	1268	1325	27	1	57	0.0175439
NODE_2491_length_1447_cov_2.262611	1268	1325	29	2	57	0.0350877
NODE_2491_length_1447_cov_2.262611	1268	1325	31	15	57	0.2631579
NODE_2491_length_1447_cov_2.262611	1268	1325	35	2	57	0.0350877
NODE_2491_length_1447_cov_2.262611	1268	1325	36	3	57	0.0526316
NODE_2491_length_1447_cov_2.262611	1268	1325	38	1	57	0.0175439
NODE_2491_length_1447_cov_2.262611	1268	1325	40	1	57	0.0175439
NODE_2491_length_1447_cov_2.262611	1268	1325	47	19	57	0.3333333
NODE_2491_length_1447_cov_2.262611	1268	1325	49	7	57	0.1228070
NODE_2491_length_1447_cov_2.262611	1321	1378	35	4	57	0.0701754
NODE_2491_length_1447_cov_2.262611	1321	1378	37	4	57	0.0701754
NODE_2491_length_1447_cov_2.262611	1321	1378	39	2	57	0.0350877
NODE_2491_length_1447_cov_2.262611	1321	1378	41	5	57	0.0877193
NODE_2491_length_1447_cov_2.262611	1321	1378	49	42	57	0.7368421
NODE_2494_length_1445_cov_22.052006	759	839	0	80	80	1.0000000
NODE_2494_length_1445_cov_22.052006	812	892	0	80	80	1.0000000
NODE_2494_length_1445_cov_22.052006	888	968	0	64	80	0.8000000
NODE_2494_length_1445_cov_22.052006	888	968	4	16	80	0.2000000
NODE_2494_length_1445_cov_22.052006	941	1021	0	11	80	0.1375000
NODE_2494_length_1445_cov_22.052006	941	1021	4	69	80	0.8625000
NODE_2495_length_1445_cov_13.378900	584	664	0	80	80	1.0000000
NODE_2495_length_1445_cov_13.378900	637	717	0	80	80	1.0000000
NODE_2501_length_1443_cov_7.628720	480	560	0	80	80	1.0000000
NODE_2501_length_1443_cov_7.628720	533	613	0	80	80	1.0000000
NODE_2501_length_1443_cov_7.628720	609	689	0	80	80	1.0000000
NODE_2501_length_1443_cov_7.628720	662	742	0	80	80	1.0000000
NODE_2502_length_1443_cov_4.843006	924	1004	0	54	80	0.6750000
NODE_2502_length_1443_cov_4.843006	924	1004	2	26	80	0.3250000
NODE_2502_length_1443_cov_4.843006	977	1057	0	5	80	0.0625000
NODE_2502_length_1443_cov_4.843006	977	1057	2	75	80	0.9375000
NODE_2508_length_1442_cov_24.551750	427	507	0	80	80	1.0000000
NODE_2508_length_1442_cov_24.551750	480	560	0	80	80	1.0000000
NODE_2508_length_1442_cov_24.551750	556	636	0	80	80	1.0000000
NODE_2508_length_1442_cov_24.551750	609	689	0	80	80	1.0000000
NODE_2509_length_1442_cov_24.032762	424	504	0	80	80	1.0000000
NODE_2509_length_1442_cov_24.032762	477	557	0	80	80	1.0000000
NODE_2511_length_1441_cov_16.528316	963	1043	2	80	80	1.0000000
NODE_2511_length_1441_cov_16.528316	1016	1096	0	9	80	0.1125000
NODE_2511_length_1441_cov_16.528316	1016	1096	2	71	80	0.8875000
NODE_2512_length_1441_cov_3.781669	80	156	0	76	76	1.0000000
NODE_2512_length_1441_cov_3.781669	129	209	0	80	80	1.0000000
NODE_2515_length_1440_cov_34.523490	446	526	0	34	80	0.4250000
NODE_2515_length_1440_cov_34.523490	446	526	8	7	80	0.0875000
NODE_2515_length_1440_cov_34.523490	446	526	16	39	80	0.4875000
NODE_2515_length_1440_cov_34.523490	499	576	16	77	77	1.0000000
NODE_2515_length_1440_cov_34.523490	576	654	0	17	78	0.2179487
NODE_2515_length_1440_cov_34.523490	576	654	8	7	78	0.0897436
NODE_2515_length_1440_cov_34.523490	576	654	16	54	78	0.6923077
NODE_2515_length_1440_cov_34.523490	627	707	0	70	80	0.8750000
NODE_2515_length_1440_cov_34.523490	627	707	8	7	80	0.0875000
NODE_2515_length_1440_cov_34.523490	627	707	16	3	80	0.0375000
NODE_2516_length_1440_cov_20.372110	776	856	0	14	80	0.1750000
NODE_2516_length_1440_cov_20.372110	776	856	1	60	80	0.7500000
NODE_2516_length_1440_cov_20.372110	776	856	2	6	80	0.0750000
NODE_2516_length_1440_cov_20.372110	829	909	1	21	80	0.2625000
NODE_2516_length_1440_cov_20.372110	829	909	2	59	80	0.7375000
NODE_2516_length_1440_cov_20.372110	905	985	1	46	80	0.5750000
NODE_2516_length_1440_cov_20.372110	905	985	2	34	80	0.4250000
NODE_2516_length_1440_cov_20.372110	958	1038	0	38	80	0.4750000
NODE_2516_length_1440_cov_20.372110	958	1038	1	42	80	0.5250000
NODE_2517_length_1440_cov_14.476510	586	615	6	29	29	1.0000000
NODE_2517_length_1440_cov_14.476510	666	695	2	29	29	1.0000000
NODE_2517_length_1440_cov_14.476510	1295	1359	102	1	64	0.0156250
NODE_2517_length_1440_cov_14.476510	1295	1359	119	1	64	0.0156250
NODE_2517_length_1440_cov_14.476510	1295	1359	120	2	64	0.0312500
NODE_2517_length_1440_cov_14.476510	1295	1359	128	4	64	0.0625000
NODE_2517_length_1440_cov_14.476510	1295	1359	130	7	64	0.1093750
NODE_2517_length_1440_cov_14.476510	1295	1359	132	1	64	0.0156250
NODE_2517_length_1440_cov_14.476510	1295	1359	134	4	64	0.0625000
NODE_2517_length_1440_cov_14.476510	1295	1359	136	7	64	0.1093750
NODE_2517_length_1440_cov_14.476510	1295	1359	138	4	64	0.0625000
NODE_2517_length_1440_cov_14.476510	1295	1359	140	3	64	0.0468750
NODE_2517_length_1440_cov_14.476510	1295	1359	141	5	64	0.0781250
NODE_2517_length_1440_cov_14.476510	1295	1359	142	25	64	0.3906250
NODE_2518_length_1440_cov_9.049217	384	464	0	54	80	0.6750000
NODE_2518_length_1440_cov_9.049217	384	464	1	26	80	0.3250000
NODE_2518_length_1440_cov_9.049217	437	517	0	1	80	0.0125000
NODE_2518_length_1440_cov_9.049217	437	517	1	38	80	0.4750000
NODE_2518_length_1440_cov_9.049217	437	517	2	41	80	0.5125000
NODE_2520_length_1439_cov_11.784328	898	978	0	80	80	1.0000000
NODE_2520_length_1439_cov_11.784328	951	1031	0	80	80	1.0000000
NODE_2525_length_1438_cov_41.481703	671	751	0	80	80	1.0000000
NODE_2525_length_1438_cov_41.481703	724	804	0	80	80	1.0000000
NODE_2529_length_1437_cov_14.449178	815	895	0	80	80	1.0000000
NODE_2529_length_1437_cov_14.449178	868	948	0	80	80	1.0000000
NODE_2529_length_1437_cov_14.449178	944	1024	0	80	80	1.0000000
NODE_2529_length_1437_cov_14.449178	997	1077	0	80	80	1.0000000
NODE_2532_length_1436_cov_96.256545	1145	1225	0	80	80	1.0000000
NODE_2532_length_1436_cov_96.256545	1198	1278	0	80	80	1.0000000
NODE_2532_length_1436_cov_96.256545	1274	1354	0	80	80	1.0000000
NODE_2532_length_1436_cov_96.256545	1327	1407	0	80	80	1.0000000
NODE_2536_length_1435_cov_21.468563	783	863	0	80	80	1.0000000
NODE_2536_length_1435_cov_21.468563	836	916	0	80	80	1.0000000
NODE_2536_length_1435_cov_21.468563	912	992	0	80	80	1.0000000
NODE_2536_length_1435_cov_21.468563	965	1045	0	80	80	1.0000000
NODE_2537_length_1435_cov_18.593563	1123	1203	5	15	80	0.1875000
NODE_2537_length_1435_cov_18.593563	1123	1203	6	6	80	0.0750000
NODE_2537_length_1435_cov_18.593563	1123	1203	7	1	80	0.0125000
NODE_2537_length_1435_cov_18.593563	1123	1203	9	3	80	0.0375000
NODE_2537_length_1435_cov_18.593563	1123	1203	10	17	80	0.2125000
NODE_2537_length_1435_cov_18.593563	1123	1203	12	4	80	0.0500000
NODE_2537_length_1435_cov_18.593563	1123	1203	14	12	80	0.1500000
NODE_2537_length_1435_cov_18.593563	1123	1203	16	22	80	0.2750000
NODE_2537_length_1435_cov_18.593563	1176	1256	0	13	80	0.1625000
NODE_2537_length_1435_cov_18.593563	1176	1256	1	13	80	0.1625000
NODE_2537_length_1435_cov_18.593563	1176	1256	2	9	80	0.1125000
NODE_2537_length_1435_cov_18.593563	1176	1256	3	4	80	0.0500000
NODE_2537_length_1435_cov_18.593563	1176	1256	5	29	80	0.3625000
NODE_2537_length_1435_cov_18.593563	1176	1256	6	6	80	0.0750000
NODE_2537_length_1435_cov_18.593563	1176	1256	7	1	80	0.0125000
NODE_2537_length_1435_cov_18.593563	1176	1256	9	3	80	0.0375000
NODE_2537_length_1435_cov_18.593563	1176	1256	10	2	80	0.0250000
NODE_2538_length_1435_cov_5.828593	299	379	0	80	80	1.0000000
NODE_2538_length_1435_cov_5.828593	352	432	0	80	80	1.0000000
NODE_2540_length_1434_cov_17.610487	1023	1103	0	80	80	1.0000000
NODE_2540_length_1434_cov_17.610487	1076	1156	0	80	80	1.0000000
NODE_2540_length_1434_cov_17.610487	1152	1232	0	80	80	1.0000000
NODE_2540_length_1434_cov_17.610487	1205	1285	0	80	80	1.0000000
NODE_2541_length_1434_cov_9.845693	846	926	0	54	80	0.6750000
NODE_2541_length_1434_cov_9.845693	846	926	4	26	80	0.3250000
NODE_2541_length_1434_cov_9.845693	899	978	0	1	79	0.0126582
NODE_2541_length_1434_cov_9.845693	899	978	4	78	79	0.9873418
NODE_2544_length_1433_cov_36.452774	538	618	0	80	80	1.0000000
NODE_2544_length_1433_cov_36.452774	591	671	0	80	80	1.0000000
NODE_2544_length_1433_cov_36.452774	667	747	0	80	80	1.0000000
NODE_2544_length_1433_cov_36.452774	720	800	0	80	80	1.0000000
NODE_2550_length_1431_cov_7.409159	513	593	0	80	80	1.0000000
NODE_2550_length_1431_cov_7.409159	566	646	0	80	80	1.0000000
NODE_2551_length_1431_cov_6.721471	1074	1154	0	65	80	0.8125000
NODE_2551_length_1431_cov_6.721471	1074	1154	1	15	80	0.1875000
NODE_2551_length_1431_cov_6.721471	1127	1207	0	12	80	0.1500000
NODE_2551_length_1431_cov_6.721471	1127	1207	1	68	80	0.8500000
NODE_2552_length_1430_cov_32.643877	753	833	0	80	80	1.0000000
NODE_2552_length_1430_cov_32.643877	806	886	0	80	80	1.0000000
NODE_2552_length_1430_cov_32.643877	882	962	0	26	80	0.3250000
NODE_2552_length_1430_cov_32.643877	882	962	7	1	80	0.0125000
NODE_2552_length_1430_cov_32.643877	882	962	8	35	80	0.4375000
NODE_2552_length_1430_cov_32.643877	882	962	11	18	80	0.2250000
NODE_2552_length_1430_cov_32.643877	935	1016	4	18	81	0.2222222
NODE_2552_length_1430_cov_32.643877	935	1016	8	9	81	0.1111111
NODE_2552_length_1430_cov_32.643877	935	1016	11	20	81	0.2469136
NODE_2552_length_1430_cov_32.643877	935	1016	12	34	81	0.4197531
NODE_2557_length_1428_cov_5.895410	340	416	0	52	76	0.6842105
NODE_2557_length_1428_cov_5.895410	340	416	6	24	76	0.3157895
NODE_2557_length_1428_cov_5.895410	393	476	0	5	83	0.0602410
NODE_2557_length_1428_cov_5.895410	393	476	6	78	83	0.9397590
NODE_2560_length_1427_cov_38.919428	707	787	0	6	80	0.0750000
NODE_2560_length_1427_cov_38.919428	707	787	1	74	80	0.9250000
NODE_2560_length_1427_cov_38.919428	760	840	1	80	80	1.0000000
NODE_2560_length_1427_cov_38.919428	836	916	0	43	80	0.5375000
NODE_2560_length_1427_cov_38.919428	836	916	1	37	80	0.4625000
NODE_2560_length_1427_cov_38.919428	889	969	0	80	80	1.0000000
NODE_2561_length_1427_cov_19.442771	808	888	0	80	80	1.0000000
NODE_2561_length_1427_cov_19.442771	861	941	0	80	80	1.0000000
NODE_2561_length_1427_cov_19.442771	937	1017	0	80	80	1.0000000
NODE_2561_length_1427_cov_19.442771	990	1070	0	80	80	1.0000000
NODE_2562_length_1427_cov_10.490964	728	808	0	80	80	1.0000000
NODE_2562_length_1427_cov_10.490964	781	861	0	80	80	1.0000000
NODE_2562_length_1427_cov_10.490964	857	937	0	80	80	1.0000000
NODE_2562_length_1427_cov_10.490964	910	990	0	80	80	1.0000000
NODE_2563_length_1427_cov_9.929217	646	726	0	80	80	1.0000000
NODE_2563_length_1427_cov_9.929217	699	779	0	80	80	1.0000000
NODE_2563_length_1427_cov_9.929217	775	855	0	80	80	1.0000000
NODE_2563_length_1427_cov_9.929217	828	908	0	80	80	1.0000000
NODE_2563_length_1427_cov_9.929217	1248	1324	0	4	76	0.0526316
NODE_2563_length_1427_cov_9.929217	1248	1324	2	18	76	0.2368421
NODE_2563_length_1427_cov_9.929217	1248	1324	4	37	76	0.4868421
NODE_2563_length_1427_cov_9.929217	1248	1324	6	12	76	0.1578947
NODE_2563_length_1427_cov_9.929217	1248	1324	8	5	76	0.0657895
NODE_2563_length_1427_cov_9.929217	1301	1376	4	6	75	0.0800000
NODE_2563_length_1427_cov_9.929217	1301	1376	6	52	75	0.6933333
NODE_2563_length_1427_cov_9.929217	1301	1376	8	17	75	0.2266667
NODE_2564_length_1427_cov_3.122741	1336	1399	2	11	63	0.1746032
NODE_2564_length_1427_cov_3.122741	1336	1399	4	52	63	0.8253968
NODE_2570_length_1426_cov_36.580256	422	502	0	16	80	0.2000000
NODE_2570_length_1426_cov_36.580256	422	502	8	64	80	0.8000000
NODE_2570_length_1426_cov_36.580256	475	555	0	69	80	0.8625000
NODE_2570_length_1426_cov_36.580256	475	555	8	11	80	0.1375000
NODE_2570_length_1426_cov_36.580256	551	631	0	47	80	0.5875000
NODE_2570_length_1426_cov_36.580256	551	631	22	1	80	0.0125000
NODE_2570_length_1426_cov_36.580256	551	631	24	32	80	0.4000000
NODE_2570_length_1426_cov_36.580256	604	684	24	80	80	1.0000000
NODE_2574_length_1425_cov_25.524133	561	641	0	27	80	0.3375000
NODE_2574_length_1425_cov_25.524133	561	641	15	1	80	0.0125000
NODE_2574_length_1425_cov_25.524133	561	641	16	52	80	0.6500000
NODE_2574_length_1425_cov_25.524133	614	694	0	10	80	0.1250000
NODE_2574_length_1425_cov_25.524133	614	694	15	3	80	0.0375000
NODE_2574_length_1425_cov_25.524133	614	694	16	67	80	0.8375000
NODE_2575_length_1425_cov_10.175716	361	441	0	80	80	1.0000000
NODE_2575_length_1425_cov_10.175716	414	494	0	80	80	1.0000000
NODE_2587_length_1423_cov_31.158610	862	942	0	80	80	1.0000000
NODE_2587_length_1423_cov_31.158610	915	995	0	80	80	1.0000000
NODE_2588_length_1423_cov_30.731873	764	844	0	7	80	0.0875000
NODE_2588_length_1423_cov_30.731873	764	844	2	73	80	0.9125000
NODE_2588_length_1423_cov_30.731873	817	897	2	80	80	1.0000000
NODE_2596_length_1421_cov_8.285930	136	212	155	1	76	0.0131579
NODE_2596_length_1421_cov_8.285930	136	212	157	1	76	0.0131579
NODE_2596_length_1421_cov_8.285930	136	212	159	4	76	0.0526316
NODE_2596_length_1421_cov_8.285930	136	212	161	1	76	0.0131579
NODE_2596_length_1421_cov_8.285930	136	212	164	1	76	0.0131579
NODE_2596_length_1421_cov_8.285930	136	212	165	2	76	0.0263158
NODE_2596_length_1421_cov_8.285930	136	212	166	5	76	0.0657895
NODE_2596_length_1421_cov_8.285930	136	212	168	4	76	0.0526316
NODE_2596_length_1421_cov_8.285930	136	212	169	1	76	0.0131579
NODE_2596_length_1421_cov_8.285930	136	212	171	2	76	0.0263158
NODE_2596_length_1421_cov_8.285930	136	212	177	1	76	0.0131579
NODE_2596_length_1421_cov_8.285930	136	212	180	1	76	0.0131579
NODE_2596_length_1421_cov_8.285930	136	212	181	1	76	0.0131579
NODE_2596_length_1421_cov_8.285930	136	212	184	2	76	0.0263158
NODE_2596_length_1421_cov_8.285930	136	212	186	1	76	0.0131579
NODE_2596_length_1421_cov_8.285930	136	212	187	1	76	0.0131579
NODE_2596_length_1421_cov_8.285930	136	212	195	2	76	0.0263158
NODE_2596_length_1421_cov_8.285930	136	212	201	1	76	0.0131579
NODE_2596_length_1421_cov_8.285930	136	212	223	1	76	0.0131579
NODE_2596_length_1421_cov_8.285930	136	212	234	1	76	0.0131579
NODE_2596_length_1421_cov_8.285930	136	212	239	3	76	0.0394737
NODE_2596_length_1421_cov_8.285930	136	212	242	2	76	0.0263158
NODE_2596_length_1421_cov_8.285930	136	212	244	2	76	0.0263158
NODE_2596_length_1421_cov_8.285930	136	212	246	1	76	0.0131579
NODE_2596_length_1421_cov_8.285930	136	212	250	1	76	0.0131579
NODE_2596_length_1421_cov_8.285930	136	212	257	1	76	0.0131579
NODE_2596_length_1421_cov_8.285930	136	212	261	1	76	0.0131579
NODE_2596_length_1421_cov_8.285930	136	212	263	1	76	0.0131579
NODE_2596_length_1421_cov_8.285930	136	212	266	1	76	0.0131579
NODE_2596_length_1421_cov_8.285930	136	212	275	1	76	0.0131579
NODE_2596_length_1421_cov_8.285930	136	212	277	1	76	0.0131579
NODE_2596_length_1421_cov_8.285930	136	212	289	1	76	0.0131579
NODE_2596_length_1421_cov_8.285930	136	212	293	1	76	0.0131579
NODE_2596_length_1421_cov_8.285930	136	212	296	1	76	0.0131579
NODE_2596_length_1421_cov_8.285930	136	212	297	1	76	0.0131579
NODE_2596_length_1421_cov_8.285930	136	212	298	1	76	0.0131579
NODE_2596_length_1421_cov_8.285930	136	212	300	2	76	0.0263158
NODE_2596_length_1421_cov_8.285930	136	212	301	1	76	0.0131579
NODE_2596_length_1421_cov_8.285930	136	212	302	1	76	0.0131579
NODE_2596_length_1421_cov_8.285930	136	212	305	1	76	0.0131579
NODE_2596_length_1421_cov_8.285930	136	212	307	1	76	0.0131579
NODE_2596_length_1421_cov_8.285930	136	212	308	6	76	0.0789474
NODE_2596_length_1421_cov_8.285930	136	212	309	1	76	0.0131579
NODE_2596_length_1421_cov_8.285930	136	212	310	3	76	0.0394737
NODE_2596_length_1421_cov_8.285930	136	212	311	2	76	0.0263158
NODE_2596_length_1421_cov_8.285930	136	212	312	2	76	0.0263158
NODE_2596_length_1421_cov_8.285930	136	212	314	1	76	0.0131579
NODE_2596_length_1421_cov_8.285930	136	212	316	1	76	0.0131579
NODE_2598_length_1421_cov_2.574130	22	102	2	80	80	1.0000000
NODE_2598_length_1421_cov_2.574130	75	132	0	22	57	0.3859649
NODE_2598_length_1421_cov_2.574130	75	132	2	35	57	0.6140351
NODE_2599_length_1420_cov_256.442846	60	140	12	12	80	0.1500000
NODE_2599_length_1420_cov_256.442846	60	140	13	4	80	0.0500000
NODE_2599_length_1420_cov_256.442846	60	140	15	19	80	0.2375000
NODE_2599_length_1420_cov_256.442846	60	140	18	22	80	0.2750000
NODE_2599_length_1420_cov_256.442846	60	140	19	9	80	0.1125000
NODE_2599_length_1420_cov_256.442846	60	140	22	14	80	0.1750000
NODE_2599_length_1420_cov_256.442846	1294	1360	0	10	66	0.1515152
NODE_2599_length_1420_cov_256.442846	1294	1360	2	56	66	0.8484849
NODE_2600_length_1420_cov_7.547313	628	708	0	25	80	0.3125000
NODE_2600_length_1420_cov_7.547313	628	708	2	55	80	0.6875000
NODE_2600_length_1420_cov_7.547313	681	761	0	35	80	0.4375000
NODE_2600_length_1420_cov_7.547313	681	761	2	45	80	0.5625000
NODE_2602_length_1420_cov_2.051476	972	1039	2	34	67	0.5074627
NODE_2602_length_1420_cov_2.051476	972	1039	4	33	67	0.4925373
NODE_2604_length_1419_cov_46.997727	1230	1305	0	30	75	0.4000000
NODE_2604_length_1419_cov_46.997727	1230	1305	4	45	75	0.6000000
NODE_2604_length_1419_cov_46.997727	1278	1332	4	54	54	1.0000000
NODE_2609_length_1418_cov_11.373010	432	512	0	80	80	1.0000000
NODE_2609_length_1418_cov_11.373010	485	556	0	71	71	1.0000000
NODE_2615_length_1417_cov_12.477997	354	399	0	45	45	1.0000000
NODE_2616_length_1417_cov_11.120637	794	874	0	80	80	1.0000000
NODE_2616_length_1417_cov_11.120637	847	927	0	80	80	1.0000000
NODE_2625_length_1415_cov_51.375380	423	503	0	80	80	1.0000000
NODE_2625_length_1415_cov_51.375380	476	556	0	77	80	0.9625000
NODE_2625_length_1415_cov_51.375380	476	556	2	3	80	0.0375000
NODE_2625_length_1415_cov_51.375380	552	632	0	1	80	0.0125000
NODE_2625_length_1415_cov_51.375380	552	632	2	3	80	0.0375000
NODE_2625_length_1415_cov_51.375380	552	632	4	2	80	0.0250000
NODE_2625_length_1415_cov_51.375380	552	632	5	1	80	0.0125000
NODE_2625_length_1415_cov_51.375380	552	632	7	1	80	0.0125000
NODE_2625_length_1415_cov_51.375380	552	632	8	72	80	0.9000000
NODE_2625_length_1415_cov_51.375380	605	683	0	49	78	0.6282051
NODE_2625_length_1415_cov_51.375380	605	683	4	4	78	0.0512821
NODE_2625_length_1415_cov_51.375380	605	683	8	25	78	0.3205128
NODE_2626_length_1415_cov_38.272036	513	593	0	80	80	1.0000000
NODE_2626_length_1415_cov_38.272036	566	646	0	80	80	1.0000000
NODE_2627_length_1415_cov_17.232523	642	722	0	80	80	1.0000000
NODE_2627_length_1415_cov_17.232523	695	775	0	80	80	1.0000000
NODE_2629_length_1414_cov_5.307985	1026	1106	0	80	80	1.0000000
NODE_2629_length_1414_cov_5.307985	1079	1159	0	80	80	1.0000000
NODE_2637_length_1412_cov_17.723534	875	955	0	80	80	1.0000000
NODE_2637_length_1412_cov_17.723534	928	1008	0	80	80	1.0000000
NODE_2641_length_1411_cov_34.004573	516	596	0	80	80	1.0000000
NODE_2641_length_1411_cov_34.004573	569	649	0	80	80	1.0000000
NODE_2641_length_1411_cov_34.004573	645	725	0	80	80	1.0000000
NODE_2641_length_1411_cov_34.004573	698	778	0	80	80	1.0000000
NODE_2643_length_1409_cov_25.380153	828	908	0	80	80	1.0000000
NODE_2643_length_1409_cov_25.380153	881	961	0	80	80	1.0000000
NODE_2644_length_1409_cov_13.028244	349	405	0	56	56	1.0000000
NODE_2644_length_1409_cov_13.028244	416	482	0	66	66	1.0000000
NODE_2648_length_1408_cov_6.261268	492	572	0	80	80	1.0000000
NODE_2648_length_1408_cov_6.261268	545	625	0	80	80	1.0000000
NODE_2652_length_1407_cov_27.711009	772	852	0	8	80	0.1000000
NODE_2652_length_1407_cov_27.711009	772	852	2	72	80	0.9000000
NODE_2652_length_1407_cov_27.711009	825	905	0	61	80	0.7625000
NODE_2652_length_1407_cov_27.711009	825	905	2	19	80	0.2375000
NODE_2653_length_1407_cov_24.387615	586	666	0	80	80	1.0000000
NODE_2653_length_1407_cov_24.387615	639	719	0	63	80	0.7875000
NODE_2653_length_1407_cov_24.387615	639	719	2	17	80	0.2125000
NODE_2653_length_1407_cov_24.387615	715	795	0	4	80	0.0500000
NODE_2653_length_1407_cov_24.387615	715	795	2	76	80	0.9500000
NODE_2653_length_1407_cov_24.387615	768	848	0	57	80	0.7125000
NODE_2653_length_1407_cov_24.387615	768	848	2	23	80	0.2875000
NODE_2654_length_1407_cov_19.022936	551	629	0	78	78	1.0000000
NODE_2654_length_1407_cov_19.022936	602	665	0	63	63	1.0000000
NODE_2655_length_1407_cov_11.266820	813	893	0	80	80	1.0000000
NODE_2655_length_1407_cov_11.266820	866	946	0	80	80	1.0000000
NODE_2655_length_1407_cov_11.266820	942	1022	0	80	80	1.0000000
NODE_2655_length_1407_cov_11.266820	995	1075	0	80	80	1.0000000
NODE_2657_length_1406_cov_7.247896	761	841	0	80	80	1.0000000
NODE_2657_length_1406_cov_7.247896	814	894	0	80	80	1.0000000
NODE_2659_length_1404_cov_23.406130	826	906	0	80	80	1.0000000
NODE_2659_length_1404_cov_23.406130	879	959	0	80	80	1.0000000
NODE_2659_length_1404_cov_23.406130	955	1035	0	80	80	1.0000000
NODE_2659_length_1404_cov_23.406130	1008	1088	0	80	80	1.0000000
NODE_2666_length_1403_cov_14.331288	325	405	0	80	80	1.0000000
NODE_2666_length_1403_cov_14.331288	378	458	0	80	80	1.0000000
NODE_2666_length_1403_cov_14.331288	454	534	0	80	80	1.0000000
NODE_2666_length_1403_cov_14.331288	454	534	0	80	80	1.0000000
NODE_2666_length_1403_cov_14.331288	454	524	0	70	70	1.0000000
NODE_2666_length_1403_cov_14.331288	507	587	0	79	80	0.9875000
NODE_2666_length_1403_cov_14.331288	507	587	1	1	80	0.0125000
NODE_2666_length_1403_cov_14.331288	507	579	0	72	72	1.0000000
NODE_2668_length_1402_cov_29.095165	610	690	4	77	80	0.9625000
NODE_2668_length_1402_cov_29.095165	610	690	5	3	80	0.0375000
NODE_2668_length_1402_cov_29.095165	663	743	1	15	80	0.1875000
NODE_2668_length_1402_cov_29.095165	663	743	4	24	80	0.3000000
NODE_2668_length_1402_cov_29.095165	663	743	5	41	80	0.5125000
NODE_2669_length_1402_cov_23.411358	528	608	0	66	80	0.8250000
NODE_2669_length_1402_cov_23.411358	528	608	2	14	80	0.1750000
NODE_2669_length_1402_cov_23.411358	581	661	0	13	80	0.1625000
NODE_2669_length_1402_cov_23.411358	581	661	2	14	80	0.1750000
NODE_2669_length_1402_cov_23.411358	581	661	4	53	80	0.6625000
NODE_2669_length_1402_cov_23.411358	657	737	0	8	80	0.1000000
NODE_2669_length_1402_cov_23.411358	657	737	2	28	80	0.3500000
NODE_2669_length_1402_cov_23.411358	657	737	4	44	80	0.5500000
NODE_2669_length_1402_cov_23.411358	710	790	0	61	80	0.7625000
NODE_2669_length_1402_cov_23.411358	710	790	2	19	80	0.2375000
NODE_2670_length_1402_cov_11.732924	661	741	0	80	80	1.0000000
NODE_2670_length_1402_cov_11.732924	714	794	0	80	80	1.0000000
NODE_2671_length_1402_cov_9.929394	766	846	0	80	80	1.0000000
NODE_2671_length_1402_cov_9.929394	819	899	0	80	80	1.0000000
NODE_2677_length_1401_cov_35.754992	825	905	0	13	80	0.1625000
NODE_2677_length_1401_cov_35.754992	825	905	4	67	80	0.8375000
NODE_2677_length_1401_cov_35.754992	878	958	0	66	80	0.8250000
NODE_2677_length_1401_cov_35.754992	878	958	4	14	80	0.1750000
NODE_2678_length_1401_cov_10.811828	539	619	0	80	80	1.0000000
NODE_2678_length_1401_cov_10.811828	592	672	0	80	80	1.0000000
NODE_2679_length_1401_cov_5.438556	241	321	0	71	80	0.8875000
NODE_2679_length_1401_cov_5.438556	241	321	2	9	80	0.1125000
NODE_2679_length_1401_cov_5.438556	294	374	0	18	80	0.2250000
NODE_2679_length_1401_cov_5.438556	294	374	2	62	80	0.7750000
NODE_2683_length_1400_cov_16.680246	813	893	6	80	80	1.0000000
NODE_2683_length_1400_cov_16.680246	866	946	0	23	80	0.2875000
NODE_2683_length_1400_cov_16.680246	866	946	6	57	80	0.7125000
NODE_2684_length_1400_cov_8.166795	53	133	0	20	80	0.2500000
NODE_2684_length_1400_cov_8.166795	53	133	3	1	80	0.0125000
NODE_2684_length_1400_cov_8.166795	53	133	4	59	80	0.7375000
NODE_2684_length_1400_cov_8.166795	106	186	0	73	80	0.9125000
NODE_2684_length_1400_cov_8.166795	106	186	3	1	80	0.0125000
NODE_2684_length_1400_cov_8.166795	106	186	4	6	80	0.0750000
NODE_2694_length_1397_cov_25.549307	869	918	5	3	49	0.0612245
NODE_2694_length_1397_cov_25.549307	869	918	15	1	49	0.0204082
NODE_2694_length_1397_cov_25.549307	869	918	17	45	49	0.9183673
NODE_2694_length_1397_cov_25.549307	891	971	4	16	80	0.2000000
NODE_2694_length_1397_cov_25.549307	891	971	15	20	80	0.2500000
NODE_2694_length_1397_cov_25.549307	891	971	16	18	80	0.2250000
NODE_2694_length_1397_cov_25.549307	891	971	17	26	80	0.3250000
NODE_2695_length_1397_cov_14.395223	672	752	0	80	80	1.0000000
NODE_2695_length_1397_cov_14.395223	725	805	0	80	80	1.0000000
NODE_2695_length_1397_cov_14.395223	801	881	0	80	80	1.0000000
NODE_2695_length_1397_cov_14.395223	854	934	0	80	80	1.0000000
NODE_2699_length_1396_cov_21.656130	825	905	0	42	80	0.5250000
NODE_2699_length_1396_cov_21.656130	825	905	2	38	80	0.4750000
NODE_2699_length_1396_cov_21.656130	878	958	0	80	80	1.0000000
NODE_2700_length_1396_cov_18.108712	560	640	0	17	80	0.2125000
NODE_2700_length_1396_cov_18.108712	560	640	3	2	80	0.0250000
NODE_2700_length_1396_cov_18.108712	560	640	4	61	80	0.7625000
NODE_2700_length_1396_cov_18.108712	613	693	0	70	80	0.8750000
NODE_2700_length_1396_cov_18.108712	613	693	3	2	80	0.0250000
NODE_2700_length_1396_cov_18.108712	613	693	4	8	80	0.1000000
NODE_2701_length_1396_cov_16.208944	136	198	9	32	62	0.5161290
NODE_2701_length_1396_cov_16.208944	136	198	11	1	62	0.0161290
NODE_2701_length_1396_cov_16.208944	136	198	13	3	62	0.0483871
NODE_2701_length_1396_cov_16.208944	136	198	16	7	62	0.1129032
NODE_2701_length_1396_cov_16.208944	136	198	18	19	62	0.3064516
NODE_2701_length_1396_cov_16.208944	848	928	0	17	80	0.2125000
NODE_2701_length_1396_cov_16.208944	848	928	2	63	80	0.7875000
NODE_2701_length_1396_cov_16.208944	901	981	0	12	80	0.1500000
NODE_2701_length_1396_cov_16.208944	901	981	2	66	80	0.8250000
NODE_2701_length_1396_cov_16.208944	901	981	8	2	80	0.0250000
NODE_2701_length_1396_cov_16.208944	977	1057	0	2	80	0.0250000
NODE_2701_length_1396_cov_16.208944	977	1057	8	78	80	0.9750000
NODE_2701_length_1396_cov_16.208944	1030	1110	0	26	80	0.3250000
NODE_2701_length_1396_cov_16.208944	1030	1110	7	1	80	0.0125000
NODE_2701_length_1396_cov_16.208944	1030	1110	8	53	80	0.6625000
NODE_2702_length_1396_cov_9.196608	428	508	0	80	80	1.0000000
NODE_2702_length_1396_cov_9.196608	481	561	0	80	80	1.0000000
NODE_2712_length_1394_cov_29.602317	349	415	0	1	66	0.0151515
NODE_2712_length_1394_cov_29.602317	349	415	5	1	66	0.0151515
NODE_2712_length_1394_cov_29.602317	349	415	8	11	66	0.1666667
NODE_2712_length_1394_cov_29.602317	349	415	17	40	66	0.6060606
NODE_2712_length_1394_cov_29.602317	349	415	19	2	66	0.0303030
NODE_2712_length_1394_cov_29.602317	349	415	20	11	66	0.1666667
NODE_2712_length_1394_cov_29.602317	349	416	0	2	67	0.0298507
NODE_2712_length_1394_cov_29.602317	349	416	5	1	67	0.0149254
NODE_2712_length_1394_cov_29.602317	349	416	8	11	67	0.1641791
NODE_2712_length_1394_cov_29.602317	349	416	17	40	67	0.5970149
NODE_2712_length_1394_cov_29.602317	349	416	19	2	67	0.0298507
NODE_2712_length_1394_cov_29.602317	349	416	20	11	67	0.1641791
NODE_2712_length_1394_cov_29.602317	1117	1197	0	80	80	1.0000000
NODE_2712_length_1394_cov_29.602317	1170	1250	0	80	80	1.0000000
NODE_2713_length_1394_cov_6.291892	313	393	0	80	80	1.0000000
NODE_2713_length_1394_cov_6.291892	366	446	0	80	80	1.0000000
NODE_2716_length_1393_cov_14.635240	1286	1339	12	31	53	0.5849057
NODE_2716_length_1393_cov_14.635240	1286	1339	14	22	53	0.4150943
NODE_2717_length_1393_cov_12.032457	737	817	0	80	80	1.0000000
NODE_2717_length_1393_cov_12.032457	790	870	0	80	80	1.0000000
NODE_2720_length_1392_cov_5.898685	270	350	0	80	80	1.0000000
NODE_2720_length_1392_cov_5.898685	323	399	0	76	76	1.0000000
NODE_2723_length_1391_cov_35.921827	415	495	0	80	80	1.0000000
NODE_2723_length_1391_cov_35.921827	468	548	0	80	80	1.0000000
NODE_2723_length_1391_cov_35.921827	544	624	0	80	80	1.0000000
NODE_2723_length_1391_cov_35.921827	597	677	0	80	80	1.0000000
NODE_2729_length_1390_cov_16.326878	550	630	0	9	80	0.1125000
NODE_2729_length_1390_cov_16.326878	550	630	2	71	80	0.8875000
NODE_2729_length_1390_cov_16.326878	603	683	0	50	80	0.6250000
NODE_2729_length_1390_cov_16.326878	603	683	2	30	80	0.3750000
NODE_2731_length_1389_cov_29.772093	780	860	0	42	80	0.5250000
NODE_2731_length_1389_cov_29.772093	780	860	6	38	80	0.4750000
NODE_2731_length_1389_cov_29.772093	833	913	6	80	80	1.0000000
NODE_2732_length_1389_cov_12.858140	821	901	0	16	80	0.2000000
NODE_2732_length_1389_cov_12.858140	821	901	2	64	80	0.8000000
NODE_2732_length_1389_cov_12.858140	874	954	0	43	80	0.5375000
NODE_2732_length_1389_cov_12.858140	874	954	2	37	80	0.4625000
NODE_2735_length_1388_cov_14.641583	529	610	0	81	81	1.0000000
NODE_2735_length_1388_cov_14.641583	583	660	0	77	77	1.0000000
NODE_2736_length_1388_cov_5.168348	427	499	24	6	72	0.0833333
NODE_2736_length_1388_cov_5.168348	427	499	25	2	72	0.0277778
NODE_2736_length_1388_cov_5.168348	427	499	26	1	72	0.0138889
NODE_2736_length_1388_cov_5.168348	427	499	27	1	72	0.0138889
NODE_2736_length_1388_cov_5.168348	427	499	28	25	72	0.3472222
NODE_2736_length_1388_cov_5.168348	427	499	29	9	72	0.1250000
NODE_2736_length_1388_cov_5.168348	427	499	30	28	72	0.3888889
NODE_2742_length_1386_cov_55.384615	559	639	3	9	80	0.1125000
NODE_2742_length_1386_cov_55.384615	559	639	5	35	80	0.4375000
NODE_2742_length_1386_cov_55.384615	559	639	6	36	80	0.4500000
NODE_2742_length_1386_cov_55.384615	612	692	3	5	80	0.0625000
NODE_2742_length_1386_cov_55.384615	612	692	6	75	80	0.9375000
NODE_2742_length_1386_cov_55.384615	688	768	0	35	80	0.4375000
NODE_2742_length_1386_cov_55.384615	688	768	2	15	80	0.1875000
NODE_2742_length_1386_cov_55.384615	688	768	3	30	80	0.3750000
NODE_2742_length_1386_cov_55.384615	741	821	0	18	80	0.2250000
NODE_2742_length_1386_cov_55.384615	741	821	2	62	80	0.7750000
NODE_2744_length_1386_cov_13.181041	549	629	0	80	80	1.0000000
NODE_2744_length_1386_cov_13.181041	602	682	0	80	80	1.0000000
NODE_2748_length_1385_cov_41.636081	968	1048	0	80	80	1.0000000
NODE_2748_length_1385_cov_41.636081	1021	1101	0	80	80	1.0000000
NODE_2749_length_1385_cov_38.877138	707	787	0	38	80	0.4750000
NODE_2749_length_1385_cov_38.877138	707	787	1	42	80	0.5250000
NODE_2749_length_1385_cov_38.877138	760	840	0	22	80	0.2750000
NODE_2749_length_1385_cov_38.877138	760	840	1	58	80	0.7250000
NODE_2749_length_1385_cov_38.877138	836	916	1	80	80	1.0000000
NODE_2749_length_1385_cov_38.877138	889	969	0	37	80	0.4625000
NODE_2749_length_1385_cov_38.877138	889	969	1	43	80	0.5375000
NODE_2751_length_1385_cov_4.608865	844	904	0	22	60	0.3666667
NODE_2751_length_1385_cov_4.608865	844	904	2	38	60	0.6333333
NODE_2758_length_1384_cov_10.574319	865	922	0	57	57	1.0000000
NODE_2758_length_1384_cov_10.574319	933	1013	0	80	80	1.0000000
NODE_2758_length_1384_cov_10.574319	986	1066	0	80	80	1.0000000
NODE_2759_length_1383_cov_10.710280	414	493	2	79	79	1.0000000
NODE_2759_length_1383_cov_10.710280	466	546	2	80	80	1.0000000
NODE_2763_length_1382_cov_12.521434	837	917	0	1	80	0.0125000
NODE_2763_length_1382_cov_12.521434	837	917	1	67	80	0.8375000
NODE_2763_length_1382_cov_12.521434	837	917	2	12	80	0.1500000
NODE_2763_length_1382_cov_12.521434	890	970	0	54	80	0.6750000
NODE_2763_length_1382_cov_12.521434	890	970	1	26	80	0.3250000
NODE_2764_length_1382_cov_5.074045	1028	1108	0	80	80	1.0000000
NODE_2764_length_1382_cov_5.074045	1081	1161	0	80	80	1.0000000
NODE_2771_length_1381_cov_7.796412	307	387	0	80	80	1.0000000
NODE_2771_length_1381_cov_7.796412	360	440	0	80	80	1.0000000
NODE_2775_length_1380_cov_12.804059	835	915	0	80	80	1.0000000
NODE_2775_length_1380_cov_12.804059	888	968	0	80	80	1.0000000
NODE_2782_length_1378_cov_25.362002	368	448	0	80	80	1.0000000
NODE_2782_length_1378_cov_25.362002	421	501	0	80	80	1.0000000
NODE_2782_length_1378_cov_25.362002	497	577	0	80	80	1.0000000
NODE_2782_length_1378_cov_25.362002	550	630	0	80	80	1.0000000
NODE_2783_length_1378_cov_20.508210	318	338	6	9	20	0.4500000
NODE_2783_length_1378_cov_20.508210	318	338	8	9	20	0.4500000
NODE_2783_length_1378_cov_20.508210	318	338	10	1	20	0.0500000
NODE_2783_length_1378_cov_20.508210	318	338	11	1	20	0.0500000
NODE_2783_length_1378_cov_20.508210	318	391	6	9	73	0.1232877
NODE_2783_length_1378_cov_20.508210	318	391	8	9	73	0.1232877
NODE_2783_length_1378_cov_20.508210	318	391	10	1	73	0.0136986
NODE_2783_length_1378_cov_20.508210	318	391	11	10	73	0.1369863
NODE_2783_length_1378_cov_20.508210	318	391	13	6	73	0.0821918
NODE_2783_length_1378_cov_20.508210	318	391	14	8	73	0.1095890
NODE_2783_length_1378_cov_20.508210	318	391	16	7	73	0.0958904
NODE_2783_length_1378_cov_20.508210	318	391	18	4	73	0.0547945
NODE_2783_length_1378_cov_20.508210	318	391	20	9	73	0.1232877
NODE_2783_length_1378_cov_20.508210	318	391	22	1	73	0.0136986
NODE_2783_length_1378_cov_20.508210	318	391	24	9	73	0.1232877
NODE_2785_length_1377_cov_103.832551	1259	1299	215	3	40	0.0750000
NODE_2785_length_1377_cov_103.832551	1259	1299	217	4	40	0.1000000
NODE_2785_length_1377_cov_103.832551	1259	1299	221	2	40	0.0500000
NODE_2785_length_1377_cov_103.832551	1259	1299	229	1	40	0.0250000
NODE_2785_length_1377_cov_103.832551	1259	1299	231	2	40	0.0500000
NODE_2785_length_1377_cov_103.832551	1259	1299	235	1	40	0.0250000
NODE_2785_length_1377_cov_103.832551	1259	1299	238	5	40	0.1250000
NODE_2785_length_1377_cov_103.832551	1259	1299	242	2	40	0.0500000
NODE_2785_length_1377_cov_103.832551	1259	1299	244	1	40	0.0250000
NODE_2785_length_1377_cov_103.832551	1259	1299	247	3	40	0.0750000
NODE_2785_length_1377_cov_103.832551	1259	1299	248	1	40	0.0250000
NODE_2785_length_1377_cov_103.832551	1259	1299	249	3	40	0.0750000
NODE_2785_length_1377_cov_103.832551	1259	1299	250	2	40	0.0500000
NODE_2785_length_1377_cov_103.832551	1259	1299	251	2	40	0.0500000
NODE_2785_length_1377_cov_103.832551	1259	1299	255	1	40	0.0250000
NODE_2785_length_1377_cov_103.832551	1259	1299	257	2	40	0.0500000
NODE_2785_length_1377_cov_103.832551	1259	1299	261	1	40	0.0250000
NODE_2785_length_1377_cov_103.832551	1259	1299	262	1	40	0.0250000
NODE_2785_length_1377_cov_103.832551	1259	1299	264	1	40	0.0250000
NODE_2785_length_1377_cov_103.832551	1259	1299	267	2	40	0.0500000
NODE_2788_length_1376_cov_7.967110	904	984	0	80	80	1.0000000
NODE_2788_length_1376_cov_7.967110	957	1037	0	80	80	1.0000000
NODE_2798_length_1373_cov_52.691523	524	606	1	81	82	0.9878049
NODE_2798_length_1373_cov_52.691523	524	606	2	1	82	0.0121951
NODE_2798_length_1373_cov_52.691523	579	659	1	38	80	0.4750000
NODE_2798_length_1373_cov_52.691523	579	659	2	42	80	0.5250000
NODE_2799_length_1373_cov_20.880691	987	1067	0	27	80	0.3375000
NODE_2799_length_1373_cov_20.880691	987	1067	2	53	80	0.6625000
NODE_2799_length_1373_cov_20.880691	1116	1195	2	79	79	1.0000000
NODE_2799_length_1373_cov_20.880691	1168	1248	2	68	80	0.8500000
NODE_2799_length_1373_cov_20.880691	1168	1248	4	12	80	0.1500000
NODE_2800_length_1373_cov_12.694662	94	167	7	28	73	0.3835616
NODE_2800_length_1373_cov_12.694662	94	167	9	2	73	0.0273973
NODE_2800_length_1373_cov_12.694662	94	167	10	4	73	0.0547945
NODE_2800_length_1373_cov_12.694662	94	167	12	7	73	0.0958904
NODE_2800_length_1373_cov_12.694662	94	167	14	1	73	0.0136986
NODE_2800_length_1373_cov_12.694662	94	167	18	5	73	0.0684932
NODE_2800_length_1373_cov_12.694662	94	167	20	12	73	0.1643836
NODE_2800_length_1373_cov_12.694662	94	167	22	8	73	0.1095890
NODE_2800_length_1373_cov_12.694662	94	167	23	1	73	0.0136986
NODE_2800_length_1373_cov_12.694662	94	167	25	3	73	0.0410959
NODE_2800_length_1373_cov_12.694662	94	167	26	2	73	0.0273973
NODE_2800_length_1373_cov_12.694662	140	224	18	4	84	0.0476190
NODE_2800_length_1373_cov_12.694662	140	224	20	9	84	0.1071429
NODE_2800_length_1373_cov_12.694662	140	224	22	8	84	0.0952381
NODE_2800_length_1373_cov_12.694662	140	224	23	1	84	0.0119048
NODE_2800_length_1373_cov_12.694662	140	224	25	3	84	0.0357143
NODE_2800_length_1373_cov_12.694662	140	224	26	6	84	0.0714286
NODE_2800_length_1373_cov_12.694662	140	224	28	7	84	0.0833333
NODE_2800_length_1373_cov_12.694662	140	224	29	1	84	0.0119048
NODE_2800_length_1373_cov_12.694662	140	224	30	2	84	0.0238095
NODE_2800_length_1373_cov_12.694662	140	224	31	2	84	0.0238095
NODE_2800_length_1373_cov_12.694662	140	224	32	2	84	0.0238095
NODE_2800_length_1373_cov_12.694662	140	224	33	1	84	0.0119048
NODE_2800_length_1373_cov_12.694662	140	224	34	4	84	0.0476190
NODE_2800_length_1373_cov_12.694662	140	224	38	2	84	0.0238095
NODE_2800_length_1373_cov_12.694662	140	224	39	13	84	0.1547619
NODE_2800_length_1373_cov_12.694662	140	224	40	18	84	0.2142857
NODE_2800_length_1373_cov_12.694662	140	224	41	1	84	0.0119048
NODE_2800_length_1373_cov_12.694662	1214	1286	8	4	72	0.0555556
NODE_2800_length_1373_cov_12.694662	1214	1286	10	5	72	0.0694444
NODE_2800_length_1373_cov_12.694662	1214	1286	16	56	72	0.7777778
NODE_2800_length_1373_cov_12.694662	1214	1286	18	7	72	0.0972222
NODE_2800_length_1373_cov_12.694662	1267	1339	6	2	72	0.0277778
NODE_2800_length_1373_cov_12.694662	1267	1339	8	15	72	0.2083333
NODE_2800_length_1373_cov_12.694662	1267	1339	15	1	72	0.0138889
NODE_2800_length_1373_cov_12.694662	1267	1339	16	54	72	0.7500000
NODE_2801_length_1372_cov_25.408484	665	745	1	57	80	0.7125000
NODE_2801_length_1372_cov_25.408484	665	745	2	23	80	0.2875000
NODE_2801_length_1372_cov_25.408484	718	798	1	57	80	0.7125000
NODE_2801_length_1372_cov_25.408484	718	798	2	23	80	0.2875000
NODE_2802_length_1372_cov_17.123331	647	727	0	80	80	1.0000000
NODE_2802_length_1372_cov_17.123331	700	780	0	80	80	1.0000000
NODE_2802_length_1372_cov_17.123331	776	856	0	80	80	1.0000000
NODE_2802_length_1372_cov_17.123331	829	909	0	80	80	1.0000000
NODE_2803_length_1372_cov_14.418696	211	291	0	80	80	1.0000000
NODE_2803_length_1372_cov_14.418696	264	344	0	80	80	1.0000000
NODE_2806_length_1371_cov_39.366352	715	795	0	80	80	1.0000000
NODE_2806_length_1371_cov_39.366352	768	848	0	80	80	1.0000000
NODE_2807_length_1371_cov_36.961478	371	455	0	84	84	1.0000000
NODE_2807_length_1371_cov_36.961478	424	508	0	84	84	1.0000000
NODE_2807_length_1371_cov_36.961478	504	584	0	80	80	1.0000000
NODE_2807_length_1371_cov_36.961478	557	637	0	27	80	0.3375000
NODE_2807_length_1371_cov_36.961478	557	637	2	53	80	0.6625000
NODE_2808_length_1371_cov_16.944182	459	539	0	80	80	1.0000000
NODE_2808_length_1371_cov_16.944182	512	592	0	80	80	1.0000000
NODE_2808_length_1371_cov_16.944182	588	668	0	80	80	1.0000000
NODE_2808_length_1371_cov_16.944182	641	721	0	80	80	1.0000000
NODE_2812_length_1370_cov_11.627065	502	582	0	80	80	1.0000000
NODE_2812_length_1370_cov_11.627065	555	635	0	80	80	1.0000000
NODE_2812_length_1370_cov_11.627065	631	711	0	80	80	1.0000000
NODE_2812_length_1370_cov_11.627065	684	764	0	80	80	1.0000000
NODE_2813_length_1369_cov_27.937795	597	677	0	11	80	0.1375000
NODE_2813_length_1369_cov_27.937795	597	677	17	69	80	0.8625000
NODE_2813_length_1369_cov_27.937795	650	730	0	2	80	0.0250000
NODE_2813_length_1369_cov_27.937795	650	730	17	37	80	0.4625000
NODE_2813_length_1369_cov_27.937795	650	730	18	41	80	0.5125000
NODE_2820_length_1368_cov_35.148148	546	626	0	80	80	1.0000000
NODE_2820_length_1368_cov_35.148148	599	679	0	80	80	1.0000000
NODE_2821_length_1368_cov_27.847912	486	559	2	31	73	0.4246575
NODE_2821_length_1368_cov_27.847912	486	559	4	7	73	0.0958904
NODE_2821_length_1368_cov_27.847912	486	559	6	35	73	0.4794520
NODE_2821_length_1368_cov_27.847912	532	612	0	51	80	0.6375000
NODE_2821_length_1368_cov_27.847912	532	612	2	29	80	0.3625000
NODE_2821_length_1368_cov_27.847912	608	688	0	80	80	1.0000000
NODE_2821_length_1368_cov_27.847912	661	741	0	80	80	1.0000000
NODE_2822_length_1368_cov_26.832151	458	538	0	80	80	1.0000000
NODE_2822_length_1368_cov_26.832151	511	591	0	80	80	1.0000000
NODE_2822_length_1368_cov_26.832151	587	667	0	11	80	0.1375000
NODE_2822_length_1368_cov_26.832151	587	667	2	69	80	0.8625000
NODE_2822_length_1368_cov_26.832151	640	720	0	10	80	0.1250000
NODE_2822_length_1368_cov_26.832151	640	720	2	70	80	0.8750000
NODE_2823_length_1368_cov_18.205674	603	683	0	80	80	1.0000000
NODE_2823_length_1368_cov_18.205674	656	736	0	80	80	1.0000000
NODE_2826_length_1367_cov_576.769716	799	879	299	1	80	0.0125000
NODE_2826_length_1367_cov_576.769716	799	879	304	1	80	0.0125000
NODE_2826_length_1367_cov_576.769716	799	879	308	1	80	0.0125000
NODE_2826_length_1367_cov_576.769716	799	879	309	1	80	0.0125000
NODE_2826_length_1367_cov_576.769716	799	879	310	1	80	0.0125000
NODE_2826_length_1367_cov_576.769716	799	879	319	2	80	0.0250000
NODE_2826_length_1367_cov_576.769716	799	879	322	1	80	0.0125000
NODE_2826_length_1367_cov_576.769716	799	879	323	1	80	0.0125000
NODE_2826_length_1367_cov_576.769716	799	879	325	1	80	0.0125000
NODE_2826_length_1367_cov_576.769716	799	879	329	1	80	0.0125000
NODE_2826_length_1367_cov_576.769716	799	879	331	2	80	0.0250000
NODE_2826_length_1367_cov_576.769716	799	879	334	1	80	0.0125000
NODE_2826_length_1367_cov_576.769716	799	879	338	1	80	0.0125000
NODE_2826_length_1367_cov_576.769716	799	879	339	1	80	0.0125000
NODE_2826_length_1367_cov_576.769716	799	879	340	1	80	0.0125000
NODE_2826_length_1367_cov_576.769716	799	879	342	1	80	0.0125000
NODE_2826_length_1367_cov_576.769716	799	879	347	1	80	0.0125000
NODE_2826_length_1367_cov_576.769716	799	879	349	1	80	0.0125000
NODE_2826_length_1367_cov_576.769716	799	879	351	2	80	0.0250000
NODE_2826_length_1367_cov_576.769716	799	879	352	2	80	0.0250000
NODE_2826_length_1367_cov_576.769716	799	879	354	1	80	0.0125000
NODE_2826_length_1367_cov_576.769716	799	879	355	1	80	0.0125000
NODE_2826_length_1367_cov_576.769716	799	879	356	1	80	0.0125000
NODE_2826_length_1367_cov_576.769716	799	879	357	1	80	0.0125000
NODE_2826_length_1367_cov_576.769716	799	879	364	1	80	0.0125000
NODE_2826_length_1367_cov_576.769716	799	879	366	1	80	0.0125000
NODE_2826_length_1367_cov_576.769716	799	879	376	1	80	0.0125000
NODE_2826_length_1367_cov_576.769716	799	879	390	1	80	0.0125000
NODE_2826_length_1367_cov_576.769716	799	879	396	2	80	0.0250000
NODE_2826_length_1367_cov_576.769716	799	879	397	1	80	0.0125000
NODE_2826_length_1367_cov_576.769716	799	879	399	1	80	0.0125000
NODE_2826_length_1367_cov_576.769716	799	879	400	1	80	0.0125000
NODE_2826_length_1367_cov_576.769716	799	879	401	1	80	0.0125000
NODE_2826_length_1367_cov_576.769716	799	879	408	1	80	0.0125000
NODE_2826_length_1367_cov_576.769716	799	879	412	1	80	0.0125000
NODE_2826_length_1367_cov_576.769716	799	879	432	1	80	0.0125000
NODE_2826_length_1367_cov_576.769716	799	879	448	1	80	0.0125000
NODE_2826_length_1367_cov_576.769716	799	879	454	1	80	0.0125000
NODE_2826_length_1367_cov_576.769716	799	879	458	2	80	0.0250000
NODE_2826_length_1367_cov_576.769716	799	879	459	1	80	0.0125000
NODE_2826_length_1367_cov_576.769716	799	879	461	1	80	0.0125000
NODE_2826_length_1367_cov_576.769716	799	879	464	1	80	0.0125000
NODE_2826_length_1367_cov_576.769716	799	879	465	1	80	0.0125000
NODE_2826_length_1367_cov_576.769716	799	879	470	1	80	0.0125000
NODE_2826_length_1367_cov_576.769716	799	879	473	1	80	0.0125000
NODE_2826_length_1367_cov_576.769716	799	879	495	1	80	0.0125000
NODE_2826_length_1367_cov_576.769716	799	879	505	1	80	0.0125000
NODE_2826_length_1367_cov_576.769716	799	879	569	1	80	0.0125000
NODE_2826_length_1367_cov_576.769716	799	879	571	1	80	0.0125000
NODE_2826_length_1367_cov_576.769716	799	879	588	1	80	0.0125000
NODE_2826_length_1367_cov_576.769716	799	879	590	1	80	0.0125000
NODE_2826_length_1367_cov_576.769716	799	879	595	1	80	0.0125000
NODE_2826_length_1367_cov_576.769716	799	879	597	1	80	0.0125000
NODE_2826_length_1367_cov_576.769716	799	879	616	1	80	0.0125000
NODE_2826_length_1367_cov_576.769716	799	879	626	1	80	0.0125000
NODE_2826_length_1367_cov_576.769716	799	879	638	1	80	0.0125000
NODE_2826_length_1367_cov_576.769716	799	879	639	1	80	0.0125000
NODE_2826_length_1367_cov_576.769716	799	879	671	1	80	0.0125000
NODE_2826_length_1367_cov_576.769716	799	879	726	1	80	0.0125000
NODE_2826_length_1367_cov_576.769716	799	879	783	1	80	0.0125000
NODE_2826_length_1367_cov_576.769716	799	879	794	1	80	0.0125000
NODE_2826_length_1367_cov_576.769716	799	879	820	1	80	0.0125000
NODE_2826_length_1367_cov_576.769716	799	879	871	1	80	0.0125000
NODE_2826_length_1367_cov_576.769716	799	879	896	1	80	0.0125000
NODE_2826_length_1367_cov_576.769716	799	879	956	1	80	0.0125000
NODE_2826_length_1367_cov_576.769716	799	879	963	1	80	0.0125000
NODE_2826_length_1367_cov_576.769716	799	879	969	1	80	0.0125000
NODE_2826_length_1367_cov_576.769716	799	879	970	1	80	0.0125000
NODE_2826_length_1367_cov_576.769716	799	879	1083	1	80	0.0125000
NODE_2826_length_1367_cov_576.769716	799	879	1139	1	80	0.0125000
NODE_2826_length_1367_cov_576.769716	799	879	1143	1	80	0.0125000
NODE_2826_length_1367_cov_576.769716	799	879	1146	3	80	0.0375000
NODE_2826_length_1367_cov_576.769716	852	932	569	1	80	0.0125000
NODE_2826_length_1367_cov_576.769716	852	932	571	1	80	0.0125000
NODE_2826_length_1367_cov_576.769716	852	932	588	1	80	0.0125000
NODE_2826_length_1367_cov_576.769716	852	932	590	1	80	0.0125000
NODE_2826_length_1367_cov_576.769716	852	932	595	1	80	0.0125000
NODE_2826_length_1367_cov_576.769716	852	932	597	1	80	0.0125000
NODE_2826_length_1367_cov_576.769716	852	932	616	1	80	0.0125000
NODE_2826_length_1367_cov_576.769716	852	932	626	1	80	0.0125000
NODE_2826_length_1367_cov_576.769716	852	932	638	1	80	0.0125000
NODE_2826_length_1367_cov_576.769716	852	932	639	1	80	0.0125000
NODE_2826_length_1367_cov_576.769716	852	932	671	1	80	0.0125000
NODE_2826_length_1367_cov_576.769716	852	932	726	1	80	0.0125000
NODE_2826_length_1367_cov_576.769716	852	932	783	1	80	0.0125000
NODE_2826_length_1367_cov_576.769716	852	932	794	1	80	0.0125000
NODE_2826_length_1367_cov_576.769716	852	932	820	1	80	0.0125000
NODE_2826_length_1367_cov_576.769716	852	932	871	1	80	0.0125000
NODE_2826_length_1367_cov_576.769716	852	932	896	1	80	0.0125000
NODE_2826_length_1367_cov_576.769716	852	932	956	1	80	0.0125000
NODE_2826_length_1367_cov_576.769716	852	932	963	1	80	0.0125000
NODE_2826_length_1367_cov_576.769716	852	932	969	1	80	0.0125000
NODE_2826_length_1367_cov_576.769716	852	932	970	1	80	0.0125000
NODE_2826_length_1367_cov_576.769716	852	932	1083	1	80	0.0125000
NODE_2826_length_1367_cov_576.769716	852	932	1139	1	80	0.0125000
NODE_2826_length_1367_cov_576.769716	852	932	1143	1	80	0.0125000
NODE_2826_length_1367_cov_576.769716	852	932	1145	1	80	0.0125000
NODE_2826_length_1367_cov_576.769716	852	932	1146	4	80	0.0500000
NODE_2826_length_1367_cov_576.769716	852	932	1148	1	80	0.0125000
NODE_2826_length_1367_cov_576.769716	852	932	1159	1	80	0.0125000
NODE_2826_length_1367_cov_576.769716	852	932	1198	1	80	0.0125000
NODE_2826_length_1367_cov_576.769716	852	932	1207	1	80	0.0125000
NODE_2826_length_1367_cov_576.769716	852	932	1237	1	80	0.0125000
NODE_2826_length_1367_cov_576.769716	852	932	1270	1	80	0.0125000
NODE_2826_length_1367_cov_576.769716	852	932	1283	1	80	0.0125000
NODE_2826_length_1367_cov_576.769716	852	932	1284	1	80	0.0125000
NODE_2826_length_1367_cov_576.769716	852	932	1285	2	80	0.0250000
NODE_2826_length_1367_cov_576.769716	852	932	1309	1	80	0.0125000
NODE_2826_length_1367_cov_576.769716	852	932	1315	2	80	0.0250000
NODE_2826_length_1367_cov_576.769716	852	932	1326	1	80	0.0125000
NODE_2826_length_1367_cov_576.769716	852	932	1328	7	80	0.0875000
NODE_2826_length_1367_cov_576.769716	852	932	1329	8	80	0.1000000
NODE_2826_length_1367_cov_576.769716	852	932	1341	1	80	0.0125000
NODE_2826_length_1367_cov_576.769716	852	932	1360	1	80	0.0125000
NODE_2826_length_1367_cov_576.769716	852	932	1361	2	80	0.0250000
NODE_2826_length_1367_cov_576.769716	852	932	1362	3	80	0.0375000
NODE_2826_length_1367_cov_576.769716	852	932	1363	1	80	0.0125000
NODE_2826_length_1367_cov_576.769716	852	932	1365	2	80	0.0250000
NODE_2826_length_1367_cov_576.769716	852	932	1366	1	80	0.0125000
NODE_2826_length_1367_cov_576.769716	852	932	1368	2	80	0.0250000
NODE_2826_length_1367_cov_576.769716	852	932	1373	1	80	0.0125000
NODE_2826_length_1367_cov_576.769716	852	932	1376	4	80	0.0500000
NODE_2826_length_1367_cov_576.769716	852	932	1377	2	80	0.0250000
NODE_2826_length_1367_cov_576.769716	852	932	1378	2	80	0.0250000
NODE_2826_length_1367_cov_576.769716	900	980	989	1	80	0.0125000
NODE_2826_length_1367_cov_576.769716	900	980	1053	1	80	0.0125000
NODE_2826_length_1367_cov_576.769716	900	980	1145	1	80	0.0125000
NODE_2826_length_1367_cov_576.769716	900	980	1207	1	80	0.0125000
NODE_2826_length_1367_cov_576.769716	900	980	1213	1	80	0.0125000
NODE_2826_length_1367_cov_576.769716	900	980	1227	1	80	0.0125000
NODE_2826_length_1367_cov_576.769716	900	980	1248	1	80	0.0125000
NODE_2826_length_1367_cov_576.769716	900	980	1269	1	80	0.0125000
NODE_2826_length_1367_cov_576.769716	900	980	1273	1	80	0.0125000
NODE_2826_length_1367_cov_576.769716	900	980	1278	1	80	0.0125000
NODE_2826_length_1367_cov_576.769716	900	980	1292	1	80	0.0125000
NODE_2826_length_1367_cov_576.769716	900	980	1301	1	80	0.0125000
NODE_2826_length_1367_cov_576.769716	900	980	1307	3	80	0.0375000
NODE_2826_length_1367_cov_576.769716	900	980	1309	1	80	0.0125000
NODE_2826_length_1367_cov_576.769716	900	980	1310	2	80	0.0250000
NODE_2826_length_1367_cov_576.769716	900	980	1311	3	80	0.0375000
NODE_2826_length_1367_cov_576.769716	900	980	1312	1	80	0.0125000
NODE_2826_length_1367_cov_576.769716	900	980	1322	1	80	0.0125000
NODE_2826_length_1367_cov_576.769716	900	980	1328	6	80	0.0750000
NODE_2826_length_1367_cov_576.769716	900	980	1329	4	80	0.0500000
NODE_2826_length_1367_cov_576.769716	900	980	1330	1	80	0.0125000
NODE_2826_length_1367_cov_576.769716	900	980	1336	3	80	0.0375000
NODE_2826_length_1367_cov_576.769716	900	980	1337	2	80	0.0250000
NODE_2826_length_1367_cov_576.769716	900	980	1340	1	80	0.0125000
NODE_2826_length_1367_cov_576.769716	900	980	1341	4	80	0.0500000
NODE_2826_length_1367_cov_576.769716	900	980	1342	2	80	0.0250000
NODE_2826_length_1367_cov_576.769716	900	980	1343	2	80	0.0250000
NODE_2826_length_1367_cov_576.769716	900	980	1344	4	80	0.0500000
NODE_2826_length_1367_cov_576.769716	900	980	1345	1	80	0.0125000
NODE_2826_length_1367_cov_576.769716	900	980	1346	1	80	0.0125000
NODE_2826_length_1367_cov_576.769716	900	980	1347	1	80	0.0125000
NODE_2826_length_1367_cov_576.769716	900	980	1348	1	80	0.0125000
NODE_2826_length_1367_cov_576.769716	900	980	1349	1	80	0.0125000
NODE_2826_length_1367_cov_576.769716	900	980	1351	1	80	0.0125000
NODE_2826_length_1367_cov_576.769716	900	980	1357	1	80	0.0125000
NODE_2826_length_1367_cov_576.769716	900	980	1360	1	80	0.0125000
NODE_2826_length_1367_cov_576.769716	900	980	1361	2	80	0.0250000
NODE_2826_length_1367_cov_576.769716	900	980	1362	3	80	0.0375000
NODE_2826_length_1367_cov_576.769716	900	980	1363	1	80	0.0125000
NODE_2826_length_1367_cov_576.769716	900	980	1365	2	80	0.0250000
NODE_2826_length_1367_cov_576.769716	900	980	1366	1	80	0.0125000
NODE_2826_length_1367_cov_576.769716	900	980	1368	2	80	0.0250000
NODE_2826_length_1367_cov_576.769716	900	980	1373	1	80	0.0125000
NODE_2826_length_1367_cov_576.769716	900	980	1376	4	80	0.0500000
NODE_2826_length_1367_cov_576.769716	900	980	1377	2	80	0.0250000
NODE_2826_length_1367_cov_576.769716	900	980	1378	2	80	0.0250000
NODE_2826_length_1367_cov_576.769716	905	927	1328	4	22	0.1818182
NODE_2826_length_1367_cov_576.769716	905	927	1329	1	22	0.0454545
NODE_2826_length_1367_cov_576.769716	905	927	1341	1	22	0.0454545
NODE_2826_length_1367_cov_576.769716	905	927	1361	1	22	0.0454545
NODE_2826_length_1367_cov_576.769716	905	927	1362	1	22	0.0454545
NODE_2826_length_1367_cov_576.769716	905	927	1365	2	22	0.0909091
NODE_2826_length_1367_cov_576.769716	905	927	1366	1	22	0.0454545
NODE_2826_length_1367_cov_576.769716	905	927	1368	2	22	0.0909091
NODE_2826_length_1367_cov_576.769716	905	927	1373	1	22	0.0454545
NODE_2826_length_1367_cov_576.769716	905	927	1376	4	22	0.1818182
NODE_2826_length_1367_cov_576.769716	905	927	1377	2	22	0.0909091
NODE_2826_length_1367_cov_576.769716	905	927	1378	2	22	0.0909091
NODE_2826_length_1367_cov_576.769716	1051	1131	46	1	80	0.0125000
NODE_2826_length_1367_cov_576.769716	1051	1131	47	8	80	0.1000000
NODE_2826_length_1367_cov_576.769716	1051	1131	48	1	80	0.0125000
NODE_2826_length_1367_cov_576.769716	1051	1131	50	4	80	0.0500000
NODE_2826_length_1367_cov_576.769716	1051	1131	52	11	80	0.1375000
NODE_2826_length_1367_cov_576.769716	1051	1131	53	2	80	0.0250000
NODE_2826_length_1367_cov_576.769716	1051	1131	56	1	80	0.0125000
NODE_2826_length_1367_cov_576.769716	1051	1131	59	2	80	0.0250000
NODE_2826_length_1367_cov_576.769716	1051	1131	61	3	80	0.0375000
NODE_2826_length_1367_cov_576.769716	1051	1131	62	1	80	0.0125000
NODE_2826_length_1367_cov_576.769716	1051	1131	65	5	80	0.0625000
NODE_2826_length_1367_cov_576.769716	1051	1131	66	1	80	0.0125000
NODE_2826_length_1367_cov_576.769716	1051	1131	67	1	80	0.0125000
NODE_2826_length_1367_cov_576.769716	1051	1131	68	1	80	0.0125000
NODE_2826_length_1367_cov_576.769716	1051	1131	77	1	80	0.0125000
NODE_2826_length_1367_cov_576.769716	1051	1131	79	1	80	0.0125000
NODE_2826_length_1367_cov_576.769716	1051	1131	90	1	80	0.0125000
NODE_2826_length_1367_cov_576.769716	1051	1131	92	2	80	0.0250000
NODE_2826_length_1367_cov_576.769716	1051	1131	93	3	80	0.0375000
NODE_2826_length_1367_cov_576.769716	1051	1131	97	1	80	0.0125000
NODE_2826_length_1367_cov_576.769716	1051	1131	103	1	80	0.0125000
NODE_2826_length_1367_cov_576.769716	1051	1131	105	4	80	0.0500000
NODE_2826_length_1367_cov_576.769716	1051	1131	107	1	80	0.0125000
NODE_2826_length_1367_cov_576.769716	1051	1131	109	1	80	0.0125000
NODE_2826_length_1367_cov_576.769716	1051	1131	111	2	80	0.0250000
NODE_2826_length_1367_cov_576.769716	1051	1131	112	1	80	0.0125000
NODE_2826_length_1367_cov_576.769716	1051	1131	122	3	80	0.0375000
NODE_2826_length_1367_cov_576.769716	1051	1131	123	3	80	0.0375000
NODE_2826_length_1367_cov_576.769716	1051	1131	124	3	80	0.0375000
NODE_2826_length_1367_cov_576.769716	1051	1131	128	1	80	0.0125000
NODE_2826_length_1367_cov_576.769716	1051	1131	130	1	80	0.0125000
NODE_2826_length_1367_cov_576.769716	1051	1131	132	1	80	0.0125000
NODE_2826_length_1367_cov_576.769716	1051	1131	133	1	80	0.0125000
NODE_2826_length_1367_cov_576.769716	1051	1131	138	3	80	0.0375000
NODE_2826_length_1367_cov_576.769716	1051	1131	141	2	80	0.0250000
NODE_2826_length_1367_cov_576.769716	1051	1131	143	1	80	0.0125000
NODE_2826_length_1367_cov_576.769716	1104	1184	105	3	80	0.0375000
NODE_2826_length_1367_cov_576.769716	1104	1184	107	1	80	0.0125000
NODE_2826_length_1367_cov_576.769716	1104	1184	109	1	80	0.0125000
NODE_2826_length_1367_cov_576.769716	1104	1184	111	2	80	0.0250000
NODE_2826_length_1367_cov_576.769716	1104	1184	112	1	80	0.0125000
NODE_2826_length_1367_cov_576.769716	1104	1184	122	3	80	0.0375000
NODE_2826_length_1367_cov_576.769716	1104	1184	123	3	80	0.0375000
NODE_2826_length_1367_cov_576.769716	1104	1184	124	3	80	0.0375000
NODE_2826_length_1367_cov_576.769716	1104	1184	128	1	80	0.0125000
NODE_2826_length_1367_cov_576.769716	1104	1184	130	1	80	0.0125000
NODE_2826_length_1367_cov_576.769716	1104	1184	132	1	80	0.0125000
NODE_2826_length_1367_cov_576.769716	1104	1184	133	1	80	0.0125000
NODE_2826_length_1367_cov_576.769716	1104	1184	138	3	80	0.0375000
NODE_2826_length_1367_cov_576.769716	1104	1184	141	2	80	0.0250000
NODE_2826_length_1367_cov_576.769716	1104	1184	143	1	80	0.0125000
NODE_2826_length_1367_cov_576.769716	1104	1184	147	2	80	0.0250000
NODE_2826_length_1367_cov_576.769716	1104	1184	155	1	80	0.0125000
NODE_2826_length_1367_cov_576.769716	1104	1184	158	2	80	0.0250000
NODE_2826_length_1367_cov_576.769716	1104	1184	162	3	80	0.0375000
NODE_2826_length_1367_cov_576.769716	1104	1184	164	6	80	0.0750000
NODE_2826_length_1367_cov_576.769716	1104	1184	168	1	80	0.0125000
NODE_2826_length_1367_cov_576.769716	1104	1184	170	1	80	0.0125000
NODE_2826_length_1367_cov_576.769716	1104	1184	171	1	80	0.0125000
NODE_2826_length_1367_cov_576.769716	1104	1184	173	1	80	0.0125000
NODE_2826_length_1367_cov_576.769716	1104	1184	175	1	80	0.0125000
NODE_2826_length_1367_cov_576.769716	1104	1184	176	3	80	0.0375000
NODE_2826_length_1367_cov_576.769716	1104	1184	177	1	80	0.0125000
NODE_2826_length_1367_cov_576.769716	1104	1184	179	1	80	0.0125000
NODE_2826_length_1367_cov_576.769716	1104	1184	187	2	80	0.0250000
NODE_2826_length_1367_cov_576.769716	1104	1184	189	2	80	0.0250000
NODE_2826_length_1367_cov_576.769716	1104	1184	190	3	80	0.0375000
NODE_2826_length_1367_cov_576.769716	1104	1184	191	8	80	0.1000000
NODE_2826_length_1367_cov_576.769716	1104	1184	192	4	80	0.0500000
NODE_2826_length_1367_cov_576.769716	1104	1184	193	5	80	0.0625000
NODE_2826_length_1367_cov_576.769716	1104	1184	194	3	80	0.0375000
NODE_2826_length_1367_cov_576.769716	1104	1184	196	1	80	0.0125000
NODE_2826_length_1367_cov_576.769716	1104	1184	200	1	80	0.0125000
NODE_2827_length_1367_cov_152.824921	513	593	0	80	80	1.0000000
NODE_2827_length_1367_cov_152.824921	566	646	0	56	80	0.7000000
NODE_2827_length_1367_cov_152.824921	566	646	14	17	80	0.2125000
NODE_2827_length_1367_cov_152.824921	566	646	15	7	80	0.0875000
NODE_2827_length_1367_cov_152.824921	642	722	15	17	80	0.2125000
NODE_2827_length_1367_cov_152.824921	642	722	16	8	80	0.1000000
NODE_2827_length_1367_cov_152.824921	642	722	17	4	80	0.0500000
NODE_2827_length_1367_cov_152.824921	642	722	18	3	80	0.0375000
NODE_2827_length_1367_cov_152.824921	642	722	20	4	80	0.0500000
NODE_2827_length_1367_cov_152.824921	642	722	21	1	80	0.0125000
NODE_2827_length_1367_cov_152.824921	642	722	22	4	80	0.0500000
NODE_2827_length_1367_cov_152.824921	642	722	24	39	80	0.4875000
NODE_2827_length_1367_cov_152.824921	695	775	0	52	80	0.6500000
NODE_2827_length_1367_cov_152.824921	695	775	24	28	80	0.3500000
NODE_2829_length_1367_cov_2.947161	250	326	0	41	76	0.5394737
NODE_2829_length_1367_cov_2.947161	250	326	1	33	76	0.4342105
NODE_2829_length_1367_cov_2.947161	250	326	2	2	76	0.0263158
NODE_2831_length_1366_cov_82.742699	198	278	0	80	80	1.0000000
NODE_2831_length_1366_cov_82.742699	251	331	0	80	80	1.0000000
NODE_2832_length_1366_cov_36.659037	577	657	0	80	80	1.0000000
NODE_2832_length_1366_cov_36.659037	630	710	0	80	80	1.0000000
NODE_2834_length_1366_cov_2.320442	47	116	6	5	69	0.0724638
NODE_2834_length_1366_cov_2.320442	47	116	8	2	69	0.0289855
NODE_2834_length_1366_cov_2.320442	47	116	10	62	69	0.8985507
NODE_2834_length_1366_cov_2.320442	1122	1202	5	31	80	0.3875000
NODE_2834_length_1366_cov_2.320442	1122	1202	7	7	80	0.0875000
NODE_2834_length_1366_cov_2.320442	1122	1202	9	3	80	0.0375000
NODE_2834_length_1366_cov_2.320442	1122	1202	10	12	80	0.1500000
NODE_2834_length_1366_cov_2.320442	1122	1202	12	5	80	0.0625000
NODE_2834_length_1366_cov_2.320442	1122	1202	14	2	80	0.0250000
NODE_2834_length_1366_cov_2.320442	1122	1202	18	20	80	0.2500000
NODE_2834_length_1366_cov_2.320442	1175	1255	5	20	80	0.2500000
NODE_2834_length_1366_cov_2.320442	1175	1255	7	8	80	0.1000000
NODE_2834_length_1366_cov_2.320442	1175	1255	9	3	80	0.0375000
NODE_2834_length_1366_cov_2.320442	1175	1255	12	4	80	0.0500000
NODE_2834_length_1366_cov_2.320442	1175	1255	16	3	80	0.0375000
NODE_2834_length_1366_cov_2.320442	1175	1255	18	1	80	0.0125000
NODE_2834_length_1366_cov_2.320442	1175	1255	20	10	80	0.1250000
NODE_2834_length_1366_cov_2.320442	1175	1255	24	2	80	0.0250000
NODE_2834_length_1366_cov_2.320442	1175	1255	25	5	80	0.0625000
NODE_2834_length_1366_cov_2.320442	1175	1255	28	3	80	0.0375000
NODE_2834_length_1366_cov_2.320442	1175	1255	30	17	80	0.2125000
NODE_2834_length_1366_cov_2.320442	1175	1255	34	1	80	0.0125000
NODE_2834_length_1366_cov_2.320442	1175	1255	36	3	80	0.0375000
NODE_2834_length_1366_cov_2.320442	1251	1331	23	11	80	0.1375000
NODE_2834_length_1366_cov_2.320442	1251	1331	25	9	80	0.1125000
NODE_2834_length_1366_cov_2.320442	1251	1331	26	1	80	0.0125000
NODE_2834_length_1366_cov_2.320442	1251	1331	28	1	80	0.0125000
NODE_2834_length_1366_cov_2.320442	1251	1331	32	1	80	0.0125000
NODE_2834_length_1366_cov_2.320442	1251	1331	34	6	80	0.0750000
NODE_2834_length_1366_cov_2.320442	1251	1331	36	3	80	0.0375000
NODE_2834_length_1366_cov_2.320442	1251	1331	38	48	80	0.6000000
NODE_2835_length_1365_cov_25.540284	432	509	0	77	77	1.0000000
NODE_2835_length_1365_cov_25.540284	482	562	0	80	80	1.0000000
NODE_2835_length_1365_cov_25.540284	558	635	0	77	77	1.0000000
NODE_2835_length_1365_cov_25.540284	625	688	0	63	63	1.0000000
NODE_2838_length_1364_cov_15.222134	120	191	19	5	71	0.0704225
NODE_2838_length_1364_cov_15.222134	120	191	20	4	71	0.0563380
NODE_2838_length_1364_cov_15.222134	120	191	23	4	71	0.0563380
NODE_2838_length_1364_cov_15.222134	120	191	24	4	71	0.0563380
NODE_2838_length_1364_cov_15.222134	120	191	25	12	71	0.1690141
NODE_2838_length_1364_cov_15.222134	120	191	26	1	71	0.0140845
NODE_2838_length_1364_cov_15.222134	120	191	28	4	71	0.0563380
NODE_2838_length_1364_cov_15.222134	120	191	30	4	71	0.0563380
NODE_2838_length_1364_cov_15.222134	120	191	31	3	71	0.0422535
NODE_2838_length_1364_cov_15.222134	120	191	32	11	71	0.1549296
NODE_2838_length_1364_cov_15.222134	120	191	34	4	71	0.0563380
NODE_2838_length_1364_cov_15.222134	120	191	35	4	71	0.0563380
NODE_2838_length_1364_cov_15.222134	120	191	36	3	71	0.0422535
NODE_2838_length_1364_cov_15.222134	120	191	48	2	71	0.0281690
NODE_2838_length_1364_cov_15.222134	120	191	52	2	71	0.0281690
NODE_2838_length_1364_cov_15.222134	120	191	53	4	71	0.0563380
NODE_2839_length_1364_cov_7.456917	843	923	0	77	80	0.9625000
NODE_2839_length_1364_cov_7.456917	843	923	2	3	80	0.0375000
NODE_2839_length_1364_cov_7.456917	896	976	0	24	80	0.3000000
NODE_2839_length_1364_cov_7.456917	896	976	2	56	80	0.7000000
NODE_2840_length_1364_cov_5.055336	239	290	0	51	51	1.0000000
NODE_2840_length_1364_cov_5.055336	263	343	0	80	80	1.0000000
NODE_2846_length_1363_cov_19.442247	615	695	0	80	80	1.0000000
NODE_2846_length_1363_cov_19.442247	668	748	0	80	80	1.0000000
NODE_2847_length_1363_cov_13.575949	619	699	0	80	80	1.0000000
NODE_2847_length_1363_cov_13.575949	672	752	0	80	80	1.0000000
NODE_2850_length_1362_cov_15.796516	898	978	0	58	80	0.7250000
NODE_2850_length_1362_cov_15.796516	898	978	4	22	80	0.2750000
NODE_2850_length_1362_cov_15.796516	951	1031	0	80	80	1.0000000
NODE_2855_length_1361_cov_24.574485	528	608	0	79	80	0.9875000
NODE_2855_length_1361_cov_24.574485	528	608	2	1	80	0.0125000
NODE_2855_length_1361_cov_24.574485	581	661	0	26	80	0.3250000
NODE_2855_length_1361_cov_24.574485	581	661	2	54	80	0.6750000
NODE_2856_length_1361_cov_20.148970	866	946	0	80	80	1.0000000
NODE_2856_length_1361_cov_20.148970	919	999	0	80	80	1.0000000
NODE_2858_length_1361_cov_10.530903	1139	1219	0	16	80	0.2000000
NODE_2858_length_1361_cov_10.530903	1139	1219	6	64	80	0.8000000
NODE_2858_length_1361_cov_10.530903	1139	1219	0	16	80	0.2000000
NODE_2858_length_1361_cov_10.530903	1139	1219	6	64	80	0.8000000
NODE_2858_length_1361_cov_10.530903	1192	1277	0	30	85	0.3529412
NODE_2858_length_1361_cov_10.530903	1192	1277	6	55	85	0.6470588
NODE_2858_length_1361_cov_10.530903	1273	1353	0	80	80	1.0000000
NODE_2858_length_1361_cov_10.530903	1273	1353	0	80	80	1.0000000
NODE_2858_length_1361_cov_10.530903	1273	1353	0	80	80	1.0000000
NODE_2858_length_1361_cov_10.530903	1273	1353	0	80	80	1.0000000
NODE_2858_length_1361_cov_10.530903	1273	1353	0	80	80	1.0000000
NODE_2858_length_1361_cov_10.530903	1273	1353	0	80	80	1.0000000
NODE_2859_length_1360_cov_42.789056	351	431	0	42	80	0.5250000
NODE_2859_length_1360_cov_42.789056	351	431	22	38	80	0.4750000
NODE_2859_length_1360_cov_42.789056	404	484	19	17	80	0.2125000
NODE_2859_length_1360_cov_42.789056	404	484	20	17	80	0.2125000
NODE_2859_length_1360_cov_42.789056	404	484	21	7	80	0.0875000
NODE_2859_length_1360_cov_42.789056	404	484	22	39	80	0.4875000
NODE_2860_length_1360_cov_26.407613	531	611	0	80	80	1.0000000
NODE_2860_length_1360_cov_26.407613	584	669	0	50	85	0.5882353
NODE_2860_length_1360_cov_26.407613	584	669	2	35	85	0.4117647
NODE_2861_length_1360_cov_16.182395	796	876	0	80	80	1.0000000
NODE_2861_length_1360_cov_16.182395	849	929	0	80	80	1.0000000
NODE_2861_length_1360_cov_16.182395	925	1005	0	80	80	1.0000000
NODE_2861_length_1360_cov_16.182395	978	1058	0	80	80	1.0000000
NODE_2862_length_1360_cov_12.763680	582	662	0	80	80	1.0000000
NODE_2862_length_1360_cov_12.763680	635	715	0	80	80	1.0000000
NODE_2866_length_1359_cov_41.324603	674	754	2	34	80	0.4250000
NODE_2866_length_1359_cov_41.324603	674	754	10	9	80	0.1125000
NODE_2866_length_1359_cov_41.324603	674	754	12	37	80	0.4625000
NODE_2866_length_1359_cov_41.324603	727	807	10	13	80	0.1625000
NODE_2866_length_1359_cov_41.324603	727	807	12	18	80	0.2250000
NODE_2866_length_1359_cov_41.324603	727	807	15	3	80	0.0375000
NODE_2866_length_1359_cov_41.324603	727	807	16	27	80	0.3375000
NODE_2866_length_1359_cov_41.324603	727	807	24	1	80	0.0125000
NODE_2866_length_1359_cov_41.324603	727	807	25	18	80	0.2250000
NODE_2866_length_1359_cov_41.324603	803	883	10	24	80	0.3000000
NODE_2866_length_1359_cov_41.324603	803	883	16	1	80	0.0125000
NODE_2866_length_1359_cov_41.324603	803	883	24	1	80	0.0125000
NODE_2866_length_1359_cov_41.324603	803	883	25	54	80	0.6750000
NODE_2866_length_1359_cov_41.324603	856	936	10	77	80	0.9625000
NODE_2866_length_1359_cov_41.324603	856	936	16	1	80	0.0125000
NODE_2866_length_1359_cov_41.324603	856	936	24	1	80	0.0125000
NODE_2866_length_1359_cov_41.324603	856	936	25	1	80	0.0125000
NODE_2871_length_1358_cov_23.427323	292	372	0	18	80	0.2250000
NODE_2871_length_1358_cov_23.427323	292	372	22	62	80	0.7750000
NODE_2871_length_1358_cov_23.427323	345	425	22	78	80	0.9750000
NODE_2871_length_1358_cov_23.427323	345	425	44	2	80	0.0250000
NODE_2872_length_1358_cov_19.489277	411	491	0	80	80	1.0000000
NODE_2872_length_1358_cov_19.489277	464	544	0	80	80	1.0000000
NODE_2875_length_1357_cov_15.962639	732	812	0	80	80	1.0000000
NODE_2875_length_1357_cov_15.962639	785	865	0	80	80	1.0000000
NODE_2879_length_1354_cov_9.854980	735	815	0	80	80	1.0000000
NODE_2879_length_1354_cov_9.854980	788	868	0	80	80	1.0000000
NODE_2882_length_1353_cov_32.982456	708	788	0	8	80	0.1000000
NODE_2882_length_1353_cov_32.982456	708	788	2	72	80	0.9000000
NODE_2882_length_1353_cov_32.982456	761	841	0	42	80	0.5250000
NODE_2882_length_1353_cov_32.982456	761	841	2	38	80	0.4750000
NODE_2883_length_1353_cov_21.775120	493	573	0	2	80	0.0250000
NODE_2883_length_1353_cov_21.775120	493	573	4	78	80	0.9750000
NODE_2883_length_1353_cov_21.775120	546	626	0	32	80	0.4000000
NODE_2883_length_1353_cov_21.775120	546	626	4	48	80	0.6000000
NODE_2884_length_1353_cov_18.201754	696	776	0	80	80	1.0000000
NODE_2884_length_1353_cov_18.201754	749	829	0	80	80	1.0000000
NODE_2888_length_1352_cov_26.942538	455	535	0	57	80	0.7125000
NODE_2888_length_1352_cov_26.942538	455	535	4	23	80	0.2875000
NODE_2888_length_1352_cov_26.942538	508	588	0	4	80	0.0500000
NODE_2888_length_1352_cov_26.942538	508	588	4	76	80	0.9500000
NODE_2889_length_1352_cov_17.189944	717	797	0	80	80	1.0000000
NODE_2889_length_1352_cov_17.189944	770	850	0	80	80	1.0000000
NODE_2890_length_1352_cov_15.752594	640	720	0	80	80	1.0000000
NODE_2890_length_1352_cov_15.752594	693	773	0	80	80	1.0000000
NODE_2891_length_1352_cov_10.699920	237	317	0	80	80	1.0000000
NODE_2891_length_1352_cov_10.699920	290	370	0	80	80	1.0000000
NODE_2894_length_1351_cov_32.325879	561	641	0	80	80	1.0000000
NODE_2894_length_1351_cov_32.325879	614	694	0	30	80	0.3750000
NODE_2894_length_1351_cov_32.325879	614	694	2	50	80	0.6250000
NODE_2895_length_1351_cov_16.861022	97	162	14	15	65	0.2307692
NODE_2895_length_1351_cov_16.861022	97	162	18	1	65	0.0153846
NODE_2895_length_1351_cov_16.861022	97	162	20	3	65	0.0461538
NODE_2895_length_1351_cov_16.861022	97	162	24	46	65	0.7076923
NODE_2896_length_1351_cov_9.894569	331	411	0	80	80	1.0000000
NODE_2896_length_1351_cov_9.894569	384	464	0	80	80	1.0000000
NODE_2897_length_1351_cov_8.699681	1055	1137	0	75	82	0.9146342
NODE_2897_length_1351_cov_8.699681	1055	1137	2	5	82	0.0609756
NODE_2897_length_1351_cov_8.699681	1055	1137	4	2	82	0.0243902
NODE_2897_length_1351_cov_8.699681	1110	1175	0	65	65	1.0000000
NODE_2898_length_1351_cov_2.931310	68	148	42	3	80	0.0375000
NODE_2898_length_1351_cov_2.931310	68	148	44	9	80	0.1125000
NODE_2898_length_1351_cov_2.931310	68	148	45	10	80	0.1250000
NODE_2898_length_1351_cov_2.931310	68	148	49	2	80	0.0250000
NODE_2898_length_1351_cov_2.931310	68	148	55	3	80	0.0375000
NODE_2898_length_1351_cov_2.931310	68	148	58	1	80	0.0125000
NODE_2898_length_1351_cov_2.931310	68	148	60	1	80	0.0125000
NODE_2898_length_1351_cov_2.931310	68	148	61	5	80	0.0625000
NODE_2898_length_1351_cov_2.931310	68	148	62	3	80	0.0375000
NODE_2898_length_1351_cov_2.931310	68	148	63	9	80	0.1125000
NODE_2898_length_1351_cov_2.931310	68	148	64	12	80	0.1500000
NODE_2898_length_1351_cov_2.931310	68	148	65	2	80	0.0250000
NODE_2898_length_1351_cov_2.931310	68	148	66	4	80	0.0500000
NODE_2898_length_1351_cov_2.931310	68	148	69	4	80	0.0500000
NODE_2898_length_1351_cov_2.931310	68	148	71	10	80	0.1250000
NODE_2898_length_1351_cov_2.931310	68	148	73	1	80	0.0125000
NODE_2898_length_1351_cov_2.931310	68	148	75	1	80	0.0125000
NODE_2898_length_1351_cov_2.931310	495	528	0	33	33	1.0000000
NODE_2899_length_1350_cov_18.274181	424	504	0	80	80	1.0000000
NODE_2899_length_1350_cov_18.274181	477	557	0	80	80	1.0000000
NODE_2899_length_1350_cov_18.274181	553	633	0	80	80	1.0000000
NODE_2899_length_1350_cov_18.274181	606	686	0	80	80	1.0000000
NODE_2900_length_1350_cov_8.053557	737	817	0	40	80	0.5000000
NODE_2900_length_1350_cov_8.053557	737	817	2	40	80	0.5000000
NODE_2900_length_1350_cov_8.053557	790	870	0	80	80	1.0000000
NODE_2903_length_1349_cov_23.782400	839	919	0	80	80	1.0000000
NODE_2903_length_1349_cov_23.782400	892	972	0	80	80	1.0000000
NODE_2903_length_1349_cov_23.782400	968	1048	0	80	80	1.0000000
NODE_2903_length_1349_cov_23.782400	1021	1101	0	80	80	1.0000000
NODE_2904_length_1349_cov_17.776800	811	891	0	80	80	1.0000000
NODE_2904_length_1349_cov_17.776800	864	944	0	80	80	1.0000000
NODE_2905_length_1349_cov_16.468800	828	908	0	59	80	0.7375000
NODE_2905_length_1349_cov_16.468800	828	908	2	21	80	0.2625000
NODE_2905_length_1349_cov_16.468800	881	961	0	17	80	0.2125000
NODE_2905_length_1349_cov_16.468800	881	961	2	63	80	0.7875000
NODE_2908_length_1348_cov_22.731785	468	548	0	5	80	0.0625000
NODE_2908_length_1348_cov_22.731785	468	548	1	12	80	0.1500000
NODE_2908_length_1348_cov_22.731785	468	548	2	63	80	0.7875000
NODE_2908_length_1348_cov_22.731785	521	601	2	80	80	1.0000000
NODE_2909_length_1348_cov_20.778223	517	597	0	80	80	1.0000000
NODE_2909_length_1348_cov_20.778223	570	650	0	50	80	0.6250000
NODE_2909_length_1348_cov_20.778223	570	650	2	30	80	0.3750000
NODE_2910_length_1348_cov_11.180144	673	753	0	80	80	1.0000000
NODE_2910_length_1348_cov_11.180144	726	806	0	80	80	1.0000000
NODE_2916_length_1347_cov_45.906250	683	763	0	80	80	1.0000000
NODE_2916_length_1347_cov_45.906250	736	816	0	80	80	1.0000000
NODE_2916_length_1347_cov_45.906250	812	892	0	80	80	1.0000000
NODE_2916_length_1347_cov_45.906250	865	945	0	80	80	1.0000000
NODE_2917_length_1347_cov_41.643429	439	519	0	3	80	0.0375000
NODE_2917_length_1347_cov_41.643429	439	519	2	57	80	0.7125000
NODE_2917_length_1347_cov_41.643429	439	519	4	20	80	0.2500000
NODE_2917_length_1347_cov_41.643429	492	572	2	60	80	0.7500000
NODE_2917_length_1347_cov_41.643429	492	572	4	20	80	0.2500000
NODE_2918_length_1347_cov_19.941506	458	538	0	80	80	1.0000000
NODE_2918_length_1347_cov_19.941506	511	591	0	80	80	1.0000000
NODE_2918_length_1347_cov_19.941506	587	667	0	80	80	1.0000000
NODE_2918_length_1347_cov_19.941506	640	720	0	80	80	1.0000000
NODE_2919_length_1347_cov_16.520833	713	793	0	49	80	0.6125000
NODE_2919_length_1347_cov_16.520833	713	793	2	31	80	0.3875000
NODE_2919_length_1347_cov_16.520833	766	846	1	2	80	0.0250000
NODE_2919_length_1347_cov_16.520833	766	846	2	78	80	0.9750000
NODE_2920_length_1347_cov_15.967147	638	718	0	42	80	0.5250000
NODE_2920_length_1347_cov_15.967147	638	718	4	38	80	0.4750000
NODE_2920_length_1347_cov_15.967147	691	771	4	80	80	1.0000000
NODE_2925_length_1346_cov_13.112269	429	509	0	80	80	1.0000000
NODE_2925_length_1346_cov_13.112269	482	562	0	80	80	1.0000000
NODE_2928_length_1345_cov_32.099518	629	709	0	80	80	1.0000000
NODE_2928_length_1345_cov_32.099518	682	762	0	80	80	1.0000000
NODE_2929_length_1345_cov_19.837881	723	803	0	80	80	1.0000000
NODE_2929_length_1345_cov_19.837881	776	856	0	80	80	1.0000000
NODE_2930_length_1345_cov_14.262440	361	441	0	80	80	1.0000000
NODE_2930_length_1345_cov_14.262440	414	494	0	80	80	1.0000000
NODE_2930_length_1345_cov_14.262440	490	570	0	80	80	1.0000000
NODE_2930_length_1345_cov_14.262440	543	623	0	80	80	1.0000000
NODE_2931_length_1345_cov_14.103531	950	1030	0	80	80	1.0000000
NODE_2931_length_1345_cov_14.103531	1003	1083	0	80	80	1.0000000
NODE_2934_length_1344_cov_15.013655	345	425	0	41	80	0.5125000
NODE_2934_length_1344_cov_15.013655	345	425	2	39	80	0.4875000
NODE_2934_length_1344_cov_15.013655	398	478	0	80	80	1.0000000
NODE_2935_length_1344_cov_11.383133	519	599	0	37	80	0.4625000
NODE_2935_length_1344_cov_11.383133	519	599	2	43	80	0.5375000
NODE_2935_length_1344_cov_11.383133	572	652	2	80	80	1.0000000
NODE_2935_length_1344_cov_11.383133	648	728	0	46	80	0.5750000
NODE_2935_length_1344_cov_11.383133	648	728	2	34	80	0.4250000
NODE_2935_length_1344_cov_11.383133	701	781	0	80	80	1.0000000
NODE_2936_length_1344_cov_10.924498	529	609	0	72	80	0.9000000
NODE_2936_length_1344_cov_10.924498	529	609	2	8	80	0.1000000
NODE_2936_length_1344_cov_10.924498	582	662	0	80	80	1.0000000
NODE_2937_length_1344_cov_5.531727	920	975	0	55	55	1.0000000
NODE_2942_length_1343_cov_36.005627	150	230	26	1	80	0.0125000
NODE_2942_length_1343_cov_36.005627	150	230	28	1	80	0.0125000
NODE_2942_length_1343_cov_36.005627	150	230	30	1	80	0.0125000
NODE_2942_length_1343_cov_36.005627	150	230	33	4	80	0.0500000
NODE_2942_length_1343_cov_36.005627	150	230	34	4	80	0.0500000
NODE_2942_length_1343_cov_36.005627	150	230	36	28	80	0.3500000
NODE_2942_length_1343_cov_36.005627	150	230	38	5	80	0.0625000
NODE_2942_length_1343_cov_36.005627	150	230	44	3	80	0.0375000
NODE_2942_length_1343_cov_36.005627	150	230	46	25	80	0.3125000
NODE_2942_length_1343_cov_36.005627	150	230	52	2	80	0.0250000
NODE_2942_length_1343_cov_36.005627	150	230	54	6	80	0.0750000
NODE_2942_length_1343_cov_36.005627	286	366	0	30	80	0.3750000
NODE_2942_length_1343_cov_36.005627	286	366	6	50	80	0.6250000
NODE_2942_length_1343_cov_36.005627	339	419	0	80	80	1.0000000
NODE_2942_length_1343_cov_36.005627	415	495	0	80	80	1.0000000
NODE_2942_length_1343_cov_36.005627	468	548	0	80	80	1.0000000
NODE_2943_length_1343_cov_26.826367	782	862	0	80	80	1.0000000
NODE_2943_length_1343_cov_26.826367	835	915	0	80	80	1.0000000
NODE_2944_length_1343_cov_19.353698	799	879	0	80	80	1.0000000
NODE_2944_length_1343_cov_19.353698	852	932	0	80	80	1.0000000
NODE_2944_length_1343_cov_19.353698	928	1008	0	80	80	1.0000000
NODE_2944_length_1343_cov_19.353698	981	1061	0	80	80	1.0000000
NODE_2945_length_1343_cov_15.717846	745	825	0	80	80	1.0000000
NODE_2945_length_1343_cov_15.717846	798	878	0	80	80	1.0000000
NODE_2949_length_1342_cov_30.491553	456	536	0	80	80	1.0000000
NODE_2949_length_1342_cov_30.491553	509	589	0	80	80	1.0000000
NODE_2949_length_1342_cov_30.491553	585	665	0	28	80	0.3500000
NODE_2949_length_1342_cov_30.491553	585	665	4	52	80	0.6500000
NODE_2949_length_1342_cov_30.491553	638	718	0	27	80	0.3375000
NODE_2949_length_1342_cov_30.491553	638	718	4	53	80	0.6625000
NODE_2950_length_1342_cov_26.796460	538	618	0	33	80	0.4125000
NODE_2950_length_1342_cov_26.796460	538	618	2	47	80	0.5875000
NODE_2950_length_1342_cov_26.796460	591	671	2	80	80	1.0000000
NODE_2950_length_1342_cov_26.796460	667	747	0	28	80	0.3500000
NODE_2950_length_1342_cov_26.796460	667	747	1	45	80	0.5625000
NODE_2950_length_1342_cov_26.796460	667	747	2	7	80	0.0875000
NODE_2950_length_1342_cov_26.796460	720	800	1	80	80	1.0000000
NODE_2951_length_1342_cov_22.769912	298	378	0	80	80	1.0000000
NODE_2951_length_1342_cov_22.769912	351	431	0	80	80	1.0000000
NODE_2951_length_1342_cov_22.769912	427	507	0	80	80	1.0000000
NODE_2951_length_1342_cov_22.769912	480	560	0	80	80	1.0000000
NODE_2953_length_1341_cov_22.449275	494	574	0	80	80	1.0000000
NODE_2953_length_1341_cov_22.449275	547	627	0	80	80	1.0000000
NODE_2953_length_1341_cov_22.449275	623	703	0	80	80	1.0000000
NODE_2953_length_1341_cov_22.449275	676	755	0	28	79	0.3544304
NODE_2953_length_1341_cov_22.449275	676	755	3	51	79	0.6455696
NODE_2954_length_1341_cov_14.497585	415	495	0	80	80	1.0000000
NODE_2954_length_1341_cov_14.497585	468	548	0	80	80	1.0000000
NODE_2954_length_1341_cov_14.497585	544	624	0	80	80	1.0000000
NODE_2954_length_1341_cov_14.497585	597	677	0	80	80	1.0000000
NODE_2960_length_1340_cov_9.460113	531	611	0	80	80	1.0000000
NODE_2960_length_1340_cov_9.460113	584	664	0	80	80	1.0000000
NODE_2961_length_1340_cov_6.511684	735	815	0	80	80	1.0000000
NODE_2961_length_1340_cov_6.511684	788	868	0	80	80	1.0000000
NODE_2966_length_1339_cov_22.725000	751	831	0	80	80	1.0000000
NODE_2966_length_1339_cov_22.725000	804	884	0	80	80	1.0000000
NODE_2967_length_1339_cov_9.322581	329	409	0	80	80	1.0000000
NODE_2967_length_1339_cov_9.322581	382	462	0	80	80	1.0000000
NODE_2970_length_1338_cov_31.740920	527	607	0	80	80	1.0000000
NODE_2970_length_1338_cov_31.740920	580	660	0	80	80	1.0000000
NODE_2970_length_1338_cov_31.740920	656	736	0	80	80	1.0000000
NODE_2970_length_1338_cov_31.740920	709	789	0	80	80	1.0000000
NODE_2971_length_1338_cov_21.254237	639	719	0	80	80	1.0000000
NODE_2971_length_1338_cov_21.254237	692	772	0	80	80	1.0000000
NODE_2974_length_1337_cov_32.307754	739	819	0	80	80	1.0000000
NODE_2974_length_1337_cov_32.307754	792	872	0	74	80	0.9250000
NODE_2974_length_1337_cov_32.307754	792	872	2	6	80	0.0750000
NODE_2975_length_1337_cov_30.412763	465	545	0	80	80	1.0000000
NODE_2975_length_1337_cov_30.412763	518	598	0	66	80	0.8250000
NODE_2975_length_1337_cov_30.412763	518	598	6	14	80	0.1750000
NODE_2976_length_1337_cov_12.760905	560	640	0	80	80	1.0000000
NODE_2976_length_1337_cov_12.760905	613	693	0	80	80	1.0000000
NODE_2977_length_1337_cov_9.463651	724	804	0	80	80	1.0000000
NODE_2977_length_1337_cov_9.463651	777	857	0	80	80	1.0000000
NODE_2979_length_1337_cov_4.540388	216	296	0	80	80	1.0000000
NODE_2979_length_1337_cov_4.540388	272	349	0	77	77	1.0000000
NODE_2981_length_1336_cov_28.161681	394	474	0	80	80	1.0000000
NODE_2981_length_1336_cov_28.161681	447	527	0	80	80	1.0000000
NODE_2981_length_1336_cov_28.161681	523	603	0	80	80	1.0000000
NODE_2981_length_1336_cov_28.161681	576	656	0	80	80	1.0000000
NODE_2982_length_1336_cov_7.860954	17	98	0	81	81	1.0000000
NODE_2984_length_1336_cov_1.689572	1229	1289	0	59	60	0.9833333
NODE_2984_length_1336_cov_1.689572	1229	1289	2	1	60	0.0166667
NODE_2984_length_1336_cov_1.689572	1262	1336	0	74	74	1.0000000
NODE_2985_length_1335_cov_19.547735	530	607	0	7	77	0.0909091
NODE_2985_length_1335_cov_19.547735	530	607	2	70	77	0.9090909
NODE_2985_length_1335_cov_19.547735	582	660	0	60	78	0.7692308
NODE_2985_length_1335_cov_19.547735	582	660	2	18	78	0.2307692
NODE_2985_length_1335_cov_19.547735	656	736	0	80	80	1.0000000
NODE_2985_length_1335_cov_19.547735	709	789	0	80	80	1.0000000
NODE_2986_length_1335_cov_15.383495	419	499	0	80	80	1.0000000
NODE_2986_length_1335_cov_15.383495	472	552	0	80	80	1.0000000
NODE_2986_length_1335_cov_15.383495	548	628	0	42	80	0.5250000
NODE_2986_length_1335_cov_15.383495	548	628	4	38	80	0.4750000
NODE_2986_length_1335_cov_15.383495	601	681	4	80	80	1.0000000
NODE_2991_length_1333_cov_27.372771	493	573	0	80	80	1.0000000
NODE_2991_length_1333_cov_27.372771	546	626	0	80	80	1.0000000
NODE_2996_length_1332_cov_18.978913	648	728	0	80	80	1.0000000
NODE_2996_length_1332_cov_18.978913	701	781	0	80	80	1.0000000
NODE_2996_length_1332_cov_18.978913	777	857	0	80	80	1.0000000
NODE_2996_length_1332_cov_18.978913	830	910	0	80	80	1.0000000
NODE_2997_length_1332_cov_3.112733	87	151	0	55	64	0.8593750
NODE_2997_length_1332_cov_3.112733	87	151	1	1	64	0.0156250
NODE_2997_length_1332_cov_3.112733	87	151	10	6	64	0.0937500
NODE_2997_length_1332_cov_3.112733	87	151	12	2	64	0.0312500
NODE_3000_length_1331_cov_16.831981	392	472	0	80	80	1.0000000
NODE_3000_length_1331_cov_16.831981	445	525	0	39	80	0.4875000
NODE_3000_length_1331_cov_16.831981	445	525	2	41	80	0.5125000
NODE_3000_length_1331_cov_16.831981	521	601	0	25	80	0.3125000
NODE_3000_length_1331_cov_16.831981	521	601	2	55	80	0.6875000
NODE_3000_length_1331_cov_16.831981	574	654	0	78	80	0.9750000
NODE_3000_length_1331_cov_16.831981	574	654	2	2	80	0.0250000
NODE_3001_length_1331_cov_12.841721	871	951	1	7	80	0.0875000
NODE_3001_length_1331_cov_12.841721	871	951	5	5	80	0.0625000
NODE_3001_length_1331_cov_12.841721	871	951	7	1	80	0.0125000
NODE_3001_length_1331_cov_12.841721	871	951	48	5	80	0.0625000
NODE_3001_length_1331_cov_12.841721	871	951	50	2	80	0.0250000
NODE_3001_length_1331_cov_12.841721	871	951	51	6	80	0.0750000
NODE_3001_length_1331_cov_12.841721	871	951	56	2	80	0.0250000
NODE_3001_length_1331_cov_12.841721	871	951	57	1	80	0.0125000
NODE_3001_length_1331_cov_12.841721	871	951	58	4	80	0.0500000
NODE_3001_length_1331_cov_12.841721	871	951	60	4	80	0.0500000
NODE_3001_length_1331_cov_12.841721	871	951	61	1	80	0.0125000
NODE_3001_length_1331_cov_12.841721	871	951	63	2	80	0.0250000
NODE_3001_length_1331_cov_12.841721	871	951	65	39	80	0.4875000
NODE_3001_length_1331_cov_12.841721	871	951	66	1	80	0.0125000
NODE_3001_length_1331_cov_12.841721	924	1004	0	19	80	0.2375000
NODE_3001_length_1331_cov_12.841721	924	1004	58	1	80	0.0125000
NODE_3001_length_1331_cov_12.841721	924	1004	60	26	80	0.3250000
NODE_3001_length_1331_cov_12.841721	924	1004	61	5	80	0.0625000
NODE_3001_length_1331_cov_12.841721	924	1004	65	29	80	0.3625000
NODE_3004_length_1331_cov_2.090097	0	76	0	76	76	1.0000000
NODE_3004_length_1331_cov_2.090097	49	98	0	49	49	1.0000000
NODE_3007_length_1330_cov_48.993501	278	358	0	22	80	0.2750000
NODE_3007_length_1330_cov_48.993501	278	358	4	41	80	0.5125000
NODE_3007_length_1330_cov_48.993501	278	358	6	17	80	0.2125000
NODE_3007_length_1330_cov_48.993501	331	411	2	34	80	0.4250000
NODE_3007_length_1330_cov_48.993501	331	411	4	10	80	0.1250000
NODE_3007_length_1330_cov_48.993501	331	411	6	36	80	0.4500000
NODE_3007_length_1330_cov_48.993501	742	822	0	80	80	1.0000000
NODE_3007_length_1330_cov_48.993501	795	875	0	80	80	1.0000000
NODE_3008_length_1330_cov_11.037368	407	487	0	80	80	1.0000000
NODE_3008_length_1330_cov_11.037368	460	540	0	80	80	1.0000000
NODE_3008_length_1330_cov_11.037368	536	617	0	81	81	1.0000000
NODE_3008_length_1330_cov_11.037368	590	670	0	80	80	1.0000000
NODE_3009_length_1330_cov_9.026807	551	631	0	11	80	0.1375000
NODE_3009_length_1330_cov_9.026807	551	631	10	69	80	0.8625000
NODE_3009_length_1330_cov_9.026807	604	684	0	36	80	0.4500000
NODE_3009_length_1330_cov_9.026807	604	684	10	44	80	0.5500000
NODE_3011_length_1329_cov_17.036585	691	771	0	80	80	1.0000000
NODE_3011_length_1329_cov_17.036585	744	824	0	80	80	1.0000000
NODE_3011_length_1329_cov_17.036585	820	900	0	80	80	1.0000000
NODE_3011_length_1329_cov_17.036585	873	953	0	80	80	1.0000000
NODE_3012_length_1329_cov_16.341463	428	476	4	1	48	0.0208333
NODE_3012_length_1329_cov_16.341463	428	476	6	4	48	0.0833333
NODE_3012_length_1329_cov_16.341463	428	476	8	10	48	0.2083333
NODE_3012_length_1329_cov_16.341463	428	476	10	10	48	0.2083333
NODE_3012_length_1329_cov_16.341463	428	476	11	1	48	0.0208333
NODE_3012_length_1329_cov_16.341463	428	476	14	1	48	0.0208333
NODE_3012_length_1329_cov_16.341463	428	476	15	5	48	0.1041667
NODE_3012_length_1329_cov_16.341463	428	476	16	2	48	0.0416667
NODE_3012_length_1329_cov_16.341463	428	476	18	4	48	0.0833333
NODE_3012_length_1329_cov_16.341463	428	476	20	2	48	0.0416667
NODE_3012_length_1329_cov_16.341463	428	476	26	1	48	0.0208333
NODE_3012_length_1329_cov_16.341463	428	476	28	4	48	0.0833333
NODE_3012_length_1329_cov_16.341463	428	476	30	1	48	0.0208333
NODE_3012_length_1329_cov_16.341463	428	476	32	1	48	0.0208333
NODE_3012_length_1329_cov_16.341463	428	476	34	1	48	0.0208333
NODE_3013_length_1329_cov_5.620325	888	955	0	26	67	0.3880597
NODE_3013_length_1329_cov_5.620325	888	955	14	1	67	0.0149254
NODE_3013_length_1329_cov_5.620325	888	955	15	3	67	0.0447761
NODE_3013_length_1329_cov_5.620325	888	955	18	1	67	0.0149254
NODE_3013_length_1329_cov_5.620325	888	955	19	16	67	0.2388060
NODE_3013_length_1329_cov_5.620325	888	955	21	1	67	0.0149254
NODE_3013_length_1329_cov_5.620325	888	955	32	19	67	0.2835821
NODE_3013_length_1329_cov_5.620325	941	999	31	39	58	0.6724138
NODE_3013_length_1329_cov_5.620325	941	999	32	19	58	0.3275862
NODE_3017_length_1328_cov_12.954434	794	874	0	80	80	1.0000000
NODE_3017_length_1328_cov_12.954434	847	927	0	80	80	1.0000000
NODE_3018_length_1328_cov_8.810415	762	842	0	80	80	1.0000000
NODE_3018_length_1328_cov_8.810415	815	895	0	80	80	1.0000000
NODE_3021_length_1327_cov_15.938925	260	340	0	26	80	0.3250000
NODE_3021_length_1327_cov_15.938925	260	340	2	54	80	0.6750000
NODE_3021_length_1327_cov_15.938925	313	393	0	18	80	0.2250000
NODE_3021_length_1327_cov_15.938925	313	393	2	62	80	0.7750000
NODE_3022_length_1327_cov_7.274430	159	235	6	60	76	0.7894737
NODE_3022_length_1327_cov_7.274430	159	235	12	16	76	0.2105263
NODE_3022_length_1327_cov_7.274430	774	854	0	20	80	0.2500000
NODE_3022_length_1327_cov_7.274430	774	854	6	15	80	0.1875000
NODE_3022_length_1327_cov_7.274430	774	854	8	45	80	0.5625000
NODE_3022_length_1327_cov_7.274430	827	890	0	7	63	0.1111111
NODE_3022_length_1327_cov_7.274430	827	890	6	6	63	0.0952381
NODE_3022_length_1327_cov_7.274430	827	890	8	50	63	0.7936508
NODE_3023_length_1327_cov_6.486156	896	976	0	80	80	1.0000000
NODE_3023_length_1327_cov_6.486156	949	1029	0	80	80	1.0000000
NODE_3029_length_1326_cov_32.382233	571	651	0	80	80	1.0000000
NODE_3029_length_1326_cov_32.382233	624	704	0	80	80	1.0000000
NODE_3030_length_1326_cov_30.614507	760	840	4	9	80	0.1125000
NODE_3030_length_1326_cov_30.614507	760	840	6	22	80	0.2750000
NODE_3030_length_1326_cov_30.614507	760	840	8	49	80	0.6125000
NODE_3030_length_1326_cov_30.614507	813	893	4	11	80	0.1375000
NODE_3030_length_1326_cov_30.614507	813	893	6	52	80	0.6500000
NODE_3030_length_1326_cov_30.614507	813	893	8	17	80	0.2125000
NODE_3031_length_1326_cov_30.304808	488	568	0	66	80	0.8250000
NODE_3031_length_1326_cov_30.304808	488	568	2	14	80	0.1750000
NODE_3031_length_1326_cov_30.304808	541	621	0	80	80	1.0000000
NODE_3031_length_1326_cov_30.304808	617	697	0	80	80	1.0000000
NODE_3031_length_1326_cov_30.304808	670	750	0	80	80	1.0000000
NODE_3032_length_1326_cov_10.913610	238	318	0	80	80	1.0000000
NODE_3032_length_1326_cov_10.913610	291	371	0	80	80	1.0000000
NODE_3036_length_1325_cov_38.136215	0	46	0	46	46	1.0000000
NODE_3036_length_1325_cov_38.136215	19	99	0	80	80	1.0000000
NODE_3036_length_1325_cov_38.136215	948	1022	6	34	74	0.4594595
NODE_3036_length_1325_cov_38.136215	948	1022	8	1	74	0.0135135
NODE_3036_length_1325_cov_38.136215	948	1022	10	35	74	0.4729730
NODE_3036_length_1325_cov_38.136215	948	1022	12	4	74	0.0540541
NODE_3036_length_1325_cov_38.136215	1001	1063	10	17	62	0.2741936
NODE_3036_length_1325_cov_38.136215	1001	1063	11	2	62	0.0322581
NODE_3036_length_1325_cov_38.136215	1001	1063	12	17	62	0.2741936
NODE_3036_length_1325_cov_38.136215	1001	1063	13	7	62	0.1129032
NODE_3036_length_1325_cov_38.136215	1001	1063	17	1	62	0.0161290
NODE_3036_length_1325_cov_38.136215	1001	1063	18	1	62	0.0161290
NODE_3036_length_1325_cov_38.136215	1001	1063	21	1	62	0.0161290
NODE_3036_length_1325_cov_38.136215	1001	1063	23	2	62	0.0322581
NODE_3036_length_1325_cov_38.136215	1001	1063	24	1	62	0.0161290
NODE_3036_length_1325_cov_38.136215	1001	1063	25	8	62	0.1290323
NODE_3036_length_1325_cov_38.136215	1001	1063	26	1	62	0.0161290
NODE_3036_length_1325_cov_38.136215	1001	1063	31	4	62	0.0645161
NODE_3037_length_1325_cov_29.201468	613	693	0	80	80	1.0000000
NODE_3037_length_1325_cov_29.201468	666	746	0	80	80	1.0000000
NODE_3038_length_1325_cov_11.902121	697	777	0	28	80	0.3500000
NODE_3038_length_1325_cov_11.902121	697	777	2	52	80	0.6500000
NODE_3038_length_1325_cov_11.902121	750	830	0	80	80	1.0000000
NODE_3039_length_1325_cov_7.876835	645	725	0	80	80	1.0000000
NODE_3039_length_1325_cov_7.876835	698	778	0	80	80	1.0000000
NODE_3040_length_1325_cov_3.774062	1157	1218	0	27	61	0.4426230
NODE_3040_length_1325_cov_3.774062	1157	1218	2	34	61	0.5573770
NODE_3040_length_1325_cov_3.774062	1191	1271	2	80	80	1.0000000
NODE_3041_length_1325_cov_2.896411	0	58	0	14	58	0.2413793
NODE_3041_length_1325_cov_2.896411	0	58	2	8	58	0.1379310
NODE_3041_length_1325_cov_2.896411	0	58	4	10	58	0.1724138
NODE_3041_length_1325_cov_2.896411	0	58	6	26	58	0.4482759
NODE_3041_length_1325_cov_2.896411	8	67	0	6	59	0.1016949
NODE_3041_length_1325_cov_2.896411	8	67	2	8	59	0.1355932
NODE_3041_length_1325_cov_2.896411	8	67	4	10	59	0.1694915
NODE_3041_length_1325_cov_2.896411	8	67	6	30	59	0.5084746
NODE_3041_length_1325_cov_2.896411	8	67	10	5	59	0.0847458
NODE_3046_length_1324_cov_30.340408	939	1019	0	80	80	1.0000000
NODE_3046_length_1324_cov_30.340408	992	1072	0	80	80	1.0000000
NODE_3047_length_1324_cov_7.391020	742	822	0	42	80	0.5250000
NODE_3047_length_1324_cov_7.391020	742	822	2	38	80	0.4750000
NODE_3047_length_1324_cov_7.391020	795	875	0	10	80	0.1250000
NODE_3047_length_1324_cov_7.391020	795	875	2	70	80	0.8750000
NODE_3053_length_1323_cov_30.600490	392	472	0	80	80	1.0000000
NODE_3053_length_1323_cov_30.600490	445	525	0	80	80	1.0000000
NODE_3053_length_1323_cov_30.600490	521	601	0	80	80	1.0000000
NODE_3053_length_1323_cov_30.600490	574	654	0	80	80	1.0000000
NODE_3054_length_1323_cov_20.888889	758	838	0	80	80	1.0000000
NODE_3054_length_1323_cov_20.888889	811	891	0	80	80	1.0000000
NODE_3061_length_1322_cov_8.988553	287	368	0	81	81	1.0000000
NODE_3061_length_1322_cov_8.988553	341	421	0	80	80	1.0000000
NODE_3061_length_1322_cov_8.988553	417	497	0	68	80	0.8500000
NODE_3061_length_1322_cov_8.988553	417	497	2	12	80	0.1500000
NODE_3061_length_1322_cov_8.988553	470	550	0	15	80	0.1875000
NODE_3061_length_1322_cov_8.988553	470	550	2	61	80	0.7625000
NODE_3061_length_1322_cov_8.988553	470	550	6	4	80	0.0500000
NODE_3068_length_1321_cov_57.885434	359	439	0	80	80	1.0000000
NODE_3068_length_1321_cov_57.885434	412	492	0	80	80	1.0000000
NODE_3068_length_1321_cov_57.885434	488	568	0	80	80	1.0000000
NODE_3068_length_1321_cov_57.885434	541	621	0	80	80	1.0000000
NODE_3071_length_1320_cov_70.753481	432	512	0	80	80	1.0000000
NODE_3071_length_1320_cov_70.753481	485	565	0	80	80	1.0000000
NODE_3071_length_1320_cov_70.753481	561	641	0	80	80	1.0000000
NODE_3071_length_1320_cov_70.753481	614	694	0	80	80	1.0000000
NODE_3072_length_1320_cov_39.149058	715	795	0	80	80	1.0000000
NODE_3072_length_1320_cov_39.149058	768	848	0	80	80	1.0000000
NODE_3072_length_1320_cov_39.149058	844	924	0	80	80	1.0000000
NODE_3072_length_1320_cov_39.149058	897	977	0	80	80	1.0000000
NODE_3073_length_1320_cov_19.175266	707	783	0	76	76	1.0000000
NODE_3073_length_1320_cov_19.175266	760	840	0	80	80	1.0000000
NODE_3074_length_1320_cov_11.224406	860	940	0	80	80	1.0000000
NODE_3074_length_1320_cov_11.224406	913	993	0	80	80	1.0000000
NODE_3075_length_1320_cov_11.036036	760	840	0	8	80	0.1000000
NODE_3075_length_1320_cov_11.036036	760	840	2	72	80	0.9000000
NODE_3075_length_1320_cov_11.036036	813	893	0	61	80	0.7625000
NODE_3075_length_1320_cov_11.036036	813	893	2	19	80	0.2375000
NODE_3076_length_1320_cov_8.357084	800	880	0	72	80	0.9000000
NODE_3076_length_1320_cov_8.357084	800	880	1	8	80	0.1000000
NODE_3076_length_1320_cov_8.357084	853	933	0	19	80	0.2375000
NODE_3076_length_1320_cov_8.357084	853	933	1	61	80	0.7625000
NODE_3080_length_1319_cov_27.098361	630	710	0	80	80	1.0000000
NODE_3080_length_1319_cov_27.098361	683	763	0	80	80	1.0000000
NODE_3081_length_1319_cov_22.992623	490	570	2	80	80	1.0000000
NODE_3081_length_1319_cov_22.992623	543	623	0	41	80	0.5125000
NODE_3081_length_1319_cov_22.992623	543	623	2	39	80	0.4875000
NODE_3086_length_1318_cov_13.624282	642	722	0	80	80	1.0000000
NODE_3086_length_1318_cov_13.624282	695	775	0	80	80	1.0000000
NODE_3086_length_1318_cov_13.624282	771	851	0	80	80	1.0000000
NODE_3086_length_1318_cov_13.624282	824	904	0	80	80	1.0000000
NODE_3089_length_1317_cov_162.041872	66	143	4	73	77	0.9480519
NODE_3089_length_1317_cov_162.041872	66	143	23	1	77	0.0129870
NODE_3089_length_1317_cov_162.041872	66	143	121	1	77	0.0129870
NODE_3089_length_1317_cov_162.041872	66	143	149	1	77	0.0129870
NODE_3089_length_1317_cov_162.041872	66	143	170	1	77	0.0129870
NODE_3090_length_1317_cov_19.736453	675	755	0	80	80	1.0000000
NODE_3090_length_1317_cov_19.736453	728	808	0	80	80	1.0000000
NODE_3090_length_1317_cov_19.736453	804	884	0	80	80	1.0000000
NODE_3090_length_1317_cov_19.736453	857	937	0	80	80	1.0000000
NODE_3092_length_1317_cov_2.203612	779	859	0	80	80	1.0000000
NODE_3095_length_1316_cov_25.377157	557	637	0	80	80	1.0000000
NODE_3095_length_1316_cov_25.377157	610	690	0	80	80	1.0000000
NODE_3096_length_1316_cov_15.891537	446	526	0	22	80	0.2750000
NODE_3096_length_1316_cov_15.891537	446	526	2	58	80	0.7250000
NODE_3096_length_1316_cov_15.891537	499	579	0	25	80	0.3125000
NODE_3096_length_1316_cov_15.891537	499	579	2	55	80	0.6875000
NODE_3096_length_1316_cov_15.891537	575	655	0	63	80	0.7875000
NODE_3096_length_1316_cov_15.891537	575	655	2	17	80	0.2125000
NODE_3096_length_1316_cov_15.891537	628	708	0	80	80	1.0000000
NODE_3101_length_1315_cov_24.136513	592	672	0	62	80	0.7750000
NODE_3101_length_1315_cov_24.136513	592	672	2	18	80	0.2250000
NODE_3101_length_1315_cov_24.136513	645	725	0	15	80	0.1875000
NODE_3101_length_1315_cov_24.136513	645	725	2	65	80	0.8125000
NODE_3105_length_1314_cov_38.391770	647	727	6	80	80	1.0000000
NODE_3105_length_1314_cov_38.391770	700	780	0	52	80	0.6500000
NODE_3105_length_1314_cov_38.391770	700	780	6	28	80	0.3500000
NODE_3105_length_1314_cov_38.391770	776	856	0	80	80	1.0000000
NODE_3105_length_1314_cov_38.391770	829	909	0	80	80	1.0000000
NODE_3106_length_1314_cov_30.167078	736	816	0	58	80	0.7250000
NODE_3106_length_1314_cov_30.167078	736	816	2	22	80	0.2750000
NODE_3106_length_1314_cov_30.167078	789	869	0	5	80	0.0625000
NODE_3106_length_1314_cov_30.167078	789	869	2	75	80	0.9375000
NODE_3107_length_1314_cov_11.221399	523	603	0	80	80	1.0000000
NODE_3107_length_1314_cov_11.221399	576	656	0	80	80	1.0000000
NODE_3114_length_1313_cov_29.315486	463	543	1	80	80	1.0000000
NODE_3114_length_1313_cov_29.315486	516	596	1	58	80	0.7250000
NODE_3114_length_1313_cov_29.315486	516	596	2	22	80	0.2750000
NODE_3115_length_1313_cov_25.144975	709	789	0	79	80	0.9875000
NODE_3115_length_1313_cov_25.144975	709	789	2	1	80	0.0125000
NODE_3115_length_1313_cov_25.144975	762	842	0	80	80	1.0000000
NODE_3115_length_1313_cov_25.144975	838	918	0	80	80	1.0000000
NODE_3115_length_1313_cov_25.144975	891	971	0	80	80	1.0000000
NODE_3118_length_1312_cov_20.378401	138	218	0	80	80	1.0000000
NODE_3118_length_1312_cov_20.378401	191	271	0	80	80	1.0000000
NODE_3121_length_1311_cov_38.468647	584	664	0	57	80	0.7125000
NODE_3121_length_1311_cov_38.468647	584	664	2	23	80	0.2875000
NODE_3121_length_1311_cov_38.468647	637	717	0	4	80	0.0500000
NODE_3121_length_1311_cov_38.468647	637	717	2	55	80	0.6875000
NODE_3121_length_1311_cov_38.468647	637	717	6	21	80	0.2625000
NODE_3121_length_1311_cov_38.468647	713	793	4	64	80	0.8000000
NODE_3121_length_1311_cov_38.468647	713	793	6	16	80	0.2000000
NODE_3121_length_1311_cov_38.468647	766	846	0	42	80	0.5250000
NODE_3121_length_1311_cov_38.468647	766	846	4	38	80	0.4750000
NODE_3125_length_1310_cov_37.739884	679	759	0	80	80	1.0000000
NODE_3125_length_1310_cov_37.739884	683	763	0	80	80	1.0000000
NODE_3125_length_1310_cov_37.739884	732	816	0	84	84	1.0000000
NODE_3125_length_1310_cov_37.739884	736	816	0	80	80	1.0000000
NODE_3125_length_1310_cov_37.739884	812	892	0	80	80	1.0000000
NODE_3125_length_1310_cov_37.739884	865	945	0	80	80	1.0000000
NODE_3126_length_1310_cov_12.245252	615	695	0	80	80	1.0000000
NODE_3126_length_1310_cov_12.245252	668	748	0	80	80	1.0000000
NODE_3127_length_1310_cov_10.184971	422	502	0	80	80	1.0000000
NODE_3127_length_1310_cov_10.184971	475	555	0	80	80	1.0000000
NODE_3128_length_1310_cov_3.186623	876	956	0	80	80	1.0000000
NODE_3128_length_1310_cov_3.186623	929	1009	0	80	80	1.0000000
NODE_3131_length_1310_cov_0.757225	1255	1310	0	55	55	1.0000000
NODE_3132_length_1309_cov_34.942149	474	554	0	63	80	0.7875000
NODE_3132_length_1309_cov_34.942149	474	554	1	17	80	0.2125000
NODE_3132_length_1309_cov_34.942149	527	607	0	10	80	0.1250000
NODE_3132_length_1309_cov_34.942149	527	607	1	70	80	0.8750000
NODE_3132_length_1309_cov_34.942149	603	683	0	15	80	0.1875000
NODE_3132_length_1309_cov_34.942149	603	683	1	65	80	0.8125000
NODE_3132_length_1309_cov_34.942149	656	736	0	68	80	0.8500000
NODE_3132_length_1309_cov_34.942149	656	736	1	12	80	0.1500000
NODE_3133_length_1309_cov_10.571074	839	921	0	82	82	1.0000000
NODE_3133_length_1309_cov_10.571074	894	974	0	80	80	1.0000000
NODE_3135_length_1308_cov_43.461538	330	410	0	80	80	1.0000000
NODE_3135_length_1308_cov_43.461538	383	463	0	80	80	1.0000000
NODE_3145_length_1307_cov_11.290563	595	673	0	78	78	1.0000000
NODE_3145_length_1307_cov_11.290563	646	726	0	80	80	1.0000000
NODE_3146_length_1307_cov_8.653146	430	510	0	80	80	1.0000000
NODE_3146_length_1307_cov_8.653146	483	563	0	80	80	1.0000000
NODE_3153_length_1306_cov_26.813587	369	449	0	80	80	1.0000000
NODE_3153_length_1306_cov_26.813587	422	502	0	80	80	1.0000000
NODE_3153_length_1306_cov_26.813587	498	578	0	80	80	1.0000000
NODE_3153_length_1306_cov_26.813587	551	631	0	80	80	1.0000000
NODE_3154_length_1306_cov_24.904722	634	714	0	80	80	1.0000000
NODE_3154_length_1306_cov_24.904722	687	767	0	80	80	1.0000000
NODE_3155_length_1306_cov_18.274234	388	468	0	80	80	1.0000000
NODE_3155_length_1306_cov_18.274234	441	521	0	34	80	0.4250000
NODE_3155_length_1306_cov_18.274234	441	521	2	46	80	0.5750000
NODE_3156_length_1306_cov_15.176471	1214	1294	0	65	80	0.8125000
NODE_3156_length_1306_cov_15.176471	1214	1294	2	15	80	0.1875000
NODE_3157_length_1306_cov_12.699254	458	538	0	80	80	1.0000000
NODE_3157_length_1306_cov_12.699254	511	591	0	80	80	1.0000000
NODE_3158_length_1306_cov_9.958575	630	710	0	80	80	1.0000000
NODE_3158_length_1306_cov_9.958575	683	764	0	81	81	1.0000000
NODE_3159_length_1306_cov_2.739851	1206	1246	0	40	40	1.0000000
NODE_3168_length_1304_cov_28.444813	511	591	0	16	80	0.2000000
NODE_3168_length_1304_cov_28.444813	511	591	10	64	80	0.8000000
NODE_3168_length_1304_cov_28.444813	564	644	0	4	80	0.0500000
NODE_3168_length_1304_cov_28.444813	564	644	10	76	80	0.9500000
NODE_3168_length_1304_cov_28.444813	640	720	0	80	80	1.0000000
NODE_3168_length_1304_cov_28.444813	693	773	0	80	80	1.0000000
NODE_3169_length_1304_cov_27.137759	575	655	0	37	80	0.4625000
NODE_3169_length_1304_cov_27.137759	575	655	2	43	80	0.5375000
NODE_3169_length_1304_cov_27.137759	628	708	0	80	80	1.0000000
NODE_3169_length_1304_cov_27.137759	704	784	0	80	80	1.0000000
NODE_3169_length_1304_cov_27.137759	757	837	0	80	80	1.0000000
NODE_3171_length_1303_cov_36.546512	458	538	0	80	80	1.0000000
NODE_3171_length_1303_cov_36.546512	511	591	0	80	80	1.0000000
NODE_3171_length_1303_cov_36.546512	587	667	0	80	80	1.0000000
NODE_3171_length_1303_cov_36.546512	640	720	0	80	80	1.0000000
NODE_3174_length_1302_cov_22.265170	747	827	0	80	80	1.0000000
NODE_3174_length_1302_cov_22.265170	800	880	0	80	80	1.0000000
NODE_3175_length_1302_cov_16.199501	480	560	0	80	80	1.0000000
NODE_3175_length_1302_cov_16.199501	533	613	0	80	80	1.0000000
NODE_3176_length_1302_cov_6.953450	687	767	0	80	80	1.0000000
NODE_3176_length_1302_cov_6.953450	740	820	0	80	80	1.0000000
NODE_3179_length_1301_cov_31.711314	401	481	0	80	80	1.0000000
NODE_3179_length_1301_cov_31.711314	454	534	0	80	80	1.0000000
NODE_3181_length_1301_cov_5.529950	246	326	0	80	80	1.0000000
NODE_3181_length_1301_cov_5.529950	299	379	0	80	80	1.0000000
NODE_3186_length_1300_cov_39.109908	602	682	0	80	80	1.0000000
NODE_3186_length_1300_cov_39.109908	655	735	0	34	80	0.4250000
NODE_3186_length_1300_cov_39.109908	655	735	4	4	80	0.0500000
NODE_3186_length_1300_cov_39.109908	655	735	5	42	80	0.5250000
NODE_3187_length_1300_cov_34.360533	586	666	0	80	80	1.0000000
NODE_3187_length_1300_cov_34.360533	639	719	0	80	80	1.0000000
NODE_3188_length_1300_cov_4.659450	454	535	2	81	81	1.0000000
NODE_3188_length_1300_cov_4.659450	508	588	0	43	80	0.5375000
NODE_3188_length_1300_cov_4.659450	508	588	2	37	80	0.4625000
NODE_3189_length_1299_cov_29.071667	452	532	0	80	80	1.0000000
NODE_3190_length_1299_cov_23.600833	818	898	0	80	80	1.0000000
NODE_3190_length_1299_cov_23.600833	871	951	0	80	80	1.0000000
NODE_3191_length_1299_cov_23.169167	625	705	0	80	80	1.0000000
NODE_3191_length_1299_cov_23.169167	678	758	0	80	80	1.0000000
NODE_3191_length_1299_cov_23.169167	754	834	0	80	80	1.0000000
NODE_3191_length_1299_cov_23.169167	807	887	0	80	80	1.0000000
NODE_3192_length_1299_cov_19.315000	306	386	0	80	80	1.0000000
NODE_3192_length_1299_cov_19.315000	359	439	0	80	80	1.0000000
NODE_3192_length_1299_cov_19.315000	435	515	0	80	80	1.0000000
NODE_3192_length_1299_cov_19.315000	488	568	0	80	80	1.0000000
NODE_3193_length_1299_cov_13.691667	540	620	0	80	80	1.0000000
NODE_3193_length_1299_cov_13.691667	593	673	0	80	80	1.0000000
NODE_3195_length_1298_cov_58.277731	679	759	0	80	80	1.0000000
NODE_3195_length_1298_cov_58.277731	732	812	0	80	80	1.0000000
NODE_3195_length_1298_cov_58.277731	808	888	0	80	80	1.0000000
NODE_3195_length_1298_cov_58.277731	861	941	0	80	80	1.0000000
NODE_3196_length_1298_cov_31.319433	375	455	0	80	80	1.0000000
NODE_3196_length_1298_cov_31.319433	428	508	0	80	80	1.0000000
NODE_3196_length_1298_cov_31.319433	504	584	0	14	80	0.1750000
NODE_3196_length_1298_cov_31.319433	504	584	2	66	80	0.8250000
NODE_3196_length_1298_cov_31.319433	557	637	0	54	80	0.6750000
NODE_3196_length_1298_cov_31.319433	557	637	2	26	80	0.3250000
NODE_3197_length_1298_cov_2.158465	294	360	0	66	66	1.0000000
NODE_3201_length_1296_cov_34.778613	620	700	0	80	80	1.0000000
NODE_3201_length_1296_cov_34.778613	673	753	0	46	80	0.5750000
NODE_3201_length_1296_cov_34.778613	673	753	4	34	80	0.4250000
NODE_3202_length_1296_cov_28.726817	671	751	0	80	80	1.0000000
NODE_3202_length_1296_cov_28.726817	724	804	0	80	80	1.0000000
NODE_3202_length_1296_cov_28.726817	800	880	0	80	80	1.0000000
NODE_3202_length_1296_cov_28.726817	853	933	0	80	80	1.0000000
NODE_3205_length_1295_cov_10.661371	818	898	0	71	80	0.8875000
NODE_3205_length_1295_cov_10.661371	818	898	2	9	80	0.1125000
NODE_3205_length_1295_cov_10.661371	871	951	0	80	80	1.0000000
NODE_3211_length_1294_cov_15.098745	353	433	0	80	80	1.0000000
NODE_3211_length_1294_cov_15.098745	406	486	0	80	80	1.0000000
NODE_3216_length_1293_cov_26.580402	595	675	0	25	80	0.3125000
NODE_3216_length_1293_cov_26.580402	595	675	2	55	80	0.6875000
NODE_3216_length_1293_cov_26.580402	648	728	0	78	80	0.9750000
NODE_3216_length_1293_cov_26.580402	648	728	2	2	80	0.0250000
NODE_3216_length_1293_cov_26.580402	724	804	0	80	80	1.0000000
NODE_3216_length_1293_cov_26.580402	777	857	0	80	80	1.0000000
NODE_3217_length_1293_cov_9.252094	1187	1207	0	20	20	1.0000000
NODE_3220_length_1293_cov_2.118090	1131	1195	0	64	64	1.0000000
NODE_3220_length_1293_cov_2.118090	1184	1248	0	64	64	1.0000000
NODE_3224_length_1292_cov_50.158424	402	482	1	12	80	0.1500000
NODE_3224_length_1292_cov_50.158424	402	482	17	12	80	0.1500000
NODE_3224_length_1292_cov_50.158424	402	482	18	39	80	0.4875000
NODE_3224_length_1292_cov_50.158424	402	482	19	17	80	0.2125000
NODE_3224_length_1292_cov_50.158424	455	535	0	31	80	0.3875000
NODE_3224_length_1292_cov_50.158424	455	535	18	11	80	0.1375000
NODE_3224_length_1292_cov_50.158424	455	535	19	38	80	0.4750000
NODE_3224_length_1292_cov_50.158424	531	611	0	80	80	1.0000000
NODE_3224_length_1292_cov_50.158424	584	664	0	80	80	1.0000000
NODE_3225_length_1292_cov_36.535624	670	750	0	80	80	1.0000000
NODE_3225_length_1292_cov_36.535624	723	803	0	80	80	1.0000000
NODE_3226_length_1292_cov_24.523889	420	500	0	80	80	1.0000000
NODE_3226_length_1292_cov_24.523889	473	553	0	80	80	1.0000000
NODE_3232_length_1291_cov_8.734060	623	703	0	80	80	1.0000000
NODE_3232_length_1291_cov_8.734060	676	756	0	45	80	0.5625000
NODE_3232_length_1291_cov_8.734060	676	756	2	35	80	0.4375000
NODE_3233_length_1291_cov_8.625839	756	836	0	80	80	1.0000000
NODE_3233_length_1291_cov_8.625839	809	889	0	80	80	1.0000000
NODE_3236_length_1290_cov_24.120067	497	577	0	80	80	1.0000000
NODE_3236_length_1290_cov_24.120067	550	630	0	80	80	1.0000000
NODE_3236_length_1290_cov_24.120067	626	706	0	80	80	1.0000000
NODE_3236_length_1290_cov_24.120067	679	759	0	80	80	1.0000000
NODE_3237_length_1290_cov_18.874895	671	751	0	80	80	1.0000000
NODE_3237_length_1290_cov_18.874895	724	804	0	80	80	1.0000000
NODE_3238_length_1290_cov_11.627204	573	653	0	80	80	1.0000000
NODE_3238_length_1290_cov_11.627204	626	706	0	80	80	1.0000000
NODE_3239_length_1290_cov_11.215785	373	453	0	80	80	1.0000000
NODE_3239_length_1290_cov_11.215785	426	506	0	80	80	1.0000000
NODE_3240_length_1290_cov_8.752309	788	868	0	80	80	1.0000000
NODE_3240_length_1290_cov_8.752309	841	921	0	80	80	1.0000000
NODE_3242_length_1289_cov_47.476471	919	999	0	80	80	1.0000000
NODE_3242_length_1289_cov_47.476471	972	1052	0	80	80	1.0000000
NODE_3243_length_1289_cov_18.497479	688	768	0	3	80	0.0375000
NODE_3243_length_1289_cov_18.497479	688	768	3	5	80	0.0625000
NODE_3243_length_1289_cov_18.497479	688	768	6	72	80	0.9000000
NODE_3243_length_1289_cov_18.497479	741	821	0	56	80	0.7000000
NODE_3243_length_1289_cov_18.497479	741	821	3	5	80	0.0625000
NODE_3243_length_1289_cov_18.497479	741	821	6	19	80	0.2375000
NODE_3243_length_1289_cov_18.497479	817	893	0	76	76	1.0000000
NODE_3243_length_1289_cov_18.497479	878	958	0	80	80	1.0000000
NODE_3244_length_1289_cov_11.692437	574	654	0	80	80	1.0000000
NODE_3244_length_1289_cov_11.692437	627	707	0	80	80	1.0000000
NODE_3244_length_1289_cov_11.692437	703	783	0	80	80	1.0000000
NODE_3244_length_1289_cov_11.692437	756	836	0	80	80	1.0000000
NODE_3249_length_1288_cov_29.369218	711	791	0	80	80	1.0000000
NODE_3249_length_1288_cov_29.369218	764	844	0	80	80	1.0000000
NODE_3250_length_1288_cov_6.207738	735	815	0	80	80	1.0000000
NODE_3250_length_1288_cov_6.207738	788	868	0	80	80	1.0000000
NODE_3255_length_1288_cov_1.731707	1017	1095	2	15	78	0.1923077
NODE_3255_length_1288_cov_1.731707	1017	1095	4	63	78	0.8076923
NODE_3261_length_1287_cov_29.186027	730	810	0	80	80	1.0000000
NODE_3261_length_1287_cov_29.186027	783	863	0	80	80	1.0000000
NODE_3262_length_1287_cov_22.747475	168	248	0	80	80	1.0000000
NODE_3262_length_1287_cov_22.747475	221	301	0	80	80	1.0000000
NODE_3263_length_1287_cov_19.478956	575	655	0	80	80	1.0000000
NODE_3263_length_1287_cov_19.478956	628	708	0	80	80	1.0000000
NODE_3266_length_1286_cov_27.128054	428	508	0	80	80	1.0000000
NODE_3266_length_1286_cov_27.128054	481	561	0	62	80	0.7750000
NODE_3266_length_1286_cov_27.128054	481	561	4	18	80	0.2250000
NODE_3266_length_1286_cov_27.128054	557	637	4	80	80	1.0000000
NODE_3266_length_1286_cov_27.128054	610	690	0	37	80	0.4625000
NODE_3266_length_1286_cov_27.128054	610	690	3	1	80	0.0125000
NODE_3266_length_1286_cov_27.128054	610	690	4	42	80	0.5250000
NODE_3267_length_1286_cov_12.192081	647	727	0	80	80	1.0000000
NODE_3267_length_1286_cov_12.192081	700	780	0	80	80	1.0000000
NODE_3267_length_1286_cov_12.192081	776	856	0	80	80	1.0000000
NODE_3267_length_1286_cov_12.192081	829	909	0	59	80	0.7375000
NODE_3267_length_1286_cov_12.192081	829	909	2	21	80	0.2625000
NODE_3268_length_1286_cov_8.338669	577	657	0	80	80	1.0000000
NODE_3268_length_1286_cov_8.338669	630	710	0	80	80	1.0000000
NODE_3273_length_1285_cov_40.282462	751	831	0	78	80	0.9750000
NODE_3273_length_1285_cov_40.282462	751	831	4	2	80	0.0250000
NODE_3273_length_1285_cov_40.282462	804	884	0	25	80	0.3125000
NODE_3273_length_1285_cov_40.282462	804	884	4	55	80	0.6875000
NODE_3274_length_1285_cov_15.422428	647	727	0	80	80	1.0000000
NODE_3274_length_1285_cov_15.422428	700	780	0	80	80	1.0000000
NODE_3275_length_1285_cov_6.620573	589	669	0	39	80	0.4875000
NODE_3275_length_1285_cov_6.620573	589	669	2	41	80	0.5125000
NODE_3275_length_1285_cov_6.620573	642	722	2	80	80	1.0000000
NODE_3279_length_1284_cov_5.637975	294	374	0	80	80	1.0000000
NODE_3279_length_1284_cov_5.637975	347	427	0	80	80	1.0000000
NODE_3283_length_1283_cov_10.070101	408	488	0	80	80	1.0000000
NODE_3283_length_1283_cov_10.070101	461	541	0	80	80	1.0000000
NODE_3288_length_1282_cov_37.786137	649	729	0	80	80	1.0000000
NODE_3288_length_1282_cov_37.786137	702	782	0	80	80	1.0000000
NODE_3288_length_1282_cov_37.786137	778	858	0	80	80	1.0000000
NODE_3288_length_1282_cov_37.786137	831	911	0	37	80	0.4625000
NODE_3288_length_1282_cov_37.786137	831	911	2	43	80	0.5375000
NODE_3289_length_1282_cov_25.900254	85	167	4	9	82	0.1097561
NODE_3289_length_1282_cov_25.900254	85	167	15	3	82	0.0365854
NODE_3289_length_1282_cov_25.900254	85	167	17	1	82	0.0121951
NODE_3289_length_1282_cov_25.900254	85	167	22	1	82	0.0121951
NODE_3289_length_1282_cov_25.900254	85	167	24	3	82	0.0365854
NODE_3289_length_1282_cov_25.900254	85	167	26	2	82	0.0243902
NODE_3289_length_1282_cov_25.900254	85	167	28	17	82	0.2073171
NODE_3289_length_1282_cov_25.900254	85	167	30	4	82	0.0487805
NODE_3289_length_1282_cov_25.900254	85	167	35	13	82	0.1585366
NODE_3289_length_1282_cov_25.900254	85	167	36	13	82	0.1585366
NODE_3289_length_1282_cov_25.900254	85	167	38	16	82	0.1951219
NODE_3289_length_1282_cov_25.900254	140	183	0	1	43	0.0232558
NODE_3289_length_1282_cov_25.900254	140	183	2	1	43	0.0232558
NODE_3289_length_1282_cov_25.900254	140	183	4	23	43	0.5348837
NODE_3289_length_1282_cov_25.900254	140	183	15	3	43	0.0697674
NODE_3289_length_1282_cov_25.900254	140	183	17	1	43	0.0232558
NODE_3289_length_1282_cov_25.900254	140	183	22	1	43	0.0232558
NODE_3289_length_1282_cov_25.900254	140	183	24	3	43	0.0697674
NODE_3289_length_1282_cov_25.900254	140	183	26	2	43	0.0465116
NODE_3289_length_1282_cov_25.900254	140	183	28	8	43	0.1860465
NODE_3289_length_1282_cov_25.900254	1006	1086	26	3	80	0.0375000
NODE_3289_length_1282_cov_25.900254	1006	1086	27	2	80	0.0250000
NODE_3289_length_1282_cov_25.900254	1006	1086	28	14	80	0.1750000
NODE_3289_length_1282_cov_25.900254	1006	1086	32	8	80	0.1000000
NODE_3289_length_1282_cov_25.900254	1006	1086	34	1	80	0.0125000
NODE_3289_length_1282_cov_25.900254	1006	1086	35	1	80	0.0125000
NODE_3289_length_1282_cov_25.900254	1006	1086	36	2	80	0.0250000
NODE_3289_length_1282_cov_25.900254	1006	1086	39	3	80	0.0375000
NODE_3289_length_1282_cov_25.900254	1006	1086	41	1	80	0.0125000
NODE_3289_length_1282_cov_25.900254	1006	1086	42	2	80	0.0250000
NODE_3289_length_1282_cov_25.900254	1006	1086	43	7	80	0.0875000
NODE_3289_length_1282_cov_25.900254	1006	1086	47	6	80	0.0750000
NODE_3289_length_1282_cov_25.900254	1006	1086	49	2	80	0.0250000
NODE_3289_length_1282_cov_25.900254	1006	1086	52	1	80	0.0125000
NODE_3289_length_1282_cov_25.900254	1006	1086	58	2	80	0.0250000
NODE_3289_length_1282_cov_25.900254	1006	1086	60	5	80	0.0625000
NODE_3289_length_1282_cov_25.900254	1006	1086	61	5	80	0.0625000
NODE_3289_length_1282_cov_25.900254	1006	1086	64	3	80	0.0375000
NODE_3289_length_1282_cov_25.900254	1006	1086	68	5	80	0.0625000
NODE_3289_length_1282_cov_25.900254	1006	1086	69	7	80	0.0875000
NODE_3289_length_1282_cov_25.900254	1006	1086	26	3	80	0.0375000
NODE_3289_length_1282_cov_25.900254	1006	1086	27	2	80	0.0250000
NODE_3289_length_1282_cov_25.900254	1006	1086	28	14	80	0.1750000
NODE_3289_length_1282_cov_25.900254	1006	1086	32	8	80	0.1000000
NODE_3289_length_1282_cov_25.900254	1006	1086	34	1	80	0.0125000
NODE_3289_length_1282_cov_25.900254	1006	1086	35	1	80	0.0125000
NODE_3289_length_1282_cov_25.900254	1006	1086	36	2	80	0.0250000
NODE_3289_length_1282_cov_25.900254	1006	1086	39	3	80	0.0375000
NODE_3289_length_1282_cov_25.900254	1006	1086	41	1	80	0.0125000
NODE_3289_length_1282_cov_25.900254	1006	1086	42	2	80	0.0250000
NODE_3289_length_1282_cov_25.900254	1006	1086	43	7	80	0.0875000
NODE_3289_length_1282_cov_25.900254	1006	1086	47	6	80	0.0750000
NODE_3289_length_1282_cov_25.900254	1006	1086	49	2	80	0.0250000
NODE_3289_length_1282_cov_25.900254	1006	1086	52	1	80	0.0125000
NODE_3289_length_1282_cov_25.900254	1006	1086	58	2	80	0.0250000
NODE_3289_length_1282_cov_25.900254	1006	1086	60	5	80	0.0625000
NODE_3289_length_1282_cov_25.900254	1006	1086	61	5	80	0.0625000
NODE_3289_length_1282_cov_25.900254	1006	1086	64	3	80	0.0375000
NODE_3289_length_1282_cov_25.900254	1006	1086	68	5	80	0.0625000
NODE_3289_length_1282_cov_25.900254	1006	1086	69	7	80	0.0875000
NODE_3289_length_1282_cov_25.900254	1015	1086	28	10	71	0.1408451
NODE_3289_length_1282_cov_25.900254	1015	1086	32	8	71	0.1126761
NODE_3289_length_1282_cov_25.900254	1015	1086	34	1	71	0.0140845
NODE_3289_length_1282_cov_25.900254	1015	1086	35	1	71	0.0140845
NODE_3289_length_1282_cov_25.900254	1015	1086	36	2	71	0.0281690
NODE_3289_length_1282_cov_25.900254	1015	1086	39	3	71	0.0422535
NODE_3289_length_1282_cov_25.900254	1015	1086	41	1	71	0.0140845
NODE_3289_length_1282_cov_25.900254	1015	1086	42	2	71	0.0281690
NODE_3289_length_1282_cov_25.900254	1015	1086	43	7	71	0.0985916
NODE_3289_length_1282_cov_25.900254	1015	1086	47	6	71	0.0845070
NODE_3289_length_1282_cov_25.900254	1015	1086	49	2	71	0.0281690
NODE_3289_length_1282_cov_25.900254	1015	1086	52	1	71	0.0140845
NODE_3289_length_1282_cov_25.900254	1015	1086	58	2	71	0.0281690
NODE_3289_length_1282_cov_25.900254	1015	1086	60	5	71	0.0704225
NODE_3289_length_1282_cov_25.900254	1015	1086	61	5	71	0.0704225
NODE_3289_length_1282_cov_25.900254	1015	1086	64	3	71	0.0422535
NODE_3289_length_1282_cov_25.900254	1015	1086	68	5	71	0.0704225
NODE_3289_length_1282_cov_25.900254	1015	1086	69	7	71	0.0985916
NODE_3290_length_1282_cov_14.600169	429	477	0	48	48	1.0000000
NODE_3290_length_1282_cov_14.600169	708	788	0	28	80	0.3500000
NODE_3290_length_1282_cov_14.600169	708	788	2	52	80	0.6500000
NODE_3291_length_1282_cov_8.017751	343	420	0	74	77	0.9610389
NODE_3291_length_1282_cov_8.017751	343	420	1	1	77	0.0129870
NODE_3291_length_1282_cov_8.017751	343	420	2	2	77	0.0259740
NODE_3292_length_1282_cov_5.092984	239	319	0	80	80	1.0000000
NODE_3292_length_1282_cov_5.092984	292	372	0	80	80	1.0000000
NODE_3295_length_1281_cov_31.342640	470	550	0	80	80	1.0000000
NODE_3295_length_1281_cov_31.342640	523	603	0	80	80	1.0000000
NODE_3295_length_1281_cov_31.342640	599	679	0	80	80	1.0000000
NODE_3295_length_1281_cov_31.342640	652	732	0	80	80	1.0000000
NODE_3296_length_1281_cov_25.482234	474	554	0	80	80	1.0000000
NODE_3296_length_1281_cov_25.482234	527	607	0	80	80	1.0000000
NODE_3297_length_1281_cov_14.617597	809	887	0	78	78	1.0000000
NODE_3297_length_1281_cov_14.617597	860	940	0	80	80	1.0000000
NODE_3298_length_1281_cov_12.065144	655	735	0	80	80	1.0000000
NODE_3298_length_1281_cov_12.065144	708	788	0	80	80	1.0000000
NODE_3299_length_1281_cov_9.235195	408	488	0	80	80	1.0000000
NODE_3299_length_1281_cov_9.235195	461	541	0	80	80	1.0000000
NODE_3300_length_1281_cov_7.153976	469	549	0	80	80	1.0000000
NODE_3300_length_1281_cov_7.153976	522	602	0	80	80	1.0000000
NODE_3307_length_1280_cov_24.231160	418	498	0	80	80	1.0000000
NODE_3307_length_1280_cov_24.231160	471	551	0	80	80	1.0000000
NODE_3307_length_1280_cov_24.231160	547	627	0	6	80	0.0750000
NODE_3307_length_1280_cov_24.231160	547	627	2	5	80	0.0625000
NODE_3307_length_1280_cov_24.231160	547	627	6	69	80	0.8625000
NODE_3307_length_1280_cov_24.231160	600	680	2	35	80	0.4375000
NODE_3307_length_1280_cov_24.231160	600	680	6	45	80	0.5625000
NODE_3308_length_1280_cov_5.908552	1077	1138	4	1	61	0.0163934
NODE_3308_length_1280_cov_5.908552	1077	1138	8	4	61	0.0655738
NODE_3308_length_1280_cov_5.908552	1077	1138	10	2	61	0.0327869
NODE_3308_length_1280_cov_5.908552	1077	1138	13	1	61	0.0163934
NODE_3308_length_1280_cov_5.908552	1077	1138	15	2	61	0.0327869
NODE_3308_length_1280_cov_5.908552	1077	1138	19	4	61	0.0655738
NODE_3308_length_1280_cov_5.908552	1077	1138	20	1	61	0.0163934
NODE_3308_length_1280_cov_5.908552	1077	1138	21	1	61	0.0163934
NODE_3308_length_1280_cov_5.908552	1077	1138	22	16	61	0.2622951
NODE_3308_length_1280_cov_5.908552	1077	1138	28	2	61	0.0327869
NODE_3308_length_1280_cov_5.908552	1077	1138	29	12	61	0.1967213
NODE_3308_length_1280_cov_5.908552	1077	1138	31	1	61	0.0163934
NODE_3308_length_1280_cov_5.908552	1077	1138	36	3	61	0.0491803
NODE_3308_length_1280_cov_5.908552	1077	1138	37	11	61	0.1803279
NODE_3311_length_1279_cov_16.840678	749	829	0	80	80	1.0000000
NODE_3311_length_1279_cov_16.840678	802	882	0	80	80	1.0000000
NODE_3312_length_1279_cov_3.772881	951	981	0	2	30	0.0666667
NODE_3312_length_1279_cov_3.772881	951	981	1	25	30	0.8333333
NODE_3312_length_1279_cov_3.772881	951	981	2	3	30	0.1000000
NODE_3317_length_1278_cov_45.991518	411	491	0	80	80	1.0000000
NODE_3317_length_1278_cov_45.991518	464	530	0	66	66	1.0000000
NODE_3318_length_1278_cov_37.164546	447	527	0	80	80	1.0000000
NODE_3318_length_1278_cov_37.164546	500	580	0	80	80	1.0000000
NODE_3318_length_1278_cov_37.164546	576	656	0	80	80	1.0000000
NODE_3318_length_1278_cov_37.164546	629	709	0	80	80	1.0000000
NODE_3319_length_1278_cov_12.505513	522	602	0	38	80	0.4750000
NODE_3319_length_1278_cov_12.505513	522	602	2	42	80	0.5250000
NODE_3319_length_1278_cov_12.505513	575	655	0	5	80	0.0625000
NODE_3319_length_1278_cov_12.505513	575	655	2	75	80	0.9375000
NODE_3320_length_1278_cov_12.171332	212	292	0	10	80	0.1250000
NODE_3320_length_1278_cov_12.171332	212	292	2	70	80	0.8750000
NODE_3320_length_1278_cov_12.171332	265	344	0	62	79	0.7848101
NODE_3320_length_1278_cov_12.171332	265	344	2	17	79	0.2151899
NODE_3329_length_1277_cov_21.407470	667	717	6	50	50	1.0000000
NODE_3329_length_1277_cov_21.407470	690	770	5	4	80	0.0500000
NODE_3329_length_1277_cov_21.407470	690	770	6	45	80	0.5625000
NODE_3329_length_1277_cov_21.407470	690	770	8	31	80	0.3875000
NODE_3330_length_1277_cov_18.111205	834	914	0	23	80	0.2875000
NODE_3330_length_1277_cov_18.111205	834	914	1	2	80	0.0250000
NODE_3330_length_1277_cov_18.111205	834	914	2	55	80	0.6875000
NODE_3330_length_1277_cov_18.111205	887	967	0	23	80	0.2875000
NODE_3330_length_1277_cov_18.111205	887	967	1	28	80	0.3500000
NODE_3330_length_1277_cov_18.111205	887	967	2	29	80	0.3625000
NODE_3331_length_1277_cov_12.449066	276	356	0	80	80	1.0000000
NODE_3331_length_1277_cov_12.449066	329	409	0	80	80	1.0000000
NODE_3331_length_1277_cov_12.449066	405	485	0	80	80	1.0000000
NODE_3331_length_1277_cov_12.449066	458	538	0	80	80	1.0000000
NODE_3337_length_1276_cov_21.446899	526	606	4	80	80	1.0000000
NODE_3337_length_1276_cov_21.446899	579	659	0	50	80	0.6250000
NODE_3337_length_1276_cov_21.446899	579	659	4	30	80	0.3750000
NODE_3337_length_1276_cov_21.446899	655	735	0	80	80	1.0000000
NODE_3337_length_1276_cov_21.446899	708	788	0	80	80	1.0000000
NODE_3346_length_1275_cov_35.471939	632	712	7	23	80	0.2875000
NODE_3346_length_1275_cov_35.471939	632	712	8	50	80	0.6250000
NODE_3346_length_1275_cov_35.471939	632	712	9	7	80	0.0875000
NODE_3346_length_1275_cov_35.471939	685	765	1	5	80	0.0625000
NODE_3346_length_1275_cov_35.471939	685	765	2	43	80	0.5375000
NODE_3346_length_1275_cov_35.471939	685	765	8	32	80	0.4000000
NODE_3347_length_1275_cov_19.910714	361	441	0	41	80	0.5125000
NODE_3347_length_1275_cov_19.910714	361	441	5	32	80	0.4000000
NODE_3347_length_1275_cov_19.910714	361	441	9	1	80	0.0125000
NODE_3347_length_1275_cov_19.910714	361	441	10	6	80	0.0750000
NODE_3347_length_1275_cov_19.910714	414	494	5	20	80	0.2500000
NODE_3347_length_1275_cov_19.910714	414	494	9	1	80	0.0125000
NODE_3347_length_1275_cov_19.910714	414	494	10	59	80	0.7375000
NODE_3347_length_1275_cov_19.910714	879	949	3	13	70	0.1857143
NODE_3347_length_1275_cov_19.910714	879	949	4	29	70	0.4142857
NODE_3347_length_1275_cov_19.910714	879	949	6	28	70	0.4000000
NODE_3351_length_1274_cov_23.404255	427	507	0	80	80	1.0000000
NODE_3351_length_1274_cov_23.404255	480	560	0	80	80	1.0000000
NODE_3351_length_1274_cov_23.404255	556	636	0	80	80	1.0000000
NODE_3351_length_1274_cov_23.404255	609	689	0	80	80	1.0000000
NODE_3352_length_1274_cov_20.178723	545	625	0	80	80	1.0000000
NODE_3352_length_1274_cov_20.178723	598	678	0	80	80	1.0000000
NODE_3354_length_1274_cov_2.019574	841	907	0	20	66	0.3030303
NODE_3354_length_1274_cov_2.019574	841	907	4	46	66	0.6969697
NODE_3354_length_1274_cov_2.019574	894	961	0	67	67	1.0000000
NODE_3361_length_1273_cov_42.349233	337	417	0	80	80	1.0000000
NODE_3361_length_1273_cov_42.349233	390	470	0	80	80	1.0000000
NODE_3361_length_1273_cov_42.349233	466	546	0	80	80	1.0000000
NODE_3361_length_1273_cov_42.349233	519	599	0	80	80	1.0000000
NODE_3364_length_1273_cov_4.404600	407	487	0	20	80	0.2500000
NODE_3364_length_1273_cov_4.404600	407	487	2	60	80	0.7500000
NODE_3364_length_1273_cov_4.404600	460	540	0	73	80	0.9125000
NODE_3364_length_1273_cov_4.404600	460	540	2	7	80	0.0875000
NODE_3368_length_1272_cov_28.887468	588	668	0	21	80	0.2625000
NODE_3368_length_1272_cov_28.887468	588	668	4	50	80	0.6250000
NODE_3368_length_1272_cov_28.887468	588	668	6	9	80	0.1125000
NODE_3368_length_1272_cov_28.887468	641	721	0	3	80	0.0375000
NODE_3368_length_1272_cov_28.887468	641	721	2	2	80	0.0250000
NODE_3368_length_1272_cov_28.887468	641	721	4	18	80	0.2250000
NODE_3368_length_1272_cov_28.887468	641	721	6	57	80	0.7125000
NODE_3369_length_1272_cov_11.290708	366	447	2	21	81	0.2592593
NODE_3369_length_1272_cov_11.290708	366	447	4	60	81	0.7407407
NODE_3375_length_1270_cov_13.617421	365	445	0	80	80	1.0000000
NODE_3375_length_1270_cov_13.617421	396	473	0	77	77	1.0000000
NODE_3375_length_1270_cov_13.617421	418	498	0	80	80	1.0000000
NODE_3375_length_1270_cov_13.617421	449	473	0	24	24	1.0000000
NODE_3375_length_1270_cov_13.617421	465	498	0	33	33	1.0000000
NODE_3376_length_1270_cov_11.645602	294	374	0	80	80	1.0000000
NODE_3376_length_1270_cov_11.645602	347	427	0	80	80	1.0000000
NODE_3377_length_1270_cov_2.495303	74	131	8	7	57	0.1228070
NODE_3377_length_1270_cov_2.495303	74	131	10	1	57	0.0175439
NODE_3377_length_1270_cov_2.495303	74	131	12	11	57	0.1929825
NODE_3377_length_1270_cov_2.495303	74	131	14	22	57	0.3859649
NODE_3377_length_1270_cov_2.495303	74	131	16	16	57	0.2807018
NODE_3378_length_1269_cov_55.070940	492	569	1	69	77	0.8961039
NODE_3378_length_1269_cov_55.070940	492	569	2	8	77	0.1038961
NODE_3378_length_1269_cov_55.070940	545	625	1	65	80	0.8125000
NODE_3378_length_1269_cov_55.070940	545	625	2	15	80	0.1875000
NODE_3378_length_1269_cov_55.070940	621	701	1	80	80	1.0000000
NODE_3378_length_1269_cov_55.070940	674	754	0	42	80	0.5250000
NODE_3378_length_1269_cov_55.070940	674	754	1	38	80	0.4750000
NODE_3379_length_1269_cov_22.154701	1152	1216	14	64	64	1.0000000
NODE_3379_length_1269_cov_22.154701	1152	1216	14	64	64	1.0000000
NODE_3379_length_1269_cov_22.154701	1152	1216	14	64	64	1.0000000
NODE_3379_length_1269_cov_22.154701	1189	1269	0	7	80	0.0875000
NODE_3379_length_1269_cov_22.154701	1189	1269	2	3	80	0.0375000
NODE_3379_length_1269_cov_22.154701	1189	1269	8	34	80	0.4250000
NODE_3379_length_1269_cov_22.154701	1189	1269	14	36	80	0.4500000
NODE_3379_length_1269_cov_22.154701	1189	1269	0	7	80	0.0875000
NODE_3379_length_1269_cov_22.154701	1189	1269	2	3	80	0.0375000
NODE_3379_length_1269_cov_22.154701	1189	1269	8	34	80	0.4250000
NODE_3379_length_1269_cov_22.154701	1189	1269	14	36	80	0.4500000
NODE_3380_length_1269_cov_18.753846	317	398	0	71	81	0.8765432
NODE_3380_length_1269_cov_18.753846	317	398	2	10	81	0.1234568
NODE_3381_length_1269_cov_12.637607	580	660	0	37	80	0.4625000
NODE_3381_length_1269_cov_12.637607	580	660	2	43	80	0.5375000
NODE_3381_length_1269_cov_12.637607	633	713	0	80	80	1.0000000
NODE_3381_length_1269_cov_12.637607	709	729	0	20	20	1.0000000
NODE_3381_length_1269_cov_12.637607	709	789	0	80	80	1.0000000
NODE_3381_length_1269_cov_12.637607	762	842	0	80	80	1.0000000
NODE_3382_length_1269_cov_10.552137	765	845	0	80	80	1.0000000
NODE_3382_length_1269_cov_10.552137	818	898	0	80	80	1.0000000
NODE_3391_length_1268_cov_12.862275	300	350	34	2	50	0.0400000
NODE_3391_length_1268_cov_12.862275	300	350	36	1	50	0.0200000
NODE_3391_length_1268_cov_12.862275	300	350	44	4	50	0.0800000
NODE_3391_length_1268_cov_12.862275	300	350	46	1	50	0.0200000
NODE_3391_length_1268_cov_12.862275	300	350	51	1	50	0.0200000
NODE_3391_length_1268_cov_12.862275	300	350	52	4	50	0.0800000
NODE_3391_length_1268_cov_12.862275	300	350	53	1	50	0.0200000
NODE_3391_length_1268_cov_12.862275	300	350	59	2	50	0.0400000
NODE_3391_length_1268_cov_12.862275	300	350	66	4	50	0.0800000
NODE_3391_length_1268_cov_12.862275	300	350	70	2	50	0.0400000
NODE_3391_length_1268_cov_12.862275	300	350	74	4	50	0.0800000
NODE_3391_length_1268_cov_12.862275	300	350	76	1	50	0.0200000
NODE_3391_length_1268_cov_12.862275	300	350	80	8	50	0.1600000
NODE_3391_length_1268_cov_12.862275	300	350	86	1	50	0.0200000
NODE_3391_length_1268_cov_12.862275	300	350	88	1	50	0.0200000
NODE_3391_length_1268_cov_12.862275	300	350	90	1	50	0.0200000
NODE_3391_length_1268_cov_12.862275	300	350	91	1	50	0.0200000
NODE_3391_length_1268_cov_12.862275	300	350	93	1	50	0.0200000
NODE_3391_length_1268_cov_12.862275	300	350	96	1	50	0.0200000
NODE_3391_length_1268_cov_12.862275	300	350	101	1	50	0.0200000
NODE_3391_length_1268_cov_12.862275	300	350	102	3	50	0.0600000
NODE_3391_length_1268_cov_12.862275	300	350	106	3	50	0.0600000
NODE_3391_length_1268_cov_12.862275	300	350	108	2	50	0.0400000
NODE_3392_length_1268_cov_9.523524	265	345	0	80	80	1.0000000
NODE_3392_length_1268_cov_9.523524	318	398	0	80	80	1.0000000
NODE_3393_length_1267_cov_21.315068	299	379	0	77	80	0.9625000
NODE_3393_length_1267_cov_21.315068	299	379	6	3	80	0.0375000
NODE_3393_length_1267_cov_21.315068	352	432	0	24	80	0.3000000
NODE_3393_length_1267_cov_21.315068	352	432	6	18	80	0.2250000
NODE_3393_length_1267_cov_21.315068	352	432	8	38	80	0.4750000
NODE_3393_length_1267_cov_21.315068	698	778	0	80	80	1.0000000
NODE_3393_length_1267_cov_21.315068	751	831	0	80	80	1.0000000
NODE_3394_length_1267_cov_14.880137	606	686	0	24	80	0.3000000
NODE_3394_length_1267_cov_14.880137	606	686	4	56	80	0.7000000
NODE_3394_length_1267_cov_14.880137	659	739	0	77	80	0.9625000
NODE_3394_length_1267_cov_14.880137	659	739	4	3	80	0.0375000
NODE_3397_length_1266_cov_20.584404	357	437	0	80	80	1.0000000
NODE_3397_length_1266_cov_20.584404	410	490	0	80	80	1.0000000
NODE_3398_length_1266_cov_16.571551	359	435	0	76	76	1.0000000
NODE_3398_length_1266_cov_16.571551	408	488	0	80	80	1.0000000
NODE_3399_length_1266_cov_14.218509	517	595	0	78	78	1.0000000
NODE_3399_length_1266_cov_14.218509	568	648	0	80	80	1.0000000
NODE_3399_length_1266_cov_14.218509	644	724	0	61	80	0.7625000
NODE_3399_length_1266_cov_14.218509	644	724	2	19	80	0.2375000
NODE_3399_length_1266_cov_14.218509	697	777	0	35	80	0.4375000
NODE_3399_length_1266_cov_14.218509	697	777	2	45	80	0.5625000
NODE_3403_length_1265_cov_9.807890	429	509	0	65	80	0.8125000
NODE_3403_length_1265_cov_9.807890	429	509	2	15	80	0.1875000
NODE_3403_length_1265_cov_9.807890	482	562	0	12	80	0.1500000
NODE_3403_length_1265_cov_9.807890	482	562	2	68	80	0.8500000
NODE_3404_length_1265_cov_8.233276	160	207	4	47	47	1.0000000
NODE_3404_length_1265_cov_8.233276	1004	1058	6	54	54	1.0000000
NODE_3406_length_1265_cov_3.941681	503	583	0	80	80	1.0000000
NODE_3406_length_1265_cov_3.941681	556	636	0	80	80	1.0000000
NODE_3408_length_1264_cov_8.024034	290	370	0	80	80	1.0000000
NODE_3408_length_1264_cov_8.024034	343	423	0	80	80	1.0000000
NODE_3413_length_1263_cov_8.566151	698	778	0	6	80	0.0750000
NODE_3413_length_1263_cov_8.566151	698	778	4	74	80	0.9250000
NODE_3413_length_1263_cov_8.566151	751	831	0	59	80	0.7375000
NODE_3413_length_1263_cov_8.566151	751	831	4	21	80	0.2625000
NODE_3413_length_1263_cov_8.566151	833	910	0	57	77	0.7402598
NODE_3413_length_1263_cov_8.566151	833	910	4	20	77	0.2597403
NODE_3413_length_1263_cov_8.566151	883	963	0	7	80	0.0875000
NODE_3413_length_1263_cov_8.566151	883	963	4	73	80	0.9125000
NODE_3414_length_1263_cov_7.376289	1060	1140	0	80	80	1.0000000
NODE_3414_length_1263_cov_7.376289	1113	1213	0	100	100	1.0000000
NODE_3416_length_1263_cov_1.827320	227	307	0	80	80	1.0000000
NODE_3416_length_1263_cov_1.827320	280	360	0	80	80	1.0000000
NODE_3418_length_1262_cov_17.416165	404	484	0	80	80	1.0000000
NODE_3418_length_1262_cov_17.416165	457	537	0	80	80	1.0000000
NODE_3419_length_1262_cov_15.268272	648	728	0	80	80	1.0000000
NODE_3419_length_1262_cov_15.268272	701	781	0	80	80	1.0000000
NODE_3419_length_1262_cov_15.268272	777	857	0	80	80	1.0000000
NODE_3419_length_1262_cov_15.268272	830	910	0	80	80	1.0000000
NODE_3424_length_1261_cov_1.777969	272	318	0	46	46	1.0000000
NODE_3425_length_1260_cov_55.640827	499	579	0	17	80	0.2125000
NODE_3425_length_1260_cov_55.640827	499	579	4	63	80	0.7875000
NODE_3425_length_1260_cov_55.640827	552	632	0	70	80	0.8750000
NODE_3425_length_1260_cov_55.640827	552	632	4	10	80	0.1250000
NODE_3425_length_1260_cov_55.640827	628	708	0	72	80	0.9000000
NODE_3425_length_1260_cov_55.640827	628	708	1	8	80	0.1000000
NODE_3425_length_1260_cov_55.640827	681	761	0	19	80	0.2375000
NODE_3425_length_1260_cov_55.640827	681	761	1	61	80	0.7625000
NODE_3426_length_1260_cov_12.242894	427	507	0	80	80	1.0000000
NODE_3426_length_1260_cov_12.242894	480	560	0	80	80	1.0000000
NODE_3436_length_1259_cov_15.381897	509	589	0	27	80	0.3375000
NODE_3436_length_1259_cov_15.381897	509	589	3	1	80	0.0125000
NODE_3436_length_1259_cov_15.381897	509	589	4	52	80	0.6500000
NODE_3436_length_1259_cov_15.381897	562	642	0	80	80	1.0000000
NODE_3439_length_1258_cov_33.519413	608	688	0	19	80	0.2375000
NODE_3439_length_1258_cov_33.519413	608	688	2	2	80	0.0250000
NODE_3439_length_1258_cov_33.519413	608	688	4	59	80	0.7375000
NODE_3439_length_1258_cov_33.519413	661	741	0	72	80	0.9000000
NODE_3439_length_1258_cov_33.519413	661	741	2	2	80	0.0250000
NODE_3439_length_1258_cov_33.519413	661	741	4	6	80	0.0750000
NODE_3440_length_1258_cov_22.569456	583	663	0	80	80	1.0000000
NODE_3440_length_1258_cov_22.569456	636	716	0	80	80	1.0000000
NODE_3441_length_1258_cov_18.747196	308	388	0	80	80	1.0000000
NODE_3441_length_1258_cov_18.747196	361	441	0	80	80	1.0000000
NODE_3441_length_1258_cov_18.747196	437	517	0	80	80	1.0000000
NODE_3441_length_1258_cov_18.747196	490	570	0	80	80	1.0000000
NODE_3442_length_1258_cov_13.699741	332	412	0	80	80	1.0000000
NODE_3442_length_1258_cov_13.699741	385	465	0	80	80	1.0000000
NODE_3447_length_1257_cov_34.029361	567	647	0	80	80	1.0000000
NODE_3447_length_1257_cov_34.029361	620	700	0	80	80	1.0000000
NODE_3447_length_1257_cov_34.029361	696	776	0	80	80	1.0000000
NODE_3447_length_1257_cov_34.029361	749	829	0	80	80	1.0000000
NODE_3449_length_1257_cov_7.892919	317	397	0	80	80	1.0000000
NODE_3449_length_1257_cov_7.892919	370	450	0	80	80	1.0000000
NODE_3452_length_1256_cov_50.506482	389	469	0	80	80	1.0000000
NODE_3452_length_1256_cov_50.506482	442	522	0	80	80	1.0000000
NODE_3452_length_1256_cov_50.506482	518	598	0	80	80	1.0000000
NODE_3452_length_1256_cov_50.506482	571	651	0	80	80	1.0000000
NODE_3453_length_1256_cov_25.944685	754	834	1	80	80	1.0000000
NODE_3453_length_1256_cov_25.944685	807	887	1	32	80	0.4000000
NODE_3453_length_1256_cov_25.944685	807	887	2	48	80	0.6000000
NODE_3455_length_1256_cov_21.720830	713	793	0	80	80	1.0000000
NODE_3455_length_1256_cov_21.720830	766	846	0	80	80	1.0000000
NODE_3456_length_1256_cov_14.242005	595	675	0	80	80	1.0000000
NODE_3456_length_1256_cov_14.242005	648	728	0	80	80	1.0000000
NODE_3457_length_1256_cov_5.870354	879	959	0	80	80	1.0000000
NODE_3463_length_1255_cov_37.271626	458	538	0	80	80	1.0000000
NODE_3463_length_1255_cov_37.271626	511	591	0	80	80	1.0000000
NODE_3463_length_1255_cov_37.271626	587	667	0	5	80	0.0625000
NODE_3463_length_1255_cov_37.271626	587	667	4	75	80	0.9375000
NODE_3463_length_1255_cov_37.271626	640	720	0	27	80	0.3375000
NODE_3463_length_1255_cov_37.271626	640	720	4	53	80	0.6625000
NODE_3464_length_1255_cov_21.374567	516	596	0	80	80	1.0000000
NODE_3464_length_1255_cov_21.374567	569	649	0	80	80	1.0000000
NODE_3464_length_1255_cov_21.374567	645	725	0	80	80	1.0000000
NODE_3464_length_1255_cov_21.374567	698	778	0	80	80	1.0000000
NODE_3465_length_1255_cov_18.391869	521	601	0	80	80	1.0000000
NODE_3465_length_1255_cov_18.391869	574	654	0	80	80	1.0000000
NODE_3466_length_1255_cov_4.096021	1194	1242	0	48	48	1.0000000
NODE_3469_length_1254_cov_32.470996	612	692	0	80	80	1.0000000
NODE_3469_length_1254_cov_32.470996	665	745	0	80	80	1.0000000
NODE_3470_length_1254_cov_26.449351	488	568	0	80	80	1.0000000
NODE_3470_length_1254_cov_26.449351	541	621	0	80	80	1.0000000
NODE_3471_length_1254_cov_22.032035	531	611	0	80	80	1.0000000
NODE_3471_length_1254_cov_22.032035	584	664	0	80	80	1.0000000
NODE_3479_length_1253_cov_16.916811	651	731	0	80	80	1.0000000
NODE_3479_length_1253_cov_16.916811	704	784	0	66	80	0.8250000
NODE_3479_length_1253_cov_16.916811	704	784	1	4	80	0.0500000
NODE_3479_length_1253_cov_16.916811	704	784	2	10	80	0.1250000
NODE_3479_length_1253_cov_16.916811	780	860	2	80	80	1.0000000
NODE_3479_length_1253_cov_16.916811	833	913	2	80	80	1.0000000
NODE_3480_length_1253_cov_13.816291	811	891	0	67	80	0.8375000
NODE_3480_length_1253_cov_13.816291	811	891	2	13	80	0.1625000
NODE_3481_length_1253_cov_9.067591	306	386	8	80	80	1.0000000
NODE_3481_length_1253_cov_9.067591	359	439	0	47	80	0.5875000
NODE_3481_length_1253_cov_9.067591	359	439	7	1	80	0.0125000
NODE_3481_length_1253_cov_9.067591	359	439	8	32	80	0.4000000
NODE_3487_length_1252_cov_57.745880	477	557	0	80	80	1.0000000
NODE_3487_length_1252_cov_57.745880	530	610	0	80	80	1.0000000
NODE_3487_length_1252_cov_57.745880	606	686	0	80	80	1.0000000
NODE_3487_length_1252_cov_57.745880	659	739	0	80	80	1.0000000
NODE_3488_length_1252_cov_56.694709	594	674	0	80	80	1.0000000
NODE_3488_length_1252_cov_56.694709	647	727	0	63	80	0.7875000
NODE_3488_length_1252_cov_56.694709	647	727	4	17	80	0.2125000
NODE_3488_length_1252_cov_56.694709	723	803	4	80	80	1.0000000
NODE_3488_length_1252_cov_56.694709	785	847	0	39	62	0.6290323
NODE_3488_length_1252_cov_56.694709	785	847	4	23	62	0.3709677
NODE_3489_length_1252_cov_34.023417	468	548	0	80	80	1.0000000
NODE_3489_length_1252_cov_34.023417	521	601	0	80	80	1.0000000
NODE_3489_length_1252_cov_34.023417	597	677	0	80	80	1.0000000
NODE_3489_length_1252_cov_34.023417	650	730	0	80	80	1.0000000
NODE_3490_length_1252_cov_9.316565	573	653	0	80	80	1.0000000
NODE_3490_length_1252_cov_9.316565	626	706	0	80	80	1.0000000
NODE_3491_length_1252_cov_8.295750	602	682	0	80	80	1.0000000
NODE_3491_length_1252_cov_8.295750	655	735	0	80	80	1.0000000
NODE_3494_length_1251_cov_17.513889	579	659	0	80	80	1.0000000
NODE_3494_length_1251_cov_17.513889	632	712	0	80	80	1.0000000
NODE_3494_length_1251_cov_17.513889	708	788	0	80	80	1.0000000
NODE_3494_length_1251_cov_17.513889	761	841	0	80	80	1.0000000
NODE_3497_length_1251_cov_3.139757	0	76	0	76	76	1.0000000
NODE_3497_length_1251_cov_3.139757	49	98	0	47	49	0.9591837
NODE_3497_length_1251_cov_3.139757	49	98	6	2	49	0.0408163
NODE_3501_length_1250_cov_25.133797	325	405	0	80	80	1.0000000
NODE_3501_length_1250_cov_25.133797	378	458	0	80	80	1.0000000
NODE_3503_length_1250_cov_11.471764	652	733	0	27	81	0.3333333
NODE_3503_length_1250_cov_11.471764	652	733	2	54	81	0.6666667
NODE_3503_length_1250_cov_11.471764	706	786	0	9	80	0.1125000
NODE_3503_length_1250_cov_11.471764	706	786	2	71	80	0.8875000
NODE_3505_length_1249_cov_45.772174	543	623	0	55	80	0.6875000
NODE_3505_length_1249_cov_45.772174	543	623	4	25	80	0.3125000
NODE_3505_length_1249_cov_45.772174	596	676	0	80	80	1.0000000
NODE_3505_length_1249_cov_45.772174	672	749	0	77	77	1.0000000
NODE_3505_length_1249_cov_45.772174	729	802	0	73	73	1.0000000
NODE_3506_length_1249_cov_35.670435	515	595	0	80	80	1.0000000
NODE_3506_length_1249_cov_35.670435	568	648	0	80	80	1.0000000
NODE_3506_length_1249_cov_35.670435	644	724	0	80	80	1.0000000
NODE_3506_length_1249_cov_35.670435	697	777	0	80	80	1.0000000
NODE_3507_length_1249_cov_34.616522	576	656	0	70	80	0.8750000
NODE_3507_length_1249_cov_34.616522	576	656	2	10	80	0.1250000
NODE_3507_length_1249_cov_34.616522	629	709	0	17	80	0.2125000
NODE_3507_length_1249_cov_34.616522	629	709	2	63	80	0.7875000
NODE_3507_length_1249_cov_34.616522	705	785	0	64	80	0.8000000
NODE_3507_length_1249_cov_34.616522	705	785	2	16	80	0.2000000
NODE_3507_length_1249_cov_34.616522	758	838	0	80	80	1.0000000
NODE_3508_length_1249_cov_19.592174	461	541	0	14	80	0.1750000
NODE_3508_length_1249_cov_19.592174	461	541	2	66	80	0.8250000
NODE_3508_length_1249_cov_19.592174	514	594	0	67	80	0.8375000
NODE_3508_length_1249_cov_19.592174	514	594	2	13	80	0.1625000
NODE_3508_length_1249_cov_19.592174	860	940	0	80	80	1.0000000
NODE_3508_length_1249_cov_19.592174	913	993	0	80	80	1.0000000
NODE_3509_length_1249_cov_14.926957	1153	1219	0	66	66	1.0000000
NODE_3509_length_1249_cov_14.926957	1192	1249	0	57	57	1.0000000
NODE_3509_length_1249_cov_14.926957	1192	1247	0	55	55	1.0000000
NODE_3509_length_1249_cov_14.926957	1192	1249	0	57	57	1.0000000
NODE_3510_length_1249_cov_7.682609	757	837	0	80	80	1.0000000
NODE_3510_length_1249_cov_7.682609	810	890	0	80	80	1.0000000
NODE_3514_length_1248_cov_14.351610	469	549	0	80	80	1.0000000
NODE_3514_length_1248_cov_14.351610	522	602	0	80	80	1.0000000
NODE_3514_length_1248_cov_14.351610	598	678	0	80	80	1.0000000
NODE_3514_length_1248_cov_14.351610	651	731	0	80	80	1.0000000
NODE_3515_length_1248_cov_11.181027	303	383	0	80	80	1.0000000
NODE_3515_length_1248_cov_11.181027	356	436	0	80	80	1.0000000
NODE_3515_length_1248_cov_11.181027	432	512	0	80	80	1.0000000
NODE_3515_length_1248_cov_11.181027	485	565	0	80	80	1.0000000
NODE_3516_length_1248_cov_4.372498	17	98	0	81	81	1.0000000
NODE_3516_length_1248_cov_4.372498	94	152	0	58	58	1.0000000
NODE_3517_length_1248_cov_2.356832	952	1032	0	80	80	1.0000000
NODE_3517_length_1248_cov_2.356832	1005	1085	0	45	80	0.5625000
NODE_3517_length_1248_cov_2.356832	1005	1085	2	35	80	0.4375000
NODE_3518_length_1248_cov_2.283725	1102	1151	0	49	49	1.0000000
NODE_3522_length_1247_cov_25.355401	487	567	0	80	80	1.0000000
NODE_3522_length_1247_cov_25.355401	540	620	0	80	80	1.0000000
NODE_3522_length_1247_cov_25.355401	616	696	0	80	80	1.0000000
NODE_3522_length_1247_cov_25.355401	669	749	0	80	80	1.0000000
NODE_3528_length_1246_cov_30.231909	433	513	0	10	80	0.1250000
NODE_3528_length_1246_cov_30.231909	433	513	2	70	80	0.8750000
NODE_3528_length_1246_cov_30.231909	486	566	0	63	80	0.7875000
NODE_3528_length_1246_cov_30.231909	486	566	2	17	80	0.2125000
NODE_3528_length_1246_cov_30.231909	562	642	0	64	80	0.8000000
NODE_3528_length_1246_cov_30.231909	562	642	8	1	80	0.0125000
NODE_3528_length_1246_cov_30.231909	562	642	9	15	80	0.1875000
NODE_3528_length_1246_cov_30.231909	615	695	0	11	80	0.1375000
NODE_3528_length_1246_cov_30.231909	615	695	8	17	80	0.2125000
NODE_3528_length_1246_cov_30.231909	615	695	9	52	80	0.6500000
NODE_3529_length_1246_cov_13.847428	497	577	0	80	80	1.0000000
NODE_3529_length_1246_cov_13.847428	550	630	0	80	80	1.0000000
NODE_3535_length_1245_cov_31.472949	443	523	0	80	80	1.0000000
NODE_3535_length_1245_cov_31.472949	496	576	0	80	80	1.0000000
NODE_3536_length_1245_cov_30.068935	771	841	0	70	70	1.0000000
NODE_3537_length_1245_cov_24.765271	668	748	0	80	80	1.0000000
NODE_3537_length_1245_cov_24.765271	721	801	0	80	80	1.0000000
NODE_3537_length_1245_cov_24.765271	797	877	0	80	80	1.0000000
NODE_3537_length_1245_cov_24.765271	850	930	0	80	80	1.0000000
NODE_3538_length_1245_cov_16.854276	655	735	0	80	80	1.0000000
NODE_3538_length_1245_cov_16.854276	701	771	0	70	70	1.0000000
NODE_3538_length_1245_cov_16.854276	708	788	0	80	80	1.0000000
NODE_3540_length_1245_cov_1.187609	1148	1194	2	46	46	1.0000000
NODE_3540_length_1245_cov_1.187609	1167	1245	0	23	78	0.2948718
NODE_3540_length_1245_cov_1.187609	1167	1245	2	55	78	0.7051282
NODE_3541_length_1244_cov_52.633188	501	581	0	80	80	1.0000000
NODE_3541_length_1244_cov_52.633188	554	634	0	80	80	1.0000000
NODE_3541_length_1244_cov_52.633188	630	710	0	80	80	1.0000000
NODE_3541_length_1244_cov_52.633188	683	763	0	80	80	1.0000000
NODE_3542_length_1244_cov_33.889956	445	525	4	11	80	0.1375000
NODE_3542_length_1244_cov_33.889956	445	525	8	69	80	0.8625000
NODE_3542_length_1244_cov_33.889956	498	578	0	34	80	0.4250000
NODE_3542_length_1244_cov_33.889956	498	578	4	30	80	0.3750000
NODE_3542_length_1244_cov_33.889956	498	578	8	16	80	0.2000000
NODE_3542_length_1244_cov_33.889956	574	654	0	80	80	1.0000000
NODE_3542_length_1244_cov_33.889956	627	707	0	80	80	1.0000000
NODE_3543_length_1244_cov_16.798253	644	724	0	80	80	1.0000000
NODE_3543_length_1244_cov_16.798253	697	777	0	80	80	1.0000000
NODE_3544_length_1244_cov_1.735371	276	347	0	71	71	1.0000000
NODE_3544_length_1244_cov_1.735371	276	347	0	71	71	1.0000000
NODE_3544_length_1244_cov_1.735371	320	400	0	80	80	1.0000000
NODE_3544_length_1244_cov_1.735371	320	400	0	80	80	1.0000000
NODE_3548_length_1243_cov_34.284965	774	854	0	80	80	1.0000000
NODE_3548_length_1243_cov_34.284965	827	907	0	80	80	1.0000000
NODE_3552_length_1242_cov_29.665792	539	619	0	80	80	1.0000000
NODE_3552_length_1242_cov_29.665792	592	672	0	80	80	1.0000000
NODE_3553_length_1242_cov_28.304462	506	586	0	80	80	1.0000000
NODE_3553_length_1242_cov_28.304462	559	639	0	80	80	1.0000000
NODE_3553_length_1242_cov_28.304462	635	715	0	80	80	1.0000000
NODE_3553_length_1242_cov_28.304462	688	768	0	80	80	1.0000000
NODE_3554_length_1242_cov_16.383202	704	784	0	80	80	1.0000000
NODE_3554_length_1242_cov_16.383202	757	837	0	80	80	1.0000000
NODE_3555_length_1242_cov_8.081365	688	768	0	11	80	0.1375000
NODE_3555_length_1242_cov_8.081365	688	768	2	49	80	0.6125000
NODE_3555_length_1242_cov_8.081365	688	768	4	20	80	0.2500000
NODE_3555_length_1242_cov_8.081365	741	821	2	61	80	0.7625000
NODE_3555_length_1242_cov_8.081365	741	821	4	19	80	0.2375000
NODE_3561_length_1241_cov_36.544658	602	682	0	80	80	1.0000000
NODE_3561_length_1241_cov_36.544658	655	735	0	80	80	1.0000000
NODE_3562_length_1241_cov_19.894921	676	756	2	80	80	1.0000000
NODE_3562_length_1241_cov_19.894921	729	809	0	40	80	0.5000000
NODE_3562_length_1241_cov_19.894921	729	809	2	40	80	0.5000000
NODE_3569_length_1240_cov_38.375110	483	563	0	14	80	0.1750000
NODE_3569_length_1240_cov_38.375110	483	563	3	4	80	0.0500000
NODE_3569_length_1240_cov_38.375110	483	563	6	62	80	0.7750000
NODE_3569_length_1240_cov_38.375110	536	616	6	80	80	1.0000000
NODE_3569_length_1240_cov_38.375110	612	692	0	41	80	0.5125000
NODE_3569_length_1240_cov_38.375110	612	692	2	4	80	0.0500000
NODE_3569_length_1240_cov_38.375110	612	692	5	2	80	0.0250000
NODE_3569_length_1240_cov_38.375110	612	692	6	33	80	0.4125000
NODE_3569_length_1240_cov_38.375110	665	745	0	80	80	1.0000000
NODE_3570_length_1240_cov_24.975460	625	705	0	80	80	1.0000000
NODE_3570_length_1240_cov_24.975460	678	758	0	80	80	1.0000000
NODE_3571_length_1240_cov_23.812445	731	811	0	80	80	1.0000000
NODE_3571_length_1240_cov_23.812445	784	864	0	80	80	1.0000000
NODE_3576_length_1239_cov_37.657895	399	479	0	80	80	1.0000000
NODE_3576_length_1239_cov_37.657895	452	532	0	80	80	1.0000000
NODE_3576_length_1239_cov_37.657895	528	608	0	80	80	1.0000000
NODE_3576_length_1239_cov_37.657895	581	661	0	80	80	1.0000000
NODE_3577_length_1239_cov_14.984211	398	478	0	80	80	1.0000000
NODE_3577_length_1239_cov_14.984211	451	531	0	80	80	1.0000000
NODE_3577_length_1239_cov_14.984211	771	825	0	54	54	1.0000000
NODE_3577_length_1239_cov_14.984211	798	878	0	80	80	1.0000000
NODE_3578_length_1239_cov_13.312281	806	886	0	80	80	1.0000000
NODE_3578_length_1239_cov_13.312281	859	939	0	80	80	1.0000000
NODE_3579_length_1239_cov_7.116667	444	524	0	62	80	0.7750000
NODE_3579_length_1239_cov_7.116667	444	524	2	18	80	0.2250000
NODE_3579_length_1239_cov_7.116667	497	577	0	9	80	0.1125000
NODE_3579_length_1239_cov_7.116667	497	577	2	71	80	0.8875000
NODE_3582_length_1238_cov_33.830553	625	705	0	80	80	1.0000000
NODE_3582_length_1238_cov_33.830553	678	758	0	80	80	1.0000000
NODE_3583_length_1238_cov_8.163301	664	744	2	40	80	0.5000000
NODE_3583_length_1238_cov_8.163301	664	744	4	8	80	0.1000000
NODE_3583_length_1238_cov_8.163301	664	744	6	32	80	0.4000000
NODE_3583_length_1238_cov_8.163301	717	797	4	61	80	0.7625000
NODE_3583_length_1238_cov_8.163301	717	797	6	19	80	0.2375000
NODE_3586_length_1237_cov_24.562390	447	527	0	80	80	1.0000000
NODE_3586_length_1237_cov_24.562390	500	580	0	80	80	1.0000000
NODE_3587_length_1237_cov_9.297012	515	595	0	80	80	1.0000000
NODE_3587_length_1237_cov_9.297012	568	648	0	80	80	1.0000000
NODE_3594_length_1236_cov_46.661390	632	712	0	77	80	0.9625000
NODE_3594_length_1236_cov_46.661390	632	712	2	3	80	0.0375000
NODE_3594_length_1236_cov_46.661390	685	765	0	24	80	0.3000000
NODE_3594_length_1236_cov_46.661390	685	765	2	56	80	0.7000000
NODE_3595_length_1236_cov_8.625330	735	815	0	80	80	1.0000000
NODE_3595_length_1236_cov_8.625330	788	868	0	80	80	1.0000000
NODE_3597_length_1235_cov_31.619718	331	411	20	29	80	0.3625000
NODE_3597_length_1235_cov_31.619718	331	411	22	51	80	0.6375000
NODE_3597_length_1235_cov_31.619718	384	464	0	38	80	0.4750000
NODE_3597_length_1235_cov_31.619718	384	464	2	9	80	0.1125000
NODE_3597_length_1235_cov_31.619718	384	464	8	3	80	0.0375000
NODE_3597_length_1235_cov_31.619718	384	464	22	30	80	0.3750000
NODE_3598_length_1235_cov_20.252641	559	639	1	59	80	0.7375000
NODE_3598_length_1235_cov_20.252641	559	639	2	21	80	0.2625000
NODE_3598_length_1235_cov_20.252641	612	692	0	26	80	0.3250000
NODE_3598_length_1235_cov_20.252641	612	692	1	54	80	0.6750000
NODE_3598_length_1235_cov_20.252641	688	768	0	80	80	1.0000000
NODE_3598_length_1235_cov_20.252641	741	821	0	80	80	1.0000000
NODE_3599_length_1235_cov_18.462148	695	775	0	80	80	1.0000000
NODE_3599_length_1235_cov_18.462148	748	828	0	80	80	1.0000000
NODE_3600_length_1235_cov_8.696303	765	845	0	80	80	1.0000000
NODE_3600_length_1235_cov_8.696303	818	898	0	80	80	1.0000000
NODE_3601_length_1235_cov_5.580106	544	624	0	80	80	1.0000000
NODE_3601_length_1235_cov_5.580106	597	677	0	80	80	1.0000000
NODE_3608_length_1234_cov_27.136564	528	608	0	80	80	1.0000000
NODE_3608_length_1234_cov_27.136564	581	661	0	80	80	1.0000000
NODE_3611_length_1233_cov_64.374780	497	577	0	8	80	0.1000000
NODE_3611_length_1233_cov_64.374780	497	577	2	72	80	0.9000000
NODE_3611_length_1233_cov_64.374780	550	630	0	38	80	0.4750000
NODE_3611_length_1233_cov_64.374780	550	630	2	42	80	0.5250000
NODE_3611_length_1233_cov_64.374780	626	706	0	80	80	1.0000000
NODE_3611_length_1233_cov_64.374780	679	759	0	80	80	1.0000000
NODE_3612_length_1233_cov_52.833333	654	734	0	80	80	1.0000000
NODE_3612_length_1233_cov_52.833333	707	787	0	80	80	1.0000000
NODE_3613_length_1233_cov_18.096120	522	602	0	42	80	0.5250000
NODE_3613_length_1233_cov_18.096120	522	602	4	38	80	0.4750000
NODE_3613_length_1233_cov_18.096120	575	655	4	36	80	0.4500000
NODE_3613_length_1233_cov_18.096120	575	655	6	44	80	0.5500000
NODE_3613_length_1233_cov_18.096120	651	731	0	34	80	0.4250000
NODE_3613_length_1233_cov_18.096120	651	731	2	31	80	0.3875000
NODE_3613_length_1233_cov_18.096120	651	731	6	15	80	0.1875000
NODE_3613_length_1233_cov_18.096120	704	784	0	80	80	1.0000000
NODE_3614_length_1233_cov_15.360670	585	656	0	71	71	1.0000000
NODE_3614_length_1233_cov_15.360670	631	709	0	78	78	1.0000000
NODE_3620_length_1232_cov_62.112974	552	632	0	38	80	0.4750000
NODE_3620_length_1232_cov_62.112974	552	632	2	42	80	0.5250000
NODE_3620_length_1232_cov_62.112974	605	694	0	14	89	0.1573034
NODE_3620_length_1232_cov_62.112974	605	694	2	75	89	0.8426966
NODE_3620_length_1232_cov_62.112974	690	770	2	74	80	0.9250000
NODE_3620_length_1232_cov_62.112974	690	770	4	4	80	0.0500000
NODE_3620_length_1232_cov_62.112974	690	770	6	2	80	0.0250000
NODE_3620_length_1232_cov_62.112974	743	823	2	21	80	0.2625000
NODE_3620_length_1232_cov_62.112974	743	823	4	57	80	0.7125000
NODE_3620_length_1232_cov_62.112974	743	823	6	2	80	0.0250000
NODE_3621_length_1232_cov_34.635481	469	549	0	58	80	0.7250000
NODE_3621_length_1232_cov_34.635481	469	549	9	16	80	0.2000000
NODE_3621_length_1232_cov_34.635481	469	549	10	6	80	0.0750000
NODE_3621_length_1232_cov_34.635481	522	602	0	5	80	0.0625000
NODE_3621_length_1232_cov_34.635481	522	602	9	16	80	0.2000000
NODE_3621_length_1232_cov_34.635481	522	602	10	59	80	0.7375000
NODE_3622_length_1232_cov_16.362754	774	854	0	80	80	1.0000000
NODE_3622_length_1232_cov_16.362754	827	907	0	80	80	1.0000000
NODE_3623_length_1232_cov_13.395410	234	315	0	81	81	1.0000000
NODE_3623_length_1232_cov_13.395410	287	368	0	81	81	1.0000000
NODE_3623_length_1232_cov_13.395410	364	444	0	80	80	1.0000000
NODE_3623_length_1232_cov_13.395410	417	497	0	80	80	1.0000000
NODE_3625_length_1231_cov_47.606890	509	589	0	80	80	1.0000000
NODE_3625_length_1231_cov_47.606890	562	642	0	47	80	0.5875000
NODE_3625_length_1231_cov_47.606890	562	642	2	33	80	0.4125000
NODE_3625_length_1231_cov_47.606890	638	718	0	14	80	0.1750000
NODE_3625_length_1231_cov_47.606890	638	718	2	66	80	0.8250000
NODE_3625_length_1231_cov_47.606890	691	771	0	67	80	0.8375000
NODE_3625_length_1231_cov_47.606890	691	771	2	13	80	0.1625000
NODE_3626_length_1231_cov_27.498233	698	777	0	15	79	0.1898734
NODE_3626_length_1231_cov_27.498233	698	777	1	1	79	0.0126582
NODE_3626_length_1231_cov_27.498233	698	777	3	9	79	0.1139240
NODE_3626_length_1231_cov_27.498233	698	777	6	54	79	0.6835443
NODE_3626_length_1231_cov_27.498233	750	830	0	3	80	0.0375000
NODE_3626_length_1231_cov_27.498233	750	830	6	77	80	0.9625000
NODE_3627_length_1231_cov_21.245583	673	753	0	80	80	1.0000000
NODE_3627_length_1231_cov_21.245583	726	806	0	80	80	1.0000000
NODE_3627_length_1231_cov_21.245583	802	882	0	80	80	1.0000000
NODE_3627_length_1231_cov_21.245583	860	935	0	75	75	1.0000000
NODE_3628_length_1231_cov_9.895760	515	595	0	55	80	0.6875000
NODE_3628_length_1231_cov_9.895760	515	595	2	25	80	0.3125000
NODE_3628_length_1231_cov_9.895760	568	648	0	80	80	1.0000000
NODE_3630_length_1230_cov_43.705570	412	492	0	40	80	0.5000000
NODE_3630_length_1230_cov_43.705570	412	492	2	40	80	0.5000000
NODE_3630_length_1230_cov_43.705570	465	545	0	80	80	1.0000000
NODE_3631_length_1230_cov_43.663130	501	581	0	15	80	0.1875000
NODE_3631_length_1230_cov_43.663130	501	581	2	65	80	0.8125000
NODE_3631_length_1230_cov_43.663130	554	634	0	54	80	0.6750000
NODE_3631_length_1230_cov_43.663130	554	634	2	26	80	0.3250000
NODE_3632_length_1230_cov_33.173298	315	395	2	80	80	1.0000000
NODE_3632_length_1230_cov_33.173298	368	448	0	17	80	0.2125000
NODE_3632_length_1230_cov_33.173298	368	448	1	32	80	0.4000000
NODE_3632_length_1230_cov_33.173298	368	448	2	31	80	0.3875000
NODE_3633_length_1230_cov_12.939876	201	281	6	80	80	1.0000000
NODE_3633_length_1230_cov_12.939876	218	273	6	55	55	1.0000000
NODE_3633_length_1230_cov_12.939876	254	334	0	34	80	0.4250000
NODE_3633_length_1230_cov_12.939876	254	334	6	46	80	0.5750000
NODE_3633_length_1230_cov_12.939876	330	410	0	80	80	1.0000000
NODE_3633_length_1230_cov_12.939876	383	463	0	80	80	1.0000000
NODE_3634_length_1230_cov_5.155615	248	328	0	80	80	1.0000000
NODE_3634_length_1230_cov_5.155615	301	381	0	80	80	1.0000000
NODE_3640_length_1229_cov_30.214159	341	421	0	24	80	0.3000000
NODE_3640_length_1229_cov_30.214159	341	421	8	1	80	0.0125000
NODE_3640_length_1229_cov_30.214159	341	421	9	55	80	0.6875000
NODE_3640_length_1229_cov_30.214159	394	474	9	32	80	0.4000000
NODE_3640_length_1229_cov_30.214159	394	474	10	48	80	0.6000000
NODE_3641_length_1229_cov_23.165487	376	456	0	49	80	0.6125000
NODE_3641_length_1229_cov_23.165487	376	456	1	31	80	0.3875000
NODE_3641_length_1229_cov_23.165487	429	509	1	46	80	0.5750000
NODE_3641_length_1229_cov_23.165487	429	509	2	14	80	0.1750000
NODE_3641_length_1229_cov_23.165487	429	509	4	20	80	0.2500000
NODE_3641_length_1229_cov_23.165487	505	585	4	6	80	0.0750000
NODE_3641_length_1229_cov_23.165487	505	585	7	10	80	0.1250000
NODE_3641_length_1229_cov_23.165487	505	585	8	64	80	0.8000000
NODE_3641_length_1229_cov_23.165487	558	638	4	13	80	0.1625000
NODE_3641_length_1229_cov_23.165487	558	638	5	33	80	0.4125000
NODE_3641_length_1229_cov_23.165487	558	638	7	13	80	0.1625000
NODE_3641_length_1229_cov_23.165487	558	638	8	17	80	0.2125000
NODE_3641_length_1229_cov_23.165487	558	638	9	4	80	0.0500000
NODE_3642_length_1229_cov_19.376991	484	564	0	80	80	1.0000000
NODE_3642_length_1229_cov_19.376991	537	614	0	77	77	1.0000000
NODE_3643_length_1229_cov_11.799115	670	748	0	78	78	1.0000000
NODE_3643_length_1229_cov_11.799115	728	801	0	73	73	1.0000000
NODE_3644_length_1229_cov_8.140708	970	1050	1	32	80	0.4000000
NODE_3644_length_1229_cov_8.140708	970	1050	2	48	80	0.6000000
NODE_3644_length_1229_cov_8.140708	1023	1103	2	80	80	1.0000000
NODE_3646_length_1229_cov_3.654867	765	840	0	75	75	1.0000000
NODE_3646_length_1229_cov_3.654867	813	893	0	80	80	1.0000000
NODE_3652_length_1229_cov_0.949558	1034	1079	4	37	45	0.8222222
NODE_3652_length_1229_cov_0.949558	1034	1079	6	8	45	0.1777778
NODE_3652_length_1229_cov_0.949558	1090	1130	2	39	40	0.9750000
NODE_3652_length_1229_cov_0.949558	1090	1130	4	1	40	0.0250000
NODE_3654_length_1228_cov_22.622675	604	684	0	80	80	1.0000000
NODE_3654_length_1228_cov_22.622675	657	738	0	81	81	1.0000000
NODE_3655_length_1228_cov_17.900797	423	503	0	80	80	1.0000000
NODE_3655_length_1228_cov_17.900797	423	503	0	80	80	1.0000000
NODE_3655_length_1228_cov_17.900797	423	503	0	80	80	1.0000000
NODE_3655_length_1228_cov_17.900797	476	538	0	62	62	1.0000000
NODE_3655_length_1228_cov_17.900797	476	538	0	62	62	1.0000000
NODE_3655_length_1228_cov_17.900797	476	538	0	62	62	1.0000000
NODE_3655_length_1228_cov_17.900797	476	556	0	80	80	1.0000000
NODE_3656_length_1228_cov_14.554473	367	447	0	80	80	1.0000000
NODE_3656_length_1228_cov_14.554473	420	500	0	80	80	1.0000000
NODE_3657_length_1228_cov_10.021258	661	741	0	80	80	1.0000000
NODE_3657_length_1228_cov_10.021258	714	794	0	80	80	1.0000000
NODE_3660_length_1228_cov_3.987600	1139	1219	0	78	80	0.9750000
NODE_3660_length_1228_cov_3.987600	1139	1219	1	2	80	0.0250000
NODE_3662_length_1227_cov_29.002660	423	503	0	80	80	1.0000000
NODE_3662_length_1227_cov_29.002660	476	556	0	80	80	1.0000000
NODE_3663_length_1227_cov_17.479610	759	839	0	80	80	1.0000000
NODE_3663_length_1227_cov_17.479610	812	892	0	80	80	1.0000000
NODE_3666_length_1227_cov_3.808511	120	186	6	10	66	0.1515152
NODE_3666_length_1227_cov_3.808511	120	186	12	11	66	0.1666667
NODE_3666_length_1227_cov_3.808511	120	186	16	34	66	0.5151515
NODE_3666_length_1227_cov_3.808511	120	186	18	2	66	0.0303030
NODE_3666_length_1227_cov_3.808511	120	186	20	9	66	0.1363636
NODE_3666_length_1227_cov_3.808511	173	239	8	16	66	0.2424242
NODE_3666_length_1227_cov_3.808511	173	239	14	1	66	0.0151515
NODE_3666_length_1227_cov_3.808511	173	239	16	18	66	0.2727273
NODE_3666_length_1227_cov_3.808511	173	239	18	19	66	0.2878788
NODE_3666_length_1227_cov_3.808511	173	239	20	12	66	0.1818182
NODE_3666_length_1227_cov_3.808511	229	299	0	30	70	0.4285714
NODE_3666_length_1227_cov_3.808511	229	299	2	3	70	0.0428571
NODE_3666_length_1227_cov_3.808511	229	299	4	19	70	0.2714286
NODE_3666_length_1227_cov_3.808511	229	299	7	1	70	0.0142857
NODE_3666_length_1227_cov_3.808511	229	299	8	17	70	0.2428571
NODE_3672_length_1226_cov_23.792369	579	659	0	80	80	1.0000000
NODE_3672_length_1226_cov_23.792369	632	712	0	80	80	1.0000000
NODE_3672_length_1226_cov_23.792369	708	788	0	80	80	1.0000000
NODE_3672_length_1226_cov_23.792369	761	839	0	78	78	1.0000000
NODE_3673_length_1226_cov_5.620231	463	543	0	80	80	1.0000000
NODE_3673_length_1226_cov_5.620231	516	596	0	80	80	1.0000000
NODE_3674_length_1226_cov_4.881988	582	662	0	80	80	1.0000000
NODE_3674_length_1226_cov_4.881988	635	715	0	80	80	1.0000000
NODE_3682_length_1225_cov_55.596803	637	717	2	20	80	0.2500000
NODE_3682_length_1225_cov_55.596803	637	717	10	52	80	0.6500000
NODE_3682_length_1225_cov_55.596803	637	717	12	8	80	0.1000000
NODE_3682_length_1225_cov_55.596803	690	770	10	19	80	0.2375000
NODE_3682_length_1225_cov_55.596803	690	770	11	12	80	0.1500000
NODE_3682_length_1225_cov_55.596803	690	770	12	49	80	0.6125000
NODE_3682_length_1225_cov_55.596803	766	846	0	55	80	0.6875000
NODE_3682_length_1225_cov_55.596803	766	846	4	20	80	0.2500000
NODE_3682_length_1225_cov_55.596803	766	846	11	5	80	0.0625000
NODE_3682_length_1225_cov_55.596803	819	899	0	80	80	1.0000000
NODE_3683_length_1225_cov_35.189165	661	742	0	81	81	1.0000000
NODE_3683_length_1225_cov_35.189165	714	795	0	81	81	1.0000000
NODE_3684_length_1225_cov_33.755773	456	535	0	79	79	1.0000000
NODE_3684_length_1225_cov_33.755773	508	588	0	80	80	1.0000000
NODE_3685_length_1225_cov_30.116341	566	646	0	80	80	1.0000000
NODE_3685_length_1225_cov_30.116341	619	699	0	73	80	0.9125000
NODE_3685_length_1225_cov_30.116341	619	699	2	7	80	0.0875000
NODE_3685_length_1225_cov_30.116341	695	775	2	16	80	0.2000000
NODE_3685_length_1225_cov_30.116341	695	775	4	64	80	0.8000000
NODE_3685_length_1225_cov_30.116341	748	828	0	52	80	0.6500000
NODE_3685_length_1225_cov_30.116341	748	828	2	13	80	0.1625000
NODE_3685_length_1225_cov_30.116341	748	828	4	15	80	0.1875000
NODE_3686_length_1225_cov_29.177620	195	275	0	7	80	0.0875000
NODE_3686_length_1225_cov_29.177620	195	275	8	73	80	0.9125000
NODE_3686_length_1225_cov_29.177620	248	328	0	18	80	0.2250000
NODE_3686_length_1225_cov_29.177620	248	328	8	62	80	0.7750000
NODE_3687_length_1225_cov_26.849023	588	668	0	80	80	1.0000000
NODE_3687_length_1225_cov_26.849023	641	721	0	80	80	1.0000000
NODE_3687_length_1225_cov_26.849023	717	797	0	80	80	1.0000000
NODE_3687_length_1225_cov_26.849023	770	850	0	32	80	0.4000000
NODE_3687_length_1225_cov_26.849023	770	850	2	48	80	0.6000000
NODE_3688_length_1225_cov_24.444938	386	466	0	11	80	0.1375000
NODE_3688_length_1225_cov_24.444938	386	466	2	69	80	0.8625000
NODE_3688_length_1225_cov_24.444938	439	519	0	55	80	0.6875000
NODE_3688_length_1225_cov_24.444938	439	519	2	25	80	0.3125000
NODE_3690_length_1225_cov_19.369449	491	571	0	80	80	1.0000000
NODE_3690_length_1225_cov_19.369449	544	624	0	80	80	1.0000000
NODE_3690_length_1225_cov_19.369449	620	700	0	80	80	1.0000000
NODE_3690_length_1225_cov_19.369449	673	753	0	80	80	1.0000000
NODE_3691_length_1225_cov_13.281528	462	542	0	71	80	0.8875000
NODE_3691_length_1225_cov_13.281528	462	542	1	9	80	0.1125000
NODE_3691_length_1225_cov_13.281528	515	595	0	80	80	1.0000000
NODE_3691_length_1225_cov_13.281528	591	671	0	80	80	1.0000000
NODE_3691_length_1225_cov_13.281528	644	724	0	80	80	1.0000000
NODE_3692_length_1225_cov_10.887211	566	646	0	80	80	1.0000000
NODE_3692_length_1225_cov_10.887211	619	699	0	80	80	1.0000000
NODE_3696_length_1224_cov_24.568889	613	693	2	80	80	1.0000000
NODE_3696_length_1224_cov_24.568889	666	746	1	50	80	0.6250000
NODE_3696_length_1224_cov_24.568889	666	746	2	30	80	0.3750000
NODE_3697_length_1224_cov_17.538667	762	842	0	65	80	0.8125000
NODE_3697_length_1224_cov_17.538667	762	842	8	14	80	0.1750000
NODE_3697_length_1224_cov_17.538667	762	842	14	1	80	0.0125000
NODE_3697_length_1224_cov_17.538667	815	895	0	12	80	0.1500000
NODE_3697_length_1224_cov_17.538667	815	895	8	14	80	0.1750000
NODE_3697_length_1224_cov_17.538667	815	895	14	54	80	0.6750000
NODE_3698_length_1224_cov_14.138667	389	469	0	4	80	0.0500000
NODE_3698_length_1224_cov_14.138667	389	469	4	76	80	0.9500000
NODE_3698_length_1224_cov_14.138667	442	522	0	57	80	0.7125000
NODE_3698_length_1224_cov_14.138667	442	522	4	23	80	0.2875000
NODE_3699_length_1224_cov_11.358222	704	784	0	80	80	1.0000000
NODE_3699_length_1224_cov_11.358222	757	837	0	80	80	1.0000000
NODE_3700_length_1224_cov_6.963556	516	581	0	65	65	1.0000000
NODE_3705_length_1223_cov_44.608541	548	630	0	82	82	1.0000000
NODE_3705_length_1223_cov_44.608541	601	683	0	82	82	1.0000000
NODE_3705_length_1223_cov_44.608541	679	759	0	80	80	1.0000000
NODE_3705_length_1223_cov_44.608541	732	812	0	80	80	1.0000000
NODE_3706_length_1223_cov_26.730427	508	588	0	80	80	1.0000000
NODE_3706_length_1223_cov_26.730427	561	641	0	80	80	1.0000000
NODE_3707_length_1223_cov_18.902135	460	540	0	80	80	1.0000000
NODE_3707_length_1223_cov_18.902135	513	593	0	80	80	1.0000000
NODE_3708_length_1223_cov_6.989324	707	778	1	71	71	1.0000000
NODE_3710_length_1223_cov_5.251779	666	746	2	80	80	1.0000000
NODE_3710_length_1223_cov_5.251779	719	799	0	49	80	0.6125000
NODE_3710_length_1223_cov_5.251779	719	799	2	30	80	0.3750000
NODE_3710_length_1223_cov_5.251779	719	799	3	1	80	0.0125000
NODE_3710_length_1223_cov_5.251779	795	875	0	3	80	0.0375000
NODE_3710_length_1223_cov_5.251779	795	875	3	77	80	0.9625000
NODE_3710_length_1223_cov_5.251779	848	928	0	27	80	0.3375000
NODE_3710_length_1223_cov_5.251779	848	928	3	53	80	0.6625000
NODE_3716_length_1222_cov_18.406946	273	353	0	80	80	1.0000000
NODE_3716_length_1222_cov_18.406946	326	406	0	80	80	1.0000000
NODE_3720_length_1221_cov_33.261141	505	577	0	72	72	1.0000000
NODE_3720_length_1221_cov_33.261141	558	637	0	79	79	1.0000000
NODE_3720_length_1221_cov_33.261141	633	713	0	80	80	1.0000000
NODE_3720_length_1221_cov_33.261141	686	766	0	80	80	1.0000000
NODE_3721_length_1221_cov_19.466132	541	621	0	57	80	0.7125000
NODE_3721_length_1221_cov_19.466132	541	621	1	23	80	0.2875000
NODE_3721_length_1221_cov_19.466132	594	674	0	62	80	0.7750000
NODE_3721_length_1221_cov_19.466132	594	674	2	18	80	0.2250000
NODE_3722_length_1221_cov_15.940285	788	868	0	80	80	1.0000000
NODE_3722_length_1221_cov_15.940285	841	921	0	80	80	1.0000000
NODE_3722_length_1221_cov_15.940285	917	997	0	80	80	1.0000000
NODE_3722_length_1221_cov_15.940285	970	1050	0	80	80	1.0000000
NODE_3723_length_1221_cov_15.796791	484	564	0	80	80	1.0000000
NODE_3723_length_1221_cov_15.796791	537	617	0	80	80	1.0000000
NODE_3724_length_1221_cov_15.312834	342	415	0	73	73	1.0000000
NODE_3724_length_1221_cov_15.312834	395	474	0	79	79	1.0000000
NODE_3725_length_1221_cov_9.695187	988	1068	0	80	80	1.0000000
NODE_3725_length_1221_cov_9.695187	1041	1100	0	59	59	1.0000000
NODE_3726_length_1221_cov_9.043672	695	775	0	80	80	1.0000000
NODE_3726_length_1221_cov_9.043672	748	828	0	80	80	1.0000000
NODE_3727_length_1221_cov_7.946524	147	227	0	80	80	1.0000000
NODE_3727_length_1221_cov_7.946524	200	280	0	80	80	1.0000000
NODE_3728_length_1221_cov_5.122103	248	328	0	80	80	1.0000000
NODE_3728_length_1221_cov_5.122103	301	381	0	80	80	1.0000000
NODE_3736_length_1220_cov_44.501338	319	399	0	80	80	1.0000000
NODE_3736_length_1220_cov_44.501338	372	452	0	80	80	1.0000000
NODE_3736_length_1220_cov_44.501338	448	528	0	80	80	1.0000000
NODE_3736_length_1220_cov_44.501338	501	581	0	80	80	1.0000000
NODE_3737_length_1220_cov_43.868867	720	800	0	80	80	1.0000000
NODE_3737_length_1220_cov_43.868867	773	853	0	80	80	1.0000000
NODE_3738_length_1220_cov_41.900089	593	673	0	19	80	0.2375000
NODE_3738_length_1220_cov_41.900089	593	673	4	61	80	0.7625000
NODE_3738_length_1220_cov_41.900089	646	726	0	25	80	0.3125000
NODE_3738_length_1220_cov_41.900089	646	726	4	55	80	0.6875000
NODE_3738_length_1220_cov_41.900089	722	802	0	80	80	1.0000000
NODE_3738_length_1220_cov_41.900089	775	855	0	80	80	1.0000000
NODE_3739_length_1220_cov_15.485281	395	475	0	64	80	0.8000000
NODE_3739_length_1220_cov_15.485281	395	475	2	16	80	0.2000000
NODE_3739_length_1220_cov_15.485281	448	528	0	11	80	0.1375000
NODE_3739_length_1220_cov_15.485281	448	528	2	69	80	0.8625000
NODE_3745_length_1219_cov_30.493750	643	723	0	80	80	1.0000000
NODE_3745_length_1219_cov_30.493750	696	776	0	80	80	1.0000000
NODE_3745_length_1219_cov_30.493750	772	852	0	80	80	1.0000000
NODE_3745_length_1219_cov_30.493750	825	905	0	80	80	1.0000000
NODE_3746_length_1219_cov_24.991071	566	646	0	47	80	0.5875000
NODE_3746_length_1219_cov_24.991071	566	646	4	5	80	0.0625000
NODE_3746_length_1219_cov_24.991071	566	646	8	28	80	0.3500000
NODE_3746_length_1219_cov_24.991071	619	699	8	80	80	1.0000000
NODE_3746_length_1219_cov_24.991071	695	775	0	26	80	0.3250000
NODE_3746_length_1219_cov_24.991071	695	775	4	35	80	0.4375000
NODE_3746_length_1219_cov_24.991071	695	775	8	19	80	0.2375000
NODE_3746_length_1219_cov_24.991071	748	828	0	34	80	0.4250000
NODE_3746_length_1219_cov_24.991071	748	828	2	45	80	0.5625000
NODE_3746_length_1219_cov_24.991071	748	828	4	1	80	0.0125000
NODE_3747_length_1219_cov_24.728571	465	545	0	80	80	1.0000000
NODE_3747_length_1219_cov_24.728571	518	598	0	80	80	1.0000000
NODE_3747_length_1219_cov_24.728571	594	674	0	80	80	1.0000000
NODE_3747_length_1219_cov_24.728571	647	727	0	80	80	1.0000000
NODE_3748_length_1219_cov_11.130357	535	615	2	42	80	0.5250000
NODE_3748_length_1219_cov_11.130357	535	615	4	13	80	0.1625000
NODE_3748_length_1219_cov_11.130357	535	615	6	25	80	0.3125000
NODE_3748_length_1219_cov_11.130357	588	668	4	14	80	0.1750000
NODE_3748_length_1219_cov_11.130357	588	668	6	14	80	0.1750000
NODE_3748_length_1219_cov_11.130357	588	668	8	20	80	0.2500000
NODE_3748_length_1219_cov_11.130357	588	668	10	32	80	0.4000000
NODE_3749_length_1219_cov_9.696429	734	814	0	80	80	1.0000000
NODE_3749_length_1219_cov_9.696429	787	867	0	80	80	1.0000000
NODE_3754_length_1218_cov_40.159071	554	634	0	80	80	1.0000000
NODE_3754_length_1218_cov_40.159071	607	687	0	80	80	1.0000000
NODE_3754_length_1218_cov_40.159071	683	763	0	80	80	1.0000000
NODE_3754_length_1218_cov_40.159071	736	816	0	80	80	1.0000000
NODE_3765_length_1216_cov_99.538944	44	124	119	2	80	0.0250000
NODE_3765_length_1216_cov_99.538944	44	124	120	1	80	0.0125000
NODE_3765_length_1216_cov_99.538944	44	124	123	1	80	0.0125000
NODE_3765_length_1216_cov_99.538944	44	124	144	1	80	0.0125000
NODE_3765_length_1216_cov_99.538944	44	124	146	1	80	0.0125000
NODE_3765_length_1216_cov_99.538944	44	124	154	1	80	0.0125000
NODE_3765_length_1216_cov_99.538944	44	124	158	1	80	0.0125000
NODE_3765_length_1216_cov_99.538944	44	124	160	1	80	0.0125000
NODE_3765_length_1216_cov_99.538944	44	124	162	2	80	0.0250000
NODE_3765_length_1216_cov_99.538944	44	124	173	1	80	0.0125000
NODE_3765_length_1216_cov_99.538944	44	124	179	1	80	0.0125000
NODE_3765_length_1216_cov_99.538944	44	124	182	1	80	0.0125000
NODE_3765_length_1216_cov_99.538944	44	124	184	1	80	0.0125000
NODE_3765_length_1216_cov_99.538944	44	124	188	1	80	0.0125000
NODE_3765_length_1216_cov_99.538944	44	124	194	5	80	0.0625000
NODE_3765_length_1216_cov_99.538944	44	124	196	1	80	0.0125000
NODE_3765_length_1216_cov_99.538944	44	124	200	1	80	0.0125000
NODE_3765_length_1216_cov_99.538944	44	124	206	2	80	0.0250000
NODE_3765_length_1216_cov_99.538944	44	124	212	1	80	0.0125000
NODE_3765_length_1216_cov_99.538944	44	124	215	1	80	0.0125000
NODE_3765_length_1216_cov_99.538944	44	124	225	1	80	0.0125000
NODE_3765_length_1216_cov_99.538944	44	124	232	1	80	0.0125000
NODE_3765_length_1216_cov_99.538944	44	124	236	1	80	0.0125000
NODE_3765_length_1216_cov_99.538944	44	124	238	1	80	0.0125000
NODE_3765_length_1216_cov_99.538944	44	124	240	4	80	0.0500000
NODE_3765_length_1216_cov_99.538944	44	124	247	2	80	0.0250000
NODE_3765_length_1216_cov_99.538944	44	124	249	1	80	0.0125000
NODE_3765_length_1216_cov_99.538944	44	124	250	1	80	0.0125000
NODE_3765_length_1216_cov_99.538944	44	124	258	2	80	0.0250000
NODE_3765_length_1216_cov_99.538944	44	124	260	1	80	0.0125000
NODE_3765_length_1216_cov_99.538944	44	124	261	3	80	0.0375000
NODE_3765_length_1216_cov_99.538944	44	124	263	1	80	0.0125000
NODE_3765_length_1216_cov_99.538944	44	124	265	1	80	0.0125000
NODE_3765_length_1216_cov_99.538944	44	124	267	1	80	0.0125000
NODE_3765_length_1216_cov_99.538944	44	124	272	1	80	0.0125000
NODE_3765_length_1216_cov_99.538944	44	124	276	3	80	0.0375000
NODE_3765_length_1216_cov_99.538944	44	124	278	1	80	0.0125000
NODE_3765_length_1216_cov_99.538944	44	124	280	1	80	0.0125000
NODE_3765_length_1216_cov_99.538944	44	124	288	3	80	0.0375000
NODE_3765_length_1216_cov_99.538944	44	124	290	2	80	0.0250000
NODE_3765_length_1216_cov_99.538944	44	124	291	1	80	0.0125000
NODE_3765_length_1216_cov_99.538944	44	124	292	2	80	0.0250000
NODE_3765_length_1216_cov_99.538944	44	124	294	1	80	0.0125000
NODE_3765_length_1216_cov_99.538944	44	124	299	2	80	0.0250000
NODE_3765_length_1216_cov_99.538944	44	124	301	1	80	0.0125000
NODE_3765_length_1216_cov_99.538944	44	124	303	3	80	0.0375000
NODE_3765_length_1216_cov_99.538944	44	124	305	1	80	0.0125000
NODE_3765_length_1216_cov_99.538944	44	124	306	2	80	0.0250000
NODE_3765_length_1216_cov_99.538944	44	124	307	1	80	0.0125000
NODE_3765_length_1216_cov_99.538944	44	124	309	1	80	0.0125000
NODE_3765_length_1216_cov_99.538944	44	124	310	2	80	0.0250000
NODE_3765_length_1216_cov_99.538944	44	124	311	2	80	0.0250000
NODE_3765_length_1216_cov_99.538944	44	124	315	2	80	0.0250000
NODE_3765_length_1216_cov_99.538944	97	157	280	1	60	0.0166667
NODE_3765_length_1216_cov_99.538944	97	157	288	3	60	0.0500000
NODE_3765_length_1216_cov_99.538944	97	157	290	2	60	0.0333333
NODE_3765_length_1216_cov_99.538944	97	157	291	1	60	0.0166667
NODE_3765_length_1216_cov_99.538944	97	157	292	2	60	0.0333333
NODE_3765_length_1216_cov_99.538944	97	157	294	1	60	0.0166667
NODE_3765_length_1216_cov_99.538944	97	157	299	2	60	0.0333333
NODE_3765_length_1216_cov_99.538944	97	157	301	1	60	0.0166667
NODE_3765_length_1216_cov_99.538944	97	157	303	3	60	0.0500000
NODE_3765_length_1216_cov_99.538944	97	157	305	1	60	0.0166667
NODE_3765_length_1216_cov_99.538944	97	157	306	2	60	0.0333333
NODE_3765_length_1216_cov_99.538944	97	157	307	1	60	0.0166667
NODE_3765_length_1216_cov_99.538944	97	157	309	1	60	0.0166667
NODE_3765_length_1216_cov_99.538944	97	157	310	3	60	0.0500000
NODE_3765_length_1216_cov_99.538944	97	157	311	3	60	0.0500000
NODE_3765_length_1216_cov_99.538944	97	157	312	1	60	0.0166667
NODE_3765_length_1216_cov_99.538944	97	157	313	1	60	0.0166667
NODE_3765_length_1216_cov_99.538944	97	157	314	2	60	0.0333333
NODE_3765_length_1216_cov_99.538944	97	157	315	4	60	0.0666667
NODE_3765_length_1216_cov_99.538944	97	157	316	1	60	0.0166667
NODE_3765_length_1216_cov_99.538944	97	157	320	5	60	0.0833333
NODE_3765_length_1216_cov_99.538944	97	157	322	2	60	0.0333333
NODE_3765_length_1216_cov_99.538944	97	157	329	1	60	0.0166667
NODE_3765_length_1216_cov_99.538944	97	157	334	1	60	0.0166667
NODE_3765_length_1216_cov_99.538944	97	157	347	1	60	0.0166667
NODE_3765_length_1216_cov_99.538944	97	157	352	1	60	0.0166667
NODE_3765_length_1216_cov_99.538944	97	157	353	2	60	0.0333333
NODE_3765_length_1216_cov_99.538944	97	157	354	2	60	0.0333333
NODE_3765_length_1216_cov_99.538944	97	157	355	1	60	0.0166667
NODE_3765_length_1216_cov_99.538944	97	157	357	1	60	0.0166667
NODE_3765_length_1216_cov_99.538944	97	157	358	2	60	0.0333333
NODE_3765_length_1216_cov_99.538944	97	157	359	1	60	0.0166667
NODE_3765_length_1216_cov_99.538944	97	157	362	2	60	0.0333333
NODE_3765_length_1216_cov_99.538944	97	157	365	1	60	0.0166667
NODE_3765_length_1216_cov_99.538944	97	157	366	1	60	0.0166667
NODE_3765_length_1216_cov_99.538944	824	903	169	3	79	0.0379747
NODE_3765_length_1216_cov_99.538944	824	903	171	3	79	0.0379747
NODE_3765_length_1216_cov_99.538944	824	903	172	2	79	0.0253165
NODE_3765_length_1216_cov_99.538944	824	903	173	1	79	0.0126582
NODE_3765_length_1216_cov_99.538944	824	903	175	2	79	0.0253165
NODE_3765_length_1216_cov_99.538944	824	903	176	1	79	0.0126582
NODE_3765_length_1216_cov_99.538944	824	903	178	1	79	0.0126582
NODE_3765_length_1216_cov_99.538944	824	903	179	1	79	0.0126582
NODE_3765_length_1216_cov_99.538944	824	903	180	4	79	0.0506329
NODE_3765_length_1216_cov_99.538944	824	903	181	3	79	0.0379747
NODE_3765_length_1216_cov_99.538944	824	903	183	2	79	0.0253165
NODE_3765_length_1216_cov_99.538944	824	903	185	4	79	0.0506329
NODE_3765_length_1216_cov_99.538944	824	903	186	2	79	0.0253165
NODE_3765_length_1216_cov_99.538944	824	903	187	4	79	0.0506329
NODE_3765_length_1216_cov_99.538944	824	903	188	8	79	0.1012658
NODE_3765_length_1216_cov_99.538944	824	903	189	2	79	0.0253165
NODE_3765_length_1216_cov_99.538944	824	903	190	3	79	0.0379747
NODE_3765_length_1216_cov_99.538944	824	903	192	3	79	0.0379747
NODE_3765_length_1216_cov_99.538944	824	903	194	1	79	0.0126582
NODE_3765_length_1216_cov_99.538944	824	903	196	3	79	0.0379747
NODE_3765_length_1216_cov_99.538944	824	903	197	1	79	0.0126582
NODE_3765_length_1216_cov_99.538944	824	903	199	3	79	0.0379747
NODE_3765_length_1216_cov_99.538944	824	903	203	3	79	0.0379747
NODE_3765_length_1216_cov_99.538944	824	903	206	2	79	0.0253165
NODE_3765_length_1216_cov_99.538944	824	903	207	2	79	0.0253165
NODE_3765_length_1216_cov_99.538944	824	903	208	1	79	0.0126582
NODE_3765_length_1216_cov_99.538944	824	903	210	4	79	0.0506329
NODE_3765_length_1216_cov_99.538944	824	903	211	4	79	0.0506329
NODE_3765_length_1216_cov_99.538944	824	903	214	1	79	0.0126582
NODE_3765_length_1216_cov_99.538944	824	903	215	1	79	0.0126582
NODE_3765_length_1216_cov_99.538944	824	903	223	1	79	0.0126582
NODE_3765_length_1216_cov_99.538944	824	903	224	1	79	0.0126582
NODE_3765_length_1216_cov_99.538944	824	903	226	1	79	0.0126582
NODE_3765_length_1216_cov_99.538944	824	903	228	1	79	0.0126582
NODE_3766_length_1216_cov_15.855864	668	748	2	56	80	0.7000000
NODE_3766_length_1216_cov_15.855864	668	748	4	24	80	0.3000000
NODE_3766_length_1216_cov_15.855864	721	801	0	28	80	0.3500000
NODE_3766_length_1216_cov_15.855864	721	801	2	52	80	0.6500000
NODE_3767_length_1216_cov_4.128917	720	800	0	80	80	1.0000000
NODE_3767_length_1216_cov_4.128917	773	853	0	80	80	1.0000000
NODE_3774_length_1215_cov_32.293011	411	491	0	80	80	1.0000000
NODE_3774_length_1215_cov_32.293011	464	544	0	80	80	1.0000000
NODE_3775_length_1215_cov_24.177419	729	809	0	80	80	1.0000000
NODE_3775_length_1215_cov_24.177419	782	862	0	80	80	1.0000000
NODE_3776_length_1215_cov_21.566308	645	725	0	80	80	1.0000000
NODE_3776_length_1215_cov_21.566308	698	778	0	80	80	1.0000000
NODE_3777_length_1215_cov_19.278674	630	710	0	80	80	1.0000000
NODE_3777_length_1215_cov_19.278674	683	763	0	80	80	1.0000000
NODE_3778_length_1215_cov_15.074373	664	744	0	80	80	1.0000000
NODE_3778_length_1215_cov_15.074373	717	797	0	80	80	1.0000000
NODE_3779_length_1215_cov_5.932796	507	587	0	39	80	0.4875000
NODE_3779_length_1215_cov_5.932796	507	587	3	1	80	0.0125000
NODE_3779_length_1215_cov_5.932796	507	587	4	40	80	0.5000000
NODE_3779_length_1215_cov_5.932796	560	640	4	80	80	1.0000000
NODE_3787_length_1214_cov_26.771300	420	500	43	2	80	0.0250000
NODE_3787_length_1214_cov_26.771300	420	500	52	1	80	0.0125000
NODE_3787_length_1214_cov_26.771300	420	500	53	1	80	0.0125000
NODE_3787_length_1214_cov_26.771300	420	500	61	1	80	0.0125000
NODE_3787_length_1214_cov_26.771300	420	500	63	4	80	0.0500000
NODE_3787_length_1214_cov_26.771300	420	500	67	1	80	0.0125000
NODE_3787_length_1214_cov_26.771300	420	500	69	2	80	0.0250000
NODE_3787_length_1214_cov_26.771300	420	500	73	2	80	0.0250000
NODE_3787_length_1214_cov_26.771300	420	500	74	1	80	0.0125000
NODE_3787_length_1214_cov_26.771300	420	500	78	1	80	0.0125000
NODE_3787_length_1214_cov_26.771300	420	500	81	1	80	0.0125000
NODE_3787_length_1214_cov_26.771300	420	500	84	4	80	0.0500000
NODE_3787_length_1214_cov_26.771300	420	500	85	2	80	0.0250000
NODE_3787_length_1214_cov_26.771300	420	500	89	1	80	0.0125000
NODE_3787_length_1214_cov_26.771300	420	500	90	1	80	0.0125000
NODE_3787_length_1214_cov_26.771300	420	500	116	2	80	0.0250000
NODE_3787_length_1214_cov_26.771300	420	500	122	2	80	0.0250000
NODE_3787_length_1214_cov_26.771300	420	500	125	2	80	0.0250000
NODE_3787_length_1214_cov_26.771300	420	500	126	2	80	0.0250000
NODE_3787_length_1214_cov_26.771300	420	500	130	9	80	0.1125000
NODE_3787_length_1214_cov_26.771300	420	500	132	2	80	0.0250000
NODE_3787_length_1214_cov_26.771300	420	500	134	8	80	0.1000000
NODE_3787_length_1214_cov_26.771300	420	500	136	13	80	0.1625000
NODE_3787_length_1214_cov_26.771300	420	500	138	2	80	0.0250000
NODE_3787_length_1214_cov_26.771300	420	500	139	3	80	0.0375000
NODE_3787_length_1214_cov_26.771300	420	500	140	7	80	0.0875000
NODE_3787_length_1214_cov_26.771300	420	500	141	3	80	0.0375000
NODE_3787_length_1214_cov_26.771300	473	553	26	1	80	0.0125000
NODE_3787_length_1214_cov_26.771300	473	553	43	2	80	0.0250000
NODE_3787_length_1214_cov_26.771300	473	553	49	1	80	0.0125000
NODE_3787_length_1214_cov_26.771300	473	553	50	1	80	0.0125000
NODE_3787_length_1214_cov_26.771300	473	553	54	1	80	0.0125000
NODE_3787_length_1214_cov_26.771300	473	553	56	3	80	0.0375000
NODE_3787_length_1214_cov_26.771300	473	553	62	1	80	0.0125000
NODE_3787_length_1214_cov_26.771300	473	553	67	1	80	0.0125000
NODE_3787_length_1214_cov_26.771300	473	553	69	1	80	0.0125000
NODE_3787_length_1214_cov_26.771300	473	553	76	3	80	0.0375000
NODE_3787_length_1214_cov_26.771300	473	553	78	5	80	0.0625000
NODE_3787_length_1214_cov_26.771300	473	553	83	2	80	0.0250000
NODE_3787_length_1214_cov_26.771300	473	553	87	1	80	0.0125000
NODE_3787_length_1214_cov_26.771300	473	553	89	3	80	0.0375000
NODE_3787_length_1214_cov_26.771300	473	553	93	3	80	0.0375000
NODE_3787_length_1214_cov_26.771300	473	553	95	1	80	0.0125000
NODE_3787_length_1214_cov_26.771300	473	553	101	2	80	0.0250000
NODE_3787_length_1214_cov_26.771300	473	553	105	3	80	0.0375000
NODE_3787_length_1214_cov_26.771300	473	553	112	1	80	0.0125000
NODE_3787_length_1214_cov_26.771300	473	553	118	2	80	0.0250000
NODE_3787_length_1214_cov_26.771300	473	553	119	1	80	0.0125000
NODE_3787_length_1214_cov_26.771300	473	553	123	4	80	0.0500000
NODE_3787_length_1214_cov_26.771300	473	553	127	1	80	0.0125000
NODE_3787_length_1214_cov_26.771300	473	553	129	2	80	0.0250000
NODE_3787_length_1214_cov_26.771300	473	553	131	1	80	0.0125000
NODE_3787_length_1214_cov_26.771300	473	553	134	9	80	0.1125000
NODE_3787_length_1214_cov_26.771300	473	553	135	1	80	0.0125000
NODE_3787_length_1214_cov_26.771300	473	553	136	8	80	0.1000000
NODE_3787_length_1214_cov_26.771300	473	553	138	2	80	0.0250000
NODE_3787_length_1214_cov_26.771300	473	553	139	3	80	0.0375000
NODE_3787_length_1214_cov_26.771300	473	553	140	7	80	0.0875000
NODE_3787_length_1214_cov_26.771300	473	553	141	3	80	0.0375000
NODE_3788_length_1214_cov_24.555157	480	560	0	80	80	1.0000000
NODE_3788_length_1214_cov_24.555157	533	613	0	80	80	1.0000000
NODE_3789_length_1214_cov_23.167713	623	703	0	80	80	1.0000000
NODE_3789_length_1214_cov_23.167713	676	756	0	80	80	1.0000000
NODE_3790_length_1214_cov_18.452915	555	635	0	1	80	0.0125000
NODE_3790_length_1214_cov_18.452915	555	635	2	2	80	0.0250000
NODE_3790_length_1214_cov_18.452915	555	635	4	66	80	0.8250000
NODE_3790_length_1214_cov_18.452915	555	635	7	11	80	0.1375000
NODE_3790_length_1214_cov_18.452915	608	688	0	54	80	0.6750000
NODE_3790_length_1214_cov_18.452915	608	688	2	2	80	0.0250000
NODE_3790_length_1214_cov_18.452915	608	688	4	24	80	0.3000000
NODE_3790_length_1214_cov_18.452915	684	764	0	80	80	1.0000000
NODE_3790_length_1214_cov_18.452915	737	817	0	80	80	1.0000000
NODE_3791_length_1214_cov_8.906726	206	286	0	80	80	1.0000000
NODE_3791_length_1214_cov_8.906726	259	339	0	80	80	1.0000000
NODE_3792_length_1214_cov_3.686996	415	495	0	80	80	1.0000000
NODE_3792_length_1214_cov_3.686996	468	548	0	80	80	1.0000000
NODE_3799_length_1214_cov_0.967713	1049	1129	281	1	80	0.0125000
NODE_3799_length_1214_cov_0.967713	1049	1129	285	1	80	0.0125000
NODE_3799_length_1214_cov_0.967713	1049	1129	288	1	80	0.0125000
NODE_3799_length_1214_cov_0.967713	1049	1129	296	1	80	0.0125000
NODE_3799_length_1214_cov_0.967713	1049	1129	303	1	80	0.0125000
NODE_3799_length_1214_cov_0.967713	1049	1129	307	1	80	0.0125000
NODE_3799_length_1214_cov_0.967713	1049	1129	311	1	80	0.0125000
NODE_3799_length_1214_cov_0.967713	1049	1129	313	1	80	0.0125000
NODE_3799_length_1214_cov_0.967713	1049	1129	330	1	80	0.0125000
NODE_3799_length_1214_cov_0.967713	1049	1129	334	1	80	0.0125000
NODE_3799_length_1214_cov_0.967713	1049	1129	338	1	80	0.0125000
NODE_3799_length_1214_cov_0.967713	1049	1129	340	1	80	0.0125000
NODE_3799_length_1214_cov_0.967713	1049	1129	386	1	80	0.0125000
NODE_3799_length_1214_cov_0.967713	1049	1129	401	1	80	0.0125000
NODE_3799_length_1214_cov_0.967713	1049	1129	402	1	80	0.0125000
NODE_3799_length_1214_cov_0.967713	1049	1129	407	3	80	0.0375000
NODE_3799_length_1214_cov_0.967713	1049	1129	408	2	80	0.0250000
NODE_3799_length_1214_cov_0.967713	1049	1129	409	2	80	0.0250000
NODE_3799_length_1214_cov_0.967713	1049	1129	411	1	80	0.0125000
NODE_3799_length_1214_cov_0.967713	1049	1129	412	1	80	0.0125000
NODE_3799_length_1214_cov_0.967713	1049	1129	416	3	80	0.0375000
NODE_3799_length_1214_cov_0.967713	1049	1129	417	2	80	0.0250000
NODE_3799_length_1214_cov_0.967713	1049	1129	418	2	80	0.0250000
NODE_3799_length_1214_cov_0.967713	1049	1129	419	3	80	0.0375000
NODE_3799_length_1214_cov_0.967713	1049	1129	421	1	80	0.0125000
NODE_3799_length_1214_cov_0.967713	1049	1129	423	3	80	0.0375000
NODE_3799_length_1214_cov_0.967713	1049	1129	425	2	80	0.0250000
NODE_3799_length_1214_cov_0.967713	1049	1129	428	2	80	0.0250000
NODE_3799_length_1214_cov_0.967713	1049	1129	429	2	80	0.0250000
NODE_3799_length_1214_cov_0.967713	1049	1129	430	6	80	0.0750000
NODE_3799_length_1214_cov_0.967713	1049	1129	431	1	80	0.0125000
NODE_3799_length_1214_cov_0.967713	1049	1129	433	2	80	0.0250000
NODE_3799_length_1214_cov_0.967713	1049	1129	435	3	80	0.0375000
NODE_3799_length_1214_cov_0.967713	1049	1129	439	2	80	0.0250000
NODE_3799_length_1214_cov_0.967713	1049	1129	447	2	80	0.0250000
NODE_3799_length_1214_cov_0.967713	1049	1129	450	1	80	0.0125000
NODE_3799_length_1214_cov_0.967713	1049	1129	451	1	80	0.0125000
NODE_3799_length_1214_cov_0.967713	1049	1129	452	1	80	0.0125000
NODE_3799_length_1214_cov_0.967713	1049	1129	453	2	80	0.0250000
NODE_3799_length_1214_cov_0.967713	1049	1129	457	2	80	0.0250000
NODE_3799_length_1214_cov_0.967713	1049	1129	459	1	80	0.0125000
NODE_3799_length_1214_cov_0.967713	1049	1129	460	1	80	0.0125000
NODE_3799_length_1214_cov_0.967713	1049	1129	461	1	80	0.0125000
NODE_3799_length_1214_cov_0.967713	1049	1129	463	1	80	0.0125000
NODE_3799_length_1214_cov_0.967713	1049	1129	464	3	80	0.0375000
NODE_3799_length_1214_cov_0.967713	1049	1129	468	1	80	0.0125000
NODE_3799_length_1214_cov_0.967713	1049	1129	469	1	80	0.0125000
NODE_3799_length_1214_cov_0.967713	1049	1129	470	1	80	0.0125000
NODE_3799_length_1214_cov_0.967713	1049	1129	471	2	80	0.0250000
NODE_3799_length_1214_cov_0.967713	1049	1129	472	1	80	0.0125000
NODE_3800_length_1213_cov_19.524237	499	579	0	58	80	0.7250000
NODE_3800_length_1213_cov_19.524237	499	579	2	22	80	0.2750000
NODE_3800_length_1213_cov_19.524237	552	632	0	5	80	0.0625000
NODE_3800_length_1213_cov_19.524237	552	632	2	75	80	0.9375000
NODE_3806_length_1212_cov_32.663073	688	768	0	80	80	1.0000000
NODE_3806_length_1212_cov_32.663073	741	821	0	80	80	1.0000000
NODE_3807_length_1212_cov_15.981132	33	113	17	4	80	0.0500000
NODE_3807_length_1212_cov_15.981132	33	113	18	20	80	0.2500000
NODE_3807_length_1212_cov_15.981132	33	113	19	11	80	0.1375000
NODE_3807_length_1212_cov_15.981132	33	113	20	20	80	0.2500000
NODE_3807_length_1212_cov_15.981132	33	113	21	2	80	0.0250000
NODE_3807_length_1212_cov_15.981132	33	113	22	23	80	0.2875000
NODE_3807_length_1212_cov_15.981132	511	591	0	80	80	1.0000000
NODE_3807_length_1212_cov_15.981132	564	637	0	73	73	1.0000000
NODE_3813_length_1211_cov_30.513489	561	641	0	80	80	1.0000000
NODE_3813_length_1211_cov_30.513489	614	694	0	80	80	1.0000000
NODE_3813_length_1211_cov_30.513489	690	770	0	80	80	1.0000000
NODE_3813_length_1211_cov_30.513489	743	823	0	80	80	1.0000000
NODE_3815_length_1211_cov_10.073741	380	460	0	80	80	1.0000000
NODE_3815_length_1211_cov_10.073741	433	513	0	80	80	1.0000000
NODE_3816_length_1211_cov_7.561151	598	678	0	80	80	1.0000000
NODE_3816_length_1211_cov_7.561151	651	731	0	80	80	1.0000000
NODE_3820_length_1210_cov_49.743474	398	478	0	80	80	1.0000000
NODE_3820_length_1210_cov_49.743474	451	531	0	80	80	1.0000000
NODE_3821_length_1210_cov_15.647165	647	727	0	80	80	1.0000000
NODE_3821_length_1210_cov_15.647165	700	780	0	80	80	1.0000000
NODE_3822_length_1210_cov_11.194419	794	874	0	80	80	1.0000000
NODE_3822_length_1210_cov_11.194419	847	927	0	80	80	1.0000000
NODE_3826_length_1209_cov_24.504505	582	662	1	32	80	0.4000000
NODE_3826_length_1209_cov_24.504505	582	662	2	48	80	0.6000000
NODE_3826_length_1209_cov_24.504505	635	715	1	80	80	1.0000000
NODE_3826_length_1209_cov_24.504505	711	791	0	3	80	0.0375000
NODE_3826_length_1209_cov_24.504505	711	791	1	12	80	0.1500000
NODE_3826_length_1209_cov_24.504505	711	791	2	65	80	0.8125000
NODE_3826_length_1209_cov_24.504505	764	844	0	54	80	0.6750000
NODE_3826_length_1209_cov_24.504505	764	844	2	26	80	0.3250000
NODE_3827_length_1209_cov_21.846847	520	600	0	80	80	1.0000000
NODE_3827_length_1209_cov_21.846847	573	653	0	80	80	1.0000000
NODE_3827_length_1209_cov_21.846847	649	729	0	80	80	1.0000000
NODE_3827_length_1209_cov_21.846847	702	782	0	80	80	1.0000000
NODE_3828_length_1209_cov_9.026126	782	862	0	80	80	1.0000000
NODE_3828_length_1209_cov_9.026126	835	915	0	80	80	1.0000000
NODE_3830_length_1209_cov_5.721622	926	1006	0	16	80	0.2000000
NODE_3830_length_1209_cov_5.721622	926	1006	2	64	80	0.8000000
NODE_3830_length_1209_cov_5.721622	979	1059	0	69	80	0.8625000
NODE_3830_length_1209_cov_5.721622	979	1059	2	11	80	0.1375000
NODE_3833_length_1208_cov_40.717764	886	966	130	4	80	0.0500000
NODE_3833_length_1208_cov_40.717764	886	966	132	1	80	0.0125000
NODE_3833_length_1208_cov_40.717764	886	966	133	2	80	0.0250000
NODE_3833_length_1208_cov_40.717764	886	966	134	4	80	0.0500000
NODE_3833_length_1208_cov_40.717764	886	966	138	2	80	0.0250000
NODE_3833_length_1208_cov_40.717764	886	966	139	1	80	0.0125000
NODE_3833_length_1208_cov_40.717764	886	966	141	1	80	0.0125000
NODE_3833_length_1208_cov_40.717764	886	966	142	2	80	0.0250000
NODE_3833_length_1208_cov_40.717764	886	966	143	3	80	0.0375000
NODE_3833_length_1208_cov_40.717764	886	966	144	2	80	0.0250000
NODE_3833_length_1208_cov_40.717764	886	966	145	3	80	0.0375000
NODE_3833_length_1208_cov_40.717764	886	966	147	2	80	0.0250000
NODE_3833_length_1208_cov_40.717764	886	966	151	1	80	0.0125000
NODE_3833_length_1208_cov_40.717764	886	966	157	2	80	0.0250000
NODE_3833_length_1208_cov_40.717764	886	966	166	1	80	0.0125000
NODE_3833_length_1208_cov_40.717764	886	966	167	1	80	0.0125000
NODE_3833_length_1208_cov_40.717764	886	966	169	2	80	0.0250000
NODE_3833_length_1208_cov_40.717764	886	966	171	1	80	0.0125000
NODE_3833_length_1208_cov_40.717764	886	966	175	2	80	0.0250000
NODE_3833_length_1208_cov_40.717764	886	966	177	1	80	0.0125000
NODE_3833_length_1208_cov_40.717764	886	966	180	2	80	0.0250000
NODE_3833_length_1208_cov_40.717764	886	966	181	2	80	0.0250000
NODE_3833_length_1208_cov_40.717764	886	966	182	1	80	0.0125000
NODE_3833_length_1208_cov_40.717764	886	966	183	3	80	0.0375000
NODE_3833_length_1208_cov_40.717764	886	966	184	1	80	0.0125000
NODE_3833_length_1208_cov_40.717764	886	966	185	1	80	0.0125000
NODE_3833_length_1208_cov_40.717764	886	966	187	1	80	0.0125000
NODE_3833_length_1208_cov_40.717764	886	966	195	2	80	0.0250000
NODE_3833_length_1208_cov_40.717764	886	966	197	1	80	0.0125000
NODE_3833_length_1208_cov_40.717764	886	966	198	1	80	0.0125000
NODE_3833_length_1208_cov_40.717764	886	966	223	1	80	0.0125000
NODE_3833_length_1208_cov_40.717764	886	966	227	1	80	0.0125000
NODE_3833_length_1208_cov_40.717764	886	966	234	1	80	0.0125000
NODE_3833_length_1208_cov_40.717764	886	966	240	1	80	0.0125000
NODE_3833_length_1208_cov_40.717764	886	966	242	1	80	0.0125000
NODE_3833_length_1208_cov_40.717764	886	966	248	1	80	0.0125000
NODE_3833_length_1208_cov_40.717764	886	966	252	1	80	0.0125000
NODE_3833_length_1208_cov_40.717764	886	966	258	1	80	0.0125000
NODE_3833_length_1208_cov_40.717764	886	966	267	1	80	0.0125000
NODE_3833_length_1208_cov_40.717764	886	966	272	1	80	0.0125000
NODE_3833_length_1208_cov_40.717764	886	966	277	2	80	0.0250000
NODE_3833_length_1208_cov_40.717764	886	966	294	1	80	0.0125000
NODE_3833_length_1208_cov_40.717764	886	966	296	1	80	0.0125000
NODE_3833_length_1208_cov_40.717764	886	966	305	1	80	0.0125000
NODE_3833_length_1208_cov_40.717764	886	966	307	1	80	0.0125000
NODE_3833_length_1208_cov_40.717764	886	966	316	1	80	0.0125000
NODE_3833_length_1208_cov_40.717764	886	966	329	1	80	0.0125000
NODE_3833_length_1208_cov_40.717764	886	966	333	1	80	0.0125000
NODE_3833_length_1208_cov_40.717764	886	966	342	1	80	0.0125000
NODE_3833_length_1208_cov_40.717764	886	966	352	1	80	0.0125000
NODE_3833_length_1208_cov_40.717764	886	966	358	1	80	0.0125000
NODE_3833_length_1208_cov_40.717764	886	966	385	1	80	0.0125000
NODE_3833_length_1208_cov_40.717764	886	966	389	1	80	0.0125000
NODE_3833_length_1208_cov_40.717764	886	966	398	1	80	0.0125000
NODE_3833_length_1208_cov_40.717764	886	966	421	1	80	0.0125000
NODE_3833_length_1208_cov_40.717764	886	966	431	1	80	0.0125000
NODE_3833_length_1208_cov_40.717764	939	985	223	1	46	0.0217391
NODE_3833_length_1208_cov_40.717764	939	985	227	1	46	0.0217391
NODE_3833_length_1208_cov_40.717764	939	985	234	1	46	0.0217391
NODE_3833_length_1208_cov_40.717764	939	985	240	1	46	0.0217391
NODE_3833_length_1208_cov_40.717764	939	985	242	1	46	0.0217391
NODE_3833_length_1208_cov_40.717764	939	985	248	1	46	0.0217391
NODE_3833_length_1208_cov_40.717764	939	985	252	1	46	0.0217391
NODE_3833_length_1208_cov_40.717764	939	985	258	1	46	0.0217391
NODE_3833_length_1208_cov_40.717764	939	985	267	1	46	0.0217391
NODE_3833_length_1208_cov_40.717764	939	985	272	1	46	0.0217391
NODE_3833_length_1208_cov_40.717764	939	985	277	2	46	0.0434783
NODE_3833_length_1208_cov_40.717764	939	985	294	1	46	0.0217391
NODE_3833_length_1208_cov_40.717764	939	985	296	1	46	0.0217391
NODE_3833_length_1208_cov_40.717764	939	985	305	1	46	0.0217391
NODE_3833_length_1208_cov_40.717764	939	985	307	1	46	0.0217391
NODE_3833_length_1208_cov_40.717764	939	985	316	1	46	0.0217391
NODE_3833_length_1208_cov_40.717764	939	985	329	1	46	0.0217391
NODE_3833_length_1208_cov_40.717764	939	985	333	1	46	0.0217391
NODE_3833_length_1208_cov_40.717764	939	985	342	1	46	0.0217391
NODE_3833_length_1208_cov_40.717764	939	985	352	1	46	0.0217391
NODE_3833_length_1208_cov_40.717764	939	985	358	1	46	0.0217391
NODE_3833_length_1208_cov_40.717764	939	985	385	1	46	0.0217391
NODE_3833_length_1208_cov_40.717764	939	985	389	1	46	0.0217391
NODE_3833_length_1208_cov_40.717764	939	985	398	1	46	0.0217391
NODE_3833_length_1208_cov_40.717764	939	985	421	1	46	0.0217391
NODE_3833_length_1208_cov_40.717764	939	985	431	1	46	0.0217391
NODE_3833_length_1208_cov_40.717764	939	985	434	1	46	0.0217391
NODE_3833_length_1208_cov_40.717764	939	985	436	1	46	0.0217391
NODE_3833_length_1208_cov_40.717764	939	985	442	1	46	0.0217391
NODE_3833_length_1208_cov_40.717764	939	985	448	1	46	0.0217391
NODE_3833_length_1208_cov_40.717764	939	985	451	1	46	0.0217391
NODE_3833_length_1208_cov_40.717764	939	985	460	2	46	0.0434783
NODE_3833_length_1208_cov_40.717764	939	985	461	1	46	0.0217391
NODE_3833_length_1208_cov_40.717764	939	985	465	1	46	0.0217391
NODE_3833_length_1208_cov_40.717764	939	985	473	1	46	0.0217391
NODE_3833_length_1208_cov_40.717764	939	985	479	1	46	0.0217391
NODE_3833_length_1208_cov_40.717764	939	985	486	1	46	0.0217391
NODE_3833_length_1208_cov_40.717764	939	985	487	1	46	0.0217391
NODE_3833_length_1208_cov_40.717764	939	985	497	1	46	0.0217391
NODE_3833_length_1208_cov_40.717764	939	985	500	1	46	0.0217391
NODE_3833_length_1208_cov_40.717764	939	985	508	2	46	0.0434783
NODE_3833_length_1208_cov_40.717764	939	985	512	1	46	0.0217391
NODE_3833_length_1208_cov_40.717764	939	985	518	1	46	0.0217391
NODE_3834_length_1208_cov_28.528404	614	694	0	80	80	1.0000000
NODE_3834_length_1208_cov_28.528404	667	747	0	80	80	1.0000000
NODE_3835_length_1208_cov_19.688007	682	762	0	80	80	1.0000000
NODE_3835_length_1208_cov_19.688007	735	815	0	80	80	1.0000000
NODE_3836_length_1208_cov_18.577096	455	535	0	80	80	1.0000000
NODE_3836_length_1208_cov_18.577096	508	588	0	80	80	1.0000000
NODE_3836_length_1208_cov_18.577096	584	664	0	49	80	0.6125000
NODE_3836_length_1208_cov_18.577096	584	664	2	31	80	0.3875000
NODE_3836_length_1208_cov_18.577096	637	717	0	22	80	0.2750000
NODE_3836_length_1208_cov_18.577096	637	717	2	58	80	0.7250000
NODE_3837_length_1208_cov_12.733995	766	846	0	80	80	1.0000000
NODE_3837_length_1208_cov_12.733995	819	899	0	80	80	1.0000000
NODE_3837_length_1208_cov_12.733995	895	975	0	80	80	1.0000000
NODE_3837_length_1208_cov_12.733995	948	1028	0	33	80	0.4125000
NODE_3837_length_1208_cov_12.733995	948	1028	2	47	80	0.5875000
NODE_3838_length_1207_cov_20.461191	874	954	0	33	80	0.4125000
NODE_3838_length_1207_cov_20.461191	874	954	2	19	80	0.2375000
NODE_3838_length_1207_cov_20.461191	874	954	3	2	80	0.0250000
NODE_3838_length_1207_cov_20.461191	874	954	4	26	80	0.3250000
NODE_3838_length_1207_cov_20.461191	927	1007	0	80	80	1.0000000
NODE_3846_length_1206_cov_59.851852	540	620	0	80	80	1.0000000
NODE_3846_length_1206_cov_59.851852	593	673	0	80	80	1.0000000
NODE_3846_length_1206_cov_59.851852	669	749	0	80	80	1.0000000
NODE_3846_length_1206_cov_59.851852	722	802	0	80	80	1.0000000
NODE_3847_length_1206_cov_23.752484	669	749	2	80	80	1.0000000
NODE_3847_length_1206_cov_23.752484	722	802	0	1	80	0.0125000
NODE_3847_length_1206_cov_23.752484	722	802	1	50	80	0.6250000
NODE_3847_length_1206_cov_23.752484	722	802	2	29	80	0.3625000
NODE_3848_length_1206_cov_21.226739	585	665	0	80	80	1.0000000
NODE_3848_length_1206_cov_21.226739	638	718	0	80	80	1.0000000
NODE_3855_length_1205_cov_23.990054	355	435	0	80	80	1.0000000
NODE_3855_length_1205_cov_23.990054	408	488	0	80	80	1.0000000
NODE_3856_length_1205_cov_10.473779	780	860	0	80	80	1.0000000
NODE_3856_length_1205_cov_10.473779	833	913	0	80	80	1.0000000
NODE_3863_length_1204_cov_19.396380	537	617	0	80	80	1.0000000
NODE_3863_length_1204_cov_19.396380	590	670	0	80	80	1.0000000
NODE_3864_length_1204_cov_17.716742	448	528	0	80	80	1.0000000
NODE_3864_length_1204_cov_17.716742	501	581	0	27	80	0.3375000
NODE_3864_length_1204_cov_17.716742	501	581	2	53	80	0.6625000
NODE_3865_length_1204_cov_15.206335	426	506	0	80	80	1.0000000
NODE_3865_length_1204_cov_15.206335	479	559	0	80	80	1.0000000
NODE_3866_length_1204_cov_14.097738	632	712	0	80	80	1.0000000
NODE_3866_length_1204_cov_14.097738	685	765	0	80	80	1.0000000
NODE_3867_length_1204_cov_11.971946	549	629	4	80	80	1.0000000
NODE_3867_length_1204_cov_11.971946	602	682	0	49	80	0.6125000
NODE_3867_length_1204_cov_11.971946	602	682	4	31	80	0.3875000
NODE_3867_length_1204_cov_11.971946	678	758	0	80	80	1.0000000
NODE_3867_length_1204_cov_11.971946	731	811	0	65	80	0.8125000
NODE_3867_length_1204_cov_11.971946	731	811	2	15	80	0.1875000
NODE_3868_length_1204_cov_11.665158	499	579	2	80	80	1.0000000
NODE_3868_length_1204_cov_11.665158	552	632	0	39	80	0.4875000
NODE_3868_length_1204_cov_11.665158	552	632	2	41	80	0.5125000
NODE_3869_length_1204_cov_7.028959	637	717	0	43	80	0.5375000
NODE_3869_length_1204_cov_7.028959	637	717	2	37	80	0.4625000
NODE_3869_length_1204_cov_7.028959	690	770	0	28	80	0.3500000
NODE_3869_length_1204_cov_7.028959	690	770	2	52	80	0.6500000
NODE_3870_length_1204_cov_4.677828	807	887	0	80	80	1.0000000
NODE_3870_length_1204_cov_4.677828	860	940	0	80	80	1.0000000
NODE_3873_length_1203_cov_46.789855	515	595	0	80	80	1.0000000
NODE_3873_length_1203_cov_46.789855	568	648	0	80	80	1.0000000
NODE_3873_length_1203_cov_46.789855	644	724	0	80	80	1.0000000
NODE_3873_length_1203_cov_46.789855	697	777	0	80	80	1.0000000
NODE_3874_length_1203_cov_44.029891	471	551	0	80	80	1.0000000
NODE_3874_length_1203_cov_44.029891	524	604	0	80	80	1.0000000
NODE_3874_length_1203_cov_44.029891	600	680	0	80	80	1.0000000
NODE_3874_length_1203_cov_44.029891	653	733	0	70	80	0.8750000
NODE_3874_length_1203_cov_44.029891	653	733	2	10	80	0.1250000
NODE_3875_length_1203_cov_23.790761	308	388	0	80	80	1.0000000
NODE_3875_length_1203_cov_23.790761	361	441	0	80	80	1.0000000
NODE_3875_length_1203_cov_23.790761	437	517	0	77	80	0.9625000
NODE_3875_length_1203_cov_23.790761	437	517	2	3	80	0.0375000
NODE_3875_length_1203_cov_23.790761	490	570	0	24	80	0.3000000
NODE_3875_length_1203_cov_23.790761	490	570	2	56	80	0.7000000
NODE_3876_length_1203_cov_19.498188	336	416	0	80	80	1.0000000
NODE_3876_length_1203_cov_19.498188	389	469	0	80	80	1.0000000
NODE_3877_length_1203_cov_10.996377	317	397	0	80	80	1.0000000
NODE_3877_length_1203_cov_10.996377	370	450	0	80	80	1.0000000
NODE_3878_length_1203_cov_5.747283	725	805	0	80	80	1.0000000
NODE_3878_length_1203_cov_5.747283	778	858	0	80	80	1.0000000
NODE_3881_length_1202_cov_39.333636	475	555	0	80	80	1.0000000
NODE_3881_length_1202_cov_39.333636	528	608	0	80	80	1.0000000
NODE_3881_length_1202_cov_39.333636	604	684	0	80	80	1.0000000
NODE_3881_length_1202_cov_39.333636	657	737	0	80	80	1.0000000
NODE_3882_length_1202_cov_17.556664	599	679	0	58	80	0.7250000
NODE_3882_length_1202_cov_17.556664	599	679	2	16	80	0.2000000
NODE_3882_length_1202_cov_17.556664	599	679	4	6	80	0.0750000
NODE_3882_length_1202_cov_17.556664	652	732	0	5	80	0.0625000
NODE_3882_length_1202_cov_17.556664	652	732	2	16	80	0.2000000
NODE_3882_length_1202_cov_17.556664	652	732	4	59	80	0.7375000
NODE_3883_length_1202_cov_12.338169	634	714	0	80	80	1.0000000
NODE_3883_length_1202_cov_12.338169	687	767	0	80	80	1.0000000
NODE_3884_length_1202_cov_11.800544	520	600	0	80	80	1.0000000
NODE_3884_length_1202_cov_11.800544	573	653	0	41	80	0.5125000
NODE_3884_length_1202_cov_11.800544	573	653	2	39	80	0.4875000
NODE_3887_length_1201_cov_12.161525	434	514	0	80	80	1.0000000
NODE_3887_length_1201_cov_12.161525	487	567	0	80	80	1.0000000
NODE_3888_length_1201_cov_12.046279	643	723	0	80	80	1.0000000
NODE_3888_length_1201_cov_12.046279	696	776	0	80	80	1.0000000
NODE_3891_length_1200_cov_76.694823	630	710	0	23	80	0.2875000
NODE_3891_length_1200_cov_76.694823	630	710	2	57	80	0.7125000
NODE_3891_length_1200_cov_76.694823	683	763	0	76	80	0.9500000
NODE_3891_length_1200_cov_76.694823	683	763	2	4	80	0.0500000
NODE_3891_length_1200_cov_76.694823	759	839	0	80	80	1.0000000
NODE_3891_length_1200_cov_76.694823	812	892	0	80	80	1.0000000
NODE_3892_length_1200_cov_16.881926	827	902	0	21	75	0.2800000
NODE_3892_length_1200_cov_16.881926	827	902	13	3	75	0.0400000
NODE_3892_length_1200_cov_16.881926	827	902	26	3	75	0.0400000
NODE_3892_length_1200_cov_16.881926	827	902	32	1	75	0.0133333
NODE_3892_length_1200_cov_16.881926	827	902	34	11	75	0.1466667
NODE_3892_length_1200_cov_16.881926	827	902	36	1	75	0.0133333
NODE_3892_length_1200_cov_16.881926	827	902	37	4	75	0.0533333
NODE_3892_length_1200_cov_16.881926	827	902	47	10	75	0.1333333
NODE_3892_length_1200_cov_16.881926	827	902	62	5	75	0.0666667
NODE_3892_length_1200_cov_16.881926	827	902	78	2	75	0.0266667
NODE_3892_length_1200_cov_16.881926	827	902	80	2	75	0.0266667
NODE_3892_length_1200_cov_16.881926	827	902	81	1	75	0.0133333
NODE_3892_length_1200_cov_16.881926	827	902	83	11	75	0.1466667
NODE_3892_length_1200_cov_16.881926	828	904	0	20	76	0.2631579
NODE_3892_length_1200_cov_16.881926	828	904	13	3	76	0.0394737
NODE_3892_length_1200_cov_16.881926	828	904	26	3	76	0.0394737
NODE_3892_length_1200_cov_16.881926	828	904	32	1	76	0.0131579
NODE_3892_length_1200_cov_16.881926	828	904	34	11	76	0.1447368
NODE_3892_length_1200_cov_16.881926	828	904	36	1	76	0.0131579
NODE_3892_length_1200_cov_16.881926	828	904	37	4	76	0.0526316
NODE_3892_length_1200_cov_16.881926	828	904	47	10	76	0.1315790
NODE_3892_length_1200_cov_16.881926	828	904	62	5	76	0.0657895
NODE_3892_length_1200_cov_16.881926	828	904	78	2	76	0.0263158
NODE_3892_length_1200_cov_16.881926	828	904	80	2	76	0.0263158
NODE_3892_length_1200_cov_16.881926	828	904	81	1	76	0.0131579
NODE_3892_length_1200_cov_16.881926	828	904	83	13	76	0.1710526
NODE_3892_length_1200_cov_16.881926	841	907	0	7	66	0.1060606
NODE_3892_length_1200_cov_16.881926	841	907	13	3	66	0.0454545
NODE_3892_length_1200_cov_16.881926	841	907	26	3	66	0.0454545
NODE_3892_length_1200_cov_16.881926	841	907	32	1	66	0.0151515
NODE_3892_length_1200_cov_16.881926	841	907	34	11	66	0.1666667
NODE_3892_length_1200_cov_16.881926	841	907	36	1	66	0.0151515
NODE_3892_length_1200_cov_16.881926	841	907	37	4	66	0.0606061
NODE_3892_length_1200_cov_16.881926	841	907	47	10	66	0.1515152
NODE_3892_length_1200_cov_16.881926	841	907	62	5	66	0.0757576
NODE_3892_length_1200_cov_16.881926	841	907	78	2	66	0.0303030
NODE_3892_length_1200_cov_16.881926	841	907	80	2	66	0.0303030
NODE_3892_length_1200_cov_16.881926	841	907	81	1	66	0.0151515
NODE_3892_length_1200_cov_16.881926	841	907	83	16	66	0.2424242
NODE_3892_length_1200_cov_16.881926	880	957	47	1	77	0.0129870
NODE_3892_length_1200_cov_16.881926	880	957	62	5	77	0.0649351
NODE_3892_length_1200_cov_16.881926	880	957	78	2	77	0.0259740
NODE_3892_length_1200_cov_16.881926	880	957	80	2	77	0.0259740
NODE_3892_length_1200_cov_16.881926	880	957	81	1	77	0.0129870
NODE_3892_length_1200_cov_16.881926	880	957	83	19	77	0.2467532
NODE_3892_length_1200_cov_16.881926	880	957	85	26	77	0.3376623
NODE_3892_length_1200_cov_16.881926	880	957	88	1	77	0.0129870
NODE_3892_length_1200_cov_16.881926	880	957	91	6	77	0.0779221
NODE_3892_length_1200_cov_16.881926	880	957	93	1	77	0.0129870
NODE_3892_length_1200_cov_16.881926	880	957	94	11	77	0.1428571
NODE_3892_length_1200_cov_16.881926	880	957	97	2	77	0.0259740
NODE_3892_length_1200_cov_16.881926	880	957	47	1	77	0.0129870
NODE_3892_length_1200_cov_16.881926	880	957	62	5	77	0.0649351
NODE_3892_length_1200_cov_16.881926	880	957	78	2	77	0.0259740
NODE_3892_length_1200_cov_16.881926	880	957	80	2	77	0.0259740
NODE_3892_length_1200_cov_16.881926	880	957	81	1	77	0.0129870
NODE_3892_length_1200_cov_16.881926	880	957	83	19	77	0.2467532
NODE_3892_length_1200_cov_16.881926	880	957	85	26	77	0.3376623
NODE_3892_length_1200_cov_16.881926	880	957	88	1	77	0.0129870
NODE_3892_length_1200_cov_16.881926	880	957	91	6	77	0.0779221
NODE_3892_length_1200_cov_16.881926	880	957	93	1	77	0.0129870
NODE_3892_length_1200_cov_16.881926	880	957	94	11	77	0.1428571
NODE_3892_length_1200_cov_16.881926	880	957	97	2	77	0.0259740
NODE_3892_length_1200_cov_16.881926	880	957	47	1	77	0.0129870
NODE_3892_length_1200_cov_16.881926	880	957	62	5	77	0.0649351
NODE_3892_length_1200_cov_16.881926	880	957	78	2	77	0.0259740
NODE_3892_length_1200_cov_16.881926	880	957	80	2	77	0.0259740
NODE_3892_length_1200_cov_16.881926	880	957	81	1	77	0.0129870
NODE_3892_length_1200_cov_16.881926	880	957	83	19	77	0.2467532
NODE_3892_length_1200_cov_16.881926	880	957	85	26	77	0.3376623
NODE_3892_length_1200_cov_16.881926	880	957	88	1	77	0.0129870
NODE_3892_length_1200_cov_16.881926	880	957	91	6	77	0.0779221
NODE_3892_length_1200_cov_16.881926	880	957	93	1	77	0.0129870
NODE_3892_length_1200_cov_16.881926	880	957	94	11	77	0.1428571
NODE_3892_length_1200_cov_16.881926	880	957	97	2	77	0.0259740
NODE_3893_length_1200_cov_15.374205	605	685	0	80	80	1.0000000
NODE_3893_length_1200_cov_15.374205	658	738	0	80	80	1.0000000
NODE_3894_length_1200_cov_12.953678	486	550	0	64	64	1.0000000
NODE_3899_length_1199_cov_14.843636	222	302	0	80	80	1.0000000
NODE_3899_length_1199_cov_14.843636	275	355	0	80	80	1.0000000
NODE_3900_length_1199_cov_12.005455	383	463	0	80	80	1.0000000
NODE_3900_length_1199_cov_12.005455	436	516	0	80	80	1.0000000
NODE_3900_length_1199_cov_12.005455	512	592	0	80	80	1.0000000
NODE_3900_length_1199_cov_12.005455	565	645	0	80	80	1.0000000
NODE_3902_length_1198_cov_36.830755	619	699	0	80	80	1.0000000
NODE_3902_length_1198_cov_36.830755	672	752	0	80	80	1.0000000
NODE_3903_length_1198_cov_22.864422	719	799	0	80	80	1.0000000
NODE_3903_length_1198_cov_22.864422	772	852	0	80	80	1.0000000
NODE_3904_length_1198_cov_17.619654	260	340	0	5	80	0.0625000
NODE_3904_length_1198_cov_17.619654	260	340	4	75	80	0.9375000
NODE_3904_length_1198_cov_17.619654	313	392	0	39	79	0.4936709
NODE_3904_length_1198_cov_17.619654	313	392	4	40	79	0.5063291
NODE_3905_length_1198_cov_10.148317	718	798	0	80	80	1.0000000
NODE_3905_length_1198_cov_10.148317	771	851	0	80	80	1.0000000
NODE_3906_length_1198_cov_6.733394	549	629	0	80	80	1.0000000
NODE_3906_length_1198_cov_6.733394	602	682	0	68	80	0.8500000
NODE_3906_length_1198_cov_6.733394	602	682	2	7	80	0.0875000
NODE_3906_length_1198_cov_6.733394	602	682	3	5	80	0.0625000
NODE_3912_length_1197_cov_27.653005	417	497	0	80	80	1.0000000
NODE_3912_length_1197_cov_27.653005	470	550	0	80	80	1.0000000
NODE_3912_length_1197_cov_27.653005	546	626	0	80	80	1.0000000
NODE_3912_length_1197_cov_27.653005	599	679	0	80	80	1.0000000
NODE_3913_length_1197_cov_14.653916	490	570	0	80	80	1.0000000
NODE_3913_length_1197_cov_14.653916	543	623	0	80	80	1.0000000
NODE_3921_length_1196_cov_26.169553	298	378	0	80	80	1.0000000
NODE_3921_length_1196_cov_26.169553	351	431	0	80	80	1.0000000
NODE_3921_length_1196_cov_26.169553	427	507	0	80	80	1.0000000
NODE_3921_length_1196_cov_26.169553	480	560	0	80	80	1.0000000
NODE_3922_length_1196_cov_21.755697	521	601	0	80	80	1.0000000
NODE_3922_length_1196_cov_21.755697	574	654	0	80	80	1.0000000
NODE_3922_length_1196_cov_21.755697	650	730	0	80	80	1.0000000
NODE_3922_length_1196_cov_21.755697	703	783	0	80	80	1.0000000
NODE_3923_length_1196_cov_5.966272	556	636	0	80	80	1.0000000
NODE_3923_length_1196_cov_5.966272	609	689	0	80	80	1.0000000
NODE_3927_length_1195_cov_69.056569	474	554	0	64	80	0.8000000
NODE_3927_length_1195_cov_69.056569	474	554	10	16	80	0.2000000
NODE_3927_length_1195_cov_69.056569	527	607	0	11	80	0.1375000
NODE_3927_length_1195_cov_69.056569	527	607	10	69	80	0.8625000
NODE_3927_length_1195_cov_69.056569	603	683	4	14	80	0.1750000
NODE_3927_length_1195_cov_69.056569	603	683	10	66	80	0.8250000
NODE_3927_length_1195_cov_69.056569	656	736	0	53	80	0.6625000
NODE_3927_length_1195_cov_69.056569	656	736	4	14	80	0.1750000
NODE_3927_length_1195_cov_69.056569	656	736	10	13	80	0.1625000
NODE_3928_length_1195_cov_65.062044	579	659	0	80	80	1.0000000
NODE_3928_length_1195_cov_65.062044	632	712	0	80	80	1.0000000
NODE_3928_length_1195_cov_65.062044	708	788	0	80	80	1.0000000
NODE_3928_length_1195_cov_65.062044	761	841	0	80	80	1.0000000
NODE_3929_length_1195_cov_23.187044	460	540	0	80	80	1.0000000
NODE_3929_length_1195_cov_23.187044	513	593	0	80	80	1.0000000
NODE_3930_length_1195_cov_18.983577	521	601	0	80	80	1.0000000
NODE_3930_length_1195_cov_18.983577	574	654	0	80	80	1.0000000
NODE_3931_length_1195_cov_14.119526	726	806	0	80	80	1.0000000
NODE_3931_length_1195_cov_14.119526	779	859	0	80	80	1.0000000
NODE_3931_length_1195_cov_14.119526	855	935	0	80	80	1.0000000
NODE_3931_length_1195_cov_14.119526	908	988	0	80	80	1.0000000
NODE_3932_length_1195_cov_13.805657	759	839	0	80	80	1.0000000
NODE_3932_length_1195_cov_13.805657	812	892	0	80	80	1.0000000
NODE_3938_length_1195_cov_1.969891	912	992	0	13	80	0.1625000
NODE_3938_length_1195_cov_1.969891	912	992	2	8	80	0.1000000
NODE_3938_length_1195_cov_1.969891	912	992	4	59	80	0.7375000
NODE_3938_length_1195_cov_1.969891	912	992	0	13	80	0.1625000
NODE_3938_length_1195_cov_1.969891	912	992	2	8	80	0.1000000
NODE_3938_length_1195_cov_1.969891	912	992	4	59	80	0.7375000
NODE_3941_length_1194_cov_40.157991	237	317	0	80	80	1.0000000
NODE_3941_length_1194_cov_40.157991	290	370	0	80	80	1.0000000
NODE_3946_length_1193_cov_34.295247	443	523	0	80	80	1.0000000
NODE_3946_length_1193_cov_34.295247	496	576	0	33	80	0.4125000
NODE_3946_length_1193_cov_34.295247	496	576	4	47	80	0.5875000
NODE_3947_length_1193_cov_16.930530	124	154	4	30	30	1.0000000
NODE_3947_length_1193_cov_16.930530	390	470	1	3	80	0.0375000
NODE_3947_length_1193_cov_16.930530	390	470	2	38	80	0.4750000
NODE_3947_length_1193_cov_16.930530	390	470	3	39	80	0.4875000
NODE_3947_length_1193_cov_16.930530	443	523	1	3	80	0.0375000
NODE_3947_length_1193_cov_16.930530	443	523	2	62	80	0.7750000
NODE_3947_length_1193_cov_16.930530	443	523	3	15	80	0.1875000
NODE_3949_length_1192_cov_26.803294	205	285	0	80	80	1.0000000
NODE_3949_length_1192_cov_26.803294	258	338	0	80	80	1.0000000
NODE_3949_length_1192_cov_26.803294	334	414	0	80	80	1.0000000
NODE_3949_length_1192_cov_26.803294	387	467	0	80	80	1.0000000
NODE_3950_length_1192_cov_23.228728	487	567	0	80	80	1.0000000
NODE_3950_length_1192_cov_23.228728	540	620	0	80	80	1.0000000
NODE_3950_length_1192_cov_23.228728	616	696	0	80	80	1.0000000
NODE_3950_length_1192_cov_23.228728	669	749	0	80	80	1.0000000
NODE_3951_length_1192_cov_18.314730	613	693	0	4	80	0.0500000
NODE_3951_length_1192_cov_18.314730	613	693	5	45	80	0.5625000
NODE_3951_length_1192_cov_18.314730	613	693	6	31	80	0.3875000
NODE_3951_length_1192_cov_18.314730	666	746	0	34	80	0.4250000
NODE_3951_length_1192_cov_18.314730	666	746	6	46	80	0.5750000
NODE_3951_length_1192_cov_18.314730	742	822	0	80	80	1.0000000
NODE_3951_length_1192_cov_18.314730	795	875	0	80	80	1.0000000
NODE_3952_length_1192_cov_14.888381	622	702	0	4	80	0.0500000
NODE_3952_length_1192_cov_14.888381	622	702	6	76	80	0.9500000
NODE_3952_length_1192_cov_14.888381	675	755	0	50	80	0.6250000
NODE_3952_length_1192_cov_14.888381	675	755	6	30	80	0.3750000
NODE_3952_length_1192_cov_14.888381	751	831	0	80	80	1.0000000
NODE_3952_length_1192_cov_14.888381	804	884	0	80	80	1.0000000
NODE_3953_length_1192_cov_9.995425	161	241	3	24	80	0.3000000
NODE_3953_length_1192_cov_9.995425	161	241	4	56	80	0.7000000
NODE_3953_length_1192_cov_9.995425	214	294	0	9	80	0.1125000
NODE_3953_length_1192_cov_9.995425	214	294	4	71	80	0.8875000
NODE_3954_length_1192_cov_5.078683	749	829	0	80	80	1.0000000
NODE_3954_length_1192_cov_5.078683	802	882	0	80	80	1.0000000
NODE_3960_length_1192_cov_0.614822	1046	1126	0	80	80	1.0000000
NODE_3961_length_1191_cov_55.466117	392	472	0	80	80	1.0000000
NODE_3961_length_1191_cov_55.466117	445	525	0	80	80	1.0000000
NODE_3961_length_1191_cov_55.466117	521	601	0	71	80	0.8875000
NODE_3961_length_1191_cov_55.466117	521	601	2	9	80	0.1125000
NODE_3961_length_1191_cov_55.466117	574	654	0	18	80	0.2250000
NODE_3961_length_1191_cov_55.466117	574	654	2	62	80	0.7750000
NODE_3963_length_1191_cov_20.677656	695	775	0	80	80	1.0000000
NODE_3963_length_1191_cov_20.677656	748	828	0	80	80	1.0000000
NODE_3964_length_1191_cov_9.074176	420	500	0	34	80	0.4250000
NODE_3964_length_1191_cov_9.074176	420	500	2	46	80	0.5750000
NODE_3964_length_1191_cov_9.074176	473	553	2	80	80	1.0000000
NODE_3968_length_1190_cov_40.916590	521	601	0	42	80	0.5250000
NODE_3968_length_1190_cov_40.916590	521	601	2	38	80	0.4750000
NODE_3968_length_1190_cov_40.916590	574	654	0	14	80	0.1750000
NODE_3968_length_1190_cov_40.916590	574	654	2	66	80	0.8250000
NODE_3968_length_1190_cov_40.916590	650	730	0	80	80	1.0000000
NODE_3968_length_1190_cov_40.916590	703	783	0	80	80	1.0000000
NODE_3969_length_1190_cov_20.715857	257	337	0	80	80	1.0000000
NODE_3969_length_1190_cov_20.715857	310	390	0	80	80	1.0000000
NODE_3970_length_1190_cov_19.724106	296	376	0	80	80	1.0000000
NODE_3970_length_1190_cov_19.724106	349	429	0	33	80	0.4125000
NODE_3970_length_1190_cov_19.724106	349	429	4	47	80	0.5875000
NODE_3973_length_1190_cov_2.698442	1022	1070	4	10	48	0.2083333
NODE_3973_length_1190_cov_2.698442	1022	1070	6	26	48	0.5416667
NODE_3973_length_1190_cov_2.698442	1022	1070	8	12	48	0.2500000
NODE_3973_length_1190_cov_2.698442	1075	1123	4	6	48	0.1250000
NODE_3973_length_1190_cov_2.698442	1075	1123	6	42	48	0.8750000
NODE_3977_length_1189_cov_29.193578	576	656	0	80	80	1.0000000
NODE_3977_length_1189_cov_29.193578	629	709	0	80	80	1.0000000
NODE_3978_length_1189_cov_13.484404	315	341	0	26	26	1.0000000
NODE_3978_length_1189_cov_13.484404	366	446	0	80	80	1.0000000
NODE_3984_length_1188_cov_19.278237	396	476	0	80	80	1.0000000
NODE_3984_length_1188_cov_19.278237	449	529	0	80	80	1.0000000
NODE_3990_length_1187_cov_63.185662	529	609	0	72	80	0.9000000
NODE_3990_length_1187_cov_63.185662	529	609	1	8	80	0.1000000
NODE_3990_length_1187_cov_63.185662	582	662	0	19	80	0.2375000
NODE_3990_length_1187_cov_63.185662	582	662	1	61	80	0.7625000
NODE_3990_length_1187_cov_63.185662	658	738	1	24	80	0.3000000
NODE_3990_length_1187_cov_63.185662	658	738	2	48	80	0.6000000
NODE_3990_length_1187_cov_63.185662	658	738	6	8	80	0.1000000
NODE_3990_length_1187_cov_63.185662	711	791	2	19	80	0.2375000
NODE_3990_length_1187_cov_63.185662	711	791	5	40	80	0.5000000
NODE_3990_length_1187_cov_63.185662	711	791	6	21	80	0.2625000
NODE_3991_length_1187_cov_36.926471	432	512	0	80	80	1.0000000
NODE_3991_length_1187_cov_36.926471	485	565	0	80	80	1.0000000
NODE_3991_length_1187_cov_36.926471	561	641	0	80	80	1.0000000
NODE_3991_length_1187_cov_36.926471	614	694	0	80	80	1.0000000
NODE_3992_length_1187_cov_20.383272	492	572	0	80	80	1.0000000
NODE_3992_length_1187_cov_20.383272	545	625	0	80	80	1.0000000
NODE_3993_length_1187_cov_17.941176	377	457	0	80	80	1.0000000
NODE_3993_length_1187_cov_17.941176	430	510	0	80	80	1.0000000
NODE_3993_length_1187_cov_17.941176	506	586	0	80	80	1.0000000
NODE_3993_length_1187_cov_17.941176	559	639	0	80	80	1.0000000
NODE_3997_length_1186_cov_59.606256	338	418	0	80	80	1.0000000
NODE_3997_length_1186_cov_59.606256	391	471	0	80	80	1.0000000
NODE_3997_length_1186_cov_59.606256	480	551	0	71	71	1.0000000
NODE_3997_length_1186_cov_59.606256	524	604	0	80	80	1.0000000
NODE_3998_length_1186_cov_34.937443	582	662	0	80	80	1.0000000
NODE_3998_length_1186_cov_34.937443	635	715	0	80	80	1.0000000
NODE_3998_length_1186_cov_34.937443	711	791	0	80	80	1.0000000
NODE_3998_length_1186_cov_34.937443	764	844	0	80	80	1.0000000
NODE_3999_length_1186_cov_29.840846	511	591	0	80	80	1.0000000
NODE_3999_length_1186_cov_29.840846	564	644	0	80	80	1.0000000
NODE_3999_length_1186_cov_29.840846	640	720	0	80	80	1.0000000
NODE_3999_length_1186_cov_29.840846	693	773	0	80	80	1.0000000
NODE_4000_length_1186_cov_13.108556	578	658	0	54	80	0.6750000
NODE_4000_length_1186_cov_13.108556	578	658	2	26	80	0.3250000
NODE_4000_length_1186_cov_13.108556	631	711	0	1	80	0.0125000
NODE_4000_length_1186_cov_13.108556	631	711	2	79	80	0.9875000
NODE_4001_length_1186_cov_12.867525	404	484	2	38	80	0.4750000
NODE_4001_length_1186_cov_12.867525	404	484	6	25	80	0.3125000
NODE_4001_length_1186_cov_12.867525	404	484	8	17	80	0.2125000
NODE_4001_length_1186_cov_12.867525	457	534	6	45	77	0.5844156
NODE_4001_length_1186_cov_12.867525	457	534	8	32	77	0.4155844
NODE_4001_length_1186_cov_12.867525	536	613	0	3	77	0.0389610
NODE_4001_length_1186_cov_12.867525	536	613	2	68	77	0.8831169
NODE_4001_length_1186_cov_12.867525	536	613	7	1	77	0.0129870
NODE_4001_length_1186_cov_12.867525	536	613	8	5	77	0.0649351
NODE_4001_length_1186_cov_12.867525	586	666	0	56	80	0.7000000
NODE_4001_length_1186_cov_12.867525	586	666	2	24	80	0.3000000
NODE_4002_length_1186_cov_12.135235	643	723	0	80	80	1.0000000
NODE_4002_length_1186_cov_12.135235	696	776	0	80	80	1.0000000
NODE_4012_length_1185_cov_36.974217	423	503	0	80	80	1.0000000
NODE_4012_length_1185_cov_36.974217	476	556	0	80	80	1.0000000
NODE_4013_length_1185_cov_28.410681	448	528	0	80	80	1.0000000
NODE_4013_length_1185_cov_28.410681	501	581	0	80	80	1.0000000
NODE_4014_length_1185_cov_19.768877	411	491	0	80	80	1.0000000
NODE_4014_length_1185_cov_19.768877	464	544	0	80	80	1.0000000
NODE_4014_length_1185_cov_19.768877	540	620	0	80	80	1.0000000
NODE_4014_length_1185_cov_19.768877	593	673	0	80	80	1.0000000
NODE_4015_length_1185_cov_14.490792	379	459	0	80	80	1.0000000
NODE_4015_length_1185_cov_14.490792	432	512	0	80	80	1.0000000
NODE_4016_length_1185_cov_13.686004	677	757	0	80	80	1.0000000
NODE_4016_length_1185_cov_13.686004	730	810	0	80	80	1.0000000
NODE_4017_length_1185_cov_12.362799	711	791	0	80	80	1.0000000
NODE_4017_length_1185_cov_12.362799	764	844	0	80	80	1.0000000
NODE_4024_length_1184_cov_30.061751	416	497	0	81	81	1.0000000
NODE_4024_length_1184_cov_30.061751	470	550	0	80	80	1.0000000
NODE_4024_length_1184_cov_30.061751	546	627	0	81	81	1.0000000
NODE_4024_length_1184_cov_30.061751	600	680	0	80	80	1.0000000
NODE_4025_length_1184_cov_19.544700	550	630	0	80	80	1.0000000
NODE_4025_length_1184_cov_19.544700	603	683	0	80	80	1.0000000
NODE_4025_length_1184_cov_19.544700	679	759	0	21	80	0.2625000
NODE_4025_length_1184_cov_19.544700	679	759	2	59	80	0.7375000
NODE_4025_length_1184_cov_19.544700	732	812	0	49	80	0.6125000
NODE_4025_length_1184_cov_19.544700	732	812	2	31	80	0.3875000
NODE_4026_length_1184_cov_9.129954	624	704	0	80	80	1.0000000
NODE_4026_length_1184_cov_9.129954	677	757	0	80	80	1.0000000
NODE_4031_length_1183_cov_17.260148	545	625	0	80	80	1.0000000
NODE_4031_length_1183_cov_17.260148	598	678	0	80	80	1.0000000
NODE_4031_length_1183_cov_17.260148	674	754	0	80	80	1.0000000
NODE_4031_length_1183_cov_17.260148	727	807	0	80	80	1.0000000
NODE_4032_length_1183_cov_9.777675	484	564	0	80	80	1.0000000
NODE_4032_length_1183_cov_9.777675	537	617	0	80	80	1.0000000
NODE_4033_length_1183_cov_6.847786	711	791	0	11	80	0.1375000
NODE_4033_length_1183_cov_6.847786	711	791	2	7	80	0.0875000
NODE_4033_length_1183_cov_6.847786	711	791	6	62	80	0.7750000
NODE_4033_length_1183_cov_6.847786	764	844	0	22	80	0.2750000
NODE_4033_length_1183_cov_6.847786	764	844	6	58	80	0.7250000
NODE_4033_length_1183_cov_6.847786	840	920	0	80	80	1.0000000
NODE_4033_length_1183_cov_6.847786	893	973	0	80	80	1.0000000
NODE_4035_length_1183_cov_2.680812	59	139	6	6	80	0.0750000
NODE_4035_length_1183_cov_2.680812	59	139	8	3	80	0.0375000
NODE_4035_length_1183_cov_2.680812	59	139	12	2	80	0.0250000
NODE_4035_length_1183_cov_2.680812	59	139	14	4	80	0.0500000
NODE_4035_length_1183_cov_2.680812	59	139	16	2	80	0.0250000
NODE_4035_length_1183_cov_2.680812	59	139	18	6	80	0.0750000
NODE_4035_length_1183_cov_2.680812	59	139	20	57	80	0.7125000
NODE_4040_length_1182_cov_64.600185	588	668	0	80	80	1.0000000
NODE_4040_length_1182_cov_64.600185	641	721	0	80	80	1.0000000
NODE_4040_length_1182_cov_64.600185	717	797	0	80	80	1.0000000
NODE_4040_length_1182_cov_64.600185	770	849	0	79	79	1.0000000
NODE_4041_length_1182_cov_18.584488	487	557	0	70	70	1.0000000
NODE_4041_length_1182_cov_18.584488	536	612	0	76	76	1.0000000
NODE_4041_length_1182_cov_18.584488	608	688	0	80	80	1.0000000
NODE_4041_length_1182_cov_18.584488	671	741	0	70	70	1.0000000
NODE_4042_length_1182_cov_18.075716	598	678	0	16	80	0.2000000
NODE_4042_length_1182_cov_18.075716	598	678	2	64	80	0.8000000
NODE_4042_length_1182_cov_18.075716	651	731	0	47	80	0.5875000
NODE_4042_length_1182_cov_18.075716	651	731	2	33	80	0.4125000
NODE_4042_length_1182_cov_18.075716	727	807	0	80	80	1.0000000
NODE_4042_length_1182_cov_18.075716	780	860	0	80	80	1.0000000
NODE_4043_length_1182_cov_8.716528	464	544	0	80	80	1.0000000
NODE_4043_length_1182_cov_8.716528	517	597	0	80	80	1.0000000
NODE_4044_length_1182_cov_4.109880	793	873	0	80	80	1.0000000
NODE_4044_length_1182_cov_4.109880	846	926	0	80	80	1.0000000
NODE_4045_length_1182_cov_3.433980	1052	1100	2	48	48	1.0000000
NODE_4050_length_1181_cov_13.856747	687	767	0	80	80	1.0000000
NODE_4050_length_1181_cov_13.856747	740	820	0	80	80	1.0000000
NODE_4051_length_1181_cov_8.239372	735	815	0	80	80	1.0000000
NODE_4059_length_1180_cov_46.345051	695	775	0	80	80	1.0000000
NODE_4059_length_1180_cov_46.345051	748	828	0	80	80	1.0000000
NODE_4066_length_1179_cov_93.272222	660	740	61	9	80	0.1125000
NODE_4066_length_1179_cov_93.272222	660	740	63	3	80	0.0375000
NODE_4066_length_1179_cov_93.272222	660	740	64	6	80	0.0750000
NODE_4066_length_1179_cov_93.272222	660	740	69	1	80	0.0125000
NODE_4066_length_1179_cov_93.272222	660	740	71	1	80	0.0125000
NODE_4066_length_1179_cov_93.272222	660	740	73	2	80	0.0250000
NODE_4066_length_1179_cov_93.272222	660	740	75	3	80	0.0375000
NODE_4066_length_1179_cov_93.272222	660	740	76	4	80	0.0500000
NODE_4066_length_1179_cov_93.272222	660	740	77	1	80	0.0125000
NODE_4066_length_1179_cov_93.272222	660	740	78	1	80	0.0125000
NODE_4066_length_1179_cov_93.272222	660	740	79	1	80	0.0125000
NODE_4066_length_1179_cov_93.272222	660	740	80	1	80	0.0125000
NODE_4066_length_1179_cov_93.272222	660	740	81	2	80	0.0250000
NODE_4066_length_1179_cov_93.272222	660	740	89	7	80	0.0875000
NODE_4066_length_1179_cov_93.272222	660	740	90	1	80	0.0125000
NODE_4066_length_1179_cov_93.272222	660	740	92	9	80	0.1125000
NODE_4066_length_1179_cov_93.272222	660	740	95	6	80	0.0750000
NODE_4066_length_1179_cov_93.272222	660	740	96	1	80	0.0125000
NODE_4066_length_1179_cov_93.272222	660	740	97	10	80	0.1250000
NODE_4066_length_1179_cov_93.272222	660	740	98	4	80	0.0500000
NODE_4066_length_1179_cov_93.272222	660	740	99	2	80	0.0250000
NODE_4066_length_1179_cov_93.272222	660	740	100	5	80	0.0625000
NODE_4066_length_1179_cov_93.272222	713	793	28	5	80	0.0625000
NODE_4066_length_1179_cov_93.272222	713	793	29	2	80	0.0250000
NODE_4066_length_1179_cov_93.272222	713	793	30	4	80	0.0500000
NODE_4066_length_1179_cov_93.272222	713	793	34	1	80	0.0125000
NODE_4066_length_1179_cov_93.272222	713	793	45	1	80	0.0125000
NODE_4066_length_1179_cov_93.272222	713	793	46	3	80	0.0375000
NODE_4066_length_1179_cov_93.272222	713	793	47	2	80	0.0250000
NODE_4066_length_1179_cov_93.272222	713	793	52	1	80	0.0125000
NODE_4066_length_1179_cov_93.272222	713	793	55	9	80	0.1125000
NODE_4066_length_1179_cov_93.272222	713	793	56	3	80	0.0375000
NODE_4066_length_1179_cov_93.272222	713	793	57	16	80	0.2000000
NODE_4066_length_1179_cov_93.272222	713	793	59	5	80	0.0625000
NODE_4066_length_1179_cov_93.272222	713	793	61	10	80	0.1250000
NODE_4066_length_1179_cov_93.272222	713	793	63	3	80	0.0375000
NODE_4066_length_1179_cov_93.272222	713	793	64	6	80	0.0750000
NODE_4066_length_1179_cov_93.272222	713	793	69	1	80	0.0125000
NODE_4066_length_1179_cov_93.272222	713	793	71	1	80	0.0125000
NODE_4066_length_1179_cov_93.272222	713	793	73	2	80	0.0250000
NODE_4066_length_1179_cov_93.272222	713	793	75	3	80	0.0375000
NODE_4066_length_1179_cov_93.272222	713	793	76	2	80	0.0250000
NODE_4067_length_1179_cov_55.355556	547	627	0	16	80	0.2000000
NODE_4067_length_1179_cov_55.355556	547	627	2	49	80	0.6125000
NODE_4067_length_1179_cov_55.355556	547	627	4	15	80	0.1875000
NODE_4067_length_1179_cov_55.355556	600	680	2	12	80	0.1500000
NODE_4067_length_1179_cov_55.355556	600	680	4	63	80	0.7875000
NODE_4067_length_1179_cov_55.355556	600	680	6	5	80	0.0625000
NODE_4068_length_1179_cov_29.712037	613	693	0	80	80	1.0000000
NODE_4068_length_1179_cov_29.712037	666	746	0	80	80	1.0000000
NODE_4069_length_1179_cov_26.767593	483	563	0	80	80	1.0000000
NODE_4069_length_1179_cov_26.767593	536	616	0	80	80	1.0000000
NODE_4069_length_1179_cov_26.767593	612	692	0	80	80	1.0000000
NODE_4069_length_1179_cov_26.767593	665	745	0	80	80	1.0000000
NODE_4070_length_1179_cov_22.249074	581	661	0	80	80	1.0000000
NODE_4070_length_1179_cov_22.249074	634	714	0	80	80	1.0000000
NODE_4071_length_1179_cov_16.538889	498	568	0	49	70	0.7000000
NODE_4071_length_1179_cov_16.538889	498	568	2	21	70	0.3000000
NODE_4072_length_1179_cov_15.442593	535	615	0	80	80	1.0000000
NODE_4072_length_1179_cov_15.442593	588	668	0	80	80	1.0000000
NODE_4076_length_1179_cov_2.419444	1108	1155	0	1	47	0.0212766
NODE_4076_length_1179_cov_2.419444	1108	1155	2	46	47	0.9787234
NODE_4078_length_1179_cov_1.009259	944	1024	0	80	80	1.0000000
NODE_4078_length_1179_cov_1.009259	997	1077	0	80	80	1.0000000
NODE_4079_length_1178_cov_42.484708	423	503	0	80	80	1.0000000
NODE_4079_length_1178_cov_42.484708	476	556	0	80	80	1.0000000
NODE_4079_length_1178_cov_42.484708	552	632	0	80	80	1.0000000
NODE_4079_length_1178_cov_42.484708	605	685	0	80	80	1.0000000
NODE_4080_length_1178_cov_15.332715	215	295	0	9	80	0.1125000
NODE_4080_length_1178_cov_15.332715	215	295	4	71	80	0.8875000
NODE_4080_length_1178_cov_15.332715	268	348	0	10	80	0.1250000
NODE_4080_length_1178_cov_15.332715	268	348	4	70	80	0.8750000
NODE_4081_length_1178_cov_11.403151	527	607	0	47	80	0.5875000
NODE_4081_length_1178_cov_11.403151	527	607	2	33	80	0.4125000
NODE_4081_length_1178_cov_11.403151	580	660	2	80	80	1.0000000
NODE_4084_length_1177_cov_34.920223	369	449	0	80	80	1.0000000
NODE_4084_length_1177_cov_34.920223	422	502	0	31	80	0.3875000
NODE_4084_length_1177_cov_34.920223	422	502	2	49	80	0.6125000
NODE_4084_length_1177_cov_34.920223	498	578	0	48	80	0.6000000
NODE_4084_length_1177_cov_34.920223	498	578	2	32	80	0.4000000
NODE_4084_length_1177_cov_34.920223	551	631	0	80	80	1.0000000
NODE_4085_length_1177_cov_12.186456	481	561	0	80	80	1.0000000
NODE_4085_length_1177_cov_12.186456	534	614	0	80	80	1.0000000
NODE_4085_length_1177_cov_12.186456	610	690	0	80	80	1.0000000
NODE_4085_length_1177_cov_12.186456	663	743	0	80	80	1.0000000
NODE_4086_length_1177_cov_11.926716	443	523	0	80	80	1.0000000
NODE_4086_length_1177_cov_11.926716	496	578	0	50	82	0.6097561
NODE_4086_length_1177_cov_11.926716	496	578	2	32	82	0.3902439
NODE_4088_length_1177_cov_5.923933	358	438	0	80	80	1.0000000
NODE_4088_length_1177_cov_5.923933	411	491	0	80	80	1.0000000
NODE_4089_length_1177_cov_5.775510	760	840	0	5	80	0.0625000
NODE_4089_length_1177_cov_5.775510	760	840	2	54	80	0.6750000
NODE_4089_length_1177_cov_5.775510	760	840	4	21	80	0.2625000
NODE_4089_length_1177_cov_5.775510	813	893	2	68	80	0.8500000
NODE_4089_length_1177_cov_5.775510	813	893	4	12	80	0.1500000
NODE_4096_length_1176_cov_26.994429	377	457	0	80	80	1.0000000
NODE_4096_length_1176_cov_26.994429	430	510	0	80	80	1.0000000
NODE_4096_length_1176_cov_26.994429	506	586	0	80	80	1.0000000
NODE_4096_length_1176_cov_26.994429	559	639	0	80	80	1.0000000
NODE_4097_length_1176_cov_15.766945	531	611	0	80	80	1.0000000
NODE_4097_length_1176_cov_15.766945	584	664	0	80	80	1.0000000
NODE_4098_length_1176_cov_14.882080	628	708	0	80	80	1.0000000
NODE_4098_length_1176_cov_14.882080	681	761	0	80	80	1.0000000
NODE_4099_length_1176_cov_10.692665	392	472	0	80	80	1.0000000
NODE_4099_length_1176_cov_10.692665	445	525	0	80	80	1.0000000
NODE_4106_length_1175_cov_50.754647	526	606	0	80	80	1.0000000
NODE_4106_length_1175_cov_50.754647	579	659	0	80	80	1.0000000
NODE_4107_length_1175_cov_42.638476	327	407	0	80	80	1.0000000
NODE_4107_length_1175_cov_42.638476	380	460	0	80	80	1.0000000
NODE_4107_length_1175_cov_42.638476	456	536	0	80	80	1.0000000
NODE_4107_length_1175_cov_42.638476	509	589	0	80	80	1.0000000
NODE_4108_length_1175_cov_40.217472	437	517	0	80	80	1.0000000
NODE_4108_length_1175_cov_40.217472	490	570	0	80	80	1.0000000
NODE_4108_length_1175_cov_40.217472	566	646	0	80	80	1.0000000
NODE_4108_length_1175_cov_40.217472	619	699	0	80	80	1.0000000
NODE_4109_length_1175_cov_12.834572	775	855	0	9	80	0.1125000
NODE_4109_length_1175_cov_12.834572	775	855	2	71	80	0.8875000
NODE_4109_length_1175_cov_12.834572	828	908	0	62	80	0.7750000
NODE_4109_length_1175_cov_12.834572	828	908	2	18	80	0.2250000
NODE_4115_length_1174_cov_20.569302	433	513	0	80	80	1.0000000
NODE_4115_length_1174_cov_20.569302	486	566	0	80	80	1.0000000
NODE_4115_length_1174_cov_20.569302	562	642	0	80	80	1.0000000
NODE_4115_length_1174_cov_20.569302	615	695	0	80	80	1.0000000
NODE_4116_length_1174_cov_18.797209	578	658	0	80	80	1.0000000
NODE_4116_length_1174_cov_18.797209	631	711	0	80	80	1.0000000
NODE_4117_length_1174_cov_17.486512	589	669	0	42	80	0.5250000
NODE_4117_length_1174_cov_17.486512	589	669	8	38	80	0.4750000
NODE_4117_length_1174_cov_17.486512	642	722	0	1	80	0.0125000
NODE_4117_length_1174_cov_17.486512	642	722	7	1	80	0.0125000
NODE_4117_length_1174_cov_17.486512	642	722	8	78	80	0.9750000
NODE_4118_length_1174_cov_15.888372	570	650	0	80	80	1.0000000
NODE_4118_length_1174_cov_15.888372	623	703	0	80	80	1.0000000
NODE_4118_length_1174_cov_15.888372	699	779	0	80	80	1.0000000
NODE_4118_length_1174_cov_15.888372	752	832	0	80	80	1.0000000
NODE_4124_length_1174_cov_1.536744	1066	1115	0	49	49	1.0000000
NODE_4124_length_1174_cov_1.536744	1088	1168	0	80	80	1.0000000
NODE_4128_length_1173_cov_29.562384	455	535	0	80	80	1.0000000
NODE_4128_length_1173_cov_29.562384	508	588	0	80	80	1.0000000
NODE_4128_length_1173_cov_29.562384	584	664	0	80	80	1.0000000
NODE_4128_length_1173_cov_29.562384	637	717	0	80	80	1.0000000
NODE_4129_length_1173_cov_25.206704	395	475	0	80	80	1.0000000
NODE_4129_length_1173_cov_25.206704	448	528	0	80	80	1.0000000
NODE_4130_length_1173_cov_9.486965	693	773	0	80	80	1.0000000
NODE_4130_length_1173_cov_9.486965	746	826	0	80	80	1.0000000
NODE_4131_length_1173_cov_7.946927	201	281	0	80	80	1.0000000
NODE_4131_length_1173_cov_7.946927	254	334	0	80	80	1.0000000
NODE_4136_length_1172_cov_37.177074	527	607	0	80	80	1.0000000
NODE_4136_length_1172_cov_37.177074	580	660	0	80	80	1.0000000
NODE_4137_length_1172_cov_20.397018	677	757	0	44	80	0.5500000
NODE_4137_length_1172_cov_20.397018	677	757	1	23	80	0.2875000
NODE_4137_length_1172_cov_20.397018	677	757	2	13	80	0.1625000
NODE_4137_length_1172_cov_20.397018	730	810	0	80	80	1.0000000
NODE_4138_length_1172_cov_15.018639	460	540	0	80	80	1.0000000
NODE_4138_length_1172_cov_15.018639	513	593	0	80	80	1.0000000
NODE_4139_length_1172_cov_13.199441	622	702	0	80	80	1.0000000
NODE_4139_length_1172_cov_13.199441	675	755	0	80	80	1.0000000
NODE_4140_length_1172_cov_10.720410	499	579	0	80	80	1.0000000
NODE_4140_length_1172_cov_10.720410	552	632	0	80	80	1.0000000
NODE_4140_length_1172_cov_10.720410	628	708	0	80	80	1.0000000
NODE_4140_length_1172_cov_10.720410	681	761	0	80	80	1.0000000
NODE_4141_length_1172_cov_10.574091	951	1021	0	13	70	0.1857143
NODE_4141_length_1172_cov_10.574091	951	1021	8	2	70	0.0285714
NODE_4141_length_1172_cov_10.574091	951	1021	10	7	70	0.1000000
NODE_4141_length_1172_cov_10.574091	951	1021	11	3	70	0.0428571
NODE_4141_length_1172_cov_10.574091	951	1021	12	14	70	0.2000000
NODE_4141_length_1172_cov_10.574091	951	1021	14	22	70	0.3142857
NODE_4141_length_1172_cov_10.574091	951	1021	17	1	70	0.0142857
NODE_4141_length_1172_cov_10.574091	951	1021	18	8	70	0.1142857
NODE_4142_length_1172_cov_9.204101	276	356	0	80	80	1.0000000
NODE_4142_length_1172_cov_9.204101	329	409	0	80	80	1.0000000
NODE_4148_length_1171_cov_13.311567	666	746	0	6	80	0.0750000
NODE_4148_length_1171_cov_13.311567	666	746	2	74	80	0.9250000
NODE_4148_length_1171_cov_13.311567	719	803	0	21	84	0.2500000
NODE_4148_length_1171_cov_13.311567	719	803	2	63	84	0.7500000
NODE_4149_length_1171_cov_9.154851	198	278	0	80	80	1.0000000
NODE_4149_length_1171_cov_9.154851	251	331	0	80	80	1.0000000
NODE_4157_length_1170_cov_65.480859	402	482	0	80	80	1.0000000
NODE_4157_length_1170_cov_65.480859	455	535	0	80	80	1.0000000
NODE_4158_length_1170_cov_35.283847	704	784	0	80	80	1.0000000
NODE_4158_length_1170_cov_35.283847	757	837	0	80	80	1.0000000
NODE_4159_length_1170_cov_23.600373	450	530	0	80	80	1.0000000
NODE_4159_length_1170_cov_23.600373	503	583	0	80	80	1.0000000
NODE_4159_length_1170_cov_23.600373	579	659	0	80	80	1.0000000
NODE_4159_length_1170_cov_23.600373	632	705	0	73	73	1.0000000
NODE_4160_length_1170_cov_19.783380	325	405	0	9	80	0.1125000
NODE_4160_length_1170_cov_19.783380	325	405	6	71	80	0.8875000
NODE_4160_length_1170_cov_19.783380	378	458	0	14	80	0.1750000
NODE_4160_length_1170_cov_19.783380	378	458	6	66	80	0.8250000
NODE_4168_length_1169_cov_61.689720	464	544	0	12	80	0.1500000
NODE_4168_length_1169_cov_61.689720	464	544	2	68	80	0.8500000
NODE_4168_length_1169_cov_61.689720	517	597	0	45	80	0.5625000
NODE_4168_length_1169_cov_61.689720	517	597	2	35	80	0.4375000
NODE_4168_length_1169_cov_61.689720	593	673	0	80	80	1.0000000
NODE_4168_length_1169_cov_61.689720	646	726	0	80	80	1.0000000
NODE_4169_length_1169_cov_55.247664	640	720	0	80	80	1.0000000
NODE_4169_length_1169_cov_55.247664	693	773	0	80	80	1.0000000
NODE_4170_length_1169_cov_39.016822	447	527	1	56	80	0.7000000
NODE_4170_length_1169_cov_39.016822	447	527	2	24	80	0.3000000
NODE_4170_length_1169_cov_39.016822	500	580	1	80	80	1.0000000
NODE_4170_length_1169_cov_39.016822	576	656	0	54	80	0.6750000
NODE_4170_length_1169_cov_39.016822	576	656	1	26	80	0.3250000
NODE_4170_length_1169_cov_39.016822	629	709	0	80	80	1.0000000
NODE_4171_length_1169_cov_35.383178	582	662	0	80	80	1.0000000
NODE_4171_length_1169_cov_35.383178	635	715	0	80	80	1.0000000
NODE_4173_length_1169_cov_12.010280	338	418	0	80	80	1.0000000
NODE_4173_length_1169_cov_12.010280	391	471	0	80	80	1.0000000
NODE_4175_length_1169_cov_4.172897	74	135	0	61	61	1.0000000
NODE_4175_length_1169_cov_4.172897	74	135	0	61	61	1.0000000
NODE_4175_length_1169_cov_4.172897	74	135	0	61	61	1.0000000
NODE_4183_length_1168_cov_27.350795	517	597	0	80	80	1.0000000
NODE_4183_length_1168_cov_27.350795	570	650	0	80	80	1.0000000
NODE_4183_length_1168_cov_27.350795	646	726	0	80	80	1.0000000
NODE_4183_length_1168_cov_27.350795	699	779	0	80	80	1.0000000
NODE_4184_length_1168_cov_25.777362	672	752	0	60	80	0.7500000
NODE_4184_length_1168_cov_25.777362	672	752	2	20	80	0.2500000
NODE_4184_length_1168_cov_25.777362	725	805	0	80	80	1.0000000
NODE_4185_length_1168_cov_25.295603	543	623	0	80	80	1.0000000
NODE_4185_length_1168_cov_25.295603	596	676	0	80	80	1.0000000
NODE_4185_length_1168_cov_25.295603	672	752	0	80	80	1.0000000
NODE_4185_length_1168_cov_25.295603	725	804	0	79	79	1.0000000
NODE_4186_length_1168_cov_20.202058	434	514	0	80	80	1.0000000
NODE_4186_length_1168_cov_20.202058	487	567	0	80	80	1.0000000
NODE_4187_length_1168_cov_16.787652	405	485	0	80	80	1.0000000
NODE_4187_length_1168_cov_16.787652	458	538	0	80	80	1.0000000
NODE_4188_length_1168_cov_10.079514	722	802	0	80	80	1.0000000
NODE_4188_length_1168_cov_10.079514	775	855	0	80	80	1.0000000
NODE_4198_length_1167_cov_27.961610	591	671	0	41	80	0.5125000
NODE_4198_length_1167_cov_27.961610	591	671	7	1	80	0.0125000
NODE_4198_length_1167_cov_27.961610	591	671	8	30	80	0.3750000
NODE_4198_length_1167_cov_27.961610	591	671	9	6	80	0.0750000
NODE_4198_length_1167_cov_27.961610	591	671	10	2	80	0.0250000
NODE_4198_length_1167_cov_27.961610	644	724	8	19	80	0.2375000
NODE_4198_length_1167_cov_27.961610	644	724	9	6	80	0.0750000
NODE_4198_length_1167_cov_27.961610	644	724	10	41	80	0.5125000
NODE_4198_length_1167_cov_27.961610	644	724	12	14	80	0.1750000
NODE_4199_length_1167_cov_12.393258	670	750	0	80	80	1.0000000
NODE_4199_length_1167_cov_12.393258	723	803	0	80	80	1.0000000
NODE_4200_length_1167_cov_11.189139	434	514	0	7	80	0.0875000
NODE_4200_length_1167_cov_11.189139	434	514	2	73	80	0.9125000
NODE_4200_length_1167_cov_11.189139	487	567	2	80	80	1.0000000
NODE_4201_length_1167_cov_7.998127	711	791	0	80	80	1.0000000
NODE_4201_length_1167_cov_7.998127	764	844	0	65	80	0.8125000
NODE_4201_length_1167_cov_7.998127	764	844	1	15	80	0.1875000
NODE_4206_length_1166_cov_313.815370	444	524	66	3	80	0.0375000
NODE_4206_length_1166_cov_313.815370	444	524	68	13	80	0.1625000
NODE_4206_length_1166_cov_313.815370	444	524	147	1	80	0.0125000
NODE_4206_length_1166_cov_313.815370	444	524	148	1	80	0.0125000
NODE_4206_length_1166_cov_313.815370	444	524	160	2	80	0.0250000
NODE_4206_length_1166_cov_313.815370	444	524	194	1	80	0.0125000
NODE_4206_length_1166_cov_313.815370	444	524	195	1	80	0.0125000
NODE_4206_length_1166_cov_313.815370	444	524	198	1	80	0.0125000
NODE_4206_length_1166_cov_313.815370	444	524	201	3	80	0.0375000
NODE_4206_length_1166_cov_313.815370	444	524	230	1	80	0.0125000
NODE_4206_length_1166_cov_313.815370	444	524	244	1	80	0.0125000
NODE_4206_length_1166_cov_313.815370	444	524	283	1	80	0.0125000
NODE_4206_length_1166_cov_313.815370	444	524	284	2	80	0.0250000
NODE_4206_length_1166_cov_313.815370	444	524	307	1	80	0.0125000
NODE_4206_length_1166_cov_313.815370	444	524	326	1	80	0.0125000
NODE_4206_length_1166_cov_313.815370	444	524	349	1	80	0.0125000
NODE_4206_length_1166_cov_313.815370	444	524	364	1	80	0.0125000
NODE_4206_length_1166_cov_313.815370	444	524	373	1	80	0.0125000
NODE_4206_length_1166_cov_313.815370	444	524	385	2	80	0.0250000
NODE_4206_length_1166_cov_313.815370	444	524	391	1	80	0.0125000
NODE_4206_length_1166_cov_313.815370	444	524	411	1	80	0.0125000
NODE_4206_length_1166_cov_313.815370	444	524	412	3	80	0.0375000
NODE_4206_length_1166_cov_313.815370	444	524	418	1	80	0.0125000
NODE_4206_length_1166_cov_313.815370	444	524	440	1	80	0.0125000
NODE_4206_length_1166_cov_313.815370	444	524	441	1	80	0.0125000
NODE_4206_length_1166_cov_313.815370	444	524	464	1	80	0.0125000
NODE_4206_length_1166_cov_313.815370	444	524	475	1	80	0.0125000
NODE_4206_length_1166_cov_313.815370	444	524	477	1	80	0.0125000
NODE_4206_length_1166_cov_313.815370	444	524	493	1	80	0.0125000
NODE_4206_length_1166_cov_313.815370	444	524	494	2	80	0.0250000
NODE_4206_length_1166_cov_313.815370	444	524	500	1	80	0.0125000
NODE_4206_length_1166_cov_313.815370	444	524	502	3	80	0.0375000
NODE_4206_length_1166_cov_313.815370	444	524	514	1	80	0.0125000
NODE_4206_length_1166_cov_313.815370	444	524	536	1	80	0.0125000
NODE_4206_length_1166_cov_313.815370	444	524	546	1	80	0.0125000
NODE_4206_length_1166_cov_313.815370	444	524	547	1	80	0.0125000
NODE_4206_length_1166_cov_313.815370	444	524	558	1	80	0.0125000
NODE_4206_length_1166_cov_313.815370	444	524	561	1	80	0.0125000
NODE_4206_length_1166_cov_313.815370	444	524	567	1	80	0.0125000
NODE_4206_length_1166_cov_313.815370	444	524	589	1	80	0.0125000
NODE_4206_length_1166_cov_313.815370	444	524	592	1	80	0.0125000
NODE_4206_length_1166_cov_313.815370	444	524	595	1	80	0.0125000
NODE_4206_length_1166_cov_313.815370	444	524	643	1	80	0.0125000
NODE_4206_length_1166_cov_313.815370	444	524	650	1	80	0.0125000
NODE_4206_length_1166_cov_313.815370	444	524	662	1	80	0.0125000
NODE_4206_length_1166_cov_313.815370	444	524	663	1	80	0.0125000
NODE_4206_length_1166_cov_313.815370	444	524	664	2	80	0.0250000
NODE_4206_length_1166_cov_313.815370	444	524	671	2	80	0.0250000
NODE_4206_length_1166_cov_313.815370	444	524	672	1	80	0.0125000
NODE_4206_length_1166_cov_313.815370	444	524	673	1	80	0.0125000
NODE_4206_length_1166_cov_313.815370	444	524	675	1	80	0.0125000
NODE_4206_length_1166_cov_313.815370	444	524	676	1	80	0.0125000
NODE_4206_length_1166_cov_313.815370	444	524	682	1	80	0.0125000
NODE_4206_length_1166_cov_313.815370	444	524	686	1	80	0.0125000
NODE_4206_length_1166_cov_313.815370	444	524	66	3	80	0.0375000
NODE_4206_length_1166_cov_313.815370	444	524	68	13	80	0.1625000
NODE_4206_length_1166_cov_313.815370	444	524	147	1	80	0.0125000
NODE_4206_length_1166_cov_313.815370	444	524	148	1	80	0.0125000
NODE_4206_length_1166_cov_313.815370	444	524	160	2	80	0.0250000
NODE_4206_length_1166_cov_313.815370	444	524	194	1	80	0.0125000
NODE_4206_length_1166_cov_313.815370	444	524	195	1	80	0.0125000
NODE_4206_length_1166_cov_313.815370	444	524	198	1	80	0.0125000
NODE_4206_length_1166_cov_313.815370	444	524	201	3	80	0.0375000
NODE_4206_length_1166_cov_313.815370	444	524	230	1	80	0.0125000
NODE_4206_length_1166_cov_313.815370	444	524	244	1	80	0.0125000
NODE_4206_length_1166_cov_313.815370	444	524	283	1	80	0.0125000
NODE_4206_length_1166_cov_313.815370	444	524	284	2	80	0.0250000
NODE_4206_length_1166_cov_313.815370	444	524	307	1	80	0.0125000
NODE_4206_length_1166_cov_313.815370	444	524	326	1	80	0.0125000
NODE_4206_length_1166_cov_313.815370	444	524	349	1	80	0.0125000
NODE_4206_length_1166_cov_313.815370	444	524	364	1	80	0.0125000
NODE_4206_length_1166_cov_313.815370	444	524	373	1	80	0.0125000
NODE_4206_length_1166_cov_313.815370	444	524	385	2	80	0.0250000
NODE_4206_length_1166_cov_313.815370	444	524	391	1	80	0.0125000
NODE_4206_length_1166_cov_313.815370	444	524	411	1	80	0.0125000
NODE_4206_length_1166_cov_313.815370	444	524	412	3	80	0.0375000
NODE_4206_length_1166_cov_313.815370	444	524	418	1	80	0.0125000
NODE_4206_length_1166_cov_313.815370	444	524	440	1	80	0.0125000
NODE_4206_length_1166_cov_313.815370	444	524	441	1	80	0.0125000
NODE_4206_length_1166_cov_313.815370	444	524	464	1	80	0.0125000
NODE_4206_length_1166_cov_313.815370	444	524	475	1	80	0.0125000
NODE_4206_length_1166_cov_313.815370	444	524	477	1	80	0.0125000
NODE_4206_length_1166_cov_313.815370	444	524	493	1	80	0.0125000
NODE_4206_length_1166_cov_313.815370	444	524	494	2	80	0.0250000
NODE_4206_length_1166_cov_313.815370	444	524	500	1	80	0.0125000
NODE_4206_length_1166_cov_313.815370	444	524	502	3	80	0.0375000
NODE_4206_length_1166_cov_313.815370	444	524	514	1	80	0.0125000
NODE_4206_length_1166_cov_313.815370	444	524	536	1	80	0.0125000
NODE_4206_length_1166_cov_313.815370	444	524	546	1	80	0.0125000
NODE_4206_length_1166_cov_313.815370	444	524	547	1	80	0.0125000
NODE_4206_length_1166_cov_313.815370	444	524	558	1	80	0.0125000
NODE_4206_length_1166_cov_313.815370	444	524	561	1	80	0.0125000
NODE_4206_length_1166_cov_313.815370	444	524	567	1	80	0.0125000
NODE_4206_length_1166_cov_313.815370	444	524	589	1	80	0.0125000
NODE_4206_length_1166_cov_313.815370	444	524	592	1	80	0.0125000
NODE_4206_length_1166_cov_313.815370	444	524	595	1	80	0.0125000
NODE_4206_length_1166_cov_313.815370	444	524	643	1	80	0.0125000
NODE_4206_length_1166_cov_313.815370	444	524	650	1	80	0.0125000
NODE_4206_length_1166_cov_313.815370	444	524	662	1	80	0.0125000
NODE_4206_length_1166_cov_313.815370	444	524	663	1	80	0.0125000
NODE_4206_length_1166_cov_313.815370	444	524	664	2	80	0.0250000
NODE_4206_length_1166_cov_313.815370	444	524	671	2	80	0.0250000
NODE_4206_length_1166_cov_313.815370	444	524	672	1	80	0.0125000
NODE_4206_length_1166_cov_313.815370	444	524	673	1	80	0.0125000
NODE_4206_length_1166_cov_313.815370	444	524	675	1	80	0.0125000
NODE_4206_length_1166_cov_313.815370	444	524	676	1	80	0.0125000
NODE_4206_length_1166_cov_313.815370	444	524	682	1	80	0.0125000
NODE_4206_length_1166_cov_313.815370	444	524	686	1	80	0.0125000
NODE_4206_length_1166_cov_313.815370	444	524	66	3	80	0.0375000
NODE_4206_length_1166_cov_313.815370	444	524	68	13	80	0.1625000
NODE_4206_length_1166_cov_313.815370	444	524	147	1	80	0.0125000
NODE_4206_length_1166_cov_313.815370	444	524	148	1	80	0.0125000
NODE_4206_length_1166_cov_313.815370	444	524	160	2	80	0.0250000
NODE_4206_length_1166_cov_313.815370	444	524	194	1	80	0.0125000
NODE_4206_length_1166_cov_313.815370	444	524	195	1	80	0.0125000
NODE_4206_length_1166_cov_313.815370	444	524	198	1	80	0.0125000
NODE_4206_length_1166_cov_313.815370	444	524	201	3	80	0.0375000
NODE_4206_length_1166_cov_313.815370	444	524	230	1	80	0.0125000
NODE_4206_length_1166_cov_313.815370	444	524	244	1	80	0.0125000
NODE_4206_length_1166_cov_313.815370	444	524	283	1	80	0.0125000
NODE_4206_length_1166_cov_313.815370	444	524	284	2	80	0.0250000
NODE_4206_length_1166_cov_313.815370	444	524	307	1	80	0.0125000
NODE_4206_length_1166_cov_313.815370	444	524	326	1	80	0.0125000
NODE_4206_length_1166_cov_313.815370	444	524	349	1	80	0.0125000
NODE_4206_length_1166_cov_313.815370	444	524	364	1	80	0.0125000
NODE_4206_length_1166_cov_313.815370	444	524	373	1	80	0.0125000
NODE_4206_length_1166_cov_313.815370	444	524	385	2	80	0.0250000
NODE_4206_length_1166_cov_313.815370	444	524	391	1	80	0.0125000
NODE_4206_length_1166_cov_313.815370	444	524	411	1	80	0.0125000
NODE_4206_length_1166_cov_313.815370	444	524	412	3	80	0.0375000
NODE_4206_length_1166_cov_313.815370	444	524	418	1	80	0.0125000
NODE_4206_length_1166_cov_313.815370	444	524	440	1	80	0.0125000
NODE_4206_length_1166_cov_313.815370	444	524	441	1	80	0.0125000
NODE_4206_length_1166_cov_313.815370	444	524	464	1	80	0.0125000
NODE_4206_length_1166_cov_313.815370	444	524	475	1	80	0.0125000
NODE_4206_length_1166_cov_313.815370	444	524	477	1	80	0.0125000
NODE_4206_length_1166_cov_313.815370	444	524	493	1	80	0.0125000
NODE_4206_length_1166_cov_313.815370	444	524	494	2	80	0.0250000
NODE_4206_length_1166_cov_313.815370	444	524	500	1	80	0.0125000
NODE_4206_length_1166_cov_313.815370	444	524	502	3	80	0.0375000
NODE_4206_length_1166_cov_313.815370	444	524	514	1	80	0.0125000
NODE_4206_length_1166_cov_313.815370	444	524	536	1	80	0.0125000
NODE_4206_length_1166_cov_313.815370	444	524	546	1	80	0.0125000
NODE_4206_length_1166_cov_313.815370	444	524	547	1	80	0.0125000
NODE_4206_length_1166_cov_313.815370	444	524	558	1	80	0.0125000
NODE_4206_length_1166_cov_313.815370	444	524	561	1	80	0.0125000
NODE_4206_length_1166_cov_313.815370	444	524	567	1	80	0.0125000
NODE_4206_length_1166_cov_313.815370	444	524	589	1	80	0.0125000
NODE_4206_length_1166_cov_313.815370	444	524	592	1	80	0.0125000
NODE_4206_length_1166_cov_313.815370	444	524	595	1	80	0.0125000
NODE_4206_length_1166_cov_313.815370	444	524	643	1	80	0.0125000
NODE_4206_length_1166_cov_313.815370	444	524	650	1	80	0.0125000
NODE_4206_length_1166_cov_313.815370	444	524	662	1	80	0.0125000
NODE_4206_length_1166_cov_313.815370	444	524	663	1	80	0.0125000
NODE_4206_length_1166_cov_313.815370	444	524	664	2	80	0.0250000
NODE_4206_length_1166_cov_313.815370	444	524	671	2	80	0.0250000
NODE_4206_length_1166_cov_313.815370	444	524	672	1	80	0.0125000
NODE_4206_length_1166_cov_313.815370	444	524	673	1	80	0.0125000
NODE_4206_length_1166_cov_313.815370	444	524	675	1	80	0.0125000
NODE_4206_length_1166_cov_313.815370	444	524	676	1	80	0.0125000
NODE_4206_length_1166_cov_313.815370	444	524	682	1	80	0.0125000
NODE_4206_length_1166_cov_313.815370	444	524	686	1	80	0.0125000
NODE_4206_length_1166_cov_313.815370	444	524	66	3	80	0.0375000
NODE_4206_length_1166_cov_313.815370	444	524	68	13	80	0.1625000
NODE_4206_length_1166_cov_313.815370	444	524	147	1	80	0.0125000
NODE_4206_length_1166_cov_313.815370	444	524	148	1	80	0.0125000
NODE_4206_length_1166_cov_313.815370	444	524	160	2	80	0.0250000
NODE_4206_length_1166_cov_313.815370	444	524	194	1	80	0.0125000
NODE_4206_length_1166_cov_313.815370	444	524	195	1	80	0.0125000
NODE_4206_length_1166_cov_313.815370	444	524	198	1	80	0.0125000
NODE_4206_length_1166_cov_313.815370	444	524	201	3	80	0.0375000
NODE_4206_length_1166_cov_313.815370	444	524	230	1	80	0.0125000
NODE_4206_length_1166_cov_313.815370	444	524	244	1	80	0.0125000
NODE_4206_length_1166_cov_313.815370	444	524	283	1	80	0.0125000
NODE_4206_length_1166_cov_313.815370	444	524	284	2	80	0.0250000
NODE_4206_length_1166_cov_313.815370	444	524	307	1	80	0.0125000
NODE_4206_length_1166_cov_313.815370	444	524	326	1	80	0.0125000
NODE_4206_length_1166_cov_313.815370	444	524	349	1	80	0.0125000
NODE_4206_length_1166_cov_313.815370	444	524	364	1	80	0.0125000
NODE_4206_length_1166_cov_313.815370	444	524	373	1	80	0.0125000
NODE_4206_length_1166_cov_313.815370	444	524	385	2	80	0.0250000
NODE_4206_length_1166_cov_313.815370	444	524	391	1	80	0.0125000
NODE_4206_length_1166_cov_313.815370	444	524	411	1	80	0.0125000
NODE_4206_length_1166_cov_313.815370	444	524	412	3	80	0.0375000
NODE_4206_length_1166_cov_313.815370	444	524	418	1	80	0.0125000
NODE_4206_length_1166_cov_313.815370	444	524	440	1	80	0.0125000
NODE_4206_length_1166_cov_313.815370	444	524	441	1	80	0.0125000
NODE_4206_length_1166_cov_313.815370	444	524	464	1	80	0.0125000
NODE_4206_length_1166_cov_313.815370	444	524	475	1	80	0.0125000
NODE_4206_length_1166_cov_313.815370	444	524	477	1	80	0.0125000
NODE_4206_length_1166_cov_313.815370	444	524	493	1	80	0.0125000
NODE_4206_length_1166_cov_313.815370	444	524	494	2	80	0.0250000
NODE_4206_length_1166_cov_313.815370	444	524	500	1	80	0.0125000
NODE_4206_length_1166_cov_313.815370	444	524	502	3	80	0.0375000
NODE_4206_length_1166_cov_313.815370	444	524	514	1	80	0.0125000
NODE_4206_length_1166_cov_313.815370	444	524	536	1	80	0.0125000
NODE_4206_length_1166_cov_313.815370	444	524	546	1	80	0.0125000
NODE_4206_length_1166_cov_313.815370	444	524	547	1	80	0.0125000
NODE_4206_length_1166_cov_313.815370	444	524	558	1	80	0.0125000
NODE_4206_length_1166_cov_313.815370	444	524	561	1	80	0.0125000
NODE_4206_length_1166_cov_313.815370	444	524	567	1	80	0.0125000
NODE_4206_length_1166_cov_313.815370	444	524	589	1	80	0.0125000
NODE_4206_length_1166_cov_313.815370	444	524	592	1	80	0.0125000
NODE_4206_length_1166_cov_313.815370	444	524	595	1	80	0.0125000
NODE_4206_length_1166_cov_313.815370	444	524	643	1	80	0.0125000
NODE_4206_length_1166_cov_313.815370	444	524	650	1	80	0.0125000
NODE_4206_length_1166_cov_313.815370	444	524	662	1	80	0.0125000
NODE_4206_length_1166_cov_313.815370	444	524	663	1	80	0.0125000
NODE_4206_length_1166_cov_313.815370	444	524	664	2	80	0.0250000
NODE_4206_length_1166_cov_313.815370	444	524	671	2	80	0.0250000
NODE_4206_length_1166_cov_313.815370	444	524	672	1	80	0.0125000
NODE_4206_length_1166_cov_313.815370	444	524	673	1	80	0.0125000
NODE_4206_length_1166_cov_313.815370	444	524	675	1	80	0.0125000
NODE_4206_length_1166_cov_313.815370	444	524	676	1	80	0.0125000
NODE_4206_length_1166_cov_313.815370	444	524	682	1	80	0.0125000
NODE_4206_length_1166_cov_313.815370	444	524	686	1	80	0.0125000
NODE_4206_length_1166_cov_313.815370	444	524	66	3	80	0.0375000
NODE_4206_length_1166_cov_313.815370	444	524	68	13	80	0.1625000
NODE_4206_length_1166_cov_313.815370	444	524	147	1	80	0.0125000
NODE_4206_length_1166_cov_313.815370	444	524	148	1	80	0.0125000
NODE_4206_length_1166_cov_313.815370	444	524	160	2	80	0.0250000
NODE_4206_length_1166_cov_313.815370	444	524	194	1	80	0.0125000
NODE_4206_length_1166_cov_313.815370	444	524	195	1	80	0.0125000
NODE_4206_length_1166_cov_313.815370	444	524	198	1	80	0.0125000
NODE_4206_length_1166_cov_313.815370	444	524	201	3	80	0.0375000
NODE_4206_length_1166_cov_313.815370	444	524	230	1	80	0.0125000
NODE_4206_length_1166_cov_313.815370	444	524	244	1	80	0.0125000
NODE_4206_length_1166_cov_313.815370	444	524	283	1	80	0.0125000
NODE_4206_length_1166_cov_313.815370	444	524	284	2	80	0.0250000
NODE_4206_length_1166_cov_313.815370	444	524	307	1	80	0.0125000
NODE_4206_length_1166_cov_313.815370	444	524	326	1	80	0.0125000
NODE_4206_length_1166_cov_313.815370	444	524	349	1	80	0.0125000
NODE_4206_length_1166_cov_313.815370	444	524	364	1	80	0.0125000
NODE_4206_length_1166_cov_313.815370	444	524	373	1	80	0.0125000
NODE_4206_length_1166_cov_313.815370	444	524	385	2	80	0.0250000
NODE_4206_length_1166_cov_313.815370	444	524	391	1	80	0.0125000
NODE_4206_length_1166_cov_313.815370	444	524	411	1	80	0.0125000
NODE_4206_length_1166_cov_313.815370	444	524	412	3	80	0.0375000
NODE_4206_length_1166_cov_313.815370	444	524	418	1	80	0.0125000
NODE_4206_length_1166_cov_313.815370	444	524	440	1	80	0.0125000
NODE_4206_length_1166_cov_313.815370	444	524	441	1	80	0.0125000
NODE_4206_length_1166_cov_313.815370	444	524	464	1	80	0.0125000
NODE_4206_length_1166_cov_313.815370	444	524	475	1	80	0.0125000
NODE_4206_length_1166_cov_313.815370	444	524	477	1	80	0.0125000
NODE_4206_length_1166_cov_313.815370	444	524	493	1	80	0.0125000
NODE_4206_length_1166_cov_313.815370	444	524	494	2	80	0.0250000
NODE_4206_length_1166_cov_313.815370	444	524	500	1	80	0.0125000
NODE_4206_length_1166_cov_313.815370	444	524	502	3	80	0.0375000
NODE_4206_length_1166_cov_313.815370	444	524	514	1	80	0.0125000
NODE_4206_length_1166_cov_313.815370	444	524	536	1	80	0.0125000
NODE_4206_length_1166_cov_313.815370	444	524	546	1	80	0.0125000
NODE_4206_length_1166_cov_313.815370	444	524	547	1	80	0.0125000
NODE_4206_length_1166_cov_313.815370	444	524	558	1	80	0.0125000
NODE_4206_length_1166_cov_313.815370	444	524	561	1	80	0.0125000
NODE_4206_length_1166_cov_313.815370	444	524	567	1	80	0.0125000
NODE_4206_length_1166_cov_313.815370	444	524	589	1	80	0.0125000
NODE_4206_length_1166_cov_313.815370	444	524	592	1	80	0.0125000
NODE_4206_length_1166_cov_313.815370	444	524	595	1	80	0.0125000
NODE_4206_length_1166_cov_313.815370	444	524	643	1	80	0.0125000
NODE_4206_length_1166_cov_313.815370	444	524	650	1	80	0.0125000
NODE_4206_length_1166_cov_313.815370	444	524	662	1	80	0.0125000
NODE_4206_length_1166_cov_313.815370	444	524	663	1	80	0.0125000
NODE_4206_length_1166_cov_313.815370	444	524	664	2	80	0.0250000
NODE_4206_length_1166_cov_313.815370	444	524	671	2	80	0.0250000
NODE_4206_length_1166_cov_313.815370	444	524	672	1	80	0.0125000
NODE_4206_length_1166_cov_313.815370	444	524	673	1	80	0.0125000
NODE_4206_length_1166_cov_313.815370	444	524	675	1	80	0.0125000
NODE_4206_length_1166_cov_313.815370	444	524	676	1	80	0.0125000
NODE_4206_length_1166_cov_313.815370	444	524	682	1	80	0.0125000
NODE_4206_length_1166_cov_313.815370	444	524	686	1	80	0.0125000
NODE_4206_length_1166_cov_313.815370	444	524	66	3	80	0.0375000
NODE_4206_length_1166_cov_313.815370	444	524	68	13	80	0.1625000
NODE_4206_length_1166_cov_313.815370	444	524	147	1	80	0.0125000
NODE_4206_length_1166_cov_313.815370	444	524	148	1	80	0.0125000
NODE_4206_length_1166_cov_313.815370	444	524	160	2	80	0.0250000
NODE_4206_length_1166_cov_313.815370	444	524	194	1	80	0.0125000
NODE_4206_length_1166_cov_313.815370	444	524	195	1	80	0.0125000
NODE_4206_length_1166_cov_313.815370	444	524	198	1	80	0.0125000
NODE_4206_length_1166_cov_313.815370	444	524	201	3	80	0.0375000
NODE_4206_length_1166_cov_313.815370	444	524	230	1	80	0.0125000
NODE_4206_length_1166_cov_313.815370	444	524	244	1	80	0.0125000
NODE_4206_length_1166_cov_313.815370	444	524	283	1	80	0.0125000
NODE_4206_length_1166_cov_313.815370	444	524	284	2	80	0.0250000
NODE_4206_length_1166_cov_313.815370	444	524	307	1	80	0.0125000
NODE_4206_length_1166_cov_313.815370	444	524	326	1	80	0.0125000
NODE_4206_length_1166_cov_313.815370	444	524	349	1	80	0.0125000
NODE_4206_length_1166_cov_313.815370	444	524	364	1	80	0.0125000
NODE_4206_length_1166_cov_313.815370	444	524	373	1	80	0.0125000
NODE_4206_length_1166_cov_313.815370	444	524	385	2	80	0.0250000
NODE_4206_length_1166_cov_313.815370	444	524	391	1	80	0.0125000
NODE_4206_length_1166_cov_313.815370	444	524	411	1	80	0.0125000
NODE_4206_length_1166_cov_313.815370	444	524	412	3	80	0.0375000
NODE_4206_length_1166_cov_313.815370	444	524	418	1	80	0.0125000
NODE_4206_length_1166_cov_313.815370	444	524	440	1	80	0.0125000
NODE_4206_length_1166_cov_313.815370	444	524	441	1	80	0.0125000
NODE_4206_length_1166_cov_313.815370	444	524	464	1	80	0.0125000
NODE_4206_length_1166_cov_313.815370	444	524	475	1	80	0.0125000
NODE_4206_length_1166_cov_313.815370	444	524	477	1	80	0.0125000
NODE_4206_length_1166_cov_313.815370	444	524	493	1	80	0.0125000
NODE_4206_length_1166_cov_313.815370	444	524	494	2	80	0.0250000
NODE_4206_length_1166_cov_313.815370	444	524	500	1	80	0.0125000
NODE_4206_length_1166_cov_313.815370	444	524	502	3	80	0.0375000
NODE_4206_length_1166_cov_313.815370	444	524	514	1	80	0.0125000
NODE_4206_length_1166_cov_313.815370	444	524	536	1	80	0.0125000
NODE_4206_length_1166_cov_313.815370	444	524	546	1	80	0.0125000
NODE_4206_length_1166_cov_313.815370	444	524	547	1	80	0.0125000
NODE_4206_length_1166_cov_313.815370	444	524	558	1	80	0.0125000
NODE_4206_length_1166_cov_313.815370	444	524	561	1	80	0.0125000
NODE_4206_length_1166_cov_313.815370	444	524	567	1	80	0.0125000
NODE_4206_length_1166_cov_313.815370	444	524	589	1	80	0.0125000
NODE_4206_length_1166_cov_313.815370	444	524	592	1	80	0.0125000
NODE_4206_length_1166_cov_313.815370	444	524	595	1	80	0.0125000
NODE_4206_length_1166_cov_313.815370	444	524	643	1	80	0.0125000
NODE_4206_length_1166_cov_313.815370	444	524	650	1	80	0.0125000
NODE_4206_length_1166_cov_313.815370	444	524	662	1	80	0.0125000
NODE_4206_length_1166_cov_313.815370	444	524	663	1	80	0.0125000
NODE_4206_length_1166_cov_313.815370	444	524	664	2	80	0.0250000
NODE_4206_length_1166_cov_313.815370	444	524	671	2	80	0.0250000
NODE_4206_length_1166_cov_313.815370	444	524	672	1	80	0.0125000
NODE_4206_length_1166_cov_313.815370	444	524	673	1	80	0.0125000
NODE_4206_length_1166_cov_313.815370	444	524	675	1	80	0.0125000
NODE_4206_length_1166_cov_313.815370	444	524	676	1	80	0.0125000
NODE_4206_length_1166_cov_313.815370	444	524	682	1	80	0.0125000
NODE_4206_length_1166_cov_313.815370	444	524	686	1	80	0.0125000
NODE_4206_length_1166_cov_313.815370	497	577	502	3	80	0.0375000
NODE_4206_length_1166_cov_313.815370	497	577	514	1	80	0.0125000
NODE_4206_length_1166_cov_313.815370	497	577	536	1	80	0.0125000
NODE_4206_length_1166_cov_313.815370	497	577	546	1	80	0.0125000
NODE_4206_length_1166_cov_313.815370	497	577	547	1	80	0.0125000
NODE_4206_length_1166_cov_313.815370	497	577	558	1	80	0.0125000
NODE_4206_length_1166_cov_313.815370	497	577	561	1	80	0.0125000
NODE_4206_length_1166_cov_313.815370	497	577	567	1	80	0.0125000
NODE_4206_length_1166_cov_313.815370	497	577	589	1	80	0.0125000
NODE_4206_length_1166_cov_313.815370	497	577	592	1	80	0.0125000
NODE_4206_length_1166_cov_313.815370	497	577	595	1	80	0.0125000
NODE_4206_length_1166_cov_313.815370	497	577	643	1	80	0.0125000
NODE_4206_length_1166_cov_313.815370	497	577	650	1	80	0.0125000
NODE_4206_length_1166_cov_313.815370	497	577	662	1	80	0.0125000
NODE_4206_length_1166_cov_313.815370	497	577	663	1	80	0.0125000
NODE_4206_length_1166_cov_313.815370	497	577	664	2	80	0.0250000
NODE_4206_length_1166_cov_313.815370	497	577	671	2	80	0.0250000
NODE_4206_length_1166_cov_313.815370	497	577	672	1	80	0.0125000
NODE_4206_length_1166_cov_313.815370	497	577	673	1	80	0.0125000
NODE_4206_length_1166_cov_313.815370	497	577	675	1	80	0.0125000
NODE_4206_length_1166_cov_313.815370	497	577	676	1	80	0.0125000
NODE_4206_length_1166_cov_313.815370	497	577	679	1	80	0.0125000
NODE_4206_length_1166_cov_313.815370	497	577	680	3	80	0.0375000
NODE_4206_length_1166_cov_313.815370	497	577	681	2	80	0.0250000
NODE_4206_length_1166_cov_313.815370	497	577	682	11	80	0.1375000
NODE_4206_length_1166_cov_313.815370	497	577	683	8	80	0.1000000
NODE_4206_length_1166_cov_313.815370	497	577	684	12	80	0.1500000
NODE_4206_length_1166_cov_313.815370	497	577	685	1	80	0.0125000
NODE_4206_length_1166_cov_313.815370	497	577	686	7	80	0.0875000
NODE_4206_length_1166_cov_313.815370	497	577	687	3	80	0.0375000
NODE_4206_length_1166_cov_313.815370	497	577	688	2	80	0.0250000
NODE_4206_length_1166_cov_313.815370	497	577	691	1	80	0.0125000
NODE_4206_length_1166_cov_313.815370	497	577	695	3	80	0.0375000
NODE_4206_length_1166_cov_313.815370	497	577	698	1	80	0.0125000
NODE_4206_length_1166_cov_313.815370	497	577	502	3	80	0.0375000
NODE_4206_length_1166_cov_313.815370	497	577	514	1	80	0.0125000
NODE_4206_length_1166_cov_313.815370	497	577	536	1	80	0.0125000
NODE_4206_length_1166_cov_313.815370	497	577	546	1	80	0.0125000
NODE_4206_length_1166_cov_313.815370	497	577	547	1	80	0.0125000
NODE_4206_length_1166_cov_313.815370	497	577	558	1	80	0.0125000
NODE_4206_length_1166_cov_313.815370	497	577	561	1	80	0.0125000
NODE_4206_length_1166_cov_313.815370	497	577	567	1	80	0.0125000
NODE_4206_length_1166_cov_313.815370	497	577	589	1	80	0.0125000
NODE_4206_length_1166_cov_313.815370	497	577	592	1	80	0.0125000
NODE_4206_length_1166_cov_313.815370	497	577	595	1	80	0.0125000
NODE_4206_length_1166_cov_313.815370	497	577	643	1	80	0.0125000
NODE_4206_length_1166_cov_313.815370	497	577	650	1	80	0.0125000
NODE_4206_length_1166_cov_313.815370	497	577	662	1	80	0.0125000
NODE_4206_length_1166_cov_313.815370	497	577	663	1	80	0.0125000
NODE_4206_length_1166_cov_313.815370	497	577	664	2	80	0.0250000
NODE_4206_length_1166_cov_313.815370	497	577	671	2	80	0.0250000
NODE_4206_length_1166_cov_313.815370	497	577	672	1	80	0.0125000
NODE_4206_length_1166_cov_313.815370	497	577	673	1	80	0.0125000
NODE_4206_length_1166_cov_313.815370	497	577	675	1	80	0.0125000
NODE_4206_length_1166_cov_313.815370	497	577	676	1	80	0.0125000
NODE_4206_length_1166_cov_313.815370	497	577	679	1	80	0.0125000
NODE_4206_length_1166_cov_313.815370	497	577	680	3	80	0.0375000
NODE_4206_length_1166_cov_313.815370	497	577	681	2	80	0.0250000
NODE_4206_length_1166_cov_313.815370	497	577	682	11	80	0.1375000
NODE_4206_length_1166_cov_313.815370	497	577	683	8	80	0.1000000
NODE_4206_length_1166_cov_313.815370	497	577	684	12	80	0.1500000
NODE_4206_length_1166_cov_313.815370	497	577	685	1	80	0.0125000
NODE_4206_length_1166_cov_313.815370	497	577	686	7	80	0.0875000
NODE_4206_length_1166_cov_313.815370	497	577	687	3	80	0.0375000
NODE_4206_length_1166_cov_313.815370	497	577	688	2	80	0.0250000
NODE_4206_length_1166_cov_313.815370	497	577	691	1	80	0.0125000
NODE_4206_length_1166_cov_313.815370	497	577	695	3	80	0.0375000
NODE_4206_length_1166_cov_313.815370	497	577	698	1	80	0.0125000
NODE_4206_length_1166_cov_313.815370	497	577	502	3	80	0.0375000
NODE_4206_length_1166_cov_313.815370	497	577	514	1	80	0.0125000
NODE_4206_length_1166_cov_313.815370	497	577	536	1	80	0.0125000
NODE_4206_length_1166_cov_313.815370	497	577	546	1	80	0.0125000
NODE_4206_length_1166_cov_313.815370	497	577	547	1	80	0.0125000
NODE_4206_length_1166_cov_313.815370	497	577	558	1	80	0.0125000
NODE_4206_length_1166_cov_313.815370	497	577	561	1	80	0.0125000
NODE_4206_length_1166_cov_313.815370	497	577	567	1	80	0.0125000
NODE_4206_length_1166_cov_313.815370	497	577	589	1	80	0.0125000
NODE_4206_length_1166_cov_313.815370	497	577	592	1	80	0.0125000
NODE_4206_length_1166_cov_313.815370	497	577	595	1	80	0.0125000
NODE_4206_length_1166_cov_313.815370	497	577	643	1	80	0.0125000
NODE_4206_length_1166_cov_313.815370	497	577	650	1	80	0.0125000
NODE_4206_length_1166_cov_313.815370	497	577	662	1	80	0.0125000
NODE_4206_length_1166_cov_313.815370	497	577	663	1	80	0.0125000
NODE_4206_length_1166_cov_313.815370	497	577	664	2	80	0.0250000
NODE_4206_length_1166_cov_313.815370	497	577	671	2	80	0.0250000
NODE_4206_length_1166_cov_313.815370	497	577	672	1	80	0.0125000
NODE_4206_length_1166_cov_313.815370	497	577	673	1	80	0.0125000
NODE_4206_length_1166_cov_313.815370	497	577	675	1	80	0.0125000
NODE_4206_length_1166_cov_313.815370	497	577	676	1	80	0.0125000
NODE_4206_length_1166_cov_313.815370	497	577	679	1	80	0.0125000
NODE_4206_length_1166_cov_313.815370	497	577	680	3	80	0.0375000
NODE_4206_length_1166_cov_313.815370	497	577	681	2	80	0.0250000
NODE_4206_length_1166_cov_313.815370	497	577	682	11	80	0.1375000
NODE_4206_length_1166_cov_313.815370	497	577	683	8	80	0.1000000
NODE_4206_length_1166_cov_313.815370	497	577	684	12	80	0.1500000
NODE_4206_length_1166_cov_313.815370	497	577	685	1	80	0.0125000
NODE_4206_length_1166_cov_313.815370	497	577	686	7	80	0.0875000
NODE_4206_length_1166_cov_313.815370	497	577	687	3	80	0.0375000
NODE_4206_length_1166_cov_313.815370	497	577	688	2	80	0.0250000
NODE_4206_length_1166_cov_313.815370	497	577	691	1	80	0.0125000
NODE_4206_length_1166_cov_313.815370	497	577	695	3	80	0.0375000
NODE_4206_length_1166_cov_313.815370	497	577	698	1	80	0.0125000
NODE_4206_length_1166_cov_313.815370	497	577	502	3	80	0.0375000
NODE_4206_length_1166_cov_313.815370	497	577	514	1	80	0.0125000
NODE_4206_length_1166_cov_313.815370	497	577	536	1	80	0.0125000
NODE_4206_length_1166_cov_313.815370	497	577	546	1	80	0.0125000
NODE_4206_length_1166_cov_313.815370	497	577	547	1	80	0.0125000
NODE_4206_length_1166_cov_313.815370	497	577	558	1	80	0.0125000
NODE_4206_length_1166_cov_313.815370	497	577	561	1	80	0.0125000
NODE_4206_length_1166_cov_313.815370	497	577	567	1	80	0.0125000
NODE_4206_length_1166_cov_313.815370	497	577	589	1	80	0.0125000
NODE_4206_length_1166_cov_313.815370	497	577	592	1	80	0.0125000
NODE_4206_length_1166_cov_313.815370	497	577	595	1	80	0.0125000
NODE_4206_length_1166_cov_313.815370	497	577	643	1	80	0.0125000
NODE_4206_length_1166_cov_313.815370	497	577	650	1	80	0.0125000
NODE_4206_length_1166_cov_313.815370	497	577	662	1	80	0.0125000
NODE_4206_length_1166_cov_313.815370	497	577	663	1	80	0.0125000
NODE_4206_length_1166_cov_313.815370	497	577	664	2	80	0.0250000
NODE_4206_length_1166_cov_313.815370	497	577	671	2	80	0.0250000
NODE_4206_length_1166_cov_313.815370	497	577	672	1	80	0.0125000
NODE_4206_length_1166_cov_313.815370	497	577	673	1	80	0.0125000
NODE_4206_length_1166_cov_313.815370	497	577	675	1	80	0.0125000
NODE_4206_length_1166_cov_313.815370	497	577	676	1	80	0.0125000
NODE_4206_length_1166_cov_313.815370	497	577	679	1	80	0.0125000
NODE_4206_length_1166_cov_313.815370	497	577	680	3	80	0.0375000
NODE_4206_length_1166_cov_313.815370	497	577	681	2	80	0.0250000
NODE_4206_length_1166_cov_313.815370	497	577	682	11	80	0.1375000
NODE_4206_length_1166_cov_313.815370	497	577	683	8	80	0.1000000
NODE_4206_length_1166_cov_313.815370	497	577	684	12	80	0.1500000
NODE_4206_length_1166_cov_313.815370	497	577	685	1	80	0.0125000
NODE_4206_length_1166_cov_313.815370	497	577	686	7	80	0.0875000
NODE_4206_length_1166_cov_313.815370	497	577	687	3	80	0.0375000
NODE_4206_length_1166_cov_313.815370	497	577	688	2	80	0.0250000
NODE_4206_length_1166_cov_313.815370	497	577	691	1	80	0.0125000
NODE_4206_length_1166_cov_313.815370	497	577	695	3	80	0.0375000
NODE_4206_length_1166_cov_313.815370	497	577	698	1	80	0.0125000
NODE_4206_length_1166_cov_313.815370	497	577	502	3	80	0.0375000
NODE_4206_length_1166_cov_313.815370	497	577	514	1	80	0.0125000
NODE_4206_length_1166_cov_313.815370	497	577	536	1	80	0.0125000
NODE_4206_length_1166_cov_313.815370	497	577	546	1	80	0.0125000
NODE_4206_length_1166_cov_313.815370	497	577	547	1	80	0.0125000
NODE_4206_length_1166_cov_313.815370	497	577	558	1	80	0.0125000
NODE_4206_length_1166_cov_313.815370	497	577	561	1	80	0.0125000
NODE_4206_length_1166_cov_313.815370	497	577	567	1	80	0.0125000
NODE_4206_length_1166_cov_313.815370	497	577	589	1	80	0.0125000
NODE_4206_length_1166_cov_313.815370	497	577	592	1	80	0.0125000
NODE_4206_length_1166_cov_313.815370	497	577	595	1	80	0.0125000
NODE_4206_length_1166_cov_313.815370	497	577	643	1	80	0.0125000
NODE_4206_length_1166_cov_313.815370	497	577	650	1	80	0.0125000
NODE_4206_length_1166_cov_313.815370	497	577	662	1	80	0.0125000
NODE_4206_length_1166_cov_313.815370	497	577	663	1	80	0.0125000
NODE_4206_length_1166_cov_313.815370	497	577	664	2	80	0.0250000
NODE_4206_length_1166_cov_313.815370	497	577	671	2	80	0.0250000
NODE_4206_length_1166_cov_313.815370	497	577	672	1	80	0.0125000
NODE_4206_length_1166_cov_313.815370	497	577	673	1	80	0.0125000
NODE_4206_length_1166_cov_313.815370	497	577	675	1	80	0.0125000
NODE_4206_length_1166_cov_313.815370	497	577	676	1	80	0.0125000
NODE_4206_length_1166_cov_313.815370	497	577	679	1	80	0.0125000
NODE_4206_length_1166_cov_313.815370	497	577	680	3	80	0.0375000
NODE_4206_length_1166_cov_313.815370	497	577	681	2	80	0.0250000
NODE_4206_length_1166_cov_313.815370	497	577	682	11	80	0.1375000
NODE_4206_length_1166_cov_313.815370	497	577	683	8	80	0.1000000
NODE_4206_length_1166_cov_313.815370	497	577	684	12	80	0.1500000
NODE_4206_length_1166_cov_313.815370	497	577	685	1	80	0.0125000
NODE_4206_length_1166_cov_313.815370	497	577	686	7	80	0.0875000
NODE_4206_length_1166_cov_313.815370	497	577	687	3	80	0.0375000
NODE_4206_length_1166_cov_313.815370	497	577	688	2	80	0.0250000
NODE_4206_length_1166_cov_313.815370	497	577	691	1	80	0.0125000
NODE_4206_length_1166_cov_313.815370	497	577	695	3	80	0.0375000
NODE_4206_length_1166_cov_313.815370	497	577	698	1	80	0.0125000
NODE_4206_length_1166_cov_313.815370	497	577	502	3	80	0.0375000
NODE_4206_length_1166_cov_313.815370	497	577	514	1	80	0.0125000
NODE_4206_length_1166_cov_313.815370	497	577	536	1	80	0.0125000
NODE_4206_length_1166_cov_313.815370	497	577	546	1	80	0.0125000
NODE_4206_length_1166_cov_313.815370	497	577	547	1	80	0.0125000
NODE_4206_length_1166_cov_313.815370	497	577	558	1	80	0.0125000
NODE_4206_length_1166_cov_313.815370	497	577	561	1	80	0.0125000
NODE_4206_length_1166_cov_313.815370	497	577	567	1	80	0.0125000
NODE_4206_length_1166_cov_313.815370	497	577	589	1	80	0.0125000
NODE_4206_length_1166_cov_313.815370	497	577	592	1	80	0.0125000
NODE_4206_length_1166_cov_313.815370	497	577	595	1	80	0.0125000
NODE_4206_length_1166_cov_313.815370	497	577	643	1	80	0.0125000
NODE_4206_length_1166_cov_313.815370	497	577	650	1	80	0.0125000
NODE_4206_length_1166_cov_313.815370	497	577	662	1	80	0.0125000
NODE_4206_length_1166_cov_313.815370	497	577	663	1	80	0.0125000
NODE_4206_length_1166_cov_313.815370	497	577	664	2	80	0.0250000
NODE_4206_length_1166_cov_313.815370	497	577	671	2	80	0.0250000
NODE_4206_length_1166_cov_313.815370	497	577	672	1	80	0.0125000
NODE_4206_length_1166_cov_313.815370	497	577	673	1	80	0.0125000
NODE_4206_length_1166_cov_313.815370	497	577	675	1	80	0.0125000
NODE_4206_length_1166_cov_313.815370	497	577	676	1	80	0.0125000
NODE_4206_length_1166_cov_313.815370	497	577	679	1	80	0.0125000
NODE_4206_length_1166_cov_313.815370	497	577	680	3	80	0.0375000
NODE_4206_length_1166_cov_313.815370	497	577	681	2	80	0.0250000
NODE_4206_length_1166_cov_313.815370	497	577	682	11	80	0.1375000
NODE_4206_length_1166_cov_313.815370	497	577	683	8	80	0.1000000
NODE_4206_length_1166_cov_313.815370	497	577	684	12	80	0.1500000
NODE_4206_length_1166_cov_313.815370	497	577	685	1	80	0.0125000
NODE_4206_length_1166_cov_313.815370	497	577	686	7	80	0.0875000
NODE_4206_length_1166_cov_313.815370	497	577	687	3	80	0.0375000
NODE_4206_length_1166_cov_313.815370	497	577	688	2	80	0.0250000
NODE_4206_length_1166_cov_313.815370	497	577	691	1	80	0.0125000
NODE_4206_length_1166_cov_313.815370	497	577	695	3	80	0.0375000
NODE_4206_length_1166_cov_313.815370	497	577	698	1	80	0.0125000
NODE_4206_length_1166_cov_313.815370	497	568	502	3	71	0.0422535
NODE_4206_length_1166_cov_313.815370	497	568	514	1	71	0.0140845
NODE_4206_length_1166_cov_313.815370	497	568	536	1	71	0.0140845
NODE_4206_length_1166_cov_313.815370	497	568	546	1	71	0.0140845
NODE_4206_length_1166_cov_313.815370	497	568	547	1	71	0.0140845
NODE_4206_length_1166_cov_313.815370	497	568	558	1	71	0.0140845
NODE_4206_length_1166_cov_313.815370	497	568	561	1	71	0.0140845
NODE_4206_length_1166_cov_313.815370	497	568	567	1	71	0.0140845
NODE_4206_length_1166_cov_313.815370	497	568	589	1	71	0.0140845
NODE_4206_length_1166_cov_313.815370	497	568	592	1	71	0.0140845
NODE_4206_length_1166_cov_313.815370	497	568	595	1	71	0.0140845
NODE_4206_length_1166_cov_313.815370	497	568	643	1	71	0.0140845
NODE_4206_length_1166_cov_313.815370	497	568	650	1	71	0.0140845
NODE_4206_length_1166_cov_313.815370	497	568	662	1	71	0.0140845
NODE_4206_length_1166_cov_313.815370	497	568	663	1	71	0.0140845
NODE_4206_length_1166_cov_313.815370	497	568	664	2	71	0.0281690
NODE_4206_length_1166_cov_313.815370	497	568	671	2	71	0.0281690
NODE_4206_length_1166_cov_313.815370	497	568	672	1	71	0.0140845
NODE_4206_length_1166_cov_313.815370	497	568	673	1	71	0.0140845
NODE_4206_length_1166_cov_313.815370	497	568	675	1	71	0.0140845
NODE_4206_length_1166_cov_313.815370	497	568	676	1	71	0.0140845
NODE_4206_length_1166_cov_313.815370	497	568	679	1	71	0.0140845
NODE_4206_length_1166_cov_313.815370	497	568	680	3	71	0.0422535
NODE_4206_length_1166_cov_313.815370	497	568	681	2	71	0.0281690
NODE_4206_length_1166_cov_313.815370	497	568	682	4	71	0.0563380
NODE_4206_length_1166_cov_313.815370	497	568	683	6	71	0.0845070
NODE_4206_length_1166_cov_313.815370	497	568	684	12	71	0.1690141
NODE_4206_length_1166_cov_313.815370	497	568	685	1	71	0.0140845
NODE_4206_length_1166_cov_313.815370	497	568	686	7	71	0.0985916
NODE_4206_length_1166_cov_313.815370	497	568	687	3	71	0.0422535
NODE_4206_length_1166_cov_313.815370	497	568	688	2	71	0.0281690
NODE_4206_length_1166_cov_313.815370	497	568	691	1	71	0.0140845
NODE_4206_length_1166_cov_313.815370	497	568	695	3	71	0.0422535
NODE_4206_length_1166_cov_313.815370	497	568	698	1	71	0.0140845
NODE_4206_length_1166_cov_313.815370	500	570	514	1	70	0.0142857
NODE_4206_length_1166_cov_313.815370	500	570	536	1	70	0.0142857
NODE_4206_length_1166_cov_313.815370	500	570	546	1	70	0.0142857
NODE_4206_length_1166_cov_313.815370	500	570	547	1	70	0.0142857
NODE_4206_length_1166_cov_313.815370	500	570	558	1	70	0.0142857
NODE_4206_length_1166_cov_313.815370	500	570	561	1	70	0.0142857
NODE_4206_length_1166_cov_313.815370	500	570	567	1	70	0.0142857
NODE_4206_length_1166_cov_313.815370	500	570	589	1	70	0.0142857
NODE_4206_length_1166_cov_313.815370	500	570	592	1	70	0.0142857
NODE_4206_length_1166_cov_313.815370	500	570	595	1	70	0.0142857
NODE_4206_length_1166_cov_313.815370	500	570	643	1	70	0.0142857
NODE_4206_length_1166_cov_313.815370	500	570	650	1	70	0.0142857
NODE_4206_length_1166_cov_313.815370	500	570	662	1	70	0.0142857
NODE_4206_length_1166_cov_313.815370	500	570	663	1	70	0.0142857
NODE_4206_length_1166_cov_313.815370	500	570	664	2	70	0.0285714
NODE_4206_length_1166_cov_313.815370	500	570	671	2	70	0.0285714
NODE_4206_length_1166_cov_313.815370	500	570	672	1	70	0.0142857
NODE_4206_length_1166_cov_313.815370	500	570	673	1	70	0.0142857
NODE_4206_length_1166_cov_313.815370	500	570	675	1	70	0.0142857
NODE_4206_length_1166_cov_313.815370	500	570	676	1	70	0.0142857
NODE_4206_length_1166_cov_313.815370	500	570	679	1	70	0.0142857
NODE_4206_length_1166_cov_313.815370	500	570	680	3	70	0.0428571
NODE_4206_length_1166_cov_313.815370	500	570	681	2	70	0.0285714
NODE_4206_length_1166_cov_313.815370	500	570	682	6	70	0.0857143
NODE_4206_length_1166_cov_313.815370	500	570	683	6	70	0.0857143
NODE_4206_length_1166_cov_313.815370	500	570	684	12	70	0.1714286
NODE_4206_length_1166_cov_313.815370	500	570	685	1	70	0.0142857
NODE_4206_length_1166_cov_313.815370	500	570	686	7	70	0.1000000
NODE_4206_length_1166_cov_313.815370	500	570	687	3	70	0.0428571
NODE_4206_length_1166_cov_313.815370	500	570	688	2	70	0.0285714
NODE_4206_length_1166_cov_313.815370	500	570	691	1	70	0.0142857
NODE_4206_length_1166_cov_313.815370	500	570	695	3	70	0.0428571
NODE_4206_length_1166_cov_313.815370	500	570	698	1	70	0.0142857
NODE_4206_length_1166_cov_313.815370	997	1077	0	3	80	0.0375000
NODE_4206_length_1166_cov_313.815370	997	1077	26	29	80	0.3625000
NODE_4206_length_1166_cov_313.815370	997	1077	34	3	80	0.0375000
NODE_4206_length_1166_cov_313.815370	997	1077	35	41	80	0.5125000
NODE_4206_length_1166_cov_313.815370	997	1077	36	4	80	0.0500000
NODE_4206_length_1166_cov_313.815370	1050	1130	8	1	80	0.0125000
NODE_4206_length_1166_cov_313.815370	1050	1130	31	1	80	0.0125000
NODE_4206_length_1166_cov_313.815370	1050	1130	32	4	80	0.0500000
NODE_4206_length_1166_cov_313.815370	1050	1130	33	25	80	0.3125000
NODE_4206_length_1166_cov_313.815370	1050	1130	35	45	80	0.5625000
NODE_4206_length_1166_cov_313.815370	1050	1130	36	4	80	0.0500000
NODE_4206_length_1166_cov_313.815370	1050	1130	8	1	80	0.0125000
NODE_4206_length_1166_cov_313.815370	1050	1130	31	1	80	0.0125000
NODE_4206_length_1166_cov_313.815370	1050	1130	32	4	80	0.0500000
NODE_4206_length_1166_cov_313.815370	1050	1130	33	25	80	0.3125000
NODE_4206_length_1166_cov_313.815370	1050	1130	35	45	80	0.5625000
NODE_4206_length_1166_cov_313.815370	1050	1130	36	4	80	0.0500000
NODE_4206_length_1166_cov_313.815370	1050	1121	33	22	71	0.3098592
NODE_4206_length_1166_cov_313.815370	1050	1121	35	45	71	0.6338028
NODE_4206_length_1166_cov_313.815370	1050	1121	36	4	71	0.0563380
NODE_4207_length_1166_cov_25.107779	561	641	0	80	80	1.0000000
NODE_4207_length_1166_cov_25.107779	614	694	0	80	80	1.0000000
NODE_4209_length_1166_cov_18.820056	325	405	0	80	80	1.0000000
NODE_4209_length_1166_cov_18.820056	378	458	0	80	80	1.0000000
NODE_4210_length_1166_cov_18.404873	676	756	0	80	80	1.0000000
NODE_4210_length_1166_cov_18.404873	729	809	0	80	80	1.0000000
NODE_4214_length_1166_cov_1.893158	0	71	0	22	71	0.3098592
NODE_4214_length_1166_cov_1.893158	0	71	2	49	71	0.6901408
NODE_4214_length_1166_cov_1.893158	44	99	2	55	55	1.0000000
NODE_4218_length_1165_cov_29.402439	497	577	0	80	80	1.0000000
NODE_4218_length_1165_cov_29.402439	550	630	0	80	80	1.0000000
NODE_4218_length_1165_cov_29.402439	626	706	0	80	80	1.0000000
NODE_4218_length_1165_cov_29.402439	679	759	0	80	80	1.0000000
NODE_4219_length_1165_cov_28.366792	663	743	0	47	80	0.5875000
NODE_4219_length_1165_cov_28.366792	663	743	14	1	80	0.0125000
NODE_4219_length_1165_cov_28.366792	663	743	16	32	80	0.4000000
NODE_4219_length_1165_cov_28.366792	716	796	16	80	80	1.0000000
NODE_4220_length_1165_cov_23.841463	631	711	0	80	80	1.0000000
NODE_4220_length_1165_cov_23.841463	684	765	0	81	81	1.0000000
NODE_4220_length_1165_cov_23.841463	761	841	0	80	80	1.0000000
NODE_4220_length_1165_cov_23.841463	814	894	0	80	80	1.0000000
NODE_4221_length_1165_cov_21.883677	482	562	0	80	80	1.0000000
NODE_4221_length_1165_cov_21.883677	535	615	0	80	80	1.0000000
NODE_4222_length_1165_cov_14.591932	295	375	0	80	80	1.0000000
NODE_4222_length_1165_cov_14.591932	348	428	0	80	80	1.0000000
NODE_4223_length_1165_cov_13.683865	502	582	0	52	80	0.6500000
NODE_4223_length_1165_cov_13.683865	502	582	2	1	80	0.0125000
NODE_4223_length_1165_cov_13.683865	502	582	3	1	80	0.0125000
NODE_4223_length_1165_cov_13.683865	502	582	4	26	80	0.3250000
NODE_4223_length_1165_cov_13.683865	555	635	3	1	80	0.0125000
NODE_4223_length_1165_cov_13.683865	555	635	4	26	80	0.3250000
NODE_4223_length_1165_cov_13.683865	555	635	6	21	80	0.2625000
NODE_4223_length_1165_cov_13.683865	555	635	7	32	80	0.4000000
NODE_4224_length_1165_cov_7.915572	383	463	3	22	80	0.2750000
NODE_4224_length_1165_cov_7.915572	383	463	4	58	80	0.7250000
NODE_4224_length_1165_cov_7.915572	436	516	0	6	80	0.0750000
NODE_4224_length_1165_cov_7.915572	436	516	4	74	80	0.9250000
NODE_4225_length_1165_cov_7.466229	552	632	0	80	80	1.0000000
NODE_4225_length_1165_cov_7.466229	605	685	0	80	80	1.0000000
NODE_4226_length_1165_cov_5.617261	676	756	0	80	80	1.0000000
NODE_4226_length_1165_cov_5.617261	729	809	0	80	80	1.0000000
NODE_4227_length_1165_cov_3.658537	554	602	0	48	48	1.0000000
NODE_4233_length_1164_cov_55.273239	459	539	0	67	80	0.8375000
NODE_4233_length_1164_cov_55.273239	459	539	2	13	80	0.1625000
NODE_4233_length_1164_cov_55.273239	512	592	0	80	80	1.0000000
NODE_4234_length_1164_cov_44.183099	571	651	0	80	80	1.0000000
NODE_4234_length_1164_cov_44.183099	624	704	0	80	80	1.0000000
NODE_4234_length_1164_cov_44.183099	700	780	0	80	80	1.0000000
NODE_4234_length_1164_cov_44.183099	753	833	0	80	80	1.0000000
NODE_4235_length_1164_cov_14.277934	1029	1109	2	68	80	0.8500000
NODE_4235_length_1164_cov_14.277934	1029	1109	4	12	80	0.1500000
NODE_4235_length_1164_cov_14.277934	1097	1162	0	16	65	0.2461538
NODE_4235_length_1164_cov_14.277934	1097	1162	2	49	65	0.7538462
NODE_4236_length_1164_cov_12.880751	415	495	0	80	80	1.0000000
NODE_4236_length_1164_cov_12.880751	468	548	0	80	80	1.0000000
NODE_4237_length_1164_cov_6.924883	415	495	0	80	80	1.0000000
NODE_4237_length_1164_cov_6.924883	468	548	0	80	80	1.0000000
NODE_4245_length_1163_cov_36.315789	458	538	0	80	80	1.0000000
NODE_4245_length_1163_cov_36.315789	511	591	0	80	80	1.0000000
NODE_4245_length_1163_cov_36.315789	587	667	0	80	80	1.0000000
NODE_4245_length_1163_cov_36.315789	640	720	0	80	80	1.0000000
NODE_4246_length_1163_cov_29.466165	542	622	0	80	80	1.0000000
NODE_4246_length_1163_cov_29.466165	595	675	0	80	80	1.0000000
NODE_4246_length_1163_cov_29.466165	671	751	0	80	80	1.0000000
NODE_4246_length_1163_cov_29.466165	724	804	0	80	80	1.0000000
NODE_4247_length_1163_cov_15.107143	668	748	0	80	80	1.0000000
NODE_4247_length_1163_cov_15.107143	721	801	0	80	80	1.0000000
NODE_4248_length_1163_cov_14.347744	540	620	0	80	80	1.0000000
NODE_4248_length_1163_cov_14.347744	593	673	0	80	80	1.0000000
NODE_4249_length_1163_cov_11.650376	354	434	0	80	80	1.0000000
NODE_4249_length_1163_cov_11.650376	407	487	0	80	80	1.0000000
NODE_4249_length_1163_cov_11.650376	738	818	0	80	80	1.0000000
NODE_4249_length_1163_cov_11.650376	791	871	0	80	80	1.0000000
NODE_4253_length_1162_cov_30.049859	359	439	0	14	80	0.1750000
NODE_4253_length_1162_cov_30.049859	359	439	4	66	80	0.8250000
NODE_4253_length_1162_cov_30.049859	412	492	0	67	80	0.8375000
NODE_4253_length_1162_cov_30.049859	412	492	4	13	80	0.1625000
NODE_4254_length_1162_cov_25.960489	440	520	0	36	80	0.4500000
NODE_4254_length_1162_cov_25.960489	440	520	2	44	80	0.5500000
NODE_4254_length_1162_cov_25.960489	493	573	0	22	80	0.2750000
NODE_4254_length_1162_cov_25.960489	493	573	2	58	80	0.7250000
NODE_4254_length_1162_cov_25.960489	569	649	0	80	80	1.0000000
NODE_4254_length_1162_cov_25.960489	622	702	0	80	80	1.0000000
NODE_4255_length_1162_cov_24.843838	523	603	0	80	80	1.0000000
NODE_4255_length_1162_cov_24.843838	576	656	0	80	80	1.0000000
NODE_4255_length_1162_cov_24.843838	652	732	0	80	80	1.0000000
NODE_4255_length_1162_cov_24.843838	705	785	0	80	80	1.0000000
NODE_4257_length_1162_cov_17.131703	302	382	0	80	80	1.0000000
NODE_4257_length_1162_cov_17.131703	355	435	0	80	80	1.0000000
NODE_4257_length_1162_cov_17.131703	431	511	0	80	80	1.0000000
NODE_4257_length_1162_cov_17.131703	484	564	0	80	80	1.0000000
NODE_4258_length_1162_cov_14.766698	630	710	0	17	80	0.2125000
NODE_4258_length_1162_cov_14.766698	630	710	2	20	80	0.2500000
NODE_4258_length_1162_cov_14.766698	630	710	4	43	80	0.5375000
NODE_4258_length_1162_cov_14.766698	683	763	0	2	80	0.0250000
NODE_4258_length_1162_cov_14.766698	683	763	2	24	80	0.3000000
NODE_4258_length_1162_cov_14.766698	683	763	4	54	80	0.6750000
NODE_4259_length_1162_cov_13.968015	423	503	0	80	80	1.0000000
NODE_4259_length_1162_cov_13.968015	476	556	0	80	80	1.0000000
NODE_4264_length_1162_cov_1.977422	855	926	0	71	71	1.0000000
NODE_4264_length_1162_cov_1.977422	908	977	0	69	69	1.0000000
NODE_4264_length_1162_cov_1.977422	908	977	0	69	69	1.0000000
NODE_4266_length_1161_cov_33.312618	456	536	0	22	80	0.2750000
NODE_4266_length_1161_cov_33.312618	456	536	6	58	80	0.7250000
NODE_4266_length_1161_cov_33.312618	509	587	0	28	78	0.3589744
NODE_4266_length_1161_cov_33.312618	509	587	6	50	78	0.6410257
NODE_4267_length_1161_cov_30.466102	594	674	0	80	80	1.0000000
NODE_4267_length_1161_cov_30.466102	647	727	0	80	80	1.0000000
NODE_4268_length_1161_cov_29.628060	426	506	0	80	80	1.0000000
NODE_4268_length_1161_cov_29.628060	479	559	0	80	80	1.0000000
NODE_4268_length_1161_cov_29.628060	603	683	0	80	80	1.0000000
NODE_4268_length_1161_cov_29.628060	656	736	0	80	80	1.0000000
NODE_4269_length_1161_cov_22.923729	492	572	0	80	80	1.0000000
NODE_4269_length_1161_cov_22.923729	545	625	0	80	80	1.0000000
NODE_4269_length_1161_cov_22.923729	621	701	0	80	80	1.0000000
NODE_4269_length_1161_cov_22.923729	674	754	0	80	80	1.0000000
NODE_4270_length_1161_cov_20.184557	480	560	0	62	80	0.7750000
NODE_4270_length_1161_cov_20.184557	480	560	2	18	80	0.2250000
NODE_4270_length_1161_cov_20.184557	533	613	0	11	80	0.1375000
NODE_4270_length_1161_cov_20.184557	533	613	2	69	80	0.8625000
NODE_4271_length_1161_cov_17.437853	375	455	0	80	80	1.0000000
NODE_4271_length_1161_cov_17.437853	428	508	0	80	80	1.0000000
NODE_4272_length_1161_cov_14.062147	375	455	0	80	80	1.0000000
NODE_4272_length_1161_cov_14.062147	428	508	0	80	80	1.0000000
NODE_4273_length_1161_cov_12.304143	381	461	0	80	80	1.0000000
NODE_4273_length_1161_cov_12.304143	434	514	0	80	80	1.0000000
NODE_4274_length_1161_cov_10.297552	598	678	0	80	80	1.0000000
NODE_4274_length_1161_cov_10.297552	651	731	0	80	80	1.0000000
NODE_4283_length_1160_cov_86.515551	613	693	0	80	80	1.0000000
NODE_4283_length_1160_cov_86.515551	666	746	0	80	80	1.0000000
NODE_4284_length_1160_cov_29.272385	526	606	0	80	80	1.0000000
NODE_4284_length_1160_cov_29.272385	579	659	0	80	80	1.0000000
NODE_4285_length_1160_cov_21.391140	767	847	0	80	80	1.0000000
NODE_4296_length_1159_cov_147.794340	911	991	192	2	80	0.0250000
NODE_4296_length_1159_cov_147.794340	911	991	194	2	80	0.0250000
NODE_4296_length_1159_cov_147.794340	911	991	196	2	80	0.0250000
NODE_4296_length_1159_cov_147.794340	911	991	202	1	80	0.0125000
NODE_4296_length_1159_cov_147.794340	911	991	218	3	80	0.0375000
NODE_4296_length_1159_cov_147.794340	911	991	228	2	80	0.0250000
NODE_4296_length_1159_cov_147.794340	911	991	234	1	80	0.0125000
NODE_4296_length_1159_cov_147.794340	911	991	236	2	80	0.0250000
NODE_4296_length_1159_cov_147.794340	911	991	237	1	80	0.0125000
NODE_4296_length_1159_cov_147.794340	911	991	238	3	80	0.0375000
NODE_4296_length_1159_cov_147.794340	911	991	239	1	80	0.0125000
NODE_4296_length_1159_cov_147.794340	911	991	240	2	80	0.0250000
NODE_4296_length_1159_cov_147.794340	911	991	241	2	80	0.0250000
NODE_4296_length_1159_cov_147.794340	911	991	243	2	80	0.0250000
NODE_4296_length_1159_cov_147.794340	911	991	246	1	80	0.0125000
NODE_4296_length_1159_cov_147.794340	911	991	248	1	80	0.0125000
NODE_4296_length_1159_cov_147.794340	911	991	251	1	80	0.0125000
NODE_4296_length_1159_cov_147.794340	911	991	252	1	80	0.0125000
NODE_4296_length_1159_cov_147.794340	911	991	258	1	80	0.0125000
NODE_4296_length_1159_cov_147.794340	911	991	261	2	80	0.0250000
NODE_4296_length_1159_cov_147.794340	911	991	267	2	80	0.0250000
NODE_4296_length_1159_cov_147.794340	911	991	268	1	80	0.0125000
NODE_4296_length_1159_cov_147.794340	911	991	269	5	80	0.0625000
NODE_4296_length_1159_cov_147.794340	911	991	271	2	80	0.0250000
NODE_4296_length_1159_cov_147.794340	911	991	280	1	80	0.0125000
NODE_4296_length_1159_cov_147.794340	911	991	282	1	80	0.0125000
NODE_4296_length_1159_cov_147.794340	911	991	284	6	80	0.0750000
NODE_4296_length_1159_cov_147.794340	911	991	285	1	80	0.0125000
NODE_4296_length_1159_cov_147.794340	911	991	286	3	80	0.0375000
NODE_4296_length_1159_cov_147.794340	911	991	287	1	80	0.0125000
NODE_4296_length_1159_cov_147.794340	911	991	288	7	80	0.0875000
NODE_4296_length_1159_cov_147.794340	911	991	289	4	80	0.0500000
NODE_4296_length_1159_cov_147.794340	911	991	290	3	80	0.0375000
NODE_4296_length_1159_cov_147.794340	911	991	291	3	80	0.0375000
NODE_4296_length_1159_cov_147.794340	911	991	292	3	80	0.0375000
NODE_4296_length_1159_cov_147.794340	911	991	294	2	80	0.0250000
NODE_4296_length_1159_cov_147.794340	911	991	296	2	80	0.0250000
NODE_4296_length_1159_cov_147.794340	964	1044	151	2	80	0.0250000
NODE_4296_length_1159_cov_147.794340	964	1044	154	2	80	0.0250000
NODE_4296_length_1159_cov_147.794340	964	1044	156	1	80	0.0125000
NODE_4296_length_1159_cov_147.794340	964	1044	157	1	80	0.0125000
NODE_4296_length_1159_cov_147.794340	964	1044	158	3	80	0.0375000
NODE_4296_length_1159_cov_147.794340	964	1044	167	1	80	0.0125000
NODE_4296_length_1159_cov_147.794340	964	1044	179	2	80	0.0250000
NODE_4296_length_1159_cov_147.794340	964	1044	181	2	80	0.0250000
NODE_4296_length_1159_cov_147.794340	964	1044	183	1	80	0.0125000
NODE_4296_length_1159_cov_147.794340	964	1044	189	3	80	0.0375000
NODE_4296_length_1159_cov_147.794340	964	1044	193	3	80	0.0375000
NODE_4296_length_1159_cov_147.794340	964	1044	200	3	80	0.0375000
NODE_4296_length_1159_cov_147.794340	964	1044	206	1	80	0.0125000
NODE_4296_length_1159_cov_147.794340	964	1044	210	1	80	0.0125000
NODE_4296_length_1159_cov_147.794340	964	1044	212	1	80	0.0125000
NODE_4296_length_1159_cov_147.794340	964	1044	214	1	80	0.0125000
NODE_4296_length_1159_cov_147.794340	964	1044	232	2	80	0.0250000
NODE_4296_length_1159_cov_147.794340	964	1044	238	1	80	0.0125000
NODE_4296_length_1159_cov_147.794340	964	1044	253	1	80	0.0125000
NODE_4296_length_1159_cov_147.794340	964	1044	255	3	80	0.0375000
NODE_4296_length_1159_cov_147.794340	964	1044	269	1	80	0.0125000
NODE_4296_length_1159_cov_147.794340	964	1044	271	1	80	0.0125000
NODE_4296_length_1159_cov_147.794340	964	1044	276	1	80	0.0125000
NODE_4296_length_1159_cov_147.794340	964	1044	277	4	80	0.0500000
NODE_4296_length_1159_cov_147.794340	964	1044	284	4	80	0.0500000
NODE_4296_length_1159_cov_147.794340	964	1044	285	1	80	0.0125000
NODE_4296_length_1159_cov_147.794340	964	1044	286	2	80	0.0250000
NODE_4296_length_1159_cov_147.794340	964	1044	287	1	80	0.0125000
NODE_4296_length_1159_cov_147.794340	964	1044	288	5	80	0.0625000
NODE_4296_length_1159_cov_147.794340	964	1044	289	4	80	0.0500000
NODE_4296_length_1159_cov_147.794340	964	1044	290	4	80	0.0500000
NODE_4296_length_1159_cov_147.794340	964	1044	291	1	80	0.0125000
NODE_4296_length_1159_cov_147.794340	964	1044	292	3	80	0.0375000
NODE_4296_length_1159_cov_147.794340	964	1044	294	3	80	0.0375000
NODE_4296_length_1159_cov_147.794340	964	1044	296	4	80	0.0500000
NODE_4296_length_1159_cov_147.794340	964	1044	298	2	80	0.0250000
NODE_4296_length_1159_cov_147.794340	964	1044	300	3	80	0.0375000
NODE_4296_length_1159_cov_147.794340	964	1044	302	1	80	0.0125000
NODE_4297_length_1159_cov_57.566981	457	537	0	80	80	1.0000000
NODE_4297_length_1159_cov_57.566981	510	590	0	80	80	1.0000000
NODE_4297_length_1159_cov_57.566981	586	666	0	80	80	1.0000000
NODE_4297_length_1159_cov_57.566981	639	719	0	80	80	1.0000000
NODE_4298_length_1159_cov_44.053774	329	409	0	80	80	1.0000000
NODE_4298_length_1159_cov_44.053774	382	462	0	80	80	1.0000000
NODE_4298_length_1159_cov_44.053774	458	538	0	80	80	1.0000000
NODE_4298_length_1159_cov_44.053774	511	591	0	80	80	1.0000000
NODE_4299_length_1159_cov_40.194340	391	471	0	80	80	1.0000000
NODE_4299_length_1159_cov_40.194340	444	524	0	80	80	1.0000000
NODE_4301_length_1159_cov_25.919811	456	536	0	80	80	1.0000000
NODE_4301_length_1159_cov_25.919811	509	591	0	82	82	1.0000000
NODE_4302_length_1159_cov_18.306604	538	618	0	42	80	0.5250000
NODE_4302_length_1159_cov_18.306604	538	618	2	38	80	0.4750000
NODE_4302_length_1159_cov_18.306604	591	671	0	15	80	0.1875000
NODE_4302_length_1159_cov_18.306604	591	671	2	65	80	0.8125000
NODE_4303_length_1159_cov_14.457547	358	438	0	80	80	1.0000000
NODE_4303_length_1159_cov_14.457547	411	491	0	80	80	1.0000000
NODE_4304_length_1159_cov_11.566981	625	705	0	18	80	0.2250000
NODE_4304_length_1159_cov_11.566981	625	705	2	62	80	0.7750000
NODE_4304_length_1159_cov_11.566981	678	758	0	49	80	0.6125000
NODE_4304_length_1159_cov_11.566981	678	758	2	31	80	0.3875000
NODE_4305_length_1159_cov_9.927358	278	358	0	80	80	1.0000000
NODE_4305_length_1159_cov_9.927358	331	411	0	80	80	1.0000000
NODE_4314_length_1159_cov_1.568868	513	562	0	49	49	1.0000000
NODE_4316_length_1158_cov_33.529745	357	437	0	80	80	1.0000000
NODE_4316_length_1158_cov_33.529745	410	490	0	80	80	1.0000000
NODE_4316_length_1158_cov_33.529745	486	566	0	80	80	1.0000000
NODE_4316_length_1158_cov_33.529745	539	619	0	80	80	1.0000000
NODE_4317_length_1158_cov_31.368272	416	496	0	80	80	1.0000000
NODE_4317_length_1158_cov_31.368272	469	549	0	80	80	1.0000000
NODE_4317_length_1158_cov_31.368272	545	626	0	75	81	0.9259259
NODE_4317_length_1158_cov_31.368272	545	626	6	6	81	0.0740741
NODE_4317_length_1158_cov_31.368272	599	679	0	21	80	0.2625000
NODE_4317_length_1158_cov_31.368272	599	679	6	7	80	0.0875000
NODE_4317_length_1158_cov_31.368272	599	679	11	52	80	0.6500000
NODE_4318_length_1158_cov_31.240793	430	510	0	80	80	1.0000000
NODE_4318_length_1158_cov_31.240793	483	563	0	33	80	0.4125000
NODE_4318_length_1158_cov_31.240793	483	563	1	47	80	0.5875000
NODE_4318_length_1158_cov_31.240793	559	639	1	77	80	0.9625000
NODE_4318_length_1158_cov_31.240793	559	639	2	3	80	0.0375000
NODE_4318_length_1158_cov_31.240793	612	692	1	50	80	0.6250000
NODE_4318_length_1158_cov_31.240793	612	692	2	30	80	0.3750000
NODE_4319_length_1158_cov_29.216242	405	485	0	80	80	1.0000000
NODE_4319_length_1158_cov_29.216242	458	538	0	80	80	1.0000000
NODE_4320_length_1158_cov_25.245515	500	580	0	80	80	1.0000000
NODE_4320_length_1158_cov_25.245515	553	633	0	80	80	1.0000000
NODE_4320_length_1158_cov_25.245515	629	709	0	80	80	1.0000000
NODE_4320_length_1158_cov_25.245515	682	762	0	80	80	1.0000000
NODE_4321_length_1158_cov_16.566572	396	476	0	80	80	1.0000000
NODE_4321_length_1158_cov_16.566572	449	529	0	80	80	1.0000000
NODE_4322_length_1158_cov_13.092540	372	452	0	80	80	1.0000000
NODE_4322_length_1158_cov_13.092540	425	505	0	80	80	1.0000000
NODE_4322_length_1158_cov_13.092540	735	815	0	80	80	1.0000000
NODE_4322_length_1158_cov_13.092540	788	868	0	80	80	1.0000000
NODE_4323_length_1158_cov_7.408876	656	736	0	80	80	1.0000000
NODE_4323_length_1158_cov_7.408876	709	789	0	80	80	1.0000000
NODE_4324_length_1158_cov_6.242682	239	310	2	8	71	0.1126761
NODE_4324_length_1158_cov_6.242682	239	310	8	62	71	0.8732395
NODE_4324_length_1158_cov_6.242682	239	310	10	1	71	0.0140845
NODE_4325_length_1158_cov_6.043437	531	611	0	80	80	1.0000000
NODE_4325_length_1158_cov_6.043437	584	634	0	50	50	1.0000000
NODE_4326_length_1158_cov_5.855524	324	404	0	80	80	1.0000000
NODE_4326_length_1158_cov_5.855524	377	457	0	80	80	1.0000000
NODE_4329_length_1157_cov_32.233459	472	552	0	71	80	0.8875000
NODE_4329_length_1157_cov_32.233459	472	552	4	9	80	0.1125000
NODE_4329_length_1157_cov_32.233459	525	605	0	18	80	0.2250000
NODE_4329_length_1157_cov_32.233459	525	605	4	33	80	0.4125000
NODE_4329_length_1157_cov_32.233459	525	605	6	27	80	0.3375000
NODE_4329_length_1157_cov_32.233459	525	605	8	2	80	0.0250000
NODE_4329_length_1157_cov_32.233459	601	681	4	39	80	0.4875000
NODE_4329_length_1157_cov_32.233459	601	681	6	2	80	0.0250000
NODE_4329_length_1157_cov_32.233459	601	681	8	39	80	0.4875000
NODE_4329_length_1157_cov_32.233459	654	734	2	24	80	0.3000000
NODE_4329_length_1157_cov_32.233459	654	734	4	56	80	0.7000000
NODE_4330_length_1157_cov_6.438563	765	788	0	23	23	1.0000000
NODE_4332_length_1157_cov_4.068053	221	292	0	71	71	1.0000000
NODE_4333_length_1156_cov_46.381268	328	408	0	80	80	1.0000000
NODE_4333_length_1156_cov_46.381268	381	461	0	80	80	1.0000000
NODE_4333_length_1156_cov_46.381268	457	537	0	80	80	1.0000000
NODE_4333_length_1156_cov_46.381268	510	590	0	80	80	1.0000000
NODE_4334_length_1156_cov_32.198675	378	458	0	68	80	0.8500000
NODE_4334_length_1156_cov_32.198675	378	458	2	12	80	0.1500000
NODE_4334_length_1156_cov_32.198675	431	511	0	80	80	1.0000000
NODE_4334_length_1156_cov_32.198675	507	587	0	80	80	1.0000000
NODE_4334_length_1156_cov_32.198675	560	641	0	81	81	1.0000000
NODE_4335_length_1156_cov_12.683065	593	673	0	80	80	1.0000000
NODE_4335_length_1156_cov_12.683065	646	726	0	80	80	1.0000000
NODE_4336_length_1156_cov_9.287606	680	760	0	80	80	1.0000000
NODE_4336_length_1156_cov_9.287606	733	813	0	80	80	1.0000000
NODE_4339_length_1155_cov_19.570076	437	517	0	80	80	1.0000000
NODE_4339_length_1155_cov_19.570076	490	570	0	80	80	1.0000000
NODE_4340_length_1155_cov_18.666667	332	412	0	9	80	0.1125000
NODE_4340_length_1155_cov_18.666667	332	412	6	14	80	0.1750000
NODE_4340_length_1155_cov_18.666667	332	412	10	57	80	0.7125000
NODE_4340_length_1155_cov_18.666667	385	465	0	30	80	0.3750000
NODE_4340_length_1155_cov_18.666667	385	465	4	4	80	0.0500000
NODE_4340_length_1155_cov_18.666667	385	465	10	46	80	0.5750000
NODE_4346_length_1154_cov_61.769668	488	568	0	80	80	1.0000000
NODE_4346_length_1154_cov_61.769668	541	621	0	80	80	1.0000000
NODE_4347_length_1154_cov_50.909005	409	489	0	80	80	1.0000000
NODE_4347_length_1154_cov_50.909005	462	542	0	80	80	1.0000000
NODE_4347_length_1154_cov_50.909005	538	618	0	80	80	1.0000000
NODE_4347_length_1154_cov_50.909005	591	671	0	80	80	1.0000000
NODE_4348_length_1154_cov_28.941232	695	775	0	80	80	1.0000000
NODE_4348_length_1154_cov_28.941232	748	828	0	80	80	1.0000000
NODE_4349_length_1154_cov_13.765877	322	402	0	80	80	1.0000000
NODE_4349_length_1154_cov_13.765877	375	455	0	80	80	1.0000000
NODE_4351_length_1154_cov_5.930806	497	577	0	80	80	1.0000000
NODE_4351_length_1154_cov_5.930806	550	622	0	72	72	1.0000000
NODE_4357_length_1153_cov_65.486717	416	496	0	80	80	1.0000000
NODE_4357_length_1153_cov_65.486717	469	549	0	80	80	1.0000000
NODE_4357_length_1153_cov_65.486717	545	625	0	80	80	1.0000000
NODE_4357_length_1153_cov_65.486717	598	678	0	80	80	1.0000000
NODE_4358_length_1153_cov_50.733397	404	484	0	80	80	1.0000000
NODE_4358_length_1153_cov_50.733397	457	537	0	80	80	1.0000000
NODE_4358_length_1153_cov_50.733397	533	613	0	80	80	1.0000000
NODE_4358_length_1153_cov_50.733397	586	666	0	80	80	1.0000000
NODE_4359_length_1153_cov_26.131879	493	573	0	80	80	1.0000000
NODE_4359_length_1153_cov_26.131879	546	626	0	80	80	1.0000000
NODE_4360_length_1153_cov_10.195446	500	580	0	80	80	1.0000000
NODE_4360_length_1153_cov_10.195446	553	633	0	80	80	1.0000000
NODE_4361_length_1153_cov_8.286528	558	638	0	80	80	1.0000000
NODE_4361_length_1153_cov_8.286528	611	691	0	80	80	1.0000000
NODE_4368_length_1152_cov_19.800570	553	633	0	5	80	0.0625000
NODE_4368_length_1152_cov_19.800570	553	633	9	1	80	0.0125000
NODE_4368_length_1152_cov_19.800570	553	633	10	74	80	0.9250000
NODE_4368_length_1152_cov_19.800570	606	686	10	80	80	1.0000000
NODE_4369_length_1152_cov_19.365622	490	570	0	80	80	1.0000000
NODE_4369_length_1152_cov_19.365622	543	623	0	80	80	1.0000000
NODE_4370_length_1152_cov_18.654321	594	674	0	80	80	1.0000000
NODE_4370_length_1152_cov_18.654321	647	727	0	80	80	1.0000000
NODE_4371_length_1152_cov_18.075024	377	457	0	80	80	1.0000000
NODE_4371_length_1152_cov_18.075024	430	510	0	80	80	1.0000000
NODE_4371_length_1152_cov_18.075024	506	586	0	80	80	1.0000000
NODE_4371_length_1152_cov_18.075024	559	639	0	80	80	1.0000000
NODE_4373_length_1152_cov_16.047483	543	623	0	80	80	1.0000000
NODE_4373_length_1152_cov_16.047483	596	676	0	80	80	1.0000000
NODE_4373_length_1152_cov_16.047483	672	752	0	80	80	1.0000000
NODE_4373_length_1152_cov_16.047483	725	805	0	80	80	1.0000000
NODE_4374_length_1152_cov_13.981007	583	663	0	80	80	1.0000000
NODE_4374_length_1152_cov_13.981007	636	716	0	80	80	1.0000000
NODE_4380_length_1151_cov_30.469582	479	559	0	80	80	1.0000000
NODE_4380_length_1151_cov_30.469582	532	612	0	80	80	1.0000000
NODE_4381_length_1151_cov_26.650190	567	647	0	80	80	1.0000000
NODE_4381_length_1151_cov_26.650190	620	700	0	80	80	1.0000000
NODE_4382_length_1151_cov_26.375475	441	521	0	80	80	1.0000000
NODE_4382_length_1151_cov_26.375475	494	574	0	80	80	1.0000000
NODE_4382_length_1151_cov_26.375475	570	650	0	80	80	1.0000000
NODE_4382_length_1151_cov_26.375475	623	703	0	80	80	1.0000000
NODE_4383_length_1151_cov_23.614068	590	670	0	80	80	1.0000000
NODE_4383_length_1151_cov_23.614068	643	721	0	78	78	1.0000000
NODE_4384_length_1151_cov_18.693916	355	435	0	80	80	1.0000000
NODE_4384_length_1151_cov_18.693916	408	491	0	83	83	1.0000000
NODE_4385_length_1151_cov_16.093156	474	554	0	80	80	1.0000000
NODE_4385_length_1151_cov_16.093156	527	607	0	80	80	1.0000000
NODE_4386_length_1151_cov_13.782319	400	482	0	80	82	0.9756098
NODE_4386_length_1151_cov_13.782319	400	482	2	2	82	0.0243902
NODE_4386_length_1151_cov_13.782319	450	535	0	30	85	0.3529412
NODE_4386_length_1151_cov_13.782319	450	535	2	55	85	0.6470588
NODE_4392_length_1150_cov_38.601332	563	643	0	80	80	1.0000000
NODE_4392_length_1150_cov_38.601332	616	696	0	80	80	1.0000000
NODE_4392_length_1150_cov_38.601332	692	772	0	80	80	1.0000000
NODE_4392_length_1150_cov_38.601332	745	825	0	80	80	1.0000000
NODE_4393_length_1150_cov_15.741199	497	578	0	81	81	1.0000000
NODE_4393_length_1150_cov_15.741199	550	631	0	81	81	1.0000000
NODE_4394_length_1150_cov_11.132255	795	875	0	80	80	1.0000000
NODE_4394_length_1150_cov_11.132255	848	928	0	80	80	1.0000000
NODE_4395_length_1150_cov_9.253092	583	663	0	80	80	1.0000000
NODE_4395_length_1150_cov_9.253092	636	716	0	80	80	1.0000000
NODE_4398_length_1149_cov_17.289524	644	695	0	5	51	0.0980392
NODE_4398_length_1149_cov_17.289524	644	695	3	1	51	0.0196078
NODE_4398_length_1149_cov_17.289524	644	695	4	45	51	0.8823529
NODE_4399_length_1149_cov_13.805714	584	664	0	39	80	0.4875000
NODE_4399_length_1149_cov_13.805714	584	664	2	41	80	0.5125000
NODE_4399_length_1149_cov_13.805714	637	717	0	80	80	1.0000000
NODE_4399_length_1149_cov_13.805714	713	793	0	80	80	1.0000000
NODE_4399_length_1149_cov_13.805714	766	846	0	80	80	1.0000000
NODE_4407_length_1148_cov_27.674929	387	467	0	80	80	1.0000000
NODE_4407_length_1148_cov_27.674929	440	520	0	80	80	1.0000000
NODE_4408_length_1148_cov_13.275500	136	216	0	31	80	0.3875000
NODE_4408_length_1148_cov_13.275500	136	216	2	21	80	0.2625000
NODE_4408_length_1148_cov_13.275500	136	216	4	28	80	0.3500000
NODE_4408_length_1148_cov_13.275500	189	268	4	79	79	1.0000000
NODE_4409_length_1148_cov_10.613918	506	586	0	80	80	1.0000000
NODE_4409_length_1148_cov_10.613918	559	639	0	80	80	1.0000000
NODE_4415_length_1147_cov_33.543893	378	458	0	80	80	1.0000000
NODE_4415_length_1147_cov_33.543893	431	511	0	42	80	0.5250000
NODE_4415_length_1147_cov_33.543893	431	511	4	38	80	0.4750000
NODE_4416_length_1147_cov_26.858779	254	334	0	80	80	1.0000000
NODE_4416_length_1147_cov_26.858779	307	387	0	80	80	1.0000000
NODE_4416_length_1147_cov_26.858779	383	463	0	80	80	1.0000000
NODE_4416_length_1147_cov_26.858779	436	516	0	80	80	1.0000000
NODE_4417_length_1147_cov_24.227099	606	686	0	13	80	0.1625000
NODE_4417_length_1147_cov_24.227099	606	686	4	67	80	0.8375000
NODE_4417_length_1147_cov_24.227099	659	739	4	80	80	1.0000000
NODE_4417_length_1147_cov_24.227099	735	815	0	74	80	0.9250000
NODE_4417_length_1147_cov_24.227099	735	815	4	6	80	0.0750000
NODE_4417_length_1147_cov_24.227099	788	868	0	80	80	1.0000000
NODE_4418_length_1147_cov_16.559160	417	497	0	80	80	1.0000000
NODE_4418_length_1147_cov_16.559160	470	550	0	80	80	1.0000000
NODE_4428_length_1146_cov_52.393505	411	491	0	80	80	1.0000000
NODE_4428_length_1146_cov_52.393505	464	544	0	80	80	1.0000000
NODE_4428_length_1146_cov_52.393505	540	620	0	80	80	1.0000000
NODE_4428_length_1146_cov_52.393505	593	673	0	80	80	1.0000000
NODE_4429_length_1146_cov_46.364852	233	313	0	65	80	0.8125000
NODE_4429_length_1146_cov_46.364852	233	313	2	15	80	0.1875000
NODE_4429_length_1146_cov_46.364852	286	366	0	12	80	0.1500000
NODE_4429_length_1146_cov_46.364852	286	366	2	68	80	0.8500000
NODE_4430_length_1146_cov_26.159503	476	556	0	80	80	1.0000000
NODE_4430_length_1146_cov_26.159503	529	609	0	80	80	1.0000000
NODE_4430_length_1146_cov_26.159503	605	685	0	80	80	1.0000000
NODE_4430_length_1146_cov_26.159503	658	738	0	80	80	1.0000000
NODE_4431_length_1146_cov_14.210124	343	423	0	80	80	1.0000000
NODE_4431_length_1146_cov_14.210124	396	476	0	37	80	0.4625000
NODE_4431_length_1146_cov_14.210124	396	476	2	43	80	0.5375000
NODE_4432_length_1146_cov_13.479465	425	501	0	76	76	1.0000000
NODE_4432_length_1146_cov_13.479465	505	565	0	60	60	1.0000000
NODE_4432_length_1146_cov_13.479465	561	641	0	80	80	1.0000000
NODE_4432_length_1146_cov_13.479465	614	694	0	80	80	1.0000000
NODE_4438_length_1145_cov_49.566922	395	470	0	75	75	1.0000000
NODE_4438_length_1145_cov_49.566922	443	523	0	80	80	1.0000000
NODE_4439_length_1145_cov_38.191205	497	576	0	79	79	1.0000000
NODE_4439_length_1145_cov_38.191205	549	629	0	80	80	1.0000000
NODE_4440_length_1145_cov_26.929254	468	548	0	80	80	1.0000000
NODE_4440_length_1145_cov_26.929254	521	601	0	80	80	1.0000000
NODE_4441_length_1145_cov_20.121415	508	588	0	80	80	1.0000000
NODE_4441_length_1145_cov_20.121415	561	641	0	80	80	1.0000000
NODE_4442_length_1145_cov_11.753346	527	605	0	78	78	1.0000000
NODE_4442_length_1145_cov_11.753346	578	659	0	81	81	1.0000000
NODE_4443_length_1145_cov_9.571702	93	173	0	80	80	1.0000000
NODE_4443_length_1145_cov_9.571702	146	226	0	30	80	0.3750000
NODE_4443_length_1145_cov_9.571702	146	226	2	50	80	0.6250000
NODE_4455_length_1143_cov_42.255747	380	460	0	41	80	0.5125000
NODE_4455_length_1143_cov_42.255747	380	460	2	39	80	0.4875000
NODE_4455_length_1143_cov_42.255747	433	513	0	8	80	0.1000000
NODE_4455_length_1143_cov_42.255747	433	513	2	72	80	0.9000000
NODE_4455_length_1143_cov_42.255747	509	589	0	80	80	1.0000000
NODE_4455_length_1143_cov_42.255747	562	642	0	80	80	1.0000000
NODE_4456_length_1143_cov_22.076628	526	606	2	29	80	0.3625000
NODE_4456_length_1143_cov_22.076628	526	606	3	32	80	0.4000000
NODE_4456_length_1143_cov_22.076628	526	606	4	19	80	0.2375000
NODE_4456_length_1143_cov_22.076628	579	659	3	51	80	0.6375000
NODE_4456_length_1143_cov_22.076628	579	659	4	29	80	0.3625000
NODE_4457_length_1143_cov_19.106322	565	645	0	80	80	1.0000000
NODE_4457_length_1143_cov_19.106322	618	698	0	80	80	1.0000000
NODE_4458_length_1143_cov_16.223180	638	719	0	65	81	0.8024691
NODE_4458_length_1143_cov_16.223180	638	719	1	1	81	0.0123457
NODE_4458_length_1143_cov_16.223180	638	719	2	15	81	0.1851852
NODE_4458_length_1143_cov_16.223180	692	772	0	80	80	1.0000000
NODE_4459_length_1143_cov_13.961686	634	714	0	43	80	0.5375000
NODE_4459_length_1143_cov_13.961686	634	714	2	37	80	0.4625000
NODE_4459_length_1143_cov_13.961686	687	767	0	80	80	1.0000000
NODE_4459_length_1143_cov_13.961686	763	843	0	80	80	1.0000000
NODE_4459_length_1143_cov_13.961686	816	896	0	80	80	1.0000000
NODE_4460_length_1143_cov_12.782567	328	409	0	81	81	1.0000000
NODE_4460_length_1143_cov_12.782567	381	462	0	81	81	1.0000000
NODE_4460_length_1143_cov_12.782567	458	538	0	66	80	0.8250000
NODE_4460_length_1143_cov_12.782567	458	538	2	14	80	0.1750000
NODE_4460_length_1143_cov_12.782567	511	591	0	13	80	0.1625000
NODE_4460_length_1143_cov_12.782567	511	591	2	67	80	0.8375000
NODE_4461_length_1143_cov_8.287356	692	772	0	80	80	1.0000000
NODE_4461_length_1143_cov_8.287356	745	825	0	80	80	1.0000000
NODE_4463_length_1143_cov_2.197318	988	1057	2	16	69	0.2318841
NODE_4463_length_1143_cov_2.197318	988	1057	3	2	69	0.0289855
NODE_4463_length_1143_cov_2.197318	988	1057	4	51	69	0.7391304
NODE_4466_length_1142_cov_28.364334	613	693	0	15	80	0.1875000
NODE_4466_length_1142_cov_28.364334	613	693	2	65	80	0.8125000
NODE_4466_length_1142_cov_28.364334	666	746	0	68	80	0.8500000
NODE_4466_length_1142_cov_28.364334	666	746	2	12	80	0.1500000
NODE_4467_length_1142_cov_21.669223	518	598	0	80	80	1.0000000
NODE_4467_length_1142_cov_21.669223	571	651	0	80	80	1.0000000
NODE_4468_length_1142_cov_19.007670	411	491	0	54	80	0.6750000
NODE_4468_length_1142_cov_19.007670	411	491	6	26	80	0.3250000
NODE_4468_length_1142_cov_19.007670	464	544	0	1	80	0.0125000
NODE_4468_length_1142_cov_19.007670	464	544	6	79	80	0.9875000
NODE_4474_length_1141_cov_12.500960	17	97	0	80	80	1.0000000
NODE_4474_length_1141_cov_12.500960	17	97	0	80	80	1.0000000
NODE_4474_length_1141_cov_12.500960	17	97	0	80	80	1.0000000
NODE_4474_length_1141_cov_12.500960	17	97	0	80	80	1.0000000
NODE_4474_length_1141_cov_12.500960	70	132	0	62	62	1.0000000
NODE_4474_length_1141_cov_12.500960	70	132	0	62	62	1.0000000
NODE_4474_length_1141_cov_12.500960	70	132	0	62	62	1.0000000
NODE_4474_length_1141_cov_12.500960	70	132	0	62	62	1.0000000
NODE_4475_length_1141_cov_7.197697	54	134	1	50	80	0.6250000
NODE_4475_length_1141_cov_7.197697	54	134	2	30	80	0.3750000
NODE_4475_length_1141_cov_7.197697	107	187	2	80	80	1.0000000
NODE_4475_length_1141_cov_7.197697	573	653	0	80	80	1.0000000
NODE_4475_length_1141_cov_7.197697	626	707	0	81	81	1.0000000
NODE_4476_length_1141_cov_5.428023	411	491	0	80	80	1.0000000
NODE_4476_length_1141_cov_5.428023	464	544	0	80	80	1.0000000
NODE_4482_length_1140_cov_39.383285	451	531	0	80	80	1.0000000
NODE_4482_length_1140_cov_39.383285	504	584	0	80	80	1.0000000
NODE_4482_length_1140_cov_39.383285	580	660	0	42	80	0.5250000
NODE_4482_length_1140_cov_39.383285	580	660	4	38	80	0.4750000
NODE_4482_length_1140_cov_39.383285	633	713	0	18	80	0.2250000
NODE_4482_length_1140_cov_39.383285	633	713	4	62	80	0.7750000
NODE_4483_length_1140_cov_19.493756	543	623	8	80	80	1.0000000
NODE_4483_length_1140_cov_19.493756	596	676	0	9	80	0.1125000
NODE_4483_length_1140_cov_19.493756	596	676	8	71	80	0.8875000
NODE_4484_length_1140_cov_18.341018	347	427	0	80	80	1.0000000
NODE_4484_length_1140_cov_18.341018	400	480	0	80	80	1.0000000
NODE_4484_length_1140_cov_18.341018	476	556	0	47	80	0.5875000
NODE_4484_length_1140_cov_18.341018	476	556	5	1	80	0.0125000
NODE_4484_length_1140_cov_18.341018	476	556	6	32	80	0.4000000
NODE_4484_length_1140_cov_18.341018	529	609	6	80	80	1.0000000
NODE_4494_length_1139_cov_26.812500	410	490	0	11	80	0.1375000
NODE_4494_length_1139_cov_26.812500	410	490	2	69	80	0.8625000
NODE_4494_length_1139_cov_26.812500	463	543	0	64	80	0.8000000
NODE_4494_length_1139_cov_26.812500	463	543	2	16	80	0.2000000
NODE_4494_length_1139_cov_26.812500	539	619	0	74	80	0.9250000
NODE_4494_length_1139_cov_26.812500	539	619	2	6	80	0.0750000
NODE_4494_length_1139_cov_26.812500	592	672	0	21	80	0.2625000
NODE_4494_length_1139_cov_26.812500	592	672	2	59	80	0.7375000
NODE_4495_length_1139_cov_26.323077	308	388	0	52	80	0.6500000
NODE_4495_length_1139_cov_26.323077	308	388	2	28	80	0.3500000
NODE_4495_length_1139_cov_26.323077	361	441	0	80	80	1.0000000
NODE_4495_length_1139_cov_26.323077	437	517	0	80	80	1.0000000
NODE_4495_length_1139_cov_26.323077	490	570	0	80	80	1.0000000
NODE_4496_length_1139_cov_15.223077	530	610	0	80	80	1.0000000
NODE_4496_length_1139_cov_15.223077	583	663	0	80	80	1.0000000
NODE_4505_length_1138_cov_74.599615	480	560	0	80	80	1.0000000
NODE_4505_length_1138_cov_74.599615	533	613	0	73	80	0.9125000
NODE_4505_length_1138_cov_74.599615	533	613	1	7	80	0.0875000
NODE_4505_length_1138_cov_74.599615	609	689	1	27	80	0.3375000
NODE_4505_length_1138_cov_74.599615	609	689	2	53	80	0.6625000
NODE_4505_length_1138_cov_74.599615	662	742	2	80	80	1.0000000
NODE_4506_length_1138_cov_29.407122	559	639	2	80	80	1.0000000
NODE_4506_length_1138_cov_29.407122	612	692	0	17	80	0.2125000
NODE_4506_length_1138_cov_29.407122	612	692	2	63	80	0.7875000
NODE_4506_length_1138_cov_29.407122	688	768	0	80	80	1.0000000
NODE_4506_length_1138_cov_29.407122	741	821	0	80	80	1.0000000
NODE_4507_length_1138_cov_18.326275	454	534	0	80	80	1.0000000
NODE_4507_length_1138_cov_18.326275	507	587	0	80	80	1.0000000
NODE_4507_length_1138_cov_18.326275	583	663	0	80	80	1.0000000
NODE_4507_length_1138_cov_18.326275	636	716	0	80	80	1.0000000
NODE_4509_length_1138_cov_11.834456	291	371	0	80	80	1.0000000
NODE_4509_length_1138_cov_11.834456	344	424	0	80	80	1.0000000
NODE_4510_length_1138_cov_10.923003	318	398	0	80	80	1.0000000
NODE_4510_length_1138_cov_10.923003	371	451	0	80	80	1.0000000
NODE_4517_length_1137_cov_23.983622	470	550	0	80	80	1.0000000
NODE_4517_length_1137_cov_23.983622	523	603	0	46	80	0.5750000
NODE_4517_length_1137_cov_23.983622	523	603	2	34	80	0.4250000
NODE_4517_length_1137_cov_23.983622	599	679	2	80	80	1.0000000
NODE_4517_length_1137_cov_23.983622	652	732	0	30	80	0.3750000
NODE_4517_length_1137_cov_23.983622	652	732	2	50	80	0.6250000
NODE_4518_length_1137_cov_22.877649	405	485	0	80	80	1.0000000
NODE_4518_length_1137_cov_22.877649	458	538	0	80	80	1.0000000
NODE_4518_length_1137_cov_22.877649	534	614	0	80	80	1.0000000
NODE_4518_length_1137_cov_22.877649	587	667	0	80	80	1.0000000
NODE_4519_length_1137_cov_21.570328	383	463	0	80	80	1.0000000
NODE_4519_length_1137_cov_21.570328	436	516	0	80	80	1.0000000
NODE_4520_length_1137_cov_18.560694	665	745	0	80	80	1.0000000
NODE_4520_length_1137_cov_18.560694	718	798	0	80	80	1.0000000
NODE_4521_length_1137_cov_18.505780	557	637	0	80	80	1.0000000
NODE_4521_length_1137_cov_18.505780	610	690	0	80	80	1.0000000
NODE_4521_length_1137_cov_18.505780	686	766	0	80	80	1.0000000
NODE_4521_length_1137_cov_18.505780	739	819	0	80	80	1.0000000
NODE_4523_length_1137_cov_11.866089	313	393	0	80	80	1.0000000
NODE_4523_length_1137_cov_11.866089	366	446	0	80	80	1.0000000
NODE_4523_length_1137_cov_11.866089	442	522	0	16	80	0.2000000
NODE_4523_length_1137_cov_11.866089	442	522	8	64	80	0.8000000
NODE_4523_length_1137_cov_11.866089	495	575	0	36	80	0.4500000
NODE_4523_length_1137_cov_11.866089	495	575	8	44	80	0.5500000
NODE_4524_length_1137_cov_5.594412	144	224	0	80	80	1.0000000
NODE_4524_length_1137_cov_5.594412	197	277	0	80	80	1.0000000
NODE_4532_length_1136_cov_42.827387	445	525	0	80	80	1.0000000
NODE_4532_length_1136_cov_42.827387	498	578	0	80	80	1.0000000
NODE_4532_length_1136_cov_42.827387	574	654	0	80	80	1.0000000
NODE_4532_length_1136_cov_42.827387	627	707	0	80	80	1.0000000
NODE_4533_length_1136_cov_30.940212	534	614	0	80	80	1.0000000
NODE_4533_length_1136_cov_30.940212	587	667	0	80	80	1.0000000
NODE_4533_length_1136_cov_30.940212	663	743	0	80	80	1.0000000
NODE_4533_length_1136_cov_30.940212	716	796	0	80	80	1.0000000
NODE_4534_length_1136_cov_30.797493	557	637	0	80	80	1.0000000
NODE_4534_length_1136_cov_30.797493	610	691	0	81	81	1.0000000
NODE_4534_length_1136_cov_30.797493	687	767	0	80	80	1.0000000
NODE_4534_length_1136_cov_30.797493	740	820	0	80	80	1.0000000
NODE_4535_length_1136_cov_23.142719	704	784	0	80	80	1.0000000
NODE_4535_length_1136_cov_23.142719	757	837	0	80	80	1.0000000
NODE_4536_length_1136_cov_21.798457	570	651	0	81	81	1.0000000
NODE_4536_length_1136_cov_21.798457	624	704	0	80	80	1.0000000
NODE_4537_length_1136_cov_21.109932	460	532	0	70	72	0.9722222
NODE_4537_length_1136_cov_21.109932	460	532	4	2	72	0.0277778
NODE_4537_length_1136_cov_21.109932	505	585	0	25	80	0.3125000
NODE_4537_length_1136_cov_21.109932	505	585	4	32	80	0.4000000
NODE_4537_length_1136_cov_21.109932	505	585	8	23	80	0.2875000
NODE_4538_length_1136_cov_20.528447	19	99	11	1	80	0.0125000
NODE_4538_length_1136_cov_20.528447	19	99	12	4	80	0.0500000
NODE_4538_length_1136_cov_20.528447	19	99	18	5	80	0.0625000
NODE_4538_length_1136_cov_20.528447	19	99	20	21	80	0.2625000
NODE_4538_length_1136_cov_20.528447	19	99	21	1	80	0.0125000
NODE_4538_length_1136_cov_20.528447	19	99	23	4	80	0.0500000
NODE_4538_length_1136_cov_20.528447	19	99	25	5	80	0.0625000
NODE_4538_length_1136_cov_20.528447	19	99	26	16	80	0.2000000
NODE_4538_length_1136_cov_20.528447	19	99	27	23	80	0.2875000
NODE_4538_length_1136_cov_20.528447	19	99	11	1	80	0.0125000
NODE_4538_length_1136_cov_20.528447	19	99	12	4	80	0.0500000
NODE_4538_length_1136_cov_20.528447	19	99	18	5	80	0.0625000
NODE_4538_length_1136_cov_20.528447	19	99	20	21	80	0.2625000
NODE_4538_length_1136_cov_20.528447	19	99	21	1	80	0.0125000
NODE_4538_length_1136_cov_20.528447	19	99	23	4	80	0.0500000
NODE_4538_length_1136_cov_20.528447	19	99	25	5	80	0.0625000
NODE_4538_length_1136_cov_20.528447	19	99	26	16	80	0.2000000
NODE_4538_length_1136_cov_20.528447	19	99	27	23	80	0.2875000
NODE_4538_length_1136_cov_20.528447	28	99	18	1	71	0.0140845
NODE_4538_length_1136_cov_20.528447	28	99	20	21	71	0.2957746
NODE_4538_length_1136_cov_20.528447	28	99	21	1	71	0.0140845
NODE_4538_length_1136_cov_20.528447	28	99	23	4	71	0.0563380
NODE_4538_length_1136_cov_20.528447	28	99	25	5	71	0.0704225
NODE_4538_length_1136_cov_20.528447	28	99	26	16	71	0.2253521
NODE_4538_length_1136_cov_20.528447	28	99	27	23	71	0.3239437
NODE_4538_length_1136_cov_20.528447	877	912	0	35	35	1.0000000
NODE_4538_length_1136_cov_20.528447	879	921	0	42	42	1.0000000
NODE_4539_length_1136_cov_14.921890	657	737	0	80	80	1.0000000
NODE_4539_length_1136_cov_14.921890	710	790	0	80	80	1.0000000
NODE_4556_length_1135_cov_100.121622	454	534	0	72	80	0.9000000
NODE_4556_length_1135_cov_100.121622	454	534	2	8	80	0.1000000
NODE_4556_length_1135_cov_100.121622	507	587	0	80	80	1.0000000
NODE_4556_length_1135_cov_100.121622	583	663	0	80	80	1.0000000
NODE_4556_length_1135_cov_100.121622	636	719	0	83	83	1.0000000
NODE_4557_length_1135_cov_34.523166	313	393	0	80	80	1.0000000
NODE_4557_length_1135_cov_34.523166	366	446	0	80	80	1.0000000
NODE_4558_length_1135_cov_20.735521	484	564	0	80	80	1.0000000
NODE_4558_length_1135_cov_20.735521	537	617	0	80	80	1.0000000
NODE_4558_length_1135_cov_20.735521	613	693	0	80	80	1.0000000
NODE_4558_length_1135_cov_20.735521	666	746	0	80	80	1.0000000
NODE_4559_length_1135_cov_9.644788	620	700	0	80	80	1.0000000
NODE_4559_length_1135_cov_9.644788	673	753	0	80	80	1.0000000
NODE_4562_length_1135_cov_2.990347	349	429	2	80	80	1.0000000
NODE_4562_length_1135_cov_2.990347	402	482	2	80	80	1.0000000
NODE_4571_length_1134_cov_34.784541	478	558	0	80	80	1.0000000
NODE_4571_length_1134_cov_34.784541	531	611	0	80	80	1.0000000
NODE_4571_length_1134_cov_34.784541	607	687	0	80	80	1.0000000
NODE_4571_length_1134_cov_34.784541	660	740	0	80	80	1.0000000
NODE_4572_length_1134_cov_28.524638	511	591	0	80	80	1.0000000
NODE_4572_length_1134_cov_28.524638	564	644	0	80	80	1.0000000
NODE_4572_length_1134_cov_28.524638	640	720	0	75	80	0.9375000
NODE_4572_length_1134_cov_28.524638	640	720	6	5	80	0.0625000
NODE_4572_length_1134_cov_28.524638	693	773	0	22	80	0.2750000
NODE_4572_length_1134_cov_28.524638	693	773	6	58	80	0.7250000
NODE_4576_length_1134_cov_2.619324	606	686	0	24	80	0.3000000
NODE_4576_length_1134_cov_2.619324	606	686	2	56	80	0.7000000
NODE_4576_length_1134_cov_2.619324	659	739	2	80	80	1.0000000
NODE_4584_length_1133_cov_5.563830	292	372	0	80	80	1.0000000
NODE_4584_length_1133_cov_5.563830	345	425	0	80	80	1.0000000
NODE_4584_length_1133_cov_5.563830	904	966	2	4	62	0.0645161
NODE_4584_length_1133_cov_5.563830	904	966	4	58	62	0.9354839
NODE_4592_length_1132_cov_23.121007	485	565	0	80	80	1.0000000
NODE_4592_length_1132_cov_23.121007	538	618	0	80	80	1.0000000
NODE_4592_length_1132_cov_23.121007	618	664	0	46	46	1.0000000
NODE_4592_length_1132_cov_23.121007	700	751	0	51	51	1.0000000
NODE_4593_length_1132_cov_19.377541	595	675	2	56	80	0.7000000
NODE_4593_length_1132_cov_19.377541	595	675	10	24	80	0.3000000
NODE_4593_length_1132_cov_19.377541	648	728	2	3	80	0.0375000
NODE_4593_length_1132_cov_19.377541	648	728	9	3	80	0.0375000
NODE_4593_length_1132_cov_19.377541	648	728	10	74	80	0.9250000
NODE_4594_length_1132_cov_18.872217	363	443	0	80	80	1.0000000
NODE_4594_length_1132_cov_18.872217	416	496	0	80	80	1.0000000
NODE_4595_length_1132_cov_11.242982	474	554	6	24	80	0.3000000
NODE_4595_length_1132_cov_11.242982	474	554	12	56	80	0.7000000
NODE_4595_length_1132_cov_11.242982	527	607	6	1	80	0.0125000
NODE_4595_length_1132_cov_11.242982	527	607	12	79	80	0.9875000
NODE_4596_length_1132_cov_7.356244	354	434	0	80	80	1.0000000
NODE_4596_length_1132_cov_7.356244	407	487	0	80	80	1.0000000
NODE_4597_length_1132_cov_6.214908	269	349	0	80	80	1.0000000
NODE_4597_length_1132_cov_6.214908	322	402	0	80	80	1.0000000
NODE_4606_length_1131_cov_36.161822	478	558	0	80	80	1.0000000
NODE_4606_length_1131_cov_36.161822	531	611	0	80	80	1.0000000
NODE_4606_length_1131_cov_36.161822	607	687	0	80	80	1.0000000
NODE_4606_length_1131_cov_36.161822	660	740	0	40	80	0.5000000
NODE_4606_length_1131_cov_36.161822	660	740	2	40	80	0.5000000
NODE_4607_length_1131_cov_31.907946	390	470	0	80	80	1.0000000
NODE_4607_length_1131_cov_31.907946	443	523	0	80	80	1.0000000
NODE_4607_length_1131_cov_31.907946	519	599	0	80	80	1.0000000
NODE_4607_length_1131_cov_31.907946	572	652	0	80	80	1.0000000
NODE_4608_length_1131_cov_26.827519	464	544	0	80	80	1.0000000
NODE_4608_length_1131_cov_26.827519	517	597	0	80	80	1.0000000
NODE_4609_length_1131_cov_20.441860	555	635	0	80	80	1.0000000
NODE_4609_length_1131_cov_20.441860	608	688	0	80	80	1.0000000
NODE_4610_length_1131_cov_12.517442	420	500	0	80	80	1.0000000
NODE_4610_length_1131_cov_12.517442	473	553	0	80	80	1.0000000
NODE_4611_length_1131_cov_10.912791	429	509	0	13	80	0.1625000
NODE_4611_length_1131_cov_10.912791	429	509	4	67	80	0.8375000
NODE_4611_length_1131_cov_10.912791	482	562	0	47	80	0.5875000
NODE_4611_length_1131_cov_10.912791	482	562	4	33	80	0.4125000
NODE_4620_length_1130_cov_43.354995	742	822	2	20	80	0.2500000
NODE_4620_length_1130_cov_43.354995	742	822	10	1	80	0.0125000
NODE_4620_length_1130_cov_43.354995	742	822	11	59	80	0.7375000
NODE_4620_length_1130_cov_43.354995	795	875	9	48	80	0.6000000
NODE_4620_length_1130_cov_43.354995	795	875	10	6	80	0.0750000
NODE_4620_length_1130_cov_43.354995	795	875	11	26	80	0.3250000
NODE_4621_length_1130_cov_13.097963	642	722	1	80	80	1.0000000
NODE_4621_length_1130_cov_13.097963	695	775	1	67	80	0.8375000
NODE_4621_length_1130_cov_13.097963	695	775	2	13	80	0.1625000
NODE_4626_length_1129_cov_31.088350	396	476	0	80	80	1.0000000
NODE_4626_length_1129_cov_31.088350	449	529	0	80	80	1.0000000
NODE_4627_length_1129_cov_20.591262	450	530	0	80	80	1.0000000
NODE_4627_length_1129_cov_20.591262	503	583	0	80	80	1.0000000
NODE_4628_length_1129_cov_16.934951	261	341	0	10	80	0.1250000
NODE_4628_length_1129_cov_16.934951	261	341	8	22	80	0.2750000
NODE_4628_length_1129_cov_16.934951	261	341	9	48	80	0.6000000
NODE_4628_length_1129_cov_16.934951	314	394	9	50	80	0.6250000
NODE_4628_length_1129_cov_16.934951	314	394	11	30	80	0.3750000
NODE_4629_length_1129_cov_9.441748	665	738	0	73	73	1.0000000
NODE_4629_length_1129_cov_9.441748	711	791	0	80	80	1.0000000
NODE_4630_length_1129_cov_9.260194	658	738	0	80	80	1.0000000
NODE_4630_length_1129_cov_9.260194	711	791	0	80	80	1.0000000
NODE_4631_length_1129_cov_5.055340	759	839	13	37	80	0.4625000
NODE_4631_length_1129_cov_5.055340	759	839	15	34	80	0.4250000
NODE_4631_length_1129_cov_5.055340	759	839	17	9	80	0.1125000
NODE_4638_length_1128_cov_48.099125	588	668	2	80	80	1.0000000
NODE_4638_length_1128_cov_48.099125	641	721	0	31	80	0.3875000
NODE_4638_length_1128_cov_48.099125	641	721	2	49	80	0.6125000
NODE_4640_length_1128_cov_26.230321	455	535	0	80	80	1.0000000
NODE_4640_length_1128_cov_26.230321	508	588	0	80	80	1.0000000
NODE_4640_length_1128_cov_26.230321	584	664	0	80	80	1.0000000
NODE_4640_length_1128_cov_26.230321	637	718	0	28	81	0.3456790
NODE_4640_length_1128_cov_26.230321	637	718	2	53	81	0.6543210
NODE_4641_length_1128_cov_26.031098	594	674	0	80	80	1.0000000
NODE_4641_length_1128_cov_26.031098	647	727	0	80	80	1.0000000
NODE_4642_length_1128_cov_25.869776	465	538	0	73	73	1.0000000
NODE_4642_length_1128_cov_25.869776	601	674	0	73	73	1.0000000
NODE_4642_length_1128_cov_25.869776	647	723	0	71	76	0.9342105
NODE_4642_length_1128_cov_25.869776	647	723	2	5	76	0.0657895
NODE_4643_length_1128_cov_24.185617	350	430	0	47	80	0.5875000
NODE_4643_length_1128_cov_24.185617	350	430	2	33	80	0.4125000
NODE_4643_length_1128_cov_24.185617	403	483	0	31	80	0.3875000
NODE_4643_length_1128_cov_24.185617	403	483	2	49	80	0.6125000
NODE_4644_length_1128_cov_18.537415	335	415	0	80	80	1.0000000
NODE_4644_length_1128_cov_18.537415	388	468	0	80	80	1.0000000
NODE_4645_length_1128_cov_9.345967	690	770	0	80	80	1.0000000
NODE_4645_length_1128_cov_9.345967	743	823	0	80	80	1.0000000
NODE_4647_length_1128_cov_3.920311	675	725	0	50	50	1.0000000
NODE_4647_length_1128_cov_3.920311	698	778	0	80	80	1.0000000
NODE_4648_length_1128_cov_3.631681	613	693	0	80	80	1.0000000
NODE_4648_length_1128_cov_3.631681	666	746	0	80	80	1.0000000
NODE_4650_length_1128_cov_3.091351	519	599	0	80	80	1.0000000
NODE_4650_length_1128_cov_3.091351	572	652	0	80	80	1.0000000
NODE_4660_length_1127_cov_38.932879	405	485	0	80	80	1.0000000
NODE_4660_length_1127_cov_38.932879	458	538	0	80	80	1.0000000
NODE_4660_length_1127_cov_38.932879	534	614	0	80	80	1.0000000
NODE_4660_length_1127_cov_38.932879	587	667	0	80	80	1.0000000
NODE_4661_length_1127_cov_37.721790	236	316	0	80	80	1.0000000
NODE_4661_length_1127_cov_37.721790	289	369	0	80	80	1.0000000
NODE_4661_length_1127_cov_37.721790	365	445	0	80	80	1.0000000
NODE_4661_length_1127_cov_37.721790	418	498	0	80	80	1.0000000
NODE_4662_length_1127_cov_31.866732	444	523	0	79	79	1.0000000
NODE_4662_length_1127_cov_31.866732	496	576	0	80	80	1.0000000
NODE_4662_length_1127_cov_31.866732	572	652	0	80	80	1.0000000
NODE_4662_length_1127_cov_31.866732	625	705	0	80	80	1.0000000
NODE_4663_length_1127_cov_25.616732	430	510	1	53	80	0.6625000
NODE_4663_length_1127_cov_25.616732	430	510	2	27	80	0.3375000
NODE_4663_length_1127_cov_25.616732	483	563	2	80	80	1.0000000
NODE_4664_length_1127_cov_21.838521	338	418	0	80	80	1.0000000
NODE_4664_length_1127_cov_21.838521	391	471	0	80	80	1.0000000
NODE_4664_length_1127_cov_21.838521	467	547	0	80	80	1.0000000
NODE_4664_length_1127_cov_21.838521	520	600	0	80	80	1.0000000
NODE_4665_length_1127_cov_15.024319	711	800	0	89	89	1.0000000
NODE_4665_length_1127_cov_15.024319	773	853	0	80	80	1.0000000
NODE_4667_length_1127_cov_4.786965	386	466	8	80	80	1.0000000
NODE_4667_length_1127_cov_4.786965	439	519	0	16	80	0.2000000
NODE_4667_length_1127_cov_4.786965	439	519	8	64	80	0.8000000
NODE_4672_length_1126_cov_51.699124	448	528	0	65	80	0.8125000
NODE_4672_length_1126_cov_51.699124	448	528	4	15	80	0.1875000
NODE_4672_length_1126_cov_51.699124	501	581	0	12	80	0.1500000
NODE_4672_length_1126_cov_51.699124	501	581	4	68	80	0.8500000
NODE_4673_length_1126_cov_38.135346	427	507	0	80	80	1.0000000
NODE_4673_length_1126_cov_38.135346	480	560	0	80	80	1.0000000
NODE_4673_length_1126_cov_38.135346	556	638	0	82	82	1.0000000
NODE_4673_length_1126_cov_38.135346	611	691	0	31	80	0.3875000
NODE_4673_length_1126_cov_38.135346	611	691	4	49	80	0.6125000
NODE_4674_length_1126_cov_34.637780	23	97	18	11	74	0.1486486
NODE_4674_length_1126_cov_34.637780	23	97	22	1	74	0.0135135
NODE_4674_length_1126_cov_34.637780	23	97	26	4	74	0.0540541
NODE_4674_length_1126_cov_34.637780	23	97	27	1	74	0.0135135
NODE_4674_length_1126_cov_34.637780	23	97	28	5	74	0.0675676
NODE_4674_length_1126_cov_34.637780	23	97	30	1	74	0.0135135
NODE_4674_length_1126_cov_34.637780	23	97	32	10	74	0.1351351
NODE_4674_length_1126_cov_34.637780	23	97	45	1	74	0.0135135
NODE_4674_length_1126_cov_34.637780	23	97	46	5	74	0.0675676
NODE_4674_length_1126_cov_34.637780	23	97	63	8	74	0.1081081
NODE_4674_length_1126_cov_34.637780	23	97	64	1	74	0.0135135
NODE_4674_length_1126_cov_34.637780	23	97	65	16	74	0.2162162
NODE_4674_length_1126_cov_34.637780	23	97	75	10	74	0.1351351
NODE_4674_length_1126_cov_34.637780	146	226	26	5	80	0.0625000
NODE_4674_length_1126_cov_34.637780	146	226	28	5	80	0.0625000
NODE_4674_length_1126_cov_34.637780	146	226	29	1	80	0.0125000
NODE_4674_length_1126_cov_34.637780	146	226	30	10	80	0.1250000
NODE_4674_length_1126_cov_34.637780	146	226	45	1	80	0.0125000
NODE_4674_length_1126_cov_34.637780	146	226	47	9	80	0.1125000
NODE_4674_length_1126_cov_34.637780	146	226	51	1	80	0.0125000
NODE_4674_length_1126_cov_34.637780	146	226	64	4	80	0.0500000
NODE_4674_length_1126_cov_34.637780	146	226	65	1	80	0.0125000
NODE_4674_length_1126_cov_34.637780	146	226	66	2	80	0.0250000
NODE_4674_length_1126_cov_34.637780	146	226	74	1	80	0.0125000
NODE_4674_length_1126_cov_34.637780	146	226	76	4	80	0.0500000
NODE_4674_length_1126_cov_34.637780	146	226	85	3	80	0.0375000
NODE_4674_length_1126_cov_34.637780	146	226	86	1	80	0.0125000
NODE_4674_length_1126_cov_34.637780	146	226	87	4	80	0.0500000
NODE_4674_length_1126_cov_34.637780	146	226	88	15	80	0.1875000
NODE_4674_length_1126_cov_34.637780	146	226	89	2	80	0.0250000
NODE_4674_length_1126_cov_34.637780	146	226	92	1	80	0.0125000
NODE_4674_length_1126_cov_34.637780	146	226	105	5	80	0.0625000
NODE_4674_length_1126_cov_34.637780	146	226	106	5	80	0.0625000
NODE_4674_length_1126_cov_34.637780	146	226	26	5	80	0.0625000
NODE_4674_length_1126_cov_34.637780	146	226	28	5	80	0.0625000
NODE_4674_length_1126_cov_34.637780	146	226	29	1	80	0.0125000
NODE_4674_length_1126_cov_34.637780	146	226	30	10	80	0.1250000
NODE_4674_length_1126_cov_34.637780	146	226	45	1	80	0.0125000
NODE_4674_length_1126_cov_34.637780	146	226	47	9	80	0.1125000
NODE_4674_length_1126_cov_34.637780	146	226	51	1	80	0.0125000
NODE_4674_length_1126_cov_34.637780	146	226	64	4	80	0.0500000
NODE_4674_length_1126_cov_34.637780	146	226	65	1	80	0.0125000
NODE_4674_length_1126_cov_34.637780	146	226	66	2	80	0.0250000
NODE_4674_length_1126_cov_34.637780	146	226	74	1	80	0.0125000
NODE_4674_length_1126_cov_34.637780	146	226	76	4	80	0.0500000
NODE_4674_length_1126_cov_34.637780	146	226	85	3	80	0.0375000
NODE_4674_length_1126_cov_34.637780	146	226	86	1	80	0.0125000
NODE_4674_length_1126_cov_34.637780	146	226	87	4	80	0.0500000
NODE_4674_length_1126_cov_34.637780	146	226	88	15	80	0.1875000
NODE_4674_length_1126_cov_34.637780	146	226	89	2	80	0.0250000
NODE_4674_length_1126_cov_34.637780	146	226	92	1	80	0.0125000
NODE_4674_length_1126_cov_34.637780	146	226	105	5	80	0.0625000
NODE_4674_length_1126_cov_34.637780	146	226	106	5	80	0.0625000
NODE_4674_length_1126_cov_34.637780	146	208	28	2	62	0.0322581
NODE_4674_length_1126_cov_34.637780	146	208	29	1	62	0.0161290
NODE_4674_length_1126_cov_34.637780	146	208	45	1	62	0.0161290
NODE_4674_length_1126_cov_34.637780	146	208	47	9	62	0.1451613
NODE_4674_length_1126_cov_34.637780	146	208	51	1	62	0.0161290
NODE_4674_length_1126_cov_34.637780	146	208	64	4	62	0.0645161
NODE_4674_length_1126_cov_34.637780	146	208	65	1	62	0.0161290
NODE_4674_length_1126_cov_34.637780	146	208	66	2	62	0.0322581
NODE_4674_length_1126_cov_34.637780	146	208	74	1	62	0.0161290
NODE_4674_length_1126_cov_34.637780	146	208	76	4	62	0.0645161
NODE_4674_length_1126_cov_34.637780	146	208	85	3	62	0.0483871
NODE_4674_length_1126_cov_34.637780	146	208	86	1	62	0.0161290
NODE_4674_length_1126_cov_34.637780	146	208	87	4	62	0.0645161
NODE_4674_length_1126_cov_34.637780	146	208	88	15	62	0.2419355
NODE_4674_length_1126_cov_34.637780	146	208	89	2	62	0.0322581
NODE_4674_length_1126_cov_34.637780	146	208	92	1	62	0.0161290
NODE_4674_length_1126_cov_34.637780	146	208	105	5	62	0.0806452
NODE_4674_length_1126_cov_34.637780	146	208	106	5	62	0.0806452
NODE_4674_length_1126_cov_34.637780	146	217	28	5	71	0.0704225
NODE_4674_length_1126_cov_34.637780	146	217	29	1	71	0.0140845
NODE_4674_length_1126_cov_34.637780	146	217	30	6	71	0.0845070
NODE_4674_length_1126_cov_34.637780	146	217	45	1	71	0.0140845
NODE_4674_length_1126_cov_34.637780	146	217	47	9	71	0.1267606
NODE_4674_length_1126_cov_34.637780	146	217	51	1	71	0.0140845
NODE_4674_length_1126_cov_34.637780	146	217	64	4	71	0.0563380
NODE_4674_length_1126_cov_34.637780	146	217	65	1	71	0.0140845
NODE_4674_length_1126_cov_34.637780	146	217	66	2	71	0.0281690
NODE_4674_length_1126_cov_34.637780	146	217	74	1	71	0.0140845
NODE_4674_length_1126_cov_34.637780	146	217	76	4	71	0.0563380
NODE_4674_length_1126_cov_34.637780	146	217	85	3	71	0.0422535
NODE_4674_length_1126_cov_34.637780	146	217	86	1	71	0.0140845
NODE_4674_length_1126_cov_34.637780	146	217	87	4	71	0.0563380
NODE_4674_length_1126_cov_34.637780	146	217	88	15	71	0.2112676
NODE_4674_length_1126_cov_34.637780	146	217	89	2	71	0.0281690
NODE_4674_length_1126_cov_34.637780	146	217	92	1	71	0.0140845
NODE_4674_length_1126_cov_34.637780	146	217	105	5	71	0.0704225
NODE_4674_length_1126_cov_34.637780	146	217	106	5	71	0.0704225
NODE_4675_length_1126_cov_21.360273	595	675	0	80	80	1.0000000
NODE_4675_length_1126_cov_21.360273	648	728	0	80	80	1.0000000
NODE_4676_length_1126_cov_17.420643	422	502	0	80	80	1.0000000
NODE_4676_length_1126_cov_17.420643	475	555	0	80	80	1.0000000
NODE_4677_length_1126_cov_15.896787	383	463	0	80	80	1.0000000
NODE_4677_length_1126_cov_15.896787	436	516	0	80	80	1.0000000
NODE_4678_length_1126_cov_8.525803	174	254	0	80	80	1.0000000
NODE_4678_length_1126_cov_8.525803	227	307	0	80	80	1.0000000
NODE_4679_length_1126_cov_5.805258	463	543	0	80	80	1.0000000
NODE_4679_length_1126_cov_5.805258	516	596	0	80	80	1.0000000
NODE_4685_length_1126_cov_1.502434	6	86	0	80	80	1.0000000
NODE_4685_length_1126_cov_1.502434	59	108	0	49	49	1.0000000
NODE_4689_length_1125_cov_34.314815	405	485	0	80	80	1.0000000
NODE_4689_length_1125_cov_34.314815	458	538	0	80	80	1.0000000
NODE_4689_length_1125_cov_34.314815	534	614	0	80	80	1.0000000
NODE_4689_length_1125_cov_34.314815	587	667	0	63	80	0.7875000
NODE_4689_length_1125_cov_34.314815	587	667	2	17	80	0.2125000
NODE_4690_length_1125_cov_33.553606	458	538	4	80	80	1.0000000
NODE_4690_length_1125_cov_33.553606	511	591	0	13	80	0.1625000
NODE_4690_length_1125_cov_33.553606	511	591	4	67	80	0.8375000
NODE_4690_length_1125_cov_33.553606	587	667	0	80	80	1.0000000
NODE_4690_length_1125_cov_33.553606	640	720	0	80	80	1.0000000
NODE_4691_length_1125_cov_33.371345	408	488	0	80	80	1.0000000
NODE_4691_length_1125_cov_33.371345	461	541	0	80	80	1.0000000
NODE_4691_length_1125_cov_33.371345	537	617	0	80	80	1.0000000
NODE_4691_length_1125_cov_33.371345	590	670	0	80	80	1.0000000
NODE_4692_length_1125_cov_22.580897	279	359	0	80	80	1.0000000
NODE_4692_length_1125_cov_22.580897	332	412	0	80	80	1.0000000
NODE_4692_length_1125_cov_22.580897	408	488	0	80	80	1.0000000
NODE_4692_length_1125_cov_22.580897	461	541	0	80	80	1.0000000
NODE_4705_length_1124_cov_52.278049	616	696	0	80	80	1.0000000
NODE_4705_length_1124_cov_52.278049	669	749	0	80	80	1.0000000
NODE_4706_length_1124_cov_25.280000	444	524	0	35	80	0.4375000
NODE_4706_length_1124_cov_25.280000	444	524	2	45	80	0.5625000
NODE_4706_length_1124_cov_25.280000	497	577	0	37	80	0.4625000
NODE_4706_length_1124_cov_25.280000	497	577	2	43	80	0.5375000
NODE_4706_length_1124_cov_25.280000	573	653	0	80	80	1.0000000
NODE_4706_length_1124_cov_25.280000	626	706	0	80	80	1.0000000
NODE_4707_length_1124_cov_18.700488	114	194	0	74	80	0.9250000
NODE_4707_length_1124_cov_18.700488	114	194	2	6	80	0.0750000
NODE_4707_length_1124_cov_18.700488	167	247	0	21	80	0.2625000
NODE_4707_length_1124_cov_18.700488	167	247	2	59	80	0.7375000
NODE_4717_length_1123_cov_26.445312	388	468	0	80	80	1.0000000
NODE_4717_length_1123_cov_26.445312	441	521	0	80	80	1.0000000
NODE_4717_length_1123_cov_26.445312	517	597	0	80	80	1.0000000
NODE_4717_length_1123_cov_26.445312	570	650	0	80	80	1.0000000
NODE_4718_length_1123_cov_18.677734	522	602	0	80	80	1.0000000
NODE_4718_length_1123_cov_18.677734	575	655	0	80	80	1.0000000
NODE_4718_length_1123_cov_18.677734	651	731	0	80	80	1.0000000
NODE_4718_length_1123_cov_18.677734	704	784	0	80	80	1.0000000
NODE_4728_length_1122_cov_38.688172	295	375	0	80	80	1.0000000
NODE_4728_length_1122_cov_38.688172	348	428	0	80	80	1.0000000
NODE_4728_length_1122_cov_38.688172	424	504	0	80	80	1.0000000
NODE_4728_length_1122_cov_38.688172	477	557	0	80	80	1.0000000
NODE_4729_length_1122_cov_32.827957	232	312	0	80	80	1.0000000
NODE_4729_length_1122_cov_32.827957	285	365	0	80	80	1.0000000
NODE_4729_length_1122_cov_32.827957	361	441	0	80	80	1.0000000
NODE_4729_length_1122_cov_32.827957	414	494	0	80	80	1.0000000
NODE_4730_length_1122_cov_12.574780	396	476	0	80	80	1.0000000
NODE_4730_length_1122_cov_12.574780	449	529	0	80	80	1.0000000
NODE_4730_length_1122_cov_12.574780	525	605	0	80	80	1.0000000
NODE_4730_length_1122_cov_12.574780	578	658	0	30	80	0.3750000
NODE_4730_length_1122_cov_12.574780	578	658	2	50	80	0.6250000
NODE_4731_length_1122_cov_8.582600	586	666	0	80	80	1.0000000
NODE_4731_length_1122_cov_8.582600	639	719	0	80	80	1.0000000
NODE_4733_length_1122_cov_3.714565	284	364	0	80	80	1.0000000
NODE_4733_length_1122_cov_3.714565	337	417	0	80	80	1.0000000
NODE_4738_length_1122_cov_1.757576	25	87	0	62	62	1.0000000
NODE_4742_length_1121_cov_39.595890	507	587	6	80	80	1.0000000
NODE_4742_length_1121_cov_39.595890	560	640	0	48	80	0.6000000
NODE_4742_length_1121_cov_39.595890	560	640	6	32	80	0.4000000
NODE_4742_length_1121_cov_39.595890	636	716	0	80	80	1.0000000
NODE_4742_length_1121_cov_39.595890	689	769	0	80	80	1.0000000
NODE_4743_length_1121_cov_23.832681	525	605	0	12	80	0.1500000
NODE_4743_length_1121_cov_23.832681	525	605	1	44	80	0.5500000
NODE_4743_length_1121_cov_23.832681	525	605	2	24	80	0.3000000
NODE_4743_length_1121_cov_23.832681	578	658	1	3	80	0.0375000
NODE_4743_length_1121_cov_23.832681	578	658	2	77	80	0.9625000
NODE_4744_length_1121_cov_18.033268	1	42	0	41	41	1.0000000
NODE_4744_length_1121_cov_18.033268	671	751	0	80	80	1.0000000
NODE_4744_length_1121_cov_18.033268	724	804	0	80	80	1.0000000
NODE_4745_length_1121_cov_8.633072	610	690	0	28	80	0.3500000
NODE_4745_length_1121_cov_8.633072	610	690	2	17	80	0.2125000
NODE_4745_length_1121_cov_8.633072	610	690	4	35	80	0.4375000
NODE_4745_length_1121_cov_8.633072	663	743	4	80	80	1.0000000
NODE_4751_length_1120_cov_34.281097	377	457	0	80	80	1.0000000
NODE_4751_length_1120_cov_34.281097	430	510	0	80	80	1.0000000
NODE_4751_length_1120_cov_34.281097	506	586	0	80	80	1.0000000
NODE_4751_length_1120_cov_34.281097	559	639	0	80	80	1.0000000
NODE_4752_length_1120_cov_31.468168	401	481	0	80	80	1.0000000
NODE_4752_length_1120_cov_31.468168	454	534	0	80	80	1.0000000
NODE_4752_length_1120_cov_31.468168	530	610	0	80	80	1.0000000
NODE_4752_length_1120_cov_31.468168	583	663	0	80	80	1.0000000
NODE_4753_length_1120_cov_28.182174	418	498	0	80	80	1.0000000
NODE_4753_length_1120_cov_28.182174	471	551	0	80	80	1.0000000
NODE_4754_length_1120_cov_25.423115	405	485	4	80	80	1.0000000
NODE_4754_length_1120_cov_25.423115	458	538	0	34	80	0.4250000
NODE_4754_length_1120_cov_25.423115	458	538	2	14	80	0.1750000
NODE_4754_length_1120_cov_25.423115	458	538	4	32	80	0.4000000
NODE_4754_length_1120_cov_25.423115	534	614	0	80	80	1.0000000
NODE_4754_length_1120_cov_25.423115	587	667	0	51	80	0.6375000
NODE_4754_length_1120_cov_25.423115	587	667	2	29	80	0.3625000
NODE_4755_length_1120_cov_24.441724	589	662	0	73	73	1.0000000
NODE_4755_length_1120_cov_24.441724	636	716	0	80	80	1.0000000
NODE_4756_length_1120_cov_18.966699	406	486	0	80	80	1.0000000
NODE_4756_length_1120_cov_18.966699	459	539	0	80	80	1.0000000
NODE_4757_length_1120_cov_16.136141	508	588	0	80	80	1.0000000
NODE_4757_length_1120_cov_16.136141	561	641	0	80	80	1.0000000
NODE_4758_length_1120_cov_15.492654	460	540	0	80	80	1.0000000
NODE_4758_length_1120_cov_15.492654	460	540	0	80	80	1.0000000
NODE_4758_length_1120_cov_15.492654	513	593	0	80	80	1.0000000
NODE_4759_length_1120_cov_8.696376	646	726	0	80	80	1.0000000
NODE_4759_length_1120_cov_8.696376	699	779	0	80	80	1.0000000
NODE_4760_length_1120_cov_7.916748	304	384	0	80	80	1.0000000
NODE_4760_length_1120_cov_7.916748	357	437	0	80	80	1.0000000
NODE_4772_length_1119_cov_32.617647	425	505	0	80	80	1.0000000
NODE_4772_length_1119_cov_32.617647	478	558	0	80	80	1.0000000
NODE_4773_length_1119_cov_24.944118	455	535	0	80	80	1.0000000
NODE_4773_length_1119_cov_24.944118	508	588	0	80	80	1.0000000
NODE_4774_length_1119_cov_22.214706	614	694	0	80	80	1.0000000
NODE_4774_length_1119_cov_22.214706	667	747	0	80	80	1.0000000
NODE_4775_length_1119_cov_21.115686	431	511	0	80	80	1.0000000
NODE_4775_length_1119_cov_21.115686	484	564	0	35	80	0.4375000
NODE_4775_length_1119_cov_21.115686	484	564	2	45	80	0.5625000
NODE_4777_length_1119_cov_11.895098	565	645	0	20	80	0.2500000
NODE_4777_length_1119_cov_11.895098	565	645	2	60	80	0.7500000
NODE_4777_length_1119_cov_11.895098	618	698	0	31	80	0.3875000
NODE_4777_length_1119_cov_11.895098	618	698	2	49	80	0.6125000
NODE_4782_length_1119_cov_2.783333	37	99	0	62	62	1.0000000
NODE_4789_length_1118_cov_35.214917	555	635	0	80	80	1.0000000
NODE_4789_length_1118_cov_35.214917	608	688	0	80	80	1.0000000
NODE_4789_length_1118_cov_35.214917	684	764	0	80	80	1.0000000
NODE_4789_length_1118_cov_35.214917	737	817	0	80	80	1.0000000
NODE_4790_length_1118_cov_23.114818	602	682	0	80	80	1.0000000
NODE_4790_length_1118_cov_23.114818	655	735	0	80	80	1.0000000
NODE_4790_length_1118_cov_23.114818	731	811	0	80	80	1.0000000
NODE_4790_length_1118_cov_23.114818	784	864	0	80	80	1.0000000
NODE_4791_length_1118_cov_18.293425	388	463	0	75	75	1.0000000
NODE_4791_length_1118_cov_18.293425	436	516	0	80	80	1.0000000
NODE_4791_length_1118_cov_18.293425	512	592	0	80	80	1.0000000
NODE_4791_length_1118_cov_18.293425	565	645	0	80	80	1.0000000
NODE_4792_length_1118_cov_17.228656	480	560	0	41	80	0.5125000
NODE_4792_length_1118_cov_17.228656	480	560	2	39	80	0.4875000
NODE_4792_length_1118_cov_17.228656	533	613	2	80	80	1.0000000
NODE_4794_length_1118_cov_14.299313	468	548	0	80	80	1.0000000
NODE_4794_length_1118_cov_14.299313	521	601	0	80	80	1.0000000
NODE_4795_length_1118_cov_10.203140	306	386	0	80	80	1.0000000
NODE_4795_length_1118_cov_10.203140	359	439	0	80	80	1.0000000
NODE_4795_length_1118_cov_10.203140	435	515	0	80	80	1.0000000
NODE_4795_length_1118_cov_10.203140	488	568	0	80	80	1.0000000
NODE_4796_length_1118_cov_2.885182	471	551	0	80	80	1.0000000
NODE_4796_length_1118_cov_2.885182	524	604	0	80	80	1.0000000
NODE_4805_length_1117_cov_19.425344	541	621	0	80	80	1.0000000
NODE_4805_length_1117_cov_19.425344	594	674	0	80	80	1.0000000
NODE_4806_length_1117_cov_16.386051	385	465	0	80	80	1.0000000
NODE_4806_length_1117_cov_16.386051	438	518	0	80	80	1.0000000
NODE_4807_length_1117_cov_10.353635	294	374	0	80	80	1.0000000
NODE_4807_length_1117_cov_10.353635	347	427	0	80	80	1.0000000
NODE_4808_length_1117_cov_7.492141	417	497	0	24	80	0.3000000
NODE_4808_length_1117_cov_7.492141	417	497	8	56	80	0.7000000
NODE_4808_length_1117_cov_7.492141	470	550	0	24	80	0.3000000
NODE_4808_length_1117_cov_7.492141	470	550	8	56	80	0.7000000
NODE_4812_length_1117_cov_3.225933	666	728	0	62	62	1.0000000
NODE_4819_length_1116_cov_30.106195	457	537	1	80	80	1.0000000
NODE_4819_length_1116_cov_30.106195	510	590	1	80	80	1.0000000
NODE_4820_length_1116_cov_25.518191	831	911	0	45	80	0.5625000
NODE_4820_length_1116_cov_25.518191	831	911	2	35	80	0.4375000
NODE_4820_length_1116_cov_25.518191	884	964	0	80	80	1.0000000
NODE_4821_length_1116_cov_20.629302	500	580	0	80	80	1.0000000
NODE_4821_length_1116_cov_20.629302	553	633	0	63	80	0.7875000
NODE_4821_length_1116_cov_20.629302	553	633	2	17	80	0.2125000
NODE_4822_length_1116_cov_16.723697	345	425	0	80	80	1.0000000
NODE_4822_length_1116_cov_16.723697	398	478	0	80	80	1.0000000
NODE_4823_length_1116_cov_16.046214	735	815	0	70	80	0.8750000
NODE_4823_length_1116_cov_16.046214	735	815	2	10	80	0.1250000
NODE_4823_length_1116_cov_16.046214	788	868	0	17	80	0.2125000
NODE_4823_length_1116_cov_16.046214	788	868	2	63	80	0.7875000
NODE_4828_length_1116_cov_1.379548	800	880	0	80	80	1.0000000
NODE_4828_length_1116_cov_1.379548	853	933	0	80	80	1.0000000
NODE_4832_length_1115_cov_30.584646	549	629	1	11	80	0.1375000
NODE_4832_length_1115_cov_30.584646	549	629	2	69	80	0.8625000
NODE_4832_length_1115_cov_30.584646	602	682	0	13	80	0.1625000
NODE_4832_length_1115_cov_30.584646	602	682	1	51	80	0.6375000
NODE_4832_length_1115_cov_30.584646	602	682	2	16	80	0.2000000
NODE_4833_length_1115_cov_15.871063	454	534	0	80	80	1.0000000
NODE_4833_length_1115_cov_15.871063	507	587	0	80	80	1.0000000
NODE_4833_length_1115_cov_15.871063	583	663	0	80	80	1.0000000
NODE_4833_length_1115_cov_15.871063	636	716	0	80	80	1.0000000
NODE_4840_length_1114_cov_20.633498	1034	1114	0	1	80	0.0125000
NODE_4840_length_1114_cov_20.633498	1034	1114	1	14	80	0.1750000
NODE_4840_length_1114_cov_20.633498	1034	1114	3	13	80	0.1625000
NODE_4840_length_1114_cov_20.633498	1034	1114	11	3	80	0.0375000
NODE_4840_length_1114_cov_20.633498	1034	1114	12	7	80	0.0875000
NODE_4840_length_1114_cov_20.633498	1034	1114	14	12	80	0.1500000
NODE_4840_length_1114_cov_20.633498	1034	1114	15	30	80	0.3750000
NODE_4840_length_1114_cov_20.633498	1034	1114	0	1	80	0.0125000
NODE_4840_length_1114_cov_20.633498	1034	1114	1	14	80	0.1750000
NODE_4840_length_1114_cov_20.633498	1034	1114	3	13	80	0.1625000
NODE_4840_length_1114_cov_20.633498	1034	1114	11	3	80	0.0375000
NODE_4840_length_1114_cov_20.633498	1034	1114	12	7	80	0.0875000
NODE_4840_length_1114_cov_20.633498	1034	1114	14	12	80	0.1500000
NODE_4840_length_1114_cov_20.633498	1034	1114	15	30	80	0.3750000
NODE_4840_length_1114_cov_20.633498	1034	1114	0	1	80	0.0125000
NODE_4840_length_1114_cov_20.633498	1034	1114	1	14	80	0.1750000
NODE_4840_length_1114_cov_20.633498	1034	1114	3	13	80	0.1625000
NODE_4840_length_1114_cov_20.633498	1034	1114	11	3	80	0.0375000
NODE_4840_length_1114_cov_20.633498	1034	1114	12	7	80	0.0875000
NODE_4840_length_1114_cov_20.633498	1034	1114	14	12	80	0.1500000
NODE_4840_length_1114_cov_20.633498	1034	1114	15	30	80	0.3750000
NODE_4840_length_1114_cov_20.633498	1034	1114	0	1	80	0.0125000
NODE_4840_length_1114_cov_20.633498	1034	1114	1	14	80	0.1750000
NODE_4840_length_1114_cov_20.633498	1034	1114	3	13	80	0.1625000
NODE_4840_length_1114_cov_20.633498	1034	1114	11	3	80	0.0375000
NODE_4840_length_1114_cov_20.633498	1034	1114	12	7	80	0.0875000
NODE_4840_length_1114_cov_20.633498	1034	1114	14	12	80	0.1500000
NODE_4840_length_1114_cov_20.633498	1034	1114	15	30	80	0.3750000
NODE_4840_length_1114_cov_20.633498	1034	1114	0	1	80	0.0125000
NODE_4840_length_1114_cov_20.633498	1034	1114	1	14	80	0.1750000
NODE_4840_length_1114_cov_20.633498	1034	1114	3	13	80	0.1625000
NODE_4840_length_1114_cov_20.633498	1034	1114	11	3	80	0.0375000
NODE_4840_length_1114_cov_20.633498	1034	1114	12	7	80	0.0875000
NODE_4840_length_1114_cov_20.633498	1034	1114	14	12	80	0.1500000
NODE_4840_length_1114_cov_20.633498	1034	1114	15	30	80	0.3750000
NODE_4840_length_1114_cov_20.633498	1043	1114	0	1	71	0.0140845
NODE_4840_length_1114_cov_20.633498	1043	1114	1	14	71	0.1971831
NODE_4840_length_1114_cov_20.633498	1043	1114	3	13	71	0.1830986
NODE_4840_length_1114_cov_20.633498	1043	1114	11	3	71	0.0422535
NODE_4840_length_1114_cov_20.633498	1043	1114	12	7	71	0.0985916
NODE_4840_length_1114_cov_20.633498	1043	1114	14	12	71	0.1690141
NODE_4840_length_1114_cov_20.633498	1043	1114	15	21	71	0.2957746
NODE_4841_length_1114_cov_17.383251	516	601	0	85	85	1.0000000
NODE_4841_length_1114_cov_17.383251	574	653	0	79	79	1.0000000
NODE_4841_length_1114_cov_17.383251	649	729	0	80	80	1.0000000
NODE_4841_length_1114_cov_17.383251	702	782	0	80	80	1.0000000
NODE_4842_length_1114_cov_5.562562	563	643	0	80	80	1.0000000
NODE_4842_length_1114_cov_5.562562	616	696	0	80	80	1.0000000
NODE_4847_length_1113_cov_51.988166	343	423	0	80	80	1.0000000
NODE_4847_length_1113_cov_51.988166	396	476	0	80	80	1.0000000
NODE_4847_length_1113_cov_51.988166	472	552	0	80	80	1.0000000
NODE_4847_length_1113_cov_51.988166	525	605	0	80	80	1.0000000
NODE_4848_length_1113_cov_35.005917	359	439	8	80	80	1.0000000
NODE_4848_length_1113_cov_35.005917	412	492	0	10	80	0.1250000
NODE_4848_length_1113_cov_35.005917	412	492	8	70	80	0.8750000
NODE_4849_length_1113_cov_28.106509	570	650	0	80	80	1.0000000
NODE_4849_length_1113_cov_28.106509	623	703	0	80	80	1.0000000
NODE_4849_length_1113_cov_28.106509	699	779	0	80	80	1.0000000
NODE_4849_length_1113_cov_28.106509	752	832	0	80	80	1.0000000
NODE_4850_length_1113_cov_18.636095	512	592	0	80	80	1.0000000
NODE_4850_length_1113_cov_18.636095	565	645	0	75	80	0.9375000
NODE_4850_length_1113_cov_18.636095	565	645	4	5	80	0.0625000
NODE_4851_length_1113_cov_16.664694	352	432	0	80	80	1.0000000
NODE_4851_length_1113_cov_16.664694	405	485	0	80	80	1.0000000
NODE_4851_length_1113_cov_16.664694	481	561	0	80	80	1.0000000
NODE_4851_length_1113_cov_16.664694	534	614	0	80	80	1.0000000
NODE_4852_length_1113_cov_14.155819	454	512	0	58	58	1.0000000
NODE_4852_length_1113_cov_14.155819	511	575	0	64	64	1.0000000
NODE_4853_length_1113_cov_10.185404	494	574	0	62	80	0.7750000
NODE_4853_length_1113_cov_10.185404	494	574	4	18	80	0.2250000
NODE_4853_length_1113_cov_10.185404	547	627	0	9	80	0.1125000
NODE_4853_length_1113_cov_10.185404	547	627	4	71	80	0.8875000
NODE_4855_length_1113_cov_4.005917	700	780	0	80	80	1.0000000
NODE_4855_length_1113_cov_4.005917	753	833	0	80	80	1.0000000
NODE_4866_length_1112_cov_14.961500	427	507	0	30	80	0.3750000
NODE_4866_length_1112_cov_14.961500	427	507	2	50	80	0.6250000
NODE_4866_length_1112_cov_14.961500	480	560	0	80	80	1.0000000
NODE_4866_length_1112_cov_14.961500	556	636	0	80	80	1.0000000
NODE_4866_length_1112_cov_14.961500	609	689	0	80	80	1.0000000
NODE_4875_length_1112_cov_1.655479	45	123	0	78	78	1.0000000
NODE_4875_length_1112_cov_1.655479	98	166	0	67	68	0.9852941
NODE_4875_length_1112_cov_1.655479	98	166	2	1	68	0.0147059
NODE_4880_length_1111_cov_37.999012	473	553	2	67	80	0.8375000
NODE_4880_length_1111_cov_37.999012	473	553	4	13	80	0.1625000
NODE_4880_length_1111_cov_37.999012	526	606	0	40	80	0.5000000
NODE_4880_length_1111_cov_37.999012	526	606	2	40	80	0.5000000
NODE_4880_length_1111_cov_37.999012	602	682	0	80	80	1.0000000
NODE_4880_length_1111_cov_37.999012	655	735	0	80	80	1.0000000
NODE_4881_length_1111_cov_24.394269	644	724	0	78	80	0.9750000
NODE_4881_length_1111_cov_24.394269	644	724	2	2	80	0.0250000
NODE_4881_length_1111_cov_24.394269	697	777	0	80	80	1.0000000
NODE_4882_length_1111_cov_23.676877	374	454	0	80	80	1.0000000
NODE_4882_length_1111_cov_23.676877	427	507	0	80	80	1.0000000
NODE_4883_length_1111_cov_17.522727	383	463	0	80	80	1.0000000
NODE_4883_length_1111_cov_17.522727	436	516	0	80	80	1.0000000
NODE_4884_length_1111_cov_16.495059	388	468	0	80	80	1.0000000
NODE_4884_length_1111_cov_16.495059	441	521	0	80	80	1.0000000
NODE_4885_length_1111_cov_15.366601	555	635	0	80	80	1.0000000
NODE_4885_length_1111_cov_15.366601	608	688	0	80	80	1.0000000
NODE_4886_length_1111_cov_15.314229	809	889	0	80	80	1.0000000
NODE_4886_length_1111_cov_15.314229	862	942	0	80	80	1.0000000
NODE_4887_length_1111_cov_9.732213	443	523	0	52	80	0.6500000
NODE_4887_length_1111_cov_9.732213	443	523	2	28	80	0.3500000
NODE_4887_length_1111_cov_9.732213	496	576	2	80	80	1.0000000
NODE_4888_length_1111_cov_4.907115	606	686	0	80	80	1.0000000
NODE_4888_length_1111_cov_4.907115	659	739	0	80	80	1.0000000
NODE_4892_length_1110_cov_23.012859	453	533	0	80	80	1.0000000
NODE_4892_length_1110_cov_23.012859	506	586	0	80	80	1.0000000
NODE_4892_length_1110_cov_23.012859	582	662	0	80	80	1.0000000
NODE_4892_length_1110_cov_23.012859	635	715	0	80	80	1.0000000
NODE_4895_length_1110_cov_5.305638	754	834	0	80	80	1.0000000
NODE_4895_length_1110_cov_5.305638	807	887	0	80	80	1.0000000
NODE_4896_length_1110_cov_3.698318	642	685	0	43	43	1.0000000
NODE_4899_length_1110_cov_1.871414	15	86	0	71	71	1.0000000
NODE_4903_length_1109_cov_35.307921	413	493	0	80	80	1.0000000
NODE_4903_length_1109_cov_35.307921	466	546	0	80	80	1.0000000
NODE_4903_length_1109_cov_35.307921	542	622	0	80	80	1.0000000
NODE_4903_length_1109_cov_35.307921	595	675	0	80	80	1.0000000
NODE_4904_length_1109_cov_27.880198	501	581	1	80	80	1.0000000
NODE_4904_length_1109_cov_27.880198	554	634	0	39	80	0.4875000
NODE_4904_length_1109_cov_27.880198	554	634	1	41	80	0.5125000
NODE_4904_length_1109_cov_27.880198	630	710	0	80	80	1.0000000
NODE_4904_length_1109_cov_27.880198	683	763	0	80	80	1.0000000
NODE_4905_length_1109_cov_21.858416	571	651	0	80	80	1.0000000
NODE_4905_length_1109_cov_21.858416	624	704	0	80	80	1.0000000
NODE_4912_length_1108_cov_59.921705	386	466	0	80	80	1.0000000
NODE_4912_length_1108_cov_59.921705	439	519	0	80	80	1.0000000
NODE_4912_length_1108_cov_59.921705	515	595	0	80	80	1.0000000
NODE_4912_length_1108_cov_59.921705	568	648	0	80	80	1.0000000
NODE_4914_length_1108_cov_16.069376	513	593	0	80	80	1.0000000
NODE_4914_length_1108_cov_16.069376	566	646	0	80	80	1.0000000
NODE_4916_length_1108_cov_11.656095	333	413	0	80	80	1.0000000
NODE_4916_length_1108_cov_11.656095	386	466	0	80	80	1.0000000
NODE_4917_length_1108_cov_10.266601	431	511	0	80	80	1.0000000
NODE_4917_length_1108_cov_10.266601	484	564	0	80	80	1.0000000
NODE_4918_length_1108_cov_8.895937	635	715	0	80	80	1.0000000
NODE_4918_length_1108_cov_8.895937	688	768	0	80	80	1.0000000
NODE_4920_length_1108_cov_5.682854	577	657	0	80	80	1.0000000
NODE_4920_length_1108_cov_5.682854	630	710	0	80	80	1.0000000
NODE_4927_length_1107_cov_35.050595	423	503	0	80	80	1.0000000
NODE_4927_length_1107_cov_35.050595	476	556	0	80	80	1.0000000
NODE_4927_length_1107_cov_35.050595	552	632	0	80	80	1.0000000
NODE_4927_length_1107_cov_35.050595	605	685	0	80	80	1.0000000
NODE_4928_length_1107_cov_31.386905	422	502	0	80	80	1.0000000
NODE_4928_length_1107_cov_31.386905	475	555	0	80	80	1.0000000
NODE_4929_length_1107_cov_29.178571	577	657	0	80	80	1.0000000
NODE_4929_length_1107_cov_29.178571	630	710	0	50	80	0.6250000
NODE_4929_length_1107_cov_29.178571	630	710	2	30	80	0.3750000
NODE_4929_length_1107_cov_29.178571	934	1000	10	26	66	0.3939394
NODE_4929_length_1107_cov_29.178571	934	1000	11	2	66	0.0303030
NODE_4929_length_1107_cov_29.178571	934	1000	12	15	66	0.2272727
NODE_4929_length_1107_cov_29.178571	934	1000	14	23	66	0.3484848
NODE_4929_length_1107_cov_29.178571	934	1005	10	26	71	0.3661972
NODE_4929_length_1107_cov_29.178571	934	1005	11	2	71	0.0281690
NODE_4929_length_1107_cov_29.178571	934	1005	12	20	71	0.2816902
NODE_4929_length_1107_cov_29.178571	934	1005	14	23	71	0.3239437
NODE_4930_length_1107_cov_16.038690	574	654	0	80	80	1.0000000
NODE_4930_length_1107_cov_16.038690	627	707	0	80	80	1.0000000
NODE_4931_length_1107_cov_15.472222	78	158	66	1	80	0.0125000
NODE_4931_length_1107_cov_15.472222	78	158	68	8	80	0.1000000
NODE_4931_length_1107_cov_15.472222	78	158	70	3	80	0.0375000
NODE_4931_length_1107_cov_15.472222	78	158	74	2	80	0.0250000
NODE_4931_length_1107_cov_15.472222	78	158	76	4	80	0.0500000
NODE_4931_length_1107_cov_15.472222	78	158	79	3	80	0.0375000
NODE_4931_length_1107_cov_15.472222	78	158	81	2	80	0.0250000
NODE_4931_length_1107_cov_15.472222	78	158	86	1	80	0.0125000
NODE_4931_length_1107_cov_15.472222	78	158	89	2	80	0.0250000
NODE_4931_length_1107_cov_15.472222	78	158	90	1	80	0.0125000
NODE_4931_length_1107_cov_15.472222	78	158	94	6	80	0.0750000
NODE_4931_length_1107_cov_15.472222	78	158	96	10	80	0.1250000
NODE_4931_length_1107_cov_15.472222	78	158	100	3	80	0.0375000
NODE_4931_length_1107_cov_15.472222	78	158	104	1	80	0.0125000
NODE_4931_length_1107_cov_15.472222	78	158	106	2	80	0.0250000
NODE_4931_length_1107_cov_15.472222	78	158	108	1	80	0.0125000
NODE_4931_length_1107_cov_15.472222	78	158	110	6	80	0.0750000
NODE_4931_length_1107_cov_15.472222	78	158	114	1	80	0.0125000
NODE_4931_length_1107_cov_15.472222	78	158	116	23	80	0.2875000
NODE_4931_length_1107_cov_15.472222	131	194	6	3	63	0.0476190
NODE_4931_length_1107_cov_15.472222	131	194	10	2	63	0.0317460
NODE_4931_length_1107_cov_15.472222	131	194	15	2	63	0.0317460
NODE_4931_length_1107_cov_15.472222	131	194	18	1	63	0.0158730
NODE_4931_length_1107_cov_15.472222	131	194	19	1	63	0.0158730
NODE_4931_length_1107_cov_15.472222	131	194	33	5	63	0.0793651
NODE_4931_length_1107_cov_15.472222	131	194	37	1	63	0.0158730
NODE_4931_length_1107_cov_15.472222	131	194	38	1	63	0.0158730
NODE_4931_length_1107_cov_15.472222	131	194	44	9	63	0.1428571
NODE_4931_length_1107_cov_15.472222	131	194	56	3	63	0.0476190
NODE_4931_length_1107_cov_15.472222	131	194	62	2	63	0.0317460
NODE_4931_length_1107_cov_15.472222	131	194	64	6	63	0.0952381
NODE_4931_length_1107_cov_15.472222	131	194	66	1	63	0.0158730
NODE_4931_length_1107_cov_15.472222	131	194	68	8	63	0.1269841
NODE_4931_length_1107_cov_15.472222	131	194	70	3	63	0.0476190
NODE_4931_length_1107_cov_15.472222	131	194	74	2	63	0.0317460
NODE_4931_length_1107_cov_15.472222	131	194	76	4	63	0.0634921
NODE_4931_length_1107_cov_15.472222	131	194	79	3	63	0.0476190
NODE_4931_length_1107_cov_15.472222	131	194	81	2	63	0.0317460
NODE_4931_length_1107_cov_15.472222	131	194	86	1	63	0.0158730
NODE_4931_length_1107_cov_15.472222	131	194	89	2	63	0.0317460
NODE_4931_length_1107_cov_15.472222	131	194	90	1	63	0.0158730
NODE_4931_length_1107_cov_15.472222	952	995	0	40	43	0.9302326
NODE_4931_length_1107_cov_15.472222	952	995	2	3	43	0.0697674
NODE_4931_length_1107_cov_15.472222	968	1052	0	84	84	1.0000000
NODE_4932_length_1107_cov_13.911706	502	582	1	12	80	0.1500000
NODE_4932_length_1107_cov_13.911706	502	582	2	16	80	0.2000000
NODE_4932_length_1107_cov_13.911706	502	582	3	52	80	0.6500000
NODE_4932_length_1107_cov_13.911706	555	635	1	11	80	0.1375000
NODE_4932_length_1107_cov_13.911706	555	635	2	69	80	0.8625000
NODE_4933_length_1107_cov_11.701389	520	600	0	80	80	1.0000000
NODE_4933_length_1107_cov_11.701389	573	653	0	80	80	1.0000000
NODE_4944_length_1106_cov_59.617676	452	532	0	80	80	1.0000000
NODE_4944_length_1106_cov_59.617676	505	585	0	80	80	1.0000000
NODE_4944_length_1106_cov_59.617676	581	661	0	80	80	1.0000000
NODE_4944_length_1106_cov_59.617676	634	714	0	80	80	1.0000000
NODE_4945_length_1106_cov_40.808342	439	504	0	65	65	1.0000000
NODE_4945_length_1106_cov_40.808342	471	511	0	40	40	1.0000000
NODE_4945_length_1106_cov_40.808342	503	569	0	66	66	1.0000000
NODE_4945_length_1106_cov_40.808342	536	601	0	65	65	1.0000000
NODE_4945_length_1106_cov_40.808342	568	648	0	80	80	1.0000000
NODE_4945_length_1106_cov_40.808342	621	682	0	61	61	1.0000000
NODE_4946_length_1106_cov_23.186693	560	640	0	80	80	1.0000000
NODE_4946_length_1106_cov_23.186693	613	693	0	80	80	1.0000000
NODE_4947_length_1106_cov_14.570010	466	546	0	80	80	1.0000000
NODE_4947_length_1106_cov_14.570010	519	599	0	80	80	1.0000000
NODE_4948_length_1106_cov_14.039722	487	567	0	34	80	0.4250000
NODE_4948_length_1106_cov_14.039722	487	567	4	46	80	0.5750000
NODE_4948_length_1106_cov_14.039722	540	620	0	35	80	0.4375000
NODE_4948_length_1106_cov_14.039722	540	620	3	1	80	0.0125000
NODE_4948_length_1106_cov_14.039722	540	620	4	44	80	0.5500000
NODE_4949_length_1106_cov_8.872890	328	408	0	80	80	1.0000000
NODE_4949_length_1106_cov_8.872890	381	461	0	80	80	1.0000000
NODE_4950_length_1106_cov_7.157895	332	412	0	80	80	1.0000000
NODE_4950_length_1106_cov_7.157895	385	465	0	80	80	1.0000000
NODE_4951_length_1106_cov_6.530288	513	593	0	75	80	0.9375000
NODE_4951_length_1106_cov_6.530288	513	593	2	5	80	0.0625000
NODE_4951_length_1106_cov_6.530288	566	646	0	22	80	0.2750000
NODE_4951_length_1106_cov_6.530288	566	646	2	58	80	0.7250000
NODE_4959_length_1105_cov_28.126243	253	333	0	40	80	0.5000000
NODE_4959_length_1105_cov_28.126243	253	333	2	40	80	0.5000000
NODE_4959_length_1105_cov_28.126243	306	386	2	80	80	1.0000000
NODE_4960_length_1105_cov_24.994036	549	629	0	80	80	1.0000000
NODE_4960_length_1105_cov_24.994036	602	682	0	80	80	1.0000000
NODE_4961_length_1105_cov_17.635189	442	522	0	80	80	1.0000000
NODE_4961_length_1105_cov_17.635189	495	575	0	80	80	1.0000000
NODE_4963_length_1105_cov_10.114314	438	518	0	80	80	1.0000000
NODE_4963_length_1105_cov_10.114314	491	571	0	80	80	1.0000000
NODE_4964_length_1105_cov_8.403579	507	587	0	80	80	1.0000000
NODE_4964_length_1105_cov_8.403579	560	640	0	80	80	1.0000000
NODE_4966_length_1105_cov_6.682903	467	547	0	80	80	1.0000000
NODE_4966_length_1105_cov_6.682903	520	600	0	80	80	1.0000000
NODE_4966_length_1105_cov_6.682903	596	676	0	80	80	1.0000000
NODE_4966_length_1105_cov_6.682903	649	729	0	80	80	1.0000000
NODE_4974_length_1104_cov_27.599005	388	468	0	80	80	1.0000000
NODE_4974_length_1104_cov_27.599005	441	521	0	80	80	1.0000000
NODE_4984_length_1103_cov_2.787849	620	682	2	5	62	0.0806452
NODE_4984_length_1103_cov_2.787849	620	682	5	17	62	0.2741936
NODE_4984_length_1103_cov_2.787849	620	682	6	40	62	0.6451613
NODE_4986_length_1102_cov_34.484546	667	747	0	80	80	1.0000000
NODE_4986_length_1102_cov_34.484546	720	800	0	80	80	1.0000000
NODE_4987_length_1102_cov_17.631107	511	587	0	12	76	0.1578947
NODE_4987_length_1102_cov_17.631107	511	587	2	38	76	0.5000000
NODE_4987_length_1102_cov_17.631107	511	587	4	26	76	0.3421053
NODE_4987_length_1102_cov_17.631107	560	640	0	65	80	0.8125000
NODE_4987_length_1102_cov_17.631107	560	640	2	15	80	0.1875000
NODE_4998_length_1101_cov_35.638723	414	491	4	45	77	0.5844156
NODE_4998_length_1101_cov_35.638723	414	491	9	15	77	0.1948052
NODE_4998_length_1101_cov_35.638723	414	491	13	14	77	0.1818182
NODE_4998_length_1101_cov_35.638723	414	491	15	3	77	0.0389610
NODE_4998_length_1101_cov_35.638723	414	491	4	45	77	0.5844156
NODE_4998_length_1101_cov_35.638723	414	491	9	15	77	0.1948052
NODE_4998_length_1101_cov_35.638723	414	491	13	14	77	0.1818182
NODE_4998_length_1101_cov_35.638723	414	491	15	3	77	0.0389610
NODE_4998_length_1101_cov_35.638723	488	544	15	56	56	1.0000000
NODE_4998_length_1101_cov_35.638723	752	832	2	14	80	0.1750000
NODE_4998_length_1101_cov_35.638723	752	832	3	26	80	0.3250000
NODE_4998_length_1101_cov_35.638723	752	832	4	16	80	0.2000000
NODE_4998_length_1101_cov_35.638723	752	832	5	24	80	0.3000000
NODE_4998_length_1101_cov_35.638723	805	885	0	46	80	0.5750000
NODE_4998_length_1101_cov_35.638723	805	885	2	21	80	0.2625000
NODE_4998_length_1101_cov_35.638723	805	885	3	13	80	0.1625000
NODE_4998_length_1101_cov_35.638723	881	961	0	61	80	0.7625000
NODE_4998_length_1101_cov_35.638723	881	961	1	3	80	0.0375000
NODE_4998_length_1101_cov_35.638723	881	961	3	5	80	0.0625000
NODE_4998_length_1101_cov_35.638723	881	961	5	11	80	0.1375000
NODE_4998_length_1101_cov_35.638723	934	1014	0	8	80	0.1000000
NODE_4998_length_1101_cov_35.638723	934	1014	1	3	80	0.0375000
NODE_4998_length_1101_cov_35.638723	934	1014	3	5	80	0.0625000
NODE_4998_length_1101_cov_35.638723	934	1014	4	7	80	0.0875000
NODE_4998_length_1101_cov_35.638723	934	1014	5	27	80	0.3375000
NODE_4998_length_1101_cov_35.638723	934	1014	6	30	80	0.3750000
NODE_4999_length_1101_cov_28.366267	452	532	0	80	80	1.0000000
NODE_4999_length_1101_cov_28.366267	505	585	0	80	80	1.0000000
NODE_5000_length_1101_cov_24.513972	475	555	0	80	80	1.0000000
NODE_5000_length_1101_cov_24.513972	528	608	0	80	80	1.0000000
NODE_5001_length_1101_cov_22.315369	335	415	0	80	80	1.0000000
NODE_5001_length_1101_cov_22.315369	388	468	0	80	80	1.0000000
NODE_5001_length_1101_cov_22.315369	464	544	0	80	80	1.0000000
NODE_5001_length_1101_cov_22.315369	517	597	0	80	80	1.0000000
NODE_5002_length_1101_cov_22.070858	419	499	0	80	80	1.0000000
NODE_5002_length_1101_cov_22.070858	472	552	0	80	80	1.0000000
NODE_5002_length_1101_cov_22.070858	548	628	0	54	80	0.6750000
NODE_5002_length_1101_cov_22.070858	548	628	2	17	80	0.2125000
NODE_5002_length_1101_cov_22.070858	548	628	4	9	80	0.1125000
NODE_5002_length_1101_cov_22.070858	601	681	0	1	80	0.0125000
NODE_5002_length_1101_cov_22.070858	601	681	2	17	80	0.2125000
NODE_5002_length_1101_cov_22.070858	601	681	4	23	80	0.2875000
NODE_5002_length_1101_cov_22.070858	601	681	6	39	80	0.4875000
NODE_5003_length_1101_cov_18.821357	469	549	0	80	80	1.0000000
NODE_5003_length_1101_cov_18.821357	522	602	0	80	80	1.0000000
NODE_5004_length_1101_cov_17.151697	502	582	0	51	80	0.6375000
NODE_5004_length_1101_cov_17.151697	502	582	2	29	80	0.3625000
NODE_5004_length_1101_cov_17.151697	555	635	2	80	80	1.0000000
NODE_5005_length_1101_cov_8.371257	968	1048	4	1	80	0.0125000
NODE_5005_length_1101_cov_8.371257	968	1048	12	1	80	0.0125000
NODE_5005_length_1101_cov_8.371257	968	1048	14	1	80	0.0125000
NODE_5005_length_1101_cov_8.371257	968	1048	16	1	80	0.0125000
NODE_5005_length_1101_cov_8.371257	968	1048	20	13	80	0.1625000
NODE_5005_length_1101_cov_8.371257	968	1048	26	1	80	0.0125000
NODE_5005_length_1101_cov_8.371257	968	1048	28	5	80	0.0625000
NODE_5005_length_1101_cov_8.371257	968	1048	32	7	80	0.0875000
NODE_5005_length_1101_cov_8.371257	968	1048	34	50	80	0.6250000
NODE_5010_length_1100_cov_42.528472	582	662	0	3	80	0.0375000
NODE_5010_length_1100_cov_42.528472	582	662	8	77	80	0.9625000
NODE_5010_length_1100_cov_42.528472	635	715	0	56	80	0.7000000
NODE_5010_length_1100_cov_42.528472	635	715	8	24	80	0.3000000
NODE_5010_length_1100_cov_42.528472	711	791	0	80	80	1.0000000
NODE_5010_length_1100_cov_42.528472	764	844	0	80	80	1.0000000
NODE_5011_length_1100_cov_40.883117	324	404	0	80	80	1.0000000
NODE_5011_length_1100_cov_40.883117	377	457	0	80	80	1.0000000
NODE_5011_length_1100_cov_40.883117	453	533	0	80	80	1.0000000
NODE_5011_length_1100_cov_40.883117	506	586	0	80	80	1.0000000
NODE_5012_length_1100_cov_23.160839	524	604	0	51	80	0.6375000
NODE_5012_length_1100_cov_23.160839	524	604	2	29	80	0.3625000
NODE_5012_length_1100_cov_23.160839	577	657	2	80	80	1.0000000
NODE_5012_length_1100_cov_23.160839	653	733	0	47	80	0.5875000
NODE_5012_length_1100_cov_23.160839	653	733	2	33	80	0.4125000
NODE_5012_length_1100_cov_23.160839	706	786	0	80	80	1.0000000
NODE_5013_length_1100_cov_22.200799	485	565	0	80	80	1.0000000
NODE_5013_length_1100_cov_22.200799	538	618	0	80	80	1.0000000
NODE_5013_length_1100_cov_22.200799	614	694	0	80	80	1.0000000
NODE_5013_length_1100_cov_22.200799	667	745	0	78	78	1.0000000
NODE_5014_length_1100_cov_15.353646	472	552	0	80	80	1.0000000
NODE_5014_length_1100_cov_15.353646	525	605	0	80	80	1.0000000
NODE_5015_length_1100_cov_14.584416	673	753	0	80	80	1.0000000
NODE_5015_length_1100_cov_14.584416	726	806	0	80	80	1.0000000
NODE_5029_length_1099_cov_85.893000	464	544	0	80	80	1.0000000
NODE_5029_length_1099_cov_85.893000	517	597	0	52	80	0.6500000
NODE_5029_length_1099_cov_85.893000	517	597	2	28	80	0.3500000
NODE_5029_length_1099_cov_85.893000	593	673	2	10	80	0.1250000
NODE_5029_length_1099_cov_85.893000	593	673	4	70	80	0.8750000
NODE_5029_length_1099_cov_85.893000	646	726	2	7	80	0.0875000
NODE_5029_length_1099_cov_85.893000	646	726	4	73	80	0.9125000
NODE_5030_length_1099_cov_45.874000	521	601	0	80	80	1.0000000
NODE_5030_length_1099_cov_45.874000	574	654	0	80	80	1.0000000
NODE_5030_length_1099_cov_45.874000	650	730	0	80	80	1.0000000
NODE_5030_length_1099_cov_45.874000	703	783	0	80	80	1.0000000
NODE_5031_length_1099_cov_25.192000	526	606	0	80	80	1.0000000
NODE_5031_length_1099_cov_25.192000	579	659	0	80	80	1.0000000
NODE_5032_length_1099_cov_11.846000	565	645	0	80	80	1.0000000
NODE_5032_length_1099_cov_11.846000	618	698	0	80	80	1.0000000
NODE_5033_length_1099_cov_9.527000	495	575	0	3	80	0.0375000
NODE_5033_length_1099_cov_9.527000	495	575	1	12	80	0.1500000
NODE_5033_length_1099_cov_9.527000	495	575	2	19	80	0.2375000
NODE_5033_length_1099_cov_9.527000	495	575	4	46	80	0.5750000
NODE_5033_length_1099_cov_9.527000	548	628	2	30	80	0.3750000
NODE_5033_length_1099_cov_9.527000	548	628	4	50	80	0.6250000
NODE_5034_length_1099_cov_8.993000	464	544	0	80	80	1.0000000
NODE_5034_length_1099_cov_8.993000	517	597	0	80	80	1.0000000
NODE_5039_length_1099_cov_2.286000	273	353	0	80	80	1.0000000
NODE_5045_length_1098_cov_44.988989	360	440	0	17	80	0.2125000
NODE_5045_length_1098_cov_44.988989	360	440	4	63	80	0.7875000
NODE_5045_length_1098_cov_44.988989	413	493	0	19	80	0.2375000
NODE_5045_length_1098_cov_44.988989	413	493	4	61	80	0.7625000
NODE_5046_length_1098_cov_35.192192	452	532	0	80	80	1.0000000
NODE_5046_length_1098_cov_35.192192	505	585	0	80	80	1.0000000
NODE_5046_length_1098_cov_35.192192	581	661	0	11	80	0.1375000
NODE_5046_length_1098_cov_35.192192	581	661	2	32	80	0.4000000
NODE_5046_length_1098_cov_35.192192	581	661	3	37	80	0.4625000
NODE_5046_length_1098_cov_35.192192	634	714	1	1	80	0.0125000
NODE_5046_length_1098_cov_35.192192	634	714	2	51	80	0.6375000
NODE_5046_length_1098_cov_35.192192	634	714	3	28	80	0.3500000
NODE_5047_length_1098_cov_28.743744	449	529	0	80	80	1.0000000
NODE_5047_length_1098_cov_28.743744	502	582	0	80	80	1.0000000
NODE_5047_length_1098_cov_28.743744	578	658	0	80	80	1.0000000
NODE_5047_length_1098_cov_28.743744	631	711	0	76	80	0.9500000
NODE_5047_length_1098_cov_28.743744	631	711	2	4	80	0.0500000
NODE_5048_length_1098_cov_28.230230	477	557	0	80	80	1.0000000
NODE_5048_length_1098_cov_28.230230	530	610	0	80	80	1.0000000
NODE_5048_length_1098_cov_28.230230	606	686	0	24	80	0.3000000
NODE_5048_length_1098_cov_28.230230	606	686	2	56	80	0.7000000
NODE_5048_length_1098_cov_28.230230	659	739	0	6	80	0.0750000
NODE_5048_length_1098_cov_28.230230	659	739	2	74	80	0.9250000
NODE_5049_length_1098_cov_26.131131	494	574	0	80	80	1.0000000
NODE_5049_length_1098_cov_26.131131	547	627	0	80	80	1.0000000
NODE_5050_length_1098_cov_21.355355	599	679	0	80	80	1.0000000
NODE_5050_length_1098_cov_21.355355	652	732	0	80	80	1.0000000
NODE_5051_length_1098_cov_17.087087	541	621	0	80	80	1.0000000
NODE_5051_length_1098_cov_17.087087	594	674	0	80	80	1.0000000
NODE_5051_length_1098_cov_17.087087	670	750	0	80	80	1.0000000
NODE_5051_length_1098_cov_17.087087	723	803	0	80	80	1.0000000
NODE_5052_length_1098_cov_15.455455	545	625	0	70	80	0.8750000
NODE_5052_length_1098_cov_15.455455	545	625	2	10	80	0.1250000
NODE_5052_length_1098_cov_15.455455	598	678	0	17	80	0.2125000
NODE_5052_length_1098_cov_15.455455	598	678	2	60	80	0.7500000
NODE_5052_length_1098_cov_15.455455	598	678	4	3	80	0.0375000
NODE_5052_length_1098_cov_15.455455	674	754	2	1	80	0.0125000
NODE_5052_length_1098_cov_15.455455	674	754	4	79	80	0.9875000
NODE_5052_length_1098_cov_15.455455	727	807	2	42	80	0.5250000
NODE_5052_length_1098_cov_15.455455	727	807	4	38	80	0.4750000
NODE_5054_length_1097_cov_37.103206	438	518	0	50	80	0.6250000
NODE_5054_length_1097_cov_37.103206	438	518	2	30	80	0.3750000
NODE_5054_length_1097_cov_37.103206	491	571	0	10	80	0.1250000
NODE_5054_length_1097_cov_37.103206	491	571	2	70	80	0.8750000
NODE_5054_length_1097_cov_37.103206	567	647	0	80	80	1.0000000
NODE_5054_length_1097_cov_37.103206	620	700	0	80	80	1.0000000
NODE_5055_length_1097_cov_32.624248	501	581	0	80	80	1.0000000
NODE_5055_length_1097_cov_32.624248	554	634	0	73	80	0.9125000
NODE_5055_length_1097_cov_32.624248	554	634	2	7	80	0.0875000
NODE_5056_length_1097_cov_25.240481	401	480	0	79	79	1.0000000
NODE_5056_length_1097_cov_25.240481	453	533	0	80	80	1.0000000
NODE_5056_length_1097_cov_25.240481	529	609	0	19	80	0.2375000
NODE_5056_length_1097_cov_25.240481	529	609	2	61	80	0.7625000
NODE_5056_length_1097_cov_25.240481	582	662	0	32	80	0.4000000
NODE_5056_length_1097_cov_25.240481	582	662	2	48	80	0.6000000
NODE_5057_length_1097_cov_21.221443	484	564	0	80	80	1.0000000
NODE_5057_length_1097_cov_21.221443	537	617	0	80	80	1.0000000
NODE_5057_length_1097_cov_21.221443	613	693	0	80	80	1.0000000
NODE_5057_length_1097_cov_21.221443	666	746	0	80	80	1.0000000
NODE_5058_length_1097_cov_20.968938	515	595	0	80	80	1.0000000
NODE_5058_length_1097_cov_20.968938	568	648	0	80	80	1.0000000
NODE_5059_length_1097_cov_13.136273	697	779	0	82	82	1.0000000
NODE_5059_length_1097_cov_13.136273	752	832	0	80	80	1.0000000
NODE_5060_length_1097_cov_6.376754	442	522	2	80	80	1.0000000
NODE_5060_length_1097_cov_6.376754	495	575	1	34	80	0.4250000
NODE_5060_length_1097_cov_6.376754	495	575	2	46	80	0.5750000
NODE_5061_length_1097_cov_6.068136	299	379	0	80	80	1.0000000
NODE_5061_length_1097_cov_6.068136	352	432	0	80	80	1.0000000
NODE_5072_length_1096_cov_55.816449	430	510	0	80	80	1.0000000
NODE_5072_length_1096_cov_55.816449	483	563	0	44	80	0.5500000
NODE_5072_length_1096_cov_55.816449	483	563	6	36	80	0.4500000
NODE_5072_length_1096_cov_55.816449	559	639	6	80	80	1.0000000
NODE_5072_length_1096_cov_55.816449	612	692	0	43	80	0.5375000
NODE_5072_length_1096_cov_55.816449	612	692	6	37	80	0.4625000
NODE_5073_length_1096_cov_24.672016	431	511	0	80	80	1.0000000
NODE_5073_length_1096_cov_24.672016	484	564	0	80	80	1.0000000
NODE_5073_length_1096_cov_24.672016	560	640	0	80	80	1.0000000
NODE_5073_length_1096_cov_24.672016	613	693	0	80	80	1.0000000
NODE_5074_length_1096_cov_22.980943	372	452	4	80	80	1.0000000
NODE_5074_length_1096_cov_22.980943	425	505	0	18	80	0.2250000
NODE_5074_length_1096_cov_22.980943	425	505	3	1	80	0.0125000
NODE_5074_length_1096_cov_22.980943	425	505	4	61	80	0.7625000
NODE_5075_length_1096_cov_16.649950	486	566	0	80	80	1.0000000
NODE_5075_length_1096_cov_16.649950	539	619	0	80	80	1.0000000
NODE_5076_length_1096_cov_16.433300	443	523	0	80	80	1.0000000
NODE_5076_length_1096_cov_16.433300	496	576	0	80	80	1.0000000
NODE_5076_length_1096_cov_16.433300	886	966	0	80	80	1.0000000
NODE_5076_length_1096_cov_16.433300	939	1018	0	79	79	1.0000000
NODE_5077_length_1096_cov_13.398195	670	750	0	80	80	1.0000000
NODE_5077_length_1096_cov_13.398195	723	803	0	80	80	1.0000000
NODE_5080_length_1095_cov_25.390562	520	600	0	18	80	0.2250000
NODE_5080_length_1095_cov_25.390562	520	600	9	62	80	0.7750000
NODE_5080_length_1095_cov_25.390562	573	653	9	30	80	0.3750000
NODE_5080_length_1095_cov_25.390562	573	653	10	50	80	0.6250000
NODE_5080_length_1095_cov_25.390562	649	729	0	58	80	0.7250000
NODE_5080_length_1095_cov_25.390562	649	729	10	22	80	0.2750000
NODE_5080_length_1095_cov_25.390562	702	782	0	77	80	0.9625000
NODE_5080_length_1095_cov_25.390562	702	782	1	3	80	0.0375000
NODE_5081_length_1095_cov_13.832329	549	629	0	80	80	1.0000000
NODE_5081_length_1095_cov_13.832329	602	682	0	80	80	1.0000000
NODE_5082_length_1095_cov_13.017068	497	577	0	80	80	1.0000000
NODE_5082_length_1095_cov_13.017068	550	630	0	80	80	1.0000000
NODE_5083_length_1095_cov_7.640562	627	707	0	80	80	1.0000000
NODE_5083_length_1095_cov_7.640562	680	760	0	80	80	1.0000000
NODE_5085_length_1095_cov_4.664659	307	387	0	80	80	1.0000000
NODE_5089_length_1094_cov_35.850251	409	489	0	80	80	1.0000000
NODE_5089_length_1094_cov_35.850251	462	542	0	80	80	1.0000000
NODE_5089_length_1094_cov_35.850251	538	618	0	80	80	1.0000000
NODE_5089_length_1094_cov_35.850251	591	671	0	80	80	1.0000000
NODE_5090_length_1094_cov_27.197990	462	542	0	80	80	1.0000000
NODE_5090_length_1094_cov_27.197990	515	595	0	80	80	1.0000000
NODE_5091_length_1094_cov_19.282412	451	531	0	61	80	0.7625000
NODE_5091_length_1094_cov_19.282412	451	531	2	19	80	0.2375000
NODE_5091_length_1094_cov_19.282412	504	584	0	8	80	0.1000000
NODE_5091_length_1094_cov_19.282412	504	584	2	72	80	0.9000000
NODE_5092_length_1094_cov_16.084422	558	614	0	56	56	1.0000000
NODE_5092_length_1094_cov_16.084422	587	667	0	80	80	1.0000000
NODE_5093_length_1094_cov_11.335678	384	464	0	80	80	1.0000000
NODE_5093_length_1094_cov_11.335678	437	517	0	80	80	1.0000000
NODE_5094_length_1094_cov_10.767839	396	476	0	80	80	1.0000000
NODE_5094_length_1094_cov_10.767839	449	529	0	72	80	0.9000000
NODE_5094_length_1094_cov_10.767839	449	529	2	8	80	0.1000000
NODE_5095_length_1094_cov_9.527638	579	659	0	80	80	1.0000000
NODE_5095_length_1094_cov_9.527638	632	712	0	80	80	1.0000000
NODE_5096_length_1094_cov_9.166834	527	607	2	20	80	0.2500000
NODE_5096_length_1094_cov_9.166834	527	607	4	60	80	0.7500000
NODE_5096_length_1094_cov_9.166834	580	660	0	43	80	0.5375000
NODE_5096_length_1094_cov_9.166834	580	660	2	30	80	0.3750000
NODE_5096_length_1094_cov_9.166834	580	660	4	7	80	0.0875000
NODE_5097_length_1094_cov_5.632161	708	768	0	31	60	0.5166667
NODE_5097_length_1094_cov_5.632161	708	768	2	19	60	0.3166667
NODE_5097_length_1094_cov_5.632161	708	768	4	10	60	0.1666667
NODE_5097_length_1094_cov_5.632161	761	821	4	60	60	1.0000000
NODE_5108_length_1093_cov_28.531187	374	454	0	80	80	1.0000000
NODE_5108_length_1093_cov_28.531187	427	507	0	80	80	1.0000000
NODE_5109_length_1093_cov_22.744467	516	596	0	80	80	1.0000000
NODE_5109_length_1093_cov_22.744467	569	649	0	80	80	1.0000000
NODE_5109_length_1093_cov_22.744467	645	725	0	80	80	1.0000000
NODE_5109_length_1093_cov_22.744467	698	778	0	80	80	1.0000000
NODE_5110_length_1093_cov_11.637827	282	362	0	80	80	1.0000000
NODE_5110_length_1093_cov_11.637827	335	415	0	80	80	1.0000000
NODE_5111_length_1093_cov_9.047284	660	740	0	80	80	1.0000000
NODE_5111_length_1093_cov_9.047284	713	793	0	80	80	1.0000000
NODE_5112_length_1093_cov_6.857143	658	738	0	80	80	1.0000000
NODE_5112_length_1093_cov_6.857143	711	791	0	80	80	1.0000000
NODE_5113_length_1093_cov_5.311871	587	667	0	80	80	1.0000000
NODE_5113_length_1093_cov_5.311871	640	720	0	80	80	1.0000000
NODE_5118_length_1092_cov_105.542800	682	768	135	1	86	0.0116279
NODE_5118_length_1092_cov_105.542800	682	768	138	2	86	0.0232558
NODE_5118_length_1092_cov_105.542800	682	768	147	1	86	0.0116279
NODE_5118_length_1092_cov_105.542800	682	768	148	2	86	0.0232558
NODE_5118_length_1092_cov_105.542800	682	768	157	1	86	0.0116279
NODE_5118_length_1092_cov_105.542800	682	768	165	1	86	0.0116279
NODE_5118_length_1092_cov_105.542800	682	768	170	4	86	0.0465116
NODE_5118_length_1092_cov_105.542800	682	768	171	2	86	0.0232558
NODE_5118_length_1092_cov_105.542800	682	768	176	1	86	0.0116279
NODE_5118_length_1092_cov_105.542800	682	768	178	1	86	0.0116279
NODE_5118_length_1092_cov_105.542800	682	768	179	1	86	0.0116279
NODE_5118_length_1092_cov_105.542800	682	768	182	1	86	0.0116279
NODE_5118_length_1092_cov_105.542800	682	768	183	1	86	0.0116279
NODE_5118_length_1092_cov_105.542800	682	768	187	5	86	0.0581395
NODE_5118_length_1092_cov_105.542800	682	768	191	1	86	0.0116279
NODE_5118_length_1092_cov_105.542800	682	768	192	1	86	0.0116279
NODE_5118_length_1092_cov_105.542800	682	768	194	1	86	0.0116279
NODE_5118_length_1092_cov_105.542800	682	768	219	1	86	0.0116279
NODE_5118_length_1092_cov_105.542800	682	768	223	1	86	0.0116279
NODE_5118_length_1092_cov_105.542800	682	768	224	1	86	0.0116279
NODE_5118_length_1092_cov_105.542800	682	768	225	1	86	0.0116279
NODE_5118_length_1092_cov_105.542800	682	768	227	4	86	0.0465116
NODE_5118_length_1092_cov_105.542800	682	768	230	2	86	0.0232558
NODE_5118_length_1092_cov_105.542800	682	768	231	1	86	0.0116279
NODE_5118_length_1092_cov_105.542800	682	768	234	1	86	0.0116279
NODE_5118_length_1092_cov_105.542800	682	768	235	1	86	0.0116279
NODE_5118_length_1092_cov_105.542800	682	768	237	1	86	0.0116279
NODE_5118_length_1092_cov_105.542800	682	768	238	1	86	0.0116279
NODE_5118_length_1092_cov_105.542800	682	768	244	1	86	0.0116279
NODE_5118_length_1092_cov_105.542800	682	768	250	1	86	0.0116279
NODE_5118_length_1092_cov_105.542800	682	768	251	5	86	0.0581395
NODE_5118_length_1092_cov_105.542800	682	768	253	2	86	0.0232558
NODE_5118_length_1092_cov_105.542800	682	768	256	1	86	0.0116279
NODE_5118_length_1092_cov_105.542800	682	768	277	1	86	0.0116279
NODE_5118_length_1092_cov_105.542800	682	768	284	1	86	0.0116279
NODE_5118_length_1092_cov_105.542800	682	768	286	1	86	0.0116279
NODE_5118_length_1092_cov_105.542800	682	768	289	1	86	0.0116279
NODE_5118_length_1092_cov_105.542800	682	768	290	2	86	0.0232558
NODE_5118_length_1092_cov_105.542800	682	768	294	1	86	0.0116279
NODE_5118_length_1092_cov_105.542800	682	768	297	1	86	0.0116279
NODE_5118_length_1092_cov_105.542800	682	768	301	1	86	0.0116279
NODE_5118_length_1092_cov_105.542800	682	768	305	4	86	0.0465116
NODE_5118_length_1092_cov_105.542800	682	768	308	1	86	0.0116279
NODE_5118_length_1092_cov_105.542800	682	768	319	1	86	0.0116279
NODE_5118_length_1092_cov_105.542800	682	768	321	3	86	0.0348837
NODE_5118_length_1092_cov_105.542800	682	768	323	2	86	0.0232558
NODE_5118_length_1092_cov_105.542800	682	768	324	1	86	0.0116279
NODE_5118_length_1092_cov_105.542800	682	768	325	4	86	0.0465116
NODE_5118_length_1092_cov_105.542800	682	768	326	3	86	0.0348837
NODE_5118_length_1092_cov_105.542800	682	768	327	1	86	0.0116279
NODE_5118_length_1092_cov_105.542800	682	768	328	2	86	0.0232558
NODE_5118_length_1092_cov_105.542800	682	768	329	1	86	0.0116279
NODE_5118_length_1092_cov_105.542800	682	768	330	2	86	0.0232558
NODE_5118_length_1092_cov_105.542800	745	807	229	1	62	0.0161290
NODE_5118_length_1092_cov_105.542800	745	807	231	2	62	0.0322581
NODE_5118_length_1092_cov_105.542800	745	807	232	1	62	0.0161290
NODE_5118_length_1092_cov_105.542800	745	807	244	1	62	0.0161290
NODE_5118_length_1092_cov_105.542800	745	807	245	1	62	0.0161290
NODE_5118_length_1092_cov_105.542800	745	807	273	1	62	0.0161290
NODE_5118_length_1092_cov_105.542800	745	807	274	1	62	0.0161290
NODE_5118_length_1092_cov_105.542800	745	807	281	2	62	0.0322581
NODE_5118_length_1092_cov_105.542800	745	807	283	1	62	0.0161290
NODE_5118_length_1092_cov_105.542800	745	807	285	2	62	0.0322581
NODE_5118_length_1092_cov_105.542800	745	807	291	2	62	0.0322581
NODE_5118_length_1092_cov_105.542800	745	807	292	1	62	0.0161290
NODE_5118_length_1092_cov_105.542800	745	807	293	5	62	0.0806452
NODE_5118_length_1092_cov_105.542800	745	807	295	3	62	0.0483871
NODE_5118_length_1092_cov_105.542800	745	807	297	4	62	0.0645161
NODE_5118_length_1092_cov_105.542800	745	807	299	6	62	0.0967742
NODE_5118_length_1092_cov_105.542800	745	807	301	1	62	0.0161290
NODE_5118_length_1092_cov_105.542800	745	807	303	1	62	0.0161290
NODE_5118_length_1092_cov_105.542800	745	807	305	2	62	0.0322581
NODE_5118_length_1092_cov_105.542800	745	807	308	1	62	0.0161290
NODE_5118_length_1092_cov_105.542800	745	807	319	1	62	0.0161290
NODE_5118_length_1092_cov_105.542800	745	807	321	3	62	0.0483871
NODE_5118_length_1092_cov_105.542800	745	807	323	5	62	0.0806452
NODE_5118_length_1092_cov_105.542800	745	807	324	1	62	0.0161290
NODE_5118_length_1092_cov_105.542800	745	807	325	4	62	0.0645161
NODE_5118_length_1092_cov_105.542800	745	807	326	3	62	0.0483871
NODE_5118_length_1092_cov_105.542800	745	807	327	1	62	0.0161290
NODE_5118_length_1092_cov_105.542800	745	807	328	2	62	0.0322581
NODE_5118_length_1092_cov_105.542800	745	807	329	1	62	0.0161290
NODE_5118_length_1092_cov_105.542800	745	807	330	2	62	0.0322581
NODE_5119_length_1092_cov_30.957704	610	690	0	80	80	1.0000000
NODE_5119_length_1092_cov_30.957704	663	743	0	80	80	1.0000000
NODE_5121_length_1092_cov_16.737160	725	805	0	29	80	0.3625000
NODE_5121_length_1092_cov_16.737160	725	805	4	51	80	0.6375000
NODE_5121_length_1092_cov_16.737160	778	858	0	80	80	1.0000000
NODE_5123_length_1092_cov_11.193353	335	415	0	80	80	1.0000000
NODE_5123_length_1092_cov_11.193353	388	468	0	80	80	1.0000000
NODE_5124_length_1092_cov_9.348439	489	569	0	80	80	1.0000000
NODE_5124_length_1092_cov_9.348439	542	622	0	80	80	1.0000000
NODE_5125_length_1092_cov_7.533736	243	323	0	80	80	1.0000000
NODE_5125_length_1092_cov_7.533736	296	376	0	80	80	1.0000000
NODE_5126_length_1092_cov_6.968781	470	550	0	80	80	1.0000000
NODE_5126_length_1092_cov_6.968781	523	603	0	80	80	1.0000000
NODE_5134_length_1091_cov_54.234879	417	497	0	80	80	1.0000000
NODE_5134_length_1091_cov_54.234879	470	550	0	80	80	1.0000000
NODE_5134_length_1091_cov_54.234879	546	626	0	80	80	1.0000000
NODE_5134_length_1091_cov_54.234879	599	679	0	80	80	1.0000000
NODE_5135_length_1091_cov_35.045363	384	464	0	80	80	1.0000000
NODE_5135_length_1091_cov_35.045363	437	517	0	80	80	1.0000000
NODE_5135_length_1091_cov_35.045363	513	593	0	80	80	1.0000000
NODE_5135_length_1091_cov_35.045363	566	646	0	80	80	1.0000000
NODE_5136_length_1091_cov_28.490927	329	409	1	24	80	0.3000000
NODE_5136_length_1091_cov_28.490927	329	409	2	43	80	0.5375000
NODE_5136_length_1091_cov_28.490927	329	409	3	13	80	0.1625000
NODE_5136_length_1091_cov_28.490927	382	462	0	9	80	0.1125000
NODE_5136_length_1091_cov_28.490927	382	462	2	60	80	0.7500000
NODE_5136_length_1091_cov_28.490927	382	462	3	11	80	0.1375000
NODE_5136_length_1091_cov_28.490927	618	698	0	80	80	1.0000000
NODE_5136_length_1091_cov_28.490927	671	751	0	80	80	1.0000000
NODE_5137_length_1091_cov_23.733871	514	594	0	80	80	1.0000000
NODE_5137_length_1091_cov_23.733871	567	647	0	80	80	1.0000000
NODE_5138_length_1091_cov_13.065524	444	524	0	80	80	1.0000000
NODE_5138_length_1091_cov_13.065524	497	577	0	80	80	1.0000000
NODE_5139_length_1091_cov_10.961694	582	646	0	64	64	1.0000000
NODE_5140_length_1091_cov_8.166331	299	379	0	80	80	1.0000000
NODE_5140_length_1091_cov_8.166331	352	432	0	80	80	1.0000000
NODE_5141_length_1091_cov_7.006048	617	697	0	80	80	1.0000000
NODE_5141_length_1091_cov_7.006048	670	750	0	80	80	1.0000000
NODE_5151_length_1090_cov_73.781029	352	432	0	80	80	1.0000000
NODE_5151_length_1090_cov_73.781029	405	485	0	80	80	1.0000000
NODE_5151_length_1090_cov_73.781029	481	567	0	86	86	1.0000000
NODE_5151_length_1090_cov_73.781029	540	620	0	80	80	1.0000000
NODE_5152_length_1090_cov_42.394551	530	610	0	80	80	1.0000000
NODE_5152_length_1090_cov_42.394551	583	663	0	80	80	1.0000000
NODE_5153_length_1090_cov_37.643794	436	516	0	80	80	1.0000000
NODE_5153_length_1090_cov_37.643794	489	569	0	80	80	1.0000000
NODE_5153_length_1090_cov_37.643794	565	645	0	80	80	1.0000000
NODE_5153_length_1090_cov_37.643794	618	698	0	80	80	1.0000000
NODE_5154_length_1090_cov_32.876892	487	567	4	80	80	1.0000000
NODE_5154_length_1090_cov_32.876892	540	620	0	49	80	0.6125000
NODE_5154_length_1090_cov_32.876892	540	620	4	31	80	0.3875000
NODE_5155_length_1090_cov_25.373360	486	566	0	80	80	1.0000000
NODE_5155_length_1090_cov_25.373360	539	619	0	80	80	1.0000000
NODE_5156_length_1090_cov_21.290616	422	502	0	80	80	1.0000000
NODE_5156_length_1090_cov_21.290616	475	555	0	80	80	1.0000000
NODE_5156_length_1090_cov_21.290616	551	631	0	80	80	1.0000000
NODE_5156_length_1090_cov_21.290616	604	684	0	80	80	1.0000000
NODE_5157_length_1090_cov_16.040363	666	746	0	80	80	1.0000000
NODE_5157_length_1090_cov_16.040363	719	799	0	80	80	1.0000000
NODE_5158_length_1090_cov_14.826438	393	473	0	80	80	1.0000000
NODE_5158_length_1090_cov_14.826438	446	526	0	80	80	1.0000000
NODE_5159_length_1090_cov_13.721493	498	578	0	17	80	0.2125000
NODE_5159_length_1090_cov_13.721493	498	578	2	63	80	0.7875000
NODE_5159_length_1090_cov_13.721493	551	631	0	70	80	0.8750000
NODE_5159_length_1090_cov_13.721493	551	631	2	10	80	0.1250000
NODE_5160_length_1090_cov_12.365288	386	467	0	81	81	1.0000000
NODE_5160_length_1090_cov_12.365288	440	520	0	80	80	1.0000000
NODE_5160_length_1090_cov_12.365288	516	596	0	35	80	0.4375000
NODE_5160_length_1090_cov_12.365288	516	596	2	45	80	0.5625000
NODE_5160_length_1090_cov_12.365288	569	649	2	80	80	1.0000000
NODE_5161_length_1090_cov_5.348133	0	80	6	2	80	0.0250000
NODE_5161_length_1090_cov_5.348133	0	80	10	6	80	0.0750000
NODE_5161_length_1090_cov_5.348133	0	80	14	1	80	0.0125000
NODE_5161_length_1090_cov_5.348133	0	80	18	3	80	0.0375000
NODE_5161_length_1090_cov_5.348133	0	80	20	2	80	0.0250000
NODE_5161_length_1090_cov_5.348133	0	80	22	5	80	0.0625000
NODE_5161_length_1090_cov_5.348133	0	80	23	6	80	0.0750000
NODE_5161_length_1090_cov_5.348133	0	80	25	5	80	0.0625000
NODE_5161_length_1090_cov_5.348133	0	80	34	1	80	0.0125000
NODE_5161_length_1090_cov_5.348133	0	80	35	2	80	0.0250000
NODE_5161_length_1090_cov_5.348133	0	80	39	14	80	0.1750000
NODE_5161_length_1090_cov_5.348133	0	80	41	4	80	0.0500000
NODE_5161_length_1090_cov_5.348133	0	80	42	1	80	0.0125000
NODE_5161_length_1090_cov_5.348133	0	80	43	5	80	0.0625000
NODE_5161_length_1090_cov_5.348133	0	80	51	5	80	0.0625000
NODE_5161_length_1090_cov_5.348133	0	80	55	10	80	0.1250000
NODE_5161_length_1090_cov_5.348133	0	80	57	3	80	0.0375000
NODE_5161_length_1090_cov_5.348133	0	80	67	3	80	0.0375000
NODE_5161_length_1090_cov_5.348133	0	80	71	2	80	0.0250000
NODE_5161_length_1090_cov_5.348133	53	99	43	4	46	0.0869565
NODE_5161_length_1090_cov_5.348133	53	99	51	5	46	0.1086956
NODE_5161_length_1090_cov_5.348133	53	99	55	10	46	0.2173913
NODE_5161_length_1090_cov_5.348133	53	99	57	3	46	0.0652174
NODE_5161_length_1090_cov_5.348133	53	99	67	3	46	0.0652174
NODE_5161_length_1090_cov_5.348133	53	99	71	7	46	0.1521739
NODE_5161_length_1090_cov_5.348133	53	99	72	9	46	0.1956522
NODE_5161_length_1090_cov_5.348133	53	99	73	2	46	0.0434783
NODE_5161_length_1090_cov_5.348133	53	99	75	3	46	0.0652174
NODE_5163_length_1090_cov_3.598385	300	340	25	15	40	0.3750000
NODE_5163_length_1090_cov_3.598385	300	340	27	3	40	0.0750000
NODE_5163_length_1090_cov_3.598385	300	340	29	5	40	0.1250000
NODE_5163_length_1090_cov_3.598385	300	340	30	5	40	0.1250000
NODE_5163_length_1090_cov_3.598385	300	340	32	9	40	0.2250000
NODE_5163_length_1090_cov_3.598385	300	340	33	3	40	0.0750000
NODE_5170_length_1089_cov_55.374747	515	594	0	79	79	1.0000000
NODE_5170_length_1089_cov_55.374747	567	647	0	80	80	1.0000000
NODE_5170_length_1089_cov_55.374747	643	723	0	80	80	1.0000000
NODE_5170_length_1089_cov_55.374747	696	776	0	80	80	1.0000000
NODE_5171_length_1089_cov_38.506061	458	538	0	80	80	1.0000000
NODE_5171_length_1089_cov_38.506061	511	591	0	80	80	1.0000000
NODE_5171_length_1089_cov_38.506061	587	667	0	80	80	1.0000000
NODE_5171_length_1089_cov_38.506061	640	720	0	80	80	1.0000000
NODE_5172_length_1089_cov_22.657576	379	459	0	80	80	1.0000000
NODE_5172_length_1089_cov_22.657576	432	512	0	80	80	1.0000000
NODE_5173_length_1089_cov_21.180808	547	627	0	80	80	1.0000000
NODE_5173_length_1089_cov_21.180808	600	680	0	80	80	1.0000000
NODE_5174_length_1089_cov_18.713131	431	511	0	4	80	0.0500000
NODE_5174_length_1089_cov_18.713131	431	511	2	14	80	0.1750000
NODE_5174_length_1089_cov_18.713131	431	511	4	62	80	0.7750000
NODE_5174_length_1089_cov_18.713131	484	564	0	57	80	0.7125000
NODE_5174_length_1089_cov_18.713131	484	564	2	14	80	0.1750000
NODE_5174_length_1089_cov_18.713131	484	564	4	9	80	0.1125000
NODE_5174_length_1089_cov_18.713131	560	640	0	80	80	1.0000000
NODE_5174_length_1089_cov_18.713131	613	693	0	80	80	1.0000000
NODE_5175_length_1089_cov_17.382828	376	456	0	29	80	0.3625000
NODE_5175_length_1089_cov_17.382828	376	456	2	51	80	0.6375000
NODE_5175_length_1089_cov_17.382828	429	509	0	22	80	0.2750000
NODE_5175_length_1089_cov_17.382828	429	509	2	58	80	0.7250000
NODE_5175_length_1089_cov_17.382828	505	585	0	80	80	1.0000000
NODE_5175_length_1089_cov_17.382828	558	638	0	80	80	1.0000000
NODE_5176_length_1089_cov_14.540404	610	690	0	80	80	1.0000000
NODE_5176_length_1089_cov_14.540404	663	743	0	80	80	1.0000000
NODE_5182_length_1088_cov_10.603640	504	584	1	80	80	1.0000000
NODE_5182_length_1088_cov_10.603640	557	632	0	16	75	0.2133333
NODE_5182_length_1088_cov_10.603640	557	632	1	59	75	0.7866667
NODE_5194_length_1088_cov_0.759353	0	59	0	59	59	1.0000000
NODE_5194_length_1088_cov_0.759353	32	97	0	65	65	1.0000000
NODE_5195_length_1087_cov_51.676113	457	537	0	5	80	0.0625000
NODE_5195_length_1087_cov_51.676113	457	537	1	54	80	0.6750000
NODE_5195_length_1087_cov_51.676113	457	537	5	21	80	0.2625000
NODE_5195_length_1087_cov_51.676113	510	590	1	10	80	0.1250000
NODE_5195_length_1087_cov_51.676113	510	590	5	70	80	0.8750000
NODE_5195_length_1087_cov_51.676113	586	666	0	54	80	0.6750000
NODE_5195_length_1087_cov_51.676113	586	666	1	26	80	0.3250000
NODE_5195_length_1087_cov_51.676113	639	719	0	80	80	1.0000000
NODE_5196_length_1087_cov_47.144737	214	276	56	5	62	0.0806452
NODE_5196_length_1087_cov_47.144737	214	276	59	1	62	0.0161290
NODE_5196_length_1087_cov_47.144737	214	276	65	3	62	0.0483871
NODE_5196_length_1087_cov_47.144737	214	276	67	4	62	0.0645161
NODE_5196_length_1087_cov_47.144737	214	276	71	1	62	0.0161290
NODE_5196_length_1087_cov_47.144737	214	276	73	1	62	0.0161290
NODE_5196_length_1087_cov_47.144737	214	276	78	1	62	0.0161290
NODE_5196_length_1087_cov_47.144737	214	276	80	1	62	0.0161290
NODE_5196_length_1087_cov_47.144737	214	276	81	2	62	0.0322581
NODE_5196_length_1087_cov_47.144737	214	276	82	1	62	0.0161290
NODE_5196_length_1087_cov_47.144737	214	276	91	4	62	0.0645161
NODE_5196_length_1087_cov_47.144737	214	276	93	1	62	0.0161290
NODE_5196_length_1087_cov_47.144737	214	276	96	1	62	0.0161290
NODE_5196_length_1087_cov_47.144737	214	276	103	2	62	0.0322581
NODE_5196_length_1087_cov_47.144737	214	276	108	2	62	0.0322581
NODE_5196_length_1087_cov_47.144737	214	276	112	1	62	0.0161290
NODE_5196_length_1087_cov_47.144737	214	276	117	1	62	0.0161290
NODE_5196_length_1087_cov_47.144737	214	276	125	1	62	0.0161290
NODE_5196_length_1087_cov_47.144737	214	276	128	1	62	0.0161290
NODE_5196_length_1087_cov_47.144737	214	276	132	3	62	0.0483871
NODE_5196_length_1087_cov_47.144737	214	276	134	1	62	0.0161290
NODE_5196_length_1087_cov_47.144737	214	276	135	4	62	0.0645161
NODE_5196_length_1087_cov_47.144737	214	276	139	1	62	0.0161290
NODE_5196_length_1087_cov_47.144737	214	276	140	1	62	0.0161290
NODE_5196_length_1087_cov_47.144737	214	276	141	1	62	0.0161290
NODE_5196_length_1087_cov_47.144737	214	276	143	6	62	0.0967742
NODE_5196_length_1087_cov_47.144737	214	276	145	6	62	0.0967742
NODE_5196_length_1087_cov_47.144737	214	276	147	5	62	0.0806452
NODE_5196_length_1087_cov_47.144737	630	710	0	80	80	1.0000000
NODE_5196_length_1087_cov_47.144737	683	763	0	34	80	0.4250000
NODE_5196_length_1087_cov_47.144737	683	763	2	46	80	0.5750000
NODE_5197_length_1087_cov_46.633603	871	951	0	80	80	1.0000000
NODE_5197_length_1087_cov_46.633603	924	999	0	75	75	1.0000000
NODE_5198_length_1087_cov_30.577935	528	608	0	67	80	0.8375000
NODE_5198_length_1087_cov_30.577935	528	608	4	13	80	0.1625000
NODE_5198_length_1087_cov_30.577935	581	661	0	14	80	0.1750000
NODE_5198_length_1087_cov_30.577935	581	661	4	66	80	0.8250000
NODE_5199_length_1087_cov_30.205466	515	591	0	61	76	0.8026316
NODE_5199_length_1087_cov_30.205466	515	591	1	15	76	0.1973684
NODE_5199_length_1087_cov_30.205466	564	644	0	66	80	0.8250000
NODE_5199_length_1087_cov_30.205466	564	644	1	14	80	0.1750000
NODE_5200_length_1087_cov_29.595142	568	648	0	80	80	1.0000000
NODE_5200_length_1087_cov_29.595142	621	701	0	80	80	1.0000000
NODE_5201_length_1087_cov_11.600202	374	454	0	80	80	1.0000000
NODE_5201_length_1087_cov_11.600202	427	507	0	80	80	1.0000000
NODE_5202_length_1087_cov_7.746964	436	516	0	80	80	1.0000000
NODE_5202_length_1087_cov_7.746964	489	569	0	80	80	1.0000000
NODE_5211_length_1086_cov_35.748734	406	486	1	67	80	0.8375000
NODE_5211_length_1086_cov_35.748734	406	486	2	13	80	0.1625000
NODE_5211_length_1086_cov_35.748734	459	539	1	56	80	0.7000000
NODE_5211_length_1086_cov_35.748734	459	539	2	24	80	0.3000000
NODE_5212_length_1086_cov_18.445795	325	405	0	80	80	1.0000000
NODE_5212_length_1086_cov_18.445795	378	458	0	80	80	1.0000000
NODE_5213_length_1086_cov_16.878419	528	608	0	80	80	1.0000000
NODE_5213_length_1086_cov_16.878419	581	661	0	80	80	1.0000000
NODE_5214_length_1086_cov_10.700101	498	578	0	80	80	1.0000000
NODE_5214_length_1086_cov_10.700101	551	631	0	80	80	1.0000000
NODE_5215_length_1086_cov_10.656535	277	357	0	80	80	1.0000000
NODE_5215_length_1086_cov_10.656535	330	410	0	80	80	1.0000000
NODE_5216_length_1086_cov_6.873354	374	454	0	80	80	1.0000000
NODE_5216_length_1086_cov_6.873354	427	507	0	80	80	1.0000000
NODE_5217_length_1086_cov_5.225937	869	949	0	80	80	1.0000000
NODE_5217_length_1086_cov_5.225937	922	1002	0	58	80	0.7250000
NODE_5217_length_1086_cov_5.225937	922	1002	4	22	80	0.2750000
NODE_5229_length_1085_cov_30.599391	515	595	0	80	80	1.0000000
NODE_5229_length_1085_cov_30.599391	568	648	0	67	80	0.8375000
NODE_5229_length_1085_cov_30.599391	568	648	2	13	80	0.1625000
NODE_5231_length_1085_cov_13.723124	558	638	0	80	80	1.0000000
NODE_5231_length_1085_cov_13.723124	611	691	0	80	80	1.0000000
NODE_5232_length_1085_cov_12.481744	576	656	0	80	80	1.0000000
NODE_5232_length_1085_cov_12.481744	629	709	0	80	80	1.0000000
NODE_5233_length_1085_cov_11.570994	553	633	0	80	80	1.0000000
NODE_5233_length_1085_cov_11.570994	606	686	0	80	80	1.0000000
NODE_5234_length_1085_cov_10.730223	273	353	0	80	80	1.0000000
NODE_5234_length_1085_cov_10.730223	326	406	0	70	80	0.8750000
NODE_5234_length_1085_cov_10.730223	326	406	4	10	80	0.1250000
NODE_5234_length_1085_cov_10.730223	402	482	4	15	80	0.1875000
NODE_5234_length_1085_cov_10.730223	402	482	10	4	80	0.0500000
NODE_5234_length_1085_cov_10.730223	402	482	14	61	80	0.7625000
NODE_5234_length_1085_cov_10.730223	455	535	0	10	80	0.1250000
NODE_5234_length_1085_cov_10.730223	455	535	6	1	80	0.0125000
NODE_5234_length_1085_cov_10.730223	455	535	10	36	80	0.4500000
NODE_5234_length_1085_cov_10.730223	455	535	14	33	80	0.4125000
NODE_5234_length_1085_cov_10.730223	832	908	8	2	76	0.0263158
NODE_5234_length_1085_cov_10.730223	832	908	10	8	76	0.1052632
NODE_5234_length_1085_cov_10.730223	832	908	12	17	76	0.2236842
NODE_5234_length_1085_cov_10.730223	832	908	14	1	76	0.0131579
NODE_5234_length_1085_cov_10.730223	832	908	18	1	76	0.0131579
NODE_5234_length_1085_cov_10.730223	832	908	20	11	76	0.1447368
NODE_5234_length_1085_cov_10.730223	832	908	30	10	76	0.1315790
NODE_5234_length_1085_cov_10.730223	832	908	32	7	76	0.0921053
NODE_5234_length_1085_cov_10.730223	832	908	34	19	76	0.2500000
NODE_5236_length_1085_cov_8.309331	400	480	0	80	80	1.0000000
NODE_5236_length_1085_cov_8.309331	453	533	0	80	80	1.0000000
NODE_5248_length_1084_cov_60.255838	446	524	0	78	78	1.0000000
NODE_5248_length_1084_cov_60.255838	497	577	0	80	80	1.0000000
NODE_5249_length_1084_cov_33.332995	445	525	0	40	80	0.5000000
NODE_5249_length_1084_cov_33.332995	445	525	2	40	80	0.5000000
NODE_5249_length_1084_cov_33.332995	498	578	0	80	80	1.0000000
NODE_5250_length_1084_cov_11.004061	757	837	0	80	80	1.0000000
NODE_5250_length_1084_cov_11.004061	810	890	0	80	80	1.0000000
NODE_5258_length_1083_cov_42.182927	451	531	0	80	80	1.0000000
NODE_5258_length_1083_cov_42.182927	504	584	0	80	80	1.0000000
NODE_5258_length_1083_cov_42.182927	580	660	0	48	80	0.6000000
NODE_5258_length_1083_cov_42.182927	580	660	6	32	80	0.4000000
NODE_5258_length_1083_cov_42.182927	633	713	2	21	80	0.2625000
NODE_5258_length_1083_cov_42.182927	633	713	6	34	80	0.4250000
NODE_5258_length_1083_cov_42.182927	633	713	8	25	80	0.3125000
NODE_5259_length_1083_cov_41.163618	275	355	0	32	80	0.4000000
NODE_5259_length_1083_cov_41.163618	275	355	2	48	80	0.6000000
NODE_5259_length_1083_cov_41.163618	328	408	0	26	80	0.3250000
NODE_5259_length_1083_cov_41.163618	328	408	2	54	80	0.6750000
NODE_5259_length_1083_cov_41.163618	404	484	0	80	80	1.0000000
NODE_5259_length_1083_cov_41.163618	457	537	0	80	80	1.0000000
NODE_5260_length_1083_cov_39.798780	527	607	0	64	80	0.8000000
NODE_5260_length_1083_cov_39.798780	527	607	4	16	80	0.2000000
NODE_5260_length_1083_cov_39.798780	580	660	0	24	80	0.3000000
NODE_5260_length_1083_cov_39.798780	580	660	4	56	80	0.7000000
NODE_5261_length_1083_cov_34.261179	475	555	2	29	80	0.3625000
NODE_5261_length_1083_cov_34.261179	475	555	6	45	80	0.5625000
NODE_5261_length_1083_cov_34.261179	475	555	9	4	80	0.0500000
NODE_5261_length_1083_cov_34.261179	475	555	10	2	80	0.0250000
NODE_5261_length_1083_cov_34.261179	528	608	6	21	80	0.2625000
NODE_5261_length_1083_cov_34.261179	528	608	8	50	80	0.6250000
NODE_5261_length_1083_cov_34.261179	528	608	9	7	80	0.0875000
NODE_5261_length_1083_cov_34.261179	528	608	10	2	80	0.0250000
NODE_5262_length_1083_cov_33.573171	486	566	0	80	80	1.0000000
NODE_5262_length_1083_cov_33.573171	539	619	0	80	80	1.0000000
NODE_5262_length_1083_cov_33.573171	615	695	0	80	80	1.0000000
NODE_5262_length_1083_cov_33.573171	668	748	0	80	80	1.0000000
NODE_5263_length_1083_cov_33.091463	452	532	0	80	80	1.0000000
NODE_5263_length_1083_cov_33.091463	505	585	0	80	80	1.0000000
NODE_5264_length_1083_cov_30.982724	550	630	0	80	80	1.0000000
NODE_5264_length_1083_cov_30.982724	603	683	0	80	80	1.0000000
NODE_5265_length_1083_cov_18.819106	586	666	0	80	80	1.0000000
NODE_5265_length_1083_cov_18.819106	639	719	0	80	80	1.0000000
NODE_5266_length_1083_cov_17.278455	408	488	0	80	80	1.0000000
NODE_5266_length_1083_cov_17.278455	461	541	0	80	80	1.0000000
NODE_5267_length_1083_cov_13.862805	481	561	0	80	80	1.0000000
NODE_5267_length_1083_cov_13.862805	534	614	0	80	80	1.0000000
NODE_5268_length_1083_cov_13.083333	522	602	0	43	80	0.5375000
NODE_5268_length_1083_cov_13.083333	522	602	12	2	80	0.0250000
NODE_5268_length_1083_cov_13.083333	522	602	22	35	80	0.4375000
NODE_5268_length_1083_cov_13.083333	575	655	22	80	80	1.0000000
NODE_5269_length_1083_cov_11.824187	242	322	0	80	80	1.0000000
NODE_5269_length_1083_cov_11.824187	295	375	0	80	80	1.0000000
NODE_5271_length_1083_cov_3.025407	359	439	0	80	80	1.0000000
NODE_5271_length_1083_cov_3.025407	412	489	0	77	77	1.0000000
NODE_5277_length_1082_cov_34.664293	461	541	0	80	80	1.0000000
NODE_5277_length_1082_cov_34.664293	514	594	0	80	80	1.0000000
NODE_5278_length_1082_cov_17.422177	406	486	0	80	80	1.0000000
NODE_5278_length_1082_cov_17.422177	459	539	0	80	80	1.0000000
NODE_5279_length_1082_cov_15.906409	442	522	0	10	80	0.1250000
NODE_5279_length_1082_cov_15.906409	442	522	2	70	80	0.8750000
NODE_5279_length_1082_cov_15.906409	495	575	2	38	80	0.4750000
NODE_5279_length_1082_cov_15.906409	495	575	6	35	80	0.4375000
NODE_5279_length_1082_cov_15.906409	495	575	8	7	80	0.0875000
NODE_5280_length_1082_cov_13.703967	324	404	0	80	80	1.0000000
NODE_5280_length_1082_cov_13.703967	377	457	0	80	80	1.0000000
NODE_5281_length_1082_cov_6.478128	159	205	0	8	46	0.1739130
NODE_5281_length_1082_cov_6.478128	159	205	2	26	46	0.5652174
NODE_5281_length_1082_cov_6.478128	159	205	4	12	46	0.2608696
NODE_5281_length_1082_cov_6.478128	203	283	0	7	80	0.0875000
NODE_5281_length_1082_cov_6.478128	203	283	2	25	80	0.3125000
NODE_5281_length_1082_cov_6.478128	203	283	6	48	80	0.6000000
NODE_5281_length_1082_cov_6.478128	256	336	0	9	80	0.1125000
NODE_5281_length_1082_cov_6.478128	256	336	2	6	80	0.0750000
NODE_5281_length_1082_cov_6.478128	256	336	4	2	80	0.0250000
NODE_5281_length_1082_cov_6.478128	256	336	6	63	80	0.7875000
NODE_5281_length_1082_cov_6.478128	861	941	0	80	80	1.0000000
NODE_5282_length_1082_cov_4.218718	982	1062	66	2	80	0.0250000
NODE_5282_length_1082_cov_4.218718	982	1062	68	1	80	0.0125000
NODE_5282_length_1082_cov_4.218718	982	1062	71	1	80	0.0125000
NODE_5282_length_1082_cov_4.218718	982	1062	85	1	80	0.0125000
NODE_5282_length_1082_cov_4.218718	982	1062	87	2	80	0.0250000
NODE_5282_length_1082_cov_4.218718	982	1062	89	3	80	0.0375000
NODE_5282_length_1082_cov_4.218718	982	1062	95	2	80	0.0250000
NODE_5282_length_1082_cov_4.218718	982	1062	97	1	80	0.0125000
NODE_5282_length_1082_cov_4.218718	982	1062	98	2	80	0.0250000
NODE_5282_length_1082_cov_4.218718	982	1062	106	1	80	0.0125000
NODE_5282_length_1082_cov_4.218718	982	1062	108	1	80	0.0125000
NODE_5282_length_1082_cov_4.218718	982	1062	113	1	80	0.0125000
NODE_5282_length_1082_cov_4.218718	982	1062	120	1	80	0.0125000
NODE_5282_length_1082_cov_4.218718	982	1062	126	1	80	0.0125000
NODE_5282_length_1082_cov_4.218718	982	1062	132	1	80	0.0125000
NODE_5282_length_1082_cov_4.218718	982	1062	139	1	80	0.0125000
NODE_5282_length_1082_cov_4.218718	982	1062	141	1	80	0.0125000
NODE_5282_length_1082_cov_4.218718	982	1062	144	1	80	0.0125000
NODE_5282_length_1082_cov_4.218718	982	1062	145	3	80	0.0375000
NODE_5282_length_1082_cov_4.218718	982	1062	146	4	80	0.0500000
NODE_5282_length_1082_cov_4.218718	982	1062	148	3	80	0.0375000
NODE_5282_length_1082_cov_4.218718	982	1062	152	1	80	0.0125000
NODE_5282_length_1082_cov_4.218718	982	1062	154	1	80	0.0125000
NODE_5282_length_1082_cov_4.218718	982	1062	161	1	80	0.0125000
NODE_5282_length_1082_cov_4.218718	982	1062	167	1	80	0.0125000
NODE_5282_length_1082_cov_4.218718	982	1062	171	2	80	0.0250000
NODE_5282_length_1082_cov_4.218718	982	1062	181	1	80	0.0125000
NODE_5282_length_1082_cov_4.218718	982	1062	183	2	80	0.0250000
NODE_5282_length_1082_cov_4.218718	982	1062	187	1	80	0.0125000
NODE_5282_length_1082_cov_4.218718	982	1062	193	2	80	0.0250000
NODE_5282_length_1082_cov_4.218718	982	1062	201	1	80	0.0125000
NODE_5282_length_1082_cov_4.218718	982	1062	203	5	80	0.0625000
NODE_5282_length_1082_cov_4.218718	982	1062	204	2	80	0.0250000
NODE_5282_length_1082_cov_4.218718	982	1062	206	1	80	0.0125000
NODE_5282_length_1082_cov_4.218718	982	1062	207	1	80	0.0125000
NODE_5282_length_1082_cov_4.218718	982	1062	212	1	80	0.0125000
NODE_5282_length_1082_cov_4.218718	982	1062	214	1	80	0.0125000
NODE_5282_length_1082_cov_4.218718	982	1062	217	1	80	0.0125000
NODE_5282_length_1082_cov_4.218718	982	1062	219	1	80	0.0125000
NODE_5282_length_1082_cov_4.218718	982	1062	221	2	80	0.0250000
NODE_5282_length_1082_cov_4.218718	982	1062	225	1	80	0.0125000
NODE_5282_length_1082_cov_4.218718	982	1062	232	1	80	0.0125000
NODE_5282_length_1082_cov_4.218718	982	1062	242	1	80	0.0125000
NODE_5282_length_1082_cov_4.218718	982	1062	248	3	80	0.0375000
NODE_5282_length_1082_cov_4.218718	982	1062	250	1	80	0.0125000
NODE_5282_length_1082_cov_4.218718	982	1062	251	3	80	0.0375000
NODE_5282_length_1082_cov_4.218718	982	1062	253	1	80	0.0125000
NODE_5282_length_1082_cov_4.218718	982	1062	256	1	80	0.0125000
NODE_5282_length_1082_cov_4.218718	982	1062	262	3	80	0.0375000
NODE_5282_length_1082_cov_4.218718	982	1062	263	2	80	0.0250000
NODE_5282_length_1082_cov_4.218718	982	1062	267	1	80	0.0125000
NODE_5291_length_1081_cov_45.308554	510	590	0	12	80	0.1500000
NODE_5291_length_1081_cov_45.308554	510	590	2	68	80	0.8500000
NODE_5291_length_1081_cov_45.308554	563	643	0	8	80	0.1000000
NODE_5291_length_1081_cov_45.308554	563	643	2	72	80	0.9000000
NODE_5292_length_1081_cov_39.581466	476	556	0	36	80	0.4500000
NODE_5292_length_1081_cov_39.581466	476	556	2	44	80	0.5500000
NODE_5292_length_1081_cov_39.581466	529	609	0	80	80	1.0000000
NODE_5292_length_1081_cov_39.581466	605	685	0	80	80	1.0000000
NODE_5292_length_1081_cov_39.581466	658	738	0	30	80	0.3750000
NODE_5292_length_1081_cov_39.581466	658	738	2	50	80	0.6250000
NODE_5293_length_1081_cov_39.457230	373	453	0	80	80	1.0000000
NODE_5293_length_1081_cov_39.457230	426	506	0	80	80	1.0000000
NODE_5294_length_1081_cov_20.415479	376	451	0	75	75	1.0000000
NODE_5294_length_1081_cov_20.415479	436	511	0	75	75	1.0000000
NODE_5294_length_1081_cov_20.415479	496	571	0	75	75	1.0000000
NODE_5294_length_1081_cov_20.415479	544	624	0	80	80	1.0000000
NODE_5295_length_1081_cov_19.985743	378	458	0	80	80	1.0000000
NODE_5295_length_1081_cov_19.985743	431	511	0	80	80	1.0000000
NODE_5295_length_1081_cov_19.985743	507	587	0	80	80	1.0000000
NODE_5295_length_1081_cov_19.985743	560	640	0	80	80	1.0000000
NODE_5296_length_1081_cov_12.658859	468	548	0	80	80	1.0000000
NODE_5296_length_1081_cov_12.658859	521	601	0	80	80	1.0000000
NODE_5299_length_1081_cov_2.586558	7	44	0	37	37	1.0000000
NODE_5304_length_1080_cov_27.857288	261	341	0	23	80	0.2875000
NODE_5304_length_1080_cov_27.857288	261	341	2	57	80	0.7125000
NODE_5304_length_1080_cov_27.857288	314	394	0	76	80	0.9500000
NODE_5304_length_1080_cov_27.857288	314	394	2	4	80	0.0500000
NODE_5305_length_1080_cov_24.258919	321	401	0	80	80	1.0000000
NODE_5305_length_1080_cov_24.258919	374	454	0	49	80	0.6125000
NODE_5305_length_1080_cov_24.258919	374	454	6	31	80	0.3875000
NODE_5305_length_1080_cov_24.258919	450	530	6	80	80	1.0000000
NODE_5305_length_1080_cov_24.258919	503	583	0	43	80	0.5375000
NODE_5305_length_1080_cov_24.258919	503	583	6	37	80	0.4625000
NODE_5306_length_1080_cov_22.589195	446	526	0	80	80	1.0000000
NODE_5306_length_1080_cov_22.589195	499	579	0	80	80	1.0000000
NODE_5306_length_1080_cov_22.589195	575	655	0	80	80	1.0000000
NODE_5306_length_1080_cov_22.589195	628	708	0	80	80	1.0000000
NODE_5307_length_1080_cov_15.544343	599	679	0	80	80	1.0000000
NODE_5307_length_1080_cov_15.544343	652	732	0	80	80	1.0000000
NODE_5308_length_1080_cov_10.416922	321	401	0	80	80	1.0000000
NODE_5308_length_1080_cov_10.416922	374	454	0	80	80	1.0000000
NODE_5315_length_1079_cov_55.352041	367	447	0	80	80	1.0000000
NODE_5315_length_1079_cov_55.352041	420	500	0	80	80	1.0000000
NODE_5315_length_1079_cov_55.352041	496	576	0	80	80	1.0000000
NODE_5315_length_1079_cov_55.352041	549	629	0	39	80	0.4875000
NODE_5315_length_1079_cov_55.352041	549	629	2	10	80	0.1250000
NODE_5315_length_1079_cov_55.352041	549	629	4	31	80	0.3875000
NODE_5316_length_1079_cov_46.879592	444	524	0	80	80	1.0000000
NODE_5316_length_1079_cov_46.879592	497	577	0	80	80	1.0000000
NODE_5316_length_1079_cov_46.879592	573	652	0	79	79	1.0000000
NODE_5316_length_1079_cov_46.879592	625	703	0	78	78	1.0000000
NODE_5317_length_1079_cov_13.708163	611	691	0	14	80	0.1750000
NODE_5317_length_1079_cov_13.708163	611	691	2	66	80	0.8250000
NODE_5317_length_1079_cov_13.708163	664	744	0	18	80	0.2250000
NODE_5317_length_1079_cov_13.708163	664	744	2	62	80	0.7750000
NODE_5318_length_1079_cov_8.632653	416	496	0	80	80	1.0000000
NODE_5318_length_1079_cov_8.632653	469	549	0	80	80	1.0000000
NODE_5325_length_1078_cov_27.804903	357	437	0	80	80	1.0000000
NODE_5325_length_1078_cov_27.804903	410	490	0	80	80	1.0000000
NODE_5326_length_1078_cov_26.071502	459	539	0	80	80	1.0000000
NODE_5326_length_1078_cov_26.071502	512	592	0	80	80	1.0000000
NODE_5326_length_1078_cov_26.071502	588	668	0	38	80	0.4750000
NODE_5326_length_1078_cov_26.071502	588	668	10	42	80	0.5250000
NODE_5326_length_1078_cov_26.071502	641	718	10	77	77	1.0000000
NODE_5327_length_1078_cov_14.985700	495	575	0	80	80	1.0000000
NODE_5327_length_1078_cov_14.985700	548	628	0	80	80	1.0000000
NODE_5333_length_1077_cov_23.876278	546	626	0	80	80	1.0000000
NODE_5333_length_1077_cov_23.876278	599	679	0	80	80	1.0000000
NODE_5334_length_1077_cov_16.067485	532	612	0	80	80	1.0000000
NODE_5334_length_1077_cov_16.067485	585	665	0	80	80	1.0000000
NODE_5335_length_1077_cov_14.568507	556	636	0	5	80	0.0625000
NODE_5335_length_1077_cov_14.568507	556	636	4	75	80	0.9375000
NODE_5335_length_1077_cov_14.568507	609	689	0	58	80	0.7250000
NODE_5335_length_1077_cov_14.568507	609	689	4	22	80	0.2750000
NODE_5336_length_1077_cov_9.507157	496	576	0	80	80	1.0000000
NODE_5336_length_1077_cov_9.507157	549	629	0	63	80	0.7875000
NODE_5336_length_1077_cov_9.507157	549	629	2	17	80	0.2125000
NODE_5342_length_1077_cov_1.781186	252	274	0	22	22	1.0000000
NODE_5345_length_1076_cov_20.592631	534	614	0	80	80	1.0000000
NODE_5345_length_1076_cov_20.592631	587	667	0	80	80	1.0000000
NODE_5346_length_1076_cov_14.788127	427	507	0	80	80	1.0000000
NODE_5346_length_1076_cov_14.788127	480	560	0	80	80	1.0000000
NODE_5348_length_1076_cov_6.306039	883	961	0	78	78	1.0000000
NODE_5348_length_1076_cov_6.306039	936	1014	0	78	78	1.0000000
NODE_5357_length_1075_cov_37.941598	550	630	0	10	80	0.1250000
NODE_5357_length_1075_cov_37.941598	550	630	2	70	80	0.8750000
NODE_5357_length_1075_cov_37.941598	603	685	0	65	82	0.7926829
NODE_5357_length_1075_cov_37.941598	603	685	2	17	82	0.2073171
NODE_5357_length_1075_cov_37.941598	681	761	0	80	80	1.0000000
NODE_5357_length_1075_cov_37.941598	734	814	0	80	80	1.0000000
NODE_5358_length_1075_cov_32.224385	397	477	0	80	80	1.0000000
NODE_5358_length_1075_cov_32.224385	450	530	0	80	80	1.0000000
NODE_5359_length_1075_cov_9.626025	440	520	0	80	80	1.0000000
NODE_5359_length_1075_cov_9.626025	493	573	0	80	80	1.0000000
NODE_5362_length_1075_cov_2.926230	38	99	0	61	61	1.0000000
NODE_5372_length_1074_cov_19.034872	568	648	0	27	80	0.3375000
NODE_5372_length_1074_cov_19.034872	568	648	2	53	80	0.6625000
NODE_5372_length_1074_cov_19.034872	621	701	0	80	80	1.0000000
NODE_5372_length_1074_cov_19.034872	697	777	0	80	80	1.0000000
NODE_5372_length_1074_cov_19.034872	750	830	0	80	80	1.0000000
NODE_5373_length_1074_cov_9.450256	577	657	0	58	80	0.7250000
NODE_5373_length_1074_cov_9.450256	577	657	2	22	80	0.2750000
NODE_5373_length_1074_cov_9.450256	630	710	0	80	80	1.0000000
NODE_5374_length_1074_cov_9.155897	526	606	4	80	80	1.0000000
NODE_5374_length_1074_cov_9.155897	579	659	0	8	80	0.1000000
NODE_5374_length_1074_cov_9.155897	579	659	4	72	80	0.9000000
NODE_5374_length_1074_cov_9.155897	655	735	0	80	80	1.0000000
NODE_5374_length_1074_cov_9.155897	708	788	0	65	80	0.8125000
NODE_5374_length_1074_cov_9.155897	708	788	4	15	80	0.1875000
NODE_5375_length_1074_cov_4.600000	606	686	0	80	80	1.0000000
NODE_5375_length_1074_cov_4.600000	659	739	0	80	80	1.0000000
NODE_5376_length_1074_cov_4.328205	32	112	12	2	80	0.0250000
NODE_5376_length_1074_cov_4.328205	32	112	14	7	80	0.0875000
NODE_5376_length_1074_cov_4.328205	32	112	16	41	80	0.5125000
NODE_5376_length_1074_cov_4.328205	32	112	18	7	80	0.0875000
NODE_5376_length_1074_cov_4.328205	32	112	20	1	80	0.0125000
NODE_5376_length_1074_cov_4.328205	32	112	22	22	80	0.2750000
NODE_5380_length_1073_cov_60.012320	448	528	0	80	80	1.0000000
NODE_5380_length_1073_cov_60.012320	501	581	0	80	80	1.0000000
NODE_5382_length_1073_cov_26.415811	529	609	0	80	80	1.0000000
NODE_5382_length_1073_cov_26.415811	582	662	0	80	80	1.0000000
NODE_5383_length_1073_cov_19.062628	571	651	0	77	80	0.9625000
NODE_5383_length_1073_cov_19.062628	571	651	2	3	80	0.0375000
NODE_5383_length_1073_cov_19.062628	624	704	0	80	80	1.0000000
NODE_5384_length_1073_cov_18.536961	447	527	0	80	80	1.0000000
NODE_5384_length_1073_cov_18.536961	500	580	0	32	80	0.4000000
NODE_5384_length_1073_cov_18.536961	500	580	4	48	80	0.6000000
NODE_5384_length_1073_cov_18.536961	576	656	0	19	80	0.2375000
NODE_5384_length_1073_cov_18.536961	576	656	4	61	80	0.7625000
NODE_5384_length_1073_cov_18.536961	629	709	0	72	80	0.9000000
NODE_5384_length_1073_cov_18.536961	629	709	4	8	80	0.1000000
NODE_5385_length_1073_cov_15.318275	712	792	0	27	80	0.3375000
NODE_5385_length_1073_cov_15.318275	712	792	2	53	80	0.6625000
NODE_5385_length_1073_cov_15.318275	765	845	0	55	80	0.6875000
NODE_5385_length_1073_cov_15.318275	765	845	2	25	80	0.3125000
NODE_5386_length_1073_cov_8.376797	287	367	0	80	80	1.0000000
NODE_5386_length_1073_cov_8.376797	340	420	0	80	80	1.0000000
NODE_5387_length_1073_cov_5.749487	257	337	0	80	80	1.0000000
NODE_5387_length_1073_cov_5.749487	310	390	0	80	80	1.0000000
NODE_5388_length_1073_cov_5.156057	408	444	2	30	36	0.8333333
NODE_5388_length_1073_cov_5.156057	408	444	4	6	36	0.1666667
NODE_5390_length_1073_cov_3.019507	1	69	0	68	68	1.0000000
NODE_5390_length_1073_cov_3.019507	42	122	0	80	80	1.0000000
NODE_5399_length_1072_cov_62.729702	351	431	0	80	80	1.0000000
NODE_5399_length_1072_cov_62.729702	404	484	0	80	80	1.0000000
NODE_5399_length_1072_cov_62.729702	480	560	0	80	80	1.0000000
NODE_5399_length_1072_cov_62.729702	533	613	0	80	80	1.0000000
NODE_5400_length_1072_cov_34.045221	430	510	0	80	80	1.0000000
NODE_5400_length_1072_cov_34.045221	483	563	0	80	80	1.0000000
NODE_5401_length_1072_cov_34.006166	342	423	0	3	81	0.0370370
NODE_5401_length_1072_cov_34.006166	342	423	2	63	81	0.7777778
NODE_5401_length_1072_cov_34.006166	342	423	7	1	81	0.0123457
NODE_5401_length_1072_cov_34.006166	342	423	8	14	81	0.1728395
NODE_5401_length_1072_cov_34.006166	396	476	2	12	80	0.1500000
NODE_5401_length_1072_cov_34.006166	396	476	6	7	80	0.0875000
NODE_5401_length_1072_cov_34.006166	396	476	7	1	80	0.0125000
NODE_5401_length_1072_cov_34.006166	396	476	8	60	80	0.7500000
NODE_5401_length_1072_cov_34.006166	472	552	0	34	80	0.4250000
NODE_5401_length_1072_cov_34.006166	472	552	6	28	80	0.3500000
NODE_5401_length_1072_cov_34.006166	472	552	44	18	80	0.2250000
NODE_5401_length_1072_cov_34.006166	525	605	0	9	80	0.1125000
NODE_5401_length_1072_cov_34.006166	525	605	44	71	80	0.8875000
NODE_5403_length_1072_cov_21.852004	300	380	0	80	80	1.0000000
NODE_5403_length_1072_cov_21.852004	353	433	0	80	80	1.0000000
NODE_5404_length_1072_cov_21.532374	476	556	0	80	80	1.0000000
NODE_5404_length_1072_cov_21.532374	529	609	0	80	80	1.0000000
NODE_5405_length_1072_cov_17.018499	415	495	0	80	80	1.0000000
NODE_5405_length_1072_cov_17.018499	468	548	0	80	80	1.0000000
NODE_5410_length_1072_cov_3.302158	388	449	1	61	61	1.0000000
NODE_5410_length_1072_cov_3.302158	422	502	1	80	80	1.0000000
NODE_5414_length_1072_cov_1.773895	114	176	0	1	62	0.0161290
NODE_5414_length_1072_cov_1.773895	114	176	2	8	62	0.1290323
NODE_5414_length_1072_cov_1.773895	114	176	4	15	62	0.2419355
NODE_5414_length_1072_cov_1.773895	114	176	6	10	62	0.1612903
NODE_5414_length_1072_cov_1.773895	114	176	8	19	62	0.3064516
NODE_5414_length_1072_cov_1.773895	114	176	10	9	62	0.1451613
NODE_5417_length_1071_cov_27.565844	312	392	0	80	80	1.0000000
NODE_5417_length_1071_cov_27.565844	365	445	0	80	80	1.0000000
NODE_5419_length_1071_cov_12.666667	480	560	0	77	80	0.9625000
NODE_5419_length_1071_cov_12.666667	480	560	4	3	80	0.0375000
NODE_5419_length_1071_cov_12.666667	533	613	0	24	80	0.3000000
NODE_5419_length_1071_cov_12.666667	533	613	4	56	80	0.7000000
NODE_5421_length_1071_cov_8.942387	418	498	0	80	80	1.0000000
NODE_5421_length_1071_cov_8.942387	471	551	0	80	80	1.0000000
NODE_5427_length_1070_cov_39.255407	591	671	0	80	80	1.0000000
NODE_5427_length_1070_cov_39.255407	644	724	0	80	80	1.0000000
NODE_5428_length_1070_cov_21.903193	430	510	0	4	80	0.0500000
NODE_5428_length_1070_cov_21.903193	430	510	2	76	80	0.9500000
NODE_5428_length_1070_cov_21.903193	483	563	0	39	80	0.4875000
NODE_5428_length_1070_cov_21.903193	483	563	2	41	80	0.5125000
NODE_5428_length_1070_cov_21.903193	559	639	0	80	80	1.0000000
NODE_5428_length_1070_cov_21.903193	612	692	0	80	80	1.0000000
NODE_5429_length_1070_cov_8.963955	871	900	6	5	29	0.1724138
NODE_5429_length_1070_cov_8.963955	871	900	10	1	29	0.0344828
NODE_5429_length_1070_cov_8.963955	871	900	16	5	29	0.1724138
NODE_5429_length_1070_cov_8.963955	871	900	18	7	29	0.2413793
NODE_5429_length_1070_cov_8.963955	871	900	20	5	29	0.1724138
NODE_5429_length_1070_cov_8.963955	871	900	24	1	29	0.0344828
NODE_5429_length_1070_cov_8.963955	871	900	30	4	29	0.1379310
NODE_5429_length_1070_cov_8.963955	871	900	34	1	29	0.0344828
NODE_5429_length_1070_cov_8.963955	873	953	6	3	80	0.0375000
NODE_5429_length_1070_cov_8.963955	873	953	10	1	80	0.0125000
NODE_5429_length_1070_cov_8.963955	873	953	16	5	80	0.0625000
NODE_5429_length_1070_cov_8.963955	873	953	18	7	80	0.0875000
NODE_5429_length_1070_cov_8.963955	873	953	20	5	80	0.0625000
NODE_5429_length_1070_cov_8.963955	873	953	24	1	80	0.0125000
NODE_5429_length_1070_cov_8.963955	873	953	30	4	80	0.0500000
NODE_5429_length_1070_cov_8.963955	873	953	34	2	80	0.0250000
NODE_5429_length_1070_cov_8.963955	873	953	44	2	80	0.0250000
NODE_5429_length_1070_cov_8.963955	873	953	46	1	80	0.0125000
NODE_5429_length_1070_cov_8.963955	873	953	52	1	80	0.0125000
NODE_5429_length_1070_cov_8.963955	873	953	56	1	80	0.0125000
NODE_5429_length_1070_cov_8.963955	873	953	64	1	80	0.0125000
NODE_5429_length_1070_cov_8.963955	873	953	66	2	80	0.0250000
NODE_5429_length_1070_cov_8.963955	873	953	67	4	80	0.0500000
NODE_5429_length_1070_cov_8.963955	873	953	69	1	80	0.0125000
NODE_5429_length_1070_cov_8.963955	873	953	70	1	80	0.0125000
NODE_5429_length_1070_cov_8.963955	873	953	71	1	80	0.0125000
NODE_5429_length_1070_cov_8.963955	873	953	73	1	80	0.0125000
NODE_5429_length_1070_cov_8.963955	873	953	75	7	80	0.0875000
NODE_5429_length_1070_cov_8.963955	873	953	76	9	80	0.1125000
NODE_5429_length_1070_cov_8.963955	873	953	78	3	80	0.0375000
NODE_5429_length_1070_cov_8.963955	873	953	84	9	80	0.1125000
NODE_5429_length_1070_cov_8.963955	873	953	86	5	80	0.0625000
NODE_5429_length_1070_cov_8.963955	873	953	88	3	80	0.0375000
NODE_5433_length_1070_cov_1.659114	1027	1046	0	19	19	1.0000000
NODE_5439_length_1069_cov_40.277320	451	531	0	80	80	1.0000000
NODE_5439_length_1069_cov_40.277320	504	584	0	80	80	1.0000000
NODE_5440_length_1069_cov_23.571134	274	354	0	80	80	1.0000000
NODE_5440_length_1069_cov_23.571134	327	407	0	80	80	1.0000000
NODE_5441_length_1069_cov_22.436082	185	265	0	2	80	0.0250000
NODE_5441_length_1069_cov_22.436082	185	265	8	6	80	0.0750000
NODE_5441_length_1069_cov_22.436082	185	265	10	10	80	0.1250000
NODE_5441_length_1069_cov_22.436082	185	265	15	51	80	0.6375000
NODE_5441_length_1069_cov_22.436082	185	265	16	11	80	0.1375000
NODE_5441_length_1069_cov_22.436082	238	318	6	37	80	0.4625000
NODE_5441_length_1069_cov_22.436082	238	318	15	16	80	0.2000000
NODE_5441_length_1069_cov_22.436082	238	318	16	27	80	0.3375000
NODE_5442_length_1069_cov_18.207216	436	516	0	74	80	0.9250000
NODE_5442_length_1069_cov_18.207216	436	516	8	6	80	0.0750000
NODE_5442_length_1069_cov_18.207216	489	569	0	21	80	0.2625000
NODE_5442_length_1069_cov_18.207216	489	569	8	59	80	0.7375000
NODE_5443_length_1069_cov_17.601031	596	676	0	80	80	1.0000000
NODE_5443_length_1069_cov_17.601031	649	729	0	80	80	1.0000000
NODE_5444_length_1069_cov_16.318557	353	433	0	80	80	1.0000000
NODE_5444_length_1069_cov_16.318557	406	486	0	80	80	1.0000000
NODE_5444_length_1069_cov_16.318557	482	562	0	80	80	1.0000000
NODE_5444_length_1069_cov_16.318557	535	615	0	80	80	1.0000000
NODE_5445_length_1069_cov_13.349485	471	551	0	80	80	1.0000000
NODE_5445_length_1069_cov_13.349485	524	604	0	80	80	1.0000000
NODE_5446_length_1069_cov_13.050515	314	394	0	76	80	0.9500000
NODE_5446_length_1069_cov_13.050515	314	394	4	4	80	0.0500000
NODE_5446_length_1069_cov_13.050515	367	447	0	23	80	0.2875000
NODE_5446_length_1069_cov_13.050515	367	447	4	57	80	0.7125000
NODE_5447_length_1069_cov_12.818557	240	320	0	80	80	1.0000000
NODE_5447_length_1069_cov_12.818557	293	373	0	80	80	1.0000000
NODE_5448_length_1069_cov_11.985567	554	634	0	80	80	1.0000000
NODE_5448_length_1069_cov_11.985567	607	687	0	28	80	0.3500000
NODE_5448_length_1069_cov_11.985567	607	687	2	52	80	0.6500000
NODE_5449_length_1069_cov_10.812371	366	446	0	80	80	1.0000000
NODE_5449_length_1069_cov_10.812371	419	499	0	80	80	1.0000000
NODE_5450_length_1069_cov_7.729897	482	562	0	80	80	1.0000000
NODE_5450_length_1069_cov_7.729897	535	615	0	80	80	1.0000000
NODE_5456_length_1068_cov_31.692466	314	394	0	80	80	1.0000000
NODE_5456_length_1068_cov_31.692466	367	447	0	80	80	1.0000000
NODE_5456_length_1068_cov_31.692466	443	523	0	80	80	1.0000000
NODE_5456_length_1068_cov_31.692466	496	576	0	80	80	1.0000000
NODE_5457_length_1068_cov_29.579979	347	427	0	80	80	1.0000000
NODE_5457_length_1068_cov_29.579979	400	480	0	80	80	1.0000000
NODE_5459_length_1068_cov_23.020640	476	556	0	80	80	1.0000000
NODE_5459_length_1068_cov_23.020640	529	609	0	51	80	0.6375000
NODE_5459_length_1068_cov_23.020640	529	609	2	29	80	0.3625000
NODE_5460_length_1068_cov_15.272446	546	626	0	80	80	1.0000000
NODE_5460_length_1068_cov_15.272446	599	679	0	80	80	1.0000000
NODE_5461_length_1068_cov_13.557276	674	754	0	80	80	1.0000000
NODE_5461_length_1068_cov_13.557276	727	807	0	80	80	1.0000000
NODE_5479_length_1067_cov_48.282025	429	509	0	80	80	1.0000000
NODE_5479_length_1067_cov_48.282025	482	562	0	80	80	1.0000000
NODE_5480_length_1067_cov_41.111570	460	540	0	17	80	0.2125000
NODE_5480_length_1067_cov_41.111570	460	540	2	63	80	0.7875000
NODE_5480_length_1067_cov_41.111570	513	593	0	61	80	0.7625000
NODE_5480_length_1067_cov_41.111570	513	593	2	19	80	0.2375000
NODE_5481_length_1067_cov_39.109504	295	375	0	80	80	1.0000000
NODE_5481_length_1067_cov_39.109504	348	428	0	80	80	1.0000000
NODE_5481_length_1067_cov_39.109504	424	504	0	80	80	1.0000000
NODE_5481_length_1067_cov_39.109504	477	557	0	80	80	1.0000000
NODE_5482_length_1067_cov_35.426653	252	332	0	80	80	1.0000000
NODE_5482_length_1067_cov_35.426653	305	385	0	31	80	0.3875000
NODE_5482_length_1067_cov_35.426653	305	385	3	31	80	0.3875000
NODE_5482_length_1067_cov_35.426653	305	385	5	18	80	0.2250000
NODE_5483_length_1067_cov_29.467975	412	492	0	23	80	0.2875000
NODE_5483_length_1067_cov_29.467975	412	492	2	57	80	0.7125000
NODE_5483_length_1067_cov_29.467975	465	545	0	3	80	0.0375000
NODE_5483_length_1067_cov_29.467975	465	545	2	77	80	0.9625000
NODE_5484_length_1067_cov_20.738636	579	645	17	5	66	0.0757576
NODE_5484_length_1067_cov_20.738636	579	645	25	7	66	0.1060606
NODE_5484_length_1067_cov_20.738636	579	645	28	8	66	0.1212121
NODE_5484_length_1067_cov_20.738636	579	645	29	12	66	0.1818182
NODE_5484_length_1067_cov_20.738636	579	645	35	8	66	0.1212121
NODE_5484_length_1067_cov_20.738636	579	645	36	2	66	0.0303030
NODE_5484_length_1067_cov_20.738636	579	645	37	1	66	0.0151515
NODE_5484_length_1067_cov_20.738636	579	645	38	4	66	0.0606061
NODE_5484_length_1067_cov_20.738636	579	645	40	4	66	0.0606061
NODE_5484_length_1067_cov_20.738636	579	645	42	11	66	0.1666667
NODE_5484_length_1067_cov_20.738636	579	645	43	2	66	0.0303030
NODE_5484_length_1067_cov_20.738636	579	645	44	2	66	0.0303030
NODE_5484_length_1067_cov_20.738636	618	698	28	2	80	0.0250000
NODE_5484_length_1067_cov_20.738636	618	698	30	2	80	0.0250000
NODE_5484_length_1067_cov_20.738636	618	698	33	3	80	0.0375000
NODE_5484_length_1067_cov_20.738636	618	698	34	8	80	0.1000000
NODE_5484_length_1067_cov_20.738636	618	698	35	1	80	0.0125000
NODE_5484_length_1067_cov_20.738636	618	698	36	17	80	0.2125000
NODE_5484_length_1067_cov_20.738636	618	698	37	5	80	0.0625000
NODE_5484_length_1067_cov_20.738636	618	698	38	10	80	0.1250000
NODE_5484_length_1067_cov_20.738636	618	698	40	17	80	0.2125000
NODE_5484_length_1067_cov_20.738636	618	698	42	11	80	0.1375000
NODE_5484_length_1067_cov_20.738636	618	698	43	2	80	0.0250000
NODE_5484_length_1067_cov_20.738636	618	698	44	2	80	0.0250000
NODE_5485_length_1067_cov_15.280992	538	617	0	79	79	1.0000000
NODE_5485_length_1067_cov_15.280992	590	670	0	80	80	1.0000000
NODE_5486_length_1067_cov_13.708678	478	558	0	80	80	1.0000000
NODE_5486_length_1067_cov_13.708678	531	611	0	80	80	1.0000000
NODE_5488_length_1067_cov_9.070248	625	705	0	57	80	0.7125000
NODE_5488_length_1067_cov_9.070248	625	705	2	23	80	0.2875000
NODE_5488_length_1067_cov_9.070248	678	758	0	4	80	0.0500000
NODE_5488_length_1067_cov_9.070248	678	758	2	76	80	0.9500000
NODE_5494_length_1067_cov_1.946281	765	812	0	47	47	1.0000000
NODE_5501_length_1066_cov_54.227508	395	475	0	70	80	0.8750000
NODE_5501_length_1066_cov_54.227508	395	475	2	10	80	0.1250000
NODE_5501_length_1066_cov_54.227508	448	528	0	80	80	1.0000000
NODE_5502_length_1066_cov_33.501551	357	437	0	58	80	0.7250000
NODE_5502_length_1066_cov_33.501551	357	437	1	22	80	0.2750000
NODE_5502_length_1066_cov_33.501551	410	490	0	5	80	0.0625000
NODE_5502_length_1066_cov_33.501551	410	490	1	75	80	0.9375000
NODE_5503_length_1066_cov_33.115822	397	477	0	80	80	1.0000000
NODE_5503_length_1066_cov_33.115822	450	530	0	80	80	1.0000000
NODE_5504_length_1066_cov_26.517063	215	285	290	1	70	0.0142857
NODE_5504_length_1066_cov_26.517063	215	285	291	1	70	0.0142857
NODE_5504_length_1066_cov_26.517063	215	285	292	1	70	0.0142857
NODE_5504_length_1066_cov_26.517063	215	285	294	1	70	0.0142857
NODE_5504_length_1066_cov_26.517063	215	285	295	1	70	0.0142857
NODE_5504_length_1066_cov_26.517063	215	285	298	1	70	0.0142857
NODE_5504_length_1066_cov_26.517063	215	285	300	1	70	0.0142857
NODE_5504_length_1066_cov_26.517063	215	285	305	1	70	0.0142857
NODE_5504_length_1066_cov_26.517063	215	285	307	2	70	0.0285714
NODE_5504_length_1066_cov_26.517063	215	285	308	2	70	0.0285714
NODE_5504_length_1066_cov_26.517063	215	285	309	3	70	0.0428571
NODE_5504_length_1066_cov_26.517063	215	285	322	1	70	0.0142857
NODE_5504_length_1066_cov_26.517063	215	285	324	1	70	0.0142857
NODE_5504_length_1066_cov_26.517063	215	285	335	1	70	0.0142857
NODE_5504_length_1066_cov_26.517063	215	285	337	1	70	0.0142857
NODE_5504_length_1066_cov_26.517063	215	285	341	1	70	0.0142857
NODE_5504_length_1066_cov_26.517063	215	285	351	1	70	0.0142857
NODE_5504_length_1066_cov_26.517063	215	285	352	2	70	0.0285714
NODE_5504_length_1066_cov_26.517063	215	285	356	1	70	0.0142857
NODE_5504_length_1066_cov_26.517063	215	285	357	1	70	0.0142857
NODE_5504_length_1066_cov_26.517063	215	285	359	1	70	0.0142857
NODE_5504_length_1066_cov_26.517063	215	285	362	1	70	0.0142857
NODE_5504_length_1066_cov_26.517063	215	285	363	1	70	0.0142857
NODE_5504_length_1066_cov_26.517063	215	285	364	2	70	0.0285714
NODE_5504_length_1066_cov_26.517063	215	285	365	1	70	0.0142857
NODE_5504_length_1066_cov_26.517063	215	285	366	3	70	0.0428571
NODE_5504_length_1066_cov_26.517063	215	285	367	2	70	0.0285714
NODE_5504_length_1066_cov_26.517063	215	285	368	1	70	0.0142857
NODE_5504_length_1066_cov_26.517063	215	285	369	1	70	0.0142857
NODE_5504_length_1066_cov_26.517063	215	285	370	1	70	0.0142857
NODE_5504_length_1066_cov_26.517063	215	285	371	1	70	0.0142857
NODE_5504_length_1066_cov_26.517063	215	285	376	1	70	0.0142857
NODE_5504_length_1066_cov_26.517063	215	285	389	1	70	0.0142857
NODE_5504_length_1066_cov_26.517063	215	285	390	1	70	0.0142857
NODE_5504_length_1066_cov_26.517063	215	285	391	1	70	0.0142857
NODE_5504_length_1066_cov_26.517063	215	285	393	1	70	0.0142857
NODE_5504_length_1066_cov_26.517063	215	285	395	3	70	0.0428571
NODE_5504_length_1066_cov_26.517063	215	285	396	4	70	0.0571429
NODE_5504_length_1066_cov_26.517063	215	285	397	3	70	0.0428571
NODE_5504_length_1066_cov_26.517063	215	285	398	1	70	0.0142857
NODE_5504_length_1066_cov_26.517063	215	285	399	2	70	0.0285714
NODE_5504_length_1066_cov_26.517063	215	285	401	4	70	0.0571429
NODE_5504_length_1066_cov_26.517063	215	285	402	1	70	0.0142857
NODE_5504_length_1066_cov_26.517063	215	285	404	2	70	0.0285714
NODE_5504_length_1066_cov_26.517063	215	285	406	1	70	0.0142857
NODE_5504_length_1066_cov_26.517063	215	285	407	2	70	0.0285714
NODE_5504_length_1066_cov_26.517063	215	285	408	1	70	0.0142857
NODE_5504_length_1066_cov_26.517063	215	285	410	1	70	0.0142857
NODE_5505_length_1066_cov_16.906929	526	606	0	80	80	1.0000000
NODE_5505_length_1066_cov_16.906929	579	659	0	80	80	1.0000000
NODE_5506_length_1066_cov_16.190279	298	378	0	80	80	1.0000000
NODE_5506_length_1066_cov_16.190279	351	432	0	81	81	1.0000000
NODE_5507_length_1066_cov_15.444674	582	662	0	80	80	1.0000000
NODE_5507_length_1066_cov_15.444674	635	715	0	80	80	1.0000000
NODE_5516_length_1065_cov_51.693582	480	560	0	48	80	0.6000000
NODE_5516_length_1065_cov_51.693582	480	560	2	32	80	0.4000000
NODE_5516_length_1065_cov_51.693582	533	613	0	80	80	1.0000000
NODE_5517_length_1065_cov_33.428571	422	502	0	54	80	0.6750000
NODE_5517_length_1065_cov_33.428571	422	502	8	26	80	0.3250000
NODE_5517_length_1065_cov_33.428571	422	502	0	54	80	0.6750000
NODE_5517_length_1065_cov_33.428571	422	502	8	26	80	0.3250000
NODE_5517_length_1065_cov_33.428571	422	502	0	54	80	0.6750000
NODE_5517_length_1065_cov_33.428571	422	502	8	26	80	0.3250000
NODE_5517_length_1065_cov_33.428571	475	555	0	1	80	0.0125000
NODE_5517_length_1065_cov_33.428571	475	555	8	79	80	0.9875000
NODE_5517_length_1065_cov_33.428571	475	555	0	1	80	0.0125000
NODE_5517_length_1065_cov_33.428571	475	555	8	79	80	0.9875000
NODE_5517_length_1065_cov_33.428571	551	631	0	4	80	0.0500000
NODE_5517_length_1065_cov_33.428571	551	631	2	41	80	0.5125000
NODE_5517_length_1065_cov_33.428571	551	631	8	35	80	0.4375000
NODE_5517_length_1065_cov_33.428571	551	631	0	4	80	0.0500000
NODE_5517_length_1065_cov_33.428571	551	631	2	41	80	0.5125000
NODE_5517_length_1065_cov_33.428571	551	631	8	35	80	0.4375000
NODE_5517_length_1065_cov_33.428571	551	572	8	21	21	1.0000000
NODE_5517_length_1065_cov_33.428571	604	666	2	57	62	0.9193549
NODE_5517_length_1065_cov_33.428571	604	666	6	5	62	0.0806452
NODE_5517_length_1065_cov_33.428571	604	684	2	57	80	0.7125000
NODE_5517_length_1065_cov_33.428571	604	684	6	16	80	0.2000000
NODE_5517_length_1065_cov_33.428571	604	684	8	3	80	0.0375000
NODE_5517_length_1065_cov_33.428571	604	684	10	4	80	0.0500000
NODE_5518_length_1065_cov_31.874741	255	335	0	18	80	0.2250000
NODE_5518_length_1065_cov_31.874741	255	335	1	29	80	0.3625000
NODE_5518_length_1065_cov_31.874741	255	335	2	33	80	0.4125000
NODE_5518_length_1065_cov_31.874741	308	388	2	80	80	1.0000000
NODE_5519_length_1065_cov_21.762940	234	314	0	62	80	0.7750000
NODE_5519_length_1065_cov_21.762940	234	314	2	18	80	0.2250000
NODE_5519_length_1065_cov_21.762940	287	367	0	9	80	0.1125000
NODE_5519_length_1065_cov_21.762940	287	367	2	71	80	0.8875000
NODE_5520_length_1065_cov_19.947205	447	527	0	80	80	1.0000000
NODE_5520_length_1065_cov_19.947205	500	580	0	80	80	1.0000000
NODE_5521_length_1065_cov_14.590062	343	423	3	27	80	0.3375000
NODE_5521_length_1065_cov_14.590062	343	423	4	3	80	0.0375000
NODE_5521_length_1065_cov_14.590062	343	423	7	50	80	0.6250000
NODE_5521_length_1065_cov_14.590062	396	476	4	13	80	0.1625000
NODE_5521_length_1065_cov_14.590062	396	476	6	27	80	0.3375000
NODE_5521_length_1065_cov_14.590062	396	476	7	40	80	0.5000000
NODE_5522_length_1065_cov_13.232919	243	323	0	80	80	1.0000000
NODE_5522_length_1065_cov_13.232919	296	376	0	80	80	1.0000000
NODE_5523_length_1065_cov_10.670807	481	561	0	80	80	1.0000000
NODE_5523_length_1065_cov_10.670807	534	614	0	80	80	1.0000000
NODE_5524_length_1065_cov_10.473085	496	576	0	80	80	1.0000000
NODE_5524_length_1065_cov_10.473085	549	629	0	80	80	1.0000000
NODE_5525_length_1065_cov_9.711180	286	360	0	74	74	1.0000000
NODE_5525_length_1065_cov_9.711180	339	419	0	80	80	1.0000000
NODE_5534_length_1064_cov_59.929534	457	537	0	1	80	0.0125000
NODE_5534_length_1064_cov_59.929534	457	537	6	79	80	0.9875000
NODE_5534_length_1064_cov_59.929534	510	590	0	54	80	0.6750000
NODE_5534_length_1064_cov_59.929534	510	590	6	26	80	0.3250000
NODE_5534_length_1064_cov_59.929534	586	666	0	80	80	1.0000000
NODE_5534_length_1064_cov_59.929534	639	719	0	80	80	1.0000000
NODE_5535_length_1064_cov_36.480829	367	447	0	80	80	1.0000000
NODE_5535_length_1064_cov_36.480829	420	500	0	80	80	1.0000000
NODE_5535_length_1064_cov_36.480829	496	576	0	80	80	1.0000000
NODE_5535_length_1064_cov_36.480829	549	629	0	80	80	1.0000000
NODE_5536_length_1064_cov_32.307772	547	627	0	80	80	1.0000000
NODE_5536_length_1064_cov_32.307772	600	680	0	80	80	1.0000000
NODE_5537_length_1064_cov_25.255959	462	542	0	60	80	0.7500000
NODE_5537_length_1064_cov_25.255959	462	542	1	20	80	0.2500000
NODE_5537_length_1064_cov_25.255959	515	595	0	7	80	0.0875000
NODE_5537_length_1064_cov_25.255959	515	595	1	73	80	0.9125000
NODE_5537_length_1064_cov_25.255959	591	671	1	80	80	1.0000000
NODE_5537_length_1064_cov_25.255959	644	724	0	52	80	0.6500000
NODE_5537_length_1064_cov_25.255959	644	724	1	28	80	0.3500000
NODE_5538_length_1064_cov_23.053886	343	423	0	15	80	0.1875000
NODE_5538_length_1064_cov_23.053886	343	423	6	65	80	0.8125000
NODE_5538_length_1064_cov_23.053886	396	476	0	68	80	0.8500000
NODE_5538_length_1064_cov_23.053886	396	476	6	12	80	0.1500000
NODE_5538_length_1064_cov_23.053886	472	552	0	80	80	1.0000000
NODE_5538_length_1064_cov_23.053886	525	605	0	80	80	1.0000000
NODE_5539_length_1064_cov_22.018653	479	559	0	80	80	1.0000000
NODE_5539_length_1064_cov_22.018653	532	612	0	80	80	1.0000000
NODE_5540_length_1064_cov_12.868394	424	504	0	80	80	1.0000000
NODE_5540_length_1064_cov_12.868394	477	557	0	80	80	1.0000000
NODE_5541_length_1064_cov_10.098446	467	547	0	53	80	0.6625000
NODE_5541_length_1064_cov_10.098446	467	547	3	1	80	0.0125000
NODE_5541_length_1064_cov_10.098446	467	547	4	26	80	0.3250000
NODE_5541_length_1064_cov_10.098446	520	600	3	1	80	0.0125000
NODE_5541_length_1064_cov_10.098446	520	600	4	79	80	0.9875000
NODE_5543_length_1064_cov_2.925389	173	245	4	9	72	0.1250000
NODE_5543_length_1064_cov_2.925389	173	245	6	7	72	0.0972222
NODE_5543_length_1064_cov_2.925389	173	245	8	6	72	0.0833333
NODE_5543_length_1064_cov_2.925389	173	245	9	2	72	0.0277778
NODE_5543_length_1064_cov_2.925389	173	245	10	2	72	0.0277778
NODE_5543_length_1064_cov_2.925389	173	245	12	1	72	0.0138889
NODE_5543_length_1064_cov_2.925389	173	245	13	1	72	0.0138889
NODE_5543_length_1064_cov_2.925389	173	245	18	1	72	0.0138889
NODE_5543_length_1064_cov_2.925389	173	245	25	2	72	0.0277778
NODE_5543_length_1064_cov_2.925389	173	245	27	4	72	0.0555556
NODE_5543_length_1064_cov_2.925389	173	245	28	3	72	0.0416667
NODE_5543_length_1064_cov_2.925389	173	245	30	5	72	0.0694444
NODE_5543_length_1064_cov_2.925389	173	245	32	4	72	0.0555556
NODE_5543_length_1064_cov_2.925389	173	245	37	11	72	0.1527778
NODE_5543_length_1064_cov_2.925389	173	245	39	1	72	0.0138889
NODE_5543_length_1064_cov_2.925389	173	245	40	4	72	0.0555556
NODE_5543_length_1064_cov_2.925389	173	245	44	3	72	0.0416667
NODE_5543_length_1064_cov_2.925389	173	245	49	2	72	0.0277778
NODE_5543_length_1064_cov_2.925389	173	245	51	2	72	0.0277778
NODE_5543_length_1064_cov_2.925389	173	245	53	2	72	0.0277778
NODE_5551_length_1063_cov_104.615145	504	584	0	80	80	1.0000000
NODE_5551_length_1063_cov_104.615145	557	637	0	80	80	1.0000000
NODE_5552_length_1063_cov_36.515560	482	562	0	80	80	1.0000000
NODE_5552_length_1063_cov_36.515560	535	615	0	80	80	1.0000000
NODE_5552_length_1063_cov_36.515560	611	691	0	80	80	1.0000000
NODE_5552_length_1063_cov_36.515560	664	744	0	80	80	1.0000000
NODE_5553_length_1063_cov_30.700207	470	550	0	80	80	1.0000000
NODE_5553_length_1063_cov_30.700207	523	603	0	80	80	1.0000000
NODE_5553_length_1063_cov_30.700207	599	679	0	80	80	1.0000000
NODE_5553_length_1063_cov_30.700207	652	732	0	80	80	1.0000000
NODE_5554_length_1063_cov_24.552905	362	442	0	80	80	1.0000000
NODE_5554_length_1063_cov_24.552905	415	495	0	80	80	1.0000000
NODE_5555_length_1063_cov_21.985477	407	487	0	80	80	1.0000000
NODE_5555_length_1063_cov_21.985477	460	540	0	80	80	1.0000000
NODE_5555_length_1063_cov_21.985477	536	616	0	80	80	1.0000000
NODE_5555_length_1063_cov_21.985477	589	670	0	81	81	1.0000000
NODE_5557_length_1063_cov_15.400415	685	765	0	80	80	1.0000000
NODE_5557_length_1063_cov_15.400415	738	818	0	80	80	1.0000000
NODE_5558_length_1063_cov_13.282158	510	590	0	80	80	1.0000000
NODE_5558_length_1063_cov_13.282158	563	643	0	80	80	1.0000000
NODE_5559_length_1063_cov_12.970954	417	495	0	78	78	1.0000000
NODE_5559_length_1063_cov_12.970954	468	548	0	80	80	1.0000000
NODE_5560_length_1063_cov_7.917012	639	719	0	80	80	1.0000000
NODE_5560_length_1063_cov_7.917012	692	772	0	80	80	1.0000000
NODE_5569_length_1063_cov_1.695021	893	947	0	7	54	0.1296296
NODE_5569_length_1063_cov_1.695021	893	947	2	47	54	0.8703704
NODE_5574_length_1062_cov_43.399792	272	352	0	80	80	1.0000000
NODE_5574_length_1062_cov_43.399792	325	405	0	80	80	1.0000000
NODE_5576_length_1062_cov_19.778816	401	481	0	80	80	1.0000000
NODE_5576_length_1062_cov_19.778816	454	534	0	80	80	1.0000000
NODE_5577_length_1062_cov_16.034268	628	708	0	80	80	1.0000000
NODE_5577_length_1062_cov_16.034268	681	761	0	80	80	1.0000000
NODE_5578_length_1062_cov_13.346833	623	703	0	80	80	1.0000000
NODE_5578_length_1062_cov_13.346833	676	756	0	80	80	1.0000000
NODE_5579_length_1062_cov_9.886812	670	750	0	80	80	1.0000000
NODE_5579_length_1062_cov_9.886812	723	803	0	80	80	1.0000000
NODE_5580_length_1062_cov_9.078920	525	604	0	79	79	1.0000000
NODE_5580_length_1062_cov_9.078920	577	657	0	80	80	1.0000000
NODE_5581_length_1062_cov_8.934579	203	283	0	80	80	1.0000000
NODE_5581_length_1062_cov_8.934579	256	336	0	80	80	1.0000000
NODE_5588_length_1061_cov_22.637214	418	498	1	21	80	0.2625000
NODE_5588_length_1061_cov_22.637214	418	498	2	59	80	0.7375000
NODE_5588_length_1061_cov_22.637214	471	551	1	11	80	0.1375000
NODE_5588_length_1061_cov_22.637214	471	551	2	69	80	0.8625000
NODE_5589_length_1061_cov_22.338877	479	559	0	80	80	1.0000000
NODE_5589_length_1061_cov_22.338877	532	612	0	80	80	1.0000000
NODE_5597_length_1060_cov_31.595213	394	473	0	79	79	1.0000000
NODE_5597_length_1060_cov_31.595213	446	526	0	80	80	1.0000000
NODE_5597_length_1060_cov_31.595213	522	602	0	80	80	1.0000000
NODE_5597_length_1060_cov_31.595213	575	655	0	80	80	1.0000000
NODE_5598_length_1060_cov_26.136316	486	566	0	80	80	1.0000000
NODE_5598_length_1060_cov_26.136316	539	619	0	80	80	1.0000000
NODE_5598_length_1060_cov_26.136316	615	695	0	17	80	0.2125000
NODE_5598_length_1060_cov_26.136316	615	695	4	63	80	0.7875000
NODE_5598_length_1060_cov_26.136316	668	748	0	35	80	0.4375000
NODE_5598_length_1060_cov_26.136316	668	748	4	45	80	0.5625000
NODE_5599_length_1060_cov_25.329865	370	450	0	80	80	1.0000000
NODE_5599_length_1060_cov_25.329865	423	503	0	80	80	1.0000000
NODE_5600_length_1060_cov_16.881374	539	611	0	49	72	0.6805556
NODE_5600_length_1060_cov_16.881374	539	611	2	23	72	0.3194444
NODE_5601_length_1060_cov_14.789802	406	486	0	80	80	1.0000000
NODE_5601_length_1060_cov_14.789802	459	539	0	80	80	1.0000000
NODE_5603_length_1060_cov_5.900104	517	597	4	80	80	1.0000000
NODE_5603_length_1060_cov_5.900104	570	650	0	38	80	0.4750000
NODE_5603_length_1060_cov_5.900104	570	650	4	42	80	0.5250000
NODE_5611_length_1059_cov_16.630208	412	492	0	80	80	1.0000000
NODE_5611_length_1059_cov_16.630208	465	552	0	87	87	1.0000000
NODE_5611_length_1059_cov_16.630208	548	628	0	80	80	1.0000000
NODE_5611_length_1059_cov_16.630208	601	681	0	80	80	1.0000000
NODE_5621_length_1058_cov_60.155370	395	475	0	8	80	0.1000000
NODE_5621_length_1058_cov_60.155370	395	475	2	72	80	0.9000000
NODE_5621_length_1058_cov_60.155370	448	528	0	33	80	0.4125000
NODE_5621_length_1058_cov_60.155370	448	528	2	47	80	0.5875000
NODE_5621_length_1058_cov_60.155370	524	604	0	8	80	0.1000000
NODE_5621_length_1058_cov_60.155370	524	604	2	72	80	0.9000000
NODE_5621_length_1058_cov_60.155370	577	657	0	61	80	0.7625000
NODE_5621_length_1058_cov_60.155370	577	657	2	19	80	0.2375000
NODE_5622_length_1058_cov_31.253389	475	555	0	10	80	0.1250000
NODE_5622_length_1058_cov_31.253389	475	555	6	2	80	0.0250000
NODE_5622_length_1058_cov_31.253389	475	555	17	4	80	0.0500000
NODE_5622_length_1058_cov_31.253389	475	555	18	12	80	0.1500000
NODE_5622_length_1058_cov_31.253389	475	555	20	52	80	0.6500000
NODE_5622_length_1058_cov_31.253389	475	555	0	10	80	0.1250000
NODE_5622_length_1058_cov_31.253389	475	555	6	2	80	0.0250000
NODE_5622_length_1058_cov_31.253389	475	555	17	4	80	0.0500000
NODE_5622_length_1058_cov_31.253389	475	555	18	12	80	0.1500000
NODE_5622_length_1058_cov_31.253389	475	555	20	52	80	0.6500000
NODE_5622_length_1058_cov_31.253389	528	608	0	8	80	0.1000000
NODE_5622_length_1058_cov_31.253389	528	608	11	1	80	0.0125000
NODE_5622_length_1058_cov_31.253389	528	608	12	10	80	0.1250000
NODE_5622_length_1058_cov_31.253389	528	608	18	20	80	0.2500000
NODE_5622_length_1058_cov_31.253389	528	608	20	41	80	0.5125000
NODE_5622_length_1058_cov_31.253389	533	608	0	8	75	0.1066667
NODE_5622_length_1058_cov_31.253389	533	608	11	1	75	0.0133333
NODE_5622_length_1058_cov_31.253389	533	608	12	10	75	0.1333333
NODE_5622_length_1058_cov_31.253389	533	608	18	20	75	0.2666667
NODE_5622_length_1058_cov_31.253389	533	608	20	36	75	0.4800000
NODE_5623_length_1058_cov_24.520334	264	344	0	80	80	1.0000000
NODE_5623_length_1058_cov_24.520334	317	397	0	80	80	1.0000000
NODE_5624_length_1058_cov_24.211679	297	377	0	80	80	1.0000000
NODE_5624_length_1058_cov_24.211679	350	430	0	80	80	1.0000000
NODE_5625_length_1058_cov_18.100104	454	534	0	80	80	1.0000000
NODE_5625_length_1058_cov_18.100104	507	587	0	80	80	1.0000000
NODE_5626_length_1058_cov_11.645464	476	556	0	80	80	1.0000000
NODE_5626_length_1058_cov_11.645464	529	609	0	80	80	1.0000000
NODE_5627_length_1058_cov_9.953076	621	712	0	91	91	1.0000000
NODE_5627_length_1058_cov_9.953076	685	765	0	80	80	1.0000000
NODE_5628_length_1058_cov_6.294056	819	899	2	62	80	0.7750000
NODE_5628_length_1058_cov_6.294056	819	899	4	18	80	0.2250000
NODE_5628_length_1058_cov_6.294056	875	952	0	37	77	0.4805195
NODE_5628_length_1058_cov_6.294056	875	952	2	40	77	0.5194805
NODE_5637_length_1057_cov_43.191023	413	493	1	80	80	1.0000000
NODE_5637_length_1057_cov_43.191023	466	546	1	52	80	0.6500000
NODE_5637_length_1057_cov_43.191023	466	546	2	28	80	0.3500000
NODE_5637_length_1057_cov_43.191023	542	622	1	61	80	0.7625000
NODE_5637_length_1057_cov_43.191023	542	622	2	19	80	0.2375000
NODE_5637_length_1057_cov_43.191023	595	675	0	7	80	0.0875000
NODE_5637_length_1057_cov_43.191023	595	675	1	73	80	0.9125000
NODE_5638_length_1057_cov_27.387265	486	566	0	80	80	1.0000000
NODE_5638_length_1057_cov_27.387265	539	619	0	80	80	1.0000000
NODE_5639_length_1057_cov_16.489562	416	496	0	80	80	1.0000000
NODE_5639_length_1057_cov_16.489562	469	549	0	80	80	1.0000000
NODE_5640_length_1057_cov_13.605428	631	711	0	43	80	0.5375000
NODE_5640_length_1057_cov_13.605428	631	711	2	37	80	0.4625000
NODE_5640_length_1057_cov_13.605428	684	764	2	80	80	1.0000000
NODE_5641_length_1057_cov_12.768267	518	598	0	80	80	1.0000000
NODE_5641_length_1057_cov_12.768267	571	651	0	80	80	1.0000000
NODE_5644_length_1057_cov_7.692067	706	786	0	80	80	1.0000000
NODE_5644_length_1057_cov_7.692067	759	839	0	80	80	1.0000000
NODE_5645_length_1057_cov_6.697286	561	641	0	80	80	1.0000000
NODE_5645_length_1057_cov_6.697286	614	694	0	80	80	1.0000000
NODE_5654_length_1056_cov_57.539185	462	542	0	80	80	1.0000000
NODE_5654_length_1056_cov_57.539185	515	595	0	80	80	1.0000000
NODE_5655_length_1056_cov_35.751306	421	501	0	80	80	1.0000000
NODE_5655_length_1056_cov_35.751306	474	554	0	80	80	1.0000000
NODE_5656_length_1056_cov_29.749216	415	490	0	75	75	1.0000000
NODE_5656_length_1056_cov_29.749216	416	495	0	79	79	1.0000000
NODE_5656_length_1056_cov_29.749216	448	495	0	47	47	1.0000000
NODE_5656_length_1056_cov_29.749216	468	548	0	80	80	1.0000000
NODE_5656_length_1056_cov_29.749216	468	548	0	80	80	1.0000000
NODE_5656_length_1056_cov_29.749216	468	548	0	80	80	1.0000000
NODE_5657_length_1056_cov_25.342738	297	377	0	80	80	1.0000000
NODE_5657_length_1056_cov_25.342738	350	430	0	80	80	1.0000000
NODE_5657_length_1056_cov_25.342738	426	506	0	43	80	0.5375000
NODE_5657_length_1056_cov_25.342738	426	506	4	1	80	0.0125000
NODE_5657_length_1056_cov_25.342738	426	506	5	1	80	0.0125000
NODE_5657_length_1056_cov_25.342738	426	506	16	28	80	0.3500000
NODE_5657_length_1056_cov_25.342738	426	506	17	1	80	0.0125000
NODE_5657_length_1056_cov_25.342738	426	506	19	6	80	0.0750000
NODE_5657_length_1056_cov_25.342738	479	559	16	20	80	0.2500000
NODE_5657_length_1056_cov_25.342738	479	559	17	1	80	0.0125000
NODE_5657_length_1056_cov_25.342738	479	559	18	49	80	0.6125000
NODE_5657_length_1056_cov_25.342738	479	559	19	10	80	0.1250000
NODE_5658_length_1056_cov_24.094044	535	615	0	80	80	1.0000000
NODE_5658_length_1056_cov_24.094044	588	668	0	80	80	1.0000000
NODE_5659_length_1056_cov_20.700104	570	650	1	64	80	0.8000000
NODE_5659_length_1056_cov_20.700104	570	650	3	16	80	0.2000000
NODE_5659_length_1056_cov_20.700104	623	703	0	29	80	0.3625000
NODE_5659_length_1056_cov_20.700104	623	703	1	51	80	0.6375000
NODE_5660_length_1056_cov_14.215256	349	429	0	38	80	0.4750000
NODE_5660_length_1056_cov_14.215256	349	429	1	9	80	0.1125000
NODE_5660_length_1056_cov_14.215256	349	429	2	33	80	0.4125000
NODE_5660_length_1056_cov_14.215256	402	482	2	80	80	1.0000000
NODE_5660_length_1056_cov_14.215256	478	558	0	12	80	0.1500000
NODE_5660_length_1056_cov_14.215256	478	558	1	9	80	0.1125000
NODE_5660_length_1056_cov_14.215256	478	558	2	59	80	0.7375000
NODE_5660_length_1056_cov_14.215256	531	611	0	65	80	0.8125000
NODE_5660_length_1056_cov_14.215256	531	611	1	9	80	0.1125000
NODE_5660_length_1056_cov_14.215256	531	611	2	6	80	0.0750000
NODE_5661_length_1056_cov_13.782654	563	643	0	80	80	1.0000000
NODE_5661_length_1056_cov_13.782654	616	696	0	80	80	1.0000000
NODE_5663_length_1056_cov_9.298851	373	453	0	80	80	1.0000000
NODE_5663_length_1056_cov_9.298851	426	503	0	77	77	1.0000000
NODE_5665_length_1056_cov_6.157785	396	476	0	80	80	1.0000000
NODE_5665_length_1056_cov_6.157785	449	529	0	80	80	1.0000000
NODE_5666_length_1056_cov_6.034483	287	367	0	75	80	0.9375000
NODE_5666_length_1056_cov_6.034483	287	367	2	5	80	0.0625000
NODE_5666_length_1056_cov_6.034483	340	420	0	22	80	0.2750000
NODE_5666_length_1056_cov_6.034483	340	420	2	58	80	0.7250000
NODE_5667_length_1056_cov_3.259143	371	410	0	39	39	1.0000000
NODE_5667_length_1056_cov_3.259143	424	463	0	39	39	1.0000000
NODE_5668_length_1056_cov_2.362591	234	314	0	48	80	0.6000000
NODE_5668_length_1056_cov_2.362591	234	314	2	32	80	0.4000000
NODE_5672_length_1055_cov_36.460251	468	548	0	62	80	0.7750000
NODE_5672_length_1055_cov_36.460251	468	548	2	18	80	0.2250000
NODE_5672_length_1055_cov_36.460251	521	601	0	9	80	0.1125000
NODE_5672_length_1055_cov_36.460251	521	601	2	71	80	0.8875000
NODE_5673_length_1055_cov_31.235356	502	582	0	80	80	1.0000000
NODE_5673_length_1055_cov_31.235356	555	635	0	80	80	1.0000000
NODE_5674_length_1055_cov_23.330544	403	483	0	80	80	1.0000000
NODE_5674_length_1055_cov_23.330544	456	536	0	80	80	1.0000000
NODE_5674_length_1055_cov_23.330544	532	612	0	80	80	1.0000000
NODE_5674_length_1055_cov_23.330544	585	665	0	80	80	1.0000000
NODE_5675_length_1055_cov_19.541841	321	401	0	80	80	1.0000000
NODE_5675_length_1055_cov_19.541841	374	454	0	80	80	1.0000000
NODE_5676_length_1055_cov_15.744770	525	605	0	47	80	0.5875000
NODE_5676_length_1055_cov_15.744770	525	605	6	33	80	0.4125000
NODE_5676_length_1055_cov_15.744770	578	658	6	80	80	1.0000000
NODE_5677_length_1055_cov_10.729079	335	415	0	80	80	1.0000000
NODE_5677_length_1055_cov_10.729079	388	468	0	80	80	1.0000000
NODE_5678_length_1055_cov_7.525105	575	655	0	80	80	1.0000000
NODE_5678_length_1055_cov_7.525105	628	708	0	80	80	1.0000000
NODE_5688_length_1054_cov_45.920419	371	451	0	62	80	0.7750000
NODE_5688_length_1054_cov_45.920419	371	451	1	18	80	0.2250000
NODE_5688_length_1054_cov_45.920419	424	505	0	69	81	0.8518519
NODE_5688_length_1054_cov_45.920419	424	505	1	12	81	0.1481481
NODE_5689_length_1054_cov_30.545550	499	578	0	79	79	1.0000000
NODE_5689_length_1054_cov_30.545550	552	631	0	79	79	1.0000000
NODE_5689_length_1054_cov_30.545550	627	707	0	80	80	1.0000000
NODE_5689_length_1054_cov_30.545550	680	760	0	80	80	1.0000000
NODE_5690_length_1054_cov_16.606283	347	427	0	80	80	1.0000000
NODE_5690_length_1054_cov_16.606283	400	480	0	80	80	1.0000000
NODE_5691_length_1054_cov_11.637696	244	316	0	72	72	1.0000000
NODE_5691_length_1054_cov_11.637696	312	392	0	67	80	0.8375000
NODE_5691_length_1054_cov_11.637696	312	392	2	13	80	0.1625000
NODE_5691_length_1054_cov_11.637696	365	445	0	14	80	0.1750000
NODE_5691_length_1054_cov_11.637696	365	445	2	16	80	0.2000000
NODE_5691_length_1054_cov_11.637696	365	445	4	50	80	0.6250000
NODE_5692_length_1054_cov_10.381152	493	573	0	80	80	1.0000000
NODE_5692_length_1054_cov_10.381152	546	626	0	80	80	1.0000000
NODE_5703_length_1053_cov_57.660377	445	527	0	82	82	1.0000000
NODE_5703_length_1053_cov_57.660377	500	580	0	80	80	1.0000000
NODE_5704_length_1053_cov_33.518868	329	409	0	80	80	1.0000000
NODE_5704_length_1053_cov_33.518868	382	462	0	80	80	1.0000000
NODE_5704_length_1053_cov_33.518868	458	538	0	80	80	1.0000000
NODE_5704_length_1053_cov_33.518868	511	591	0	80	80	1.0000000
NODE_5705_length_1053_cov_32.412998	375	455	0	80	80	1.0000000
NODE_5705_length_1053_cov_32.412998	428	508	0	80	80	1.0000000
NODE_5705_length_1053_cov_32.412998	504	584	0	80	80	1.0000000
NODE_5705_length_1053_cov_32.412998	557	637	0	80	80	1.0000000
NODE_5706_length_1053_cov_26.545073	456	536	0	80	80	1.0000000
NODE_5706_length_1053_cov_26.545073	509	589	0	80	80	1.0000000
NODE_5706_length_1053_cov_26.545073	585	665	0	80	80	1.0000000
NODE_5706_length_1053_cov_26.545073	638	718	0	80	80	1.0000000
NODE_5707_length_1053_cov_20.346960	543	623	0	80	80	1.0000000
NODE_5707_length_1053_cov_20.346960	596	677	0	81	81	1.0000000
NODE_5708_length_1053_cov_11.655136	393	473	0	80	80	1.0000000
NODE_5708_length_1053_cov_11.655136	446	526	0	80	80	1.0000000
NODE_5710_length_1053_cov_4.771488	84	149	6	65	65	1.0000000
NODE_5718_length_1052_cov_18.469045	448	528	0	80	80	1.0000000
NODE_5718_length_1052_cov_18.469045	501	581	0	80	80	1.0000000
NODE_5719_length_1052_cov_13.136411	425	505	0	80	80	1.0000000
NODE_5719_length_1052_cov_13.136411	478	558	0	80	80	1.0000000
NODE_5722_length_1052_cov_3.082896	607	687	1	80	80	1.0000000
NODE_5722_length_1052_cov_3.082896	660	740	0	37	80	0.4625000
NODE_5722_length_1052_cov_3.082896	660	740	1	43	80	0.5375000
NODE_5729_length_1051_cov_34.868697	472	552	0	80	80	1.0000000
NODE_5729_length_1051_cov_34.868697	525	605	0	80	80	1.0000000
NODE_5730_length_1051_cov_19.446429	549	629	0	80	80	1.0000000
NODE_5730_length_1051_cov_19.446429	602	682	0	80	80	1.0000000
NODE_5731_length_1051_cov_4.022059	600	680	0	4	80	0.0500000
NODE_5731_length_1051_cov_4.022059	600	680	2	76	80	0.9500000
NODE_5736_length_1050_cov_31.556257	429	509	0	80	80	1.0000000
NODE_5736_length_1050_cov_31.556257	482	562	0	47	80	0.5875000
NODE_5736_length_1050_cov_31.556257	482	562	2	33	80	0.4125000
NODE_5736_length_1050_cov_31.556257	558	638	2	80	80	1.0000000
NODE_5736_length_1050_cov_31.556257	611	691	0	29	80	0.3625000
NODE_5736_length_1050_cov_31.556257	611	691	1	19	80	0.2375000
NODE_5736_length_1050_cov_31.556257	611	691	2	32	80	0.4000000
NODE_5737_length_1050_cov_16.337539	398	478	0	80	80	1.0000000
NODE_5737_length_1050_cov_16.337539	451	531	0	80	80	1.0000000
NODE_5738_length_1050_cov_13.290221	507	587	0	9	80	0.1125000
NODE_5738_length_1050_cov_13.290221	507	587	4	71	80	0.8875000
NODE_5738_length_1050_cov_13.290221	560	640	0	2	80	0.0250000
NODE_5738_length_1050_cov_13.290221	560	640	4	78	80	0.9750000
NODE_5739_length_1050_cov_11.389064	532	612	0	80	80	1.0000000
NODE_5739_length_1050_cov_11.389064	585	665	0	80	80	1.0000000
NODE_5740_length_1050_cov_11.091483	259	321	0	62	62	1.0000000
NODE_5740_length_1050_cov_11.091483	294	374	0	80	80	1.0000000
NODE_5740_length_1050_cov_11.091483	370	450	0	80	80	1.0000000
NODE_5740_length_1050_cov_11.091483	423	503	0	80	80	1.0000000
NODE_5742_length_1050_cov_2.201893	928	990	2	62	62	1.0000000
NODE_5742_length_1050_cov_2.201893	981	1043	0	11	62	0.1774193
NODE_5742_length_1050_cov_2.201893	981	1043	2	51	62	0.8225806
NODE_5748_length_1050_cov_1.241851	935	990	2	5	55	0.0909091
NODE_5748_length_1050_cov_1.241851	935	990	6	1	55	0.0181818
NODE_5748_length_1050_cov_1.241851	935	990	8	2	55	0.0363636
NODE_5748_length_1050_cov_1.241851	935	990	10	30	55	0.5454546
NODE_5748_length_1050_cov_1.241851	935	990	16	17	55	0.3090909
NODE_5748_length_1050_cov_1.241851	956	1036	10	17	80	0.2125000
NODE_5748_length_1050_cov_1.241851	956	1036	14	7	80	0.0875000
NODE_5748_length_1050_cov_1.241851	956	1036	16	56	80	0.7000000
NODE_5752_length_1049_cov_28.174737	446	526	0	80	80	1.0000000
NODE_5752_length_1049_cov_28.174737	499	579	0	80	80	1.0000000
NODE_5753_length_1049_cov_23.186316	389	469	0	80	80	1.0000000
NODE_5753_length_1049_cov_23.186316	442	522	0	80	80	1.0000000
NODE_5753_length_1049_cov_23.186316	518	595	0	77	77	1.0000000
NODE_5753_length_1049_cov_23.186316	568	648	0	80	80	1.0000000
NODE_5754_length_1049_cov_21.097895	532	612	0	58	80	0.7250000
NODE_5754_length_1049_cov_21.097895	532	612	1	22	80	0.2750000
NODE_5754_length_1049_cov_21.097895	585	665	0	80	80	1.0000000
NODE_5755_length_1049_cov_18.964211	375	466	0	91	91	1.0000000
NODE_5755_length_1049_cov_18.964211	439	519	0	80	80	1.0000000
NODE_5755_length_1049_cov_18.964211	515	595	0	80	80	1.0000000
NODE_5755_length_1049_cov_18.964211	568	648	0	80	80	1.0000000
NODE_5756_length_1049_cov_18.075789	437	517	0	80	80	1.0000000
NODE_5756_length_1049_cov_18.075789	490	570	0	80	80	1.0000000
NODE_5756_length_1049_cov_18.075789	566	644	0	78	78	1.0000000
NODE_5756_length_1049_cov_18.075789	620	695	0	75	75	1.0000000
NODE_5757_length_1049_cov_16.194737	569	650	0	81	81	1.0000000
NODE_5757_length_1049_cov_16.194737	623	703	0	80	80	1.0000000
NODE_5757_length_1049_cov_16.194737	699	779	0	26	80	0.3250000
NODE_5757_length_1049_cov_16.194737	699	779	6	54	80	0.6750000
NODE_5757_length_1049_cov_16.194737	752	832	0	4	80	0.0500000
NODE_5757_length_1049_cov_16.194737	752	832	5	1	80	0.0125000
NODE_5757_length_1049_cov_16.194737	752	832	6	75	80	0.9375000
NODE_5759_length_1049_cov_6.323158	588	668	0	5	80	0.0625000
NODE_5759_length_1049_cov_6.323158	588	668	2	75	80	0.9375000
NODE_5759_length_1049_cov_6.323158	641	721	0	58	80	0.7250000
NODE_5759_length_1049_cov_6.323158	641	721	2	22	80	0.2750000
NODE_5770_length_1048_cov_73.887250	535	615	0	80	80	1.0000000
NODE_5770_length_1048_cov_73.887250	588	668	0	80	80	1.0000000
NODE_5770_length_1048_cov_73.887250	664	744	0	80	80	1.0000000
NODE_5770_length_1048_cov_73.887250	717	797	0	80	80	1.0000000
NODE_5770_length_1048_cov_73.887250	899	979	0	80	80	1.0000000
NODE_5771_length_1048_cov_48.242360	407	487	0	80	80	1.0000000
NODE_5771_length_1048_cov_48.242360	460	540	0	80	80	1.0000000
NODE_5771_length_1048_cov_48.242360	536	616	0	80	80	1.0000000
NODE_5771_length_1048_cov_48.242360	589	669	0	80	80	1.0000000
NODE_5772_length_1048_cov_38.430980	352	432	0	80	80	1.0000000
NODE_5772_length_1048_cov_38.430980	405	485	0	80	80	1.0000000
NODE_5773_length_1048_cov_28.179136	548	628	0	80	80	1.0000000
NODE_5773_length_1048_cov_28.179136	601	681	0	80	80	1.0000000
NODE_5773_length_1048_cov_28.179136	677	757	0	80	80	1.0000000
NODE_5773_length_1048_cov_28.179136	730	810	0	80	80	1.0000000
NODE_5774_length_1048_cov_22.985248	409	489	0	34	80	0.4250000
NODE_5774_length_1048_cov_22.985248	409	489	3	36	80	0.4500000
NODE_5774_length_1048_cov_22.985248	409	489	5	1	80	0.0125000
NODE_5774_length_1048_cov_22.985248	409	489	6	9	80	0.1125000
NODE_5774_length_1048_cov_22.985248	462	542	0	80	80	1.0000000
NODE_5774_length_1048_cov_22.985248	538	618	0	80	80	1.0000000
NODE_5774_length_1048_cov_22.985248	591	671	0	80	80	1.0000000
NODE_5775_length_1048_cov_17.883035	500	580	0	80	80	1.0000000
NODE_5775_length_1048_cov_17.883035	553	633	0	80	80	1.0000000
NODE_5776_length_1048_cov_17.444679	377	457	0	80	80	1.0000000
NODE_5776_length_1048_cov_17.444679	430	510	0	80	80	1.0000000
NODE_5777_length_1048_cov_13.387777	518	598	0	80	80	1.0000000
NODE_5777_length_1048_cov_13.387777	571	651	0	80	80	1.0000000
NODE_5778_length_1048_cov_12.934668	716	796	0	80	80	1.0000000
NODE_5778_length_1048_cov_12.934668	769	849	0	80	80	1.0000000
NODE_5778_length_1048_cov_12.934668	845	925	0	80	80	1.0000000
NODE_5778_length_1048_cov_12.934668	898	975	0	27	77	0.3506494
NODE_5778_length_1048_cov_12.934668	898	975	2	50	77	0.6493506
NODE_5779_length_1048_cov_12.712329	330	410	0	80	80	1.0000000
NODE_5779_length_1048_cov_12.712329	384	463	0	79	79	1.0000000
NODE_5779_length_1048_cov_12.712329	459	539	0	72	80	0.9000000
NODE_5779_length_1048_cov_12.712329	459	539	7	1	80	0.0125000
NODE_5779_length_1048_cov_12.712329	459	539	9	1	80	0.0125000
NODE_5779_length_1048_cov_12.712329	459	539	16	1	80	0.0125000
NODE_5779_length_1048_cov_12.712329	459	539	17	5	80	0.0625000
NODE_5779_length_1048_cov_12.712329	512	592	0	19	80	0.2375000
NODE_5779_length_1048_cov_12.712329	512	592	7	1	80	0.0125000
NODE_5779_length_1048_cov_12.712329	512	592	9	1	80	0.0125000
NODE_5779_length_1048_cov_12.712329	512	592	16	1	80	0.0125000
NODE_5779_length_1048_cov_12.712329	512	592	17	34	80	0.4250000
NODE_5779_length_1048_cov_12.712329	512	592	18	24	80	0.3000000
NODE_5780_length_1048_cov_9.232877	305	355	0	50	50	1.0000000
NODE_5786_length_1047_cov_79.917722	540	620	0	37	80	0.4625000
NODE_5786_length_1047_cov_79.917722	540	620	8	43	80	0.5375000
NODE_5786_length_1047_cov_79.917722	593	673	0	5	80	0.0625000
NODE_5786_length_1047_cov_79.917722	593	673	8	75	80	0.9375000
NODE_5787_length_1047_cov_28.527426	582	662	0	80	80	1.0000000
NODE_5787_length_1047_cov_28.527426	635	715	0	80	80	1.0000000
NODE_5788_length_1047_cov_26.068565	372	452	0	37	80	0.4625000
NODE_5788_length_1047_cov_26.068565	372	452	4	43	80	0.5375000
NODE_5788_length_1047_cov_26.068565	425	505	0	80	80	1.0000000
NODE_5789_length_1047_cov_25.946203	424	504	0	49	80	0.6125000
NODE_5789_length_1047_cov_25.946203	424	504	2	31	80	0.3875000
NODE_5789_length_1047_cov_25.946203	477	557	2	80	80	1.0000000
NODE_5790_length_1047_cov_19.255274	458	538	0	36	80	0.4500000
NODE_5790_length_1047_cov_19.255274	458	538	4	2	80	0.0250000
NODE_5790_length_1047_cov_19.255274	458	538	5	25	80	0.3125000
NODE_5790_length_1047_cov_19.255274	458	538	6	17	80	0.2125000
NODE_5790_length_1047_cov_19.255274	511	591	5	31	80	0.3875000
NODE_5790_length_1047_cov_19.255274	511	591	6	49	80	0.6125000
NODE_5791_length_1047_cov_16.618143	467	547	0	80	80	1.0000000
NODE_5791_length_1047_cov_16.618143	520	600	0	80	80	1.0000000
NODE_5792_length_1047_cov_14.246835	643	723	0	80	80	1.0000000
NODE_5792_length_1047_cov_14.246835	696	776	0	80	80	1.0000000
NODE_5793_length_1047_cov_9.869198	414	494	0	38	80	0.4750000
NODE_5793_length_1047_cov_9.869198	414	494	2	42	80	0.5250000
NODE_5793_length_1047_cov_9.869198	467	547	0	5	80	0.0625000
NODE_5793_length_1047_cov_9.869198	467	547	2	75	80	0.9375000
NODE_5794_length_1047_cov_8.513713	300	380	0	80	80	1.0000000
NODE_5794_length_1047_cov_8.513713	353	433	0	80	80	1.0000000
NODE_5795_length_1047_cov_7.412447	442	522	0	80	80	1.0000000
NODE_5795_length_1047_cov_7.412447	495	575	0	80	80	1.0000000
NODE_5803_length_1046_cov_41.392819	587	667	0	80	80	1.0000000
NODE_5803_length_1046_cov_41.392819	640	720	0	80	80	1.0000000
NODE_5804_length_1046_cov_30.317846	382	462	0	80	80	1.0000000
NODE_5804_length_1046_cov_30.317846	435	515	0	80	80	1.0000000
NODE_5805_length_1046_cov_28.184794	346	426	0	80	80	1.0000000
NODE_5805_length_1046_cov_28.184794	399	479	0	80	80	1.0000000
NODE_5806_length_1046_cov_24.595565	501	581	0	80	80	1.0000000
NODE_5806_length_1046_cov_24.595565	554	634	0	80	80	1.0000000
NODE_5807_length_1046_cov_17.958817	447	527	0	16	80	0.2000000
NODE_5807_length_1046_cov_17.958817	447	527	4	64	80	0.8000000
NODE_5807_length_1046_cov_17.958817	500	580	0	31	80	0.3875000
NODE_5807_length_1046_cov_17.958817	500	580	4	49	80	0.6125000
NODE_5808_length_1046_cov_15.494192	385	465	0	80	80	1.0000000
NODE_5808_length_1046_cov_15.494192	438	518	0	80	80	1.0000000
NODE_5809_length_1046_cov_12.639916	554	634	0	13	80	0.1625000
NODE_5809_length_1046_cov_12.639916	554	634	2	67	80	0.8375000
NODE_5809_length_1046_cov_12.639916	607	687	0	58	80	0.7250000
NODE_5809_length_1046_cov_12.639916	607	687	2	22	80	0.2750000
NODE_5810_length_1046_cov_11.238648	471	551	0	80	80	1.0000000
NODE_5810_length_1046_cov_11.238648	524	604	0	80	80	1.0000000
NODE_5811_length_1046_cov_10.744456	459	539	0	80	80	1.0000000
NODE_5811_length_1046_cov_10.744456	512	592	0	80	80	1.0000000
NODE_5812_length_1046_cov_8.689546	302	382	0	23	80	0.2875000
NODE_5812_length_1046_cov_8.689546	302	382	2	57	80	0.7125000
NODE_5812_length_1046_cov_8.689546	355	435	0	73	80	0.9125000
NODE_5812_length_1046_cov_8.689546	355	435	2	7	80	0.0875000
NODE_5823_length_1045_cov_75.975687	359	440	0	81	81	1.0000000
NODE_5823_length_1045_cov_75.975687	412	493	0	81	81	1.0000000
NODE_5823_length_1045_cov_75.975687	489	569	0	80	80	1.0000000
NODE_5823_length_1045_cov_75.975687	542	622	0	80	80	1.0000000
NODE_5824_length_1045_cov_54.419662	434	514	0	80	80	1.0000000
NODE_5824_length_1045_cov_54.419662	487	567	0	80	80	1.0000000
NODE_5824_length_1045_cov_54.419662	563	639	0	76	76	1.0000000
NODE_5824_length_1045_cov_54.419662	616	696	0	80	80	1.0000000
NODE_5825_length_1045_cov_23.188161	395	475	0	80	80	1.0000000
NODE_5825_length_1045_cov_23.188161	448	528	0	80	80	1.0000000
NODE_5826_length_1045_cov_19.686047	571	651	0	80	80	1.0000000
NODE_5826_length_1045_cov_19.686047	624	704	0	80	80	1.0000000
NODE_5827_length_1045_cov_19.378436	478	558	0	51	80	0.6375000
NODE_5827_length_1045_cov_19.378436	478	558	2	29	80	0.3625000
NODE_5827_length_1045_cov_19.378436	531	611	2	80	80	1.0000000
NODE_5828_length_1045_cov_17.601480	359	439	0	80	80	1.0000000
NODE_5828_length_1045_cov_17.601480	412	492	0	80	80	1.0000000
NODE_5829_length_1045_cov_17.372093	633	713	0	80	80	1.0000000
NODE_5829_length_1045_cov_17.372093	686	766	0	80	80	1.0000000
NODE_5830_length_1045_cov_14.828753	433	513	0	80	80	1.0000000
NODE_5830_length_1045_cov_14.828753	486	566	0	80	80	1.0000000
NODE_5831_length_1045_cov_11.673362	664	744	0	80	80	1.0000000
NODE_5831_length_1045_cov_11.673362	717	797	0	80	80	1.0000000
NODE_5843_length_1044_cov_42.600000	344	424	2	80	80	1.0000000
NODE_5843_length_1044_cov_42.600000	397	477	0	48	80	0.6000000
NODE_5843_length_1044_cov_42.600000	397	477	2	32	80	0.4000000
NODE_5844_length_1044_cov_27.653968	454	534	0	80	80	1.0000000
NODE_5844_length_1044_cov_27.653968	507	587	0	80	80	1.0000000
NODE_5845_length_1044_cov_24.561905	297	375	0	78	78	1.0000000
NODE_5845_length_1044_cov_24.561905	348	428	0	80	80	1.0000000
NODE_5845_length_1044_cov_24.561905	424	504	0	80	80	1.0000000
NODE_5845_length_1044_cov_24.561905	477	557	0	80	80	1.0000000
NODE_5846_length_1044_cov_23.720635	294	374	0	17	80	0.2125000
NODE_5846_length_1044_cov_23.720635	294	374	3	29	80	0.3625000
NODE_5846_length_1044_cov_23.720635	294	374	4	34	80	0.4250000
NODE_5846_length_1044_cov_23.720635	347	427	0	70	80	0.8750000
NODE_5846_length_1044_cov_23.720635	347	427	4	10	80	0.1250000
NODE_5846_length_1044_cov_23.720635	423	503	0	80	80	1.0000000
NODE_5846_length_1044_cov_23.720635	476	556	0	80	80	1.0000000
NODE_5847_length_1044_cov_20.871958	462	542	0	80	80	1.0000000
NODE_5847_length_1044_cov_20.871958	515	595	0	80	80	1.0000000
NODE_5847_length_1044_cov_20.871958	591	671	0	80	80	1.0000000
NODE_5847_length_1044_cov_20.871958	644	724	0	54	80	0.6750000
NODE_5847_length_1044_cov_20.871958	644	724	4	26	80	0.3250000
NODE_5848_length_1044_cov_18.596825	433	513	0	80	80	1.0000000
NODE_5848_length_1044_cov_18.596825	486	566	0	80	80	1.0000000
NODE_5849_length_1044_cov_16.102646	414	494	0	39	80	0.4875000
NODE_5849_length_1044_cov_16.102646	414	494	2	41	80	0.5125000
NODE_5849_length_1044_cov_16.102646	467	547	0	80	80	1.0000000
NODE_5850_length_1044_cov_12.156614	578	658	4	80	80	1.0000000
NODE_5850_length_1044_cov_12.156614	631	711	0	22	80	0.2750000
NODE_5850_length_1044_cov_12.156614	631	711	4	58	80	0.7250000
NODE_5851_length_1044_cov_10.661376	506	586	0	80	80	1.0000000
NODE_5851_length_1044_cov_10.661376	559	639	0	80	80	1.0000000
NODE_5852_length_1044_cov_9.534392	461	541	0	80	80	1.0000000
NODE_5852_length_1044_cov_9.534392	514	594	0	80	80	1.0000000
NODE_5853_length_1044_cov_5.517460	434	514	0	80	80	1.0000000
NODE_5853_length_1044_cov_5.517460	487	567	0	80	80	1.0000000
NODE_5856_length_1044_cov_1.502646	769	845	0	76	76	1.0000000
NODE_5860_length_1043_cov_42.288136	452	532	0	80	80	1.0000000
NODE_5860_length_1043_cov_42.288136	505	585	0	80	80	1.0000000
NODE_5861_length_1043_cov_25.987288	350	430	0	80	80	1.0000000
NODE_5861_length_1043_cov_25.987288	403	483	0	80	80	1.0000000
NODE_5861_length_1043_cov_25.987288	479	559	0	80	80	1.0000000
NODE_5861_length_1043_cov_25.987288	532	612	0	80	80	1.0000000
NODE_5862_length_1043_cov_20.838983	561	641	0	80	80	1.0000000
NODE_5862_length_1043_cov_20.838983	614	694	0	80	80	1.0000000
NODE_5863_length_1043_cov_20.312500	489	569	0	80	80	1.0000000
NODE_5863_length_1043_cov_20.312500	542	622	0	80	80	1.0000000
NODE_5864_length_1043_cov_16.320975	569	649	0	80	80	1.0000000
NODE_5864_length_1043_cov_16.320975	622	702	0	80	80	1.0000000
NODE_5865_length_1043_cov_11.176907	521	601	0	80	80	1.0000000
NODE_5865_length_1043_cov_11.176907	574	654	0	80	80	1.0000000
NODE_5866_length_1043_cov_8.146186	530	596	0	66	66	1.0000000
NODE_5866_length_1043_cov_8.146186	569	649	0	80	80	1.0000000
NODE_5868_length_1043_cov_5.347458	646	726	0	80	80	1.0000000
NODE_5868_length_1043_cov_5.347458	699	779	0	80	80	1.0000000
NODE_5879_length_1042_cov_242.728526	820	900	179	1	80	0.0125000
NODE_5879_length_1042_cov_242.728526	820	900	184	1	80	0.0125000
NODE_5879_length_1042_cov_242.728526	820	900	185	1	80	0.0125000
NODE_5879_length_1042_cov_242.728526	820	900	186	3	80	0.0375000
NODE_5879_length_1042_cov_242.728526	820	900	187	1	80	0.0125000
NODE_5879_length_1042_cov_242.728526	820	900	191	1	80	0.0125000
NODE_5879_length_1042_cov_242.728526	820	900	197	1	80	0.0125000
NODE_5879_length_1042_cov_242.728526	820	900	202	1	80	0.0125000
NODE_5879_length_1042_cov_242.728526	820	900	204	1	80	0.0125000
NODE_5879_length_1042_cov_242.728526	820	900	212	1	80	0.0125000
NODE_5879_length_1042_cov_242.728526	820	900	216	1	80	0.0125000
NODE_5879_length_1042_cov_242.728526	820	900	221	1	80	0.0125000
NODE_5879_length_1042_cov_242.728526	820	900	231	1	80	0.0125000
NODE_5879_length_1042_cov_242.728526	820	900	232	1	80	0.0125000
NODE_5879_length_1042_cov_242.728526	820	900	233	1	80	0.0125000
NODE_5879_length_1042_cov_242.728526	820	900	234	1	80	0.0125000
NODE_5879_length_1042_cov_242.728526	820	900	238	2	80	0.0250000
NODE_5879_length_1042_cov_242.728526	820	900	240	1	80	0.0125000
NODE_5879_length_1042_cov_242.728526	820	900	241	1	80	0.0125000
NODE_5879_length_1042_cov_242.728526	820	900	242	5	80	0.0625000
NODE_5879_length_1042_cov_242.728526	820	900	243	3	80	0.0375000
NODE_5879_length_1042_cov_242.728526	820	900	244	2	80	0.0250000
NODE_5879_length_1042_cov_242.728526	820	900	245	3	80	0.0375000
NODE_5879_length_1042_cov_242.728526	820	900	246	2	80	0.0250000
NODE_5879_length_1042_cov_242.728526	820	900	249	1	80	0.0125000
NODE_5879_length_1042_cov_242.728526	820	900	251	3	80	0.0375000
NODE_5879_length_1042_cov_242.728526	820	900	254	1	80	0.0125000
NODE_5879_length_1042_cov_242.728526	820	900	255	4	80	0.0500000
NODE_5879_length_1042_cov_242.728526	820	900	256	3	80	0.0375000
NODE_5879_length_1042_cov_242.728526	820	900	257	2	80	0.0250000
NODE_5879_length_1042_cov_242.728526	820	900	259	3	80	0.0375000
NODE_5879_length_1042_cov_242.728526	820	900	260	1	80	0.0125000
NODE_5879_length_1042_cov_242.728526	820	900	271	1	80	0.0125000
NODE_5879_length_1042_cov_242.728526	820	900	272	1	80	0.0125000
NODE_5879_length_1042_cov_242.728526	820	900	273	1	80	0.0125000
NODE_5879_length_1042_cov_242.728526	820	900	281	4	80	0.0500000
NODE_5879_length_1042_cov_242.728526	820	900	282	1	80	0.0125000
NODE_5879_length_1042_cov_242.728526	820	900	284	3	80	0.0375000
NODE_5879_length_1042_cov_242.728526	820	900	286	8	80	0.1000000
NODE_5879_length_1042_cov_242.728526	820	900	287	2	80	0.0250000
NODE_5879_length_1042_cov_242.728526	820	900	288	4	80	0.0500000
NODE_5879_length_1042_cov_242.728526	873	903	257	1	30	0.0333333
NODE_5879_length_1042_cov_242.728526	873	903	259	1	30	0.0333333
NODE_5879_length_1042_cov_242.728526	873	903	271	1	30	0.0333333
NODE_5879_length_1042_cov_242.728526	873	903	272	1	30	0.0333333
NODE_5879_length_1042_cov_242.728526	873	903	273	1	30	0.0333333
NODE_5879_length_1042_cov_242.728526	873	903	281	4	30	0.1333333
NODE_5879_length_1042_cov_242.728526	873	903	282	1	30	0.0333333
NODE_5879_length_1042_cov_242.728526	873	903	284	3	30	0.1000000
NODE_5879_length_1042_cov_242.728526	873	903	286	8	30	0.2666667
NODE_5879_length_1042_cov_242.728526	873	903	287	2	30	0.0666667
NODE_5879_length_1042_cov_242.728526	873	903	288	6	30	0.2000000
NODE_5879_length_1042_cov_242.728526	873	903	289	1	30	0.0333333
NODE_5880_length_1042_cov_63.214210	355	435	0	80	80	1.0000000
NODE_5880_length_1042_cov_63.214210	408	488	0	80	80	1.0000000
NODE_5881_length_1042_cov_29.581124	497	577	0	80	80	1.0000000
NODE_5881_length_1042_cov_29.581124	550	630	0	80	80	1.0000000
NODE_5882_length_1042_cov_23.861082	519	599	0	19	80	0.2375000
NODE_5882_length_1042_cov_23.861082	519	599	1	61	80	0.7625000
NODE_5882_length_1042_cov_23.861082	572	652	1	80	80	1.0000000
NODE_5882_length_1042_cov_23.861082	648	728	1	19	80	0.2375000
NODE_5882_length_1042_cov_23.861082	648	728	2	34	80	0.4250000
NODE_5882_length_1042_cov_23.861082	648	728	7	27	80	0.3375000
NODE_5882_length_1042_cov_23.861082	701	781	7	80	80	1.0000000
NODE_5883_length_1042_cov_22.247084	555	635	0	80	80	1.0000000
NODE_5883_length_1042_cov_22.247084	608	688	0	80	80	1.0000000
NODE_5884_length_1042_cov_22.117709	335	415	0	80	80	1.0000000
NODE_5884_length_1042_cov_22.117709	388	468	0	80	80	1.0000000
NODE_5884_length_1042_cov_22.117709	464	544	0	80	80	1.0000000
NODE_5884_length_1042_cov_22.117709	517	597	0	80	80	1.0000000
NODE_5885_length_1042_cov_16.831389	27	97	2	18	70	0.2571429
NODE_5885_length_1042_cov_16.831389	27	97	3	3	70	0.0428571
NODE_5885_length_1042_cov_16.831389	27	97	4	28	70	0.4000000
NODE_5885_length_1042_cov_16.831389	27	97	6	21	70	0.3000000
NODE_5885_length_1042_cov_16.831389	372	452	0	80	80	1.0000000
NODE_5885_length_1042_cov_16.831389	425	505	0	80	80	1.0000000
NODE_5886_length_1042_cov_16.662778	416	496	0	80	80	1.0000000
NODE_5886_length_1042_cov_16.662778	469	549	0	80	80	1.0000000
NODE_5887_length_1042_cov_9.474019	361	441	2	76	80	0.9500000
NODE_5887_length_1042_cov_9.474019	361	441	4	4	80	0.0500000
NODE_5887_length_1042_cov_9.474019	414	494	2	25	80	0.3125000
NODE_5887_length_1042_cov_9.474019	414	494	4	55	80	0.6875000
NODE_5888_length_1042_cov_6.725345	356	419	0	63	63	1.0000000
NODE_5888_length_1042_cov_6.725345	392	472	0	80	80	1.0000000
NODE_5896_length_1041_cov_42.960722	335	415	0	80	80	1.0000000
NODE_5896_length_1041_cov_42.960722	388	468	0	80	80	1.0000000
NODE_5896_length_1041_cov_42.960722	464	544	0	80	80	1.0000000
NODE_5896_length_1041_cov_42.960722	517	597	0	80	80	1.0000000
NODE_5897_length_1041_cov_37.331210	513	593	2	80	80	1.0000000
NODE_5897_length_1041_cov_37.331210	566	646	0	29	80	0.3625000
NODE_5897_length_1041_cov_37.331210	566	646	2	51	80	0.6375000
NODE_5897_length_1041_cov_37.331210	642	722	0	80	80	1.0000000
NODE_5897_length_1041_cov_37.331210	695	775	0	80	80	1.0000000
NODE_5898_length_1041_cov_36.477707	455	535	0	8	80	0.1000000
NODE_5898_length_1041_cov_36.477707	455	535	2	72	80	0.9000000
NODE_5898_length_1041_cov_36.477707	508	588	2	48	80	0.6000000
NODE_5898_length_1041_cov_36.477707	508	588	4	30	80	0.3750000
NODE_5898_length_1041_cov_36.477707	508	588	6	2	80	0.0250000
NODE_5898_length_1041_cov_36.477707	584	664	4	80	80	1.0000000
NODE_5898_length_1041_cov_36.477707	637	717	0	28	80	0.3500000
NODE_5898_length_1041_cov_36.477707	637	717	2	4	80	0.0500000
NODE_5898_length_1041_cov_36.477707	637	717	4	48	80	0.6000000
NODE_5898_length_1041_cov_36.477707	753	799	0	46	46	1.0000000
NODE_5899_length_1041_cov_19.286624	468	548	0	80	80	1.0000000
NODE_5899_length_1041_cov_19.286624	521	601	0	80	80	1.0000000
NODE_5900_length_1041_cov_17.072187	578	658	0	80	80	1.0000000
NODE_5900_length_1041_cov_17.072187	631	711	0	80	80	1.0000000
NODE_5901_length_1041_cov_11.887473	437	517	0	39	80	0.4875000
NODE_5901_length_1041_cov_11.887473	437	517	2	41	80	0.5125000
NODE_5901_length_1041_cov_11.887473	490	570	0	6	80	0.0750000
NODE_5901_length_1041_cov_11.887473	490	570	2	74	80	0.9250000
NODE_5902_length_1041_cov_6.957537	354	434	0	80	80	1.0000000
NODE_5902_length_1041_cov_6.957537	407	487	0	80	80	1.0000000
NODE_5913_length_1040_cov_34.618491	478	558	0	80	80	1.0000000
NODE_5913_length_1040_cov_34.618491	531	611	0	80	80	1.0000000
NODE_5914_length_1040_cov_33.061637	485	565	0	79	80	0.9875000
NODE_5914_length_1040_cov_33.061637	485	565	2	1	80	0.0125000
NODE_5914_length_1040_cov_33.061637	538	618	0	26	80	0.3250000
NODE_5914_length_1040_cov_33.061637	538	618	2	54	80	0.6750000
NODE_5915_length_1040_cov_27.818278	402	482	0	80	80	1.0000000
NODE_5915_length_1040_cov_27.818278	455	535	0	80	80	1.0000000
NODE_5916_length_1040_cov_17.933050	487	567	0	80	80	1.0000000
NODE_5916_length_1040_cov_17.933050	540	620	0	80	80	1.0000000
NODE_5917_length_1040_cov_14.327311	237	317	0	80	80	1.0000000
NODE_5917_length_1040_cov_14.327311	290	370	0	80	80	1.0000000
NODE_5917_length_1040_cov_14.327311	366	446	0	80	80	1.0000000
NODE_5917_length_1040_cov_14.327311	419	499	0	80	80	1.0000000
NODE_5918_length_1040_cov_11.910733	369	449	0	28	80	0.3500000
NODE_5918_length_1040_cov_11.910733	369	449	1	5	80	0.0625000
NODE_5918_length_1040_cov_11.910733	369	449	2	47	80	0.5875000
NODE_5918_length_1040_cov_11.910733	422	502	0	80	80	1.0000000
NODE_5919_length_1040_cov_11.521785	355	435	0	80	80	1.0000000
NODE_5919_length_1040_cov_11.521785	408	488	0	80	80	1.0000000
NODE_5920_length_1040_cov_9.573858	632	712	0	80	80	1.0000000
NODE_5920_length_1040_cov_9.573858	685	765	0	80	80	1.0000000
NODE_5921_length_1040_cov_8.148778	349	429	0	80	80	1.0000000
NODE_5921_length_1040_cov_8.148778	402	482	0	55	80	0.6875000
NODE_5921_length_1040_cov_8.148778	402	482	1	6	80	0.0750000
NODE_5921_length_1040_cov_8.148778	402	482	2	19	80	0.2375000
NODE_5922_length_1040_cov_7.927736	282	362	0	80	80	1.0000000
NODE_5922_length_1040_cov_7.927736	335	415	0	80	80	1.0000000
NODE_5927_length_1040_cov_2.317747	2	78	0	76	76	1.0000000
NODE_5934_length_1039_cov_40.150000	487	567	0	80	80	1.0000000
NODE_5934_length_1039_cov_40.150000	540	620	0	80	80	1.0000000
NODE_5934_length_1039_cov_40.150000	616	696	0	6	80	0.0750000
NODE_5934_length_1039_cov_40.150000	616	696	2	74	80	0.9250000
NODE_5934_length_1039_cov_40.150000	669	739	0	21	70	0.3000000
NODE_5934_length_1039_cov_40.150000	669	739	2	49	70	0.7000000
NODE_5935_length_1039_cov_37.940426	175	255	0	80	80	1.0000000
NODE_5935_length_1039_cov_37.940426	228	308	0	80	80	1.0000000
NODE_5935_length_1039_cov_37.940426	304	384	0	80	80	1.0000000
NODE_5935_length_1039_cov_37.940426	357	437	0	80	80	1.0000000
NODE_5936_length_1039_cov_24.567021	371	451	0	80	80	1.0000000
NODE_5936_length_1039_cov_24.567021	424	504	0	80	80	1.0000000
NODE_5937_length_1039_cov_15.790426	293	373	0	80	80	1.0000000
NODE_5937_length_1039_cov_15.790426	346	426	0	80	80	1.0000000
NODE_5938_length_1039_cov_14.670213	591	671	0	80	80	1.0000000
NODE_5938_length_1039_cov_14.670213	644	724	0	59	80	0.7375000
NODE_5938_length_1039_cov_14.670213	644	724	2	21	80	0.2625000
NODE_5939_length_1039_cov_11.568085	439	519	0	80	80	1.0000000
NODE_5939_length_1039_cov_11.568085	492	571	0	79	79	1.0000000
NODE_5947_length_1038_cov_17.191693	549	629	0	80	80	1.0000000
NODE_5947_length_1038_cov_17.191693	602	682	0	80	80	1.0000000
NODE_5948_length_1038_cov_13.520767	516	596	0	80	80	1.0000000
NODE_5948_length_1038_cov_13.520767	569	649	0	80	80	1.0000000
NODE_5949_length_1038_cov_10.541001	487	567	0	80	80	1.0000000
NODE_5949_length_1038_cov_10.541001	540	620	0	80	80	1.0000000
NODE_5950_length_1038_cov_8.826411	432	512	0	80	80	1.0000000
NODE_5950_length_1038_cov_8.826411	485	565	0	80	80	1.0000000
NODE_5952_length_1038_cov_2.587859	673	753	0	80	80	1.0000000
NODE_5952_length_1038_cov_2.587859	726	806	0	80	80	1.0000000
NODE_5963_length_1037_cov_66.968017	402	482	0	80	80	1.0000000
NODE_5963_length_1037_cov_66.968017	455	535	0	61	80	0.7625000
NODE_5963_length_1037_cov_66.968017	455	535	2	19	80	0.2375000
NODE_5964_length_1037_cov_53.639659	527	607	0	80	80	1.0000000
NODE_5964_length_1037_cov_53.639659	580	660	0	80	80	1.0000000
NODE_5965_length_1037_cov_45.353945	542	622	0	4	80	0.0500000
NODE_5965_length_1037_cov_45.353945	542	622	6	76	80	0.9500000
NODE_5965_length_1037_cov_45.353945	595	675	4	25	80	0.3125000
NODE_5965_length_1037_cov_45.353945	595	675	6	35	80	0.4375000
NODE_5965_length_1037_cov_45.353945	595	675	8	3	80	0.0375000
NODE_5965_length_1037_cov_45.353945	595	675	9	1	80	0.0125000
NODE_5965_length_1037_cov_45.353945	595	675	10	16	80	0.2000000
NODE_5966_length_1037_cov_31.078891	356	436	0	6	80	0.0750000
NODE_5966_length_1037_cov_31.078891	356	436	6	74	80	0.9250000
NODE_5966_length_1037_cov_31.078891	409	489	0	59	80	0.7375000
NODE_5966_length_1037_cov_31.078891	409	489	6	21	80	0.2625000
NODE_5967_length_1037_cov_25.453092	421	501	0	38	80	0.4750000
NODE_5967_length_1037_cov_25.453092	421	501	2	42	80	0.5250000
NODE_5967_length_1037_cov_25.453092	474	554	0	80	80	1.0000000
NODE_5967_length_1037_cov_25.453092	550	573	0	23	23	1.0000000
NODE_5968_length_1037_cov_13.740938	348	428	0	80	80	1.0000000
NODE_5968_length_1037_cov_13.740938	401	481	0	80	80	1.0000000
NODE_5969_length_1037_cov_12.632196	564	644	0	80	80	1.0000000
NODE_5969_length_1037_cov_12.632196	617	697	0	80	80	1.0000000
NODE_5970_length_1037_cov_8.904051	640	720	0	80	80	1.0000000
NODE_5970_length_1037_cov_8.904051	693	773	0	80	80	1.0000000
NODE_5978_length_1037_cov_1.859275	31	91	0	60	60	1.0000000
NODE_5986_length_1036_cov_52.270011	493	573	0	80	80	1.0000000
NODE_5986_length_1036_cov_52.270011	546	626	0	80	80	1.0000000
NODE_5987_length_1036_cov_24.080043	369	449	0	3	80	0.0375000
NODE_5987_length_1036_cov_24.080043	369	449	2	77	80	0.9625000
NODE_5987_length_1036_cov_24.080043	422	502	0	53	80	0.6625000
NODE_5987_length_1036_cov_24.080043	422	502	2	27	80	0.3375000
NODE_5988_length_1036_cov_20.533618	513	593	0	80	80	1.0000000
NODE_5988_length_1036_cov_20.533618	566	645	0	79	79	1.0000000
NODE_5988_length_1036_cov_20.533618	648	728	0	80	80	1.0000000
NODE_5988_length_1036_cov_20.533618	701	781	0	80	80	1.0000000
NODE_5989_length_1036_cov_19.715048	467	547	2	39	80	0.4875000
NODE_5989_length_1036_cov_19.715048	467	547	4	41	80	0.5125000
NODE_5989_length_1036_cov_19.715048	520	600	2	30	80	0.3750000
NODE_5989_length_1036_cov_19.715048	520	600	6	50	80	0.6250000
NODE_5990_length_1036_cov_19.452508	399	479	0	80	80	1.0000000
NODE_5990_length_1036_cov_19.452508	452	532	0	69	80	0.8625000
NODE_5990_length_1036_cov_19.452508	452	532	2	11	80	0.1375000
NODE_5990_length_1036_cov_19.452508	528	608	2	80	80	1.0000000
NODE_5990_length_1036_cov_19.452508	581	661	2	80	80	1.0000000
NODE_5991_length_1036_cov_13.840982	635	715	0	80	80	1.0000000
NODE_5991_length_1036_cov_13.840982	688	768	0	80	80	1.0000000
NODE_5992_length_1036_cov_6.913554	424	504	0	80	80	1.0000000
NODE_5992_length_1036_cov_6.913554	477	557	0	80	80	1.0000000
NODE_5993_length_1036_cov_5.880470	436	516	0	80	80	1.0000000
NODE_5993_length_1036_cov_5.880470	489	569	0	80	80	1.0000000
NODE_5994_length_1036_cov_4.638207	531	611	0	80	80	1.0000000
NODE_5994_length_1036_cov_4.638207	584	664	0	80	80	1.0000000
NODE_5998_length_1036_cov_1.293490	19	69	0	50	50	1.0000000
NODE_6001_length_1035_cov_31.941239	590	670	0	80	80	1.0000000
NODE_6001_length_1035_cov_31.941239	643	723	0	80	80	1.0000000
NODE_6002_length_1035_cov_14.917735	396	476	0	24	80	0.3000000
NODE_6002_length_1035_cov_14.917735	396	476	3	1	80	0.0125000
NODE_6002_length_1035_cov_14.917735	396	476	4	45	80	0.5625000
NODE_6002_length_1035_cov_14.917735	396	476	8	10	80	0.1250000
NODE_6002_length_1035_cov_14.917735	449	529	4	17	80	0.2125000
NODE_6002_length_1035_cov_14.917735	449	529	8	63	80	0.7875000
NODE_6003_length_1035_cov_12.552350	467	547	0	80	80	1.0000000
NODE_6003_length_1035_cov_12.552350	520	600	0	80	80	1.0000000
NODE_6004_length_1035_cov_12.050214	40	103	4	63	63	1.0000000
NODE_6004_length_1035_cov_12.050214	138	219	0	8	81	0.0987654
NODE_6004_length_1035_cov_12.050214	138	219	2	73	81	0.9012346
NODE_6005_length_1035_cov_7.020299	350	430	0	80	80	1.0000000
NODE_6005_length_1035_cov_7.020299	403	483	0	80	80	1.0000000
NODE_6006_length_1035_cov_4.726496	531	611	0	80	80	1.0000000
NODE_6006_length_1035_cov_4.726496	584	664	0	80	80	1.0000000
NODE_6018_length_1034_cov_26.810695	322	402	0	80	80	1.0000000
NODE_6018_length_1034_cov_26.810695	375	455	0	80	80	1.0000000
NODE_6018_length_1034_cov_26.810695	451	531	0	80	80	1.0000000
NODE_6018_length_1034_cov_26.810695	504	584	0	80	80	1.0000000
NODE_6032_length_1033_cov_42.574946	462	542	0	80	80	1.0000000
NODE_6032_length_1033_cov_42.574946	515	595	0	80	80	1.0000000
NODE_6033_length_1033_cov_17.073876	464	544	0	80	80	1.0000000
NODE_6033_length_1033_cov_17.073876	517	597	0	57	80	0.7125000
NODE_6033_length_1033_cov_17.073876	517	597	2	23	80	0.2875000
NODE_6034_length_1033_cov_15.791221	309	386	2	77	77	1.0000000
NODE_6034_length_1033_cov_15.791221	359	439	2	80	80	1.0000000
NODE_6035_length_1033_cov_11.340471	437	517	0	80	80	1.0000000
NODE_6035_length_1033_cov_11.340471	490	570	0	80	80	1.0000000
NODE_6045_length_1032_cov_56.511254	466	546	0	24	80	0.3000000
NODE_6045_length_1032_cov_56.511254	466	546	4	56	80	0.7000000
NODE_6045_length_1032_cov_56.511254	519	599	0	77	80	0.9625000
NODE_6045_length_1032_cov_56.511254	519	599	4	3	80	0.0375000
NODE_6046_length_1032_cov_20.752412	479	559	0	80	80	1.0000000
NODE_6046_length_1032_cov_20.752412	532	612	0	80	80	1.0000000
NODE_6047_length_1032_cov_8.166131	257	337	0	80	80	1.0000000
NODE_6047_length_1032_cov_8.166131	310	390	0	80	80	1.0000000
NODE_6048_length_1032_cov_7.991426	277	357	0	80	80	1.0000000
NODE_6048_length_1032_cov_7.991426	330	410	0	80	80	1.0000000
NODE_6049_length_1032_cov_5.276527	371	451	0	54	80	0.6750000
NODE_6049_length_1032_cov_5.276527	371	451	2	26	80	0.3250000
NODE_6049_length_1032_cov_5.276527	424	504	0	1	80	0.0125000
NODE_6049_length_1032_cov_5.276527	424	504	2	79	80	0.9875000
NODE_6055_length_1031_cov_71.154506	586	654	0	68	68	1.0000000
NODE_6055_length_1031_cov_71.154506	616	696	0	80	80	1.0000000
NODE_6055_length_1031_cov_71.154506	669	749	0	80	80	1.0000000
NODE_6056_length_1031_cov_70.221030	409	489	0	4	80	0.0500000
NODE_6056_length_1031_cov_70.221030	409	489	4	9	80	0.1125000
NODE_6056_length_1031_cov_70.221030	409	489	6	43	80	0.5375000
NODE_6056_length_1031_cov_70.221030	409	489	8	19	80	0.2375000
NODE_6056_length_1031_cov_70.221030	409	489	10	5	80	0.0625000
NODE_6056_length_1031_cov_70.221030	462	542	0	17	80	0.2125000
NODE_6056_length_1031_cov_70.221030	462	542	6	63	80	0.7875000
NODE_6056_length_1031_cov_70.221030	538	618	0	35	80	0.4375000
NODE_6056_length_1031_cov_70.221030	538	618	4	2	80	0.0250000
NODE_6056_length_1031_cov_70.221030	538	618	5	3	80	0.0375000
NODE_6056_length_1031_cov_70.221030	538	618	6	40	80	0.5000000
NODE_6056_length_1031_cov_70.221030	591	671	0	80	80	1.0000000
NODE_6057_length_1031_cov_43.618026	462	542	0	80	80	1.0000000
NODE_6057_length_1031_cov_43.618026	515	595	0	80	80	1.0000000
NODE_6058_length_1031_cov_43.581545	303	383	0	80	80	1.0000000
NODE_6058_length_1031_cov_43.581545	356	436	0	80	80	1.0000000
NODE_6058_length_1031_cov_43.581545	432	512	0	80	80	1.0000000
NODE_6058_length_1031_cov_43.581545	485	565	0	80	80	1.0000000
NODE_6059_length_1031_cov_22.310086	382	462	0	80	80	1.0000000
NODE_6059_length_1031_cov_22.310086	435	515	0	80	80	1.0000000
NODE_6060_length_1031_cov_11.547210	481	561	0	80	80	1.0000000
NODE_6060_length_1031_cov_11.547210	534	614	0	80	80	1.0000000
NODE_6066_length_1030_cov_54.380236	363	443	0	80	80	1.0000000
NODE_6066_length_1030_cov_54.380236	416	496	0	80	80	1.0000000
NODE_6066_length_1030_cov_54.380236	492	572	0	80	80	1.0000000
NODE_6066_length_1030_cov_54.380236	545	625	0	80	80	1.0000000
NODE_6067_length_1030_cov_45.040816	334	414	0	80	80	1.0000000
NODE_6067_length_1030_cov_45.040816	387	467	0	76	80	0.9500000
NODE_6067_length_1030_cov_45.040816	387	467	4	4	80	0.0500000
NODE_6067_length_1030_cov_45.040816	463	543	4	43	80	0.5375000
NODE_6067_length_1030_cov_45.040816	463	543	8	33	80	0.4125000
NODE_6067_length_1030_cov_45.040816	463	543	10	4	80	0.0500000
NODE_6067_length_1030_cov_45.040816	516	596	8	23	80	0.2875000
NODE_6067_length_1030_cov_45.040816	516	596	10	43	80	0.5375000
NODE_6067_length_1030_cov_45.040816	516	596	14	14	80	0.1750000
NODE_6068_length_1030_cov_20.491944	511	591	0	80	80	1.0000000
NODE_6068_length_1030_cov_20.491944	564	644	0	80	80	1.0000000
NODE_6069_length_1030_cov_17.253491	524	604	0	80	80	1.0000000
NODE_6069_length_1030_cov_17.253491	577	657	0	80	80	1.0000000
NODE_6070_length_1030_cov_14.337272	564	644	0	80	80	1.0000000
NODE_6070_length_1030_cov_14.337272	617	697	0	80	80	1.0000000
NODE_6071_length_1030_cov_5.742213	474	554	0	80	80	1.0000000
NODE_6071_length_1030_cov_5.742213	527	607	0	80	80	1.0000000
NODE_6073_length_1030_cov_5.208378	978	1030	0	22	52	0.4230769
NODE_6073_length_1030_cov_5.208378	978	1030	2	7	52	0.1346154
NODE_6073_length_1030_cov_5.208378	978	1030	4	14	52	0.2692308
NODE_6073_length_1030_cov_5.208378	978	1030	6	3	52	0.0576923
NODE_6073_length_1030_cov_5.208378	978	1030	8	6	52	0.1153846
NODE_6077_length_1030_cov_2.146079	979	1010	0	31	31	1.0000000
NODE_6083_length_1029_cov_236.527957	584	666	23	14	82	0.1707317
NODE_6083_length_1029_cov_236.527957	584	666	35	6	82	0.0731707
NODE_6083_length_1029_cov_236.527957	584	666	37	7	82	0.0853659
NODE_6083_length_1029_cov_236.527957	584	666	40	55	82	0.6707317
NODE_6083_length_1029_cov_236.527957	639	702	18	22	63	0.3492064
NODE_6083_length_1029_cov_236.527957	639	702	36	4	63	0.0634921
NODE_6083_length_1029_cov_236.527957	639	702	37	1	63	0.0158730
NODE_6083_length_1029_cov_236.527957	639	702	40	36	63	0.5714286
NODE_6084_length_1029_cov_41.650538	364	444	0	80	80	1.0000000
NODE_6084_length_1029_cov_41.650538	417	497	0	80	80	1.0000000
NODE_6084_length_1029_cov_41.650538	493	573	0	80	80	1.0000000
NODE_6084_length_1029_cov_41.650538	546	626	0	80	80	1.0000000
NODE_6085_length_1029_cov_34.940860	314	360	0	46	46	1.0000000
NODE_6085_length_1029_cov_34.940860	371	451	0	80	80	1.0000000
NODE_6085_length_1029_cov_34.940860	424	502	0	78	78	1.0000000
NODE_6086_length_1029_cov_28.752688	255	335	0	11	80	0.1375000
NODE_6086_length_1029_cov_28.752688	255	335	4	69	80	0.8625000
NODE_6086_length_1029_cov_28.752688	308	388	0	64	80	0.8000000
NODE_6086_length_1029_cov_28.752688	308	388	4	16	80	0.2000000
NODE_6086_length_1029_cov_28.752688	384	464	0	80	80	1.0000000
NODE_6086_length_1029_cov_28.752688	437	517	0	80	80	1.0000000
NODE_6087_length_1029_cov_28.523656	409	489	0	80	80	1.0000000
NODE_6087_length_1029_cov_28.523656	462	542	0	80	80	1.0000000
NODE_6088_length_1029_cov_28.283871	281	361	0	80	80	1.0000000
NODE_6088_length_1029_cov_28.283871	334	414	0	80	80	1.0000000
NODE_6088_length_1029_cov_28.283871	410	490	0	80	80	1.0000000
NODE_6088_length_1029_cov_28.283871	463	546	0	83	83	1.0000000
NODE_6089_length_1029_cov_26.883871	434	514	0	80	80	1.0000000
NODE_6089_length_1029_cov_26.883871	487	567	0	80	80	1.0000000
NODE_6090_length_1029_cov_23.552688	305	385	0	80	80	1.0000000
NODE_6090_length_1029_cov_23.552688	358	438	0	80	80	1.0000000
NODE_6090_length_1029_cov_23.552688	434	514	0	80	80	1.0000000
NODE_6090_length_1029_cov_23.552688	487	567	0	80	80	1.0000000
NODE_6091_length_1029_cov_22.520430	434	514	0	80	80	1.0000000
NODE_6091_length_1029_cov_22.520430	487	567	0	80	80	1.0000000
NODE_6092_length_1029_cov_21.924731	335	415	0	80	80	1.0000000
NODE_6092_length_1029_cov_21.924731	388	468	0	80	80	1.0000000
NODE_6093_length_1029_cov_17.101075	501	581	6	80	80	1.0000000
NODE_6093_length_1029_cov_17.101075	554	634	0	48	80	0.6000000
NODE_6093_length_1029_cov_17.101075	554	634	6	32	80	0.4000000
NODE_6093_length_1029_cov_17.101075	630	710	0	80	80	1.0000000
NODE_6093_length_1029_cov_17.101075	683	755	0	72	72	1.0000000
NODE_6094_length_1029_cov_14.052688	405	485	0	80	80	1.0000000
NODE_6094_length_1029_cov_14.052688	458	538	0	80	80	1.0000000
NODE_6095_length_1029_cov_11.119355	291	369	0	78	78	1.0000000
NODE_6095_length_1029_cov_11.119355	342	422	0	80	80	1.0000000
NODE_6097_length_1029_cov_3.850538	231	311	0	80	80	1.0000000
NODE_6097_length_1029_cov_3.850538	284	364	0	80	80	1.0000000
NODE_6104_length_1028_cov_19.625404	495	575	0	52	80	0.6500000
NODE_6104_length_1028_cov_19.625404	495	575	2	28	80	0.3500000
NODE_6104_length_1028_cov_19.625404	548	628	0	10	80	0.1250000
NODE_6104_length_1028_cov_19.625404	548	628	2	70	80	0.8750000
NODE_6105_length_1028_cov_17.497309	533	613	0	80	80	1.0000000
NODE_6105_length_1028_cov_17.497309	586	666	0	80	80	1.0000000
NODE_6106_length_1028_cov_16.528525	497	577	0	80	80	1.0000000
NODE_6106_length_1028_cov_16.528525	550	630	0	80	80	1.0000000
NODE_6107_length_1028_cov_10.212056	463	543	0	80	80	1.0000000
NODE_6107_length_1028_cov_10.212056	516	596	0	80	80	1.0000000
NODE_6108_length_1028_cov_10.131324	399	479	0	80	80	1.0000000
NODE_6108_length_1028_cov_10.131324	452	532	0	80	80	1.0000000
NODE_6109_length_1028_cov_9.773950	482	562	0	80	80	1.0000000
NODE_6109_length_1028_cov_9.773950	535	615	0	80	80	1.0000000
NODE_6110_length_1028_cov_8.079656	399	479	0	49	80	0.6125000
NODE_6110_length_1028_cov_8.079656	399	479	2	31	80	0.3875000
NODE_6110_length_1028_cov_8.079656	452	532	0	15	80	0.1875000
NODE_6110_length_1028_cov_8.079656	452	532	2	65	80	0.8125000
NODE_6111_length_1028_cov_7.092573	439	519	0	80	80	1.0000000
NODE_6111_length_1028_cov_7.092573	492	572	0	80	80	1.0000000
NODE_6112_length_1028_cov_4.727664	416	488	0	72	72	1.0000000
NODE_6112_length_1028_cov_4.727664	461	541	0	80	80	1.0000000
NODE_6125_length_1027_cov_51.341595	399	479	0	80	80	1.0000000
NODE_6125_length_1027_cov_51.341595	452	532	0	80	80	1.0000000
NODE_6125_length_1027_cov_51.341595	528	608	0	80	80	1.0000000
NODE_6125_length_1027_cov_51.341595	581	661	0	80	80	1.0000000
NODE_6126_length_1027_cov_45.613147	347	427	0	80	80	1.0000000
NODE_6126_length_1027_cov_45.613147	400	480	0	80	80	1.0000000
NODE_6126_length_1027_cov_45.613147	476	556	0	80	80	1.0000000
NODE_6126_length_1027_cov_45.613147	529	609	0	80	80	1.0000000
NODE_6127_length_1027_cov_35.435345	431	511	0	80	80	1.0000000
NODE_6127_length_1027_cov_35.435345	484	564	0	80	80	1.0000000
NODE_6135_length_1026_cov_39.737864	374	454	0	80	80	1.0000000
NODE_6135_length_1026_cov_39.737864	427	509	0	82	82	1.0000000
NODE_6135_length_1026_cov_39.737864	505	585	0	80	80	1.0000000
NODE_6135_length_1026_cov_39.737864	558	638	0	80	80	1.0000000
NODE_6136_length_1026_cov_26.400216	423	503	0	80	80	1.0000000
NODE_6136_length_1026_cov_26.400216	476	556	0	80	80	1.0000000
NODE_6137_length_1026_cov_25.325782	477	557	0	39	80	0.4875000
NODE_6137_length_1026_cov_25.325782	477	557	4	41	80	0.5125000
NODE_6137_length_1026_cov_25.325782	530	610	4	80	80	1.0000000
NODE_6137_length_1026_cov_25.325782	606	686	0	45	80	0.5625000
NODE_6137_length_1026_cov_25.325782	606	686	4	35	80	0.4375000
NODE_6137_length_1026_cov_25.325782	659	739	0	80	80	1.0000000
NODE_6138_length_1026_cov_22.218986	408	488	0	80	80	1.0000000
NODE_6138_length_1026_cov_22.218986	461	541	0	80	80	1.0000000
NODE_6138_length_1026_cov_22.218986	537	617	0	80	80	1.0000000
NODE_6138_length_1026_cov_22.218986	590	670	0	80	80	1.0000000
NODE_6139_length_1026_cov_15.640777	450	530	0	80	80	1.0000000
NODE_6139_length_1026_cov_15.640777	503	583	0	80	80	1.0000000
NODE_6140_length_1026_cov_12.062567	165	245	0	61	80	0.7625000
NODE_6140_length_1026_cov_12.062567	165	245	11	1	80	0.0125000
NODE_6140_length_1026_cov_12.062567	165	245	12	18	80	0.2250000
NODE_6140_length_1026_cov_12.062567	218	298	0	8	80	0.1000000
NODE_6140_length_1026_cov_12.062567	218	298	11	26	80	0.3250000
NODE_6140_length_1026_cov_12.062567	218	298	12	46	80	0.5750000
NODE_6142_length_1026_cov_5.002157	335	415	0	80	80	1.0000000
NODE_6142_length_1026_cov_5.002157	388	468	0	80	80	1.0000000
NODE_6155_length_1025_cov_52.053996	366	446	0	80	80	1.0000000
NODE_6155_length_1025_cov_52.053996	419	499	0	80	80	1.0000000
NODE_6155_length_1025_cov_52.053996	495	575	0	80	80	1.0000000
NODE_6155_length_1025_cov_52.053996	548	628	0	80	80	1.0000000
NODE_6156_length_1025_cov_35.980562	318	375	0	36	57	0.6315789
NODE_6156_length_1025_cov_35.980562	318	375	4	21	57	0.3684210
NODE_6156_length_1025_cov_35.980562	348	428	0	80	80	1.0000000
NODE_6156_length_1025_cov_35.980562	425	482	0	57	57	1.0000000
NODE_6156_length_1025_cov_35.980562	455	521	0	66	66	1.0000000
NODE_6157_length_1025_cov_26.954644	607	687	0	80	80	1.0000000
NODE_6157_length_1025_cov_26.954644	660	740	0	80	80	1.0000000
NODE_6158_length_1025_cov_20.576674	428	508	0	80	80	1.0000000
NODE_6158_length_1025_cov_20.576674	481	561	0	80	80	1.0000000
NODE_6159_length_1025_cov_15.525918	415	495	0	44	80	0.5500000
NODE_6159_length_1025_cov_15.525918	415	495	2	36	80	0.4500000
NODE_6159_length_1025_cov_15.525918	468	548	0	80	80	1.0000000
NODE_6160_length_1025_cov_7.044276	240	320	0	80	80	1.0000000
NODE_6161_length_1025_cov_6.688985	334	414	0	80	80	1.0000000
NODE_6161_length_1025_cov_6.688985	387	467	0	80	80	1.0000000
NODE_6170_length_1024_cov_28.681081	264	344	0	80	80	1.0000000
NODE_6170_length_1024_cov_28.681081	317	397	0	80	80	1.0000000
NODE_6170_length_1024_cov_28.681081	393	477	0	84	84	1.0000000
NODE_6171_length_1024_cov_17.922162	324	404	0	80	80	1.0000000
NODE_6171_length_1024_cov_17.922162	377	457	0	80	80	1.0000000
NODE_6173_length_1024_cov_12.018378	368	448	0	80	80	1.0000000
NODE_6173_length_1024_cov_12.018378	421	501	0	80	80	1.0000000
NODE_6174_length_1024_cov_8.800000	517	597	0	80	80	1.0000000
NODE_6174_length_1024_cov_8.800000	570	650	0	80	80	1.0000000
NODE_6175_length_1024_cov_6.207568	318	398	0	80	80	1.0000000
NODE_6175_length_1024_cov_6.207568	371	451	0	80	80	1.0000000
NODE_6178_length_1024_cov_2.468108	274	324	0	50	50	1.0000000
NODE_6178_length_1024_cov_2.468108	274	322	0	48	48	1.0000000
NODE_6178_length_1024_cov_2.468108	274	324	0	50	50	1.0000000
NODE_6178_length_1024_cov_2.468108	274	323	0	49	49	1.0000000
NODE_6178_length_1024_cov_2.468108	274	322	0	48	48	1.0000000
NODE_6185_length_1023_cov_100.366883	441	521	0	80	80	1.0000000
NODE_6185_length_1023_cov_100.366883	494	574	0	80	80	1.0000000
NODE_6186_length_1023_cov_64.271645	349	429	0	80	80	1.0000000
NODE_6186_length_1023_cov_64.271645	402	482	0	80	80	1.0000000
NODE_6186_length_1023_cov_64.271645	478	558	0	80	80	1.0000000
NODE_6186_length_1023_cov_64.271645	531	611	0	80	80	1.0000000
NODE_6187_length_1023_cov_32.695887	318	398	0	80	80	1.0000000
NODE_6187_length_1023_cov_32.695887	371	451	0	80	80	1.0000000
NODE_6187_length_1023_cov_32.695887	447	527	0	80	80	1.0000000
NODE_6187_length_1023_cov_32.695887	500	580	0	80	80	1.0000000
NODE_6188_length_1023_cov_16.244589	601	681	0	80	80	1.0000000
NODE_6188_length_1023_cov_16.244589	654	734	0	80	80	1.0000000
NODE_6189_length_1023_cov_15.876623	371	451	0	80	80	1.0000000
NODE_6189_length_1023_cov_15.876623	424	504	0	80	80	1.0000000
NODE_6189_length_1023_cov_15.876623	500	580	0	80	80	1.0000000
NODE_6189_length_1023_cov_15.876623	553	633	0	80	80	1.0000000
NODE_6190_length_1023_cov_14.678571	555	635	0	44	80	0.5500000
NODE_6190_length_1023_cov_14.678571	555	635	2	36	80	0.4500000
NODE_6190_length_1023_cov_14.678571	608	688	2	34	80	0.4250000
NODE_6190_length_1023_cov_14.678571	608	688	4	30	80	0.3750000
NODE_6190_length_1023_cov_14.678571	608	688	6	16	80	0.2000000
NODE_6191_length_1023_cov_14.443723	406	486	0	80	80	1.0000000
NODE_6191_length_1023_cov_14.443723	459	539	0	80	80	1.0000000
NODE_6192_length_1023_cov_10.984848	590	670	0	80	80	1.0000000
NODE_6192_length_1023_cov_10.984848	643	723	0	80	80	1.0000000
NODE_6202_length_1022_cov_42.952329	555	636	0	81	81	1.0000000
NODE_6202_length_1022_cov_42.952329	609	689	0	80	80	1.0000000
NODE_6202_length_1022_cov_42.952329	685	765	0	80	80	1.0000000
NODE_6202_length_1022_cov_42.952329	738	818	0	80	80	1.0000000
NODE_6203_length_1022_cov_29.949079	510	590	0	80	80	1.0000000
NODE_6203_length_1022_cov_29.949079	563	643	0	80	80	1.0000000
NODE_6204_length_1022_cov_7.672806	461	541	0	80	80	1.0000000
NODE_6204_length_1022_cov_7.672806	514	594	0	80	80	1.0000000
NODE_6213_length_1021_cov_47.379610	341	421	0	80	80	1.0000000
NODE_6213_length_1021_cov_47.379610	394	474	0	35	80	0.4375000
NODE_6213_length_1021_cov_47.379610	394	474	2	45	80	0.5625000
NODE_6213_length_1021_cov_47.379610	470	550	2	34	80	0.4250000
NODE_6213_length_1021_cov_47.379610	470	550	6	36	80	0.4500000
NODE_6213_length_1021_cov_47.379610	470	550	8	10	80	0.1250000
NODE_6213_length_1021_cov_47.379610	523	603	0	15	80	0.1875000
NODE_6213_length_1021_cov_47.379610	523	603	6	65	80	0.8125000
NODE_6214_length_1021_cov_33.255965	588	668	0	80	80	1.0000000
NODE_6214_length_1021_cov_33.255965	641	721	0	80	80	1.0000000
NODE_6227_length_1020_cov_24.565689	485	565	0	80	80	1.0000000
NODE_6227_length_1020_cov_24.565689	538	618	0	80	80	1.0000000
NODE_6228_length_1020_cov_20.825190	395	475	0	26	80	0.3250000
NODE_6228_length_1020_cov_20.825190	395	475	1	54	80	0.6750000
NODE_6228_length_1020_cov_20.825190	448	528	0	79	80	0.9875000
NODE_6228_length_1020_cov_20.825190	448	528	1	1	80	0.0125000
NODE_6229_length_1020_cov_20.305103	285	365	0	80	80	1.0000000
NODE_6229_length_1020_cov_20.305103	338	418	0	80	80	1.0000000
NODE_6229_length_1020_cov_20.305103	414	494	0	80	80	1.0000000
NODE_6229_length_1020_cov_20.305103	467	548	0	81	81	1.0000000
NODE_6230_length_1020_cov_17.919653	408	488	0	80	80	1.0000000
NODE_6230_length_1020_cov_17.919653	461	541	0	80	80	1.0000000
NODE_6231_length_1020_cov_13.972856	436	516	0	80	80	1.0000000
NODE_6231_length_1020_cov_13.972856	489	569	0	80	80	1.0000000
NODE_6232_length_1020_cov_10.472313	407	487	0	80	80	1.0000000
NODE_6232_length_1020_cov_10.472313	460	540	0	52	80	0.6500000
NODE_6232_length_1020_cov_10.472313	460	540	2	28	80	0.3500000
NODE_6235_length_1020_cov_3.707926	821	901	0	80	80	1.0000000
NODE_6235_length_1020_cov_3.707926	874	954	0	80	80	1.0000000
NODE_6238_length_1020_cov_2.648208	0	70	0	70	70	1.0000000
NODE_6238_length_1020_cov_2.648208	43	88	0	45	45	1.0000000
NODE_6248_length_1019_cov_30.164130	476	556	0	80	80	1.0000000
NODE_6248_length_1019_cov_30.164130	529	609	0	80	80	1.0000000
NODE_6248_length_1019_cov_30.164130	605	685	0	80	80	1.0000000
NODE_6248_length_1019_cov_30.164130	658	738	0	80	80	1.0000000
NODE_6249_length_1019_cov_22.845652	343	423	0	80	80	1.0000000
NODE_6249_length_1019_cov_22.845652	396	476	0	80	80	1.0000000
NODE_6249_length_1019_cov_22.845652	472	552	0	80	80	1.0000000
NODE_6249_length_1019_cov_22.845652	525	605	0	80	80	1.0000000
NODE_6250_length_1019_cov_8.098913	523	601	0	78	78	1.0000000
NODE_6250_length_1019_cov_8.098913	574	654	0	80	80	1.0000000
NODE_6251_length_1019_cov_7.896739	423	503	4	80	80	1.0000000
NODE_6251_length_1019_cov_7.896739	476	556	0	26	80	0.3250000
NODE_6251_length_1019_cov_7.896739	476	556	2	13	80	0.1625000
NODE_6251_length_1019_cov_7.896739	476	556	4	41	80	0.5125000
NODE_6252_length_1019_cov_4.597826	625	696	0	8	71	0.1126761
NODE_6252_length_1019_cov_4.597826	625	696	2	10	71	0.1408451
NODE_6252_length_1019_cov_4.597826	625	696	6	53	71	0.7464789
NODE_6263_length_1019_cov_1.139130	89	165	10	1	76	0.0131579
NODE_6263_length_1019_cov_1.139130	89	165	11	23	76	0.3026316
NODE_6263_length_1019_cov_1.139130	89	165	12	52	76	0.6842105
NODE_6265_length_1018_cov_33.494015	212	292	0	6	80	0.0750000
NODE_6265_length_1018_cov_33.494015	212	292	2	74	80	0.9250000
NODE_6265_length_1018_cov_33.494015	265	345	0	59	80	0.7375000
NODE_6265_length_1018_cov_33.494015	265	345	2	21	80	0.2625000
NODE_6266_length_1018_cov_22.776931	372	452	0	80	80	1.0000000
NODE_6266_length_1018_cov_22.776931	425	505	0	80	80	1.0000000
NODE_6268_length_1018_cov_8.486398	404	484	0	80	80	1.0000000
NODE_6268_length_1018_cov_8.486398	457	537	0	80	80	1.0000000
NODE_6270_length_1018_cov_7.737758	357	437	0	80	80	1.0000000
NODE_6270_length_1018_cov_7.737758	410	490	0	80	80	1.0000000
NODE_6286_length_1017_cov_207.523965	0	41	16	3	41	0.0731707
NODE_6286_length_1017_cov_207.523965	0	41	17	1	41	0.0243902
NODE_6286_length_1017_cov_207.523965	0	41	19	3	41	0.0731707
NODE_6286_length_1017_cov_207.523965	0	41	21	14	41	0.3414634
NODE_6286_length_1017_cov_207.523965	0	41	23	5	41	0.1219512
NODE_6286_length_1017_cov_207.523965	0	41	25	13	41	0.3170732
NODE_6286_length_1017_cov_207.523965	0	41	27	2	41	0.0487805
NODE_6286_length_1017_cov_207.523965	14	94	21	7	80	0.0875000
NODE_6286_length_1017_cov_207.523965	14	94	23	5	80	0.0625000
NODE_6286_length_1017_cov_207.523965	14	94	25	13	80	0.1625000
NODE_6286_length_1017_cov_207.523965	14	94	27	2	80	0.0250000
NODE_6286_length_1017_cov_207.523965	14	94	29	1	80	0.0125000
NODE_6286_length_1017_cov_207.523965	14	94	31	16	80	0.2000000
NODE_6286_length_1017_cov_207.523965	14	94	33	20	80	0.2500000
NODE_6286_length_1017_cov_207.523965	14	94	35	4	80	0.0500000
NODE_6286_length_1017_cov_207.523965	14	94	36	5	80	0.0625000
NODE_6286_length_1017_cov_207.523965	14	94	42	3	80	0.0375000
NODE_6286_length_1017_cov_207.523965	14	94	44	4	80	0.0500000
NODE_6287_length_1017_cov_18.824619	490	570	0	80	80	1.0000000
NODE_6287_length_1017_cov_18.824619	543	623	0	80	80	1.0000000
NODE_6288_length_1017_cov_14.794118	428	508	0	80	80	1.0000000
NODE_6288_length_1017_cov_14.794118	481	561	0	80	80	1.0000000
NODE_6288_length_1017_cov_14.794118	557	637	0	80	80	1.0000000
NODE_6288_length_1017_cov_14.794118	610	690	0	80	80	1.0000000
NODE_6297_length_1016_cov_22.267176	577	657	0	80	80	1.0000000
NODE_6297_length_1016_cov_22.267176	630	710	0	80	80	1.0000000
NODE_6298_length_1016_cov_21.134133	625	705	0	80	80	1.0000000
NODE_6298_length_1016_cov_21.134133	678	758	0	80	80	1.0000000
NODE_6299_length_1016_cov_20.392585	504	584	0	80	80	1.0000000
NODE_6299_length_1016_cov_20.392585	557	637	0	80	80	1.0000000
NODE_6299_length_1016_cov_20.392585	633	713	0	80	80	1.0000000
NODE_6299_length_1016_cov_20.392585	686	766	0	80	80	1.0000000
NODE_6300_length_1016_cov_16.917121	524	604	0	80	80	1.0000000
NODE_6300_length_1016_cov_16.917121	577	657	0	80	80	1.0000000
NODE_6301_length_1016_cov_8.243184	438	518	0	80	80	1.0000000
NODE_6301_length_1016_cov_8.243184	491	571	0	80	80	1.0000000
NODE_6301_length_1016_cov_8.243184	567	647	0	80	80	1.0000000
NODE_6301_length_1016_cov_8.243184	620	700	0	80	80	1.0000000
NODE_6302_length_1016_cov_8.141767	166	256	1	1	90	0.0111111
NODE_6302_length_1016_cov_8.141767	166	256	2	4	90	0.0444444
NODE_6302_length_1016_cov_8.141767	166	256	4	2	90	0.0222222
NODE_6302_length_1016_cov_8.141767	166	256	8	9	90	0.1000000
NODE_6302_length_1016_cov_8.141767	166	256	10	1	90	0.0111111
NODE_6302_length_1016_cov_8.141767	166	256	12	34	90	0.3777778
NODE_6302_length_1016_cov_8.141767	166	256	14	1	90	0.0111111
NODE_6302_length_1016_cov_8.141767	166	256	16	5	90	0.0555556
NODE_6302_length_1016_cov_8.141767	166	256	18	16	90	0.1777778
NODE_6302_length_1016_cov_8.141767	166	256	20	7	90	0.0777778
NODE_6302_length_1016_cov_8.141767	166	256	22	10	90	0.1111111
NODE_6303_length_1016_cov_7.466739	576	656	0	80	80	1.0000000
NODE_6303_length_1016_cov_7.466739	629	709	0	80	80	1.0000000
NODE_6318_length_1015_cov_24.680131	459	539	0	65	80	0.8125000
NODE_6318_length_1015_cov_24.680131	459	539	11	15	80	0.1875000
NODE_6318_length_1015_cov_24.680131	512	592	0	12	80	0.1500000
NODE_6318_length_1015_cov_24.680131	512	592	11	67	80	0.8375000
NODE_6318_length_1015_cov_24.680131	512	592	12	1	80	0.0125000
NODE_6318_length_1015_cov_24.680131	588	668	11	3	80	0.0375000
NODE_6318_length_1015_cov_24.680131	588	668	12	77	80	0.9625000
NODE_6318_length_1015_cov_24.680131	641	721	0	50	80	0.6250000
NODE_6318_length_1015_cov_24.680131	641	721	12	30	80	0.3750000
NODE_6319_length_1015_cov_23.198690	407	487	0	80	80	1.0000000
NODE_6319_length_1015_cov_23.198690	460	540	0	80	80	1.0000000
NODE_6319_length_1015_cov_23.198690	536	616	0	80	80	1.0000000
NODE_6319_length_1015_cov_23.198690	589	669	0	80	80	1.0000000
NODE_6320_length_1015_cov_22.544760	490	570	0	80	80	1.0000000
NODE_6320_length_1015_cov_22.544760	543	623	0	80	80	1.0000000
NODE_6321_length_1015_cov_17.994541	510	590	0	8	80	0.1000000
NODE_6321_length_1015_cov_17.994541	510	590	2	72	80	0.9000000
NODE_6321_length_1015_cov_17.994541	563	643	0	43	80	0.5375000
NODE_6321_length_1015_cov_17.994541	563	643	2	37	80	0.4625000
NODE_6322_length_1015_cov_16.594978	437	517	0	80	80	1.0000000
NODE_6322_length_1015_cov_16.594978	490	570	0	80	80	1.0000000
NODE_6323_length_1015_cov_14.000000	505	585	7	54	80	0.6750000
NODE_6323_length_1015_cov_14.000000	505	585	8	26	80	0.3250000
NODE_6323_length_1015_cov_14.000000	558	638	0	13	80	0.1625000
NODE_6323_length_1015_cov_14.000000	558	638	7	67	80	0.8375000
NODE_6324_length_1015_cov_9.978166	345	425	0	80	80	1.0000000
NODE_6324_length_1015_cov_9.978166	398	478	0	80	80	1.0000000
NODE_6325_length_1015_cov_6.844978	393	473	0	80	80	1.0000000
NODE_6325_length_1015_cov_6.844978	446	526	0	80	80	1.0000000
NODE_6337_length_1014_cov_95.709290	259	335	0	76	76	1.0000000
NODE_6337_length_1014_cov_95.709290	310	390	0	55	80	0.6875000
NODE_6337_length_1014_cov_95.709290	310	390	1	25	80	0.3125000
NODE_6337_length_1014_cov_95.709290	386	466	1	80	80	1.0000000
NODE_6337_length_1014_cov_95.709290	439	519	0	4	80	0.0500000
NODE_6337_length_1014_cov_95.709290	439	519	1	76	80	0.9500000
NODE_6338_length_1014_cov_67.918033	182	262	0	80	80	1.0000000
NODE_6338_length_1014_cov_67.918033	235	315	0	80	80	1.0000000
NODE_6338_length_1014_cov_67.918033	311	391	0	80	80	1.0000000
NODE_6338_length_1014_cov_67.918033	364	444	0	80	80	1.0000000
NODE_6339_length_1014_cov_44.802186	418	498	0	80	80	1.0000000
NODE_6339_length_1014_cov_44.802186	471	551	0	80	80	1.0000000
NODE_6340_length_1014_cov_36.349727	369	449	0	72	80	0.9000000
NODE_6340_length_1014_cov_36.349727	369	449	2	8	80	0.1000000
NODE_6340_length_1014_cov_36.349727	422	502	0	80	80	1.0000000
NODE_6340_length_1014_cov_36.349727	498	578	0	80	80	1.0000000
NODE_6340_length_1014_cov_36.349727	551	631	0	80	80	1.0000000
NODE_6341_length_1014_cov_35.547541	363	441	0	78	78	1.0000000
NODE_6341_length_1014_cov_35.547541	416	494	0	78	78	1.0000000
NODE_6342_length_1014_cov_32.266667	428	508	0	62	80	0.7750000
NODE_6342_length_1014_cov_32.266667	428	508	8	18	80	0.2250000
NODE_6342_length_1014_cov_32.266667	481	561	0	9	80	0.1125000
NODE_6342_length_1014_cov_32.266667	481	561	8	71	80	0.8875000
NODE_6343_length_1014_cov_28.493989	480	560	0	70	80	0.8750000
NODE_6343_length_1014_cov_28.493989	480	560	2	10	80	0.1250000
NODE_6343_length_1014_cov_28.493989	533	613	0	80	80	1.0000000
NODE_6343_length_1014_cov_28.493989	609	689	0	80	80	1.0000000
NODE_6343_length_1014_cov_28.493989	662	742	0	80	80	1.0000000
NODE_6344_length_1014_cov_25.171585	500	580	0	80	80	1.0000000
NODE_6344_length_1014_cov_25.171585	553	633	0	80	80	1.0000000
NODE_6345_length_1014_cov_22.437158	534	614	0	80	80	1.0000000
NODE_6345_length_1014_cov_22.437158	587	667	0	80	80	1.0000000
NODE_6346_length_1014_cov_19.238251	379	459	0	80	80	1.0000000
NODE_6346_length_1014_cov_19.238251	432	512	0	80	80	1.0000000
NODE_6346_length_1014_cov_19.238251	508	585	0	77	77	1.0000000
NODE_6346_length_1014_cov_19.238251	558	638	0	80	80	1.0000000
NODE_6347_length_1014_cov_15.926776	594	674	0	80	80	1.0000000
NODE_6347_length_1014_cov_15.926776	647	727	0	80	80	1.0000000
NODE_6348_length_1014_cov_8.691803	285	365	0	80	80	1.0000000
NODE_6348_length_1014_cov_8.691803	338	418	0	80	80	1.0000000
NODE_6349_length_1014_cov_7.959563	531	611	0	80	80	1.0000000
NODE_6349_length_1014_cov_7.959563	584	664	0	80	80	1.0000000
NODE_6351_length_1014_cov_7.608743	298	378	0	49	80	0.6125000
NODE_6351_length_1014_cov_7.608743	298	378	4	31	80	0.3875000
NODE_6351_length_1014_cov_7.608743	351	431	0	80	80	1.0000000
NODE_6352_length_1014_cov_6.209836	321	401	0	80	80	1.0000000
NODE_6352_length_1014_cov_6.209836	374	454	0	80	80	1.0000000
NODE_6364_length_1013_cov_32.695842	423	503	0	80	80	1.0000000
NODE_6364_length_1013_cov_32.695842	476	556	0	80	80	1.0000000
NODE_6364_length_1013_cov_32.695842	552	632	0	80	80	1.0000000
NODE_6364_length_1013_cov_32.695842	605	685	0	80	80	1.0000000
NODE_6365_length_1013_cov_21.935449	424	503	0	79	79	1.0000000
NODE_6365_length_1013_cov_21.935449	476	556	0	80	80	1.0000000
NODE_6366_length_1013_cov_17.532823	440	520	0	74	80	0.9250000
NODE_6366_length_1013_cov_17.532823	440	520	1	6	80	0.0750000
NODE_6366_length_1013_cov_17.532823	493	573	0	21	80	0.2625000
NODE_6366_length_1013_cov_17.532823	493	573	1	6	80	0.0750000
NODE_6366_length_1013_cov_17.532823	493	573	2	53	80	0.6625000
NODE_6367_length_1013_cov_14.555799	478	558	0	23	80	0.2875000
NODE_6367_length_1013_cov_14.555799	478	558	4	57	80	0.7125000
NODE_6367_length_1013_cov_14.555799	531	611	0	76	80	0.9500000
NODE_6367_length_1013_cov_14.555799	531	611	4	4	80	0.0500000
NODE_6368_length_1013_cov_13.142232	476	556	0	80	80	1.0000000
NODE_6368_length_1013_cov_13.142232	529	609	0	80	80	1.0000000
NODE_6369_length_1013_cov_7.756018	538	618	0	80	80	1.0000000
NODE_6369_length_1013_cov_7.756018	591	671	0	80	80	1.0000000
NODE_6371_length_1013_cov_4.368709	550	630	0	79	80	0.9875000
NODE_6371_length_1013_cov_4.368709	550	630	2	1	80	0.0125000
NODE_6371_length_1013_cov_4.368709	603	683	0	80	80	1.0000000
NODE_6380_length_1012_cov_91.547645	378	458	0	80	80	1.0000000
NODE_6380_length_1012_cov_91.547645	431	511	0	80	80	1.0000000
NODE_6380_length_1012_cov_91.547645	507	587	0	80	80	1.0000000
NODE_6380_length_1012_cov_91.547645	560	640	0	80	80	1.0000000
NODE_6381_length_1012_cov_64.409639	345	425	0	80	80	1.0000000
NODE_6381_length_1012_cov_64.409639	398	478	0	80	80	1.0000000
NODE_6382_length_1012_cov_63.035049	438	518	0	28	80	0.3500000
NODE_6382_length_1012_cov_63.035049	438	518	22	36	80	0.4500000
NODE_6382_length_1012_cov_63.035049	438	518	26	8	80	0.1000000
NODE_6382_length_1012_cov_63.035049	438	518	28	8	80	0.1000000
NODE_6382_length_1012_cov_63.035049	491	571	22	11	80	0.1375000
NODE_6382_length_1012_cov_63.035049	491	571	26	8	80	0.1000000
NODE_6382_length_1012_cov_63.035049	491	571	28	61	80	0.7625000
NODE_6383_length_1012_cov_53.686747	276	356	0	80	80	1.0000000
NODE_6383_length_1012_cov_53.686747	329	409	0	80	80	1.0000000
NODE_6383_length_1012_cov_53.686747	405	485	0	80	80	1.0000000
NODE_6383_length_1012_cov_53.686747	458	538	0	80	80	1.0000000
NODE_6384_length_1012_cov_35.861993	453	533	0	80	80	1.0000000
NODE_6384_length_1012_cov_35.861993	506	581	0	75	75	1.0000000
NODE_6385_length_1012_cov_16.125958	510	590	0	80	80	1.0000000
NODE_6385_length_1012_cov_16.125958	563	643	0	80	80	1.0000000
NODE_6386_length_1012_cov_15.395400	501	581	0	80	80	1.0000000
NODE_6386_length_1012_cov_15.395400	554	634	0	80	80	1.0000000
NODE_6388_length_1012_cov_6.409639	528	608	0	80	80	1.0000000
NODE_6388_length_1012_cov_6.409639	581	661	0	80	80	1.0000000
NODE_6398_length_1011_cov_53.032895	515	595	0	80	80	1.0000000
NODE_6398_length_1011_cov_53.032895	568	648	0	43	80	0.5375000
NODE_6398_length_1011_cov_53.032895	568	648	2	37	80	0.4625000
NODE_6399_length_1011_cov_25.838816	366	446	0	46	80	0.5750000
NODE_6399_length_1011_cov_25.838816	366	446	2	34	80	0.4250000
NODE_6399_length_1011_cov_25.838816	419	499	0	16	80	0.2000000
NODE_6399_length_1011_cov_25.838816	419	499	2	64	80	0.8000000
NODE_6400_length_1011_cov_22.734649	426	506	0	80	80	1.0000000
NODE_6400_length_1011_cov_22.734649	479	559	0	80	80	1.0000000
NODE_6400_length_1011_cov_22.734649	555	636	0	81	81	1.0000000
NODE_6400_length_1011_cov_22.734649	609	689	0	80	80	1.0000000
NODE_6401_length_1011_cov_18.127193	389	469	0	80	80	1.0000000
NODE_6401_length_1011_cov_18.127193	442	520	0	78	78	1.0000000
NODE_6401_length_1011_cov_18.127193	516	596	0	80	80	1.0000000
NODE_6401_length_1011_cov_18.127193	569	649	0	80	80	1.0000000
NODE_6402_length_1011_cov_12.709430	309	389	0	80	80	1.0000000
NODE_6402_length_1011_cov_12.709430	362	442	0	80	80	1.0000000
NODE_6403_length_1011_cov_8.731360	441	521	0	80	80	1.0000000
NODE_6403_length_1011_cov_8.731360	494	574	0	80	80	1.0000000
NODE_6405_length_1011_cov_7.212719	219	299	0	80	80	1.0000000
NODE_6408_length_1011_cov_3.569079	173	253	0	80	80	1.0000000
NODE_6408_length_1011_cov_3.569079	226	306	0	80	80	1.0000000
NODE_6409_length_1011_cov_1.703947	779	851	6	1	72	0.0138889
NODE_6409_length_1011_cov_1.703947	779	851	8	19	72	0.2638889
NODE_6409_length_1011_cov_1.703947	779	851	10	3	72	0.0416667
NODE_6409_length_1011_cov_1.703947	779	851	11	4	72	0.0555556
NODE_6409_length_1011_cov_1.703947	779	851	12	8	72	0.1111111
NODE_6409_length_1011_cov_1.703947	779	851	13	2	72	0.0277778
NODE_6409_length_1011_cov_1.703947	779	851	14	1	72	0.0138889
NODE_6409_length_1011_cov_1.703947	779	851	16	5	72	0.0694444
NODE_6409_length_1011_cov_1.703947	779	851	18	2	72	0.0277778
NODE_6409_length_1011_cov_1.703947	779	851	22	27	72	0.3750000
NODE_6416_length_1010_cov_51.841932	335	415	0	62	80	0.7750000
NODE_6416_length_1010_cov_51.841932	335	415	2	18	80	0.2250000
NODE_6416_length_1010_cov_51.841932	388	468	0	9	80	0.1125000
NODE_6416_length_1010_cov_51.841932	388	468	2	71	80	0.8875000
NODE_6417_length_1010_cov_35.860593	576	656	0	80	80	1.0000000
NODE_6417_length_1010_cov_35.860593	629	709	0	80	80	1.0000000
NODE_6418_length_1010_cov_30.043908	509	589	0	80	80	1.0000000
NODE_6418_length_1010_cov_30.043908	562	642	0	80	80	1.0000000
NODE_6418_length_1010_cov_30.043908	638	718	0	80	80	1.0000000
NODE_6418_length_1010_cov_30.043908	691	771	0	80	80	1.0000000
NODE_6420_length_1010_cov_15.156970	364	444	0	80	80	1.0000000
NODE_6420_length_1010_cov_15.156970	417	497	0	80	80	1.0000000
NODE_6421_length_1010_cov_13.546652	385	465	0	80	80	1.0000000
NODE_6421_length_1010_cov_13.546652	438	518	0	80	80	1.0000000
NODE_6422_length_1010_cov_13.317234	480	560	0	18	80	0.2250000
NODE_6422_length_1010_cov_13.317234	480	560	4	62	80	0.7750000
NODE_6422_length_1010_cov_13.317234	533	613	4	80	80	1.0000000
NODE_6423_length_1010_cov_12.900110	427	507	0	80	80	1.0000000
NODE_6423_length_1010_cov_12.900110	480	560	0	80	80	1.0000000
NODE_6424_length_1010_cov_11.423710	631	711	0	80	80	1.0000000
NODE_6424_length_1010_cov_11.423710	684	764	0	54	80	0.6750000
NODE_6424_length_1010_cov_11.423710	684	764	2	26	80	0.3250000
NODE_6425_length_1010_cov_11.256861	492	572	0	80	80	1.0000000
NODE_6425_length_1010_cov_11.256861	545	625	0	80	80	1.0000000
NODE_6426_length_1010_cov_11.000000	455	535	0	80	80	1.0000000
NODE_6426_length_1010_cov_11.000000	508	588	0	62	80	0.7750000
NODE_6426_length_1010_cov_11.000000	508	588	2	18	80	0.2250000
NODE_6428_length_1010_cov_4.990121	476	556	0	80	80	1.0000000
NODE_6428_length_1010_cov_4.990121	529	609	0	80	80	1.0000000
NODE_6430_length_1010_cov_4.892426	476	556	0	80	80	1.0000000
NODE_6430_length_1010_cov_4.892426	529	609	0	80	80	1.0000000
NODE_6431_length_1010_cov_3.624588	157	196	0	39	39	1.0000000
NODE_6435_length_1010_cov_1.440176	1	58	0	57	57	1.0000000
NODE_6436_length_1009_cov_44.626374	288	362	0	74	74	1.0000000
NODE_6436_length_1009_cov_44.626374	335	415	0	80	80	1.0000000
NODE_6436_length_1009_cov_44.626374	411	491	0	80	80	1.0000000
NODE_6436_length_1009_cov_44.626374	464	544	0	80	80	1.0000000
NODE_6437_length_1009_cov_31.828571	412	492	0	19	80	0.2375000
NODE_6437_length_1009_cov_31.828571	412	492	4	61	80	0.7625000
NODE_6437_length_1009_cov_31.828571	465	545	0	72	80	0.9000000
NODE_6437_length_1009_cov_31.828571	465	545	4	8	80	0.1000000
NODE_6438_length_1009_cov_28.539560	571	651	0	80	80	1.0000000
NODE_6438_length_1009_cov_28.539560	624	704	0	80	80	1.0000000
NODE_6439_length_1009_cov_20.281319	577	657	0	80	80	1.0000000
NODE_6439_length_1009_cov_20.281319	630	710	0	80	80	1.0000000
NODE_6440_length_1009_cov_18.649451	430	510	0	80	80	1.0000000
NODE_6440_length_1009_cov_18.649451	483	563	0	80	80	1.0000000
NODE_6442_length_1009_cov_3.767033	647	727	0	80	80	1.0000000
NODE_6442_length_1009_cov_3.767033	700	780	0	80	80	1.0000000
NODE_6443_length_1009_cov_2.903297	36	63	0	27	27	1.0000000
NODE_6451_length_1008_cov_44.825083	399	479	0	46	80	0.5750000
NODE_6451_length_1008_cov_44.825083	399	479	1	34	80	0.4250000
NODE_6451_length_1008_cov_44.825083	452	532	1	80	80	1.0000000
NODE_6452_length_1008_cov_41.030803	280	360	0	80	80	1.0000000
NODE_6452_length_1008_cov_41.030803	333	413	0	80	80	1.0000000
NODE_6452_length_1008_cov_41.030803	409	489	0	80	80	1.0000000
NODE_6452_length_1008_cov_41.030803	462	542	0	80	80	1.0000000
NODE_6453_length_1008_cov_39.377338	311	391	0	80	80	1.0000000
NODE_6453_length_1008_cov_39.377338	364	444	0	80	80	1.0000000
NODE_6453_length_1008_cov_39.377338	440	520	0	80	80	1.0000000
NODE_6453_length_1008_cov_39.377338	493	573	0	80	80	1.0000000
NODE_6454_length_1008_cov_27.836084	405	485	0	80	80	1.0000000
NODE_6454_length_1008_cov_27.836084	458	538	0	80	80	1.0000000
NODE_6454_length_1008_cov_27.836084	534	614	0	80	80	1.0000000
NODE_6454_length_1008_cov_27.836084	587	667	0	80	80	1.0000000
NODE_6455_length_1008_cov_24.741474	485	565	0	80	80	1.0000000
NODE_6455_length_1008_cov_24.741474	538	618	0	76	80	0.9500000
NODE_6455_length_1008_cov_24.741474	538	618	2	4	80	0.0500000
NODE_6456_length_1008_cov_20.278328	401	481	0	80	80	1.0000000
NODE_6456_length_1008_cov_20.278328	454	534	0	80	80	1.0000000
NODE_6457_length_1008_cov_6.071507	460	540	0	80	80	1.0000000
NODE_6457_length_1008_cov_6.071507	513	593	0	80	80	1.0000000
NODE_6466_length_1008_cov_1.798680	0	64	0	64	64	1.0000000
NODE_6466_length_1008_cov_1.798680	37	104	0	61	67	0.9104478
NODE_6466_length_1008_cov_1.798680	37	104	4	6	67	0.0895522
NODE_6473_length_1007_cov_27.011013	294	371	0	77	77	1.0000000
NODE_6473_length_1007_cov_27.011013	347	424	0	77	77	1.0000000
NODE_6474_length_1007_cov_24.668502	369	449	0	80	80	1.0000000
NODE_6474_length_1007_cov_24.668502	422	502	0	80	80	1.0000000
NODE_6474_length_1007_cov_24.668502	498	578	0	80	80	1.0000000
NODE_6474_length_1007_cov_24.668502	551	631	0	80	80	1.0000000
NODE_6475_length_1007_cov_21.729075	454	534	0	80	80	1.0000000
NODE_6475_length_1007_cov_21.729075	507	587	0	34	80	0.4250000
NODE_6475_length_1007_cov_21.729075	507	587	2	46	80	0.5750000
NODE_6475_length_1007_cov_21.729075	583	663	0	14	80	0.1750000
NODE_6475_length_1007_cov_21.729075	583	663	2	66	80	0.8250000
NODE_6475_length_1007_cov_21.729075	636	716	0	67	80	0.8375000
NODE_6475_length_1007_cov_21.729075	636	716	2	13	80	0.1625000
NODE_6476_length_1007_cov_14.515419	400	480	0	60	80	0.7500000
NODE_6476_length_1007_cov_14.515419	400	480	5	14	80	0.1750000
NODE_6476_length_1007_cov_14.515419	400	480	6	6	80	0.0750000
NODE_6476_length_1007_cov_14.515419	453	533	0	7	80	0.0875000
NODE_6476_length_1007_cov_14.515419	453	533	5	14	80	0.1750000
NODE_6476_length_1007_cov_14.515419	453	533	6	59	80	0.7375000
NODE_6477_length_1007_cov_13.685022	376	456	0	80	80	1.0000000
NODE_6477_length_1007_cov_13.685022	429	509	0	80	80	1.0000000
NODE_6478_length_1007_cov_9.189427	438	518	0	80	80	1.0000000
NODE_6478_length_1007_cov_9.189427	491	571	0	80	80	1.0000000
NODE_6491_length_1006_cov_59.773980	379	459	0	33	80	0.4125000
NODE_6491_length_1006_cov_59.773980	379	459	2	47	80	0.5875000
NODE_6491_length_1006_cov_59.773980	432	512	0	11	80	0.1375000
NODE_6491_length_1006_cov_59.773980	432	512	2	69	80	0.8625000
NODE_6491_length_1006_cov_59.773980	508	588	0	80	80	1.0000000
NODE_6491_length_1006_cov_59.773980	561	641	0	80	80	1.0000000
NODE_6492_length_1006_cov_34.762955	482	562	0	80	80	1.0000000
NODE_6492_length_1006_cov_34.762955	535	615	0	80	80	1.0000000
NODE_6493_length_1006_cov_21.776185	516	596	0	80	80	1.0000000
NODE_6493_length_1006_cov_21.776185	569	649	0	80	80	1.0000000
NODE_6494_length_1006_cov_19.690187	371	451	0	80	80	1.0000000
NODE_6494_length_1006_cov_19.690187	424	504	0	80	80	1.0000000
NODE_6495_length_1006_cov_19.299890	495	575	0	80	80	1.0000000
NODE_6495_length_1006_cov_19.299890	548	628	0	80	80	1.0000000
NODE_6496_length_1006_cov_13.187431	245	325	0	80	80	1.0000000
NODE_6496_length_1006_cov_13.187431	298	378	0	80	80	1.0000000
NODE_6497_length_1006_cov_12.862183	383	463	0	80	80	1.0000000
NODE_6497_length_1006_cov_12.862183	436	516	0	80	80	1.0000000
NODE_6498_length_1006_cov_10.986770	762	842	0	80	80	1.0000000
NODE_6498_length_1006_cov_10.986770	815	895	0	80	80	1.0000000
NODE_6499_length_1006_cov_8.633958	314	394	0	80	80	1.0000000
NODE_6499_length_1006_cov_8.633958	367	447	0	80	80	1.0000000
NODE_6515_length_1005_cov_80.271523	509	589	0	14	80	0.1750000
NODE_6515_length_1005_cov_80.271523	509	589	20	66	80	0.8250000
NODE_6515_length_1005_cov_80.271523	562	642	0	67	80	0.8375000
NODE_6515_length_1005_cov_80.271523	562	642	20	13	80	0.1625000
NODE_6516_length_1005_cov_45.008830	357	437	0	44	80	0.5500000
NODE_6516_length_1005_cov_45.008830	357	437	4	36	80	0.4500000
NODE_6516_length_1005_cov_45.008830	410	490	4	80	80	1.0000000
NODE_6517_length_1005_cov_36.636865	567	647	0	80	80	1.0000000
NODE_6517_length_1005_cov_36.636865	620	700	0	80	80	1.0000000
NODE_6518_length_1005_cov_21.222958	389	409	0	20	20	1.0000000
NODE_6518_length_1005_cov_21.222958	451	519	0	68	68	1.0000000
NODE_6518_length_1005_cov_21.222958	515	595	0	80	80	1.0000000
NODE_6518_length_1005_cov_21.222958	568	648	0	80	80	1.0000000
NODE_6520_length_1005_cov_14.278146	480	560	0	80	80	1.0000000
NODE_6520_length_1005_cov_14.278146	533	613	0	80	80	1.0000000
NODE_6521_length_1005_cov_13.215232	511	591	0	80	80	1.0000000
NODE_6521_length_1005_cov_13.215232	564	644	0	80	80	1.0000000
NODE_6523_length_1005_cov_5.579470	534	614	0	22	80	0.2750000
NODE_6523_length_1005_cov_5.579470	534	614	2	25	80	0.3125000
NODE_6523_length_1005_cov_5.579470	534	614	8	33	80	0.4125000
NODE_6523_length_1005_cov_5.579470	587	667	6	18	80	0.2250000
NODE_6523_length_1005_cov_5.579470	587	667	8	62	80	0.7750000
NODE_6536_length_1004_cov_45.470718	343	423	0	80	80	1.0000000
NODE_6536_length_1004_cov_45.470718	396	476	0	80	80	1.0000000
NODE_6536_length_1004_cov_45.470718	472	552	0	80	80	1.0000000
NODE_6536_length_1004_cov_45.470718	525	605	0	80	80	1.0000000
NODE_6537_length_1004_cov_34.565746	419	499	0	16	80	0.2000000
NODE_6537_length_1004_cov_34.565746	419	499	11	64	80	0.8000000
NODE_6537_length_1004_cov_34.565746	472	552	11	47	80	0.5875000
NODE_6537_length_1004_cov_34.565746	472	552	12	33	80	0.4125000
NODE_6538_length_1004_cov_28.710497	385	465	0	80	80	1.0000000
NODE_6538_length_1004_cov_28.710497	438	518	0	63	80	0.7875000
NODE_6538_length_1004_cov_28.710497	438	518	2	17	80	0.2125000
NODE_6538_length_1004_cov_28.710497	514	594	0	1	80	0.0125000
NODE_6538_length_1004_cov_28.710497	514	594	2	79	80	0.9875000
NODE_6538_length_1004_cov_28.710497	567	647	0	54	80	0.6750000
NODE_6538_length_1004_cov_28.710497	567	647	2	26	80	0.3250000
NODE_6539_length_1004_cov_12.745856	432	512	0	80	80	1.0000000
NODE_6539_length_1004_cov_12.745856	485	565	0	80	80	1.0000000
NODE_6550_length_1003_cov_47.014381	383	463	0	28	80	0.3500000
NODE_6550_length_1003_cov_47.014381	383	463	3	1	80	0.0125000
NODE_6550_length_1003_cov_47.014381	383	463	4	51	80	0.6375000
NODE_6550_length_1003_cov_47.014381	436	516	0	80	80	1.0000000
NODE_6550_length_1003_cov_47.014381	512	592	0	80	80	1.0000000
NODE_6550_length_1003_cov_47.014381	565	645	0	80	80	1.0000000
NODE_6551_length_1003_cov_35.329646	372	452	0	80	80	1.0000000
NODE_6551_length_1003_cov_35.329646	425	505	0	80	80	1.0000000
NODE_6552_length_1003_cov_32.721239	357	437	0	80	80	1.0000000
NODE_6552_length_1003_cov_32.721239	410	490	0	80	80	1.0000000
NODE_6553_length_1003_cov_23.758850	467	547	1	36	80	0.4500000
NODE_6553_length_1003_cov_23.758850	467	547	2	44	80	0.5500000
NODE_6553_length_1003_cov_23.758850	520	600	1	30	80	0.3750000
NODE_6553_length_1003_cov_23.758850	520	600	2	50	80	0.6250000
NODE_6554_length_1003_cov_19.939159	240	320	0	80	80	1.0000000
NODE_6554_length_1003_cov_19.939159	293	373	0	80	80	1.0000000
NODE_6555_length_1003_cov_16.618363	524	604	0	80	80	1.0000000
NODE_6555_length_1003_cov_16.618363	577	657	0	80	80	1.0000000
NODE_6555_length_1003_cov_16.618363	653	733	0	80	80	1.0000000
NODE_6555_length_1003_cov_16.618363	706	786	0	80	80	1.0000000
NODE_6556_length_1003_cov_13.863938	537	617	0	80	80	1.0000000
NODE_6556_length_1003_cov_13.863938	590	670	0	80	80	1.0000000
NODE_6557_length_1003_cov_12.363938	529	609	0	12	80	0.1500000
NODE_6557_length_1003_cov_12.363938	529	609	1	68	80	0.8500000
NODE_6557_length_1003_cov_12.363938	582	662	0	65	80	0.8125000
NODE_6557_length_1003_cov_12.363938	582	662	1	15	80	0.1875000
NODE_6567_length_1002_cov_65.513843	387	467	0	80	80	1.0000000
NODE_6567_length_1002_cov_65.513843	440	520	0	80	80	1.0000000
NODE_6567_length_1002_cov_65.513843	516	596	0	80	80	1.0000000
NODE_6567_length_1002_cov_65.513843	569	649	0	33	80	0.4125000
NODE_6567_length_1002_cov_65.513843	569	649	2	47	80	0.5875000
NODE_6568_length_1002_cov_41.995570	408	488	0	80	80	1.0000000
NODE_6568_length_1002_cov_41.995570	461	541	0	80	80	1.0000000
NODE_6569_length_1002_cov_19.966777	401	481	0	80	80	1.0000000
NODE_6569_length_1002_cov_19.966777	454	534	0	80	80	1.0000000
NODE_6570_length_1002_cov_19.539313	334	414	0	71	80	0.8875000
NODE_6570_length_1002_cov_19.539313	334	414	1	9	80	0.1125000
NODE_6570_length_1002_cov_19.539313	335	414	0	70	79	0.8860760
NODE_6570_length_1002_cov_19.539313	335	414	1	9	79	0.1139240
NODE_6570_length_1002_cov_19.539313	387	467	0	18	80	0.2250000
NODE_6570_length_1002_cov_19.539313	387	467	1	17	80	0.2125000
NODE_6570_length_1002_cov_19.539313	387	467	2	45	80	0.5625000
NODE_6570_length_1002_cov_19.539313	387	467	0	18	80	0.2250000
NODE_6570_length_1002_cov_19.539313	387	467	1	17	80	0.2125000
NODE_6570_length_1002_cov_19.539313	387	467	2	45	80	0.5625000
NODE_6570_length_1002_cov_19.539313	396	467	0	9	71	0.1267606
NODE_6570_length_1002_cov_19.539313	396	467	1	17	71	0.2394366
NODE_6570_length_1002_cov_19.539313	396	467	2	45	71	0.6338028
NODE_6570_length_1002_cov_19.539313	463	543	2	80	80	1.0000000
NODE_6570_length_1002_cov_19.539313	516	596	2	52	80	0.6500000
NODE_6570_length_1002_cov_19.539313	516	596	3	17	80	0.2125000
NODE_6570_length_1002_cov_19.539313	516	596	4	11	80	0.1375000
NODE_6571_length_1002_cov_17.780731	631	711	0	80	80	1.0000000
NODE_6571_length_1002_cov_17.780731	684	764	0	80	80	1.0000000
NODE_6572_length_1002_cov_17.590255	0	58	0	58	58	1.0000000
NODE_6572_length_1002_cov_17.590255	31	77	0	46	46	1.0000000
NODE_6573_length_1002_cov_17.105205	522	602	0	80	80	1.0000000
NODE_6573_length_1002_cov_17.105205	575	655	0	80	80	1.0000000
NODE_6574_length_1002_cov_11.954596	480	560	0	80	80	1.0000000
NODE_6574_length_1002_cov_11.954596	533	613	0	80	80	1.0000000
NODE_6575_length_1002_cov_11.823920	471	551	0	80	80	1.0000000
NODE_6575_length_1002_cov_11.823920	524	614	0	90	90	1.0000000
NODE_6577_length_1002_cov_6.596899	422	502	0	80	80	1.0000000
NODE_6577_length_1002_cov_6.596899	475	555	0	80	80	1.0000000
NODE_6588_length_1002_cov_2.102990	29	110	6	12	81	0.1481481
NODE_6588_length_1002_cov_2.102990	29	110	8	15	81	0.1851852
NODE_6588_length_1002_cov_2.102990	29	110	10	54	81	0.6666667
NODE_6596_length_1001_cov_41.914634	549	629	0	80	80	1.0000000
NODE_6596_length_1001_cov_41.914634	602	682	0	80	80	1.0000000
NODE_6597_length_1001_cov_30.378049	306	386	0	80	80	1.0000000
NODE_6597_length_1001_cov_30.378049	359	439	0	75	80	0.9375000
NODE_6597_length_1001_cov_30.378049	359	439	5	1	80	0.0125000
NODE_6597_length_1001_cov_30.378049	359	439	6	4	80	0.0500000
NODE_6597_length_1001_cov_30.378049	369	439	0	65	70	0.9285714
NODE_6597_length_1001_cov_30.378049	369	439	5	1	70	0.0142857
NODE_6597_length_1001_cov_30.378049	369	439	6	4	70	0.0571429
NODE_6597_length_1001_cov_30.378049	435	515	6	80	80	1.0000000
NODE_6597_length_1001_cov_30.378049	488	568	0	13	80	0.1625000
NODE_6597_length_1001_cov_30.378049	488	568	6	67	80	0.8375000
NODE_6598_length_1001_cov_22.517738	536	616	0	80	80	1.0000000
NODE_6598_length_1001_cov_22.517738	589	670	0	81	81	1.0000000
NODE_6599_length_1001_cov_17.996674	414	456	0	42	42	1.0000000
NODE_6599_length_1001_cov_17.996674	429	509	0	80	80	1.0000000
NODE_6599_length_1001_cov_17.996674	505	585	0	80	80	1.0000000
NODE_6599_length_1001_cov_17.996674	558	638	0	80	80	1.0000000
NODE_6600_length_1001_cov_16.798226	422	502	0	24	80	0.3000000
NODE_6600_length_1001_cov_16.798226	422	502	2	56	80	0.7000000
NODE_6600_length_1001_cov_16.798226	475	555	0	25	80	0.3125000
NODE_6600_length_1001_cov_16.798226	475	555	2	55	80	0.6875000
NODE_6600_length_1001_cov_16.798226	551	631	0	80	80	1.0000000
NODE_6600_length_1001_cov_16.798226	604	684	0	80	80	1.0000000
NODE_6601_length_1001_cov_12.778271	348	428	0	53	80	0.6625000
NODE_6601_length_1001_cov_12.778271	348	428	2	27	80	0.3375000
NODE_6601_length_1001_cov_12.778271	401	481	0	3	80	0.0375000
NODE_6601_length_1001_cov_12.778271	401	481	2	77	80	0.9625000
NODE_6602_length_1001_cov_12.305987	255	335	0	80	80	1.0000000
NODE_6602_length_1001_cov_12.305987	308	388	0	80	80	1.0000000
NODE_6603_length_1001_cov_11.955654	485	569	0	84	84	1.0000000
NODE_6603_length_1001_cov_11.955654	542	622	0	80	80	1.0000000
NODE_6604_length_1001_cov_10.156319	587	667	0	80	80	1.0000000
NODE_6604_length_1001_cov_10.156319	640	720	0	80	80	1.0000000
NODE_6605_length_1001_cov_9.754989	377	457	0	80	80	1.0000000
NODE_6605_length_1001_cov_9.754989	430	510	0	80	80	1.0000000
NODE_6607_length_1001_cov_4.616408	408	488	0	80	80	1.0000000
NODE_6607_length_1001_cov_4.616408	461	541	0	80	80	1.0000000
NODE_6616_length_1000_cov_55.578246	393	473	0	30	80	0.3750000
NODE_6616_length_1000_cov_55.578246	393	473	2	50	80	0.6250000
NODE_6616_length_1000_cov_55.578246	446	526	0	80	80	1.0000000
NODE_6616_length_1000_cov_55.578246	522	598	0	50	76	0.6578947
NODE_6616_length_1000_cov_55.578246	522	598	2	26	76	0.3421053
NODE_6616_length_1000_cov_55.578246	575	649	2	45	74	0.6081081
NODE_6616_length_1000_cov_55.578246	575	649	4	29	74	0.3918919
NODE_6617_length_1000_cov_51.534961	432	512	0	29	80	0.3625000
NODE_6617_length_1000_cov_51.534961	432	512	6	51	80	0.6375000
NODE_6617_length_1000_cov_51.534961	485	565	0	80	80	1.0000000
NODE_6617_length_1000_cov_51.534961	561	641	0	80	80	1.0000000
NODE_6617_length_1000_cov_51.534961	614	694	0	80	80	1.0000000
NODE_6618_length_1000_cov_39.011099	186	266	0	80	80	1.0000000
NODE_6618_length_1000_cov_39.011099	239	319	0	80	80	1.0000000
NODE_6619_length_1000_cov_19.897891	451	531	0	80	80	1.0000000
NODE_6619_length_1000_cov_19.897891	504	584	0	80	80	1.0000000
NODE_6619_length_1000_cov_19.897891	580	660	0	80	80	1.0000000
NODE_6619_length_1000_cov_19.897891	633	713	0	80	80	1.0000000
NODE_6620_length_1000_cov_13.349612	324	404	0	80	80	1.0000000
NODE_6620_length_1000_cov_13.349612	377	457	0	80	80	1.0000000
NODE_6621_length_1000_cov_11.463929	382	462	0	80	80	1.0000000
NODE_6621_length_1000_cov_11.463929	435	515	0	80	80	1.0000000
NODE_6622_length_1000_cov_9.675916	625	705	4	80	80	1.0000000
NODE_6622_length_1000_cov_9.675916	678	758	0	26	80	0.3250000
NODE_6622_length_1000_cov_9.675916	678	758	4	54	80	0.6750000
NODE_6623_length_1000_cov_7.051054	358	438	0	54	80	0.6750000
NODE_6623_length_1000_cov_7.051054	358	438	2	26	80	0.3250000
NODE_6623_length_1000_cov_7.051054	411	491	0	80	80	1.0000000
NODE_6626_length_1000_cov_3.652608	203	265	0	18	62	0.2903226
NODE_6626_length_1000_cov_3.652608	203	265	2	11	62	0.1774193
NODE_6626_length_1000_cov_3.652608	203	265	4	33	62	0.5322581
NODE_6639_length_999_cov_47.442222	604	684	0	6	80	0.0750000
NODE_6639_length_999_cov_47.442222	604	684	35	2	80	0.0250000
NODE_6639_length_999_cov_47.442222	604	684	36	21	80	0.2625000
NODE_6639_length_999_cov_47.442222	604	684	37	16	80	0.2000000
NODE_6639_length_999_cov_47.442222	604	684	38	35	80	0.4375000
NODE_6639_length_999_cov_47.442222	657	723	35	6	66	0.0909091
NODE_6639_length_999_cov_47.442222	657	723	36	7	66	0.1060606
NODE_6639_length_999_cov_47.442222	657	723	37	6	66	0.0909091
NODE_6639_length_999_cov_47.442222	657	723	38	47	66	0.7121212
NODE_6640_length_999_cov_33.055556	458	540	0	82	82	1.0000000
NODE_6640_length_999_cov_33.055556	513	593	0	80	80	1.0000000
NODE_6641_length_999_cov_22.755556	493	573	0	80	80	1.0000000
NODE_6641_length_999_cov_22.755556	546	626	0	80	80	1.0000000
NODE_6642_length_999_cov_21.842222	359	439	0	34	80	0.4250000
NODE_6642_length_999_cov_21.842222	359	439	4	46	80	0.5750000
NODE_6642_length_999_cov_21.842222	412	492	4	80	80	1.0000000
NODE_6643_length_999_cov_20.006667	361	441	0	80	80	1.0000000
NODE_6643_length_999_cov_20.006667	414	494	0	80	80	1.0000000
NODE_6643_length_999_cov_20.006667	490	570	0	80	80	1.0000000
NODE_6643_length_999_cov_20.006667	543	623	0	80	80	1.0000000
NODE_6645_length_999_cov_16.794444	438	518	0	80	80	1.0000000
NODE_6645_length_999_cov_16.794444	491	571	0	80	80	1.0000000
NODE_6646_length_999_cov_15.146667	464	544	0	80	80	1.0000000
NODE_6646_length_999_cov_15.146667	517	597	0	80	80	1.0000000
NODE_6648_length_999_cov_8.771111	361	441	0	80	80	1.0000000
NODE_6648_length_999_cov_8.771111	414	492	0	78	78	1.0000000
NODE_6649_length_999_cov_5.171111	417	497	0	80	80	1.0000000
NODE_6649_length_999_cov_5.171111	470	550	0	80	80	1.0000000
NODE_6650_length_999_cov_2.854444	35	101	10	62	66	0.9393939
NODE_6650_length_999_cov_2.854444	35	101	16	4	66	0.0606061
NODE_6657_length_998_cov_30.697442	404	484	0	80	80	1.0000000
NODE_6657_length_998_cov_30.697442	457	537	0	80	80	1.0000000
NODE_6657_length_998_cov_30.697442	533	613	0	80	80	1.0000000
NODE_6657_length_998_cov_30.697442	586	666	0	80	80	1.0000000
NODE_6658_length_998_cov_23.703003	235	315	0	80	80	1.0000000
NODE_6658_length_998_cov_23.703003	288	368	0	80	80	1.0000000
NODE_6659_length_998_cov_22.692992	531	611	0	80	80	1.0000000
NODE_6659_length_998_cov_22.692992	584	664	0	80	80	1.0000000
NODE_6660_length_998_cov_11.152392	514	594	0	80	80	1.0000000
NODE_6660_length_998_cov_11.152392	567	640	0	73	73	1.0000000
NODE_6660_length_998_cov_11.152392	636	716	0	80	80	1.0000000
NODE_6660_length_998_cov_11.152392	689	769	0	80	80	1.0000000
NODE_6661_length_998_cov_10.061179	422	502	0	80	80	1.0000000
NODE_6661_length_998_cov_10.061179	475	555	0	80	80	1.0000000
NODE_6662_length_998_cov_7.126808	353	430	0	77	77	1.0000000
NODE_6662_length_998_cov_7.126808	403	483	0	80	80	1.0000000
NODE_6669_length_997_cov_48.518931	445	525	0	80	80	1.0000000
NODE_6669_length_997_cov_48.518931	498	578	0	80	80	1.0000000
NODE_6670_length_997_cov_36.721604	400	480	0	80	80	1.0000000
NODE_6670_length_997_cov_36.721604	453	533	0	80	80	1.0000000
NODE_6671_length_997_cov_22.646993	328	408	0	80	80	1.0000000
NODE_6671_length_997_cov_22.646993	381	461	0	80	80	1.0000000
NODE_6672_length_997_cov_19.709354	420	500	0	80	80	1.0000000
NODE_6672_length_997_cov_19.709354	473	553	0	80	80	1.0000000
NODE_6672_length_997_cov_19.709354	549	629	0	80	80	1.0000000
NODE_6672_length_997_cov_19.709354	602	682	0	80	80	1.0000000
NODE_6673_length_997_cov_17.947661	465	545	4	80	80	1.0000000
NODE_6673_length_997_cov_17.947661	518	598	0	10	80	0.1250000
NODE_6673_length_997_cov_17.947661	518	598	4	70	80	0.8750000
NODE_6673_length_997_cov_17.947661	594	674	0	80	80	1.0000000
NODE_6673_length_997_cov_17.947661	647	727	0	80	80	1.0000000
NODE_6674_length_997_cov_14.718263	388	468	0	80	80	1.0000000
NODE_6674_length_997_cov_14.718263	441	521	0	80	80	1.0000000
NODE_6675_length_997_cov_7.114699	307	387	0	80	80	1.0000000
NODE_6675_length_997_cov_7.114699	360	440	0	80	80	1.0000000
NODE_6694_length_996_cov_59.568562	387	467	0	80	80	1.0000000
NODE_6694_length_996_cov_59.568562	440	520	0	80	80	1.0000000
NODE_6695_length_996_cov_32.462653	503	583	4	54	80	0.6750000
NODE_6695_length_996_cov_32.462653	503	583	5	26	80	0.3250000
NODE_6695_length_996_cov_32.462653	556	636	0	50	80	0.6250000
NODE_6695_length_996_cov_32.462653	556	636	4	30	80	0.3750000
NODE_6696_length_996_cov_23.312152	571	651	0	78	80	0.9750000
NODE_6696_length_996_cov_23.312152	571	651	1	2	80	0.0250000
NODE_6696_length_996_cov_23.312152	624	704	0	25	80	0.3125000
NODE_6696_length_996_cov_23.312152	624	704	1	18	80	0.2250000
NODE_6696_length_996_cov_23.312152	624	704	2	37	80	0.4625000
NODE_6697_length_996_cov_20.979933	533	613	0	56	80	0.7000000
NODE_6697_length_996_cov_20.979933	533	613	1	20	80	0.2500000
NODE_6697_length_996_cov_20.979933	533	613	2	4	80	0.0500000
NODE_6697_length_996_cov_20.979933	586	666	0	80	80	1.0000000
NODE_6698_length_996_cov_17.865106	535	615	0	80	80	1.0000000
NODE_6698_length_996_cov_17.865106	588	668	0	80	80	1.0000000
NODE_6699_length_996_cov_10.297659	499	579	0	80	80	1.0000000
NODE_6699_length_996_cov_10.297659	552	630	0	78	78	1.0000000
NODE_6702_length_996_cov_3.205128	499	555	0	56	56	1.0000000
NODE_6707_length_995_cov_26.131696	543	623	0	80	80	1.0000000
NODE_6707_length_995_cov_26.131696	596	676	0	80	80	1.0000000
NODE_6708_length_995_cov_20.262277	457	537	0	80	80	1.0000000
NODE_6708_length_995_cov_20.262277	510	590	0	80	80	1.0000000
NODE_6709_length_995_cov_19.382812	457	537	0	80	80	1.0000000
NODE_6709_length_995_cov_19.382812	510	590	0	80	80	1.0000000
NODE_6710_length_995_cov_19.034598	453	533	0	80	80	1.0000000
NODE_6710_length_995_cov_19.034598	506	586	0	80	80	1.0000000
NODE_6711_length_995_cov_9.734375	222	323	0	101	101	1.0000000
NODE_6711_length_995_cov_9.734375	296	376	0	80	80	1.0000000
NODE_6723_length_994_cov_74.678212	362	442	0	80	80	1.0000000
NODE_6723_length_994_cov_74.678212	415	495	0	80	80	1.0000000
NODE_6723_length_994_cov_74.678212	491	571	0	80	80	1.0000000
NODE_6723_length_994_cov_74.678212	544	624	0	80	80	1.0000000
NODE_6724_length_994_cov_26.045810	442	522	0	10	80	0.1250000
NODE_6724_length_994_cov_26.045810	442	522	2	70	80	0.8750000
NODE_6724_length_994_cov_26.045810	495	575	0	24	80	0.3000000
NODE_6724_length_994_cov_26.045810	495	575	2	56	80	0.7000000
NODE_6725_length_994_cov_25.240223	504	584	0	80	80	1.0000000
NODE_6725_length_994_cov_25.240223	557	637	0	80	80	1.0000000
NODE_6726_length_994_cov_24.615642	422	502	0	80	80	1.0000000
NODE_6726_length_994_cov_24.615642	475	555	0	80	80	1.0000000
NODE_6726_length_994_cov_24.615642	551	631	0	80	80	1.0000000
NODE_6726_length_994_cov_24.615642	604	684	0	80	80	1.0000000
NODE_6727_length_994_cov_22.593296	323	403	0	80	80	1.0000000
NODE_6727_length_994_cov_22.593296	376	456	0	80	80	1.0000000
NODE_6727_length_994_cov_22.593296	452	532	0	80	80	1.0000000
NODE_6727_length_994_cov_22.593296	505	585	0	80	80	1.0000000
NODE_6728_length_994_cov_6.985475	0	58	0	58	58	1.0000000
NODE_6728_length_994_cov_6.985475	15	95	0	80	80	1.0000000
NODE_6728_length_994_cov_6.985475	68	148	0	80	80	1.0000000
NODE_6740_length_993_cov_56.321029	266	346	0	80	80	1.0000000
NODE_6740_length_993_cov_56.321029	319	399	0	80	80	1.0000000
NODE_6740_length_993_cov_56.321029	400	470	0	70	70	1.0000000
NODE_6740_length_993_cov_56.321029	443	523	0	80	80	1.0000000
NODE_6741_length_993_cov_44.695749	385	465	0	80	80	1.0000000
NODE_6741_length_993_cov_44.695749	438	518	0	80	80	1.0000000
NODE_6742_length_993_cov_40.574944	417	497	0	80	80	1.0000000
NODE_6742_length_993_cov_40.574944	470	550	0	80	80	1.0000000
NODE_6742_length_993_cov_40.574944	546	628	0	82	82	1.0000000
NODE_6742_length_993_cov_40.574944	601	681	0	80	80	1.0000000
NODE_6743_length_993_cov_39.817673	3	83	0	15	80	0.1875000
NODE_6743_length_993_cov_39.817673	3	83	3	8	80	0.1000000
NODE_6743_length_993_cov_39.817673	3	83	6	57	80	0.7125000
NODE_6744_length_993_cov_30.128635	477	557	0	4	80	0.0500000
NODE_6744_length_993_cov_30.128635	477	557	7	1	80	0.0125000
NODE_6744_length_993_cov_30.128635	477	557	9	1	80	0.0125000
NODE_6744_length_993_cov_30.128635	477	557	18	74	80	0.9250000
NODE_6744_length_993_cov_30.128635	530	610	17	20	80	0.2500000
NODE_6744_length_993_cov_30.128635	530	610	18	60	80	0.7500000
NODE_6745_length_993_cov_17.435123	573	653	0	80	80	1.0000000
NODE_6745_length_993_cov_17.435123	626	706	0	80	80	1.0000000
NODE_6746_length_993_cov_13.074944	483	563	0	80	80	1.0000000
NODE_6746_length_993_cov_13.074944	536	616	0	80	80	1.0000000
NODE_6747_length_993_cov_10.190157	500	580	0	80	80	1.0000000
NODE_6747_length_993_cov_10.190157	553	633	0	80	80	1.0000000
NODE_6756_length_993_cov_0.909396	16	73	0	57	57	1.0000000
NODE_6757_length_992_cov_36.119821	354	434	1	64	80	0.8000000
NODE_6757_length_992_cov_36.119821	354	434	2	16	80	0.2000000
NODE_6757_length_992_cov_36.119821	407	487	1	29	80	0.3625000
NODE_6757_length_992_cov_36.119821	407	487	2	51	80	0.6375000
NODE_6757_length_992_cov_36.119821	483	563	1	10	80	0.1250000
NODE_6757_length_992_cov_36.119821	483	563	3	70	80	0.8750000
NODE_6757_length_992_cov_36.119821	536	616	0	27	80	0.3375000
NODE_6757_length_992_cov_36.119821	536	616	2	21	80	0.2625000
NODE_6757_length_992_cov_36.119821	536	616	3	32	80	0.4000000
NODE_6758_length_992_cov_34.802912	443	523	0	80	80	1.0000000
NODE_6758_length_992_cov_34.802912	496	576	0	80	80	1.0000000
NODE_6759_length_992_cov_33.047032	381	461	0	80	80	1.0000000
NODE_6759_length_992_cov_33.047032	434	514	0	80	80	1.0000000
NODE_6759_length_992_cov_33.047032	510	590	0	80	80	1.0000000
NODE_6759_length_992_cov_33.047032	563	643	0	80	80	1.0000000
NODE_6760_length_992_cov_23.543113	435	515	2	80	80	1.0000000
NODE_6760_length_992_cov_23.543113	488	568	0	4	80	0.0500000
NODE_6760_length_992_cov_23.543113	488	568	2	76	80	0.9500000
NODE_6761_length_992_cov_22.608063	440	520	0	80	80	1.0000000
NODE_6761_length_992_cov_22.608063	493	573	0	80	80	1.0000000
NODE_6762_length_992_cov_21.427772	216	296	0	80	80	1.0000000
NODE_6762_length_992_cov_21.427772	269	349	0	80	80	1.0000000
NODE_6763_length_992_cov_20.010078	312	392	0	58	80	0.7250000
NODE_6763_length_992_cov_20.010078	312	392	2	22	80	0.2750000
NODE_6763_length_992_cov_20.010078	365	445	0	11	80	0.1375000
NODE_6763_length_992_cov_20.010078	365	445	2	69	80	0.8625000
NODE_6764_length_992_cov_16.524076	465	545	0	80	80	1.0000000
NODE_6764_length_992_cov_16.524076	518	598	0	80	80	1.0000000
NODE_6765_length_992_cov_16.266517	396	476	0	80	80	1.0000000
NODE_6765_length_992_cov_16.266517	449	529	0	80	80	1.0000000
NODE_6766_length_992_cov_16.146697	272	352	0	80	80	1.0000000
NODE_6766_length_992_cov_16.146697	325	405	0	80	80	1.0000000
NODE_6767_length_992_cov_15.212766	354	434	0	80	80	1.0000000
NODE_6767_length_992_cov_15.212766	407	487	0	80	80	1.0000000
NODE_6767_length_992_cov_15.212766	483	563	0	80	80	1.0000000
NODE_6767_length_992_cov_15.212766	536	616	0	80	80	1.0000000
NODE_6781_length_991_cov_48.582960	451	531	0	80	80	1.0000000
NODE_6781_length_991_cov_48.582960	504	584	0	80	80	1.0000000
NODE_6782_length_991_cov_25.891256	340	420	0	80	80	1.0000000
NODE_6782_length_991_cov_25.891256	393	473	0	80	80	1.0000000
NODE_6782_length_991_cov_25.891256	469	549	0	80	80	1.0000000
NODE_6782_length_991_cov_25.891256	522	602	0	80	80	1.0000000
NODE_6783_length_991_cov_25.392377	377	457	0	80	80	1.0000000
NODE_6783_length_991_cov_25.392377	430	510	0	80	80	1.0000000
NODE_6783_length_991_cov_25.392377	506	586	0	80	80	1.0000000
NODE_6783_length_991_cov_25.392377	559	639	0	80	80	1.0000000
NODE_6784_length_991_cov_22.210762	421	501	0	70	80	0.8750000
NODE_6784_length_991_cov_22.210762	421	501	2	10	80	0.1250000
NODE_6784_length_991_cov_22.210762	474	554	0	17	80	0.2125000
NODE_6784_length_991_cov_22.210762	474	554	2	63	80	0.7875000
NODE_6785_length_991_cov_18.008969	366	446	0	80	80	1.0000000
NODE_6785_length_991_cov_18.008969	419	499	0	80	80	1.0000000
NODE_6785_length_991_cov_18.008969	495	575	0	80	80	1.0000000
NODE_6785_length_991_cov_18.008969	548	629	0	81	81	1.0000000
NODE_6786_length_991_cov_14.727578	426	506	6	5	80	0.0625000
NODE_6786_length_991_cov_14.727578	426	506	8	75	80	0.9375000
NODE_6786_length_991_cov_14.727578	479	559	0	4	80	0.0500000
NODE_6786_length_991_cov_14.727578	479	559	6	54	80	0.6750000
NODE_6786_length_991_cov_14.727578	479	559	8	22	80	0.2750000
NODE_6787_length_991_cov_13.081839	240	320	0	80	80	1.0000000
NODE_6787_length_991_cov_13.081839	293	373	0	80	80	1.0000000
NODE_6788_length_991_cov_12.693946	425	505	0	77	80	0.9625000
NODE_6788_length_991_cov_12.693946	425	505	3	3	80	0.0375000
NODE_6788_length_991_cov_12.693946	478	558	0	24	80	0.3000000
NODE_6788_length_991_cov_12.693946	478	558	3	56	80	0.7000000
NODE_6789_length_991_cov_9.647982	436	516	5	80	80	1.0000000
NODE_6789_length_991_cov_9.647982	489	569	0	2	80	0.0250000
NODE_6789_length_991_cov_9.647982	489	569	1	38	80	0.4750000
NODE_6789_length_991_cov_9.647982	489	569	3	1	80	0.0125000
NODE_6789_length_991_cov_9.647982	489	569	5	39	80	0.4875000
NODE_6790_length_991_cov_5.176009	538	618	0	80	80	1.0000000
NODE_6790_length_991_cov_5.176009	591	671	0	80	80	1.0000000
NODE_6801_length_990_cov_39.386083	402	482	0	80	80	1.0000000
NODE_6801_length_990_cov_39.386083	455	535	0	80	80	1.0000000
NODE_6802_length_990_cov_35.993266	321	401	0	80	80	1.0000000
NODE_6802_length_990_cov_35.993266	374	454	0	80	80	1.0000000
NODE_6802_length_990_cov_35.993266	450	530	0	80	80	1.0000000
NODE_6802_length_990_cov_35.993266	503	583	0	80	80	1.0000000
NODE_6803_length_990_cov_24.445567	588	668	0	80	80	1.0000000
NODE_6803_length_990_cov_24.445567	641	721	0	80	80	1.0000000
NODE_6805_length_990_cov_22.378227	430	510	0	80	80	1.0000000
NODE_6805_length_990_cov_22.378227	483	563	0	80	80	1.0000000
NODE_6806_length_990_cov_20.150393	408	488	0	80	80	1.0000000
NODE_6806_length_990_cov_20.150393	461	541	0	80	80	1.0000000
NODE_6807_length_990_cov_18.154882	434	514	0	80	80	1.0000000
NODE_6807_length_990_cov_18.154882	487	567	0	80	80	1.0000000
NODE_6808_length_990_cov_17.250281	329	409	0	80	80	1.0000000
NODE_6808_length_990_cov_17.250281	382	462	0	80	80	1.0000000
NODE_6808_length_990_cov_17.250281	458	538	0	80	80	1.0000000
NODE_6808_length_990_cov_17.250281	511	591	0	80	80	1.0000000
NODE_6809_length_990_cov_14.977553	448	528	0	80	80	1.0000000
NODE_6809_length_990_cov_14.977553	501	581	0	80	80	1.0000000
NODE_6810_length_990_cov_13.846240	482	562	0	22	80	0.2750000
NODE_6810_length_990_cov_13.846240	482	562	2	58	80	0.7250000
NODE_6810_length_990_cov_13.846240	535	615	0	75	80	0.9375000
NODE_6810_length_990_cov_13.846240	535	615	2	5	80	0.0625000
NODE_6821_length_990_cov_0.978676	79	151	2	38	72	0.5277778
NODE_6821_length_990_cov_0.978676	79	151	4	34	72	0.4722222
NODE_6821_length_990_cov_0.978676	82	152	0	1	70	0.0142857
NODE_6821_length_990_cov_0.978676	82	152	2	38	70	0.5428572
NODE_6821_length_990_cov_0.978676	82	152	4	31	70	0.4428571
NODE_6823_length_989_cov_45.902247	47	127	9	1	80	0.0125000
NODE_6823_length_989_cov_45.902247	47	127	12	2	80	0.0250000
NODE_6823_length_989_cov_45.902247	47	127	16	1	80	0.0125000
NODE_6823_length_989_cov_45.902247	47	127	18	2	80	0.0250000
NODE_6823_length_989_cov_45.902247	47	127	22	2	80	0.0250000
NODE_6823_length_989_cov_45.902247	47	127	24	11	80	0.1375000
NODE_6823_length_989_cov_45.902247	47	127	29	2	80	0.0250000
NODE_6823_length_989_cov_45.902247	47	127	31	3	80	0.0375000
NODE_6823_length_989_cov_45.902247	47	127	32	56	80	0.7000000
NODE_6823_length_989_cov_45.902247	330	410	0	80	80	1.0000000
NODE_6823_length_989_cov_45.902247	383	463	0	80	80	1.0000000
NODE_6824_length_989_cov_35.430337	412	492	0	27	80	0.3375000
NODE_6824_length_989_cov_35.430337	412	492	2	53	80	0.6625000
NODE_6824_length_989_cov_35.430337	465	545	0	36	80	0.4500000
NODE_6824_length_989_cov_35.430337	465	545	2	44	80	0.5500000
NODE_6825_length_989_cov_30.124719	477	557	0	80	80	1.0000000
NODE_6825_length_989_cov_30.124719	530	610	0	80	80	1.0000000
NODE_6826_length_989_cov_29.347191	447	527	0	80	80	1.0000000
NODE_6826_length_989_cov_29.347191	500	580	0	80	80	1.0000000
NODE_6826_length_989_cov_29.347191	576	656	0	80	80	1.0000000
NODE_6826_length_989_cov_29.347191	629	709	0	80	80	1.0000000
NODE_6827_length_989_cov_27.886517	245	325	0	1	80	0.0125000
NODE_6827_length_989_cov_27.886517	245	325	2	79	80	0.9875000
NODE_6827_length_989_cov_27.886517	298	378	0	35	80	0.4375000
NODE_6827_length_989_cov_27.886517	298	378	2	45	80	0.5625000
NODE_6827_length_989_cov_27.886517	374	454	0	80	80	1.0000000
NODE_6827_length_989_cov_27.886517	427	507	0	80	80	1.0000000
NODE_6828_length_989_cov_27.515730	393	473	0	80	80	1.0000000
NODE_6828_length_989_cov_27.515730	446	526	0	80	80	1.0000000
NODE_6828_length_989_cov_27.515730	522	602	0	80	80	1.0000000
NODE_6828_length_989_cov_27.515730	575	655	0	59	80	0.7375000
NODE_6828_length_989_cov_27.515730	575	655	2	21	80	0.2625000
NODE_6829_length_989_cov_23.844944	312	392	0	80	80	1.0000000
NODE_6829_length_989_cov_23.844944	365	445	0	80	80	1.0000000
NODE_6830_length_989_cov_23.131461	475	555	0	80	80	1.0000000
NODE_6830_length_989_cov_23.131461	528	608	0	80	80	1.0000000
NODE_6831_length_989_cov_20.189888	500	580	0	38	80	0.4750000
NODE_6831_length_989_cov_20.189888	500	580	4	42	80	0.5250000
NODE_6831_length_989_cov_20.189888	553	633	4	39	80	0.4875000
NODE_6831_length_989_cov_20.189888	553	633	6	41	80	0.5125000
NODE_6832_length_989_cov_18.429213	190	270	0	80	80	1.0000000
NODE_6832_length_989_cov_18.429213	258	323	0	65	65	1.0000000
NODE_6832_length_989_cov_18.429213	319	399	0	80	80	1.0000000
NODE_6832_length_989_cov_18.429213	372	412	0	40	40	1.0000000
NODE_6833_length_989_cov_10.307865	433	513	0	80	80	1.0000000
NODE_6833_length_989_cov_10.307865	486	570	0	84	84	1.0000000
NODE_6833_length_989_cov_10.307865	566	642	0	76	76	1.0000000
NODE_6833_length_989_cov_10.307865	615	695	0	80	80	1.0000000
NODE_6834_length_989_cov_8.941573	528	608	0	80	80	1.0000000
NODE_6834_length_989_cov_8.941573	581	661	0	80	80	1.0000000
NODE_6835_length_989_cov_5.132584	459	524	0	65	65	1.0000000
NODE_6838_length_989_cov_2.540449	703	783	0	80	80	1.0000000
NODE_6845_length_988_cov_52.168729	361	441	0	80	80	1.0000000
NODE_6845_length_988_cov_52.168729	414	494	0	80	80	1.0000000
NODE_6845_length_988_cov_52.168729	490	570	0	37	80	0.4625000
NODE_6845_length_988_cov_52.168729	490	570	6	43	80	0.5375000
NODE_6845_length_988_cov_52.168729	543	623	0	4	80	0.0500000
NODE_6845_length_988_cov_52.168729	543	623	6	76	80	0.9500000
NODE_6846_length_988_cov_36.733408	390	470	0	80	80	1.0000000
NODE_6846_length_988_cov_36.733408	443	523	0	80	80	1.0000000
NODE_6847_length_988_cov_36.221597	478	558	0	80	80	1.0000000
NODE_6847_length_988_cov_36.221597	531	611	0	34	80	0.4250000
NODE_6847_length_988_cov_36.221597	531	611	2	46	80	0.5750000
NODE_6848_length_988_cov_25.895388	389	469	0	80	80	1.0000000
NODE_6848_length_988_cov_25.895388	442	522	0	80	80	1.0000000
NODE_6848_length_988_cov_25.895388	518	598	0	80	80	1.0000000
NODE_6848_length_988_cov_25.895388	571	651	0	46	80	0.5750000
NODE_6848_length_988_cov_25.895388	571	651	2	34	80	0.4250000
NODE_6849_length_988_cov_20.250844	423	503	0	67	80	0.8375000
NODE_6849_length_988_cov_20.250844	423	503	2	13	80	0.1625000
NODE_6849_length_988_cov_20.250844	476	556	0	80	80	1.0000000
NODE_6850_length_988_cov_15.812148	474	554	0	80	80	1.0000000
NODE_6850_length_988_cov_15.812148	527	607	0	80	80	1.0000000
NODE_6851_length_988_cov_15.082115	435	517	0	82	82	1.0000000
NODE_6851_length_988_cov_15.082115	490	570	0	80	80	1.0000000
NODE_6852_length_988_cov_14.697413	467	547	0	63	80	0.7875000
NODE_6852_length_988_cov_14.697413	467	547	4	17	80	0.2125000
NODE_6852_length_988_cov_14.697413	520	600	0	10	80	0.1250000
NODE_6852_length_988_cov_14.697413	520	600	4	70	80	0.8750000
NODE_6853_length_988_cov_7.730034	562	642	0	80	80	1.0000000
NODE_6853_length_988_cov_7.730034	615	695	0	80	80	1.0000000
NODE_6862_length_987_cov_42.784910	383	476	0	93	93	1.0000000
NODE_6862_length_987_cov_42.784910	449	529	0	80	80	1.0000000
NODE_6863_length_987_cov_39.716216	290	370	0	80	80	1.0000000
NODE_6863_length_987_cov_39.716216	343	423	0	80	80	1.0000000
NODE_6863_length_987_cov_39.716216	419	499	0	80	80	1.0000000
NODE_6863_length_987_cov_39.716216	472	552	0	80	80	1.0000000
NODE_6864_length_987_cov_28.171171	406	486	0	80	80	1.0000000
NODE_6864_length_987_cov_28.171171	459	539	0	80	80	1.0000000
NODE_6864_length_987_cov_28.171171	535	615	0	80	80	1.0000000
NODE_6864_length_987_cov_28.171171	588	668	0	76	80	0.9500000
NODE_6864_length_987_cov_28.171171	588	668	2	4	80	0.0500000
NODE_6865_length_987_cov_23.627252	331	411	0	80	80	1.0000000
NODE_6865_length_987_cov_23.627252	384	464	0	80	80	1.0000000
NODE_6866_length_987_cov_18.797297	437	517	0	80	80	1.0000000
NODE_6866_length_987_cov_18.797297	490	570	0	80	80	1.0000000
NODE_6867_length_987_cov_15.628378	369	449	0	80	80	1.0000000
NODE_6867_length_987_cov_15.628378	422	502	0	80	80	1.0000000
NODE_6868_length_987_cov_15.439189	438	518	0	80	80	1.0000000
NODE_6868_length_987_cov_15.439189	491	571	0	80	80	1.0000000
NODE_6869_length_987_cov_14.343468	506	586	0	80	80	1.0000000
NODE_6869_length_987_cov_14.343468	559	639	0	80	80	1.0000000
NODE_6870_length_987_cov_13.515766	475	555	0	80	80	1.0000000
NODE_6870_length_987_cov_13.515766	528	608	0	80	80	1.0000000
NODE_6871_length_987_cov_9.521396	408	482	0	74	74	1.0000000
NODE_6871_length_987_cov_9.521396	455	535	0	80	80	1.0000000
NODE_6872_length_987_cov_9.054054	440	520	0	80	80	1.0000000
NODE_6872_length_987_cov_9.054054	493	573	0	80	80	1.0000000
NODE_6875_length_987_cov_5.378378	509	589	0	80	80	1.0000000
NODE_6875_length_987_cov_5.378378	562	642	0	80	80	1.0000000
NODE_6889_length_986_cov_36.937993	327	407	0	7	80	0.0875000
NODE_6889_length_986_cov_36.937993	327	407	4	73	80	0.9125000
NODE_6889_length_986_cov_36.937993	380	460	0	60	80	0.7500000
NODE_6889_length_986_cov_36.937993	380	460	4	20	80	0.2500000
NODE_6889_length_986_cov_36.937993	456	536	0	80	80	1.0000000
NODE_6889_length_986_cov_36.937993	509	589	0	80	80	1.0000000
NODE_6890_length_986_cov_35.130778	325	405	6	33	80	0.4125000
NODE_6890_length_986_cov_35.130778	325	405	8	47	80	0.5875000
NODE_6890_length_986_cov_35.130778	378	458	0	40	80	0.5000000
NODE_6890_length_986_cov_35.130778	378	458	6	40	80	0.5000000
NODE_6890_length_986_cov_35.130778	454	534	0	80	80	1.0000000
NODE_6890_length_986_cov_35.130778	507	587	0	80	80	1.0000000
NODE_6891_length_986_cov_24.037204	602	682	0	80	80	1.0000000
NODE_6891_length_986_cov_24.037204	655	735	0	80	80	1.0000000
NODE_6891_length_986_cov_24.037204	731	811	0	80	80	1.0000000
NODE_6891_length_986_cov_24.037204	784	864	0	70	80	0.8750000
NODE_6891_length_986_cov_24.037204	784	864	2	10	80	0.1250000
NODE_6892_length_986_cov_20.591883	395	475	0	80	80	1.0000000
NODE_6892_length_986_cov_20.591883	448	528	0	80	80	1.0000000
NODE_6893_length_986_cov_16.815107	389	469	0	35	80	0.4375000
NODE_6893_length_986_cov_16.815107	389	469	2	45	80	0.5625000
NODE_6893_length_986_cov_16.815107	442	522	0	26	80	0.3250000
NODE_6893_length_986_cov_16.815107	442	522	2	54	80	0.6750000
NODE_6894_length_986_cov_11.021421	474	554	0	30	80	0.3750000
NODE_6894_length_986_cov_11.021421	474	554	2	50	80	0.6250000
NODE_6894_length_986_cov_11.021421	527	607	0	80	80	1.0000000
NODE_6905_length_985_cov_41.707675	443	523	0	80	80	1.0000000
NODE_6905_length_985_cov_41.707675	496	576	0	80	80	1.0000000
NODE_6911_length_984_cov_64.531073	412	481	0	14	69	0.2028985
NODE_6911_length_984_cov_64.531073	412	481	2	55	69	0.7971014
NODE_6911_length_984_cov_64.531073	454	534	0	25	80	0.3125000
NODE_6911_length_984_cov_64.531073	454	534	2	55	80	0.6875000
NODE_6911_length_984_cov_64.531073	475	555	0	46	80	0.5750000
NODE_6911_length_984_cov_64.531073	475	555	2	34	80	0.4250000
NODE_6911_length_984_cov_64.531073	528	608	0	80	80	1.0000000
NODE_6911_length_984_cov_64.531073	549	629	0	80	80	1.0000000
NODE_6912_length_984_cov_28.832768	430	510	0	80	80	1.0000000
NODE_6912_length_984_cov_28.832768	483	563	0	80	80	1.0000000
NODE_6913_length_984_cov_27.247458	203	283	0	80	80	1.0000000
NODE_6913_length_984_cov_27.247458	256	336	0	55	80	0.6875000
NODE_6913_length_984_cov_27.247458	256	336	4	3	80	0.0375000
NODE_6913_length_984_cov_27.247458	256	336	8	22	80	0.2750000
NODE_6913_length_984_cov_27.247458	332	412	8	80	80	1.0000000
NODE_6913_length_984_cov_27.247458	385	465	0	1	80	0.0125000
NODE_6913_length_984_cov_27.247458	385	465	4	3	80	0.0375000
NODE_6913_length_984_cov_27.247458	385	465	8	76	80	0.9500000
NODE_6914_length_984_cov_25.944633	483	563	0	80	80	1.0000000
NODE_6914_length_984_cov_25.944633	536	616	0	80	80	1.0000000
NODE_6915_length_984_cov_16.611299	351	431	0	80	80	1.0000000
NODE_6915_length_984_cov_16.611299	404	484	0	80	80	1.0000000
NODE_6917_length_984_cov_6.414689	415	495	2	47	80	0.5875000
NODE_6917_length_984_cov_6.414689	415	495	4	33	80	0.4125000
NODE_6917_length_984_cov_6.414689	468	548	0	40	80	0.5000000
NODE_6917_length_984_cov_6.414689	468	548	2	40	80	0.5000000
NODE_6918_length_984_cov_4.720904	494	574	0	80	80	1.0000000
NODE_6918_length_984_cov_4.720904	547	627	0	80	80	1.0000000
NODE_6927_length_984_cov_1.333333	922	971	8	3	49	0.0612245
NODE_6927_length_984_cov_1.333333	922	971	12	21	49	0.4285714
NODE_6927_length_984_cov_1.333333	922	971	14	25	49	0.5102041
NODE_6931_length_983_cov_34.566742	466	546	0	80	80	1.0000000
NODE_6931_length_983_cov_34.566742	519	599	0	80	80	1.0000000
NODE_6932_length_983_cov_26.011312	449	529	0	80	80	1.0000000
NODE_6932_length_983_cov_26.011312	502	582	0	80	80	1.0000000
NODE_6932_length_983_cov_26.011312	578	658	0	80	80	1.0000000
NODE_6932_length_983_cov_26.011312	631	711	0	80	80	1.0000000
NODE_6933_length_983_cov_24.694570	539	619	3	48	80	0.6000000
NODE_6933_length_983_cov_24.694570	539	619	4	32	80	0.4000000
NODE_6933_length_983_cov_24.694570	592	672	0	52	80	0.6500000
NODE_6933_length_983_cov_24.694570	592	672	2	1	80	0.0125000
NODE_6933_length_983_cov_24.694570	592	672	3	27	80	0.3375000
NODE_6934_length_983_cov_22.214932	395	475	0	80	80	1.0000000
NODE_6934_length_983_cov_22.214932	448	528	0	80	80	1.0000000
NODE_6935_length_983_cov_19.132353	377	457	0	80	80	1.0000000
NODE_6935_length_983_cov_19.132353	430	510	0	80	80	1.0000000
NODE_6936_length_983_cov_16.875566	419	499	0	80	80	1.0000000
NODE_6936_length_983_cov_16.875566	472	552	0	80	80	1.0000000
NODE_6936_length_983_cov_16.875566	548	628	0	80	80	1.0000000
NODE_6936_length_983_cov_16.875566	601	681	0	80	80	1.0000000
NODE_6937_length_983_cov_7.240950	487	567	0	80	80	1.0000000
NODE_6937_length_983_cov_7.240950	540	620	0	80	80	1.0000000
NODE_6949_length_982_cov_30.750849	357	437	0	73	80	0.9125000
NODE_6949_length_982_cov_30.750849	357	437	8	7	80	0.0875000
NODE_6949_length_982_cov_30.750849	410	490	0	20	80	0.2500000
NODE_6949_length_982_cov_30.750849	410	490	8	60	80	0.7500000
NODE_6950_length_982_cov_29.901472	516	596	0	80	80	1.0000000
NODE_6950_length_982_cov_29.901472	569	649	0	80	80	1.0000000
NODE_6951_length_982_cov_18.251416	356	436	0	11	80	0.1375000
NODE_6951_length_982_cov_18.251416	356	436	2	69	80	0.8625000
NODE_6951_length_982_cov_18.251416	409	489	0	64	80	0.8000000
NODE_6951_length_982_cov_18.251416	409	489	2	16	80	0.2000000
NODE_6951_length_982_cov_18.251416	485	565	0	80	80	1.0000000
NODE_6951_length_982_cov_18.251416	538	618	0	80	80	1.0000000
NODE_6952_length_982_cov_13.840317	608	688	0	80	80	1.0000000
NODE_6952_length_982_cov_13.840317	661	741	0	80	80	1.0000000
NODE_6953_length_982_cov_13.227633	317	397	0	80	80	1.0000000
NODE_6953_length_982_cov_13.227633	370	450	0	80	80	1.0000000
NODE_6954_length_982_cov_10.918460	209	289	0	80	80	1.0000000
NODE_6954_length_982_cov_10.918460	262	342	0	80	80	1.0000000
NODE_6956_length_982_cov_7.210646	216	296	0	80	80	1.0000000
NODE_6956_length_982_cov_7.210646	269	349	0	80	80	1.0000000
NODE_6973_length_981_cov_55.260771	410	490	0	80	80	1.0000000
NODE_6973_length_981_cov_55.260771	463	543	0	80	80	1.0000000
NODE_6973_length_981_cov_55.260771	539	619	0	80	80	1.0000000
NODE_6973_length_981_cov_55.260771	592	672	0	80	80	1.0000000
NODE_6974_length_981_cov_33.287982	362	441	0	34	79	0.4303797
NODE_6974_length_981_cov_33.287982	362	441	2	45	79	0.5696203
NODE_6974_length_981_cov_33.287982	414	495	0	81	81	1.0000000
NODE_6974_length_981_cov_33.287982	491	571	0	80	80	1.0000000
NODE_6974_length_981_cov_33.287982	544	624	0	80	80	1.0000000
NODE_6975_length_981_cov_33.121315	269	349	0	80	80	1.0000000
NODE_6975_length_981_cov_33.121315	322	402	0	80	80	1.0000000
NODE_6975_length_981_cov_33.121315	398	478	0	80	80	1.0000000
NODE_6975_length_981_cov_33.121315	451	531	0	80	80	1.0000000
NODE_6976_length_981_cov_26.732426	397	477	0	80	80	1.0000000
NODE_6976_length_981_cov_26.732426	450	530	0	80	80	1.0000000
NODE_6977_length_981_cov_24.304989	390	470	0	80	80	1.0000000
NODE_6977_length_981_cov_24.304989	443	523	0	80	80	1.0000000
NODE_6978_length_981_cov_10.485261	363	443	0	80	80	1.0000000
NODE_6978_length_981_cov_10.485261	416	496	0	80	80	1.0000000
NODE_6980_length_981_cov_5.328798	821	885	0	64	64	1.0000000
NODE_6980_length_981_cov_5.328798	847	884	0	37	37	1.0000000
NODE_6998_length_980_cov_40.710556	329	409	0	80	80	1.0000000
NODE_6998_length_980_cov_40.710556	382	462	0	80	80	1.0000000
NODE_6998_length_980_cov_40.710556	458	538	0	56	80	0.7000000
NODE_6998_length_980_cov_40.710556	458	538	2	24	80	0.3000000
NODE_6998_length_980_cov_40.710556	511	591	0	3	80	0.0375000
NODE_6998_length_980_cov_40.710556	511	591	2	77	80	0.9625000
NODE_6999_length_980_cov_37.634506	666	746	0	30	80	0.3750000
NODE_6999_length_980_cov_37.634506	666	746	2	50	80	0.6250000
NODE_6999_length_980_cov_37.634506	719	799	0	31	80	0.3875000
NODE_6999_length_980_cov_37.634506	719	799	2	49	80	0.6125000
NODE_7000_length_980_cov_36.261067	331	411	0	80	80	1.0000000
NODE_7000_length_980_cov_36.261067	384	453	0	69	69	1.0000000
NODE_7000_length_980_cov_36.261067	465	545	0	80	80	1.0000000
NODE_7000_length_980_cov_36.261067	518	598	0	80	80	1.0000000
NODE_7001_length_980_cov_28.514188	430	510	0	80	80	1.0000000
NODE_7001_length_980_cov_28.514188	483	563	0	80	80	1.0000000
NODE_7002_length_980_cov_25.205448	497	577	0	80	80	1.0000000
NODE_7002_length_980_cov_25.205448	550	630	0	80	80	1.0000000
NODE_7003_length_980_cov_24.321226	417	497	0	80	80	1.0000000
NODE_7003_length_980_cov_24.321226	470	550	0	80	80	1.0000000
NODE_7004_length_980_cov_20.460840	388	468	0	80	80	1.0000000
NODE_7004_length_980_cov_20.460840	441	521	0	80	80	1.0000000
NODE_7005_length_980_cov_19.969353	486	566	0	80	80	1.0000000
NODE_7005_length_980_cov_19.969353	539	619	0	80	80	1.0000000
NODE_7006_length_980_cov_13.736663	350	430	0	80	80	1.0000000
NODE_7006_length_980_cov_13.736663	403	483	0	80	80	1.0000000
NODE_7006_length_980_cov_13.736663	479	559	0	80	80	1.0000000
NODE_7006_length_980_cov_13.736663	532	612	0	80	80	1.0000000
NODE_7008_length_980_cov_10.842225	517	597	0	80	80	1.0000000
NODE_7008_length_980_cov_10.842225	570	650	0	80	80	1.0000000
NODE_7009_length_980_cov_10.087401	341	424	0	83	83	1.0000000
NODE_7009_length_980_cov_10.087401	397	477	0	80	80	1.0000000
NODE_7010_length_980_cov_9.643587	267	347	0	80	80	1.0000000
NODE_7010_length_980_cov_9.643587	320	400	0	80	80	1.0000000
NODE_7010_length_980_cov_9.643587	396	476	0	34	80	0.4250000
NODE_7010_length_980_cov_9.643587	396	476	2	46	80	0.5750000
NODE_7010_length_980_cov_9.643587	449	529	0	24	80	0.3000000
NODE_7010_length_980_cov_9.643587	449	529	2	56	80	0.7000000
NODE_7026_length_979_cov_22.576136	442	522	0	9	80	0.1125000
NODE_7026_length_979_cov_22.576136	442	522	3	12	80	0.1500000
NODE_7026_length_979_cov_22.576136	442	522	4	59	80	0.7375000
NODE_7026_length_979_cov_22.576136	495	575	0	48	80	0.6000000
NODE_7026_length_979_cov_22.576136	495	575	3	17	80	0.2125000
NODE_7026_length_979_cov_22.576136	495	575	4	15	80	0.1875000
NODE_7027_length_979_cov_19.739773	445	524	0	78	79	0.9873418
NODE_7027_length_979_cov_19.739773	445	524	1	1	79	0.0126582
NODE_7027_length_979_cov_19.739773	497	577	0	80	80	1.0000000
NODE_7028_length_979_cov_19.480682	436	516	0	80	80	1.0000000
NODE_7028_length_979_cov_19.480682	489	569	0	80	80	1.0000000
NODE_7028_length_979_cov_19.480682	565	645	0	80	80	1.0000000
NODE_7028_length_979_cov_19.480682	618	698	0	80	80	1.0000000
NODE_7029_length_979_cov_18.901136	470	550	0	80	80	1.0000000
NODE_7029_length_979_cov_18.901136	523	603	0	80	80	1.0000000
NODE_7031_length_979_cov_3.519318	101	168	2	30	67	0.4477612
NODE_7031_length_979_cov_3.519318	101	168	4	37	67	0.5522388
NODE_7040_length_978_cov_23.195677	424	504	0	22	80	0.2750000
NODE_7040_length_978_cov_23.195677	424	504	2	20	80	0.2500000
NODE_7040_length_978_cov_23.195677	424	504	4	14	80	0.1750000
NODE_7040_length_978_cov_23.195677	424	504	5	20	80	0.2500000
NODE_7040_length_978_cov_23.195677	424	504	6	4	80	0.0500000
NODE_7040_length_978_cov_23.195677	477	557	4	42	80	0.5250000
NODE_7040_length_978_cov_23.195677	477	557	5	20	80	0.2500000
NODE_7040_length_978_cov_23.195677	477	557	6	18	80	0.2250000
NODE_7041_length_978_cov_18.866894	440	520	0	8	80	0.1000000
NODE_7041_length_978_cov_18.866894	440	520	4	72	80	0.9000000
NODE_7041_length_978_cov_18.866894	493	573	0	33	80	0.4125000
NODE_7041_length_978_cov_18.866894	493	573	4	47	80	0.5875000
NODE_7042_length_978_cov_15.614334	341	421	0	80	80	1.0000000
NODE_7042_length_978_cov_15.614334	394	474	0	80	80	1.0000000
NODE_7042_length_978_cov_15.614334	470	550	0	80	80	1.0000000
NODE_7042_length_978_cov_15.614334	523	603	0	80	80	1.0000000
NODE_7043_length_978_cov_15.253697	327	407	0	80	80	1.0000000
NODE_7043_length_978_cov_15.253697	380	460	0	72	80	0.9000000
NODE_7043_length_978_cov_15.253697	380	460	2	8	80	0.1000000
NODE_7043_length_978_cov_15.253697	456	536	0	18	80	0.2250000
NODE_7043_length_978_cov_15.253697	456	536	2	62	80	0.7750000
NODE_7043_length_978_cov_15.253697	509	589	0	71	80	0.8875000
NODE_7043_length_978_cov_15.253697	509	589	2	9	80	0.1125000
NODE_7044_length_978_cov_14.730375	407	487	0	80	80	1.0000000
NODE_7044_length_978_cov_14.730375	460	540	0	80	80	1.0000000
NODE_7045_length_978_cov_7.257110	571	651	0	80	80	1.0000000
NODE_7045_length_978_cov_7.257110	624	704	0	80	80	1.0000000
NODE_7062_length_977_cov_47.484055	427	507	0	80	80	1.0000000
NODE_7062_length_977_cov_47.484055	480	560	0	80	80	1.0000000
NODE_7063_length_977_cov_47.116173	428	508	0	80	80	1.0000000
NODE_7063_length_977_cov_47.116173	481	561	0	80	80	1.0000000
NODE_7063_length_977_cov_47.116173	557	637	0	80	80	1.0000000
NODE_7063_length_977_cov_47.116173	610	690	0	80	80	1.0000000
NODE_7064_length_977_cov_32.542141	486	566	0	80	80	1.0000000
NODE_7064_length_977_cov_32.542141	539	619	0	80	80	1.0000000
NODE_7065_length_977_cov_30.676538	361	441	18	80	80	1.0000000
NODE_7065_length_977_cov_30.676538	414	494	18	80	80	1.0000000
NODE_7066_length_977_cov_28.348519	455	535	0	80	80	1.0000000
NODE_7066_length_977_cov_28.348519	508	588	0	80	80	1.0000000
NODE_7067_length_977_cov_26.571754	343	423	0	80	80	1.0000000
NODE_7067_length_977_cov_26.571754	396	476	0	80	80	1.0000000
NODE_7067_length_977_cov_26.571754	472	552	0	27	80	0.3375000
NODE_7067_length_977_cov_26.571754	472	552	2	53	80	0.6625000
NODE_7067_length_977_cov_26.571754	525	600	2	75	75	1.0000000
NODE_7068_length_977_cov_24.898633	470	550	0	80	80	1.0000000
NODE_7068_length_977_cov_24.898633	523	603	0	80	80	1.0000000
NODE_7069_length_977_cov_22.986333	313	393	0	80	80	1.0000000
NODE_7069_length_977_cov_22.986333	366	446	0	80	80	1.0000000
NODE_7069_length_977_cov_22.986333	442	522	0	20	80	0.2500000
NODE_7069_length_977_cov_22.986333	442	522	2	60	80	0.7500000
NODE_7069_length_977_cov_22.986333	495	575	0	33	80	0.4125000
NODE_7069_length_977_cov_22.986333	495	575	2	47	80	0.5875000
NODE_7070_length_977_cov_10.753986	290	370	0	32	80	0.4000000
NODE_7070_length_977_cov_10.753986	290	370	4	48	80	0.6000000
NODE_7070_length_977_cov_10.753986	343	423	0	15	80	0.1875000
NODE_7070_length_977_cov_10.753986	343	423	4	65	80	0.8125000
NODE_7071_length_977_cov_9.924829	401	456	0	55	55	1.0000000
NODE_7073_length_977_cov_6.391800	483	563	0	80	80	1.0000000
NODE_7073_length_977_cov_6.391800	536	616	0	80	80	1.0000000
NODE_7075_length_977_cov_2.907745	191	241	0	50	50	1.0000000
NODE_7085_length_976_cov_38.192702	326	406	0	41	80	0.5125000
NODE_7085_length_976_cov_38.192702	326	406	2	39	80	0.4875000
NODE_7085_length_976_cov_38.192702	379	459	0	80	80	1.0000000
NODE_7085_length_976_cov_38.192702	455	535	0	80	80	1.0000000
NODE_7085_length_976_cov_38.192702	455	536	0	81	81	1.0000000
NODE_7085_length_976_cov_38.192702	455	519	0	64	64	1.0000000
NODE_7085_length_976_cov_38.192702	508	588	0	80	80	1.0000000
NODE_7086_length_976_cov_26.275941	499	579	0	80	80	1.0000000
NODE_7086_length_976_cov_26.275941	552	632	0	80	80	1.0000000
NODE_7087_length_976_cov_25.559863	376	456	0	80	80	1.0000000
NODE_7087_length_976_cov_25.559863	429	509	0	80	80	1.0000000
NODE_7088_length_976_cov_17.961231	572	652	0	80	80	1.0000000
NODE_7088_length_976_cov_17.961231	625	705	0	80	80	1.0000000
NODE_7089_length_976_cov_5.567845	789	851	4	10	62	0.1612903
NODE_7089_length_976_cov_5.567845	789	851	6	52	62	0.8387097
NODE_7089_length_976_cov_5.567845	842	904	0	11	62	0.1774193
NODE_7089_length_976_cov_5.567845	842	904	4	51	62	0.8225806
NODE_7101_length_975_cov_192.211187	722	802	35	2	80	0.0250000
NODE_7101_length_975_cov_192.211187	722	802	37	5	80	0.0625000
NODE_7101_length_975_cov_192.211187	722	802	38	3	80	0.0375000
NODE_7101_length_975_cov_192.211187	722	802	39	7	80	0.0875000
NODE_7101_length_975_cov_192.211187	722	802	43	1	80	0.0125000
NODE_7101_length_975_cov_192.211187	722	802	47	1	80	0.0125000
NODE_7101_length_975_cov_192.211187	722	802	51	2	80	0.0250000
NODE_7101_length_975_cov_192.211187	722	802	53	3	80	0.0375000
NODE_7101_length_975_cov_192.211187	722	802	54	1	80	0.0125000
NODE_7101_length_975_cov_192.211187	722	802	56	2	80	0.0250000
NODE_7101_length_975_cov_192.211187	722	802	58	2	80	0.0250000
NODE_7101_length_975_cov_192.211187	722	802	61	1	80	0.0125000
NODE_7101_length_975_cov_192.211187	722	802	62	3	80	0.0375000
NODE_7101_length_975_cov_192.211187	722	802	64	13	80	0.1625000
NODE_7101_length_975_cov_192.211187	722	802	66	3	80	0.0375000
NODE_7101_length_975_cov_192.211187	722	802	67	1	80	0.0125000
NODE_7101_length_975_cov_192.211187	722	802	68	7	80	0.0875000
NODE_7101_length_975_cov_192.211187	722	802	70	5	80	0.0625000
NODE_7101_length_975_cov_192.211187	722	802	72	1	80	0.0125000
NODE_7101_length_975_cov_192.211187	722	802	73	2	80	0.0250000
NODE_7101_length_975_cov_192.211187	722	802	77	2	80	0.0250000
NODE_7101_length_975_cov_192.211187	722	802	79	4	80	0.0500000
NODE_7101_length_975_cov_192.211187	722	802	81	1	80	0.0125000
NODE_7101_length_975_cov_192.211187	722	802	83	1	80	0.0125000
NODE_7101_length_975_cov_192.211187	722	802	84	3	80	0.0375000
NODE_7101_length_975_cov_192.211187	722	802	85	4	80	0.0500000
NODE_7102_length_975_cov_41.446347	414	494	0	36	80	0.4500000
NODE_7102_length_975_cov_41.446347	414	494	1	44	80	0.5500000
NODE_7102_length_975_cov_41.446347	467	547	1	80	80	1.0000000
NODE_7103_length_975_cov_37.618721	375	455	0	80	80	1.0000000
NODE_7103_length_975_cov_37.618721	428	508	0	80	80	1.0000000
NODE_7104_length_975_cov_34.265982	424	504	0	80	80	1.0000000
NODE_7104_length_975_cov_34.265982	477	557	0	80	80	1.0000000
NODE_7105_length_975_cov_31.888128	461	541	0	64	80	0.8000000
NODE_7105_length_975_cov_31.888128	461	541	2	14	80	0.1750000
NODE_7105_length_975_cov_31.888128	461	541	3	2	80	0.0250000
NODE_7105_length_975_cov_31.888128	514	594	0	13	80	0.1625000
NODE_7105_length_975_cov_31.888128	514	594	2	67	80	0.8375000
NODE_7106_length_975_cov_22.093607	392	472	0	80	80	1.0000000
NODE_7106_length_975_cov_22.093607	445	525	0	80	80	1.0000000
NODE_7107_length_975_cov_15.091324	403	483	0	70	80	0.8750000
NODE_7107_length_975_cov_15.091324	403	483	2	10	80	0.1250000
NODE_7107_length_975_cov_15.091324	456	536	0	80	80	1.0000000
NODE_7108_length_975_cov_15.046804	63	143	0	80	80	1.0000000
NODE_7108_length_975_cov_15.046804	116	196	0	80	80	1.0000000
NODE_7109_length_975_cov_12.043379	535	615	0	80	80	1.0000000
NODE_7109_length_975_cov_12.043379	588	668	0	80	80	1.0000000
NODE_7110_length_975_cov_11.772831	276	354	0	78	78	1.0000000
NODE_7110_length_975_cov_11.772831	327	407	0	80	80	1.0000000
NODE_7111_length_975_cov_10.599315	405	485	0	80	80	1.0000000
NODE_7111_length_975_cov_10.599315	458	538	0	80	80	1.0000000
NODE_7112_length_975_cov_8.089041	430	510	0	80	80	1.0000000
NODE_7112_length_975_cov_8.089041	483	563	0	80	80	1.0000000
NODE_7114_length_975_cov_3.728311	254	334	0	80	80	1.0000000
NODE_7114_length_975_cov_3.728311	307	387	0	80	80	1.0000000
NODE_7125_length_974_cov_293.334857	564	642	686	1	78	0.0128205
NODE_7125_length_974_cov_293.334857	564	642	689	1	78	0.0128205
NODE_7125_length_974_cov_293.334857	564	642	691	1	78	0.0128205
NODE_7125_length_974_cov_293.334857	564	642	693	1	78	0.0128205
NODE_7125_length_974_cov_293.334857	564	642	698	2	78	0.0256410
NODE_7125_length_974_cov_293.334857	564	642	700	2	78	0.0256410
NODE_7125_length_974_cov_293.334857	564	642	702	2	78	0.0256410
NODE_7125_length_974_cov_293.334857	564	642	703	5	78	0.0641026
NODE_7125_length_974_cov_293.334857	564	642	704	2	78	0.0256410
NODE_7125_length_974_cov_293.334857	564	642	706	2	78	0.0256410
NODE_7125_length_974_cov_293.334857	564	642	707	3	78	0.0384615
NODE_7125_length_974_cov_293.334857	564	642	708	3	78	0.0384615
NODE_7125_length_974_cov_293.334857	564	642	709	5	78	0.0641026
NODE_7125_length_974_cov_293.334857	564	642	710	6	78	0.0769231
NODE_7125_length_974_cov_293.334857	564	642	711	2	78	0.0256410
NODE_7125_length_974_cov_293.334857	564	642	712	2	78	0.0256410
NODE_7125_length_974_cov_293.334857	564	642	713	1	78	0.0128205
NODE_7125_length_974_cov_293.334857	564	642	714	3	78	0.0384615
NODE_7125_length_974_cov_293.334857	564	642	715	1	78	0.0128205
NODE_7125_length_974_cov_293.334857	564	642	716	2	78	0.0256410
NODE_7125_length_974_cov_293.334857	564	642	717	2	78	0.0256410
NODE_7125_length_974_cov_293.334857	564	642	718	4	78	0.0512821
NODE_7125_length_974_cov_293.334857	564	642	719	3	78	0.0384615
NODE_7125_length_974_cov_293.334857	564	642	720	3	78	0.0384615
NODE_7125_length_974_cov_293.334857	564	642	721	3	78	0.0384615
NODE_7125_length_974_cov_293.334857	564	642	722	1	78	0.0128205
NODE_7125_length_974_cov_293.334857	564	642	723	1	78	0.0128205
NODE_7125_length_974_cov_293.334857	564	642	724	1	78	0.0128205
NODE_7125_length_974_cov_293.334857	564	642	725	1	78	0.0128205
NODE_7125_length_974_cov_293.334857	564	642	727	1	78	0.0128205
NODE_7125_length_974_cov_293.334857	564	642	729	1	78	0.0128205
NODE_7125_length_974_cov_293.334857	564	642	757	1	78	0.0128205
NODE_7125_length_974_cov_293.334857	564	642	760	1	78	0.0128205
NODE_7125_length_974_cov_293.334857	564	642	762	1	78	0.0128205
NODE_7125_length_974_cov_293.334857	564	642	772	1	78	0.0128205
NODE_7125_length_974_cov_293.334857	564	642	775	1	78	0.0128205
NODE_7125_length_974_cov_293.334857	564	642	777	1	78	0.0128205
NODE_7125_length_974_cov_293.334857	564	642	778	1	78	0.0128205
NODE_7125_length_974_cov_293.334857	564	642	780	2	78	0.0256410
NODE_7125_length_974_cov_293.334857	564	642	783	1	78	0.0128205
NODE_7125_length_974_cov_293.334857	564	642	686	1	78	0.0128205
NODE_7125_length_974_cov_293.334857	564	642	689	1	78	0.0128205
NODE_7125_length_974_cov_293.334857	564	642	691	1	78	0.0128205
NODE_7125_length_974_cov_293.334857	564	642	693	1	78	0.0128205
NODE_7125_length_974_cov_293.334857	564	642	698	2	78	0.0256410
NODE_7125_length_974_cov_293.334857	564	642	700	2	78	0.0256410
NODE_7125_length_974_cov_293.334857	564	642	702	2	78	0.0256410
NODE_7125_length_974_cov_293.334857	564	642	703	5	78	0.0641026
NODE_7125_length_974_cov_293.334857	564	642	704	2	78	0.0256410
NODE_7125_length_974_cov_293.334857	564	642	706	2	78	0.0256410
NODE_7125_length_974_cov_293.334857	564	642	707	3	78	0.0384615
NODE_7125_length_974_cov_293.334857	564	642	708	3	78	0.0384615
NODE_7125_length_974_cov_293.334857	564	642	709	5	78	0.0641026
NODE_7125_length_974_cov_293.334857	564	642	710	6	78	0.0769231
NODE_7125_length_974_cov_293.334857	564	642	711	2	78	0.0256410
NODE_7125_length_974_cov_293.334857	564	642	712	2	78	0.0256410
NODE_7125_length_974_cov_293.334857	564	642	713	1	78	0.0128205
NODE_7125_length_974_cov_293.334857	564	642	714	3	78	0.0384615
NODE_7125_length_974_cov_293.334857	564	642	715	1	78	0.0128205
NODE_7125_length_974_cov_293.334857	564	642	716	2	78	0.0256410
NODE_7125_length_974_cov_293.334857	564	642	717	2	78	0.0256410
NODE_7125_length_974_cov_293.334857	564	642	718	4	78	0.0512821
NODE_7125_length_974_cov_293.334857	564	642	719	3	78	0.0384615
NODE_7125_length_974_cov_293.334857	564	642	720	3	78	0.0384615
NODE_7125_length_974_cov_293.334857	564	642	721	3	78	0.0384615
NODE_7125_length_974_cov_293.334857	564	642	722	1	78	0.0128205
NODE_7125_length_974_cov_293.334857	564	642	723	1	78	0.0128205
NODE_7125_length_974_cov_293.334857	564	642	724	1	78	0.0128205
NODE_7125_length_974_cov_293.334857	564	642	725	1	78	0.0128205
NODE_7125_length_974_cov_293.334857	564	642	727	1	78	0.0128205
NODE_7125_length_974_cov_293.334857	564	642	729	1	78	0.0128205
NODE_7125_length_974_cov_293.334857	564	642	757	1	78	0.0128205
NODE_7125_length_974_cov_293.334857	564	642	760	1	78	0.0128205
NODE_7125_length_974_cov_293.334857	564	642	762	1	78	0.0128205
NODE_7125_length_974_cov_293.334857	564	642	772	1	78	0.0128205
NODE_7125_length_974_cov_293.334857	564	642	775	1	78	0.0128205
NODE_7125_length_974_cov_293.334857	564	642	777	1	78	0.0128205
NODE_7125_length_974_cov_293.334857	564	642	778	1	78	0.0128205
NODE_7125_length_974_cov_293.334857	564	642	780	2	78	0.0256410
NODE_7125_length_974_cov_293.334857	564	642	783	1	78	0.0128205
NODE_7125_length_974_cov_293.334857	564	633	698	2	69	0.0289855
NODE_7125_length_974_cov_293.334857	564	633	700	2	69	0.0289855
NODE_7125_length_974_cov_293.334857	564	633	702	2	69	0.0289855
NODE_7125_length_974_cov_293.334857	564	633	703	4	69	0.0579710
NODE_7125_length_974_cov_293.334857	564	633	704	2	69	0.0289855
NODE_7125_length_974_cov_293.334857	564	633	706	2	69	0.0289855
NODE_7125_length_974_cov_293.334857	564	633	707	3	69	0.0434783
NODE_7125_length_974_cov_293.334857	564	633	708	3	69	0.0434783
NODE_7125_length_974_cov_293.334857	564	633	709	5	69	0.0724638
NODE_7125_length_974_cov_293.334857	564	633	710	6	69	0.0869565
NODE_7125_length_974_cov_293.334857	564	633	711	2	69	0.0289855
NODE_7125_length_974_cov_293.334857	564	633	712	2	69	0.0289855
NODE_7125_length_974_cov_293.334857	564	633	713	1	69	0.0144928
NODE_7125_length_974_cov_293.334857	564	633	714	2	69	0.0289855
NODE_7125_length_974_cov_293.334857	564	633	715	1	69	0.0144928
NODE_7125_length_974_cov_293.334857	564	633	716	2	69	0.0289855
NODE_7125_length_974_cov_293.334857	564	633	717	2	69	0.0289855
NODE_7125_length_974_cov_293.334857	564	633	718	3	69	0.0434783
NODE_7125_length_974_cov_293.334857	564	633	719	3	69	0.0434783
NODE_7125_length_974_cov_293.334857	564	633	720	3	69	0.0434783
NODE_7125_length_974_cov_293.334857	564	633	721	1	69	0.0144928
NODE_7125_length_974_cov_293.334857	564	633	722	1	69	0.0144928
NODE_7125_length_974_cov_293.334857	564	633	723	1	69	0.0144928
NODE_7125_length_974_cov_293.334857	564	633	724	1	69	0.0144928
NODE_7125_length_974_cov_293.334857	564	633	725	1	69	0.0144928
NODE_7125_length_974_cov_293.334857	564	633	727	1	69	0.0144928
NODE_7125_length_974_cov_293.334857	564	633	729	1	69	0.0144928
NODE_7125_length_974_cov_293.334857	564	633	757	1	69	0.0144928
NODE_7125_length_974_cov_293.334857	564	633	760	1	69	0.0144928
NODE_7125_length_974_cov_293.334857	564	633	762	1	69	0.0144928
NODE_7125_length_974_cov_293.334857	564	633	772	1	69	0.0144928
NODE_7125_length_974_cov_293.334857	564	633	775	1	69	0.0144928
NODE_7125_length_974_cov_293.334857	564	633	777	1	69	0.0144928
NODE_7125_length_974_cov_293.334857	564	633	778	1	69	0.0144928
NODE_7125_length_974_cov_293.334857	564	633	780	2	69	0.0289855
NODE_7125_length_974_cov_293.334857	564	633	783	1	69	0.0144928
NODE_7126_length_974_cov_49.884571	459	539	0	69	80	0.8625000
NODE_7126_length_974_cov_49.884571	459	539	2	11	80	0.1375000
NODE_7126_length_974_cov_49.884571	512	592	0	16	80	0.2000000
NODE_7126_length_974_cov_49.884571	512	592	2	64	80	0.8000000
NODE_7127_length_974_cov_38.384000	430	508	0	78	78	1.0000000
NODE_7127_length_974_cov_38.384000	483	561	0	78	78	1.0000000
NODE_7128_length_974_cov_26.008000	391	471	0	12	80	0.1500000
NODE_7128_length_974_cov_26.008000	391	471	2	68	80	0.8500000
NODE_7128_length_974_cov_26.008000	444	524	0	65	80	0.8125000
NODE_7128_length_974_cov_26.008000	444	524	2	15	80	0.1875000
NODE_7128_length_974_cov_26.008000	520	600	0	80	80	1.0000000
NODE_7128_length_974_cov_26.008000	573	653	0	80	80	1.0000000
NODE_7129_length_974_cov_21.160000	460	540	0	80	80	1.0000000
NODE_7129_length_974_cov_21.160000	513	593	0	80	80	1.0000000
NODE_7131_length_974_cov_11.384000	290	370	0	80	80	1.0000000
NODE_7131_length_974_cov_11.384000	343	423	0	80	80	1.0000000
NODE_7132_length_974_cov_11.216000	543	623	0	40	80	0.5000000
NODE_7132_length_974_cov_11.216000	543	623	2	40	80	0.5000000
NODE_7132_length_974_cov_11.216000	596	668	0	72	72	1.0000000
NODE_7133_length_974_cov_9.601143	436	516	0	80	80	1.0000000
NODE_7133_length_974_cov_9.601143	489	569	0	80	80	1.0000000
NODE_7134_length_974_cov_7.436571	382	462	0	80	80	1.0000000
NODE_7134_length_974_cov_7.436571	436	515	0	79	79	1.0000000
NODE_7147_length_973_cov_46.012586	349	429	0	80	80	1.0000000
NODE_7147_length_973_cov_46.012586	402	482	0	80	80	1.0000000
NODE_7147_length_973_cov_46.012586	478	558	0	43	80	0.5375000
NODE_7147_length_973_cov_46.012586	478	558	2	37	80	0.4625000
NODE_7147_length_973_cov_46.012586	531	611	0	34	80	0.4250000
NODE_7147_length_973_cov_46.012586	531	611	2	46	80	0.5750000
NODE_7148_length_973_cov_40.305492	364	444	0	28	80	0.3500000
NODE_7148_length_973_cov_40.305492	364	444	2	24	80	0.3000000
NODE_7148_length_973_cov_40.305492	364	444	4	28	80	0.3500000
NODE_7148_length_973_cov_40.305492	417	497	0	80	80	1.0000000
NODE_7149_length_973_cov_24.105263	460	540	0	80	80	1.0000000
NODE_7149_length_973_cov_24.105263	513	593	0	80	80	1.0000000
NODE_7150_length_973_cov_22.106407	342	422	0	80	80	1.0000000
NODE_7150_length_973_cov_22.106407	395	475	0	80	80	1.0000000
NODE_7150_length_973_cov_22.106407	471	550	0	79	79	1.0000000
NODE_7150_length_973_cov_22.106407	526	604	0	78	78	1.0000000
NODE_7151_length_973_cov_10.994279	430	510	0	30	80	0.3750000
NODE_7151_length_973_cov_10.994279	430	510	2	50	80	0.6250000
NODE_7151_length_973_cov_10.994279	483	563	0	44	80	0.5500000
NODE_7151_length_973_cov_10.994279	483	563	2	36	80	0.4500000
NODE_7151_length_973_cov_10.994279	559	635	0	76	76	1.0000000
NODE_7151_length_973_cov_10.994279	608	688	0	80	80	1.0000000
NODE_7153_length_973_cov_2.973684	734	814	0	73	80	0.9125000
NODE_7153_length_973_cov_2.973684	734	814	2	7	80	0.0875000
NODE_7153_length_973_cov_2.973684	820	890	2	4	70	0.0571429
NODE_7153_length_973_cov_2.973684	820	890	4	1	70	0.0142857
NODE_7153_length_973_cov_2.973684	820	890	13	15	70	0.2142857
NODE_7153_length_973_cov_2.973684	820	890	15	5	70	0.0714286
NODE_7153_length_973_cov_2.973684	820	890	17	13	70	0.1857143
NODE_7153_length_973_cov_2.973684	820	890	19	2	70	0.0285714
NODE_7153_length_973_cov_2.973684	820	890	20	1	70	0.0142857
NODE_7153_length_973_cov_2.973684	820	890	21	4	70	0.0571429
NODE_7153_length_973_cov_2.973684	820	890	23	25	70	0.3571429
NODE_7153_length_973_cov_2.973684	863	944	9	5	81	0.0617284
NODE_7153_length_973_cov_2.973684	863	944	11	1	81	0.0123457
NODE_7153_length_973_cov_2.973684	863	944	17	5	81	0.0617284
NODE_7153_length_973_cov_2.973684	863	944	19	3	81	0.0370370
NODE_7153_length_973_cov_2.973684	863	944	21	3	81	0.0370370
NODE_7153_length_973_cov_2.973684	863	944	23	64	81	0.7901235
NODE_7166_length_972_cov_32.547537	299	379	0	80	80	1.0000000
NODE_7166_length_972_cov_32.547537	352	432	0	80	80	1.0000000
NODE_7166_length_972_cov_32.547537	428	508	0	80	80	1.0000000
NODE_7166_length_972_cov_32.547537	481	561	0	80	80	1.0000000
NODE_7167_length_972_cov_31.010309	474	554	0	80	80	1.0000000
NODE_7167_length_972_cov_31.010309	527	607	0	80	80	1.0000000
NODE_7168_length_972_cov_29.810997	481	561	0	80	80	1.0000000
NODE_7168_length_972_cov_29.810997	534	614	0	80	80	1.0000000
NODE_7169_length_972_cov_23.438717	442	522	0	80	80	1.0000000
NODE_7169_length_972_cov_23.438717	495	575	0	80	80	1.0000000
NODE_7170_length_972_cov_18.886598	453	533	2	80	80	1.0000000
NODE_7170_length_972_cov_18.886598	506	585	0	24	79	0.3037975
NODE_7170_length_972_cov_18.886598	506	585	2	55	79	0.6962025
NODE_7171_length_972_cov_15.100802	329	409	0	80	80	1.0000000
NODE_7171_length_972_cov_15.100802	382	462	0	75	80	0.9375000
NODE_7171_length_972_cov_15.100802	382	462	1	5	80	0.0625000
NODE_7172_length_972_cov_12.674685	444	524	0	80	80	1.0000000
NODE_7172_length_972_cov_12.674685	497	577	0	80	80	1.0000000
NODE_7173_length_972_cov_11.235968	504	584	0	80	80	1.0000000
NODE_7173_length_972_cov_11.235968	557	637	0	80	80	1.0000000
NODE_7174_length_972_cov_10.983963	402	482	0	80	80	1.0000000
NODE_7174_length_972_cov_10.983963	455	535	0	80	80	1.0000000
NODE_7175_length_972_cov_8.887743	302	382	0	80	80	1.0000000
NODE_7175_length_972_cov_8.887743	355	430	0	75	75	1.0000000
NODE_7176_length_972_cov_8.265750	488	568	0	80	80	1.0000000
NODE_7176_length_972_cov_8.265750	541	621	0	80	80	1.0000000
NODE_7182_length_972_cov_2.714777	165	241	2	76	76	1.0000000
NODE_7195_length_971_cov_52.575688	398	478	1	80	80	1.0000000
NODE_7195_length_971_cov_52.575688	451	531	0	15	80	0.1875000
NODE_7195_length_971_cov_52.575688	451	531	1	65	80	0.8125000
NODE_7195_length_971_cov_52.575688	527	607	0	76	80	0.9500000
NODE_7195_length_971_cov_52.575688	527	607	1	4	80	0.0500000
NODE_7195_length_971_cov_52.575688	580	660	0	23	80	0.2875000
NODE_7195_length_971_cov_52.575688	580	660	1	57	80	0.7125000
NODE_7196_length_971_cov_44.464450	280	360	0	80	80	1.0000000
NODE_7196_length_971_cov_44.464450	333	413	0	80	80	1.0000000
NODE_7196_length_971_cov_44.464450	409	489	0	80	80	1.0000000
NODE_7196_length_971_cov_44.464450	462	542	0	80	80	1.0000000
NODE_7197_length_971_cov_32.721330	509	589	0	80	80	1.0000000
NODE_7197_length_971_cov_32.721330	562	642	0	80	80	1.0000000
NODE_7198_length_971_cov_30.264908	474	554	0	80	80	1.0000000
NODE_7198_length_971_cov_30.264908	527	607	0	56	80	0.7000000
NODE_7198_length_971_cov_30.264908	527	607	2	24	80	0.3000000
NODE_7199_length_971_cov_26.631881	434	514	0	80	80	1.0000000
NODE_7199_length_971_cov_26.631881	487	567	0	80	80	1.0000000
NODE_7200_length_971_cov_25.635321	404	484	0	80	80	1.0000000
NODE_7200_length_971_cov_25.635321	457	537	0	80	80	1.0000000
NODE_7201_length_971_cov_23.334862	363	443	0	7	80	0.0875000
NODE_7201_length_971_cov_23.334862	363	443	10	10	80	0.1250000
NODE_7201_length_971_cov_23.334862	363	443	12	63	80	0.7875000
NODE_7201_length_971_cov_23.334862	416	497	0	61	81	0.7530864
NODE_7201_length_971_cov_23.334862	416	497	10	2	81	0.0246914
NODE_7201_length_971_cov_23.334862	416	497	12	18	81	0.2222222
NODE_7202_length_971_cov_18.254587	468	548	0	24	80	0.3000000
NODE_7202_length_971_cov_18.254587	468	548	8	56	80	0.7000000
NODE_7202_length_971_cov_18.254587	521	601	0	30	80	0.3750000
NODE_7202_length_971_cov_18.254587	521	601	8	50	80	0.6250000
NODE_7203_length_971_cov_18.229358	392	472	0	80	80	1.0000000
NODE_7203_length_971_cov_18.229358	445	525	0	70	80	0.8750000
NODE_7203_length_971_cov_18.229358	445	525	2	10	80	0.1250000
NODE_7204_length_971_cov_16.591743	481	561	0	80	80	1.0000000
NODE_7204_length_971_cov_16.591743	534	614	0	80	80	1.0000000
NODE_7205_length_971_cov_15.563073	463	543	0	80	80	1.0000000
NODE_7205_length_971_cov_15.563073	516	596	0	80	80	1.0000000
NODE_7206_length_971_cov_12.141055	415	495	0	80	80	1.0000000
NODE_7206_length_971_cov_12.141055	468	548	0	80	80	1.0000000
NODE_7222_length_970_cov_34.928817	438	518	0	80	80	1.0000000
NODE_7222_length_970_cov_34.928817	491	571	0	80	80	1.0000000
NODE_7223_length_970_cov_34.445465	540	620	0	80	80	1.0000000
NODE_7223_length_970_cov_34.445465	593	673	0	80	80	1.0000000
NODE_7224_length_970_cov_34.257176	352	432	0	80	80	1.0000000
NODE_7224_length_970_cov_34.257176	405	485	0	77	80	0.9625000
NODE_7224_length_970_cov_34.257176	405	485	2	3	80	0.0375000
NODE_7225_length_970_cov_26.904707	297	372	8	23	75	0.3066667
NODE_7225_length_970_cov_26.904707	297	372	9	36	75	0.4800000
NODE_7225_length_970_cov_26.904707	297	372	10	16	75	0.2133333
NODE_7225_length_970_cov_26.904707	303	376	8	23	73	0.3150685
NODE_7225_length_970_cov_26.904707	303	376	9	40	73	0.5479452
NODE_7225_length_970_cov_26.904707	303	376	10	10	73	0.1369863
NODE_7225_length_970_cov_26.904707	311	377	8	23	66	0.3484848
NODE_7225_length_970_cov_26.904707	311	377	9	41	66	0.6212121
NODE_7225_length_970_cov_26.904707	311	377	10	2	66	0.0303030
NODE_7225_length_970_cov_26.904707	350	429	1	36	79	0.4556962
NODE_7225_length_970_cov_26.904707	350	429	7	1	79	0.0126582
NODE_7225_length_970_cov_26.904707	350	429	9	42	79	0.5316456
NODE_7225_length_970_cov_26.904707	350	429	1	36	79	0.4556962
NODE_7225_length_970_cov_26.904707	350	429	7	1	79	0.0126582
NODE_7225_length_970_cov_26.904707	350	429	9	42	79	0.5316456
NODE_7225_length_970_cov_26.904707	350	429	1	36	79	0.4556962
NODE_7225_length_970_cov_26.904707	350	429	7	1	79	0.0126582
NODE_7225_length_970_cov_26.904707	350	429	9	42	79	0.5316456
NODE_7226_length_970_cov_26.040184	266	346	0	60	80	0.7500000
NODE_7226_length_970_cov_26.040184	266	346	2	3	80	0.0375000
NODE_7226_length_970_cov_26.040184	266	346	4	17	80	0.2125000
NODE_7226_length_970_cov_26.040184	319	399	0	7	80	0.0875000
NODE_7226_length_970_cov_26.040184	319	399	2	3	80	0.0375000
NODE_7226_length_970_cov_26.040184	319	399	4	70	80	0.8750000
NODE_7226_length_970_cov_26.040184	395	475	4	80	80	1.0000000
NODE_7226_length_970_cov_26.040184	448	528	0	49	80	0.6125000
NODE_7226_length_970_cov_26.040184	448	528	2	3	80	0.0375000
NODE_7226_length_970_cov_26.040184	448	528	4	28	80	0.3500000
NODE_7227_length_970_cov_19.291619	415	495	0	80	80	1.0000000
NODE_7227_length_970_cov_19.291619	468	548	0	80	80	1.0000000
NODE_7228_length_970_cov_17.731343	557	637	0	80	80	1.0000000
NODE_7228_length_970_cov_17.731343	610	690	0	80	80	1.0000000
NODE_7229_length_970_cov_15.135476	407	487	0	80	80	1.0000000
NODE_7229_length_970_cov_15.135476	460	540	0	80	80	1.0000000
NODE_7230_length_970_cov_12.675086	534	614	0	80	80	1.0000000
NODE_7230_length_970_cov_12.675086	587	667	0	80	80	1.0000000
NODE_7231_length_970_cov_8.095293	487	567	0	80	80	1.0000000
NODE_7231_length_970_cov_8.095293	540	620	0	80	80	1.0000000
NODE_7233_length_970_cov_7.127440	336	416	0	80	80	1.0000000
NODE_7233_length_970_cov_7.127440	389	469	0	80	80	1.0000000
NODE_7234_length_970_cov_5.824340	0	56	0	56	56	1.0000000
NODE_7246_length_969_cov_47.172414	419	499	0	72	80	0.9000000
NODE_7246_length_969_cov_47.172414	419	499	4	8	80	0.1000000
NODE_7246_length_969_cov_47.172414	472	552	0	80	80	1.0000000
NODE_7247_length_969_cov_28.234483	327	407	0	80	80	1.0000000
NODE_7247_length_969_cov_28.234483	380	460	0	80	80	1.0000000
NODE_7248_length_969_cov_27.131034	392	472	6	80	80	1.0000000
NODE_7248_length_969_cov_27.131034	445	525	0	43	80	0.5375000
NODE_7248_length_969_cov_27.131034	445	525	6	37	80	0.4625000
NODE_7249_length_969_cov_26.345977	466	542	0	76	76	1.0000000
NODE_7249_length_969_cov_26.345977	515	595	0	80	80	1.0000000
NODE_7250_length_969_cov_18.954023	274	354	0	80	80	1.0000000
NODE_7250_length_969_cov_18.954023	327	407	0	80	80	1.0000000
NODE_7251_length_969_cov_17.952874	410	490	0	3	80	0.0375000
NODE_7251_length_969_cov_17.952874	410	490	2	77	80	0.9625000
NODE_7251_length_969_cov_17.952874	463	543	2	80	80	1.0000000
NODE_7251_length_969_cov_17.952874	693	773	0	26	80	0.3250000
NODE_7251_length_969_cov_17.952874	693	773	8	35	80	0.4375000
NODE_7251_length_969_cov_17.952874	693	773	10	19	80	0.2375000
NODE_7251_length_969_cov_17.952874	746	826	4	19	80	0.2375000
NODE_7251_length_969_cov_17.952874	746	826	8	8	80	0.1000000
NODE_7251_length_969_cov_17.952874	746	826	10	42	80	0.5250000
NODE_7251_length_969_cov_17.952874	746	826	12	11	80	0.1375000
NODE_7252_length_969_cov_15.942529	446	526	0	40	80	0.5000000
NODE_7252_length_969_cov_15.942529	446	526	2	40	80	0.5000000
NODE_7252_length_969_cov_15.942529	499	579	0	80	80	1.0000000
NODE_7253_length_969_cov_9.926437	573	653	0	46	80	0.5750000
NODE_7253_length_969_cov_9.926437	573	653	4	34	80	0.4250000
NODE_7253_length_969_cov_9.926437	626	706	0	9	80	0.1125000
NODE_7253_length_969_cov_9.926437	626	706	4	71	80	0.8875000
NODE_7265_length_968_cov_59.162255	376	456	0	80	80	1.0000000
NODE_7265_length_968_cov_59.162255	429	509	0	74	80	0.9250000
NODE_7265_length_968_cov_59.162255	429	509	12	6	80	0.0750000
NODE_7265_length_968_cov_59.162255	505	585	12	25	80	0.3125000
NODE_7265_length_968_cov_59.162255	505	585	13	55	80	0.6875000
NODE_7265_length_968_cov_59.162255	558	638	2	3	80	0.0375000
NODE_7265_length_968_cov_59.162255	558	638	13	37	80	0.4625000
NODE_7265_length_968_cov_59.162255	558	638	15	3	80	0.0375000
NODE_7265_length_968_cov_59.162255	558	638	16	37	80	0.4625000
NODE_7266_length_968_cov_40.005754	514	594	0	80	80	1.0000000
NODE_7266_length_968_cov_40.005754	567	647	0	80	80	1.0000000
NODE_7267_length_968_cov_36.521289	450	530	0	80	80	1.0000000
NODE_7267_length_968_cov_36.521289	503	583	0	80	80	1.0000000
NODE_7268_length_968_cov_34.799770	474	554	0	80	80	1.0000000
NODE_7268_length_968_cov_34.799770	527	607	0	80	80	1.0000000
NODE_7269_length_968_cov_26.929804	293	372	0	79	79	1.0000000
NODE_7269_length_968_cov_26.929804	345	425	0	62	80	0.7750000
NODE_7269_length_968_cov_26.929804	345	425	1	18	80	0.2250000
NODE_7269_length_968_cov_26.929804	421	501	1	54	80	0.6750000
NODE_7269_length_968_cov_26.929804	421	501	2	26	80	0.3250000
NODE_7269_length_968_cov_26.929804	474	554	1	1	80	0.0125000
NODE_7269_length_968_cov_26.929804	474	554	2	79	80	0.9875000
NODE_7270_length_968_cov_24.468354	434	514	0	80	80	1.0000000
NODE_7270_length_968_cov_24.468354	487	567	0	80	80	1.0000000
NODE_7271_length_968_cov_23.204833	344	424	0	80	80	1.0000000
NODE_7271_length_968_cov_23.204833	397	477	0	80	80	1.0000000
NODE_7271_length_968_cov_23.204833	473	553	0	80	80	1.0000000
NODE_7271_length_968_cov_23.204833	526	606	0	80	80	1.0000000
NODE_7272_length_968_cov_22.321059	417	497	0	26	80	0.3250000
NODE_7272_length_968_cov_22.321059	417	497	2	54	80	0.6750000
NODE_7272_length_968_cov_22.321059	470	550	0	35	80	0.4375000
NODE_7272_length_968_cov_22.321059	470	550	2	45	80	0.5625000
NODE_7273_length_968_cov_20.897583	313	393	0	15	80	0.1875000
NODE_7273_length_968_cov_20.897583	313	393	2	65	80	0.8125000
NODE_7273_length_968_cov_20.897583	366	446	0	24	80	0.3000000
NODE_7273_length_968_cov_20.897583	366	446	2	56	80	0.7000000
NODE_7274_length_968_cov_19.296893	401	481	0	80	80	1.0000000
NODE_7274_length_968_cov_19.296893	454	534	0	80	80	1.0000000
NODE_7275_length_968_cov_18.100115	573	653	0	80	80	1.0000000
NODE_7275_length_968_cov_18.100115	626	706	0	80	80	1.0000000
NODE_7276_length_968_cov_15.576525	472	552	0	80	80	1.0000000
NODE_7276_length_968_cov_15.576525	525	605	0	80	80	1.0000000
NODE_7277_length_968_cov_15.024166	329	409	0	80	80	1.0000000
NODE_7277_length_968_cov_15.024166	382	462	0	80	80	1.0000000
NODE_7277_length_968_cov_15.024166	458	538	0	80	80	1.0000000
NODE_7277_length_968_cov_15.024166	511	591	0	80	80	1.0000000
NODE_7278_length_968_cov_13.911392	674	754	0	32	80	0.4000000
NODE_7278_length_968_cov_13.911392	674	754	2	48	80	0.6000000
NODE_7278_length_968_cov_13.911392	727	807	0	80	80	1.0000000
NODE_7279_length_968_cov_11.698504	598	678	0	80	80	1.0000000
NODE_7279_length_968_cov_11.698504	651	731	0	80	80	1.0000000
NODE_7280_length_968_cov_6.490219	538	618	0	80	80	1.0000000
NODE_7280_length_968_cov_6.490219	591	671	0	80	80	1.0000000
NODE_7294_length_967_cov_25.572581	332	412	0	80	80	1.0000000
NODE_7294_length_967_cov_25.572581	385	465	0	80	80	1.0000000
NODE_7295_length_967_cov_24.919355	396	476	0	80	80	1.0000000
NODE_7295_length_967_cov_24.919355	449	529	0	80	80	1.0000000
NODE_7296_length_967_cov_19.137097	374	454	0	80	80	1.0000000
NODE_7296_length_967_cov_19.137097	427	507	0	80	80	1.0000000
NODE_7296_length_967_cov_19.137097	503	583	0	80	80	1.0000000
NODE_7296_length_967_cov_19.137097	556	636	0	80	80	1.0000000
NODE_7297_length_967_cov_14.654378	453	533	0	80	80	1.0000000
NODE_7297_length_967_cov_14.654378	506	586	0	80	80	1.0000000
NODE_7298_length_967_cov_8.027650	280	360	0	80	80	1.0000000
NODE_7298_length_967_cov_8.027650	333	413	0	80	80	1.0000000
NODE_7310_length_966_cov_43.154556	401	474	9	73	73	1.0000000
NODE_7310_length_966_cov_43.154556	447	527	0	20	80	0.2500000
NODE_7310_length_966_cov_43.154556	447	527	9	60	80	0.7500000
NODE_7311_length_966_cov_42.877739	477	557	0	80	80	1.0000000
NODE_7311_length_966_cov_42.877739	530	610	0	80	80	1.0000000
NODE_7312_length_966_cov_39.956171	283	363	0	80	80	1.0000000
NODE_7312_length_966_cov_39.956171	336	416	0	80	80	1.0000000
NODE_7312_length_966_cov_39.956171	412	494	0	82	82	1.0000000
NODE_7312_length_966_cov_39.956171	467	547	0	80	80	1.0000000
NODE_7313_length_966_cov_36.160323	461	541	0	80	80	1.0000000
NODE_7313_length_966_cov_36.160323	461	541	0	80	80	1.0000000
NODE_7313_length_966_cov_36.160323	514	594	0	80	80	1.0000000
NODE_7314_length_966_cov_18.658593	408	488	0	41	80	0.5125000
NODE_7314_length_966_cov_18.658593	408	488	2	39	80	0.4875000
NODE_7314_length_966_cov_18.658593	461	541	0	80	80	1.0000000
NODE_7315_length_966_cov_17.606690	341	421	0	80	80	1.0000000
NODE_7315_length_966_cov_17.606690	394	474	0	80	80	1.0000000
NODE_7316_length_966_cov_16.064591	296	376	0	76	80	0.9500000
NODE_7316_length_966_cov_16.064591	296	376	12	4	80	0.0500000
NODE_7316_length_966_cov_16.064591	349	429	0	80	80	1.0000000
NODE_7317_length_966_cov_15.155709	562	642	0	80	80	1.0000000
NODE_7317_length_966_cov_15.155709	615	695	0	80	80	1.0000000
NODE_7318_length_966_cov_7.726644	280	360	0	21	80	0.2625000
NODE_7318_length_966_cov_7.726644	280	360	1	8	80	0.1000000
NODE_7318_length_966_cov_7.726644	280	360	2	51	80	0.6375000
NODE_7318_length_966_cov_7.726644	334	414	2	80	80	1.0000000
NODE_7335_length_965_cov_51.524249	197	277	0	80	80	1.0000000
NODE_7335_length_965_cov_51.524249	250	327	0	77	77	1.0000000
NODE_7335_length_965_cov_51.524249	329	406	0	77	77	1.0000000
NODE_7335_length_965_cov_51.524249	379	459	0	80	80	1.0000000
NODE_7336_length_965_cov_18.072748	515	595	0	80	80	1.0000000
NODE_7336_length_965_cov_18.072748	568	648	0	80	80	1.0000000
NODE_7337_length_965_cov_14.277136	342	422	0	80	80	1.0000000
NODE_7337_length_965_cov_14.277136	395	470	0	57	75	0.7600000
NODE_7337_length_965_cov_14.277136	395	470	8	18	75	0.2400000
NODE_7338_length_965_cov_7.808314	567	647	2	80	80	1.0000000
NODE_7338_length_965_cov_7.808314	620	700	0	39	80	0.4875000
NODE_7338_length_965_cov_7.808314	620	700	2	41	80	0.5125000
NODE_7344_length_964_cov_60.153757	197	277	4	25	80	0.3125000
NODE_7344_length_964_cov_60.153757	197	277	8	2	80	0.0250000
NODE_7344_length_964_cov_60.153757	197	277	12	7	80	0.0875000
NODE_7344_length_964_cov_60.153757	197	277	13	4	80	0.0500000
NODE_7344_length_964_cov_60.153757	197	277	15	3	80	0.0375000
NODE_7344_length_964_cov_60.153757	197	277	17	1	80	0.0125000
NODE_7344_length_964_cov_60.153757	197	277	18	7	80	0.0875000
NODE_7344_length_964_cov_60.153757	197	277	20	7	80	0.0875000
NODE_7344_length_964_cov_60.153757	197	277	21	6	80	0.0750000
NODE_7344_length_964_cov_60.153757	197	277	23	4	80	0.0500000
NODE_7344_length_964_cov_60.153757	197	277	25	3	80	0.0375000
NODE_7344_length_964_cov_60.153757	197	277	28	1	80	0.0125000
NODE_7344_length_964_cov_60.153757	197	277	30	1	80	0.0125000
NODE_7344_length_964_cov_60.153757	197	277	31	2	80	0.0250000
NODE_7344_length_964_cov_60.153757	197	277	33	7	80	0.0875000
NODE_7344_length_964_cov_60.153757	250	314	0	1	64	0.0156250
NODE_7344_length_964_cov_60.153757	250	314	2	35	64	0.5468750
NODE_7344_length_964_cov_60.153757	250	314	4	26	64	0.4062500
NODE_7344_length_964_cov_60.153757	250	314	8	2	64	0.0312500
NODE_7344_length_964_cov_60.153757	672	752	0	72	80	0.9000000
NODE_7344_length_964_cov_60.153757	672	752	2	8	80	0.1000000
NODE_7344_length_964_cov_60.153757	725	805	0	80	80	1.0000000
NODE_7345_length_964_cov_45.564162	314	394	1	14	80	0.1750000
NODE_7345_length_964_cov_45.564162	314	394	2	66	80	0.8250000
NODE_7345_length_964_cov_45.564162	367	447	1	67	80	0.8375000
NODE_7345_length_964_cov_45.564162	367	447	2	13	80	0.1625000
NODE_7345_length_964_cov_45.564162	443	523	0	27	80	0.3375000
NODE_7345_length_964_cov_45.564162	443	523	1	8	80	0.1000000
NODE_7345_length_964_cov_45.564162	443	523	2	45	80	0.5625000
NODE_7345_length_964_cov_45.564162	496	566	2	70	70	1.0000000
NODE_7346_length_964_cov_33.487861	363	443	0	80	80	1.0000000
NODE_7346_length_964_cov_33.487861	416	496	0	80	80	1.0000000
NODE_7347_length_964_cov_33.077457	408	488	0	80	80	1.0000000
NODE_7347_length_964_cov_33.077457	461	541	0	80	80	1.0000000
NODE_7347_length_964_cov_33.077457	537	617	0	80	80	1.0000000
NODE_7347_length_964_cov_33.077457	590	670	0	80	80	1.0000000
NODE_7348_length_964_cov_29.250867	419	499	10	80	80	1.0000000
NODE_7348_length_964_cov_29.250867	472	552	0	27	80	0.3375000
NODE_7348_length_964_cov_29.250867	472	552	8	1	80	0.0125000
NODE_7348_length_964_cov_29.250867	472	552	9	8	80	0.1000000
NODE_7348_length_964_cov_29.250867	472	552	10	44	80	0.5500000
NODE_7349_length_964_cov_20.191908	228	301	0	73	73	1.0000000
NODE_7349_length_964_cov_20.191908	349	429	0	80	80	1.0000000
NODE_7349_length_964_cov_20.191908	402	482	0	80	80	1.0000000
NODE_7350_length_964_cov_18.510983	486	566	0	7	80	0.0875000
NODE_7350_length_964_cov_18.510983	486	566	6	73	80	0.9125000
NODE_7350_length_964_cov_18.510983	539	619	0	26	80	0.3250000
NODE_7350_length_964_cov_18.510983	539	619	5	1	80	0.0125000
NODE_7350_length_964_cov_18.510983	539	619	6	53	80	0.6625000
NODE_7351_length_964_cov_16.613873	464	544	0	80	80	1.0000000
NODE_7351_length_964_cov_16.613873	517	597	0	80	80	1.0000000
NODE_7352_length_964_cov_15.717919	411	491	0	80	80	1.0000000
NODE_7352_length_964_cov_15.717919	464	544	0	80	80	1.0000000
NODE_7352_length_964_cov_15.717919	540	620	0	80	80	1.0000000
NODE_7352_length_964_cov_15.717919	593	668	0	75	75	1.0000000
NODE_7353_length_964_cov_14.591908	521	601	0	80	80	1.0000000
NODE_7353_length_964_cov_14.591908	574	654	0	80	80	1.0000000
NODE_7354_length_964_cov_11.589595	475	555	0	80	80	1.0000000
NODE_7354_length_964_cov_11.589595	528	608	0	80	80	1.0000000
NODE_7355_length_964_cov_7.639306	420	500	0	80	80	1.0000000
NODE_7355_length_964_cov_7.639306	473	553	0	80	80	1.0000000
NODE_7356_length_964_cov_7.596532	534	614	0	80	80	1.0000000
NODE_7356_length_964_cov_7.596532	587	667	0	80	80	1.0000000
NODE_7357_length_964_cov_6.568786	368	448	0	80	80	1.0000000
NODE_7357_length_964_cov_6.568786	421	501	0	80	80	1.0000000
NODE_7359_length_964_cov_6.027746	890	940	22	33	50	0.6600000
NODE_7359_length_964_cov_6.027746	890	940	24	8	50	0.1600000
NODE_7359_length_964_cov_6.027746	890	940	26	9	50	0.1800000
NODE_7361_length_964_cov_4.665896	706	772	0	66	66	1.0000000
NODE_7376_length_963_cov_66.251157	456	536	0	15	80	0.1875000
NODE_7376_length_963_cov_66.251157	456	536	6	65	80	0.8125000
NODE_7376_length_963_cov_66.251157	509	589	0	68	80	0.8500000
NODE_7376_length_963_cov_66.251157	509	589	6	12	80	0.1500000
NODE_7376_length_963_cov_66.251157	585	665	0	80	80	1.0000000
NODE_7376_length_963_cov_66.251157	638	718	0	80	80	1.0000000
NODE_7377_length_963_cov_35.638889	381	461	0	80	80	1.0000000
NODE_7377_length_963_cov_35.638889	434	514	0	59	80	0.7375000
NODE_7377_length_963_cov_35.638889	434	514	2	21	80	0.2625000
NODE_7377_length_963_cov_35.638889	510	590	0	47	80	0.5875000
NODE_7377_length_963_cov_35.638889	510	590	2	33	80	0.4125000
NODE_7377_length_963_cov_35.638889	563	643	0	80	80	1.0000000
NODE_7378_length_963_cov_33.642361	347	427	0	80	80	1.0000000
NODE_7378_length_963_cov_33.642361	400	480	0	80	80	1.0000000
NODE_7379_length_963_cov_18.626157	392	472	0	80	80	1.0000000
NODE_7379_length_963_cov_18.626157	445	525	0	80	80	1.0000000
NODE_7380_length_963_cov_17.750000	402	482	0	80	80	1.0000000
NODE_7380_length_963_cov_17.750000	455	535	0	80	80	1.0000000
NODE_7381_length_963_cov_17.023148	542	622	0	75	80	0.9375000
NODE_7381_length_963_cov_17.023148	542	622	1	5	80	0.0625000
NODE_7381_length_963_cov_17.023148	595	675	0	80	80	1.0000000
NODE_7382_length_963_cov_16.642361	481	561	0	5	80	0.0625000
NODE_7382_length_963_cov_16.642361	481	561	13	75	80	0.9375000
NODE_7382_length_963_cov_16.642361	534	614	0	33	80	0.4125000
NODE_7382_length_963_cov_16.642361	534	614	13	47	80	0.5875000
NODE_7382_length_963_cov_16.642361	572	629	0	48	57	0.8421053
NODE_7382_length_963_cov_16.642361	572	629	13	9	57	0.1578947
NODE_7383_length_963_cov_14.961806	283	363	0	80	80	1.0000000
NODE_7383_length_963_cov_14.961806	336	416	0	80	80	1.0000000
NODE_7384_length_963_cov_13.341435	558	638	0	80	80	1.0000000
NODE_7384_length_963_cov_13.341435	611	691	0	80	80	1.0000000
NODE_7386_length_963_cov_9.520833	459	539	0	80	80	1.0000000
NODE_7386_length_963_cov_9.520833	512	592	0	80	80	1.0000000
NODE_7386_length_963_cov_9.520833	588	662	0	74	74	1.0000000
NODE_7386_length_963_cov_9.520833	641	724	0	83	83	1.0000000
NODE_7388_length_963_cov_7.510417	781	842	5	4	61	0.0655738
NODE_7388_length_963_cov_7.510417	781	842	8	8	61	0.1311475
NODE_7388_length_963_cov_7.510417	781	842	14	6	61	0.0983607
NODE_7388_length_963_cov_7.510417	781	842	28	1	61	0.0163934
NODE_7388_length_963_cov_7.510417	781	842	29	4	61	0.0655738
NODE_7388_length_963_cov_7.510417	781	842	33	13	61	0.2131148
NODE_7388_length_963_cov_7.510417	781	842	34	5	61	0.0819672
NODE_7388_length_963_cov_7.510417	781	842	37	1	61	0.0163934
NODE_7388_length_963_cov_7.510417	781	842	38	1	61	0.0163934
NODE_7388_length_963_cov_7.510417	781	842	42	18	61	0.2950820
NODE_7388_length_963_cov_7.510417	815	894	33	2	79	0.0253165
NODE_7388_length_963_cov_7.510417	815	894	34	5	79	0.0632911
NODE_7388_length_963_cov_7.510417	815	894	37	1	79	0.0126582
NODE_7388_length_963_cov_7.510417	815	894	38	2	79	0.0253165
NODE_7388_length_963_cov_7.510417	815	894	42	69	79	0.8734177
NODE_7392_length_963_cov_3.755787	378	458	0	80	80	1.0000000
NODE_7392_length_963_cov_3.755787	431	511	0	80	80	1.0000000
NODE_7397_length_963_cov_1.931713	426	485	0	59	59	1.0000000
NODE_7404_length_962_cov_37.169177	356	436	0	80	80	1.0000000
NODE_7404_length_962_cov_37.169177	409	489	0	80	80	1.0000000
NODE_7405_length_962_cov_28.852839	474	554	0	80	80	1.0000000
NODE_7405_length_962_cov_28.852839	527	607	0	80	80	1.0000000
NODE_7405_length_962_cov_28.852839	603	683	0	75	80	0.9375000
NODE_7405_length_962_cov_28.852839	603	683	8	5	80	0.0625000
NODE_7405_length_962_cov_28.852839	656	736	0	22	80	0.2750000
NODE_7405_length_962_cov_28.852839	656	736	8	58	80	0.7250000
NODE_7406_length_962_cov_27.859791	441	521	0	20	80	0.2500000
NODE_7406_length_962_cov_27.859791	441	521	5	25	80	0.3125000
NODE_7406_length_962_cov_27.859791	441	521	6	35	80	0.4375000
NODE_7406_length_962_cov_27.859791	494	574	0	31	80	0.3875000
NODE_7406_length_962_cov_27.859791	494	574	5	47	80	0.5875000
NODE_7406_length_962_cov_27.859791	494	574	6	2	80	0.0250000
NODE_7407_length_962_cov_21.019699	318	398	0	80	80	1.0000000
NODE_7407_length_962_cov_21.019699	371	451	0	80	80	1.0000000
NODE_7408_length_962_cov_16.792584	350	430	0	80	80	1.0000000
NODE_7408_length_962_cov_16.792584	403	483	0	80	80	1.0000000
NODE_7409_length_962_cov_14.650058	477	557	0	80	80	1.0000000
NODE_7409_length_962_cov_14.650058	530	610	0	80	80	1.0000000
NODE_7410_length_962_cov_7.993048	308	345	0	37	37	1.0000000
NODE_7411_length_962_cov_7.835458	447	527	0	37	80	0.4625000
NODE_7411_length_962_cov_7.835458	447	527	2	43	80	0.5375000
NODE_7411_length_962_cov_7.835458	500	580	0	8	80	0.1000000
NODE_7411_length_962_cov_7.835458	500	580	2	72	80	0.9000000
NODE_7412_length_962_cov_6.855156	490	570	0	80	80	1.0000000
NODE_7412_length_962_cov_6.855156	543	623	0	80	80	1.0000000
NODE_7417_length_962_cov_1.840093	88	151	0	1	63	0.0158730
NODE_7417_length_962_cov_1.840093	88	151	2	1	63	0.0158730
NODE_7417_length_962_cov_1.840093	88	151	4	1	63	0.0158730
NODE_7417_length_962_cov_1.840093	88	151	8	1	63	0.0158730
NODE_7417_length_962_cov_1.840093	88	151	10	1	63	0.0158730
NODE_7417_length_962_cov_1.840093	88	151	12	7	63	0.1111111
NODE_7417_length_962_cov_1.840093	88	151	14	1	63	0.0158730
NODE_7417_length_962_cov_1.840093	88	151	16	22	63	0.3492064
NODE_7417_length_962_cov_1.840093	88	151	18	2	63	0.0317460
NODE_7417_length_962_cov_1.840093	88	151	20	3	63	0.0476190
NODE_7417_length_962_cov_1.840093	88	151	24	1	63	0.0158730
NODE_7417_length_962_cov_1.840093	88	151	28	6	63	0.0952381
NODE_7417_length_962_cov_1.840093	88	151	32	11	63	0.1746032
NODE_7417_length_962_cov_1.840093	88	151	34	5	63	0.0793651
NODE_7422_length_961_cov_61.019722	453	533	0	80	80	1.0000000
NODE_7422_length_961_cov_61.019722	506	586	0	80	80	1.0000000
NODE_7422_length_961_cov_61.019722	614	672	0	58	58	1.0000000
NODE_7423_length_961_cov_51.005800	334	414	0	44	80	0.5500000
NODE_7423_length_961_cov_51.005800	334	414	1	14	80	0.1750000
NODE_7423_length_961_cov_51.005800	334	414	2	22	80	0.2750000
NODE_7423_length_961_cov_51.005800	387	467	1	5	80	0.0625000
NODE_7423_length_961_cov_51.005800	387	467	2	75	80	0.9375000
NODE_7424_length_961_cov_45.923434	391	471	0	80	80	1.0000000
NODE_7424_length_961_cov_45.923434	444	524	0	80	80	1.0000000
NODE_7426_length_961_cov_21.410673	313	393	6	23	80	0.2875000
NODE_7426_length_961_cov_21.410673	313	393	19	50	80	0.6250000
NODE_7426_length_961_cov_21.410673	313	393	20	7	80	0.0875000
NODE_7426_length_961_cov_21.410673	366	446	14	22	80	0.2750000
NODE_7426_length_961_cov_21.410673	366	446	18	1	80	0.0125000
NODE_7426_length_961_cov_21.410673	366	446	19	20	80	0.2500000
NODE_7426_length_961_cov_21.410673	366	446	20	37	80	0.4625000
NODE_7427_length_961_cov_18.592807	403	483	0	80	80	1.0000000
NODE_7427_length_961_cov_18.592807	456	536	0	80	80	1.0000000
NODE_7428_length_961_cov_17.701856	433	513	0	80	80	1.0000000
NODE_7428_length_961_cov_17.701856	486	566	0	80	80	1.0000000
NODE_7429_length_961_cov_17.020882	505	585	0	80	80	1.0000000
NODE_7429_length_961_cov_17.020882	558	638	0	80	80	1.0000000
NODE_7430_length_961_cov_16.235499	328	408	0	80	80	1.0000000
NODE_7430_length_961_cov_16.235499	381	461	0	80	80	1.0000000
NODE_7432_length_961_cov_12.968677	347	427	0	80	80	1.0000000
NODE_7432_length_961_cov_12.968677	400	480	0	80	80	1.0000000
NODE_7433_length_961_cov_9.875870	439	519	0	80	80	1.0000000
NODE_7433_length_961_cov_9.875870	492	572	0	80	80	1.0000000
NODE_7434_length_961_cov_6.172854	624	704	0	80	80	1.0000000
NODE_7434_length_961_cov_6.172854	677	757	0	80	80	1.0000000
NODE_7435_length_961_cov_4.553364	451	531	0	80	80	1.0000000
NODE_7435_length_961_cov_4.553364	504	584	0	80	80	1.0000000
NODE_7440_length_960_cov_35.649245	65	145	0	80	80	1.0000000
NODE_7440_length_960_cov_35.649245	118	198	0	80	80	1.0000000
NODE_7440_length_960_cov_35.649245	446	526	0	23	80	0.2875000
NODE_7440_length_960_cov_35.649245	446	526	3	1	80	0.0125000
NODE_7440_length_960_cov_35.649245	446	526	4	56	80	0.7000000
NODE_7440_length_960_cov_35.649245	499	579	4	37	80	0.4625000
NODE_7440_length_960_cov_35.649245	499	579	6	43	80	0.5375000
NODE_7441_length_960_cov_34.886179	386	466	0	80	80	1.0000000
NODE_7441_length_960_cov_34.886179	439	519	0	80	80	1.0000000
NODE_7443_length_960_cov_25.133566	413	493	0	80	80	1.0000000
NODE_7443_length_960_cov_25.133566	466	546	0	80	80	1.0000000
NODE_7444_length_960_cov_19.336818	385	465	0	80	80	1.0000000
NODE_7444_length_960_cov_19.336818	438	518	0	80	80	1.0000000
NODE_7445_length_960_cov_13.221835	460	539	0	79	79	1.0000000
NODE_7445_length_960_cov_13.221835	512	592	0	80	80	1.0000000
NODE_7446_length_960_cov_12.804878	347	427	0	80	80	1.0000000
NODE_7446_length_960_cov_12.804878	400	480	0	80	80	1.0000000
NODE_7462_length_959_cov_39.394186	326	406	0	51	80	0.6375000
NODE_7462_length_959_cov_39.394186	326	406	4	29	80	0.3625000
NODE_7462_length_959_cov_39.394186	379	459	0	5	80	0.0625000
NODE_7462_length_959_cov_39.394186	379	459	4	75	80	0.9375000
NODE_7463_length_959_cov_28.895349	327	407	0	80	80	1.0000000
NODE_7463_length_959_cov_28.895349	380	460	0	80	80	1.0000000
NODE_7464_length_959_cov_26.634884	563	643	0	5	80	0.0625000
NODE_7464_length_959_cov_26.634884	563	643	4	30	80	0.3750000
NODE_7464_length_959_cov_26.634884	563	643	6	45	80	0.5625000
NODE_7464_length_959_cov_26.634884	616	696	0	33	80	0.4125000
NODE_7464_length_959_cov_26.634884	616	696	2	2	80	0.0250000
NODE_7464_length_959_cov_26.634884	616	696	6	45	80	0.5625000
NODE_7464_length_959_cov_26.634884	692	772	0	44	80	0.5500000
NODE_7464_length_959_cov_26.634884	692	772	2	3	80	0.0375000
NODE_7464_length_959_cov_26.634884	692	772	4	33	80	0.4125000
NODE_7464_length_959_cov_26.634884	745	825	0	11	80	0.1375000
NODE_7464_length_959_cov_26.634884	745	825	2	7	80	0.0875000
NODE_7464_length_959_cov_26.634884	745	825	4	62	80	0.7750000
NODE_7465_length_959_cov_18.862791	320	400	0	11	80	0.1375000
NODE_7465_length_959_cov_18.862791	320	400	2	69	80	0.8625000
NODE_7465_length_959_cov_18.862791	373	453	0	64	80	0.8000000
NODE_7465_length_959_cov_18.862791	373	453	2	16	80	0.2000000
NODE_7466_length_959_cov_17.910465	358	438	0	80	80	1.0000000
NODE_7466_length_959_cov_17.910465	411	491	0	80	80	1.0000000
NODE_7467_length_959_cov_15.337209	267	347	0	80	80	1.0000000
NODE_7467_length_959_cov_15.337209	320	400	0	80	80	1.0000000
NODE_7468_length_959_cov_9.005814	529	609	0	80	80	1.0000000
NODE_7468_length_959_cov_9.005814	582	662	0	80	80	1.0000000
NODE_7469_length_959_cov_8.163953	392	472	0	80	80	1.0000000
NODE_7469_length_959_cov_8.163953	445	525	0	80	80	1.0000000
NODE_7470_length_959_cov_7.097674	401	481	0	80	80	1.0000000
NODE_7470_length_959_cov_7.097674	454	534	0	80	80	1.0000000
NODE_7472_length_959_cov_4.603488	596	676	0	80	80	1.0000000
NODE_7472_length_959_cov_4.603488	649	729	0	80	80	1.0000000
NODE_7486_length_958_cov_57.015134	328	408	0	70	80	0.8750000
NODE_7486_length_958_cov_57.015134	328	408	2	10	80	0.1250000
NODE_7486_length_958_cov_57.015134	381	461	0	17	80	0.2125000
NODE_7486_length_958_cov_57.015134	381	461	2	12	80	0.1500000
NODE_7486_length_958_cov_57.015134	381	461	4	51	80	0.6375000
NODE_7486_length_958_cov_57.015134	457	537	0	37	80	0.4625000
NODE_7486_length_958_cov_57.015134	457	537	2	27	80	0.3375000
NODE_7486_length_958_cov_57.015134	457	537	4	16	80	0.2000000
NODE_7486_length_958_cov_57.015134	510	590	0	80	80	1.0000000
NODE_7487_length_958_cov_42.265425	418	498	0	80	80	1.0000000
NODE_7487_length_958_cov_42.265425	471	551	0	80	80	1.0000000
NODE_7488_length_958_cov_28.618161	336	416	0	35	80	0.4375000
NODE_7488_length_958_cov_28.618161	336	416	4	45	80	0.5625000
NODE_7488_length_958_cov_28.618161	389	469	0	80	80	1.0000000
NODE_7488_length_958_cov_28.618161	465	545	0	80	80	1.0000000
NODE_7488_length_958_cov_28.618161	518	598	0	80	80	1.0000000
NODE_7489_length_958_cov_16.452852	446	526	0	80	80	1.0000000
NODE_7489_length_958_cov_16.452852	499	579	0	80	80	1.0000000
NODE_7490_length_958_cov_16.008149	446	526	0	80	80	1.0000000
NODE_7490_length_958_cov_16.008149	499	579	0	80	80	1.0000000
NODE_7491_length_958_cov_14.154831	516	596	0	80	80	1.0000000
NODE_7491_length_958_cov_14.154831	569	649	0	80	80	1.0000000
NODE_7492_length_958_cov_12.381839	454	534	0	80	80	1.0000000
NODE_7492_length_958_cov_12.381839	507	587	0	80	80	1.0000000
NODE_7493_length_958_cov_11.782305	479	559	0	80	80	1.0000000
NODE_7493_length_958_cov_11.782305	532	612	0	80	80	1.0000000
NODE_7501_length_957_cov_40.837995	746	826	0	34	80	0.4250000
NODE_7501_length_957_cov_40.837995	746	826	2	46	80	0.5750000
NODE_7501_length_957_cov_40.837995	799	879	0	16	80	0.2000000
NODE_7501_length_957_cov_40.837995	799	879	2	64	80	0.8000000
NODE_7502_length_957_cov_25.976690	631	711	0	80	80	1.0000000
NODE_7502_length_957_cov_25.976690	684	764	0	80	80	1.0000000
NODE_7503_length_957_cov_25.855478	57	131	6	3	74	0.0405405
NODE_7503_length_957_cov_25.855478	57	131	8	2	74	0.0270270
NODE_7503_length_957_cov_25.855478	57	131	10	1	74	0.0135135
NODE_7503_length_957_cov_25.855478	57	131	14	1	74	0.0135135
NODE_7503_length_957_cov_25.855478	57	131	16	2	74	0.0270270
NODE_7503_length_957_cov_25.855478	57	131	17	2	74	0.0270270
NODE_7503_length_957_cov_25.855478	57	131	18	7	74	0.0945946
NODE_7503_length_957_cov_25.855478	57	131	20	4	74	0.0540541
NODE_7503_length_957_cov_25.855478	57	131	22	3	74	0.0405405
NODE_7503_length_957_cov_25.855478	57	131	26	1	74	0.0135135
NODE_7503_length_957_cov_25.855478	57	131	27	3	74	0.0405405
NODE_7503_length_957_cov_25.855478	57	131	28	45	74	0.6081081
NODE_7503_length_957_cov_25.855478	414	494	0	80	80	1.0000000
NODE_7503_length_957_cov_25.855478	467	547	0	80	80	1.0000000
NODE_7504_length_957_cov_24.625874	445	525	0	80	80	1.0000000
NODE_7504_length_957_cov_24.625874	498	578	0	80	80	1.0000000
NODE_7505_length_957_cov_19.955711	286	366	0	80	80	1.0000000
NODE_7505_length_957_cov_19.955711	339	419	0	80	80	1.0000000
NODE_7506_length_957_cov_18.861305	414	494	0	80	80	1.0000000
NODE_7506_length_957_cov_18.861305	467	547	0	80	80	1.0000000
NODE_7507_length_957_cov_17.356643	361	441	0	80	80	1.0000000
NODE_7507_length_957_cov_17.356643	414	494	0	80	80	1.0000000
NODE_7508_length_957_cov_13.569930	162	242	0	80	80	1.0000000
NODE_7508_length_957_cov_13.569930	215	299	0	84	84	1.0000000
NODE_7509_length_957_cov_12.334499	314	394	5	61	80	0.7625000
NODE_7509_length_957_cov_12.334499	314	394	6	19	80	0.2375000
NODE_7509_length_957_cov_12.334499	367	447	0	48	80	0.6000000
NODE_7509_length_957_cov_12.334499	367	447	5	32	80	0.4000000
NODE_7510_length_957_cov_12.017483	173	253	0	80	80	1.0000000
NODE_7510_length_957_cov_12.017483	226	306	0	44	80	0.5500000
NODE_7510_length_957_cov_12.017483	226	306	2	36	80	0.4500000
NODE_7511_length_957_cov_10.026807	446	526	0	80	80	1.0000000
NODE_7511_length_957_cov_10.026807	499	579	0	80	80	1.0000000
NODE_7529_length_956_cov_48.047841	479	559	0	80	80	1.0000000
NODE_7529_length_956_cov_48.047841	532	612	0	80	80	1.0000000
NODE_7529_length_956_cov_48.047841	608	688	0	48	80	0.6000000
NODE_7529_length_956_cov_48.047841	608	688	1	1	80	0.0125000
NODE_7529_length_956_cov_48.047841	608	688	4	21	80	0.2625000
NODE_7529_length_956_cov_48.047841	608	688	5	10	80	0.1250000
NODE_7529_length_956_cov_48.047841	661	741	4	17	80	0.2125000
NODE_7529_length_956_cov_48.047841	661	741	5	11	80	0.1375000
NODE_7529_length_956_cov_48.047841	661	741	6	36	80	0.4500000
NODE_7529_length_956_cov_48.047841	661	741	10	8	80	0.1000000
NODE_7529_length_956_cov_48.047841	661	741	15	1	80	0.0125000
NODE_7529_length_956_cov_48.047841	661	741	18	4	80	0.0500000
NODE_7529_length_956_cov_48.047841	661	741	22	3	80	0.0375000
NODE_7530_length_956_cov_34.539090	298	378	0	80	80	1.0000000
NODE_7530_length_956_cov_34.539090	351	431	0	80	80	1.0000000
NODE_7530_length_956_cov_34.539090	427	507	0	80	80	1.0000000
NODE_7530_length_956_cov_34.539090	480	560	0	80	80	1.0000000
NODE_7531_length_956_cov_24.355893	398	478	0	80	80	1.0000000
NODE_7531_length_956_cov_24.355893	451	531	0	80	80	1.0000000
NODE_7532_length_956_cov_21.940490	373	453	0	80	80	1.0000000
NODE_7532_length_956_cov_21.940490	426	506	0	80	80	1.0000000
NODE_7532_length_956_cov_21.940490	502	582	0	80	80	1.0000000
NODE_7532_length_956_cov_21.940490	555	635	0	80	80	1.0000000
NODE_7533_length_956_cov_19.435239	274	354	0	80	80	1.0000000
NODE_7533_length_956_cov_19.435239	274	301	0	27	27	1.0000000
NODE_7534_length_956_cov_17.819137	378	458	0	80	80	1.0000000
NODE_7534_length_956_cov_17.819137	431	511	0	80	80	1.0000000
NODE_7535_length_956_cov_16.098016	551	631	0	57	80	0.7125000
NODE_7535_length_956_cov_16.098016	551	631	6	23	80	0.2875000
NODE_7535_length_956_cov_16.098016	604	684	0	4	80	0.0500000
NODE_7535_length_956_cov_16.098016	604	684	6	76	80	0.9500000
NODE_7536_length_956_cov_15.229872	490	570	0	80	80	1.0000000
NODE_7536_length_956_cov_15.229872	543	623	0	80	80	1.0000000
NODE_7537_length_956_cov_7.533256	439	519	0	80	80	1.0000000
NODE_7537_length_956_cov_7.533256	497	572	0	75	75	1.0000000
NODE_7545_length_955_cov_30.821262	438	518	0	80	80	1.0000000
NODE_7545_length_955_cov_30.821262	491	571	0	80	80	1.0000000
NODE_7546_length_955_cov_30.574766	380	460	0	80	80	1.0000000
NODE_7546_length_955_cov_30.574766	433	513	0	80	80	1.0000000
NODE_7546_length_955_cov_30.574766	509	589	0	80	80	1.0000000
NODE_7546_length_955_cov_30.574766	562	642	0	80	80	1.0000000
NODE_7547_length_955_cov_27.734813	373	453	0	80	80	1.0000000
NODE_7547_length_955_cov_27.734813	426	506	0	80	80	1.0000000
NODE_7548_length_955_cov_24.475467	439	519	0	80	80	1.0000000
NODE_7548_length_955_cov_24.475467	492	572	0	80	80	1.0000000
NODE_7549_length_955_cov_22.146028	351	431	33	1	80	0.0125000
NODE_7549_length_955_cov_22.146028	351	431	34	37	80	0.4625000
NODE_7549_length_955_cov_22.146028	351	431	35	24	80	0.3000000
NODE_7549_length_955_cov_22.146028	351	431	37	18	80	0.2250000
NODE_7549_length_955_cov_22.146028	404	484	35	9	80	0.1125000
NODE_7549_length_955_cov_22.146028	404	484	37	32	80	0.4000000
NODE_7549_length_955_cov_22.146028	404	484	38	39	80	0.4875000
NODE_7550_length_955_cov_16.212617	441	521	0	80	80	1.0000000
NODE_7550_length_955_cov_16.212617	494	574	0	80	80	1.0000000
NODE_7551_length_955_cov_13.334112	269	349	0	80	80	1.0000000
NODE_7551_length_955_cov_13.334112	322	402	0	80	80	1.0000000
NODE_7552_length_955_cov_12.544393	363	443	0	80	80	1.0000000
NODE_7552_length_955_cov_12.544393	416	496	0	80	80	1.0000000
NODE_7553_length_955_cov_8.204439	358	438	2	80	80	1.0000000
NODE_7553_length_955_cov_8.204439	411	491	0	46	80	0.5750000
NODE_7553_length_955_cov_8.204439	411	491	2	34	80	0.4250000
NODE_7563_length_954_cov_35.691228	381	461	0	32	80	0.4000000
NODE_7563_length_954_cov_35.691228	381	461	2	48	80	0.6000000
NODE_7563_length_954_cov_35.691228	434	514	0	80	80	1.0000000
NODE_7564_length_954_cov_30.769591	408	488	0	17	80	0.2125000
NODE_7564_length_954_cov_30.769591	408	488	8	63	80	0.7875000
NODE_7564_length_954_cov_30.769591	461	541	0	25	80	0.3125000
NODE_7564_length_954_cov_30.769591	461	541	8	55	80	0.6875000
NODE_7565_length_954_cov_27.247953	418	498	0	13	80	0.1625000
NODE_7565_length_954_cov_27.247953	418	498	10	67	80	0.8375000
NODE_7565_length_954_cov_27.247953	471	551	10	74	80	0.9250000
NODE_7565_length_954_cov_27.247953	471	551	14	6	80	0.0750000
NODE_7566_length_954_cov_22.796491	270	350	0	80	80	1.0000000
NODE_7566_length_954_cov_22.796491	323	403	0	80	80	1.0000000
NODE_7567_length_954_cov_15.645614	337	417	0	80	80	1.0000000
NODE_7567_length_954_cov_15.645614	390	470	0	80	80	1.0000000
NODE_7568_length_954_cov_13.538012	346	426	0	40	80	0.5000000
NODE_7568_length_954_cov_13.538012	346	426	1	40	80	0.5000000
NODE_7568_length_954_cov_13.538012	399	479	1	74	80	0.9250000
NODE_7568_length_954_cov_13.538012	399	479	2	6	80	0.0750000
NODE_7569_length_954_cov_12.162573	155	217	0	62	62	1.0000000
NODE_7570_length_954_cov_10.714620	239	319	1	24	80	0.3000000
NODE_7570_length_954_cov_10.714620	239	319	6	5	80	0.0625000
NODE_7570_length_954_cov_10.714620	239	319	7	8	80	0.1000000
NODE_7570_length_954_cov_10.714620	239	319	8	43	80	0.5375000
NODE_7570_length_954_cov_10.714620	292	372	1	25	80	0.3125000
NODE_7570_length_954_cov_10.714620	292	372	7	11	80	0.1375000
NODE_7570_length_954_cov_10.714620	292	372	8	44	80	0.5500000
NODE_7571_length_954_cov_5.670175	431	511	0	80	80	1.0000000
NODE_7571_length_954_cov_5.670175	484	564	0	80	80	1.0000000
NODE_7582_length_953_cov_35.789227	425	505	0	80	80	1.0000000
NODE_7582_length_953_cov_35.789227	478	558	0	80	80	1.0000000
NODE_7583_length_953_cov_33.940281	430	510	0	80	80	1.0000000
NODE_7583_length_953_cov_33.940281	483	563	0	80	80	1.0000000
NODE_7584_length_953_cov_26.844262	333	413	0	80	80	1.0000000
NODE_7584_length_953_cov_26.844262	386	466	0	80	80	1.0000000
NODE_7584_length_953_cov_26.844262	462	542	0	80	80	1.0000000
NODE_7584_length_953_cov_26.844262	515	595	0	80	80	1.0000000
NODE_7585_length_953_cov_20.770492	301	381	0	80	80	1.0000000
NODE_7585_length_953_cov_20.770492	354	434	0	80	80	1.0000000
NODE_7586_length_953_cov_17.514052	421	501	0	80	80	1.0000000
NODE_7586_length_953_cov_17.514052	474	554	0	80	80	1.0000000
NODE_7586_length_953_cov_17.514052	550	630	0	80	80	1.0000000
NODE_7586_length_953_cov_17.514052	603	683	0	80	80	1.0000000
NODE_7587_length_953_cov_11.579625	332	412	0	80	80	1.0000000
NODE_7587_length_953_cov_11.579625	385	465	0	80	80	1.0000000
NODE_7588_length_953_cov_7.281030	276	356	0	80	80	1.0000000
NODE_7588_length_953_cov_7.281030	329	409	0	80	80	1.0000000
NODE_7599_length_952_cov_44.880422	447	527	0	20	80	0.2500000
NODE_7599_length_952_cov_44.880422	447	527	2	60	80	0.7500000
NODE_7599_length_952_cov_44.880422	500	580	0	73	80	0.9125000
NODE_7599_length_952_cov_44.880422	500	580	2	7	80	0.0875000
NODE_7599_length_952_cov_44.880422	871	951	0	80	80	1.0000000
NODE_7600_length_952_cov_42.485346	402	482	0	28	80	0.3500000
NODE_7600_length_952_cov_42.485346	402	482	10	4	80	0.0500000
NODE_7600_length_952_cov_42.485346	402	482	18	3	80	0.0375000
NODE_7600_length_952_cov_42.485346	402	482	19	45	80	0.5625000
NODE_7600_length_952_cov_42.485346	455	535	18	22	80	0.2750000
NODE_7600_length_952_cov_42.485346	455	535	19	24	80	0.3000000
NODE_7600_length_952_cov_42.485346	455	535	20	8	80	0.1000000
NODE_7600_length_952_cov_42.485346	455	535	21	26	80	0.3250000
NODE_7601_length_952_cov_40.065651	422	502	0	80	80	1.0000000
NODE_7601_length_952_cov_40.065651	475	555	0	80	80	1.0000000
NODE_7602_length_952_cov_34.813599	308	388	4	80	80	1.0000000
NODE_7602_length_952_cov_34.813599	361	441	0	31	80	0.3875000
NODE_7602_length_952_cov_34.813599	361	441	4	49	80	0.6125000
NODE_7603_length_952_cov_28.055100	661	741	4	35	80	0.4375000
NODE_7603_length_952_cov_28.055100	661	741	6	45	80	0.5625000
NODE_7603_length_952_cov_28.055100	714	794	0	45	80	0.5625000
NODE_7603_length_952_cov_28.055100	714	794	4	35	80	0.4375000
NODE_7604_length_952_cov_23.739742	435	515	0	80	80	1.0000000
NODE_7604_length_952_cov_23.739742	488	568	0	80	80	1.0000000
NODE_7606_length_952_cov_11.478312	245	324	0	79	79	1.0000000
NODE_7606_length_952_cov_11.478312	297	377	0	80	80	1.0000000
NODE_7607_length_952_cov_11.284877	272	352	0	80	80	1.0000000
NODE_7607_length_952_cov_11.284877	325	405	0	80	80	1.0000000
NODE_7608_length_952_cov_10.807737	458	538	0	80	80	1.0000000
NODE_7608_length_952_cov_10.807737	511	591	0	80	80	1.0000000
NODE_7609_length_952_cov_8.770223	375	455	0	40	80	0.5000000
NODE_7609_length_952_cov_8.770223	375	455	2	40	80	0.5000000
NODE_7609_length_952_cov_8.770223	428	508	0	6	80	0.0750000
NODE_7609_length_952_cov_8.770223	428	508	2	74	80	0.9250000
NODE_7623_length_951_cov_54.397887	354	434	0	80	80	1.0000000
NODE_7623_length_951_cov_54.397887	407	487	0	80	80	1.0000000
NODE_7623_length_951_cov_54.397887	483	563	0	69	80	0.8625000
NODE_7623_length_951_cov_54.397887	483	563	28	11	80	0.1375000
NODE_7623_length_951_cov_54.397887	544	616	0	8	72	0.1111111
NODE_7623_length_951_cov_54.397887	544	616	28	64	72	0.8888889
NODE_7624_length_951_cov_47.881455	355	435	0	80	80	1.0000000
NODE_7624_length_951_cov_47.881455	408	488	0	80	80	1.0000000
NODE_7624_length_951_cov_47.881455	484	564	0	80	80	1.0000000
NODE_7624_length_951_cov_47.881455	537	617	0	80	80	1.0000000
NODE_7625_length_951_cov_24.322770	479	559	8	13	80	0.1625000
NODE_7625_length_951_cov_24.322770	479	559	10	67	80	0.8375000
NODE_7625_length_951_cov_24.322770	532	612	0	9	80	0.1125000
NODE_7625_length_951_cov_24.322770	532	612	8	57	80	0.7125000
NODE_7625_length_951_cov_24.322770	532	612	10	14	80	0.1750000
NODE_7626_length_951_cov_23.001174	470	550	0	45	80	0.5625000
NODE_7626_length_951_cov_23.001174	470	550	2	35	80	0.4375000
NODE_7626_length_951_cov_23.001174	523	603	2	80	80	1.0000000
NODE_7627_length_951_cov_22.059859	562	642	0	80	80	1.0000000
NODE_7627_length_951_cov_22.059859	615	695	0	80	80	1.0000000
NODE_7628_length_951_cov_19.413146	456	536	0	80	80	1.0000000
NODE_7628_length_951_cov_19.413146	509	589	0	80	80	1.0000000
NODE_7628_length_951_cov_19.413146	830	877	0	47	47	1.0000000
NODE_7629_length_951_cov_18.970657	384	464	0	80	80	1.0000000
NODE_7629_length_951_cov_18.970657	437	517	0	80	80	1.0000000
NODE_7629_length_951_cov_18.970657	513	593	0	80	80	1.0000000
NODE_7629_length_951_cov_18.970657	566	646	0	80	80	1.0000000
NODE_7630_length_951_cov_17.164319	409	490	0	81	81	1.0000000
NODE_7630_length_951_cov_17.164319	463	543	0	80	80	1.0000000
NODE_7631_length_951_cov_17.009390	393	473	0	80	80	1.0000000
NODE_7631_length_951_cov_17.009390	446	526	0	80	80	1.0000000
NODE_7632_length_951_cov_15.551643	520	600	0	80	80	1.0000000
NODE_7632_length_951_cov_15.551643	573	653	0	80	80	1.0000000
NODE_7633_length_951_cov_13.562207	364	444	0	80	80	1.0000000
NODE_7633_length_951_cov_13.562207	417	497	0	80	80	1.0000000
NODE_7634_length_951_cov_13.086854	450	530	0	80	80	1.0000000
NODE_7634_length_951_cov_13.086854	503	583	0	80	80	1.0000000
NODE_7635_length_951_cov_6.812207	350	430	0	80	80	1.0000000
NODE_7635_length_951_cov_6.812207	403	483	0	80	80	1.0000000
NODE_7636_length_951_cov_5.076291	80	160	0	80	80	1.0000000
NODE_7636_length_951_cov_5.076291	133	213	0	80	80	1.0000000
NODE_7649_length_950_cov_62.151586	731	794	2	63	63	1.0000000
NODE_7650_length_950_cov_56.088132	354	434	0	80	80	1.0000000
NODE_7650_length_950_cov_56.088132	407	487	0	28	80	0.3500000
NODE_7650_length_950_cov_56.088132	407	487	1	52	80	0.6500000
NODE_7650_length_950_cov_56.088132	483	563	1	80	80	1.0000000
NODE_7650_length_950_cov_56.088132	536	616	0	11	80	0.1375000
NODE_7650_length_950_cov_56.088132	536	616	1	49	80	0.6125000
NODE_7650_length_950_cov_56.088132	536	616	4	20	80	0.2500000
NODE_7651_length_950_cov_29.780259	501	581	0	80	80	1.0000000
NODE_7651_length_950_cov_29.780259	554	634	0	80	80	1.0000000
NODE_7652_length_950_cov_27.278496	388	468	0	80	80	1.0000000
NODE_7652_length_950_cov_27.278496	441	519	0	78	78	1.0000000
NODE_7653_length_950_cov_26.766157	322	402	0	80	80	1.0000000
NODE_7653_length_950_cov_26.766157	375	455	0	80	80	1.0000000
NODE_7653_length_950_cov_26.766157	451	531	0	80	80	1.0000000
NODE_7653_length_950_cov_26.766157	504	584	0	80	80	1.0000000
NODE_7654_length_950_cov_19.638073	421	501	0	80	80	1.0000000
NODE_7654_length_950_cov_19.638073	474	554	0	76	80	0.9500000
NODE_7654_length_950_cov_19.638073	474	554	1	4	80	0.0500000
NODE_7654_length_950_cov_19.638073	550	630	1	14	80	0.1750000
NODE_7654_length_950_cov_19.638073	550	630	2	66	80	0.8250000
NODE_7654_length_950_cov_19.638073	603	683	2	78	80	0.9750000
NODE_7654_length_950_cov_19.638073	603	683	4	2	80	0.0250000
NODE_7655_length_950_cov_14.686251	376	456	0	16	80	0.2000000
NODE_7655_length_950_cov_14.686251	376	456	2	64	80	0.8000000
NODE_7655_length_950_cov_14.686251	429	509	0	69	80	0.8625000
NODE_7655_length_950_cov_14.686251	429	509	2	11	80	0.1375000
NODE_7656_length_950_cov_14.215041	339	419	0	48	80	0.6000000
NODE_7656_length_950_cov_14.215041	339	419	2	32	80	0.4000000
NODE_7656_length_950_cov_14.215041	392	472	0	80	80	1.0000000
NODE_7657_length_950_cov_6.397180	370	450	0	69	80	0.8625000
NODE_7657_length_950_cov_6.397180	370	450	4	11	80	0.1375000
NODE_7657_length_950_cov_6.397180	423	504	0	16	81	0.1975309
NODE_7657_length_950_cov_6.397180	423	504	4	65	81	0.8024691
NODE_7659_length_950_cov_4.430082	594	674	0	80	80	1.0000000
NODE_7659_length_950_cov_4.430082	647	727	0	80	80	1.0000000
NODE_7672_length_949_cov_25.550588	371	451	0	80	80	1.0000000
NODE_7672_length_949_cov_25.550588	500	580	0	80	80	1.0000000
NODE_7672_length_949_cov_25.550588	553	633	0	80	80	1.0000000
NODE_7673_length_949_cov_20.949412	252	332	0	80	80	1.0000000
NODE_7673_length_949_cov_20.949412	305	385	0	80	80	1.0000000
NODE_7674_length_949_cov_20.601176	364	444	0	80	80	1.0000000
NODE_7674_length_949_cov_20.601176	417	497	0	80	80	1.0000000
NODE_7674_length_949_cov_20.601176	493	573	0	28	80	0.3500000
NODE_7674_length_949_cov_20.601176	493	573	2	52	80	0.6500000
NODE_7674_length_949_cov_20.601176	546	626	0	28	80	0.3500000
NODE_7674_length_949_cov_20.601176	546	626	2	52	80	0.6500000
NODE_7675_length_949_cov_20.575294	481	561	0	54	80	0.6750000
NODE_7675_length_949_cov_20.575294	481	561	2	26	80	0.3250000
NODE_7675_length_949_cov_20.575294	534	614	0	1	80	0.0125000
NODE_7675_length_949_cov_20.575294	534	614	2	79	80	0.9875000
NODE_7676_length_949_cov_19.483529	340	420	0	80	80	1.0000000
NODE_7676_length_949_cov_19.483529	393	473	0	80	80	1.0000000
NODE_7676_length_949_cov_19.483529	469	549	0	80	80	1.0000000
NODE_7676_length_949_cov_19.483529	522	602	0	80	80	1.0000000
NODE_7677_length_949_cov_19.407059	433	513	0	80	80	1.0000000
NODE_7677_length_949_cov_19.407059	486	566	0	80	80	1.0000000
NODE_7677_length_949_cov_19.407059	562	642	0	80	80	1.0000000
NODE_7677_length_949_cov_19.407059	615	695	0	80	80	1.0000000
NODE_7678_length_949_cov_10.903529	561	641	0	80	80	1.0000000
NODE_7678_length_949_cov_10.903529	614	694	0	80	80	1.0000000
NODE_7679_length_949_cov_7.245882	0	71	0	49	71	0.6901408
NODE_7679_length_949_cov_7.245882	0	71	2	22	71	0.3098592
NODE_7679_length_949_cov_7.245882	0	71	0	49	71	0.6901408
NODE_7679_length_949_cov_7.245882	0	71	2	22	71	0.3098592
NODE_7679_length_949_cov_7.245882	44	124	0	5	80	0.0625000
NODE_7679_length_949_cov_7.245882	44	124	2	75	80	0.9375000
NODE_7680_length_949_cov_6.998824	494	574	0	80	80	1.0000000
NODE_7680_length_949_cov_6.998824	547	627	0	80	80	1.0000000
NODE_7702_length_948_cov_37.201413	510	590	0	80	80	1.0000000
NODE_7702_length_948_cov_37.201413	563	643	0	80	80	1.0000000
NODE_7703_length_948_cov_20.082450	58	99	0	41	41	1.0000000
NODE_7703_length_948_cov_20.082450	113	193	1	3	80	0.0375000
NODE_7703_length_948_cov_20.082450	113	193	3	3	80	0.0375000
NODE_7703_length_948_cov_20.082450	113	193	5	7	80	0.0875000
NODE_7703_length_948_cov_20.082450	113	193	8	1	80	0.0125000
NODE_7703_length_948_cov_20.082450	113	193	11	19	80	0.2375000
NODE_7703_length_948_cov_20.082450	113	193	13	15	80	0.1875000
NODE_7703_length_948_cov_20.082450	113	193	15	11	80	0.1375000
NODE_7703_length_948_cov_20.082450	113	193	21	3	80	0.0375000
NODE_7703_length_948_cov_20.082450	113	193	24	13	80	0.1625000
NODE_7703_length_948_cov_20.082450	113	193	27	5	80	0.0625000
NODE_7703_length_948_cov_20.082450	166	246	15	6	80	0.0750000
NODE_7703_length_948_cov_20.082450	166	246	20	23	80	0.2875000
NODE_7703_length_948_cov_20.082450	166	246	21	3	80	0.0375000
NODE_7703_length_948_cov_20.082450	166	246	22	1	80	0.0125000
NODE_7703_length_948_cov_20.082450	166	246	23	9	80	0.1125000
NODE_7703_length_948_cov_20.082450	166	246	24	13	80	0.1625000
NODE_7703_length_948_cov_20.082450	166	246	25	9	80	0.1125000
NODE_7703_length_948_cov_20.082450	166	246	26	1	80	0.0125000
NODE_7703_length_948_cov_20.082450	166	246	27	15	80	0.1875000
NODE_7704_length_948_cov_16.785630	308	388	0	80	80	1.0000000
NODE_7704_length_948_cov_16.785630	361	441	0	80	80	1.0000000
NODE_7704_length_948_cov_16.785630	437	517	0	80	80	1.0000000
NODE_7704_length_948_cov_16.785630	490	570	0	80	80	1.0000000
NODE_7705_length_948_cov_12.740872	400	480	0	80	80	1.0000000
NODE_7705_length_948_cov_12.740872	453	533	0	80	80	1.0000000
NODE_7706_length_948_cov_10.220259	465	545	0	80	80	1.0000000
NODE_7706_length_948_cov_10.220259	518	598	0	80	80	1.0000000
NODE_7707_length_948_cov_8.504122	456	536	0	80	80	1.0000000
NODE_7707_length_948_cov_8.504122	509	589	0	80	80	1.0000000
NODE_7709_length_948_cov_5.425206	641	721	0	80	80	1.0000000
NODE_7709_length_948_cov_5.425206	694	774	0	80	80	1.0000000
NODE_7711_length_948_cov_3.586572	696	776	0	80	80	1.0000000
NODE_7715_length_948_cov_2.786808	259	324	0	65	65	1.0000000
NODE_7715_length_948_cov_2.786808	297	377	0	80	80	1.0000000
NODE_7721_length_947_cov_91.466981	393	473	0	80	80	1.0000000
NODE_7721_length_947_cov_91.466981	446	526	0	80	80	1.0000000
NODE_7722_length_947_cov_61.139151	402	482	0	80	80	1.0000000
NODE_7722_length_947_cov_61.139151	455	535	0	80	80	1.0000000
NODE_7723_length_947_cov_50.009434	488	568	0	49	80	0.6125000
NODE_7723_length_947_cov_50.009434	488	568	1	31	80	0.3875000
NODE_7723_length_947_cov_50.009434	541	621	1	49	80	0.6125000
NODE_7723_length_947_cov_50.009434	541	621	2	31	80	0.3875000
NODE_7724_length_947_cov_36.271226	511	591	0	80	80	1.0000000
NODE_7724_length_947_cov_36.271226	564	644	0	80	80	1.0000000
NODE_7725_length_947_cov_23.384434	425	505	0	6	80	0.0750000
NODE_7725_length_947_cov_23.384434	425	505	2	74	80	0.9250000
NODE_7725_length_947_cov_23.384434	478	558	0	48	80	0.6000000
NODE_7725_length_947_cov_23.384434	478	558	2	32	80	0.4000000
NODE_7726_length_947_cov_19.103774	316	396	0	80	80	1.0000000
NODE_7726_length_947_cov_19.103774	369	449	0	80	80	1.0000000
NODE_7727_length_947_cov_18.853774	516	596	0	80	80	1.0000000
NODE_7727_length_947_cov_18.853774	569	649	0	80	80	1.0000000
NODE_7728_length_947_cov_18.077830	315	395	0	80	80	1.0000000
NODE_7728_length_947_cov_18.077830	368	448	0	80	80	1.0000000
NODE_7729_length_947_cov_17.713443	403	483	0	16	80	0.2000000
NODE_7729_length_947_cov_17.713443	403	483	2	64	80	0.8000000
NODE_7729_length_947_cov_17.713443	456	536	0	20	80	0.2500000
NODE_7729_length_947_cov_17.713443	456	536	2	60	80	0.7500000
NODE_7730_length_947_cov_14.492925	358	438	0	80	80	1.0000000
NODE_7730_length_947_cov_14.492925	411	491	0	80	80	1.0000000
NODE_7730_length_947_cov_14.492925	487	567	0	80	80	1.0000000
NODE_7730_length_947_cov_14.492925	540	620	0	80	80	1.0000000
NODE_7731_length_947_cov_10.573113	550	630	0	67	80	0.8375000
NODE_7731_length_947_cov_10.573113	550	630	2	13	80	0.1625000
NODE_7731_length_947_cov_10.573113	603	683	0	80	80	1.0000000
NODE_7732_length_947_cov_7.762972	550	630	0	80	80	1.0000000
NODE_7732_length_947_cov_7.762972	607	683	0	76	76	1.0000000
NODE_7747_length_946_cov_39.726092	378	458	0	80	80	1.0000000
NODE_7747_length_946_cov_39.726092	431	511	0	80	80	1.0000000
NODE_7747_length_946_cov_39.726092	507	587	0	80	80	1.0000000
NODE_7747_length_946_cov_39.726092	560	640	0	80	80	1.0000000
NODE_7748_length_946_cov_32.728453	404	484	0	80	80	1.0000000
NODE_7748_length_946_cov_32.728453	457	537	0	80	80	1.0000000
NODE_7749_length_946_cov_27.548996	280	360	0	80	80	1.0000000
NODE_7749_length_946_cov_27.548996	333	413	0	80	80	1.0000000
NODE_7750_length_946_cov_24.622196	352	432	0	80	80	1.0000000
NODE_7750_length_946_cov_24.622196	405	486	0	81	81	1.0000000
NODE_7751_length_946_cov_18.082645	492	572	0	80	80	1.0000000
NODE_7751_length_946_cov_18.082645	545	625	0	80	80	1.0000000
NODE_7752_length_946_cov_18.031877	433	513	0	80	80	1.0000000
NODE_7752_length_946_cov_18.031877	486	566	0	69	80	0.8625000
NODE_7752_length_946_cov_18.031877	486	566	4	11	80	0.1375000
NODE_7753_length_946_cov_15.188902	472	552	0	80	80	1.0000000
NODE_7753_length_946_cov_15.188902	525	605	0	80	80	1.0000000
NODE_7754_length_946_cov_11.201889	408	488	0	80	80	1.0000000
NODE_7754_length_946_cov_11.201889	461	541	0	80	80	1.0000000
NODE_7768_length_945_cov_42.997636	361	441	0	80	80	1.0000000
NODE_7768_length_945_cov_42.997636	414	494	0	80	80	1.0000000
NODE_7769_length_945_cov_31.223404	357	437	0	80	80	1.0000000
NODE_7769_length_945_cov_31.223404	410	490	0	80	80	1.0000000
NODE_7770_length_945_cov_26.348700	331	411	0	80	80	1.0000000
NODE_7770_length_945_cov_26.348700	384	464	0	80	80	1.0000000
NODE_7771_length_945_cov_20.349882	435	515	0	31	80	0.3875000
NODE_7771_length_945_cov_20.349882	435	515	2	49	80	0.6125000
NODE_7771_length_945_cov_20.349882	488	568	0	80	80	1.0000000
NODE_7772_length_945_cov_14.771868	386	466	0	80	80	1.0000000
NODE_7772_length_945_cov_14.771868	439	519	0	80	80	1.0000000
NODE_7773_length_945_cov_10.158392	599	679	0	80	80	1.0000000
NODE_7773_length_945_cov_10.158392	652	732	0	80	80	1.0000000
NODE_7775_length_945_cov_5.403073	357	437	0	80	80	1.0000000
NODE_7775_length_945_cov_5.403073	410	490	0	80	80	1.0000000
NODE_7785_length_944_cov_42.401183	358	438	4	80	80	1.0000000
NODE_7785_length_944_cov_42.401183	411	498	0	48	87	0.5517241
NODE_7785_length_944_cov_42.401183	411	498	4	39	87	0.4482759
NODE_7786_length_944_cov_32.712426	377	457	5	2	80	0.0250000
NODE_7786_length_944_cov_32.712426	377	457	9	28	80	0.3500000
NODE_7786_length_944_cov_32.712426	377	457	10	50	80	0.6250000
NODE_7786_length_944_cov_32.712426	430	510	0	20	80	0.2500000
NODE_7786_length_944_cov_32.712426	430	510	5	35	80	0.4375000
NODE_7786_length_944_cov_32.712426	430	510	9	13	80	0.1625000
NODE_7786_length_944_cov_32.712426	430	510	10	12	80	0.1500000
NODE_7787_length_944_cov_27.839053	417	497	2	80	80	1.0000000
NODE_7787_length_944_cov_27.839053	470	550	0	39	80	0.4875000
NODE_7787_length_944_cov_27.839053	470	550	2	41	80	0.5125000
NODE_7788_length_944_cov_24.702959	413	493	0	80	80	1.0000000
NODE_7788_length_944_cov_24.702959	466	546	0	80	80	1.0000000
NODE_7789_length_944_cov_11.951479	347	427	0	80	80	1.0000000
NODE_7789_length_944_cov_11.951479	400	480	0	80	80	1.0000000
NODE_7789_length_944_cov_11.951479	476	556	0	80	80	1.0000000
NODE_7789_length_944_cov_11.951479	529	609	0	80	80	1.0000000
NODE_7790_length_944_cov_6.745562	366	446	0	80	80	1.0000000
NODE_7790_length_944_cov_6.745562	419	499	0	80	80	1.0000000
NODE_7792_length_944_cov_4.420118	236	316	0	80	80	1.0000000
NODE_7792_length_944_cov_4.420118	289	369	0	80	80	1.0000000
NODE_7800_length_943_cov_40.111374	536	614	0	78	78	1.0000000
NODE_7800_length_943_cov_40.111374	587	667	0	80	80	1.0000000
NODE_7801_length_943_cov_29.446682	338	418	0	27	80	0.3375000
NODE_7801_length_943_cov_29.446682	338	418	1	1	80	0.0125000
NODE_7801_length_943_cov_29.446682	338	418	2	52	80	0.6500000
NODE_7801_length_943_cov_29.446682	391	471	0	26	80	0.3250000
NODE_7801_length_943_cov_29.446682	391	471	2	54	80	0.6750000
NODE_7802_length_943_cov_28.289100	393	473	0	80	80	1.0000000
NODE_7802_length_943_cov_28.289100	446	526	0	80	80	1.0000000
NODE_7803_length_943_cov_27.225118	343	423	0	80	80	1.0000000
NODE_7803_length_943_cov_27.225118	396	476	0	80	80	1.0000000
NODE_7804_length_943_cov_26.536730	275	303	2	28	28	1.0000000
NODE_7804_length_943_cov_26.536730	299	379	0	24	80	0.3000000
NODE_7804_length_943_cov_26.536730	299	379	2	56	80	0.7000000
NODE_7804_length_943_cov_26.536730	352	432	0	77	80	0.9625000
NODE_7804_length_943_cov_26.536730	352	432	2	3	80	0.0375000
NODE_7805_length_943_cov_24.992891	374	454	0	80	80	1.0000000
NODE_7805_length_943_cov_24.992891	427	507	0	80	80	1.0000000
NODE_7805_length_943_cov_24.992891	503	583	0	56	80	0.7000000
NODE_7805_length_943_cov_24.992891	503	583	8	24	80	0.3000000
NODE_7805_length_943_cov_24.992891	556	636	0	3	80	0.0375000
NODE_7805_length_943_cov_24.992891	556	636	8	77	80	0.9625000
NODE_7806_length_943_cov_24.758294	403	483	0	80	80	1.0000000
NODE_7806_length_943_cov_24.758294	456	536	0	80	80	1.0000000
NODE_7807_length_943_cov_22.316351	432	512	0	57	80	0.7125000
NODE_7807_length_943_cov_22.316351	432	512	8	23	80	0.2875000
NODE_7807_length_943_cov_22.316351	485	565	0	4	80	0.0500000
NODE_7807_length_943_cov_22.316351	485	565	8	76	80	0.9500000
NODE_7808_length_943_cov_22.149289	393	473	0	17	80	0.2125000
NODE_7808_length_943_cov_22.149289	393	473	2	63	80	0.7875000
NODE_7808_length_943_cov_22.149289	446	526	0	70	80	0.8750000
NODE_7808_length_943_cov_22.149289	446	526	2	10	80	0.1250000
NODE_7809_length_943_cov_20.055687	412	492	0	80	80	1.0000000
NODE_7809_length_943_cov_20.055687	465	545	0	80	80	1.0000000
NODE_7810_length_943_cov_16.022512	338	418	0	80	80	1.0000000
NODE_7810_length_943_cov_16.022512	391	471	0	80	80	1.0000000
NODE_7811_length_943_cov_10.939573	474	554	0	80	80	1.0000000
NODE_7811_length_943_cov_10.939573	527	607	0	80	80	1.0000000
NODE_7812_length_943_cov_9.483412	422	502	0	42	80	0.5250000
NODE_7812_length_943_cov_9.483412	422	502	2	38	80	0.4750000
NODE_7812_length_943_cov_9.483412	475	555	0	8	80	0.1000000
NODE_7812_length_943_cov_9.483412	475	555	2	72	80	0.9000000
NODE_7830_length_942_cov_58.088968	384	464	0	80	80	1.0000000
NODE_7830_length_942_cov_58.088968	437	517	0	80	80	1.0000000
NODE_7832_length_942_cov_27.466192	360	440	0	75	80	0.9375000
NODE_7832_length_942_cov_27.466192	360	440	2	5	80	0.0625000
NODE_7832_length_942_cov_27.466192	413	493	0	22	80	0.2750000
NODE_7832_length_942_cov_27.466192	413	493	2	58	80	0.7250000
NODE_7833_length_942_cov_26.914591	346	426	0	24	80	0.3000000
NODE_7833_length_942_cov_26.914591	346	426	4	56	80	0.7000000
NODE_7833_length_942_cov_26.914591	399	479	0	77	80	0.9625000
NODE_7833_length_942_cov_26.914591	399	479	4	3	80	0.0375000
NODE_7834_length_942_cov_17.911032	390	470	0	80	80	1.0000000
NODE_7834_length_942_cov_17.911032	443	523	0	80	80	1.0000000
NODE_7835_length_942_cov_14.695136	442	522	0	80	80	1.0000000
NODE_7835_length_942_cov_14.695136	495	575	0	80	80	1.0000000
NODE_7836_length_942_cov_14.097272	547	627	0	80	80	1.0000000
NODE_7836_length_942_cov_14.097272	600	680	0	80	80	1.0000000
NODE_7837_length_942_cov_13.174377	322	402	0	80	80	1.0000000
NODE_7837_length_942_cov_13.174377	375	455	0	80	80	1.0000000
NODE_7858_length_941_cov_36.592637	259	339	0	80	80	1.0000000
NODE_7858_length_941_cov_36.592637	312	392	0	80	80	1.0000000
NODE_7858_length_941_cov_36.592637	388	468	0	6	80	0.0750000
NODE_7858_length_941_cov_36.592637	388	468	5	74	80	0.9250000
NODE_7858_length_941_cov_36.592637	441	521	5	80	80	1.0000000
NODE_7859_length_941_cov_35.375297	352	432	0	80	80	1.0000000
NODE_7859_length_941_cov_35.375297	405	485	0	80	80	1.0000000
NODE_7859_length_941_cov_35.375297	481	561	0	11	80	0.1375000
NODE_7859_length_941_cov_35.375297	481	561	4	69	80	0.8625000
NODE_7859_length_941_cov_35.375297	534	614	0	20	80	0.2500000
NODE_7859_length_941_cov_35.375297	534	614	4	60	80	0.7500000
NODE_7860_length_941_cov_32.222090	407	487	0	80	80	1.0000000
NODE_7860_length_941_cov_32.222090	460	540	0	36	80	0.4500000
NODE_7860_length_941_cov_32.222090	460	540	2	44	80	0.5500000
NODE_7861_length_941_cov_28.442993	391	471	0	80	80	1.0000000
NODE_7861_length_941_cov_28.442993	444	524	0	80	80	1.0000000
NODE_7862_length_941_cov_20.788599	341	421	0	80	80	1.0000000
NODE_7862_length_941_cov_20.788599	394	474	0	80	80	1.0000000
NODE_7863_length_941_cov_18.000000	364	444	0	80	80	1.0000000
NODE_7863_length_941_cov_18.000000	417	497	0	80	80	1.0000000
NODE_7864_length_941_cov_11.020190	325	405	6	80	80	1.0000000
NODE_7864_length_941_cov_11.020190	378	458	0	16	80	0.2000000
NODE_7864_length_941_cov_11.020190	378	458	6	64	80	0.8000000
NODE_7865_length_941_cov_6.020190	260	287	13	27	27	1.0000000
NODE_7865_length_941_cov_6.020190	260	340	2	3	80	0.0375000
NODE_7865_length_941_cov_6.020190	260	340	12	41	80	0.5125000
NODE_7865_length_941_cov_6.020190	260	340	13	34	80	0.4250000
NODE_7865_length_941_cov_6.020190	260	340	14	2	80	0.0250000
NODE_7867_length_941_cov_3.745843	867	941	0	24	74	0.3243243
NODE_7867_length_941_cov_3.745843	867	941	2	50	74	0.6756757
NODE_7877_length_940_cov_43.954816	243	323	0	59	80	0.7375000
NODE_7877_length_940_cov_43.954816	243	323	4	21	80	0.2625000
NODE_7877_length_940_cov_43.954816	296	376	0	6	80	0.0750000
NODE_7877_length_940_cov_43.954816	296	376	4	74	80	0.9250000
NODE_7877_length_940_cov_43.954816	372	452	0	68	80	0.8500000
NODE_7877_length_940_cov_43.954816	372	452	4	12	80	0.1500000
NODE_7877_length_940_cov_43.954816	425	505	0	80	80	1.0000000
NODE_7878_length_940_cov_27.763377	423	503	0	80	80	1.0000000
NODE_7878_length_940_cov_27.763377	476	556	0	80	80	1.0000000
NODE_7897_length_939_cov_58.982143	363	443	0	49	80	0.6125000
NODE_7897_length_939_cov_58.982143	363	443	4	31	80	0.3875000
NODE_7897_length_939_cov_58.982143	416	496	0	12	80	0.1500000
NODE_7897_length_939_cov_58.982143	416	496	4	68	80	0.8500000
NODE_7898_length_939_cov_32.469048	327	407	0	80	80	1.0000000
NODE_7898_length_939_cov_32.469048	380	460	0	80	80	1.0000000
NODE_7899_length_939_cov_31.895238	265	345	0	79	80	0.9875000
NODE_7899_length_939_cov_31.895238	265	345	2	1	80	0.0125000
NODE_7899_length_939_cov_31.895238	318	398	0	26	80	0.3250000
NODE_7899_length_939_cov_31.895238	318	398	2	54	80	0.6750000
NODE_7900_length_939_cov_25.354762	439	519	0	80	80	1.0000000
NODE_7900_length_939_cov_25.354762	492	572	0	80	80	1.0000000
NODE_7901_length_939_cov_24.892857	370	450	0	80	80	1.0000000
NODE_7901_length_939_cov_24.892857	423	503	0	80	80	1.0000000
NODE_7902_length_939_cov_24.246429	422	502	0	80	80	1.0000000
NODE_7902_length_939_cov_24.246429	475	555	0	80	80	1.0000000
NODE_7902_length_939_cov_24.246429	551	631	0	80	80	1.0000000
NODE_7902_length_939_cov_24.246429	604	684	0	80	80	1.0000000
NODE_7903_length_939_cov_21.141667	368	448	0	80	80	1.0000000
NODE_7903_length_939_cov_21.141667	421	501	0	80	80	1.0000000
NODE_7904_length_939_cov_16.425000	327	407	0	52	80	0.6500000
NODE_7904_length_939_cov_16.425000	327	407	2	28	80	0.3500000
NODE_7904_length_939_cov_16.425000	380	460	2	80	80	1.0000000
NODE_7905_length_939_cov_13.828571	469	548	0	79	79	1.0000000
NODE_7905_length_939_cov_13.828571	522	603	0	81	81	1.0000000
NODE_7906_length_939_cov_13.521429	402	482	0	80	80	1.0000000
NODE_7906_length_939_cov_13.521429	455	535	0	80	80	1.0000000
NODE_7907_length_939_cov_12.955952	398	478	0	80	80	1.0000000
NODE_7907_length_939_cov_12.955952	451	531	0	42	80	0.5250000
NODE_7907_length_939_cov_12.955952	451	531	4	38	80	0.4750000
NODE_7908_length_939_cov_6.564286	523	545	0	22	22	1.0000000
NODE_7922_length_938_cov_44.458880	362	442	0	80	80	1.0000000
NODE_7922_length_938_cov_44.458880	415	495	0	80	80	1.0000000
NODE_7923_length_938_cov_44.435042	748	815	0	67	67	1.0000000
NODE_7924_length_938_cov_32.177592	466	546	0	80	80	1.0000000
NODE_7924_length_938_cov_32.177592	519	599	0	80	80	1.0000000
NODE_7925_length_938_cov_21.139452	474	554	0	80	80	1.0000000
NODE_7925_length_938_cov_21.139452	527	607	0	80	80	1.0000000
NODE_7927_length_938_cov_8.791418	300	380	0	32	80	0.4000000
NODE_7927_length_938_cov_8.791418	300	380	2	48	80	0.6000000
NODE_7927_length_938_cov_8.791418	353	433	0	80	80	1.0000000
NODE_7932_length_938_cov_2.693683	59	139	0	80	80	1.0000000
NODE_7932_length_938_cov_2.693683	112	192	0	80	80	1.0000000
NODE_7946_length_937_cov_31.890215	407	487	0	80	80	1.0000000
NODE_7946_length_937_cov_31.890215	460	536	0	76	76	1.0000000
NODE_7947_length_937_cov_31.198091	425	505	0	80	80	1.0000000
NODE_7947_length_937_cov_31.198091	478	558	0	80	80	1.0000000
NODE_7948_length_937_cov_29.742243	296	376	0	80	80	1.0000000
NODE_7948_length_937_cov_29.742243	349	429	0	80	80	1.0000000
NODE_7948_length_937_cov_29.742243	425	505	0	80	80	1.0000000
NODE_7948_length_937_cov_29.742243	478	558	0	80	80	1.0000000
NODE_7950_length_937_cov_26.153938	487	567	0	80	80	1.0000000
NODE_7950_length_937_cov_26.153938	540	620	0	80	80	1.0000000
NODE_7951_length_937_cov_20.898568	515	595	0	80	80	1.0000000
NODE_7951_length_937_cov_20.898568	568	648	0	80	80	1.0000000
NODE_7952_length_937_cov_20.502387	181	261	0	80	80	1.0000000
NODE_7952_length_937_cov_20.502387	234	314	0	80	80	1.0000000
NODE_7952_length_937_cov_20.502387	310	390	0	54	80	0.6750000
NODE_7952_length_937_cov_20.502387	310	390	2	26	80	0.3250000
NODE_7952_length_937_cov_20.502387	363	443	0	9	80	0.1125000
NODE_7952_length_937_cov_20.502387	363	443	2	71	80	0.8875000
NODE_7953_length_937_cov_15.219570	526	606	0	80	80	1.0000000
NODE_7953_length_937_cov_15.219570	579	659	0	80	80	1.0000000
NODE_7954_length_937_cov_9.633652	521	601	0	80	80	1.0000000
NODE_7954_length_937_cov_9.633652	574	654	0	80	80	1.0000000
NODE_7956_length_937_cov_6.630072	305	385	0	80	80	1.0000000
NODE_7956_length_937_cov_6.630072	358	438	0	80	80	1.0000000
NODE_7957_length_937_cov_4.649165	470	550	0	80	80	1.0000000
NODE_7957_length_937_cov_4.649165	523	603	0	80	80	1.0000000
NODE_7969_length_936_cov_57.105137	267	347	0	55	80	0.6875000
NODE_7969_length_936_cov_57.105137	267	347	2	25	80	0.3125000
NODE_7969_length_936_cov_57.105137	320	400	0	6	80	0.0750000
NODE_7969_length_936_cov_57.105137	320	400	2	74	80	0.9250000
NODE_7969_length_936_cov_57.105137	396	476	0	9	80	0.1125000
NODE_7969_length_936_cov_57.105137	396	476	3	32	80	0.4000000
NODE_7969_length_936_cov_57.105137	396	476	4	39	80	0.4875000
NODE_7969_length_936_cov_57.105137	449	529	4	80	80	1.0000000
NODE_7970_length_936_cov_39.983274	433	513	0	80	80	1.0000000
NODE_7970_length_936_cov_39.983274	486	566	0	80	80	1.0000000
NODE_7971_length_936_cov_22.486260	534	614	2	80	80	1.0000000
NODE_7971_length_936_cov_22.486260	587	667	0	27	80	0.3375000
NODE_7971_length_936_cov_22.486260	587	667	2	53	80	0.6625000
NODE_7972_length_936_cov_19.639188	409	489	0	80	80	1.0000000
NODE_7972_length_936_cov_19.639188	462	542	0	80	80	1.0000000
NODE_7973_length_936_cov_15.083632	322	402	2	80	80	1.0000000
NODE_7973_length_936_cov_15.083632	375	455	2	80	80	1.0000000
NODE_7974_length_936_cov_13.962963	356	424	6	68	68	1.0000000
NODE_7975_length_936_cov_12.502987	447	527	0	80	80	1.0000000
NODE_7975_length_936_cov_12.502987	500	580	0	80	80	1.0000000
NODE_7976_length_936_cov_12.279570	340	420	0	80	80	1.0000000
NODE_7976_length_936_cov_12.279570	393	473	0	80	80	1.0000000
NODE_7977_length_936_cov_7.906810	587	667	0	80	80	1.0000000
NODE_7977_length_936_cov_7.906810	640	720	0	80	80	1.0000000
NODE_7978_length_936_cov_6.845878	322	402	0	80	80	1.0000000
NODE_7978_length_936_cov_6.845878	375	455	0	80	80	1.0000000
NODE_7979_length_936_cov_6.434886	556	635	0	79	79	1.0000000
NODE_7979_length_936_cov_6.434886	608	688	0	80	80	1.0000000
NODE_7993_length_935_cov_38.209330	57	137	126	3	80	0.0375000
NODE_7993_length_935_cov_38.209330	57	137	135	1	80	0.0125000
NODE_7993_length_935_cov_38.209330	57	137	141	2	80	0.0250000
NODE_7993_length_935_cov_38.209330	57	137	149	2	80	0.0250000
NODE_7993_length_935_cov_38.209330	57	137	153	2	80	0.0250000
NODE_7993_length_935_cov_38.209330	57	137	155	1	80	0.0125000
NODE_7993_length_935_cov_38.209330	57	137	165	1	80	0.0125000
NODE_7993_length_935_cov_38.209330	57	137	168	2	80	0.0250000
NODE_7993_length_935_cov_38.209330	57	137	170	1	80	0.0125000
NODE_7993_length_935_cov_38.209330	57	137	174	1	80	0.0125000
NODE_7993_length_935_cov_38.209330	57	137	178	2	80	0.0250000
NODE_7993_length_935_cov_38.209330	57	137	180	1	80	0.0125000
NODE_7993_length_935_cov_38.209330	57	137	192	2	80	0.0250000
NODE_7993_length_935_cov_38.209330	57	137	194	1	80	0.0125000
NODE_7993_length_935_cov_38.209330	57	137	196	2	80	0.0250000
NODE_7993_length_935_cov_38.209330	57	137	198	3	80	0.0375000
NODE_7993_length_935_cov_38.209330	57	137	202	5	80	0.0625000
NODE_7993_length_935_cov_38.209330	57	137	204	48	80	0.6000000
NODE_7994_length_935_cov_27.306220	439	519	0	80	80	1.0000000
NODE_7994_length_935_cov_27.306220	492	572	0	80	80	1.0000000
NODE_7995_length_935_cov_26.562201	321	401	1	80	80	1.0000000
NODE_7995_length_935_cov_26.562201	374	454	0	47	80	0.5875000
NODE_7995_length_935_cov_26.562201	374	454	1	33	80	0.4125000
NODE_7995_length_935_cov_26.562201	450	530	0	29	80	0.3625000
NODE_7995_length_935_cov_26.562201	450	530	1	51	80	0.6375000
NODE_7995_length_935_cov_26.562201	503	583	1	80	80	1.0000000
NODE_7996_length_935_cov_25.098086	356	436	0	80	80	1.0000000
NODE_7996_length_935_cov_25.098086	409	489	0	80	80	1.0000000
NODE_7997_length_935_cov_24.316986	467	547	0	80	80	1.0000000
NODE_7997_length_935_cov_24.316986	520	600	0	80	80	1.0000000
NODE_7998_length_935_cov_19.221292	397	477	0	80	80	1.0000000
NODE_7998_length_935_cov_19.221292	450	530	0	80	80	1.0000000
NODE_7999_length_935_cov_15.016746	404	484	1	8	80	0.1000000
NODE_7999_length_935_cov_15.016746	404	484	4	70	80	0.8750000
NODE_7999_length_935_cov_15.016746	404	484	5	2	80	0.0250000
NODE_7999_length_935_cov_15.016746	457	537	0	31	80	0.3875000
NODE_7999_length_935_cov_15.016746	457	537	3	1	80	0.0125000
NODE_7999_length_935_cov_15.016746	457	537	4	48	80	0.6000000
NODE_8000_length_935_cov_13.138756	341	421	0	80	80	1.0000000
NODE_8000_length_935_cov_13.138756	394	474	0	80	80	1.0000000
NODE_8002_length_935_cov_6.485646	512	592	0	80	80	1.0000000
NODE_8002_length_935_cov_6.485646	565	645	0	80	80	1.0000000
NODE_8003_length_935_cov_6.467703	250	330	0	80	80	1.0000000
NODE_8003_length_935_cov_6.467703	303	383	0	80	80	1.0000000
NODE_8004_length_935_cov_6.144737	478	558	0	80	80	1.0000000
NODE_8004_length_935_cov_6.144737	531	611	0	80	80	1.0000000
NODE_8005_length_935_cov_3.905502	39	119	2	3	80	0.0375000
NODE_8005_length_935_cov_3.905502	39	119	4	1	80	0.0125000
NODE_8005_length_935_cov_3.905502	39	119	6	2	80	0.0250000
NODE_8005_length_935_cov_3.905502	39	119	9	1	80	0.0125000
NODE_8005_length_935_cov_3.905502	39	119	10	1	80	0.0125000
NODE_8005_length_935_cov_3.905502	39	119	22	49	80	0.6125000
NODE_8005_length_935_cov_3.905502	39	119	24	23	80	0.2875000
NODE_8005_length_935_cov_3.905502	92	166	0	29	74	0.3918919
NODE_8005_length_935_cov_3.905502	92	166	2	21	74	0.2837838
NODE_8005_length_935_cov_3.905502	92	166	4	1	74	0.0135135
NODE_8005_length_935_cov_3.905502	92	166	6	2	74	0.0270270
NODE_8005_length_935_cov_3.905502	92	166	9	1	74	0.0135135
NODE_8005_length_935_cov_3.905502	92	166	10	1	74	0.0135135
NODE_8005_length_935_cov_3.905502	92	166	22	19	74	0.2567568
NODE_8028_length_934_cov_22.898204	403	483	0	80	80	1.0000000
NODE_8028_length_934_cov_22.898204	456	536	0	80	80	1.0000000
NODE_8029_length_934_cov_17.746108	246	326	0	40	80	0.5000000
NODE_8029_length_934_cov_17.746108	246	326	2	40	80	0.5000000
NODE_8029_length_934_cov_17.746108	299	379	0	18	80	0.2250000
NODE_8029_length_934_cov_17.746108	299	379	2	62	80	0.7750000
NODE_8030_length_934_cov_16.049102	367	447	0	47	80	0.5875000
NODE_8030_length_934_cov_16.049102	367	447	2	33	80	0.4125000
NODE_8030_length_934_cov_16.049102	420	500	2	80	80	1.0000000
NODE_8031_length_934_cov_13.738922	379	459	0	80	80	1.0000000
NODE_8031_length_934_cov_13.738922	432	459	0	27	27	1.0000000
NODE_8031_length_934_cov_13.738922	470	512	0	42	42	1.0000000
NODE_8032_length_934_cov_9.091018	407	487	0	80	80	1.0000000
NODE_8032_length_934_cov_9.091018	460	540	0	80	80	1.0000000
NODE_8034_length_934_cov_5.349701	583	663	0	80	80	1.0000000
NODE_8050_length_933_cov_36.557554	462	542	0	80	80	1.0000000
NODE_8050_length_933_cov_36.557554	515	595	0	80	80	1.0000000
NODE_8051_length_933_cov_27.645084	476	556	0	80	80	1.0000000
NODE_8051_length_933_cov_27.645084	529	609	0	80	80	1.0000000
NODE_8052_length_933_cov_26.749400	611	691	0	39	80	0.4875000
NODE_8052_length_933_cov_26.749400	611	691	6	41	80	0.5125000
NODE_8052_length_933_cov_26.749400	664	744	0	25	80	0.3125000
NODE_8052_length_933_cov_26.749400	664	744	6	55	80	0.6875000
NODE_8053_length_933_cov_26.308153	430	510	2	80	80	1.0000000
NODE_8053_length_933_cov_26.308153	483	563	0	41	80	0.5125000
NODE_8053_length_933_cov_26.308153	483	563	2	39	80	0.4875000
NODE_8054_length_933_cov_19.966427	444	530	0	86	86	1.0000000
NODE_8054_length_933_cov_19.966427	497	583	0	86	86	1.0000000
NODE_8055_length_933_cov_16.870504	284	364	0	80	80	1.0000000
NODE_8055_length_933_cov_16.870504	337	415	0	78	78	1.0000000
NODE_8056_length_933_cov_16.699041	366	446	0	80	80	1.0000000
NODE_8056_length_933_cov_16.699041	419	499	0	80	80	1.0000000
NODE_8057_length_933_cov_11.171463	197	277	0	57	80	0.7125000
NODE_8057_length_933_cov_11.171463	197	277	2	23	80	0.2875000
NODE_8057_length_933_cov_11.171463	250	330	0	80	80	1.0000000
NODE_8073_length_932_cov_26.656663	397	477	0	80	80	1.0000000
NODE_8073_length_932_cov_26.656663	450	530	0	80	80	1.0000000
NODE_8074_length_932_cov_16.581032	407	485	0	78	78	1.0000000
NODE_8074_length_932_cov_16.581032	460	538	0	78	78	1.0000000
NODE_8075_length_932_cov_13.462185	413	493	0	80	80	1.0000000
NODE_8075_length_932_cov_13.462185	466	546	0	80	80	1.0000000
NODE_8076_length_932_cov_13.442977	386	466	0	80	80	1.0000000
NODE_8076_length_932_cov_13.442977	439	519	0	80	80	1.0000000
NODE_8077_length_932_cov_11.947179	344	424	0	80	80	1.0000000
NODE_8077_length_932_cov_11.947179	397	477	0	80	80	1.0000000
NODE_8079_length_932_cov_10.849940	409	489	0	80	80	1.0000000
NODE_8079_length_932_cov_10.849940	462	542	0	80	80	1.0000000
NODE_8080_length_932_cov_10.174070	342	422	0	80	80	1.0000000
NODE_8080_length_932_cov_10.174070	395	475	0	80	80	1.0000000
NODE_8082_length_932_cov_9.200480	184	264	0	80	80	1.0000000
NODE_8082_length_932_cov_9.200480	237	317	0	80	80	1.0000000
NODE_8090_length_932_cov_2.689076	598	676	0	78	78	1.0000000
NODE_8090_length_932_cov_2.689076	798	845	0	24	47	0.5106383
NODE_8090_length_932_cov_2.689076	798	845	2	23	47	0.4893617
NODE_8103_length_931_cov_51.451923	320	400	0	80	80	1.0000000
NODE_8103_length_931_cov_51.451923	373	453	0	80	80	1.0000000
NODE_8104_length_931_cov_46.621394	527	607	0	15	80	0.1875000
NODE_8104_length_931_cov_46.621394	527	607	6	65	80	0.8125000
NODE_8104_length_931_cov_46.621394	580	660	0	68	80	0.8500000
NODE_8104_length_931_cov_46.621394	580	660	6	12	80	0.1500000
NODE_8105_length_931_cov_36.334135	347	427	0	80	80	1.0000000
NODE_8105_length_931_cov_36.334135	400	480	0	80	80	1.0000000
NODE_8106_length_931_cov_32.495192	482	562	13	4	80	0.0500000
NODE_8106_length_931_cov_32.495192	482	562	24	7	80	0.0875000
NODE_8106_length_931_cov_32.495192	482	562	25	3	80	0.0375000
NODE_8106_length_931_cov_32.495192	482	562	26	66	80	0.8250000
NODE_8106_length_931_cov_32.495192	535	617	0	25	82	0.3048781
NODE_8106_length_931_cov_32.495192	535	617	13	34	82	0.4146341
NODE_8106_length_931_cov_32.495192	535	617	24	7	82	0.0853659
NODE_8106_length_931_cov_32.495192	535	617	25	3	82	0.0365854
NODE_8106_length_931_cov_32.495192	535	617	26	13	82	0.1585366
NODE_8107_length_931_cov_22.100962	375	455	0	80	80	1.0000000
NODE_8107_length_931_cov_22.100962	428	508	0	80	80	1.0000000
NODE_8108_length_931_cov_21.781250	347	427	1	13	80	0.1625000
NODE_8108_length_931_cov_21.781250	347	427	7	1	80	0.0125000
NODE_8108_length_931_cov_21.781250	347	427	9	57	80	0.7125000
NODE_8108_length_931_cov_21.781250	347	427	11	9	80	0.1125000
NODE_8108_length_931_cov_21.781250	400	480	8	3	80	0.0375000
NODE_8108_length_931_cov_21.781250	400	480	9	18	80	0.2250000
NODE_8108_length_931_cov_21.781250	400	480	10	44	80	0.5500000
NODE_8108_length_931_cov_21.781250	400	480	11	15	80	0.1875000
NODE_8109_length_931_cov_19.084135	411	491	0	80	80	1.0000000
NODE_8109_length_931_cov_19.084135	464	544	0	37	80	0.4625000
NODE_8109_length_931_cov_19.084135	464	544	2	9	80	0.1125000
NODE_8109_length_931_cov_19.084135	464	544	4	34	80	0.4250000
NODE_8110_length_931_cov_14.879808	444	524	0	80	80	1.0000000
NODE_8110_length_931_cov_14.879808	497	577	0	80	80	1.0000000
NODE_8111_length_931_cov_13.087740	759	800	16	2	41	0.0487805
NODE_8111_length_931_cov_13.087740	759	800	20	5	41	0.1219512
NODE_8111_length_931_cov_13.087740	759	800	22	3	41	0.0731707
NODE_8111_length_931_cov_13.087740	759	800	24	11	41	0.2682927
NODE_8111_length_931_cov_13.087740	759	800	26	4	41	0.0975610
NODE_8111_length_931_cov_13.087740	759	800	28	16	41	0.3902439
NODE_8112_length_931_cov_10.534856	399	479	0	65	80	0.8125000
NODE_8112_length_931_cov_10.534856	399	479	4	15	80	0.1875000
NODE_8112_length_931_cov_10.534856	452	532	0	80	80	1.0000000
NODE_8113_length_931_cov_9.865385	236	316	0	80	80	1.0000000
NODE_8113_length_931_cov_9.865385	289	369	0	80	80	1.0000000
NODE_8115_length_931_cov_6.201923	479	559	4	55	80	0.6875000
NODE_8115_length_931_cov_6.201923	479	559	6	25	80	0.3125000
NODE_8115_length_931_cov_6.201923	532	612	0	45	80	0.5625000
NODE_8115_length_931_cov_6.201923	532	612	4	35	80	0.4375000
NODE_8124_length_931_cov_1.780048	832	902	0	70	70	1.0000000
NODE_8126_length_931_cov_1.433894	220	284	12	2	64	0.0312500
NODE_8126_length_931_cov_1.433894	220	284	14	10	64	0.1562500
NODE_8126_length_931_cov_1.433894	220	284	16	4	64	0.0625000
NODE_8126_length_931_cov_1.433894	220	284	17	1	64	0.0156250
NODE_8126_length_931_cov_1.433894	220	284	18	23	64	0.3593750
NODE_8126_length_931_cov_1.433894	220	284	20	3	64	0.0468750
NODE_8126_length_931_cov_1.433894	220	284	22	4	64	0.0625000
NODE_8126_length_931_cov_1.433894	220	284	24	9	64	0.1406250
NODE_8126_length_931_cov_1.433894	220	284	26	1	64	0.0156250
NODE_8126_length_931_cov_1.433894	220	284	28	7	64	0.1093750
NODE_8131_length_930_cov_49.052948	252	332	0	39	80	0.4875000
NODE_8131_length_930_cov_49.052948	252	332	2	6	80	0.0750000
NODE_8131_length_930_cov_49.052948	252	332	4	35	80	0.4375000
NODE_8131_length_930_cov_49.052948	305	385	0	28	80	0.3500000
NODE_8131_length_930_cov_49.052948	305	385	4	52	80	0.6500000
NODE_8131_length_930_cov_49.052948	381	462	0	81	81	1.0000000
NODE_8131_length_930_cov_49.052948	435	515	0	40	80	0.5000000
NODE_8131_length_930_cov_49.052948	435	515	2	40	80	0.5000000
NODE_8132_length_930_cov_31.510229	400	482	0	82	82	1.0000000
NODE_8132_length_930_cov_31.510229	453	535	0	82	82	1.0000000
NODE_8133_length_930_cov_29.139591	329	409	0	80	80	1.0000000
NODE_8133_length_930_cov_29.139591	382	462	0	80	80	1.0000000
NODE_8134_length_930_cov_24.787004	518	598	0	80	80	1.0000000
NODE_8134_length_930_cov_24.787004	571	651	0	80	80	1.0000000
NODE_8135_length_930_cov_24.608905	300	380	0	80	80	1.0000000
NODE_8135_length_930_cov_24.608905	353	433	0	80	80	1.0000000
NODE_8136_length_930_cov_16.494585	482	562	0	10	80	0.1250000
NODE_8136_length_930_cov_16.494585	482	562	1	7	80	0.0875000
NODE_8136_length_930_cov_16.494585	482	562	2	63	80	0.7875000
NODE_8136_length_930_cov_16.494585	535	615	0	63	80	0.7875000
NODE_8136_length_930_cov_16.494585	535	615	1	7	80	0.0875000
NODE_8136_length_930_cov_16.494585	535	615	2	10	80	0.1250000
NODE_8137_length_930_cov_13.296029	249	329	0	80	80	1.0000000
NODE_8137_length_930_cov_13.296029	302	382	0	80	80	1.0000000
NODE_8137_length_930_cov_13.296029	378	458	0	80	80	1.0000000
NODE_8137_length_930_cov_13.296029	431	511	0	80	80	1.0000000
NODE_8138_length_930_cov_11.758123	463	543	0	60	80	0.7500000
NODE_8138_length_930_cov_11.758123	463	543	2	20	80	0.2500000
NODE_8138_length_930_cov_11.758123	516	596	0	7	80	0.0875000
NODE_8138_length_930_cov_11.758123	516	596	2	73	80	0.9125000
NODE_8139_length_930_cov_7.576414	531	611	0	77	80	0.9625000
NODE_8139_length_930_cov_7.576414	531	611	2	3	80	0.0375000
NODE_8139_length_930_cov_7.576414	584	664	0	80	80	1.0000000
NODE_8156_length_930_cov_0.821901	676	736	0	60	60	1.0000000
NODE_8157_length_929_cov_54.485542	313	393	0	70	80	0.8750000
NODE_8157_length_929_cov_54.485542	313	393	2	10	80	0.1250000
NODE_8157_length_929_cov_54.485542	366	446	0	17	80	0.2125000
NODE_8157_length_929_cov_54.485542	366	446	2	63	80	0.7875000
NODE_8157_length_929_cov_54.485542	442	522	0	51	80	0.6375000
NODE_8157_length_929_cov_54.485542	442	522	2	29	80	0.3625000
NODE_8157_length_929_cov_54.485542	495	575	0	80	80	1.0000000
NODE_8158_length_929_cov_49.865060	429	509	0	80	80	1.0000000
NODE_8158_length_929_cov_49.865060	482	562	0	80	80	1.0000000
NODE_8159_length_929_cov_34.634940	358	438	0	80	80	1.0000000
NODE_8159_length_929_cov_34.634940	411	491	0	80	80	1.0000000
NODE_8161_length_929_cov_20.815663	365	445	0	80	80	1.0000000
NODE_8161_length_929_cov_20.815663	418	498	0	80	80	1.0000000
NODE_8162_length_929_cov_17.798795	376	456	0	80	80	1.0000000
NODE_8162_length_929_cov_17.798795	429	509	0	80	80	1.0000000
NODE_8163_length_929_cov_16.622892	331	408	0	77	77	1.0000000
NODE_8163_length_929_cov_16.622892	381	461	0	80	80	1.0000000
NODE_8163_length_929_cov_16.622892	457	537	0	33	80	0.4125000
NODE_8163_length_929_cov_16.622892	457	537	2	47	80	0.5875000
NODE_8163_length_929_cov_16.622892	510	590	2	80	80	1.0000000
NODE_8164_length_929_cov_15.242169	302	382	0	80	80	1.0000000
NODE_8164_length_929_cov_15.242169	355	435	0	80	80	1.0000000
NODE_8164_length_929_cov_15.242169	431	511	0	80	80	1.0000000
NODE_8164_length_929_cov_15.242169	484	564	0	52	80	0.6500000
NODE_8164_length_929_cov_15.242169	484	564	2	28	80	0.3500000
NODE_8165_length_929_cov_13.197590	259	339	8	80	80	1.0000000
NODE_8165_length_929_cov_13.197590	312	392	7	1	80	0.0125000
NODE_8165_length_929_cov_13.197590	312	392	8	79	80	0.9875000
NODE_8167_length_929_cov_7.766265	385	465	0	80	80	1.0000000
NODE_8167_length_929_cov_7.766265	438	518	0	80	80	1.0000000
NODE_8168_length_929_cov_5.750602	382	462	0	8	80	0.1000000
NODE_8168_length_929_cov_5.750602	382	462	2	72	80	0.9000000
NODE_8168_length_929_cov_5.750602	435	515	2	80	80	1.0000000
NODE_8181_length_928_cov_35.226779	273	353	0	64	80	0.8000000
NODE_8181_length_928_cov_35.226779	273	353	2	16	80	0.2000000
NODE_8181_length_928_cov_35.226779	326	406	0	11	80	0.1375000
NODE_8181_length_928_cov_35.226779	326	406	2	69	80	0.8625000
NODE_8181_length_928_cov_35.226779	402	482	0	25	80	0.3125000
NODE_8181_length_928_cov_35.226779	402	482	2	55	80	0.6875000
NODE_8181_length_928_cov_35.226779	455	535	0	78	80	0.9750000
NODE_8181_length_928_cov_35.226779	455	535	2	2	80	0.0250000
NODE_8182_length_928_cov_25.218335	299	379	0	80	80	1.0000000
NODE_8182_length_928_cov_25.218335	352	432	0	80	80	1.0000000
NODE_8183_length_928_cov_22.815440	342	422	0	6	80	0.0750000
NODE_8183_length_928_cov_22.815440	342	422	4	74	80	0.9250000
NODE_8183_length_928_cov_22.815440	395	475	4	80	80	1.0000000
NODE_8183_length_928_cov_22.815440	471	551	0	74	80	0.9250000
NODE_8183_length_928_cov_22.815440	471	551	4	6	80	0.0750000
NODE_8183_length_928_cov_22.815440	524	604	0	80	80	1.0000000
NODE_8184_length_928_cov_20.718938	365	445	0	80	80	1.0000000
NODE_8184_length_928_cov_20.718938	418	498	0	80	80	1.0000000
NODE_8185_length_928_cov_19.418577	420	500	0	18	80	0.2250000
NODE_8185_length_928_cov_19.418577	420	500	2	62	80	0.7750000
NODE_8185_length_928_cov_19.418577	473	553	0	71	80	0.8875000
NODE_8185_length_928_cov_19.418577	473	553	2	9	80	0.1125000
NODE_8185_length_928_cov_19.418577	549	591	0	42	42	1.0000000
NODE_8186_length_928_cov_13.354644	323	403	0	80	80	1.0000000
NODE_8186_length_928_cov_13.354644	376	456	0	80	80	1.0000000
NODE_8187_length_928_cov_13.096502	361	441	0	80	80	1.0000000
NODE_8187_length_928_cov_13.096502	414	494	0	80	80	1.0000000
NODE_8189_length_928_cov_10.399276	447	527	0	11	80	0.1375000
NODE_8189_length_928_cov_10.399276	447	527	2	69	80	0.8625000
NODE_8189_length_928_cov_10.399276	500	580	0	34	80	0.4250000
NODE_8189_length_928_cov_10.399276	500	580	2	46	80	0.5750000
NODE_8207_length_927_cov_19.516908	398	478	0	80	80	1.0000000
NODE_8207_length_927_cov_19.516908	451	531	0	80	80	1.0000000
NODE_8208_length_927_cov_11.190821	358	438	0	80	80	1.0000000
NODE_8208_length_927_cov_11.190821	411	491	0	80	80	1.0000000
NODE_8209_length_927_cov_8.123188	239	319	0	80	80	1.0000000
NODE_8209_length_927_cov_8.123188	292	372	0	80	80	1.0000000
NODE_8210_length_927_cov_4.585749	515	595	0	80	80	1.0000000
NODE_8210_length_927_cov_4.585749	568	648	0	80	80	1.0000000
NODE_8222_length_927_cov_1.250000	626	706	0	80	80	1.0000000
NODE_8222_length_927_cov_1.250000	679	759	0	80	80	1.0000000
NODE_8227_length_926_cov_78.382104	433	513	0	18	80	0.2250000
NODE_8227_length_926_cov_78.382104	433	513	2	62	80	0.7750000
NODE_8227_length_926_cov_78.382104	486	566	0	71	80	0.8875000
NODE_8227_length_926_cov_78.382104	486	566	2	9	80	0.1125000
NODE_8228_length_926_cov_44.385732	383	463	0	80	80	1.0000000
NODE_8228_length_926_cov_44.385732	436	516	0	80	80	1.0000000
NODE_8229_length_926_cov_43.446191	362	442	0	80	80	1.0000000
NODE_8229_length_926_cov_43.446191	415	495	0	80	80	1.0000000
NODE_8229_length_926_cov_43.446191	491	571	0	80	80	1.0000000
NODE_8229_length_926_cov_43.446191	544	624	0	80	80	1.0000000
NODE_8230_length_926_cov_40.163241	42	61	8	19	19	1.0000000
NODE_8230_length_926_cov_40.163241	279	359	0	80	80	1.0000000
NODE_8230_length_926_cov_40.163241	332	412	0	80	80	1.0000000
NODE_8230_length_926_cov_40.163241	408	488	0	80	80	1.0000000
NODE_8230_length_926_cov_40.163241	461	541	0	80	80	1.0000000
NODE_8231_length_926_cov_29.923821	372	452	0	80	80	1.0000000
NODE_8231_length_926_cov_29.923821	425	505	0	80	80	1.0000000
NODE_8232_length_926_cov_24.657799	350	430	0	80	80	1.0000000
NODE_8232_length_926_cov_24.657799	403	483	0	80	80	1.0000000
NODE_8233_length_926_cov_17.438936	360	440	0	44	80	0.5500000
NODE_8233_length_926_cov_17.438936	360	440	2	36	80	0.4500000
NODE_8233_length_926_cov_17.438936	413	493	0	71	80	0.8875000
NODE_8233_length_926_cov_17.438936	413	493	2	9	80	0.1125000
NODE_8234_length_926_cov_12.413543	418	491	0	24	73	0.3287671
NODE_8234_length_926_cov_12.413543	418	491	4	9	73	0.1232877
NODE_8234_length_926_cov_12.413543	418	491	6	23	73	0.3150685
NODE_8234_length_926_cov_12.413543	418	491	8	17	73	0.2328767
NODE_8234_length_926_cov_12.413543	464	544	4	4	80	0.0500000
NODE_8234_length_926_cov_12.413543	464	544	6	10	80	0.1250000
NODE_8234_length_926_cov_12.413543	464	544	8	50	80	0.6250000
NODE_8234_length_926_cov_12.413543	464	544	10	16	80	0.2000000
NODE_8235_length_926_cov_5.771463	453	533	0	80	80	1.0000000
NODE_8235_length_926_cov_5.771463	505	586	0	81	81	1.0000000
NODE_8236_length_926_cov_5.209190	435	515	0	80	80	1.0000000
NODE_8236_length_926_cov_5.209190	488	568	0	80	80	1.0000000
NODE_8247_length_925_cov_40.767554	514	594	0	80	80	1.0000000
NODE_8247_length_925_cov_40.767554	567	647	0	80	80	1.0000000
NODE_8248_length_925_cov_30.226392	262	342	0	80	80	1.0000000
NODE_8248_length_925_cov_30.226392	315	395	0	80	80	1.0000000
NODE_8248_length_925_cov_30.226392	391	471	0	80	80	1.0000000
NODE_8248_length_925_cov_30.226392	444	524	0	80	80	1.0000000
NODE_8249_length_925_cov_22.075061	334	414	0	12	80	0.1500000
NODE_8249_length_925_cov_22.075061	334	414	6	68	80	0.8500000
NODE_8249_length_925_cov_22.075061	387	467	0	65	80	0.8125000
NODE_8249_length_925_cov_22.075061	387	467	6	15	80	0.1875000
NODE_8250_length_925_cov_18.164649	410	490	0	80	80	1.0000000
NODE_8250_length_925_cov_18.164649	464	543	0	79	79	1.0000000
NODE_8251_length_925_cov_14.067797	472	548	0	76	76	1.0000000
NODE_8251_length_925_cov_14.067797	525	601	0	76	76	1.0000000
NODE_8252_length_925_cov_7.098063	418	498	0	80	80	1.0000000
NODE_8252_length_925_cov_7.098063	471	551	0	80	80	1.0000000
NODE_8266_length_924_cov_61.292121	397	477	0	80	80	1.0000000
NODE_8266_length_924_cov_61.292121	450	530	0	80	80	1.0000000
NODE_8267_length_924_cov_31.522424	375	455	0	57	80	0.7125000
NODE_8267_length_924_cov_31.522424	375	455	5	5	80	0.0625000
NODE_8267_length_924_cov_31.522424	375	455	6	18	80	0.2250000
NODE_8267_length_924_cov_31.522424	428	508	0	4	80	0.0500000
NODE_8267_length_924_cov_31.522424	428	508	5	5	80	0.0625000
NODE_8267_length_924_cov_31.522424	428	508	6	71	80	0.8875000
NODE_8268_length_924_cov_30.446061	299	379	0	80	80	1.0000000
NODE_8268_length_924_cov_30.446061	352	432	0	80	80	1.0000000
NODE_8268_length_924_cov_30.446061	428	508	0	80	80	1.0000000
NODE_8268_length_924_cov_30.446061	481	561	0	80	80	1.0000000
NODE_8269_length_924_cov_28.877576	542	622	0	80	80	1.0000000
NODE_8269_length_924_cov_28.877576	595	675	0	80	80	1.0000000
NODE_8270_length_924_cov_27.261818	506	586	0	80	80	1.0000000
NODE_8270_length_924_cov_27.261818	559	639	0	47	80	0.5875000
NODE_8270_length_924_cov_27.261818	559	639	4	12	80	0.1500000
NODE_8270_length_924_cov_27.261818	559	639	6	21	80	0.2625000
NODE_8271_length_924_cov_25.946667	371	451	0	80	80	1.0000000
NODE_8271_length_924_cov_25.946667	424	504	0	80	80	1.0000000
NODE_8271_length_924_cov_25.946667	500	580	0	48	80	0.6000000
NODE_8271_length_924_cov_25.946667	500	580	2	32	80	0.4000000
NODE_8271_length_924_cov_25.946667	553	633	0	27	80	0.3375000
NODE_8271_length_924_cov_25.946667	553	633	2	53	80	0.6625000
NODE_8272_length_924_cov_25.113939	305	385	4	21	80	0.2625000
NODE_8272_length_924_cov_25.113939	305	385	8	59	80	0.7375000
NODE_8272_length_924_cov_25.113939	358	438	2	3	80	0.0375000
NODE_8272_length_924_cov_25.113939	358	438	4	59	80	0.7375000
NODE_8272_length_924_cov_25.113939	358	438	6	12	80	0.1500000
NODE_8272_length_924_cov_25.113939	358	438	8	6	80	0.0750000
NODE_8272_length_924_cov_25.113939	434	514	0	22	80	0.2750000
NODE_8272_length_924_cov_25.113939	434	514	2	57	80	0.7125000
NODE_8272_length_924_cov_25.113939	434	514	6	1	80	0.0125000
NODE_8272_length_924_cov_25.113939	487	567	0	75	80	0.9375000
NODE_8272_length_924_cov_25.113939	487	567	2	5	80	0.0625000
NODE_8273_length_924_cov_16.343030	481	561	0	68	80	0.8500000
NODE_8273_length_924_cov_16.343030	481	561	4	12	80	0.1500000
NODE_8273_length_924_cov_16.343030	534	614	0	15	80	0.1875000
NODE_8273_length_924_cov_16.343030	534	614	4	65	80	0.8125000
NODE_8274_length_924_cov_14.793939	299	379	0	80	80	1.0000000
NODE_8274_length_924_cov_14.793939	352	432	0	80	80	1.0000000
NODE_8275_length_924_cov_14.209697	485	562	0	77	77	1.0000000
NODE_8275_length_924_cov_14.209697	535	615	0	80	80	1.0000000
NODE_8276_length_924_cov_13.423030	287	367	0	80	80	1.0000000
NODE_8276_length_924_cov_13.423030	340	420	0	80	80	1.0000000
NODE_8277_length_924_cov_12.008485	237	307	0	70	70	1.0000000
NODE_8279_length_924_cov_8.619394	560	640	0	80	80	1.0000000
NODE_8279_length_924_cov_8.619394	613	693	0	80	80	1.0000000
NODE_8280_length_924_cov_4.640000	426	506	0	80	80	1.0000000
NODE_8280_length_924_cov_4.640000	479	559	0	80	80	1.0000000
NODE_8290_length_924_cov_1.467879	352	381	0	29	29	1.0000000
NODE_8296_length_924_cov_0.648485	830	890	0	10	60	0.1666667
NODE_8296_length_924_cov_0.648485	830	890	4	50	60	0.8333333
NODE_8296_length_924_cov_0.648485	863	924	0	6	61	0.0983607
NODE_8296_length_924_cov_0.648485	863	924	4	55	61	0.9016393
NODE_8297_length_923_cov_43.213592	371	451	0	80	80	1.0000000
NODE_8297_length_923_cov_43.213592	424	504	0	80	80	1.0000000
NODE_8297_length_923_cov_43.213592	500	580	0	80	80	1.0000000
NODE_8297_length_923_cov_43.213592	553	633	0	80	80	1.0000000
NODE_8298_length_923_cov_34.108010	370	450	0	80	80	1.0000000
NODE_8298_length_923_cov_34.108010	423	503	0	80	80	1.0000000
NODE_8299_length_923_cov_29.163835	392	472	0	46	80	0.5750000
NODE_8299_length_923_cov_29.163835	392	472	1	34	80	0.4250000
NODE_8299_length_923_cov_29.163835	445	525	1	46	80	0.5750000
NODE_8299_length_923_cov_29.163835	445	525	2	34	80	0.4250000
NODE_8300_length_923_cov_19.139563	375	455	0	80	80	1.0000000
NODE_8300_length_923_cov_19.139563	428	508	0	80	80	1.0000000
NODE_8301_length_923_cov_17.433252	512	592	0	80	80	1.0000000
NODE_8301_length_923_cov_17.433252	565	645	0	80	80	1.0000000
NODE_8302_length_923_cov_16.597087	279	359	0	80	80	1.0000000
NODE_8302_length_923_cov_16.597087	332	412	0	80	80	1.0000000
NODE_8303_length_923_cov_15.229369	446	526	0	80	80	1.0000000
NODE_8303_length_923_cov_15.229369	499	579	0	80	80	1.0000000
NODE_8304_length_923_cov_14.007282	304	349	0	45	45	1.0000000
NODE_8304_length_923_cov_14.007282	345	427	0	82	82	1.0000000
NODE_8304_length_923_cov_14.007282	397	480	0	83	83	1.0000000
NODE_8305_length_923_cov_6.500000	308	388	0	4	80	0.0500000
NODE_8305_length_923_cov_6.500000	308	388	2	4	80	0.0500000
NODE_8305_length_923_cov_6.500000	308	388	4	28	80	0.3500000
NODE_8305_length_923_cov_6.500000	308	388	6	44	80	0.5500000
NODE_8305_length_923_cov_6.500000	361	441	0	57	80	0.7125000
NODE_8305_length_923_cov_6.500000	361	441	4	23	80	0.2875000
NODE_8307_length_923_cov_6.115291	447	527	0	80	80	1.0000000
NODE_8307_length_923_cov_6.115291	500	580	0	80	80	1.0000000
NODE_8308_length_923_cov_5.351942	363	445	0	82	82	1.0000000
NODE_8308_length_923_cov_5.351942	365	445	0	80	80	1.0000000
NODE_8317_length_923_cov_1.059466	63	143	0	80	80	1.0000000
NODE_8320_length_922_cov_40.331713	243	289	41	1	46	0.0217391
NODE_8320_length_922_cov_40.331713	243	289	44	6	46	0.1304348
NODE_8320_length_922_cov_40.331713	243	289	45	4	46	0.0869565
NODE_8320_length_922_cov_40.331713	243	289	47	5	46	0.1086956
NODE_8320_length_922_cov_40.331713	243	289	48	5	46	0.1086956
NODE_8320_length_922_cov_40.331713	243	289	49	3	46	0.0652174
NODE_8320_length_922_cov_40.331713	243	289	50	2	46	0.0434783
NODE_8320_length_922_cov_40.331713	243	289	51	1	46	0.0217391
NODE_8320_length_922_cov_40.331713	243	289	52	3	46	0.0652174
NODE_8320_length_922_cov_40.331713	243	289	54	3	46	0.0652174
NODE_8320_length_922_cov_40.331713	243	289	56	2	46	0.0434783
NODE_8320_length_922_cov_40.331713	243	289	57	1	46	0.0217391
NODE_8320_length_922_cov_40.331713	243	289	59	2	46	0.0434783
NODE_8320_length_922_cov_40.331713	243	289	60	1	46	0.0217391
NODE_8320_length_922_cov_40.331713	243	289	61	1	46	0.0217391
NODE_8320_length_922_cov_40.331713	243	289	62	1	46	0.0217391
NODE_8320_length_922_cov_40.331713	243	289	65	1	46	0.0217391
NODE_8320_length_922_cov_40.331713	243	289	74	2	46	0.0434783
NODE_8320_length_922_cov_40.331713	243	289	75	2	46	0.0434783
NODE_8320_length_922_cov_40.331713	262	342	41	1	80	0.0125000
NODE_8320_length_922_cov_40.331713	262	342	44	6	80	0.0750000
NODE_8320_length_922_cov_40.331713	262	342	47	5	80	0.0625000
NODE_8320_length_922_cov_40.331713	262	342	49	3	80	0.0375000
NODE_8320_length_922_cov_40.331713	262	342	51	1	80	0.0125000
NODE_8320_length_922_cov_40.331713	262	342	57	1	80	0.0125000
NODE_8320_length_922_cov_40.331713	262	342	59	2	80	0.0250000
NODE_8320_length_922_cov_40.331713	262	342	60	1	80	0.0125000
NODE_8320_length_922_cov_40.331713	262	342	61	1	80	0.0125000
NODE_8320_length_922_cov_40.331713	262	342	62	1	80	0.0125000
NODE_8320_length_922_cov_40.331713	262	342	65	1	80	0.0125000
NODE_8320_length_922_cov_40.331713	262	342	70	2	80	0.0250000
NODE_8320_length_922_cov_40.331713	262	342	74	2	80	0.0250000
NODE_8320_length_922_cov_40.331713	262	342	75	2	80	0.0250000
NODE_8320_length_922_cov_40.331713	262	342	79	1	80	0.0125000
NODE_8320_length_922_cov_40.331713	262	342	80	1	80	0.0125000
NODE_8320_length_922_cov_40.331713	262	342	88	1	80	0.0125000
NODE_8320_length_922_cov_40.331713	262	342	90	1	80	0.0125000
NODE_8320_length_922_cov_40.331713	262	342	93	1	80	0.0125000
NODE_8320_length_922_cov_40.331713	262	342	95	1	80	0.0125000
NODE_8320_length_922_cov_40.331713	262	342	97	1	80	0.0125000
NODE_8320_length_922_cov_40.331713	262	342	98	1	80	0.0125000
NODE_8320_length_922_cov_40.331713	262	342	99	1	80	0.0125000
NODE_8320_length_922_cov_40.331713	262	342	102	1	80	0.0125000
NODE_8320_length_922_cov_40.331713	262	342	105	2	80	0.0250000
NODE_8320_length_922_cov_40.331713	262	342	106	3	80	0.0375000
NODE_8320_length_922_cov_40.331713	262	342	107	1	80	0.0125000
NODE_8320_length_922_cov_40.331713	262	342	109	2	80	0.0250000
NODE_8320_length_922_cov_40.331713	262	342	110	1	80	0.0125000
NODE_8320_length_922_cov_40.331713	262	342	117	1	80	0.0125000
NODE_8320_length_922_cov_40.331713	262	342	128	2	80	0.0250000
NODE_8320_length_922_cov_40.331713	262	342	132	1	80	0.0125000
NODE_8320_length_922_cov_40.331713	262	342	148	1	80	0.0125000
NODE_8320_length_922_cov_40.331713	262	342	153	1	80	0.0125000
NODE_8320_length_922_cov_40.331713	262	342	154	1	80	0.0125000
NODE_8320_length_922_cov_40.331713	262	342	161	1	80	0.0125000
NODE_8320_length_922_cov_40.331713	262	342	163	1	80	0.0125000
NODE_8320_length_922_cov_40.331713	262	342	170	1	80	0.0125000
NODE_8320_length_922_cov_40.331713	262	342	176	3	80	0.0375000
NODE_8320_length_922_cov_40.331713	262	342	179	1	80	0.0125000
NODE_8320_length_922_cov_40.331713	262	342	184	1	80	0.0125000
NODE_8320_length_922_cov_40.331713	262	342	186	1	80	0.0125000
NODE_8320_length_922_cov_40.331713	262	342	189	1	80	0.0125000
NODE_8320_length_922_cov_40.331713	262	342	191	2	80	0.0250000
NODE_8320_length_922_cov_40.331713	262	342	193	2	80	0.0250000
NODE_8320_length_922_cov_40.331713	262	342	196	1	80	0.0125000
NODE_8320_length_922_cov_40.331713	262	342	199	1	80	0.0125000
NODE_8320_length_922_cov_40.331713	262	342	204	1	80	0.0125000
NODE_8320_length_922_cov_40.331713	262	342	207	1	80	0.0125000
NODE_8320_length_922_cov_40.331713	262	342	210	3	80	0.0375000
NODE_8320_length_922_cov_40.331713	262	342	214	1	80	0.0125000
NODE_8320_length_922_cov_40.331713	262	342	218	1	80	0.0125000
NODE_8320_length_922_cov_40.331713	262	342	227	2	80	0.0250000
NODE_8320_length_922_cov_40.331713	780	860	0	80	80	1.0000000
NODE_8320_length_922_cov_40.331713	833	913	0	80	80	1.0000000
NODE_8321_length_922_cov_38.549210	126	177	75	2	51	0.0392157
NODE_8321_length_922_cov_38.549210	126	177	84	1	51	0.0196078
NODE_8321_length_922_cov_38.549210	126	177	88	1	51	0.0196078
NODE_8321_length_922_cov_38.549210	126	177	112	1	51	0.0196078
NODE_8321_length_922_cov_38.549210	126	177	114	1	51	0.0196078
NODE_8321_length_922_cov_38.549210	126	177	117	1	51	0.0196078
NODE_8321_length_922_cov_38.549210	126	177	121	1	51	0.0196078
NODE_8321_length_922_cov_38.549210	126	177	127	1	51	0.0196078
NODE_8321_length_922_cov_38.549210	126	177	129	1	51	0.0196078
NODE_8321_length_922_cov_38.549210	126	177	141	1	51	0.0196078
NODE_8321_length_922_cov_38.549210	126	177	144	1	51	0.0196078
NODE_8321_length_922_cov_38.549210	126	177	152	1	51	0.0196078
NODE_8321_length_922_cov_38.549210	126	177	157	1	51	0.0196078
NODE_8321_length_922_cov_38.549210	126	177	166	1	51	0.0196078
NODE_8321_length_922_cov_38.549210	126	177	174	2	51	0.0392157
NODE_8321_length_922_cov_38.549210	126	177	176	1	51	0.0196078
NODE_8321_length_922_cov_38.549210	126	177	186	5	51	0.0980392
NODE_8321_length_922_cov_38.549210	126	177	188	3	51	0.0588235
NODE_8321_length_922_cov_38.549210	126	177	192	3	51	0.0588235
NODE_8321_length_922_cov_38.549210	126	177	193	2	51	0.0392157
NODE_8321_length_922_cov_38.549210	126	177	197	2	51	0.0392157
NODE_8321_length_922_cov_38.549210	126	177	203	1	51	0.0196078
NODE_8321_length_922_cov_38.549210	126	177	217	1	51	0.0196078
NODE_8321_length_922_cov_38.549210	126	177	220	1	51	0.0196078
NODE_8321_length_922_cov_38.549210	126	177	224	1	51	0.0196078
NODE_8321_length_922_cov_38.549210	126	177	226	1	51	0.0196078
NODE_8321_length_922_cov_38.549210	126	177	227	1	51	0.0196078
NODE_8321_length_922_cov_38.549210	126	177	231	1	51	0.0196078
NODE_8321_length_922_cov_38.549210	126	177	233	3	51	0.0588235
NODE_8321_length_922_cov_38.549210	126	177	237	1	51	0.0196078
NODE_8321_length_922_cov_38.549210	126	177	242	1	51	0.0196078
NODE_8321_length_922_cov_38.549210	126	177	247	1	51	0.0196078
NODE_8321_length_922_cov_38.549210	126	177	249	1	51	0.0196078
NODE_8321_length_922_cov_38.549210	126	177	251	1	51	0.0196078
NODE_8321_length_922_cov_38.549210	126	177	260	1	51	0.0196078
NODE_8321_length_922_cov_38.549210	126	177	268	1	51	0.0196078
NODE_8321_length_922_cov_38.549210	126	177	271	1	51	0.0196078
NODE_8321_length_922_cov_38.549210	308	383	0	75	75	1.0000000
NODE_8321_length_922_cov_38.549210	356	393	0	37	37	1.0000000
NODE_8321_length_922_cov_38.549210	818	898	0	80	80	1.0000000
NODE_8321_length_922_cov_38.549210	871	908	0	37	37	1.0000000
NODE_8322_length_922_cov_35.041312	385	465	0	80	80	1.0000000
NODE_8322_length_922_cov_35.041312	438	518	0	80	80	1.0000000
NODE_8323_length_922_cov_30.749696	426	506	0	80	80	1.0000000
NODE_8323_length_922_cov_30.749696	479	559	0	80	80	1.0000000
NODE_8324_length_922_cov_25.558931	291	370	0	79	79	1.0000000
NODE_8324_length_922_cov_25.558931	344	423	0	72	79	0.9113924
NODE_8324_length_922_cov_25.558931	344	423	3	7	79	0.0886076
NODE_8325_length_922_cov_25.527339	391	471	0	80	80	1.0000000
NODE_8325_length_922_cov_25.527339	444	524	0	80	80	1.0000000
NODE_8326_length_922_cov_23.630620	224	304	0	80	80	1.0000000
NODE_8326_length_922_cov_23.630620	277	357	0	80	80	1.0000000
NODE_8326_length_922_cov_23.630620	353	433	0	80	80	1.0000000
NODE_8326_length_922_cov_23.630620	406	486	0	80	80	1.0000000
NODE_8327_length_922_cov_22.388821	465	545	0	80	80	1.0000000
NODE_8327_length_922_cov_22.388821	518	598	0	80	80	1.0000000
NODE_8328_length_922_cov_20.320778	421	501	0	80	80	1.0000000
NODE_8328_length_922_cov_20.320778	474	554	0	80	80	1.0000000
NODE_8329_length_922_cov_17.645200	413	479	0	2	66	0.0303030
NODE_8329_length_922_cov_17.645200	413	479	2	10	66	0.1515152
NODE_8329_length_922_cov_17.645200	413	479	4	54	66	0.8181818
NODE_8330_length_922_cov_12.574727	454	534	0	80	80	1.0000000
NODE_8330_length_922_cov_12.574727	507	587	0	80	80	1.0000000
NODE_8331_length_922_cov_11.934386	255	335	0	6	80	0.0750000
NODE_8331_length_922_cov_11.934386	255	335	2	42	80	0.5250000
NODE_8331_length_922_cov_11.934386	255	335	3	1	80	0.0125000
NODE_8331_length_922_cov_11.934386	255	335	4	31	80	0.3875000
NODE_8331_length_922_cov_11.934386	308	388	0	26	80	0.3250000
NODE_8331_length_922_cov_11.934386	308	388	4	54	80	0.6750000
NODE_8332_length_922_cov_11.068044	423	503	0	68	80	0.8500000
NODE_8332_length_922_cov_11.068044	423	503	2	12	80	0.1500000
NODE_8332_length_922_cov_11.068044	476	557	0	15	81	0.1851852
NODE_8332_length_922_cov_11.068044	476	557	2	66	81	0.8148148
NODE_8333_length_922_cov_7.907655	441	521	0	80	80	1.0000000
NODE_8333_length_922_cov_7.907655	494	574	0	80	80	1.0000000
NODE_8334_length_922_cov_7.737546	463	543	0	80	80	1.0000000
NODE_8334_length_922_cov_7.737546	516	596	0	80	80	1.0000000
NODE_8335_length_922_cov_7.241798	298	378	0	80	80	1.0000000
NODE_8335_length_922_cov_7.241798	351	431	0	80	80	1.0000000
NODE_8347_length_921_cov_21.317518	457	537	0	80	80	1.0000000
NODE_8347_length_921_cov_21.317518	510	590	0	80	80	1.0000000
NODE_8348_length_921_cov_18.462287	519	599	0	80	80	1.0000000
NODE_8348_length_921_cov_18.462287	572	652	0	80	80	1.0000000
NODE_8349_length_921_cov_15.440389	373	453	0	39	80	0.4875000
NODE_8349_length_921_cov_15.440389	373	453	2	41	80	0.5125000
NODE_8349_length_921_cov_15.440389	426	506	0	24	80	0.3000000
NODE_8349_length_921_cov_15.440389	426	506	2	56	80	0.7000000
NODE_8350_length_921_cov_13.216545	465	545	0	80	80	1.0000000
NODE_8350_length_921_cov_13.216545	518	598	0	80	80	1.0000000
NODE_8351_length_921_cov_9.283455	399	439	0	40	40	1.0000000
NODE_8351_length_921_cov_9.283455	532	612	0	80	80	1.0000000
NODE_8351_length_921_cov_9.283455	585	665	0	80	80	1.0000000
NODE_8352_length_921_cov_8.253041	289	369	0	80	80	1.0000000
NODE_8352_length_921_cov_8.253041	342	422	0	80	80	1.0000000
NODE_8364_length_920_cov_47.493301	543	623	0	80	80	1.0000000
NODE_8364_length_920_cov_47.493301	596	676	0	80	80	1.0000000
NODE_8365_length_920_cov_30.404385	543	623	0	80	80	1.0000000
NODE_8365_length_920_cov_30.404385	596	676	0	80	80	1.0000000
NODE_8366_length_920_cov_25.360536	413	493	0	25	80	0.3125000
NODE_8366_length_920_cov_25.360536	413	493	2	55	80	0.6875000
NODE_8366_length_920_cov_25.360536	466	546	0	72	80	0.9000000
NODE_8366_length_920_cov_25.360536	466	546	2	8	80	0.1000000
NODE_8366_length_920_cov_25.360536	542	615	0	71	73	0.9726027
NODE_8366_length_920_cov_25.360536	542	615	2	2	73	0.0273973
NODE_8366_length_920_cov_25.360536	588	668	0	25	80	0.3125000
NODE_8366_length_920_cov_25.360536	588	668	2	45	80	0.5625000
NODE_8366_length_920_cov_25.360536	588	668	4	10	80	0.1250000
NODE_8367_length_920_cov_24.918392	403	483	0	80	80	1.0000000
NODE_8367_length_920_cov_24.918392	456	536	0	80	80	1.0000000
NODE_8368_length_920_cov_18.517661	353	433	0	80	80	1.0000000
NODE_8368_length_920_cov_18.517661	406	486	0	80	80	1.0000000
NODE_8369_length_920_cov_17.710110	310	390	0	80	80	1.0000000
NODE_8369_length_920_cov_17.710110	363	443	0	80	80	1.0000000
NODE_8370_length_920_cov_15.650426	403	458	0	55	55	1.0000000
NODE_8371_length_920_cov_12.588307	454	534	0	80	80	1.0000000
NODE_8371_length_920_cov_12.588307	507	586	0	79	79	1.0000000
NODE_8372_length_920_cov_10.822168	354	434	0	80	80	1.0000000
NODE_8372_length_920_cov_10.822168	407	487	0	80	80	1.0000000
NODE_8374_length_920_cov_8.297199	453	533	0	80	80	1.0000000
NODE_8374_length_920_cov_8.297199	506	583	0	77	77	1.0000000
NODE_8378_length_920_cov_2.992692	501	581	0	80	80	1.0000000
NODE_8378_length_920_cov_2.992692	554	634	0	80	80	1.0000000
NODE_8389_length_919_cov_44.813415	338	418	0	55	80	0.6875000
NODE_8389_length_919_cov_44.813415	338	418	2	25	80	0.3125000
NODE_8389_length_919_cov_44.813415	391	471	0	80	80	1.0000000
NODE_8389_length_919_cov_44.813415	467	547	0	80	80	1.0000000
NODE_8389_length_919_cov_44.813415	520	600	0	80	80	1.0000000
NODE_8390_length_919_cov_37.459756	389	469	2	10	80	0.1250000
NODE_8390_length_919_cov_37.459756	389	469	4	25	80	0.3125000
NODE_8390_length_919_cov_37.459756	389	469	6	45	80	0.5625000
NODE_8390_length_919_cov_37.459756	442	522	0	47	80	0.5875000
NODE_8390_length_919_cov_37.459756	442	522	4	31	80	0.3875000
NODE_8390_length_919_cov_37.459756	442	522	6	2	80	0.0250000
NODE_8390_length_919_cov_37.459756	518	598	0	80	80	1.0000000
NODE_8390_length_919_cov_37.459756	571	651	0	80	80	1.0000000
NODE_8391_length_919_cov_35.002439	474	554	0	80	80	1.0000000
NODE_8391_length_919_cov_35.002439	527	607	0	80	80	1.0000000
NODE_8392_length_919_cov_29.935366	246	326	0	80	80	1.0000000
NODE_8392_length_919_cov_29.935366	299	379	0	80	80	1.0000000
NODE_8393_length_919_cov_28.190244	470	550	0	14	80	0.1750000
NODE_8393_length_919_cov_28.190244	470	550	2	66	80	0.8250000
NODE_8393_length_919_cov_28.190244	523	603	0	35	80	0.4375000
NODE_8393_length_919_cov_28.190244	523	603	1	1	80	0.0125000
NODE_8393_length_919_cov_28.190244	523	603	2	44	80	0.5500000
NODE_8394_length_919_cov_27.119512	454	534	0	80	80	1.0000000
NODE_8394_length_919_cov_27.119512	507	587	0	80	80	1.0000000
NODE_8395_length_919_cov_21.836585	545	625	8	75	80	0.9375000
NODE_8395_length_919_cov_21.836585	545	625	11	1	80	0.0125000
NODE_8395_length_919_cov_21.836585	545	625	12	4	80	0.0500000
NODE_8395_length_919_cov_21.836585	598	677	4	9	79	0.1139240
NODE_8395_length_919_cov_21.836585	598	677	8	65	79	0.8227848
NODE_8395_length_919_cov_21.836585	598	677	11	1	79	0.0126582
NODE_8395_length_919_cov_21.836585	598	677	12	4	79	0.0506329
NODE_8396_length_919_cov_17.442683	385	465	0	80	80	1.0000000
NODE_8396_length_919_cov_17.442683	438	518	0	80	80	1.0000000
NODE_8397_length_919_cov_16.685366	309	389	0	3	80	0.0375000
NODE_8397_length_919_cov_16.685366	309	389	2	14	80	0.1750000
NODE_8397_length_919_cov_16.685366	309	389	6	63	80	0.7875000
NODE_8397_length_919_cov_16.685366	362	442	0	9	80	0.1125000
NODE_8397_length_919_cov_16.685366	362	442	2	61	80	0.7625000
NODE_8397_length_919_cov_16.685366	362	442	6	10	80	0.1250000
NODE_8398_length_919_cov_14.013415	435	515	0	80	80	1.0000000
NODE_8398_length_919_cov_14.013415	488	568	0	80	80	1.0000000
NODE_8399_length_919_cov_12.013415	340	420	0	80	80	1.0000000
NODE_8399_length_919_cov_12.013415	393	473	0	80	80	1.0000000
NODE_8403_length_919_cov_3.529268	424	504	0	80	80	1.0000000
NODE_8403_length_919_cov_3.529268	477	557	0	80	80	1.0000000
NODE_8404_length_919_cov_3.200000	444	524	0	80	80	1.0000000
NODE_8404_length_919_cov_3.200000	497	577	0	79	80	0.9875000
NODE_8404_length_919_cov_3.200000	497	577	2	1	80	0.0125000
NODE_8415_length_918_cov_41.115995	387	467	0	76	80	0.9500000
NODE_8415_length_918_cov_41.115995	387	467	2	4	80	0.0500000
NODE_8415_length_918_cov_41.115995	440	520	0	23	80	0.2875000
NODE_8415_length_918_cov_41.115995	440	520	2	57	80	0.7125000
NODE_8416_length_918_cov_37.405372	427	507	0	80	80	1.0000000
NODE_8416_length_918_cov_37.405372	480	560	0	80	80	1.0000000
NODE_8417_length_918_cov_31.559219	289	369	0	80	80	1.0000000
NODE_8417_length_918_cov_31.559219	342	422	0	80	80	1.0000000
NODE_8417_length_918_cov_31.559219	418	498	0	80	80	1.0000000
NODE_8417_length_918_cov_31.559219	471	551	0	80	80	1.0000000
NODE_8418_length_918_cov_25.195360	429	509	0	20	80	0.2500000
NODE_8418_length_918_cov_25.195360	429	509	1	1	80	0.0125000
NODE_8418_length_918_cov_25.195360	429	509	2	15	80	0.1875000
NODE_8418_length_918_cov_25.195360	429	509	3	39	80	0.4875000
NODE_8418_length_918_cov_25.195360	429	509	4	5	80	0.0625000
NODE_8418_length_918_cov_25.195360	482	562	0	30	80	0.3750000
NODE_8418_length_918_cov_25.195360	482	562	3	45	80	0.5625000
NODE_8418_length_918_cov_25.195360	482	562	4	5	80	0.0625000
NODE_8420_length_918_cov_10.537241	361	441	0	80	80	1.0000000
NODE_8420_length_918_cov_10.537241	414	492	0	78	78	1.0000000
NODE_8421_length_918_cov_9.821734	283	363	0	80	80	1.0000000
NODE_8421_length_918_cov_9.821734	336	416	0	80	80	1.0000000
NODE_8422_length_918_cov_9.714286	365	445	0	80	80	1.0000000
NODE_8422_length_918_cov_9.714286	418	498	0	80	80	1.0000000
NODE_8441_length_917_cov_38.845966	405	476	0	71	71	1.0000000
NODE_8441_length_917_cov_38.845966	458	538	0	80	80	1.0000000
NODE_8442_length_917_cov_37.775061	505	585	0	80	80	1.0000000
NODE_8442_length_917_cov_37.775061	558	638	0	80	80	1.0000000
NODE_8443_length_917_cov_33.195599	335	415	0	61	80	0.7625000
NODE_8443_length_917_cov_33.195599	335	415	2	13	80	0.1625000
NODE_8443_length_917_cov_33.195599	335	415	4	6	80	0.0750000
NODE_8443_length_917_cov_33.195599	388	468	0	8	80	0.1000000
NODE_8443_length_917_cov_33.195599	388	468	2	13	80	0.1625000
NODE_8443_length_917_cov_33.195599	388	468	4	59	80	0.7375000
NODE_8443_length_917_cov_33.195599	464	544	4	80	80	1.0000000
NODE_8443_length_917_cov_33.195599	517	597	0	38	80	0.4750000
NODE_8443_length_917_cov_33.195599	517	597	2	13	80	0.1625000
NODE_8443_length_917_cov_33.195599	517	597	4	29	80	0.3625000
NODE_8444_length_917_cov_22.871638	463	543	0	80	80	1.0000000
NODE_8444_length_917_cov_22.871638	516	593	0	77	77	1.0000000
NODE_8445_length_917_cov_16.899756	321	401	0	80	80	1.0000000
NODE_8445_length_917_cov_16.899756	374	454	0	80	80	1.0000000
NODE_8446_length_917_cov_12.283619	397	477	0	14	80	0.1750000
NODE_8446_length_917_cov_12.283619	397	477	6	66	80	0.8250000
NODE_8446_length_917_cov_12.283619	450	530	0	48	80	0.6000000
NODE_8446_length_917_cov_12.283619	450	530	2	2	80	0.0250000
NODE_8446_length_917_cov_12.283619	450	530	4	17	80	0.2125000
NODE_8446_length_917_cov_12.283619	450	530	6	13	80	0.1625000
NODE_8447_length_917_cov_12.172372	380	460	2	32	80	0.4000000
NODE_8447_length_917_cov_12.172372	380	460	4	39	80	0.4875000
NODE_8447_length_917_cov_12.172372	380	460	6	9	80	0.1125000
NODE_8447_length_917_cov_12.172372	433	513	2	30	80	0.3750000
NODE_8447_length_917_cov_12.172372	433	513	5	2	80	0.0250000
NODE_8447_length_917_cov_12.172372	433	513	6	25	80	0.3125000
NODE_8447_length_917_cov_12.172372	433	513	7	22	80	0.2750000
NODE_8447_length_917_cov_12.172372	433	513	8	1	80	0.0125000
NODE_8447_length_917_cov_12.172372	545	597	0	20	52	0.3846154
NODE_8447_length_917_cov_12.172372	545	597	4	1	52	0.0192308
NODE_8447_length_917_cov_12.172372	545	597	5	31	52	0.5961539
NODE_8448_length_917_cov_8.277506	564	644	0	80	80	1.0000000
NODE_8448_length_917_cov_8.277506	617	697	0	80	80	1.0000000
NODE_8449_length_917_cov_8.145477	155	235	0	80	80	1.0000000
NODE_8449_length_917_cov_8.145477	208	288	0	80	80	1.0000000
NODE_8451_length_917_cov_6.073350	366	446	0	56	80	0.7000000
NODE_8451_length_917_cov_6.073350	366	446	1	12	80	0.1500000
NODE_8451_length_917_cov_6.073350	366	446	2	12	80	0.1500000
NODE_8451_length_917_cov_6.073350	419	499	0	3	80	0.0375000
NODE_8451_length_917_cov_6.073350	419	499	1	12	80	0.1500000
NODE_8451_length_917_cov_6.073350	419	499	2	65	80	0.8125000
NODE_8463_length_916_cov_32.867809	347	427	0	80	80	1.0000000
NODE_8463_length_916_cov_32.867809	400	480	0	80	80	1.0000000
NODE_8464_length_916_cov_27.673195	450	530	0	13	80	0.1625000
NODE_8464_length_916_cov_27.673195	450	530	4	67	80	0.8375000
NODE_8464_length_916_cov_27.673195	503	583	0	66	80	0.8250000
NODE_8464_length_916_cov_27.673195	503	583	4	14	80	0.1750000
NODE_8465_length_916_cov_27.146879	223	303	0	80	80	1.0000000
NODE_8465_length_916_cov_27.146879	276	356	0	80	80	1.0000000
NODE_8466_length_916_cov_25.604651	398	478	0	80	80	1.0000000
NODE_8466_length_916_cov_25.604651	451	531	0	80	80	1.0000000
NODE_8467_length_916_cov_18.035496	456	536	0	80	80	1.0000000
NODE_8467_length_916_cov_18.035496	509	589	0	80	80	1.0000000
NODE_8468_length_916_cov_12.651163	500	580	6	80	80	1.0000000
NODE_8468_length_916_cov_12.651163	553	633	0	50	80	0.6250000
NODE_8468_length_916_cov_12.651163	553	633	6	30	80	0.3750000
NODE_8469_length_916_cov_11.337821	530	610	0	80	80	1.0000000
NODE_8469_length_916_cov_11.337821	583	663	0	80	80	1.0000000
NODE_8470_length_916_cov_9.640147	293	373	0	29	80	0.3625000
NODE_8470_length_916_cov_9.640147	293	373	2	51	80	0.6375000
NODE_8470_length_916_cov_9.640147	346	426	0	33	80	0.4125000
NODE_8470_length_916_cov_9.640147	346	426	2	47	80	0.5875000
NODE_8472_length_916_cov_8.042840	426	506	0	80	80	1.0000000
NODE_8472_length_916_cov_8.042840	479	559	0	80	80	1.0000000
NODE_8473_length_916_cov_7.123623	785	847	2	3	62	0.0483871
NODE_8473_length_916_cov_7.123623	785	847	4	5	62	0.0806452
NODE_8473_length_916_cov_7.123623	785	847	6	6	62	0.0967742
NODE_8473_length_916_cov_7.123623	785	847	10	1	62	0.0161290
NODE_8473_length_916_cov_7.123623	785	847	12	1	62	0.0161290
NODE_8473_length_916_cov_7.123623	785	847	16	2	62	0.0322581
NODE_8473_length_916_cov_7.123623	785	847	18	44	62	0.7096774
NODE_8473_length_916_cov_7.123623	820	900	16	2	80	0.0250000
NODE_8473_length_916_cov_7.123623	820	900	18	78	80	0.9750000
NODE_8481_length_915_cov_59.289216	398	478	0	80	80	1.0000000
NODE_8481_length_915_cov_59.289216	451	531	0	80	80	1.0000000
NODE_8481_length_915_cov_59.289216	527	607	0	30	80	0.3750000
NODE_8481_length_915_cov_59.289216	527	607	9	9	80	0.1125000
NODE_8481_length_915_cov_59.289216	527	607	10	41	80	0.5125000
NODE_8481_length_915_cov_59.289216	580	660	0	34	80	0.4250000
NODE_8481_length_915_cov_59.289216	580	660	9	28	80	0.3500000
NODE_8481_length_915_cov_59.289216	580	660	10	18	80	0.2250000
NODE_8482_length_915_cov_45.104167	153	228	0	75	75	1.0000000
NODE_8482_length_915_cov_45.104167	206	286	0	80	80	1.0000000
NODE_8482_length_915_cov_45.104167	282	362	0	80	80	1.0000000
NODE_8482_length_915_cov_45.104167	335	415	0	80	80	1.0000000
NODE_8483_length_915_cov_37.599265	397	477	0	80	80	1.0000000
NODE_8483_length_915_cov_37.599265	450	530	0	80	80	1.0000000
NODE_8485_length_915_cov_20.458333	297	377	0	38	80	0.4750000
NODE_8485_length_915_cov_20.458333	297	377	2	42	80	0.5250000
NODE_8485_length_915_cov_20.458333	350	430	0	80	80	1.0000000
NODE_8485_length_915_cov_20.458333	426	506	0	80	80	1.0000000
NODE_8485_length_915_cov_20.458333	479	559	0	80	80	1.0000000
NODE_8486_length_915_cov_14.397059	175	255	0	80	80	1.0000000
NODE_8486_length_915_cov_14.397059	228	308	0	80	80	1.0000000
NODE_8487_length_915_cov_8.741422	295	375	4	1	80	0.0125000
NODE_8487_length_915_cov_8.741422	295	375	6	79	80	0.9875000
NODE_8487_length_915_cov_8.741422	348	428	0	8	80	0.1000000
NODE_8487_length_915_cov_8.741422	348	428	4	25	80	0.3125000
NODE_8487_length_915_cov_8.741422	348	428	6	47	80	0.5875000
NODE_8488_length_915_cov_7.719363	823	894	0	35	71	0.4929577
NODE_8488_length_915_cov_7.719363	823	894	1	15	71	0.2112676
NODE_8488_length_915_cov_7.719363	823	894	15	3	71	0.0422535
NODE_8488_length_915_cov_7.719363	823	894	16	18	71	0.2535211
NODE_8488_length_915_cov_7.719363	828	894	0	35	66	0.5303030
NODE_8488_length_915_cov_7.719363	828	894	1	15	66	0.2272727
NODE_8488_length_915_cov_7.719363	828	894	15	3	66	0.0454545
NODE_8488_length_915_cov_7.719363	828	894	16	13	66	0.1969697
NODE_8488_length_915_cov_7.719363	867	915	0	48	48	1.0000000
NODE_8488_length_915_cov_7.719363	867	915	0	48	48	1.0000000
NODE_8488_length_915_cov_7.719363	867	915	0	48	48	1.0000000
NODE_8489_length_915_cov_7.648284	370	450	0	80	80	1.0000000
NODE_8489_length_915_cov_7.648284	423	503	0	80	80	1.0000000
NODE_8490_length_915_cov_6.848039	434	514	0	80	80	1.0000000
NODE_8490_length_915_cov_6.848039	487	567	0	80	80	1.0000000
NODE_8497_length_915_cov_2.011029	24	99	0	24	75	0.3200000
NODE_8497_length_915_cov_2.011029	24	99	2	51	75	0.6800000
NODE_8505_length_914_cov_89.814724	0	41	10	2	41	0.0487805
NODE_8505_length_914_cov_89.814724	0	41	12	1	41	0.0243902
NODE_8505_length_914_cov_89.814724	0	41	14	1	41	0.0243902
NODE_8505_length_914_cov_89.814724	0	41	22	1	41	0.0243902
NODE_8505_length_914_cov_89.814724	0	41	24	1	41	0.0243902
NODE_8505_length_914_cov_89.814724	0	41	26	1	41	0.0243902
NODE_8505_length_914_cov_89.814724	0	41	28	1	41	0.0243902
NODE_8505_length_914_cov_89.814724	0	41	38	2	41	0.0487805
NODE_8505_length_914_cov_89.814724	0	41	42	1	41	0.0243902
NODE_8505_length_914_cov_89.814724	0	41	58	1	41	0.0243902
NODE_8505_length_914_cov_89.814724	0	41	66	1	41	0.0243902
NODE_8505_length_914_cov_89.814724	0	41	98	1	41	0.0243902
NODE_8505_length_914_cov_89.814724	0	41	105	1	41	0.0243902
NODE_8505_length_914_cov_89.814724	0	41	121	2	41	0.0487805
NODE_8505_length_914_cov_89.814724	0	41	123	2	41	0.0487805
NODE_8505_length_914_cov_89.814724	0	41	126	3	41	0.0731707
NODE_8505_length_914_cov_89.814724	0	41	128	1	41	0.0243902
NODE_8505_length_914_cov_89.814724	0	41	139	1	41	0.0243902
NODE_8505_length_914_cov_89.814724	0	41	142	1	41	0.0243902
NODE_8505_length_914_cov_89.814724	0	41	192	3	41	0.0731707
NODE_8505_length_914_cov_89.814724	0	41	194	6	41	0.1463415
NODE_8505_length_914_cov_89.814724	0	41	198	1	41	0.0243902
NODE_8505_length_914_cov_89.814724	0	41	202	4	41	0.0975610
NODE_8505_length_914_cov_89.814724	0	41	205	1	41	0.0243902
NODE_8505_length_914_cov_89.814724	0	41	208	1	41	0.0243902
NODE_8505_length_914_cov_89.814724	19	94	126	3	75	0.0400000
NODE_8505_length_914_cov_89.814724	19	94	128	1	75	0.0133333
NODE_8505_length_914_cov_89.814724	19	94	139	1	75	0.0133333
NODE_8505_length_914_cov_89.814724	19	94	142	1	75	0.0133333
NODE_8505_length_914_cov_89.814724	19	94	192	3	75	0.0400000
NODE_8505_length_914_cov_89.814724	19	94	194	6	75	0.0800000
NODE_8505_length_914_cov_89.814724	19	94	198	1	75	0.0133333
NODE_8505_length_914_cov_89.814724	19	94	202	4	75	0.0533333
NODE_8505_length_914_cov_89.814724	19	94	205	1	75	0.0133333
NODE_8505_length_914_cov_89.814724	19	94	208	1	75	0.0133333
NODE_8505_length_914_cov_89.814724	19	94	217	1	75	0.0133333
NODE_8505_length_914_cov_89.814724	19	94	223	3	75	0.0400000
NODE_8505_length_914_cov_89.814724	19	94	230	1	75	0.0133333
NODE_8505_length_914_cov_89.814724	19	94	233	1	75	0.0133333
NODE_8505_length_914_cov_89.814724	19	94	237	1	75	0.0133333
NODE_8505_length_914_cov_89.814724	19	94	246	1	75	0.0133333
NODE_8505_length_914_cov_89.814724	19	94	248	5	75	0.0666667
NODE_8505_length_914_cov_89.814724	19	94	249	1	75	0.0133333
NODE_8505_length_914_cov_89.814724	19	94	251	4	75	0.0533333
NODE_8505_length_914_cov_89.814724	19	94	252	1	75	0.0133333
NODE_8505_length_914_cov_89.814724	19	94	255	7	75	0.0933333
NODE_8505_length_914_cov_89.814724	19	94	257	4	75	0.0533333
NODE_8505_length_914_cov_89.814724	19	94	260	1	75	0.0133333
NODE_8505_length_914_cov_89.814724	19	94	262	1	75	0.0133333
NODE_8505_length_914_cov_89.814724	19	94	264	1	75	0.0133333
NODE_8505_length_914_cov_89.814724	19	94	265	1	75	0.0133333
NODE_8505_length_914_cov_89.814724	19	94	266	2	75	0.0266667
NODE_8505_length_914_cov_89.814724	19	94	268	8	75	0.1066667
NODE_8505_length_914_cov_89.814724	19	94	270	1	75	0.0133333
NODE_8505_length_914_cov_89.814724	19	94	273	1	75	0.0133333
NODE_8505_length_914_cov_89.814724	19	94	275	1	75	0.0133333
NODE_8505_length_914_cov_89.814724	19	94	276	3	75	0.0400000
NODE_8505_length_914_cov_89.814724	19	94	278	2	75	0.0266667
NODE_8505_length_914_cov_89.814724	19	94	280	1	75	0.0133333
NODE_8506_length_914_cov_33.755828	400	480	0	80	80	1.0000000
NODE_8506_length_914_cov_33.755828	453	533	0	80	80	1.0000000
NODE_8507_length_914_cov_31.557055	368	448	2	54	80	0.6750000
NODE_8507_length_914_cov_31.557055	368	448	4	26	80	0.3250000
NODE_8507_length_914_cov_31.557055	421	501	0	16	80	0.2000000
NODE_8507_length_914_cov_31.557055	421	501	2	37	80	0.4625000
NODE_8507_length_914_cov_31.557055	421	501	4	27	80	0.3375000
NODE_8508_length_914_cov_29.087117	331	411	2	41	80	0.5125000
NODE_8508_length_914_cov_29.087117	331	411	6	39	80	0.4875000
NODE_8508_length_914_cov_29.087117	384	464	0	30	80	0.3750000
NODE_8508_length_914_cov_29.087117	384	464	4	11	80	0.1375000
NODE_8508_length_914_cov_29.087117	384	464	5	9	80	0.1125000
NODE_8508_length_914_cov_29.087117	384	464	6	30	80	0.3750000
NODE_8509_length_914_cov_28.490798	273	353	0	80	80	1.0000000
NODE_8509_length_914_cov_28.490798	326	406	0	80	80	1.0000000
NODE_8509_length_914_cov_28.490798	402	482	0	80	80	1.0000000
NODE_8509_length_914_cov_28.490798	455	535	0	80	80	1.0000000
NODE_8510_length_914_cov_25.429448	393	473	0	80	80	1.0000000
NODE_8510_length_914_cov_25.429448	446	526	0	80	80	1.0000000
NODE_8510_length_914_cov_25.429448	522	602	0	80	80	1.0000000
NODE_8510_length_914_cov_25.429448	575	655	0	80	80	1.0000000
NODE_8511_length_914_cov_19.111656	354	434	1	44	80	0.5500000
NODE_8511_length_914_cov_19.111656	354	434	2	36	80	0.4500000
NODE_8511_length_914_cov_19.111656	407	487	2	80	80	1.0000000
NODE_8512_length_914_cov_13.423313	603	683	0	68	80	0.8500000
NODE_8512_length_914_cov_13.423313	603	683	2	12	80	0.1500000
NODE_8512_length_914_cov_13.423313	656	736	0	15	80	0.1875000
NODE_8512_length_914_cov_13.423313	656	736	2	65	80	0.8125000
NODE_8513_length_914_cov_10.947239	341	411	0	70	70	1.0000000
NODE_8513_length_914_cov_10.947239	384	464	0	57	80	0.7125000
NODE_8513_length_914_cov_10.947239	384	464	2	23	80	0.2875000
NODE_8518_length_914_cov_1.931288	833	873	0	40	40	1.0000000
NODE_8526_length_913_cov_49.665848	31	111	57	1	80	0.0125000
NODE_8526_length_913_cov_49.665848	31	111	59	1	80	0.0125000
NODE_8526_length_913_cov_49.665848	31	111	64	2	80	0.0250000
NODE_8526_length_913_cov_49.665848	31	111	70	1	80	0.0125000
NODE_8526_length_913_cov_49.665848	31	111	72	1	80	0.0125000
NODE_8526_length_913_cov_49.665848	31	111	76	1	80	0.0125000
NODE_8526_length_913_cov_49.665848	31	111	82	1	80	0.0125000
NODE_8526_length_913_cov_49.665848	31	111	84	1	80	0.0125000
NODE_8526_length_913_cov_49.665848	31	111	88	7	80	0.0875000
NODE_8526_length_913_cov_49.665848	31	111	90	6	80	0.0750000
NODE_8526_length_913_cov_49.665848	31	111	94	1	80	0.0125000
NODE_8526_length_913_cov_49.665848	31	111	96	4	80	0.0500000
NODE_8526_length_913_cov_49.665848	31	111	98	1	80	0.0125000
NODE_8526_length_913_cov_49.665848	31	111	100	1	80	0.0125000
NODE_8526_length_913_cov_49.665848	31	111	104	2	80	0.0250000
NODE_8526_length_913_cov_49.665848	31	111	110	2	80	0.0250000
NODE_8526_length_913_cov_49.665848	31	111	112	1	80	0.0125000
NODE_8526_length_913_cov_49.665848	31	111	113	1	80	0.0125000
NODE_8526_length_913_cov_49.665848	31	111	115	1	80	0.0125000
NODE_8526_length_913_cov_49.665848	31	111	119	2	80	0.0250000
NODE_8526_length_913_cov_49.665848	31	111	120	1	80	0.0125000
NODE_8526_length_913_cov_49.665848	31	111	122	5	80	0.0625000
NODE_8526_length_913_cov_49.665848	31	111	123	3	80	0.0375000
NODE_8526_length_913_cov_49.665848	31	111	124	1	80	0.0125000
NODE_8526_length_913_cov_49.665848	31	111	126	2	80	0.0250000
NODE_8526_length_913_cov_49.665848	31	111	128	17	80	0.2125000
NODE_8526_length_913_cov_49.665848	31	111	129	2	80	0.0250000
NODE_8526_length_913_cov_49.665848	31	111	131	4	80	0.0500000
NODE_8526_length_913_cov_49.665848	31	111	132	1	80	0.0125000
NODE_8526_length_913_cov_49.665848	31	111	134	3	80	0.0375000
NODE_8526_length_913_cov_49.665848	31	111	136	2	80	0.0250000
NODE_8526_length_913_cov_49.665848	31	111	137	1	80	0.0125000
NODE_8526_length_913_cov_49.665848	136	155	95	5	19	0.2631579
NODE_8526_length_913_cov_49.665848	136	155	96	1	19	0.0526316
NODE_8526_length_913_cov_49.665848	136	155	97	2	19	0.1052632
NODE_8526_length_913_cov_49.665848	136	155	98	1	19	0.0526316
NODE_8526_length_913_cov_49.665848	136	155	100	3	19	0.1578947
NODE_8526_length_913_cov_49.665848	136	155	101	2	19	0.1052632
NODE_8526_length_913_cov_49.665848	136	155	102	2	19	0.1052632
NODE_8526_length_913_cov_49.665848	136	155	103	3	19	0.1578947
NODE_8527_length_913_cov_47.115479	367	447	0	80	80	1.0000000
NODE_8527_length_913_cov_47.115479	420	500	0	80	80	1.0000000
NODE_8528_length_913_cov_36.541769	502	582	0	80	80	1.0000000
NODE_8528_length_913_cov_36.541769	555	635	0	80	80	1.0000000
NODE_8529_length_913_cov_33.679361	433	513	0	80	80	1.0000000
NODE_8529_length_913_cov_33.679361	486	566	0	80	80	1.0000000
NODE_8530_length_913_cov_29.675676	408	488	0	80	80	1.0000000
NODE_8530_length_913_cov_29.675676	461	541	0	80	80	1.0000000
NODE_8531_length_913_cov_24.901720	342	422	0	80	80	1.0000000
NODE_8531_length_913_cov_24.901720	395	475	0	80	80	1.0000000
NODE_8532_length_913_cov_24.625307	396	476	0	80	80	1.0000000
NODE_8532_length_913_cov_24.625307	449	529	0	80	80	1.0000000
NODE_8533_length_913_cov_15.094595	525	589	0	64	64	1.0000000
NODE_8533_length_913_cov_15.094595	562	642	0	80	80	1.0000000
NODE_8534_length_913_cov_8.633907	305	385	0	80	80	1.0000000
NODE_8534_length_913_cov_8.633907	358	429	0	71	71	1.0000000
NODE_8546_length_912_cov_25.110701	419	499	0	80	80	1.0000000
NODE_8546_length_912_cov_25.110701	472	552	0	53	80	0.6625000
NODE_8546_length_912_cov_25.110701	472	552	2	27	80	0.3375000
NODE_8547_length_912_cov_20.045510	306	386	6	14	80	0.1750000
NODE_8547_length_912_cov_20.045510	306	386	10	66	80	0.8250000
NODE_8547_length_912_cov_20.045510	359	439	0	2	80	0.0250000
NODE_8547_length_912_cov_20.045510	359	439	4	32	80	0.4000000
NODE_8547_length_912_cov_20.045510	359	439	10	46	80	0.5750000
NODE_8548_length_912_cov_19.635916	326	406	0	80	80	1.0000000
NODE_8548_length_912_cov_19.635916	379	459	0	80	80	1.0000000
NODE_8549_length_912_cov_17.714637	395	475	0	80	80	1.0000000
NODE_8549_length_912_cov_17.714637	448	528	0	80	80	1.0000000
NODE_8550_length_912_cov_15.546125	355	435	0	33	80	0.4125000
NODE_8550_length_912_cov_15.546125	355	435	8	36	80	0.4500000
NODE_8550_length_912_cov_15.546125	355	435	10	11	80	0.1375000
NODE_8550_length_912_cov_15.546125	408	488	8	16	80	0.2000000
NODE_8550_length_912_cov_15.546125	408	488	10	64	80	0.8000000
NODE_8551_length_912_cov_15.077491	255	291	0	36	36	1.0000000
NODE_8551_length_912_cov_15.077491	264	328	0	64	64	1.0000000
NODE_8551_length_912_cov_15.077491	415	495	0	80	80	1.0000000
NODE_8551_length_912_cov_15.077491	468	548	0	80	80	1.0000000
NODE_8552_length_912_cov_15.023370	361	441	0	79	80	0.9875000
NODE_8552_length_912_cov_15.023370	361	441	2	1	80	0.0125000
NODE_8552_length_912_cov_15.023370	414	494	0	26	80	0.3250000
NODE_8552_length_912_cov_15.023370	414	494	2	54	80	0.6750000
NODE_8553_length_912_cov_13.600246	61	141	0	80	80	1.0000000
NODE_8553_length_912_cov_13.600246	460	540	0	74	80	0.9250000
NODE_8553_length_912_cov_13.600246	460	540	2	6	80	0.0750000
NODE_8553_length_912_cov_13.600246	513	593	0	23	80	0.2875000
NODE_8553_length_912_cov_13.600246	513	593	2	57	80	0.7125000
NODE_8554_length_912_cov_13.113161	385	465	0	80	80	1.0000000
NODE_8554_length_912_cov_13.113161	438	518	0	80	80	1.0000000
NODE_8555_length_912_cov_11.110701	353	433	0	80	80	1.0000000
NODE_8555_length_912_cov_11.110701	406	486	0	80	80	1.0000000
NODE_8555_length_912_cov_11.110701	827	907	0	80	80	1.0000000
NODE_8555_length_912_cov_11.110701	831	854	0	23	23	1.0000000
NODE_8584_length_911_cov_173.171182	580	660	455	1	80	0.0125000
NODE_8584_length_911_cov_173.171182	580	660	457	1	80	0.0125000
NODE_8584_length_911_cov_173.171182	580	660	460	1	80	0.0125000
NODE_8584_length_911_cov_173.171182	580	660	466	1	80	0.0125000
NODE_8584_length_911_cov_173.171182	580	660	469	1	80	0.0125000
NODE_8584_length_911_cov_173.171182	580	660	472	1	80	0.0125000
NODE_8584_length_911_cov_173.171182	580	660	473	1	80	0.0125000
NODE_8584_length_911_cov_173.171182	580	660	477	1	80	0.0125000
NODE_8584_length_911_cov_173.171182	580	660	488	1	80	0.0125000
NODE_8584_length_911_cov_173.171182	580	660	489	1	80	0.0125000
NODE_8584_length_911_cov_173.171182	580	660	503	1	80	0.0125000
NODE_8584_length_911_cov_173.171182	580	660	519	1	80	0.0125000
NODE_8584_length_911_cov_173.171182	580	660	533	1	80	0.0125000
NODE_8584_length_911_cov_173.171182	580	660	534	1	80	0.0125000
NODE_8584_length_911_cov_173.171182	580	660	543	1	80	0.0125000
NODE_8584_length_911_cov_173.171182	580	660	544	1	80	0.0125000
NODE_8584_length_911_cov_173.171182	580	660	550	1	80	0.0125000
NODE_8584_length_911_cov_173.171182	580	660	562	2	80	0.0250000
NODE_8584_length_911_cov_173.171182	580	660	564	2	80	0.0250000
NODE_8584_length_911_cov_173.171182	580	660	565	1	80	0.0125000
NODE_8584_length_911_cov_173.171182	580	660	571	1	80	0.0125000
NODE_8584_length_911_cov_173.171182	580	660	577	1	80	0.0125000
NODE_8584_length_911_cov_173.171182	580	660	579	1	80	0.0125000
NODE_8584_length_911_cov_173.171182	580	660	586	1	80	0.0125000
NODE_8584_length_911_cov_173.171182	580	660	590	1	80	0.0125000
NODE_8584_length_911_cov_173.171182	580	660	593	2	80	0.0250000
NODE_8584_length_911_cov_173.171182	580	660	596	1	80	0.0125000
NODE_8584_length_911_cov_173.171182	580	660	605	1	80	0.0125000
NODE_8584_length_911_cov_173.171182	580	660	609	1	80	0.0125000
NODE_8584_length_911_cov_173.171182	580	660	628	2	80	0.0250000
NODE_8584_length_911_cov_173.171182	580	660	635	1	80	0.0125000
NODE_8584_length_911_cov_173.171182	580	660	646	1	80	0.0125000
NODE_8584_length_911_cov_173.171182	580	660	660	1	80	0.0125000
NODE_8584_length_911_cov_173.171182	580	660	661	1	80	0.0125000
NODE_8584_length_911_cov_173.171182	580	660	664	1	80	0.0125000
NODE_8584_length_911_cov_173.171182	580	660	665	2	80	0.0250000
NODE_8584_length_911_cov_173.171182	580	660	666	2	80	0.0250000
NODE_8584_length_911_cov_173.171182	580	660	667	1	80	0.0125000
NODE_8584_length_911_cov_173.171182	580	660	668	1	80	0.0125000
NODE_8584_length_911_cov_173.171182	580	660	676	1	80	0.0125000
NODE_8584_length_911_cov_173.171182	580	660	684	1	80	0.0125000
NODE_8584_length_911_cov_173.171182	580	660	695	1	80	0.0125000
NODE_8584_length_911_cov_173.171182	580	660	705	1	80	0.0125000
NODE_8584_length_911_cov_173.171182	580	660	713	1	80	0.0125000
NODE_8584_length_911_cov_173.171182	580	660	720	1	80	0.0125000
NODE_8584_length_911_cov_173.171182	580	660	721	5	80	0.0625000
NODE_8584_length_911_cov_173.171182	580	660	722	1	80	0.0125000
NODE_8584_length_911_cov_173.171182	580	660	726	1	80	0.0125000
NODE_8584_length_911_cov_173.171182	580	660	727	1	80	0.0125000
NODE_8584_length_911_cov_173.171182	580	660	738	1	80	0.0125000
NODE_8584_length_911_cov_173.171182	580	660	741	1	80	0.0125000
NODE_8584_length_911_cov_173.171182	580	660	747	1	80	0.0125000
NODE_8584_length_911_cov_173.171182	580	660	750	1	80	0.0125000
NODE_8584_length_911_cov_173.171182	580	660	759	1	80	0.0125000
NODE_8584_length_911_cov_173.171182	580	660	761	1	80	0.0125000
NODE_8584_length_911_cov_173.171182	580	660	765	2	80	0.0250000
NODE_8584_length_911_cov_173.171182	580	660	767	3	80	0.0375000
NODE_8584_length_911_cov_173.171182	580	660	768	1	80	0.0125000
NODE_8584_length_911_cov_173.171182	580	660	771	1	80	0.0125000
NODE_8584_length_911_cov_173.171182	580	660	775	2	80	0.0250000
NODE_8584_length_911_cov_173.171182	580	660	776	1	80	0.0125000
NODE_8584_length_911_cov_173.171182	580	660	778	2	80	0.0250000
NODE_8584_length_911_cov_173.171182	580	660	779	1	80	0.0125000
NODE_8584_length_911_cov_173.171182	580	660	780	1	80	0.0125000
NODE_8584_length_911_cov_173.171182	580	660	781	1	80	0.0125000
NODE_8584_length_911_cov_173.171182	633	713	720	1	80	0.0125000
NODE_8584_length_911_cov_173.171182	633	713	721	3	80	0.0375000
NODE_8584_length_911_cov_173.171182	633	713	722	1	80	0.0125000
NODE_8584_length_911_cov_173.171182	633	713	727	1	80	0.0125000
NODE_8584_length_911_cov_173.171182	633	713	738	1	80	0.0125000
NODE_8584_length_911_cov_173.171182	633	713	741	1	80	0.0125000
NODE_8584_length_911_cov_173.171182	633	713	747	1	80	0.0125000
NODE_8584_length_911_cov_173.171182	633	713	750	1	80	0.0125000
NODE_8584_length_911_cov_173.171182	633	713	759	1	80	0.0125000
NODE_8584_length_911_cov_173.171182	633	713	761	1	80	0.0125000
NODE_8584_length_911_cov_173.171182	633	713	765	2	80	0.0250000
NODE_8584_length_911_cov_173.171182	633	713	767	3	80	0.0375000
NODE_8584_length_911_cov_173.171182	633	713	768	1	80	0.0125000
NODE_8584_length_911_cov_173.171182	633	713	769	1	80	0.0125000
NODE_8584_length_911_cov_173.171182	633	713	771	1	80	0.0125000
NODE_8584_length_911_cov_173.171182	633	713	775	3	80	0.0375000
NODE_8584_length_911_cov_173.171182	633	713	776	1	80	0.0125000
NODE_8584_length_911_cov_173.171182	633	713	778	3	80	0.0375000
NODE_8584_length_911_cov_173.171182	633	713	779	1	80	0.0125000
NODE_8584_length_911_cov_173.171182	633	713	780	2	80	0.0250000
NODE_8584_length_911_cov_173.171182	633	713	781	1	80	0.0125000
NODE_8584_length_911_cov_173.171182	633	713	785	2	80	0.0250000
NODE_8584_length_911_cov_173.171182	633	713	786	1	80	0.0125000
NODE_8584_length_911_cov_173.171182	633	713	789	3	80	0.0375000
NODE_8584_length_911_cov_173.171182	633	713	790	1	80	0.0125000
NODE_8584_length_911_cov_173.171182	633	713	791	1	80	0.0125000
NODE_8584_length_911_cov_173.171182	633	713	794	2	80	0.0250000
NODE_8584_length_911_cov_173.171182	633	713	797	1	80	0.0125000
NODE_8584_length_911_cov_173.171182	633	713	798	2	80	0.0250000
NODE_8584_length_911_cov_173.171182	633	713	799	2	80	0.0250000
NODE_8584_length_911_cov_173.171182	633	713	800	2	80	0.0250000
NODE_8584_length_911_cov_173.171182	633	713	801	3	80	0.0375000
NODE_8584_length_911_cov_173.171182	633	713	802	3	80	0.0375000
NODE_8584_length_911_cov_173.171182	633	713	803	8	80	0.1000000
NODE_8584_length_911_cov_173.171182	633	713	805	4	80	0.0500000
NODE_8584_length_911_cov_173.171182	633	713	806	1	80	0.0125000
NODE_8584_length_911_cov_173.171182	633	713	807	1	80	0.0125000
NODE_8584_length_911_cov_173.171182	633	713	812	1	80	0.0125000
NODE_8584_length_911_cov_173.171182	633	713	829	1	80	0.0125000
NODE_8584_length_911_cov_173.171182	633	713	842	1	80	0.0125000
NODE_8584_length_911_cov_173.171182	633	713	843	1	80	0.0125000
NODE_8584_length_911_cov_173.171182	633	713	854	1	80	0.0125000
NODE_8584_length_911_cov_173.171182	633	713	859	1	80	0.0125000
NODE_8584_length_911_cov_173.171182	633	713	864	1	80	0.0125000
NODE_8584_length_911_cov_173.171182	633	713	869	2	80	0.0250000
NODE_8584_length_911_cov_173.171182	633	713	875	1	80	0.0125000
NODE_8584_length_911_cov_173.171182	633	713	885	1	80	0.0125000
NODE_8584_length_911_cov_173.171182	633	713	886	1	80	0.0125000
NODE_8585_length_911_cov_88.250000	525	605	0	80	80	1.0000000
NODE_8585_length_911_cov_88.250000	578	658	0	80	80	1.0000000
NODE_8586_length_911_cov_46.854680	255	335	0	80	80	1.0000000
NODE_8586_length_911_cov_46.854680	308	388	0	80	80	1.0000000
NODE_8586_length_911_cov_46.854680	384	464	0	80	80	1.0000000
NODE_8586_length_911_cov_46.854680	437	517	0	80	80	1.0000000
NODE_8587_length_911_cov_31.362069	301	381	0	80	80	1.0000000
NODE_8587_length_911_cov_31.362069	354	434	0	80	80	1.0000000
NODE_8588_length_911_cov_19.235222	445	525	0	80	80	1.0000000
NODE_8588_length_911_cov_19.235222	498	578	0	80	80	1.0000000
NODE_8589_length_911_cov_16.230296	233	313	2	80	80	1.0000000
NODE_8589_length_911_cov_16.230296	286	366	0	53	80	0.6625000
NODE_8589_length_911_cov_16.230296	286	366	2	27	80	0.3375000
NODE_8590_length_911_cov_14.979064	472	552	1	52	80	0.6500000
NODE_8590_length_911_cov_14.979064	472	552	2	28	80	0.3500000
NODE_8590_length_911_cov_14.979064	525	605	0	23	80	0.2875000
NODE_8590_length_911_cov_14.979064	525	605	1	57	80	0.7125000
NODE_8591_length_911_cov_12.089901	357	409	2	52	52	1.0000000
NODE_8591_length_911_cov_12.089901	401	462	0	5	61	0.0819672
NODE_8591_length_911_cov_12.089901	401	462	2	56	61	0.9180328
NODE_8606_length_910_cov_27.838471	347	427	0	80	80	1.0000000
NODE_8606_length_910_cov_27.838471	400	480	0	80	80	1.0000000
NODE_8607_length_910_cov_25.895191	361	441	0	80	80	1.0000000
NODE_8607_length_910_cov_25.895191	414	494	0	80	80	1.0000000
NODE_8608_length_910_cov_25.604192	294	374	0	80	80	1.0000000
NODE_8608_length_910_cov_25.604192	347	427	0	80	80	1.0000000
NODE_8608_length_910_cov_25.604192	423	503	0	80	80	1.0000000
NODE_8608_length_910_cov_25.604192	476	556	0	80	80	1.0000000
NODE_8609_length_910_cov_16.066584	656	736	0	43	80	0.5375000
NODE_8609_length_910_cov_16.066584	656	736	2	37	80	0.4625000
NODE_8609_length_910_cov_16.066584	709	789	0	18	80	0.2250000
NODE_8609_length_910_cov_16.066584	709	789	2	62	80	0.7750000
NODE_8610_length_910_cov_14.696671	417	497	0	80	80	1.0000000
NODE_8610_length_910_cov_14.696671	470	550	0	80	80	1.0000000
NODE_8612_length_910_cov_7.114673	442	522	0	80	80	1.0000000
NODE_8612_length_910_cov_7.114673	495	575	0	80	80	1.0000000
NODE_8614_length_910_cov_2.992602	196	269	13	2	73	0.0273973
NODE_8614_length_910_cov_2.992602	196	269	14	3	73	0.0410959
NODE_8614_length_910_cov_2.992602	196	269	15	5	73	0.0684932
NODE_8614_length_910_cov_2.992602	196	269	16	3	73	0.0410959
NODE_8614_length_910_cov_2.992602	196	269	17	2	73	0.0273973
NODE_8614_length_910_cov_2.992602	196	269	18	14	73	0.1917808
NODE_8614_length_910_cov_2.992602	196	269	20	24	73	0.3287671
NODE_8614_length_910_cov_2.992602	196	269	22	6	73	0.0821918
NODE_8614_length_910_cov_2.992602	196	269	24	12	73	0.1643836
NODE_8614_length_910_cov_2.992602	196	269	26	2	73	0.0273973
NODE_8614_length_910_cov_2.992602	249	329	20	4	80	0.0500000
NODE_8614_length_910_cov_2.992602	249	329	22	5	80	0.0625000
NODE_8614_length_910_cov_2.992602	249	329	23	3	80	0.0375000
NODE_8614_length_910_cov_2.992602	249	329	24	28	80	0.3500000
NODE_8614_length_910_cov_2.992602	249	329	26	25	80	0.3125000
NODE_8614_length_910_cov_2.992602	249	329	28	15	80	0.1875000
NODE_8614_length_910_cov_2.992602	386	439	4	34	53	0.6415094
NODE_8614_length_910_cov_2.992602	386	439	6	17	53	0.3207547
NODE_8614_length_910_cov_2.992602	386	439	8	2	53	0.0377358
NODE_8623_length_909_cov_35.291358	426	506	0	80	80	1.0000000
NODE_8623_length_909_cov_35.291358	479	559	0	80	80	1.0000000
NODE_8624_length_909_cov_27.449383	311	391	0	36	80	0.4500000
NODE_8624_length_909_cov_27.449383	311	391	6	44	80	0.5500000
NODE_8624_length_909_cov_27.449383	364	444	0	9	80	0.1125000
NODE_8624_length_909_cov_27.449383	364	444	2	9	80	0.1125000
NODE_8624_length_909_cov_27.449383	364	444	6	27	80	0.3375000
NODE_8624_length_909_cov_27.449383	364	444	8	35	80	0.4375000
NODE_8625_length_909_cov_25.212346	295	375	0	4	80	0.0500000
NODE_8625_length_909_cov_25.212346	295	375	2	76	80	0.9500000
NODE_8625_length_909_cov_25.212346	348	428	0	27	80	0.3375000
NODE_8625_length_909_cov_25.212346	348	428	2	53	80	0.6625000
NODE_8626_length_909_cov_23.604938	403	483	0	80	80	1.0000000
NODE_8626_length_909_cov_23.604938	456	536	0	80	80	1.0000000
NODE_8627_length_909_cov_19.070370	441	521	6	80	80	1.0000000
NODE_8627_length_909_cov_19.070370	494	574	6	80	80	1.0000000
NODE_8628_length_909_cov_11.533333	332	412	0	80	80	1.0000000
NODE_8628_length_909_cov_11.533333	385	465	0	80	80	1.0000000
NODE_8629_length_909_cov_10.229630	497	577	0	80	80	1.0000000
NODE_8629_length_909_cov_10.229630	550	622	0	72	72	1.0000000
NODE_8631_length_909_cov_7.122222	328	408	0	80	80	1.0000000
NODE_8631_length_909_cov_7.122222	381	461	0	80	80	1.0000000
NODE_8632_length_909_cov_4.664198	775	855	6	8	80	0.1000000
NODE_8632_length_909_cov_4.664198	775	855	7	8	80	0.1000000
NODE_8632_length_909_cov_4.664198	775	855	8	62	80	0.7750000
NODE_8632_length_909_cov_4.664198	775	855	9	2	80	0.0250000
NODE_8632_length_909_cov_4.664198	828	885	0	9	57	0.1578947
NODE_8632_length_909_cov_4.664198	828	885	3	3	57	0.0526316
NODE_8632_length_909_cov_4.664198	828	885	4	1	57	0.0175439
NODE_8632_length_909_cov_4.664198	828	885	6	5	57	0.0877193
NODE_8632_length_909_cov_4.664198	828	885	8	39	57	0.6842105
NODE_8644_length_908_cov_55.546354	409	489	0	80	80	1.0000000
NODE_8644_length_908_cov_55.546354	462	542	0	68	80	0.8500000
NODE_8644_length_908_cov_55.546354	462	542	4	12	80	0.1500000
NODE_8645_length_908_cov_18.720643	329	409	0	80	80	1.0000000
NODE_8645_length_908_cov_18.720643	382	462	0	80	80	1.0000000
NODE_8646_length_908_cov_14.640297	430	510	0	31	80	0.3875000
NODE_8646_length_908_cov_14.640297	430	510	6	26	80	0.3250000
NODE_8646_length_908_cov_14.640297	430	510	8	23	80	0.2875000
NODE_8646_length_908_cov_14.640297	483	562	6	4	79	0.0506329
NODE_8646_length_908_cov_14.640297	483	562	8	75	79	0.9493671
NODE_8648_length_908_cov_10.789864	370	450	0	18	80	0.2250000
NODE_8648_length_908_cov_10.789864	370	450	2	62	80	0.7750000
NODE_8648_length_908_cov_10.789864	423	503	2	80	80	1.0000000
NODE_8651_length_908_cov_3.737948	251	331	0	80	80	1.0000000
NODE_8651_length_908_cov_3.737948	304	384	0	55	80	0.6875000
NODE_8651_length_908_cov_3.737948	304	384	1	25	80	0.3125000
NODE_8664_length_907_cov_22.110149	459	539	0	80	80	1.0000000
NODE_8664_length_907_cov_22.110149	512	592	0	80	80	1.0000000
NODE_8665_length_907_cov_20.943069	410	490	0	80	80	1.0000000
NODE_8665_length_907_cov_20.943069	463	543	0	80	80	1.0000000
NODE_8666_length_907_cov_19.519802	411	488	2	11	77	0.1428571
NODE_8666_length_907_cov_19.519802	411	488	5	6	77	0.0779221
NODE_8666_length_907_cov_19.519802	411	488	6	6	77	0.0779221
NODE_8666_length_907_cov_19.519802	411	488	8	54	77	0.7012987
NODE_8666_length_907_cov_19.519802	461	541	6	59	80	0.7375000
NODE_8666_length_907_cov_19.519802	461	541	8	21	80	0.2625000
NODE_8667_length_907_cov_17.928218	329	405	0	22	76	0.2894737
NODE_8667_length_907_cov_17.928218	329	405	4	54	76	0.7105263
NODE_8667_length_907_cov_17.928218	382	462	2	22	80	0.2750000
NODE_8667_length_907_cov_17.928218	382	462	4	24	80	0.3000000
NODE_8667_length_907_cov_17.928218	382	462	6	34	80	0.4250000
NODE_8668_length_907_cov_13.060644	293	373	0	80	80	1.0000000
NODE_8668_length_907_cov_13.060644	346	426	0	80	80	1.0000000
NODE_8669_length_907_cov_11.155941	401	462	4	61	61	1.0000000
NODE_8669_length_907_cov_11.155941	607	687	0	80	80	1.0000000
NODE_8670_length_907_cov_9.237624	247	327	0	80	80	1.0000000
NODE_8670_length_907_cov_9.237624	300	380	0	80	80	1.0000000
NODE_8671_length_907_cov_8.686881	275	365	0	90	90	1.0000000
NODE_8671_length_907_cov_8.686881	338	418	0	80	80	1.0000000
NODE_8680_length_907_cov_2.949257	503	526	0	23	23	1.0000000
NODE_8686_length_906_cov_32.369269	447	527	0	80	80	1.0000000
NODE_8686_length_906_cov_32.369269	500	580	0	80	80	1.0000000
NODE_8687_length_906_cov_23.594796	196	276	0	80	80	1.0000000
NODE_8687_length_906_cov_23.594796	249	329	0	80	80	1.0000000
NODE_8688_length_906_cov_21.443618	404	484	0	80	80	1.0000000
NODE_8688_length_906_cov_21.443618	457	537	0	80	80	1.0000000
NODE_8689_length_906_cov_20.596035	593	634	2	41	41	1.0000000
NODE_8690_length_906_cov_20.429988	410	490	0	80	80	1.0000000
NODE_8690_length_906_cov_20.429988	463	543	0	80	80	1.0000000
NODE_8691_length_906_cov_20.395291	523	603	0	80	80	1.0000000
NODE_8691_length_906_cov_20.395291	576	656	0	80	80	1.0000000
NODE_8692_length_906_cov_19.297398	255	335	0	47	80	0.5875000
NODE_8692_length_906_cov_19.297398	255	335	2	33	80	0.4125000
NODE_8692_length_906_cov_19.297398	308	388	0	7	80	0.0875000
NODE_8692_length_906_cov_19.297398	308	388	2	73	80	0.9125000
NODE_8693_length_906_cov_18.505576	357	437	0	80	80	1.0000000
NODE_8693_length_906_cov_18.505576	410	490	0	80	80	1.0000000
NODE_8694_length_906_cov_10.068154	191	271	0	80	80	1.0000000
NODE_8694_length_906_cov_10.068154	244	324	0	80	80	1.0000000
NODE_8695_length_906_cov_10.006196	304	384	0	80	80	1.0000000
NODE_8695_length_906_cov_10.006196	357	437	0	80	80	1.0000000
NODE_8696_length_906_cov_8.562577	370	454	0	84	84	1.0000000
NODE_8696_length_906_cov_8.562577	423	507	0	84	84	1.0000000
NODE_8716_length_905_cov_39.203474	406	486	1	80	80	1.0000000
NODE_8716_length_905_cov_39.203474	459	539	1	66	80	0.8250000
NODE_8716_length_905_cov_39.203474	459	539	2	14	80	0.1750000
NODE_8717_length_905_cov_37.053350	411	491	0	80	80	1.0000000
NODE_8717_length_905_cov_37.053350	464	544	0	80	80	1.0000000
NODE_8718_length_905_cov_27.426799	288	368	0	80	80	1.0000000
NODE_8718_length_905_cov_27.426799	341	421	0	80	80	1.0000000
NODE_8719_length_905_cov_26.332506	375	455	0	80	80	1.0000000
NODE_8719_length_905_cov_26.332506	428	508	0	80	80	1.0000000
NODE_8720_length_905_cov_20.651365	377	457	4	80	80	1.0000000
NODE_8720_length_905_cov_20.651365	430	510	0	51	80	0.6375000
NODE_8720_length_905_cov_20.651365	430	510	3	1	80	0.0125000
NODE_8720_length_905_cov_20.651365	430	510	4	28	80	0.3500000
NODE_8721_length_905_cov_19.718362	365	445	0	80	80	1.0000000
NODE_8721_length_905_cov_19.718362	418	498	0	80	80	1.0000000
NODE_8722_length_905_cov_13.696030	366	420	1	54	54	1.0000000
NODE_8723_length_905_cov_9.978908	222	302	0	80	80	1.0000000
NODE_8723_length_905_cov_9.978908	275	355	0	80	80	1.0000000
NODE_8725_length_905_cov_7.980149	321	401	0	1	80	0.0125000
NODE_8725_length_905_cov_7.980149	321	401	2	79	80	0.9875000
NODE_8725_length_905_cov_7.980149	374	454	0	54	80	0.6750000
NODE_8725_length_905_cov_7.980149	374	454	2	26	80	0.3250000
NODE_8727_length_905_cov_6.064516	459	539	0	80	80	1.0000000
NODE_8727_length_905_cov_6.064516	512	592	0	80	80	1.0000000
NODE_8742_length_905_cov_1.040943	73	119	18	9	46	0.1956522
NODE_8742_length_905_cov_1.040943	73	119	20	2	46	0.0434783
NODE_8742_length_905_cov_1.040943	73	119	23	35	46	0.7608696
NODE_8742_length_905_cov_1.040943	126	172	6	1	46	0.0217391
NODE_8742_length_905_cov_1.040943	126	172	7	5	46	0.1086956
NODE_8742_length_905_cov_1.040943	126	172	9	8	46	0.1739130
NODE_8742_length_905_cov_1.040943	126	172	11	2	46	0.0434783
NODE_8742_length_905_cov_1.040943	126	172	15	2	46	0.0434783
NODE_8742_length_905_cov_1.040943	126	172	17	2	46	0.0434783
NODE_8742_length_905_cov_1.040943	126	172	18	1	46	0.0217391
NODE_8742_length_905_cov_1.040943	126	172	20	3	46	0.0652174
NODE_8742_length_905_cov_1.040943	126	172	22	5	46	0.1086956
NODE_8742_length_905_cov_1.040943	126	172	24	17	46	0.3695652
NODE_8743_length_904_cov_29.532919	338	418	0	44	80	0.5500000
NODE_8743_length_904_cov_29.532919	338	418	2	28	80	0.3500000
NODE_8743_length_904_cov_29.532919	338	418	4	8	80	0.1000000
NODE_8743_length_904_cov_29.532919	391	471	0	80	80	1.0000000
NODE_8743_length_904_cov_29.532919	467	547	0	80	80	1.0000000
NODE_8743_length_904_cov_29.532919	520	600	0	80	80	1.0000000
NODE_8744_length_904_cov_28.844720	371	451	0	80	80	1.0000000
NODE_8744_length_904_cov_28.844720	424	504	0	80	80	1.0000000
NODE_8745_length_904_cov_26.977640	488	568	0	80	80	1.0000000
NODE_8745_length_904_cov_26.977640	541	621	0	80	80	1.0000000
NODE_8746_length_904_cov_24.529193	464	544	0	80	80	1.0000000
NODE_8746_length_904_cov_24.529193	517	597	0	80	80	1.0000000
NODE_8747_length_904_cov_24.452174	507	587	4	80	80	1.0000000
NODE_8747_length_904_cov_24.452174	560	640	0	53	80	0.6625000
NODE_8747_length_904_cov_24.452174	560	640	4	27	80	0.3375000
NODE_8748_length_904_cov_19.649689	307	387	0	80	80	1.0000000
NODE_8748_length_904_cov_19.649689	360	440	0	80	80	1.0000000
NODE_8748_length_904_cov_19.649689	595	675	0	80	80	1.0000000
NODE_8748_length_904_cov_19.649689	648	728	0	80	80	1.0000000
NODE_8750_length_904_cov_16.608696	252	332	0	80	80	1.0000000
NODE_8750_length_904_cov_16.608696	305	385	0	80	80	1.0000000
NODE_8750_length_904_cov_16.608696	381	461	0	80	80	1.0000000
NODE_8750_length_904_cov_16.608696	434	514	0	77	80	0.9625000
NODE_8750_length_904_cov_16.608696	434	514	1	3	80	0.0375000
NODE_8751_length_904_cov_15.811180	431	511	0	80	80	1.0000000
NODE_8751_length_904_cov_15.811180	484	564	0	80	80	1.0000000
NODE_8752_length_904_cov_9.249689	581	661	0	80	80	1.0000000
NODE_8752_length_904_cov_9.249689	634	714	0	80	80	1.0000000
NODE_8756_length_904_cov_4.772671	318	398	0	80	80	1.0000000
NODE_8756_length_904_cov_4.772671	371	451	0	80	80	1.0000000
NODE_8773_length_903_cov_58.723881	386	466	3	36	80	0.4500000
NODE_8773_length_903_cov_58.723881	386	466	5	9	80	0.1125000
NODE_8773_length_903_cov_58.723881	386	466	28	8	80	0.1000000
NODE_8773_length_903_cov_58.723881	386	466	29	1	80	0.0125000
NODE_8773_length_903_cov_58.723881	386	466	30	13	80	0.1625000
NODE_8773_length_903_cov_58.723881	386	466	48	2	80	0.0250000
NODE_8773_length_903_cov_58.723881	386	466	49	11	80	0.1375000
NODE_8773_length_903_cov_58.723881	439	519	28	8	80	0.1000000
NODE_8773_length_903_cov_58.723881	439	519	30	6	80	0.0750000
NODE_8773_length_903_cov_58.723881	439	519	48	2	80	0.0250000
NODE_8773_length_903_cov_58.723881	439	519	49	16	80	0.2000000
NODE_8773_length_903_cov_58.723881	439	519	50	4	80	0.0500000
NODE_8773_length_903_cov_58.723881	439	519	51	17	80	0.2125000
NODE_8773_length_903_cov_58.723881	439	519	52	27	80	0.3375000
NODE_8773_length_903_cov_58.723881	515	595	25	14	80	0.1750000
NODE_8773_length_903_cov_58.723881	515	595	43	1	80	0.0125000
NODE_8773_length_903_cov_58.723881	515	595	47	1	80	0.0125000
NODE_8773_length_903_cov_58.723881	515	595	48	18	80	0.2250000
NODE_8773_length_903_cov_58.723881	515	595	49	35	80	0.4375000
NODE_8773_length_903_cov_58.723881	515	595	50	9	80	0.1125000
NODE_8773_length_903_cov_58.723881	515	595	51	2	80	0.0250000
NODE_8773_length_903_cov_58.723881	568	648	0	45	80	0.5625000
NODE_8773_length_903_cov_58.723881	568	648	21	1	80	0.0125000
NODE_8773_length_903_cov_58.723881	568	648	23	1	80	0.0125000
NODE_8773_length_903_cov_58.723881	568	648	25	20	80	0.2500000
NODE_8773_length_903_cov_58.723881	568	648	43	1	80	0.0125000
NODE_8773_length_903_cov_58.723881	568	648	47	1	80	0.0125000
NODE_8773_length_903_cov_58.723881	568	648	48	11	80	0.1375000
NODE_8774_length_903_cov_41.298507	397	477	0	80	80	1.0000000
NODE_8774_length_903_cov_41.298507	450	530	0	80	80	1.0000000
NODE_8775_length_903_cov_28.691542	394	474	2	80	80	1.0000000
NODE_8775_length_903_cov_28.691542	447	527	0	44	80	0.5500000
NODE_8775_length_903_cov_28.691542	447	527	2	36	80	0.4500000
NODE_8776_length_903_cov_26.276119	441	521	0	80	80	1.0000000
NODE_8776_length_903_cov_26.276119	494	574	0	80	80	1.0000000
NODE_8778_length_903_cov_18.166667	351	431	0	80	80	1.0000000
NODE_8778_length_903_cov_18.166667	404	484	0	80	80	1.0000000
NODE_8779_length_903_cov_15.460199	440	520	0	80	80	1.0000000
NODE_8779_length_903_cov_15.460199	493	573	0	80	80	1.0000000
NODE_8780_length_903_cov_15.084577	352	432	0	80	80	1.0000000
NODE_8780_length_903_cov_15.084577	405	485	0	80	80	1.0000000
NODE_8781_length_903_cov_15.070896	367	447	0	80	80	1.0000000
NODE_8781_length_903_cov_15.070896	420	500	0	80	80	1.0000000
NODE_8782_length_903_cov_14.004975	318	399	0	81	81	1.0000000
NODE_8782_length_903_cov_14.004975	372	452	0	80	80	1.0000000
NODE_8783_length_903_cov_10.546020	150	230	0	80	80	1.0000000
NODE_8783_length_903_cov_10.546020	203	283	0	31	80	0.3875000
NODE_8783_length_903_cov_10.546020	203	283	2	49	80	0.6125000
NODE_8784_length_903_cov_9.288557	373	453	0	80	80	1.0000000
NODE_8784_length_903_cov_9.288557	426	506	0	80	80	1.0000000
NODE_8785_length_903_cov_8.052239	439	519	0	80	80	1.0000000
NODE_8785_length_903_cov_8.052239	492	572	0	80	80	1.0000000
NODE_8798_length_902_cov_64.459527	355	435	0	80	80	1.0000000
NODE_8798_length_902_cov_64.459527	408	488	0	80	80	1.0000000
NODE_8798_length_902_cov_64.459527	484	564	0	80	80	1.0000000
NODE_8798_length_902_cov_64.459527	537	617	0	80	80	1.0000000
NODE_8799_length_902_cov_60.823163	395	475	2	80	80	1.0000000
NODE_8799_length_902_cov_60.823163	448	528	0	12	80	0.1500000
NODE_8799_length_902_cov_60.823163	448	528	2	68	80	0.8500000
NODE_8800_length_902_cov_44.002491	383	463	0	80	80	1.0000000
NODE_8800_length_902_cov_44.002491	436	516	0	80	80	1.0000000
NODE_8801_length_902_cov_41.059776	378	458	0	80	80	1.0000000
NODE_8801_length_902_cov_41.059776	431	511	0	80	80	1.0000000
NODE_8802_length_902_cov_38.952677	372	452	0	80	80	1.0000000
NODE_8802_length_902_cov_38.952677	425	505	0	80	80	1.0000000
NODE_8803_length_902_cov_34.156912	373	453	0	80	80	1.0000000
NODE_8803_length_902_cov_34.156912	426	506	0	80	80	1.0000000
NODE_8804_length_902_cov_23.007472	295	375	0	80	80	1.0000000
NODE_8804_length_902_cov_23.007472	348	428	0	80	80	1.0000000
NODE_8805_length_902_cov_19.491905	238	291	0	53	53	1.0000000
NODE_8805_length_902_cov_19.491905	264	344	0	80	80	1.0000000
NODE_8806_length_902_cov_10.794521	214	294	0	80	80	1.0000000
NODE_8806_length_902_cov_10.794521	267	347	0	80	80	1.0000000
NODE_8807_length_902_cov_9.520548	518	598	0	80	80	1.0000000
NODE_8807_length_902_cov_9.520548	571	651	0	80	80	1.0000000
NODE_8808_length_902_cov_8.323786	337	417	0	37	80	0.4625000
NODE_8808_length_902_cov_8.323786	337	417	2	43	80	0.5375000
NODE_8808_length_902_cov_8.323786	390	470	2	75	80	0.9375000
NODE_8808_length_902_cov_8.323786	390	470	4	5	80	0.0625000
NODE_8811_length_902_cov_7.300125	434	514	0	42	80	0.5250000
NODE_8811_length_902_cov_7.300125	434	514	1	38	80	0.4750000
NODE_8811_length_902_cov_7.300125	487	567	1	80	80	1.0000000
NODE_8812_length_902_cov_4.185554	505	585	0	80	80	1.0000000
NODE_8812_length_902_cov_4.185554	558	588	0	30	30	1.0000000
NODE_8812_length_902_cov_4.185554	610	662	0	52	52	1.0000000
NODE_8830_length_902_cov_0.963885	82	106	0	24	24	1.0000000
NODE_8832_length_901_cov_36.066085	412	490	0	12	78	0.1538462
NODE_8832_length_901_cov_36.066085	412	490	4	66	78	0.8461539
NODE_8832_length_901_cov_36.066085	463	543	0	32	80	0.4000000
NODE_8832_length_901_cov_36.066085	463	543	4	48	80	0.6000000
NODE_8833_length_901_cov_28.129676	377	457	0	80	80	1.0000000
NODE_8833_length_901_cov_28.129676	430	510	0	80	80	1.0000000
NODE_8834_length_901_cov_26.763092	272	352	0	9	80	0.1125000
NODE_8834_length_901_cov_26.763092	272	352	2	71	80	0.8875000
NODE_8834_length_901_cov_26.763092	325	405	0	62	80	0.7750000
NODE_8834_length_901_cov_26.763092	325	405	2	18	80	0.2250000
NODE_8834_length_901_cov_26.763092	401	481	0	80	80	1.0000000
NODE_8834_length_901_cov_26.763092	454	534	0	80	80	1.0000000
NODE_8835_length_901_cov_25.628429	369	449	0	80	80	1.0000000
NODE_8835_length_901_cov_25.628429	422	502	0	80	80	1.0000000
NODE_8836_length_901_cov_17.857855	408	488	0	80	80	1.0000000
NODE_8836_length_901_cov_17.857855	461	541	0	80	80	1.0000000
NODE_8837_length_901_cov_16.254364	362	442	0	80	80	1.0000000
NODE_8837_length_901_cov_16.254364	415	495	0	80	80	1.0000000
NODE_8838_length_901_cov_8.346633	321	401	0	12	80	0.1500000
NODE_8838_length_901_cov_8.346633	321	401	4	68	80	0.8500000
NODE_8838_length_901_cov_8.346633	374	454	0	29	80	0.3625000
NODE_8838_length_901_cov_8.346633	374	454	4	51	80	0.6375000
NODE_8840_length_901_cov_6.044888	363	443	0	80	80	1.0000000
NODE_8840_length_901_cov_6.044888	416	496	0	80	80	1.0000000
NODE_8845_length_901_cov_3.814214	194	274	0	80	80	1.0000000
NODE_8845_length_901_cov_3.814214	247	326	0	79	79	1.0000000
NODE_8857_length_900_cov_30.284644	407	487	0	80	80	1.0000000
NODE_8857_length_900_cov_30.284644	460	540	0	80	80	1.0000000
NODE_8858_length_900_cov_29.679151	425	505	0	80	80	1.0000000
NODE_8858_length_900_cov_29.679151	478	558	0	80	80	1.0000000
NODE_8859_length_900_cov_25.963795	321	401	0	80	80	1.0000000
NODE_8859_length_900_cov_25.963795	374	454	0	80	80	1.0000000
NODE_8860_length_900_cov_17.681648	530	606	0	43	76	0.5657895
NODE_8860_length_900_cov_17.681648	530	606	1	24	76	0.3157895
NODE_8860_length_900_cov_17.681648	530	606	2	9	76	0.1184211
NODE_8860_length_900_cov_17.681648	583	659	1	14	76	0.1842105
NODE_8860_length_900_cov_17.681648	583	659	2	62	76	0.8157895
NODE_8861_length_900_cov_16.294632	316	396	0	80	80	1.0000000
NODE_8861_length_900_cov_16.294632	369	449	0	80	80	1.0000000
NODE_8863_length_900_cov_5.962547	0	70	2	3	70	0.0428571
NODE_8863_length_900_cov_5.962547	0	70	4	6	70	0.0857143
NODE_8863_length_900_cov_5.962547	0	70	6	61	70	0.8714285
NODE_8863_length_900_cov_5.962547	43	108	0	3	65	0.0461538
NODE_8863_length_900_cov_5.962547	43	108	4	2	65	0.0307692
NODE_8863_length_900_cov_5.962547	43	108	6	60	65	0.9230769
NODE_8870_length_900_cov_2.521848	85	165	0	80	80	1.0000000
NODE_8870_length_900_cov_2.521848	138	218	0	80	80	1.0000000
NODE_8879_length_899_cov_45.853750	380	460	0	80	80	1.0000000
NODE_8879_length_899_cov_45.853750	433	516	0	83	83	1.0000000
NODE_8880_length_899_cov_37.758750	381	461	0	80	80	1.0000000
NODE_8880_length_899_cov_37.758750	434	514	0	80	80	1.0000000
NODE_8881_length_899_cov_27.362500	413	493	0	80	80	1.0000000
NODE_8881_length_899_cov_27.362500	466	546	0	80	80	1.0000000
NODE_8882_length_899_cov_20.563750	379	459	8	80	80	1.0000000
NODE_8882_length_899_cov_20.563750	432	507	0	31	75	0.4133333
NODE_8882_length_899_cov_20.563750	432	507	8	44	75	0.5866666
NODE_8884_length_899_cov_17.130000	319	399	0	80	80	1.0000000
NODE_8884_length_899_cov_17.130000	372	452	0	46	80	0.5750000
NODE_8884_length_899_cov_17.130000	372	452	2	34	80	0.4250000
NODE_8885_length_899_cov_16.317500	270	350	0	64	80	0.8000000
NODE_8885_length_899_cov_16.317500	270	350	5	16	80	0.2000000
NODE_8885_length_899_cov_16.317500	323	403	0	11	80	0.1375000
NODE_8885_length_899_cov_16.317500	323	403	5	30	80	0.3750000
NODE_8885_length_899_cov_16.317500	323	403	9	1	80	0.0125000
NODE_8885_length_899_cov_16.317500	323	403	10	38	80	0.4750000
NODE_8886_length_899_cov_16.190000	284	364	0	80	80	1.0000000
NODE_8886_length_899_cov_16.190000	337	417	0	80	80	1.0000000
NODE_8887_length_899_cov_13.873750	317	397	0	80	80	1.0000000
NODE_8887_length_899_cov_13.873750	370	450	0	80	80	1.0000000
NODE_8888_length_899_cov_12.957500	240	320	0	80	80	1.0000000
NODE_8888_length_899_cov_12.957500	293	373	0	80	80	1.0000000
NODE_8889_length_899_cov_12.516250	387	467	0	14	80	0.1750000
NODE_8889_length_899_cov_12.516250	387	467	2	66	80	0.8250000
NODE_8889_length_899_cov_12.516250	440	520	0	67	80	0.8375000
NODE_8889_length_899_cov_12.516250	440	520	2	13	80	0.1625000
NODE_8890_length_899_cov_10.846250	348	428	0	80	80	1.0000000
NODE_8890_length_899_cov_10.846250	401	485	0	84	84	1.0000000
NODE_8891_length_899_cov_9.185000	347	427	0	80	80	1.0000000
NODE_8891_length_899_cov_9.185000	400	480	0	80	80	1.0000000
NODE_8892_length_899_cov_8.655000	498	578	0	80	80	1.0000000
NODE_8892_length_899_cov_8.655000	551	631	0	80	80	1.0000000
NODE_8893_length_899_cov_3.551250	0	54	0	10	54	0.1851852
NODE_8893_length_899_cov_3.551250	0	54	2	7	54	0.1296296
NODE_8893_length_899_cov_3.551250	0	54	4	8	54	0.1481481
NODE_8893_length_899_cov_3.551250	0	54	6	1	54	0.0185185
NODE_8893_length_899_cov_3.551250	0	54	8	28	54	0.5185185
NODE_8893_length_899_cov_3.551250	27	107	8	80	80	1.0000000
NODE_8893_length_899_cov_3.551250	103	183	0	31	80	0.3875000
NODE_8893_length_899_cov_3.551250	103	183	2	13	80	0.1625000
NODE_8893_length_899_cov_3.551250	103	183	4	19	80	0.2375000
NODE_8893_length_899_cov_3.551250	103	183	6	11	80	0.1375000
NODE_8893_length_899_cov_3.551250	103	183	8	6	80	0.0750000
NODE_8893_length_899_cov_3.551250	156	179	0	23	23	1.0000000
NODE_8914_length_898_cov_52.405507	299	379	0	80	80	1.0000000
NODE_8914_length_898_cov_52.405507	352	432	0	61	80	0.7625000
NODE_8914_length_898_cov_52.405507	352	432	6	19	80	0.2375000
NODE_8914_length_898_cov_52.405507	428	508	6	47	80	0.5875000
NODE_8914_length_898_cov_52.405507	428	508	7	2	80	0.0250000
NODE_8914_length_898_cov_52.405507	428	508	8	31	80	0.3875000
NODE_8914_length_898_cov_52.405507	481	561	0	12	80	0.1500000
NODE_8914_length_898_cov_52.405507	481	561	2	25	80	0.3125000
NODE_8914_length_898_cov_52.405507	481	561	8	43	80	0.5375000
NODE_8915_length_898_cov_44.973717	363	443	0	80	80	1.0000000
NODE_8915_length_898_cov_44.973717	416	496	0	80	80	1.0000000
NODE_8916_length_898_cov_38.269086	425	505	0	80	80	1.0000000
NODE_8916_length_898_cov_38.269086	478	558	0	80	80	1.0000000
NODE_8917_length_898_cov_27.006258	465	545	19	2	80	0.0250000
NODE_8917_length_898_cov_27.006258	465	545	28	27	80	0.3375000
NODE_8917_length_898_cov_27.006258	465	545	29	22	80	0.2750000
NODE_8917_length_898_cov_27.006258	465	545	30	10	80	0.1250000
NODE_8917_length_898_cov_27.006258	465	545	31	2	80	0.0250000
NODE_8917_length_898_cov_27.006258	465	545	32	17	80	0.2125000
NODE_8917_length_898_cov_27.006258	518	598	19	55	80	0.6875000
NODE_8917_length_898_cov_27.006258	518	598	28	3	80	0.0375000
NODE_8917_length_898_cov_27.006258	518	598	30	3	80	0.0375000
NODE_8917_length_898_cov_27.006258	518	598	31	2	80	0.0250000
NODE_8917_length_898_cov_27.006258	518	598	32	17	80	0.2125000
NODE_8918_length_898_cov_25.902378	185	265	0	80	80	1.0000000
NODE_8918_length_898_cov_25.902378	238	318	0	80	80	1.0000000
NODE_8918_length_898_cov_25.902378	314	394	0	80	80	1.0000000
NODE_8918_length_898_cov_25.902378	367	447	0	80	80	1.0000000
NODE_8919_length_898_cov_25.209011	368	448	0	80	80	1.0000000
NODE_8919_length_898_cov_25.209011	421	501	0	80	80	1.0000000
NODE_8920_length_898_cov_21.923655	325	405	0	80	80	1.0000000
NODE_8920_length_898_cov_21.923655	378	458	0	80	80	1.0000000
NODE_8921_length_898_cov_21.065081	306	386	0	80	80	1.0000000
NODE_8921_length_898_cov_21.065081	359	439	0	80	80	1.0000000
NODE_8922_length_898_cov_20.954944	374	454	0	80	80	1.0000000
NODE_8922_length_898_cov_20.954944	427	507	0	80	80	1.0000000
NODE_8923_length_898_cov_17.387985	398	478	0	80	80	1.0000000
NODE_8923_length_898_cov_17.387985	451	531	0	80	80	1.0000000
NODE_8924_length_898_cov_17.252816	265	345	0	80	80	1.0000000
NODE_8924_length_898_cov_17.252816	318	398	0	80	80	1.0000000
NODE_8926_length_898_cov_13.152691	455	535	0	80	80	1.0000000
NODE_8926_length_898_cov_13.152691	508	588	0	80	80	1.0000000
NODE_8927_length_898_cov_12.612015	375	455	0	80	80	1.0000000
NODE_8927_length_898_cov_12.612015	428	508	0	80	80	1.0000000
NODE_8928_length_898_cov_12.498123	428	508	0	80	80	1.0000000
NODE_8928_length_898_cov_12.498123	481	561	0	80	80	1.0000000
NODE_8932_length_898_cov_1.790989	0	56	0	56	56	1.0000000
NODE_8932_length_898_cov_1.790989	29	93	0	62	64	0.9687500
NODE_8932_length_898_cov_1.790989	29	93	2	2	64	0.0312500
NODE_8944_length_897_cov_63.921053	350	430	0	18	80	0.2250000
NODE_8944_length_897_cov_63.921053	350	430	11	62	80	0.7750000
NODE_8944_length_897_cov_63.921053	403	483	0	71	80	0.8875000
NODE_8944_length_897_cov_63.921053	403	483	11	9	80	0.1125000
NODE_8945_length_897_cov_58.921053	316	396	2	80	80	1.0000000
NODE_8945_length_897_cov_58.921053	369	449	0	17	80	0.2125000
NODE_8945_length_897_cov_58.921053	369	449	2	63	80	0.7875000
NODE_8946_length_897_cov_35.946115	324	404	0	80	80	1.0000000
NODE_8946_length_897_cov_35.946115	377	457	0	80	80	1.0000000
NODE_8947_length_897_cov_25.548872	238	318	0	80	80	1.0000000
NODE_8947_length_897_cov_25.548872	291	371	0	80	80	1.0000000
NODE_8948_length_897_cov_24.913534	399	479	0	80	80	1.0000000
NODE_8948_length_897_cov_24.913534	452	532	0	80	80	1.0000000
NODE_8949_length_897_cov_21.839599	308	388	0	80	80	1.0000000
NODE_8949_length_897_cov_21.839599	361	441	0	80	80	1.0000000
NODE_8950_length_897_cov_19.355890	489	569	0	80	80	1.0000000
NODE_8950_length_897_cov_19.355890	542	622	0	80	80	1.0000000
NODE_8951_length_897_cov_16.295739	209	289	0	80	80	1.0000000
NODE_8951_length_897_cov_16.295739	262	342	0	80	80	1.0000000
NODE_8952_length_897_cov_14.766917	395	475	0	20	80	0.2500000
NODE_8952_length_897_cov_14.766917	395	475	6	60	80	0.7500000
NODE_8952_length_897_cov_14.766917	448	528	5	10	80	0.1250000
NODE_8952_length_897_cov_14.766917	448	528	6	70	80	0.8750000
NODE_8953_length_897_cov_14.219298	253	333	0	80	80	1.0000000
NODE_8953_length_897_cov_14.219298	306	386	0	80	80	1.0000000
NODE_8954_length_897_cov_11.116541	182	262	0	80	80	1.0000000
NODE_8954_length_897_cov_11.116541	235	315	0	80	80	1.0000000
NODE_8955_length_897_cov_8.211779	303	383	0	80	80	1.0000000
NODE_8955_length_897_cov_8.211779	356	436	0	80	80	1.0000000
NODE_8973_length_896_cov_48.249686	397	477	23	64	80	0.8000000
NODE_8973_length_896_cov_48.249686	397	477	24	16	80	0.2000000
NODE_8973_length_896_cov_48.249686	450	530	0	25	80	0.3125000
NODE_8973_length_896_cov_48.249686	450	530	19	14	80	0.1750000
NODE_8973_length_896_cov_48.249686	450	530	23	16	80	0.2000000
NODE_8973_length_896_cov_48.249686	450	530	24	25	80	0.3125000
NODE_8974_length_896_cov_24.824341	213	293	0	80	80	1.0000000
NODE_8974_length_896_cov_24.824341	266	346	0	80	80	1.0000000
NODE_8975_length_896_cov_23.130489	333	413	0	80	80	1.0000000
NODE_8975_length_896_cov_23.130489	386	466	0	80	80	1.0000000
NODE_8975_length_896_cov_23.130489	462	542	0	26	80	0.3250000
NODE_8975_length_896_cov_23.130489	462	542	2	54	80	0.6750000
NODE_8975_length_896_cov_23.130489	515	595	0	36	80	0.4500000
NODE_8975_length_896_cov_23.130489	515	595	2	44	80	0.5500000
NODE_8976_length_896_cov_20.673777	361	441	0	80	80	1.0000000
NODE_8976_length_896_cov_20.673777	414	497	0	83	83	1.0000000
NODE_8977_length_896_cov_18.979925	418	498	0	80	80	1.0000000
NODE_8977_length_896_cov_18.979925	471	551	0	80	80	1.0000000
NODE_8978_length_896_cov_15.875784	340	420	0	80	80	1.0000000
NODE_8978_length_896_cov_15.875784	393	473	0	80	80	1.0000000
NODE_8980_length_896_cov_10.646173	337	417	0	80	80	1.0000000
NODE_8980_length_896_cov_10.646173	390	470	0	80	80	1.0000000
NODE_8981_length_896_cov_10.351317	327	407	0	80	80	1.0000000
NODE_8981_length_896_cov_10.351317	380	460	0	80	80	1.0000000
NODE_8982_length_896_cov_9.754078	411	491	0	80	80	1.0000000
NODE_8982_length_896_cov_9.754078	464	544	0	80	80	1.0000000
NODE_8983_length_896_cov_8.069009	340	422	0	82	82	1.0000000
NODE_8983_length_896_cov_8.069009	395	475	0	80	80	1.0000000
NODE_8986_length_896_cov_4.939774	384	464	0	80	80	1.0000000
NODE_8986_length_896_cov_4.939774	437	517	0	80	80	1.0000000
NODE_9005_length_895_cov_54.949749	378	458	0	80	80	1.0000000
NODE_9005_length_895_cov_54.949749	431	511	0	80	80	1.0000000
NODE_9006_length_895_cov_53.945980	306	386	0	80	80	1.0000000
NODE_9006_length_895_cov_53.945980	359	439	0	80	80	1.0000000
NODE_9007_length_895_cov_48.915829	369	449	0	80	80	1.0000000
NODE_9007_length_895_cov_48.915829	422	502	0	80	80	1.0000000
NODE_9007_length_895_cov_48.915829	498	578	0	37	80	0.4625000
NODE_9007_length_895_cov_48.915829	498	578	2	43	80	0.5375000
NODE_9007_length_895_cov_48.915829	551	631	0	16	80	0.2000000
NODE_9007_length_895_cov_48.915829	551	631	1	1	80	0.0125000
NODE_9007_length_895_cov_48.915829	551	631	2	63	80	0.7875000
NODE_9008_length_895_cov_38.347990	452	532	0	80	80	1.0000000
NODE_9008_length_895_cov_38.347990	505	585	0	80	80	1.0000000
NODE_9009_length_895_cov_33.716080	418	499	0	81	81	1.0000000
NODE_9009_length_895_cov_33.716080	472	552	0	80	80	1.0000000
NODE_9010_length_895_cov_21.630653	392	468	0	76	76	1.0000000
NODE_9010_length_895_cov_21.630653	441	521	0	80	80	1.0000000
NODE_9011_length_895_cov_19.932161	331	411	0	80	80	1.0000000
NODE_9011_length_895_cov_19.932161	384	464	0	80	80	1.0000000
NODE_9011_length_895_cov_19.932161	460	540	0	80	80	1.0000000
NODE_9011_length_895_cov_19.932161	513	593	0	80	80	1.0000000
NODE_9012_length_895_cov_16.037688	403	479	0	22	76	0.2894737
NODE_9012_length_895_cov_16.037688	403	479	2	54	76	0.7105263
NODE_9012_length_895_cov_16.037688	452	532	0	22	80	0.2750000
NODE_9012_length_895_cov_16.037688	452	532	2	58	80	0.7250000
NODE_9013_length_895_cov_13.003769	372	452	2	80	80	1.0000000
NODE_9013_length_895_cov_13.003769	425	491	0	3	66	0.0454545
NODE_9013_length_895_cov_13.003769	425	491	2	63	66	0.9545454
NODE_9014_length_895_cov_12.736181	280	360	0	80	80	1.0000000
NODE_9014_length_895_cov_12.736181	333	413	0	80	80	1.0000000
NODE_9015_length_895_cov_11.090452	505	585	1	2	80	0.0250000
NODE_9015_length_895_cov_11.090452	505	585	2	78	80	0.9750000
NODE_9015_length_895_cov_11.090452	558	638	2	80	80	1.0000000
NODE_9016_length_895_cov_9.266332	468	548	0	80	80	1.0000000
NODE_9016_length_895_cov_9.266332	521	601	0	80	80	1.0000000
NODE_9018_length_895_cov_5.659548	472	552	0	80	80	1.0000000
NODE_9018_length_895_cov_5.659548	525	605	0	80	80	1.0000000
NODE_9019_length_895_cov_5.383166	42	123	0	30	81	0.3703704
NODE_9019_length_895_cov_5.383166	42	123	2	51	81	0.6296296
NODE_9030_length_894_cov_60.153459	446	526	0	49	80	0.6125000
NODE_9030_length_894_cov_60.153459	446	526	2	31	80	0.3875000
NODE_9030_length_894_cov_60.153459	499	579	2	80	80	1.0000000
NODE_9031_length_894_cov_49.618868	373	453	0	80	80	1.0000000
NODE_9031_length_894_cov_49.618868	426	506	0	80	80	1.0000000
NODE_9032_length_894_cov_33.228931	459	539	0	5	80	0.0625000
NODE_9032_length_894_cov_33.228931	459	539	2	75	80	0.9375000
NODE_9032_length_894_cov_33.228931	512	592	0	50	80	0.6250000
NODE_9032_length_894_cov_33.228931	512	592	2	30	80	0.3750000
NODE_9033_length_894_cov_31.933333	411	491	0	80	80	1.0000000
NODE_9033_length_894_cov_31.933333	464	544	0	80	80	1.0000000
NODE_9034_length_894_cov_30.499371	270	350	0	80	80	1.0000000
NODE_9034_length_894_cov_30.499371	323	403	0	80	80	1.0000000
NODE_9034_length_894_cov_30.499371	399	479	0	80	80	1.0000000
NODE_9034_length_894_cov_30.499371	452	532	0	80	80	1.0000000
NODE_9035_length_894_cov_23.046541	79	159	0	80	80	1.0000000
NODE_9035_length_894_cov_23.046541	132	212	0	80	80	1.0000000
NODE_9036_length_894_cov_22.266667	381	461	0	23	80	0.2875000
NODE_9036_length_894_cov_22.266667	381	461	6	31	80	0.3875000
NODE_9036_length_894_cov_22.266667	381	461	8	18	80	0.2250000
NODE_9036_length_894_cov_22.266667	381	461	10	8	80	0.1000000
NODE_9036_length_894_cov_22.266667	434	514	2	2	80	0.0250000
NODE_9036_length_894_cov_22.266667	434	514	4	18	80	0.2250000
NODE_9036_length_894_cov_22.266667	434	514	6	1	80	0.0125000
NODE_9036_length_894_cov_22.266667	434	514	8	18	80	0.2250000
NODE_9036_length_894_cov_22.266667	434	514	10	41	80	0.5125000
NODE_9037_length_894_cov_21.997484	332	412	0	80	80	1.0000000
NODE_9037_length_894_cov_21.997484	385	465	0	80	80	1.0000000
NODE_9038_length_894_cov_21.205031	319	399	0	80	80	1.0000000
NODE_9038_length_894_cov_21.205031	372	452	0	80	80	1.0000000
NODE_9038_length_894_cov_21.205031	448	528	0	80	80	1.0000000
NODE_9038_length_894_cov_21.205031	501	581	0	80	80	1.0000000
NODE_9039_length_894_cov_21.132075	422	502	0	80	80	1.0000000
NODE_9039_length_894_cov_21.132075	475	555	0	80	80	1.0000000
NODE_9040_length_894_cov_15.598742	338	418	0	80	80	1.0000000
NODE_9040_length_894_cov_15.598742	391	471	0	80	80	1.0000000
NODE_9041_length_894_cov_14.079245	344	424	0	80	80	1.0000000
NODE_9041_length_894_cov_14.079245	397	477	0	80	80	1.0000000
NODE_9042_length_894_cov_13.031447	336	416	0	58	80	0.7250000
NODE_9042_length_894_cov_13.031447	336	416	2	22	80	0.2750000
NODE_9042_length_894_cov_13.031447	389	469	0	80	80	1.0000000
NODE_9043_length_894_cov_13.031447	353	433	0	80	80	1.0000000
NODE_9043_length_894_cov_13.031447	406	486	0	80	80	1.0000000
NODE_9044_length_894_cov_9.706918	330	410	0	80	80	1.0000000
NODE_9045_length_894_cov_6.963522	378	458	0	80	80	1.0000000
NODE_9045_length_894_cov_6.963522	431	511	0	80	80	1.0000000
NODE_9046_length_894_cov_4.993711	365	445	0	41	80	0.5125000
NODE_9046_length_894_cov_4.993711	365	445	6	39	80	0.4875000
NODE_9046_length_894_cov_4.993711	418	498	6	80	80	1.0000000
NODE_9066_length_893_cov_59.134761	261	341	0	69	80	0.8625000
NODE_9066_length_893_cov_59.134761	261	341	2	11	80	0.1375000
NODE_9066_length_893_cov_59.134761	314	394	0	34	80	0.4250000
NODE_9066_length_893_cov_59.134761	314	394	2	46	80	0.5750000
NODE_9067_length_893_cov_58.991184	388	468	0	80	80	1.0000000
NODE_9067_length_893_cov_58.991184	441	521	0	80	80	1.0000000
NODE_9067_length_893_cov_58.991184	517	597	0	80	80	1.0000000
NODE_9067_length_893_cov_58.991184	570	650	0	30	80	0.3750000
NODE_9067_length_893_cov_58.991184	570	650	6	50	80	0.6250000
NODE_9068_length_893_cov_55.644836	434	514	0	80	80	1.0000000
NODE_9068_length_893_cov_55.644836	487	567	0	80	80	1.0000000
NODE_9068_length_893_cov_55.644836	563	643	0	80	80	1.0000000
NODE_9068_length_893_cov_55.644836	616	696	0	80	80	1.0000000
NODE_9069_length_893_cov_54.803526	479	559	0	80	80	1.0000000
NODE_9069_length_893_cov_54.803526	532	612	0	80	80	1.0000000
NODE_9070_length_893_cov_38.147355	391	471	0	80	80	1.0000000
NODE_9070_length_893_cov_38.147355	444	524	0	80	80	1.0000000
NODE_9071_length_893_cov_33.690176	387	467	0	80	80	1.0000000
NODE_9071_length_893_cov_33.690176	440	520	0	80	80	1.0000000
NODE_9072_length_893_cov_32.162469	524	604	0	80	80	1.0000000
NODE_9072_length_893_cov_32.162469	577	657	0	80	80	1.0000000
NODE_9073_length_893_cov_31.916877	344	424	0	80	80	1.0000000
NODE_9073_length_893_cov_31.916877	397	477	0	80	80	1.0000000
NODE_9074_length_893_cov_28.693955	437	517	0	80	80	1.0000000
NODE_9074_length_893_cov_28.693955	490	570	0	80	80	1.0000000
NODE_9075_length_893_cov_23.564232	363	443	0	80	80	1.0000000
NODE_9075_length_893_cov_23.564232	416	496	0	80	80	1.0000000
NODE_9076_length_893_cov_22.633501	272	352	0	80	80	1.0000000
NODE_9076_length_893_cov_22.633501	272	352	0	80	80	1.0000000
NODE_9076_length_893_cov_22.633501	272	352	0	80	80	1.0000000
NODE_9076_length_893_cov_22.633501	325	405	0	80	80	1.0000000
NODE_9076_length_893_cov_22.633501	325	405	0	80	80	1.0000000
NODE_9076_length_893_cov_22.633501	325	405	0	80	80	1.0000000
NODE_9076_length_893_cov_22.633501	401	481	0	80	80	1.0000000
NODE_9076_length_893_cov_22.633501	454	534	0	80	80	1.0000000
NODE_9077_length_893_cov_22.403023	453	533	0	80	80	1.0000000
NODE_9077_length_893_cov_22.403023	506	586	0	80	80	1.0000000
NODE_9078_length_893_cov_19.423174	298	378	0	80	80	1.0000000
NODE_9078_length_893_cov_19.423174	351	431	0	80	80	1.0000000
NODE_9078_length_893_cov_19.423174	427	507	0	80	80	1.0000000
NODE_9078_length_893_cov_19.423174	480	560	0	37	80	0.4625000
NODE_9078_length_893_cov_19.423174	480	560	4	43	80	0.5375000
NODE_9079_length_893_cov_19.389169	360	440	0	80	80	1.0000000
NODE_9079_length_893_cov_19.389169	413	493	0	80	80	1.0000000
NODE_9079_length_893_cov_19.389169	489	569	0	80	80	1.0000000
NODE_9079_length_893_cov_19.389169	542	622	0	80	80	1.0000000
NODE_9080_length_893_cov_18.152393	394	474	0	3	80	0.0375000
NODE_9080_length_893_cov_18.152393	394	474	2	77	80	0.9625000
NODE_9080_length_893_cov_18.152393	447	527	0	56	80	0.7000000
NODE_9080_length_893_cov_18.152393	447	527	2	24	80	0.3000000
NODE_9081_length_893_cov_15.960957	442	522	0	80	80	1.0000000
NODE_9081_length_893_cov_15.960957	495	575	0	80	80	1.0000000
NODE_9082_length_893_cov_13.119647	473	553	0	80	80	1.0000000
NODE_9082_length_893_cov_13.119647	526	606	0	45	80	0.5625000
NODE_9082_length_893_cov_13.119647	526	606	2	35	80	0.4375000
NODE_9084_length_893_cov_5.549118	353	415	0	12	62	0.1935484
NODE_9084_length_893_cov_5.549118	353	415	2	50	62	0.8064516
NODE_9100_length_893_cov_1.141058	28	108	2	29	80	0.3625000
NODE_9100_length_893_cov_1.141058	28	108	4	51	80	0.6375000
NODE_9104_length_892_cov_74.968474	333	413	0	29	80	0.3625000
NODE_9104_length_892_cov_74.968474	333	413	4	51	80	0.6375000
NODE_9104_length_892_cov_74.968474	386	466	0	41	80	0.5125000
NODE_9104_length_892_cov_74.968474	386	466	2	39	80	0.4875000
NODE_9104_length_892_cov_74.968474	462	542	0	50	80	0.6250000
NODE_9104_length_892_cov_74.968474	462	542	1	1	80	0.0125000
NODE_9104_length_892_cov_74.968474	462	542	2	29	80	0.3625000
NODE_9104_length_892_cov_74.968474	515	595	0	80	80	1.0000000
NODE_9105_length_892_cov_54.549811	463	550	0	41	87	0.4712644
NODE_9105_length_892_cov_54.549811	463	550	2	46	87	0.5287356
NODE_9105_length_892_cov_54.549811	523	603	2	80	80	1.0000000
NODE_9105_length_892_cov_54.549811	599	679	0	68	80	0.8500000
NODE_9105_length_892_cov_54.549811	599	679	2	12	80	0.1500000
NODE_9106_length_892_cov_37.887768	373	453	0	80	80	1.0000000
NODE_9106_length_892_cov_37.887768	426	506	0	80	80	1.0000000
NODE_9107_length_892_cov_19.732661	361	441	0	80	80	1.0000000
NODE_9107_length_892_cov_19.732661	414	494	0	80	80	1.0000000
NODE_9108_length_892_cov_19.052963	290	370	0	80	80	1.0000000
NODE_9108_length_892_cov_19.052963	343	423	0	80	80	1.0000000
NODE_9108_length_892_cov_19.052963	419	499	0	80	80	1.0000000
NODE_9108_length_892_cov_19.052963	472	552	0	80	80	1.0000000
NODE_9109_length_892_cov_17.276166	341	421	0	80	80	1.0000000
NODE_9109_length_892_cov_17.276166	394	474	0	45	80	0.5625000
NODE_9109_length_892_cov_17.276166	394	474	2	35	80	0.4375000
NODE_9110_length_892_cov_16.312736	411	491	0	80	80	1.0000000
NODE_9110_length_892_cov_16.312736	464	544	0	80	80	1.0000000
NODE_9111_length_892_cov_15.808323	395	475	8	80	80	1.0000000
NODE_9111_length_892_cov_15.808323	448	528	0	33	80	0.4125000
NODE_9111_length_892_cov_15.808323	448	528	8	47	80	0.5875000
NODE_9112_length_892_cov_14.020177	522	602	0	80	80	1.0000000
NODE_9112_length_892_cov_14.020177	575	655	0	80	80	1.0000000
NODE_9114_length_892_cov_8.798235	400	480	0	80	80	1.0000000
NODE_9114_length_892_cov_8.798235	453	533	0	80	80	1.0000000
NODE_9115_length_892_cov_8.413619	428	508	0	80	80	1.0000000
NODE_9115_length_892_cov_8.413619	481	561	0	80	80	1.0000000
NODE_9116_length_892_cov_6.694830	374	454	0	80	80	1.0000000
NODE_9116_length_892_cov_6.694830	427	507	0	80	80	1.0000000
NODE_9134_length_891_cov_30.166667	295	375	0	29	80	0.3625000
NODE_9134_length_891_cov_30.166667	295	375	4	51	80	0.6375000
NODE_9134_length_891_cov_30.166667	348	428	0	13	80	0.1625000
NODE_9134_length_891_cov_30.166667	348	428	4	67	80	0.8375000
NODE_9135_length_891_cov_26.333333	319	399	0	80	80	1.0000000
NODE_9135_length_891_cov_26.333333	372	452	0	80	80	1.0000000
NODE_9136_length_891_cov_22.228535	336	416	0	80	80	1.0000000
NODE_9136_length_891_cov_22.228535	389	469	0	80	80	1.0000000
NODE_9137_length_891_cov_20.446970	377	457	0	80	80	1.0000000
NODE_9137_length_891_cov_20.446970	430	510	0	80	80	1.0000000
NODE_9138_length_891_cov_20.226010	310	390	0	80	80	1.0000000
NODE_9138_length_891_cov_20.226010	363	443	0	80	80	1.0000000
NODE_9140_length_891_cov_13.207071	392	472	0	80	80	1.0000000
NODE_9140_length_891_cov_13.207071	445	525	0	80	80	1.0000000
NODE_9141_length_891_cov_11.579545	379	459	0	80	80	1.0000000
NODE_9141_length_891_cov_11.579545	432	512	0	80	80	1.0000000
NODE_9142_length_891_cov_11.117424	499	579	0	80	80	1.0000000
NODE_9142_length_891_cov_11.117424	552	632	0	67	80	0.8375000
NODE_9142_length_891_cov_11.117424	552	632	2	13	80	0.1625000
NODE_9153_length_890_cov_29.070796	284	364	0	80	80	1.0000000
NODE_9153_length_890_cov_29.070796	337	417	0	80	80	1.0000000
NODE_9153_length_890_cov_29.070796	413	497	0	84	84	1.0000000
NODE_9153_length_890_cov_29.070796	470	550	0	80	80	1.0000000
NODE_9154_length_890_cov_27.295828	550	630	0	80	80	1.0000000
NODE_9154_length_890_cov_27.295828	603	683	0	80	80	1.0000000
NODE_9155_length_890_cov_18.088496	80	135	0	55	55	1.0000000
NODE_9155_length_890_cov_18.088496	276	356	0	72	80	0.9000000
NODE_9155_length_890_cov_18.088496	276	356	2	8	80	0.1000000
NODE_9155_length_890_cov_18.088496	329	406	0	19	77	0.2467532
NODE_9155_length_890_cov_18.088496	329	406	2	58	77	0.7532467
NODE_9156_length_890_cov_16.831858	402	482	0	80	80	1.0000000
NODE_9156_length_890_cov_16.831858	455	535	0	80	80	1.0000000
NODE_9157_length_890_cov_11.881163	222	302	0	80	80	1.0000000
NODE_9157_length_890_cov_11.881163	275	355	0	80	80	1.0000000
NODE_9158_length_890_cov_8.676359	335	415	0	80	80	1.0000000
NODE_9158_length_890_cov_8.676359	388	468	0	80	80	1.0000000
NODE_9183_length_889_cov_61.520253	334	414	0	39	80	0.4875000
NODE_9183_length_889_cov_61.520253	334	414	4	41	80	0.5125000
NODE_9183_length_889_cov_61.520253	387	467	4	80	80	1.0000000
NODE_9183_length_889_cov_61.520253	463	543	0	72	80	0.9000000
NODE_9183_length_889_cov_61.520253	463	543	4	8	80	0.1000000
NODE_9183_length_889_cov_61.520253	516	596	0	80	80	1.0000000
NODE_9184_length_889_cov_30.012658	311	391	0	25	80	0.3125000
NODE_9184_length_889_cov_30.012658	311	391	2	55	80	0.6875000
NODE_9184_length_889_cov_30.012658	364	444	0	78	80	0.9750000
NODE_9184_length_889_cov_30.012658	364	444	2	2	80	0.0250000
NODE_9185_length_889_cov_28.217722	413	483	0	70	70	1.0000000
NODE_9185_length_889_cov_28.217722	466	542	0	76	76	1.0000000
NODE_9186_length_889_cov_27.924051	379	449	0	70	70	1.0000000
NODE_9186_length_889_cov_27.924051	432	512	0	80	80	1.0000000
NODE_9187_length_889_cov_25.887342	227	285	0	58	58	1.0000000
NODE_9187_length_889_cov_25.887342	258	337	0	79	79	1.0000000
NODE_9188_length_889_cov_22.992405	451	531	0	56	80	0.7000000
NODE_9188_length_889_cov_22.992405	451	531	7	1	80	0.0125000
NODE_9188_length_889_cov_22.992405	451	531	8	23	80	0.2875000
NODE_9188_length_889_cov_22.992405	504	584	0	3	80	0.0375000
NODE_9188_length_889_cov_22.992405	504	584	7	1	80	0.0125000
NODE_9188_length_889_cov_22.992405	504	584	8	76	80	0.9500000
NODE_9189_length_889_cov_20.703797	331	411	0	35	80	0.4375000
NODE_9189_length_889_cov_20.703797	331	411	4	45	80	0.5625000
NODE_9189_length_889_cov_20.703797	384	464	2	10	80	0.1250000
NODE_9189_length_889_cov_20.703797	384	464	4	69	80	0.8625000
NODE_9189_length_889_cov_20.703797	384	464	6	1	80	0.0125000
NODE_9190_length_889_cov_20.226582	234	314	0	80	80	1.0000000
NODE_9190_length_889_cov_20.226582	287	367	0	80	80	1.0000000
NODE_9191_length_889_cov_15.587342	407	487	0	80	80	1.0000000
NODE_9191_length_889_cov_15.587342	460	540	0	80	80	1.0000000
NODE_9192_length_889_cov_12.669620	313	393	0	80	80	1.0000000
NODE_9192_length_889_cov_12.669620	366	446	0	80	80	1.0000000
NODE_9193_length_889_cov_12.198734	399	479	0	19	80	0.2375000
NODE_9193_length_889_cov_12.198734	399	479	2	61	80	0.7625000
NODE_9193_length_889_cov_12.198734	452	532	0	14	80	0.1750000
NODE_9193_length_889_cov_12.198734	452	532	2	66	80	0.8250000
NODE_9197_length_889_cov_3.841772	187	267	0	80	80	1.0000000
NODE_9197_length_889_cov_3.841772	240	320	0	80	80	1.0000000
NODE_9213_length_888_cov_37.102662	490	570	0	16	80	0.2000000
NODE_9213_length_888_cov_37.102662	490	570	2	64	80	0.8000000
NODE_9213_length_888_cov_37.102662	543	623	2	80	80	1.0000000
NODE_9214_length_888_cov_28.230672	366	446	0	80	80	1.0000000
NODE_9214_length_888_cov_28.230672	419	499	0	80	80	1.0000000
NODE_9215_length_888_cov_25.243346	391	471	0	80	80	1.0000000
NODE_9215_length_888_cov_25.243346	444	524	0	80	80	1.0000000
NODE_9216_length_888_cov_21.045627	236	316	0	80	80	1.0000000
NODE_9216_length_888_cov_21.045627	289	367	0	78	78	1.0000000
NODE_9218_length_888_cov_13.447402	515	595	0	80	80	1.0000000
NODE_9218_length_888_cov_13.447402	568	648	0	80	80	1.0000000
NODE_9219_length_888_cov_12.806084	179	259	0	80	80	1.0000000
NODE_9219_length_888_cov_12.806084	232	312	0	80	80	1.0000000
NODE_9219_length_888_cov_12.806084	308	388	0	80	80	1.0000000
NODE_9219_length_888_cov_12.806084	361	441	0	59	80	0.7375000
NODE_9219_length_888_cov_12.806084	361	441	2	21	80	0.2625000
NODE_9220_length_888_cov_12.551331	365	445	0	80	80	1.0000000
NODE_9220_length_888_cov_12.551331	418	498	0	80	80	1.0000000
NODE_9228_length_888_cov_2.041825	42	102	0	60	60	1.0000000
NODE_9237_length_887_cov_32.927665	514	594	0	8	80	0.1000000
NODE_9237_length_887_cov_32.927665	514	594	2	72	80	0.9000000
NODE_9237_length_887_cov_32.927665	567	647	0	19	80	0.2375000
NODE_9237_length_887_cov_32.927665	567	647	2	61	80	0.7625000
NODE_9238_length_887_cov_26.920051	358	438	0	80	80	1.0000000
NODE_9238_length_887_cov_26.920051	411	491	0	80	80	1.0000000
NODE_9239_length_887_cov_20.714467	304	384	0	80	80	1.0000000
NODE_9239_length_887_cov_20.714467	357	433	0	76	76	1.0000000
NODE_9240_length_887_cov_19.771574	407	487	0	80	80	1.0000000
NODE_9240_length_887_cov_19.771574	460	540	0	28	80	0.3500000
NODE_9240_length_887_cov_19.771574	460	540	2	52	80	0.6500000
NODE_9241_length_887_cov_14.535533	333	413	0	80	80	1.0000000
NODE_9241_length_887_cov_14.535533	386	466	0	80	80	1.0000000
NODE_9242_length_887_cov_14.114213	345	425	0	80	80	1.0000000
NODE_9242_length_887_cov_14.114213	398	478	0	80	80	1.0000000
NODE_9243_length_887_cov_9.451777	406	486	0	80	80	1.0000000
NODE_9243_length_887_cov_9.451777	459	539	0	80	80	1.0000000
NODE_9245_length_887_cov_6.656091	473	553	0	80	80	1.0000000
NODE_9245_length_887_cov_6.656091	526	606	0	80	80	1.0000000
NODE_9246_length_887_cov_4.719543	420	500	0	80	80	1.0000000
NODE_9246_length_887_cov_4.719543	473	553	0	80	80	1.0000000
NODE_9250_length_887_cov_2.583756	385	429	0	44	44	1.0000000
NODE_9250_length_887_cov_2.583756	393	428	0	35	35	1.0000000
NODE_9261_length_887_cov_1.087563	754	829	0	5	75	0.0666667
NODE_9261_length_887_cov_1.087563	754	829	2	5	75	0.0666667
NODE_9261_length_887_cov_1.087563	754	829	4	65	75	0.8666667
NODE_9264_length_886_cov_35.482846	365	445	0	80	80	1.0000000
NODE_9264_length_886_cov_35.482846	418	498	0	80	80	1.0000000
NODE_9265_length_886_cov_31.939009	438	518	0	80	80	1.0000000
NODE_9265_length_886_cov_31.939009	491	571	0	80	80	1.0000000
NODE_9266_length_886_cov_25.301144	326	406	2	2	80	0.0250000
NODE_9266_length_886_cov_25.301144	326	406	15	1	80	0.0125000
NODE_9266_length_886_cov_25.301144	326	406	16	1	80	0.0125000
NODE_9266_length_886_cov_25.301144	326	406	17	15	80	0.1875000
NODE_9266_length_886_cov_25.301144	326	406	29	1	80	0.0125000
NODE_9266_length_886_cov_25.301144	326	406	30	33	80	0.4125000
NODE_9266_length_886_cov_25.301144	326	406	34	5	80	0.0625000
NODE_9266_length_886_cov_25.301144	326	406	48	8	80	0.1000000
NODE_9266_length_886_cov_25.301144	326	406	50	14	80	0.1750000
NODE_9266_length_886_cov_25.301144	326	406	2	2	80	0.0250000
NODE_9266_length_886_cov_25.301144	326	406	15	1	80	0.0125000
NODE_9266_length_886_cov_25.301144	326	406	16	1	80	0.0125000
NODE_9266_length_886_cov_25.301144	326	406	17	15	80	0.1875000
NODE_9266_length_886_cov_25.301144	326	406	29	1	80	0.0125000
NODE_9266_length_886_cov_25.301144	326	406	30	33	80	0.4125000
NODE_9266_length_886_cov_25.301144	326	406	34	5	80	0.0625000
NODE_9266_length_886_cov_25.301144	326	406	48	8	80	0.1000000
NODE_9266_length_886_cov_25.301144	326	406	50	14	80	0.1750000
NODE_9266_length_886_cov_25.301144	379	459	34	5	80	0.0625000
NODE_9266_length_886_cov_25.301144	379	459	48	8	80	0.1000000
NODE_9266_length_886_cov_25.301144	379	459	49	25	80	0.3125000
NODE_9266_length_886_cov_25.301144	379	459	50	42	80	0.5250000
NODE_9266_length_886_cov_25.301144	379	459	34	5	80	0.0625000
NODE_9266_length_886_cov_25.301144	379	459	48	8	80	0.1000000
NODE_9266_length_886_cov_25.301144	379	459	49	25	80	0.3125000
NODE_9266_length_886_cov_25.301144	379	459	50	42	80	0.5250000
NODE_9267_length_886_cov_14.463787	327	407	0	80	80	1.0000000
NODE_9267_length_886_cov_14.463787	380	460	0	80	80	1.0000000
NODE_9286_length_885_cov_35.510178	373	453	0	80	80	1.0000000
NODE_9286_length_885_cov_35.510178	426	506	0	80	80	1.0000000
NODE_9287_length_885_cov_31.857506	368	448	0	80	80	1.0000000
NODE_9287_length_885_cov_31.857506	421	501	0	80	80	1.0000000
NODE_9288_length_885_cov_31.195929	395	475	0	80	80	1.0000000
NODE_9288_length_885_cov_31.195929	448	528	0	80	80	1.0000000
NODE_9289_length_885_cov_23.735369	356	436	0	80	80	1.0000000
NODE_9289_length_885_cov_23.735369	409	489	0	80	80	1.0000000
NODE_9289_length_885_cov_23.735369	485	565	0	80	80	1.0000000
NODE_9289_length_885_cov_23.735369	538	618	0	80	80	1.0000000
NODE_9290_length_885_cov_22.174300	340	420	0	80	80	1.0000000
NODE_9290_length_885_cov_22.174300	393	473	0	80	80	1.0000000
NODE_9290_length_885_cov_22.174300	469	549	0	80	80	1.0000000
NODE_9290_length_885_cov_22.174300	522	602	0	80	80	1.0000000
NODE_9291_length_885_cov_17.852417	413	493	0	69	80	0.8625000
NODE_9291_length_885_cov_17.852417	413	493	2	11	80	0.1375000
NODE_9291_length_885_cov_17.852417	466	546	0	16	80	0.2000000
NODE_9291_length_885_cov_17.852417	466	546	2	64	80	0.8000000
NODE_9292_length_885_cov_15.652672	346	426	0	80	80	1.0000000
NODE_9292_length_885_cov_15.652672	399	479	0	80	80	1.0000000
NODE_9292_length_885_cov_15.652672	475	555	0	80	80	1.0000000
NODE_9292_length_885_cov_15.652672	528	608	0	80	80	1.0000000
NODE_9293_length_885_cov_11.648855	530	610	0	80	80	1.0000000
NODE_9293_length_885_cov_11.648855	583	663	0	80	80	1.0000000
NODE_9294_length_885_cov_9.707379	611	691	0	80	80	1.0000000
NODE_9294_length_885_cov_9.707379	664	744	0	80	80	1.0000000
NODE_9311_length_884_cov_73.050955	536	616	0	80	80	1.0000000
NODE_9311_length_884_cov_73.050955	589	669	0	80	80	1.0000000
NODE_9312_length_884_cov_28.373248	381	461	0	80	80	1.0000000
NODE_9312_length_884_cov_28.373248	434	514	0	80	80	1.0000000
NODE_9313_length_884_cov_20.649682	463	543	0	80	80	1.0000000
NODE_9313_length_884_cov_20.649682	516	596	0	80	80	1.0000000
NODE_9314_length_884_cov_13.391083	225	305	0	80	80	1.0000000
NODE_9314_length_884_cov_13.391083	278	358	0	80	80	1.0000000
NODE_9315_length_884_cov_9.192357	278	358	0	80	80	1.0000000
NODE_9315_length_884_cov_9.192357	331	411	0	80	80	1.0000000
NODE_9315_length_884_cov_9.192357	407	487	0	80	80	1.0000000
NODE_9315_length_884_cov_9.192357	460	540	0	80	80	1.0000000
NODE_9335_length_883_cov_46.780612	344	424	0	80	80	1.0000000
NODE_9335_length_883_cov_46.780612	397	477	0	80	80	1.0000000
NODE_9336_length_883_cov_46.304847	387	467	0	80	80	1.0000000
NODE_9336_length_883_cov_46.304847	440	520	0	80	80	1.0000000
NODE_9337_length_883_cov_39.579082	410	490	0	80	80	1.0000000
NODE_9337_length_883_cov_39.579082	463	543	0	80	80	1.0000000
NODE_9338_length_883_cov_28.307398	379	459	0	9	80	0.1125000
NODE_9338_length_883_cov_28.307398	379	459	4	1	80	0.0125000
NODE_9338_length_883_cov_28.307398	379	459	6	70	80	0.8750000
NODE_9338_length_883_cov_28.307398	432	512	2	27	80	0.3375000
NODE_9338_length_883_cov_28.307398	432	512	6	53	80	0.6625000
NODE_9339_length_883_cov_24.927296	429	509	0	80	80	1.0000000
NODE_9339_length_883_cov_24.927296	482	562	0	80	80	1.0000000
NODE_9341_length_883_cov_17.445153	326	406	1	80	80	1.0000000
NODE_9341_length_883_cov_17.445153	379	459	1	51	80	0.6375000
NODE_9341_length_883_cov_17.445153	379	459	2	29	80	0.3625000
NODE_9342_length_883_cov_14.660714	319	395	0	55	76	0.7236842
NODE_9342_length_883_cov_14.660714	319	395	2	21	76	0.2763158
NODE_9342_length_883_cov_14.660714	740	816	0	76	76	1.0000000
NODE_9343_length_883_cov_11.052296	223	303	0	80	80	1.0000000
NODE_9343_length_883_cov_11.052296	276	356	0	80	80	1.0000000
NODE_9344_length_883_cov_6.873724	0	66	2	2	66	0.0303030
NODE_9344_length_883_cov_6.873724	0	66	4	23	66	0.3484848
NODE_9344_length_883_cov_6.873724	0	66	6	3	66	0.0454545
NODE_9344_length_883_cov_6.873724	0	66	9	13	66	0.1969697
NODE_9344_length_883_cov_6.873724	0	66	10	20	66	0.3030303
NODE_9344_length_883_cov_6.873724	0	66	12	5	66	0.0757576
NODE_9345_length_883_cov_3.873724	471	551	0	76	80	0.9500000
NODE_9345_length_883_cov_3.873724	471	551	3	4	80	0.0500000
NODE_9345_length_883_cov_3.873724	524	604	0	23	80	0.2875000
NODE_9345_length_883_cov_3.873724	524	604	3	20	80	0.2500000
NODE_9345_length_883_cov_3.873724	524	604	5	37	80	0.4625000
NODE_9346_length_883_cov_3.247449	294	374	0	30	80	0.3750000
NODE_9346_length_883_cov_3.247449	294	374	4	50	80	0.6250000
NODE_9346_length_883_cov_3.247449	347	427	0	31	80	0.3875000
NODE_9346_length_883_cov_3.247449	347	427	4	49	80	0.6125000
NODE_9370_length_882_cov_24.241379	438	518	0	80	80	1.0000000
NODE_9370_length_882_cov_24.241379	491	571	0	80	80	1.0000000
NODE_9371_length_882_cov_23.145594	355	435	0	7	80	0.0875000
NODE_9371_length_882_cov_23.145594	355	435	5	3	80	0.0375000
NODE_9371_length_882_cov_23.145594	355	435	6	70	80	0.8750000
NODE_9371_length_882_cov_23.145594	408	488	0	4	80	0.0500000
NODE_9371_length_882_cov_23.145594	408	488	6	76	80	0.9500000
NODE_9372_length_882_cov_21.401022	335	415	0	80	80	1.0000000
NODE_9372_length_882_cov_21.401022	388	468	0	80	80	1.0000000
NODE_9373_length_882_cov_19.579821	456	511	0	55	55	1.0000000
NODE_9373_length_882_cov_19.579821	506	586	0	80	80	1.0000000
NODE_9373_length_882_cov_19.579821	559	639	0	80	80	1.0000000
NODE_9374_length_882_cov_19.342273	298	378	0	80	80	1.0000000
NODE_9374_length_882_cov_19.342273	351	431	0	80	80	1.0000000
NODE_9374_length_882_cov_19.342273	427	508	0	81	81	1.0000000
NODE_9374_length_882_cov_19.342273	481	561	0	80	80	1.0000000
NODE_9375_length_882_cov_11.873563	267	347	0	80	80	1.0000000
NODE_9375_length_882_cov_11.873563	320	400	0	80	80	1.0000000
NODE_9376_length_882_cov_8.794381	430	510	0	80	80	1.0000000
NODE_9376_length_882_cov_8.794381	483	563	0	80	80	1.0000000
NODE_9377_length_882_cov_7.537676	527	608	0	81	81	1.0000000
NODE_9379_length_882_cov_6.696041	355	435	0	80	80	1.0000000
NODE_9379_length_882_cov_6.696041	408	488	0	80	80	1.0000000
NODE_9380_length_882_cov_4.734355	585	665	0	80	80	1.0000000
NODE_9380_length_882_cov_4.734355	638	718	0	80	80	1.0000000
NODE_9398_length_881_cov_32.875959	444	524	0	80	80	1.0000000
NODE_9398_length_881_cov_32.875959	497	577	0	80	80	1.0000000
NODE_9399_length_881_cov_25.750639	43	117	2	74	74	1.0000000
NODE_9399_length_881_cov_25.750639	116	193	0	8	77	0.1038961
NODE_9399_length_881_cov_25.750639	116	193	1	6	77	0.0779221
NODE_9399_length_881_cov_25.750639	116	193	2	63	77	0.8181818
NODE_9400_length_881_cov_23.897698	286	365	0	79	79	1.0000000
NODE_9400_length_881_cov_23.897698	338	418	0	80	80	1.0000000
NODE_9401_length_881_cov_20.656010	359	439	0	80	80	1.0000000
NODE_9401_length_881_cov_20.656010	412	492	0	80	80	1.0000000
NODE_9402_length_881_cov_20.340153	242	322	0	80	80	1.0000000
NODE_9402_length_881_cov_20.340153	295	375	0	80	80	1.0000000
NODE_9403_length_881_cov_18.234015	420	500	0	16	80	0.2000000
NODE_9403_length_881_cov_18.234015	420	500	2	64	80	0.8000000
NODE_9403_length_881_cov_18.234015	473	553	0	2	80	0.0250000
NODE_9403_length_881_cov_18.234015	473	553	2	78	80	0.9750000
NODE_9404_length_881_cov_17.748082	291	371	0	15	80	0.1875000
NODE_9404_length_881_cov_17.748082	291	371	4	65	80	0.8125000
NODE_9404_length_881_cov_17.748082	344	424	0	30	80	0.3750000
NODE_9404_length_881_cov_17.748082	344	424	4	50	80	0.6250000
NODE_9405_length_881_cov_12.884910	332	412	0	80	80	1.0000000
NODE_9405_length_881_cov_12.884910	385	465	0	80	80	1.0000000
NODE_9406_length_881_cov_6.473146	474	553	0	79	79	1.0000000
NODE_9406_length_881_cov_6.473146	514	594	0	80	80	1.0000000
NODE_9406_length_881_cov_6.473146	526	565	0	39	39	1.0000000
NODE_9406_length_881_cov_6.473146	555	606	0	51	51	1.0000000
NODE_9406_length_881_cov_6.473146	567	647	0	80	80	1.0000000
NODE_9407_length_881_cov_5.615090	547	627	0	33	80	0.4125000
NODE_9407_length_881_cov_5.615090	547	627	2	47	80	0.5875000
NODE_9407_length_881_cov_5.615090	600	680	0	80	80	1.0000000
NODE_9424_length_880_cov_26.663252	320	400	0	80	80	1.0000000
NODE_9424_length_880_cov_26.663252	373	453	0	80	80	1.0000000
NODE_9425_length_880_cov_21.828425	328	408	0	80	80	1.0000000
NODE_9425_length_880_cov_21.828425	381	461	0	80	80	1.0000000
NODE_9426_length_880_cov_20.245839	427	507	3	17	80	0.2125000
NODE_9426_length_880_cov_20.245839	427	507	13	15	80	0.1875000
NODE_9426_length_880_cov_20.245839	427	507	16	48	80	0.6000000
NODE_9426_length_880_cov_20.245839	480	560	9	8	80	0.1000000
NODE_9426_length_880_cov_20.245839	480	560	12	30	80	0.3750000
NODE_9426_length_880_cov_20.245839	480	560	16	42	80	0.5250000
NODE_9427_length_880_cov_19.434059	0	69	0	69	69	1.0000000
NODE_9428_length_880_cov_11.843790	363	430	0	67	67	1.0000000
NODE_9429_length_880_cov_11.544174	185	265	0	80	80	1.0000000
NODE_9429_length_880_cov_11.544174	238	318	0	80	80	1.0000000
NODE_9430_length_880_cov_10.956466	354	434	0	33	80	0.4125000
NODE_9430_length_880_cov_10.956466	354	434	2	47	80	0.5875000
NODE_9430_length_880_cov_10.956466	407	487	0	17	80	0.2125000
NODE_9430_length_880_cov_10.956466	407	487	2	63	80	0.7875000
NODE_9431_length_880_cov_10.008963	395	474	0	79	79	1.0000000
NODE_9431_length_880_cov_10.008963	448	527	0	79	79	1.0000000
NODE_9453_length_879_cov_23.565385	326	406	1	80	80	1.0000000
NODE_9453_length_879_cov_23.565385	379	459	1	39	80	0.4875000
NODE_9453_length_879_cov_23.565385	379	459	2	41	80	0.5125000
NODE_9453_length_879_cov_23.565385	455	535	1	60	80	0.7500000
NODE_9453_length_879_cov_23.565385	455	535	2	20	80	0.2500000
NODE_9453_length_879_cov_23.565385	508	586	0	18	78	0.2307692
NODE_9453_length_879_cov_23.565385	508	586	1	60	78	0.7692308
NODE_9454_length_879_cov_20.758974	355	439	0	30	84	0.3571429
NODE_9454_length_879_cov_20.758974	355	439	2	42	84	0.5000000
NODE_9454_length_879_cov_20.758974	355	439	6	12	84	0.1428571
NODE_9454_length_879_cov_20.758974	412	492	0	74	80	0.9250000
NODE_9454_length_879_cov_20.758974	412	492	2	6	80	0.0750000
NODE_9455_length_879_cov_19.685897	295	375	0	55	80	0.6875000
NODE_9455_length_879_cov_19.685897	295	375	2	25	80	0.3125000
NODE_9455_length_879_cov_19.685897	348	428	0	80	80	1.0000000
NODE_9456_length_879_cov_17.738462	413	488	0	20	75	0.2666667
NODE_9456_length_879_cov_17.738462	413	488	2	55	75	0.7333333
NODE_9456_length_879_cov_17.738462	569	649	0	70	80	0.8750000
NODE_9456_length_879_cov_17.738462	569	649	2	10	80	0.1250000
NODE_9456_length_879_cov_17.738462	569	649	0	70	80	0.8750000
NODE_9456_length_879_cov_17.738462	569	649	2	10	80	0.1250000
NODE_9456_length_879_cov_17.738462	569	649	0	70	80	0.8750000
NODE_9456_length_879_cov_17.738462	569	649	2	10	80	0.1250000
NODE_9456_length_879_cov_17.738462	622	676	0	54	54	1.0000000
NODE_9458_length_879_cov_10.756410	335	415	0	80	80	1.0000000
NODE_9458_length_879_cov_10.756410	388	468	0	80	80	1.0000000
NODE_9459_length_879_cov_7.432051	234	314	0	80	80	1.0000000
NODE_9459_length_879_cov_7.432051	288	367	0	79	79	1.0000000
NODE_9473_length_878_cov_230.436457	415	495	0	80	80	1.0000000
NODE_9473_length_878_cov_230.436457	468	548	0	80	80	1.0000000
NODE_9474_length_878_cov_49.514763	410	490	2	20	80	0.2500000
NODE_9474_length_878_cov_49.514763	410	490	4	1	80	0.0125000
NODE_9474_length_878_cov_49.514763	410	490	10	10	80	0.1250000
NODE_9474_length_878_cov_49.514763	410	490	12	49	80	0.6125000
NODE_9474_length_878_cov_49.514763	463	543	2	3	80	0.0375000
NODE_9474_length_878_cov_49.514763	463	543	4	51	80	0.6375000
NODE_9474_length_878_cov_49.514763	463	543	12	26	80	0.3250000
NODE_9475_length_878_cov_38.862644	365	445	0	8	80	0.1000000
NODE_9475_length_878_cov_38.862644	365	445	3	72	80	0.9000000
NODE_9475_length_878_cov_38.862644	418	498	0	39	80	0.4875000
NODE_9475_length_878_cov_38.862644	418	498	2	1	80	0.0125000
NODE_9475_length_878_cov_38.862644	418	498	3	40	80	0.5000000
NODE_9476_length_878_cov_36.517330	346	426	0	80	80	1.0000000
NODE_9476_length_878_cov_36.517330	399	479	0	80	80	1.0000000
NODE_9476_length_878_cov_36.517330	475	555	0	68	80	0.8500000
NODE_9476_length_878_cov_36.517330	475	555	2	12	80	0.1500000
NODE_9476_length_878_cov_36.517330	528	608	0	15	80	0.1875000
NODE_9476_length_878_cov_36.517330	528	608	2	65	80	0.8125000
NODE_9477_length_878_cov_34.404365	627	707	0	29	80	0.3625000
NODE_9477_length_878_cov_34.404365	627	707	2	51	80	0.6375000
NODE_9477_length_878_cov_34.404365	627	695	0	29	68	0.4264706
NODE_9477_length_878_cov_34.404365	627	695	2	39	68	0.5735294
NODE_9477_length_878_cov_34.404365	680	760	2	30	80	0.3750000
NODE_9477_length_878_cov_34.404365	680	760	4	4	80	0.0500000
NODE_9477_length_878_cov_34.404365	680	760	8	6	80	0.0750000
NODE_9477_length_878_cov_34.404365	680	760	10	2	80	0.0250000
NODE_9477_length_878_cov_34.404365	680	760	16	10	80	0.1250000
NODE_9477_length_878_cov_34.404365	680	760	20	7	80	0.0875000
NODE_9477_length_878_cov_34.404365	680	760	24	3	80	0.0375000
NODE_9477_length_878_cov_34.404365	680	760	26	14	80	0.1750000
NODE_9477_length_878_cov_34.404365	680	760	28	4	80	0.0500000
NODE_9478_length_878_cov_28.761232	467	547	0	80	80	1.0000000
NODE_9478_length_878_cov_28.761232	520	600	0	80	80	1.0000000
NODE_9479_length_878_cov_24.899872	316	396	0	80	80	1.0000000
NODE_9479_length_878_cov_24.899872	369	449	0	80	80	1.0000000
NODE_9479_length_878_cov_24.899872	445	525	0	80	80	1.0000000
NODE_9479_length_878_cov_24.899872	498	578	0	80	80	1.0000000
NODE_9480_length_878_cov_21.446727	377	457	0	80	80	1.0000000
NODE_9480_length_878_cov_21.446727	430	510	0	80	80	1.0000000
NODE_9481_length_878_cov_20.553273	424	504	0	6	80	0.0750000
NODE_9481_length_878_cov_20.553273	424	504	4	20	80	0.2500000
NODE_9481_length_878_cov_20.553273	424	504	7	1	80	0.0125000
NODE_9481_length_878_cov_20.553273	424	504	8	7	80	0.0875000
NODE_9481_length_878_cov_20.553273	424	504	10	46	80	0.5750000
NODE_9481_length_878_cov_20.553273	477	557	0	20	80	0.2500000
NODE_9481_length_878_cov_20.553273	477	557	2	11	80	0.1375000
NODE_9481_length_878_cov_20.553273	477	557	6	1	80	0.0125000
NODE_9481_length_878_cov_20.553273	477	557	10	48	80	0.6000000
NODE_9482_length_878_cov_14.016688	214	294	0	80	80	1.0000000
NODE_9482_length_878_cov_14.016688	267	347	0	80	80	1.0000000
NODE_9483_length_878_cov_9.252888	423	503	2	80	80	1.0000000
NODE_9483_length_878_cov_9.252888	476	556	2	80	80	1.0000000
NODE_9484_length_878_cov_8.695764	333	413	0	80	80	1.0000000
NODE_9484_length_878_cov_8.695764	386	466	0	80	80	1.0000000
NODE_9485_length_878_cov_6.686778	65	145	0	80	80	1.0000000
NODE_9485_length_878_cov_6.686778	118	198	0	80	80	1.0000000
NODE_9487_length_878_cov_6.328626	426	506	0	65	80	0.8125000
NODE_9487_length_878_cov_6.328626	426	506	4	15	80	0.1875000
NODE_9487_length_878_cov_6.328626	479	559	0	12	80	0.1500000
NODE_9487_length_878_cov_6.328626	479	559	4	22	80	0.2750000
NODE_9487_length_878_cov_6.328626	479	559	6	46	80	0.5750000
NODE_9488_length_878_cov_5.771502	470	513	0	43	43	1.0000000
NODE_9490_length_878_cov_2.672657	499	579	2	80	80	1.0000000
NODE_9490_length_878_cov_2.672657	552	631	0	31	79	0.3924051
NODE_9490_length_878_cov_2.672657	552	631	2	48	79	0.6075949
NODE_9507_length_877_cov_59.021851	324	404	0	80	80	1.0000000
NODE_9507_length_877_cov_59.021851	377	457	0	80	80	1.0000000
NODE_9508_length_877_cov_54.422879	418	498	0	80	80	1.0000000
NODE_9508_length_877_cov_54.422879	471	551	0	80	80	1.0000000
NODE_9509_length_877_cov_47.672237	451	527	0	76	76	1.0000000
NODE_9509_length_877_cov_47.672237	500	580	0	80	80	1.0000000
NODE_9510_length_877_cov_29.884319	349	429	0	54	80	0.6750000
NODE_9510_length_877_cov_29.884319	349	429	4	26	80	0.3250000
NODE_9510_length_877_cov_29.884319	402	482	0	1	80	0.0125000
NODE_9510_length_877_cov_29.884319	402	482	4	36	80	0.4500000
NODE_9510_length_877_cov_29.884319	402	482	8	43	80	0.5375000
NODE_9511_length_877_cov_17.681234	423	503	0	27	80	0.3375000
NODE_9511_length_877_cov_17.681234	423	503	2	53	80	0.6625000
NODE_9511_length_877_cov_17.681234	476	556	0	30	80	0.3750000
NODE_9511_length_877_cov_17.681234	476	556	2	50	80	0.6250000
NODE_9512_length_877_cov_17.520566	228	308	0	80	80	1.0000000
NODE_9512_length_877_cov_17.520566	281	361	0	80	80	1.0000000
NODE_9513_length_877_cov_17.374036	362	442	1	26	80	0.3250000
NODE_9513_length_877_cov_17.374036	362	442	2	54	80	0.6750000
NODE_9513_length_877_cov_17.374036	415	495	1	66	80	0.8250000
NODE_9513_length_877_cov_17.374036	415	495	2	14	80	0.1750000
NODE_9515_length_877_cov_9.320051	395	475	0	80	80	1.0000000
NODE_9515_length_877_cov_9.320051	448	528	0	80	80	1.0000000
NODE_9517_length_877_cov_6.755784	222	302	0	80	80	1.0000000
NODE_9517_length_877_cov_6.755784	275	354	0	79	79	1.0000000
NODE_9537_length_876_cov_46.021879	389	469	0	80	80	1.0000000
NODE_9537_length_876_cov_46.021879	442	522	0	80	80	1.0000000
NODE_9538_length_876_cov_34.441441	379	459	0	80	80	1.0000000
NODE_9538_length_876_cov_34.441441	432	512	0	80	80	1.0000000
NODE_9539_length_876_cov_30.742600	344	424	0	80	80	1.0000000
NODE_9539_length_876_cov_30.742600	397	477	0	29	80	0.3625000
NODE_9539_length_876_cov_30.742600	397	477	4	51	80	0.6375000
NODE_9540_length_876_cov_28.476190	345	425	0	80	80	1.0000000
NODE_9540_length_876_cov_28.476190	398	478	0	80	80	1.0000000
NODE_9541_length_876_cov_22.722008	324	404	1	11	80	0.1375000
NODE_9541_length_876_cov_22.722008	324	404	2	69	80	0.8625000
NODE_9541_length_876_cov_22.722008	377	457	2	36	80	0.4500000
NODE_9541_length_876_cov_22.722008	377	457	6	44	80	0.5500000
NODE_9542_length_876_cov_17.458172	367	447	1	41	80	0.5125000
NODE_9542_length_876_cov_17.458172	367	447	2	39	80	0.4875000
NODE_9542_length_876_cov_17.458172	420	500	1	70	80	0.8750000
NODE_9542_length_876_cov_17.458172	420	500	2	10	80	0.1250000
NODE_9561_length_875_cov_52.965206	190	270	0	80	80	1.0000000
NODE_9561_length_875_cov_52.965206	243	323	0	80	80	1.0000000
NODE_9561_length_875_cov_52.965206	319	399	0	80	80	1.0000000
NODE_9561_length_875_cov_52.965206	372	447	0	75	75	1.0000000
NODE_9562_length_875_cov_35.634021	260	340	0	80	80	1.0000000
NODE_9562_length_875_cov_35.634021	313	393	0	80	80	1.0000000
NODE_9562_length_875_cov_35.634021	389	469	0	80	80	1.0000000
NODE_9562_length_875_cov_35.634021	442	522	0	80	80	1.0000000
NODE_9563_length_875_cov_33.771907	363	441	0	78	78	1.0000000
NODE_9563_length_875_cov_33.771907	414	494	0	80	80	1.0000000
NODE_9564_length_875_cov_29.698454	322	402	0	80	80	1.0000000
NODE_9564_length_875_cov_29.698454	375	455	0	80	80	1.0000000
NODE_9565_length_875_cov_23.041237	364	444	0	7	80	0.0875000
NODE_9565_length_875_cov_23.041237	364	444	2	73	80	0.9125000
NODE_9565_length_875_cov_23.041237	417	497	0	30	80	0.3750000
NODE_9565_length_875_cov_23.041237	417	497	2	50	80	0.6250000
NODE_9565_length_875_cov_23.041237	493	573	0	80	80	1.0000000
NODE_9565_length_875_cov_23.041237	546	626	0	80	80	1.0000000
NODE_9566_length_875_cov_9.800258	242	322	0	80	80	1.0000000
NODE_9566_length_875_cov_9.800258	295	376	0	81	81	1.0000000
NODE_9567_length_875_cov_8.195876	407	487	0	80	80	1.0000000
NODE_9567_length_875_cov_8.195876	460	540	0	80	80	1.0000000
NODE_9585_length_874_cov_48.925161	185	265	0	80	80	1.0000000
NODE_9585_length_874_cov_48.925161	238	318	0	80	80	1.0000000
NODE_9587_length_874_cov_37.354839	199	279	0	80	80	1.0000000
NODE_9587_length_874_cov_37.354839	252	332	0	80	80	1.0000000
NODE_9588_length_874_cov_35.040000	231	311	0	80	80	1.0000000
NODE_9588_length_874_cov_35.040000	284	364	0	80	80	1.0000000
NODE_9589_length_874_cov_23.415484	327	407	0	80	80	1.0000000
NODE_9589_length_874_cov_23.415484	380	460	0	80	80	1.0000000
NODE_9589_length_874_cov_23.415484	456	536	0	80	80	1.0000000
NODE_9589_length_874_cov_23.415484	509	589	0	80	80	1.0000000
NODE_9590_length_874_cov_21.885161	279	359	0	80	80	1.0000000
NODE_9590_length_874_cov_21.885161	332	412	0	80	80	1.0000000
NODE_9591_length_874_cov_11.172903	67	147	0	80	80	1.0000000
NODE_9591_length_874_cov_11.172903	120	200	0	80	80	1.0000000
NODE_9592_length_874_cov_9.645161	424	504	0	80	80	1.0000000
NODE_9592_length_874_cov_9.645161	477	557	0	80	80	1.0000000
NODE_9593_length_874_cov_8.637419	359	439	0	80	80	1.0000000
NODE_9593_length_874_cov_8.637419	412	499	0	47	87	0.5402299
NODE_9593_length_874_cov_8.637419	412	499	2	40	87	0.4597701
NODE_9596_length_874_cov_4.785806	829	874	0	45	45	1.0000000
NODE_9618_length_873_cov_100.625323	50	130	22	3	80	0.0375000
NODE_9618_length_873_cov_100.625323	50	130	26	77	80	0.9625000
NODE_9619_length_873_cov_45.633075	226	306	0	80	80	1.0000000
NODE_9619_length_873_cov_45.633075	279	359	0	80	80	1.0000000
NODE_9619_length_873_cov_45.633075	693	773	0	80	80	1.0000000
NODE_9619_length_873_cov_45.633075	746	826	0	80	80	1.0000000
NODE_9620_length_873_cov_39.224806	190	270	0	59	80	0.7375000
NODE_9620_length_873_cov_39.224806	190	270	5	1	80	0.0125000
NODE_9620_length_873_cov_39.224806	190	270	6	20	80	0.2500000
NODE_9620_length_873_cov_39.224806	243	307	0	64	64	1.0000000
NODE_9620_length_873_cov_39.224806	390	470	0	80	80	1.0000000
NODE_9620_length_873_cov_39.224806	443	523	0	80	80	1.0000000
NODE_9620_length_873_cov_39.224806	504	523	0	19	19	1.0000000
NODE_9620_length_873_cov_39.224806	519	599	0	80	80	1.0000000
NODE_9620_length_873_cov_39.224806	572	652	0	80	80	1.0000000
NODE_9621_length_873_cov_27.992248	372	452	0	80	80	1.0000000
NODE_9621_length_873_cov_27.992248	425	505	0	80	80	1.0000000
NODE_9622_length_873_cov_23.270026	390	470	0	80	80	1.0000000
NODE_9622_length_873_cov_23.270026	443	528	0	85	85	1.0000000
NODE_9623_length_873_cov_23.197674	293	373	0	34	80	0.4250000
NODE_9623_length_873_cov_23.197674	293	373	2	46	80	0.5750000
NODE_9623_length_873_cov_23.197674	346	426	0	3	80	0.0375000
NODE_9623_length_873_cov_23.197674	346	426	2	77	80	0.9625000
NODE_9624_length_873_cov_20.432817	347	427	0	80	80	1.0000000
NODE_9624_length_873_cov_20.432817	400	480	0	80	80	1.0000000
NODE_9624_length_873_cov_20.432817	476	556	0	80	80	1.0000000
NODE_9624_length_873_cov_20.432817	529	609	0	80	80	1.0000000
NODE_9625_length_873_cov_19.913437	445	525	2	47	80	0.5875000
NODE_9625_length_873_cov_19.913437	445	525	4	33	80	0.4125000
NODE_9625_length_873_cov_19.913437	498	578	0	1	80	0.0125000
NODE_9625_length_873_cov_19.913437	498	578	2	79	80	0.9875000
NODE_9626_length_873_cov_16.718346	276	356	0	63	80	0.7875000
NODE_9626_length_873_cov_16.718346	276	356	4	17	80	0.2125000
NODE_9626_length_873_cov_16.718346	329	409	0	10	80	0.1250000
NODE_9626_length_873_cov_16.718346	329	409	4	70	80	0.8750000
NODE_9627_length_873_cov_16.422481	423	503	0	80	80	1.0000000
NODE_9627_length_873_cov_16.422481	476	556	0	80	80	1.0000000
NODE_9628_length_873_cov_11.198966	410	490	0	62	80	0.7750000
NODE_9628_length_873_cov_11.198966	410	490	1	18	80	0.2250000
NODE_9628_length_873_cov_11.198966	463	543	0	80	80	1.0000000
NODE_9629_length_873_cov_9.799742	334	414	0	80	80	1.0000000
NODE_9629_length_873_cov_9.799742	387	467	0	80	80	1.0000000
NODE_9632_length_873_cov_3.828165	490	570	0	80	80	1.0000000
NODE_9632_length_873_cov_3.828165	543	583	0	40	40	1.0000000
NODE_9632_length_873_cov_3.828165	690	735	0	45	45	1.0000000
NODE_9633_length_873_cov_3.443152	716	746	0	30	30	1.0000000
NODE_9647_length_873_cov_1.239018	593	658	0	12	65	0.1846154
NODE_9647_length_873_cov_1.239018	593	658	2	4	65	0.0615385
NODE_9647_length_873_cov_1.239018	593	658	4	2	65	0.0307692
NODE_9647_length_873_cov_1.239018	593	658	6	1	65	0.0153846
NODE_9647_length_873_cov_1.239018	593	658	7	2	65	0.0307692
NODE_9647_length_873_cov_1.239018	593	658	9	40	65	0.6153846
NODE_9647_length_873_cov_1.239018	593	658	13	4	65	0.0615385
NODE_9651_length_872_cov_47.732212	432	512	0	11	80	0.1375000
NODE_9651_length_872_cov_47.732212	432	512	5	1	80	0.0125000
NODE_9651_length_872_cov_47.732212	432	512	6	68	80	0.8500000
NODE_9651_length_872_cov_47.732212	484	564	0	63	80	0.7875000
NODE_9651_length_872_cov_47.732212	484	564	5	1	80	0.0125000
NODE_9651_length_872_cov_47.732212	484	564	6	16	80	0.2000000
NODE_9651_length_872_cov_47.732212	560	640	0	80	80	1.0000000
NODE_9651_length_872_cov_47.732212	613	693	0	80	80	1.0000000
NODE_9652_length_872_cov_16.204398	349	429	0	41	80	0.5125000
NODE_9652_length_872_cov_16.204398	349	429	1	39	80	0.4875000
NODE_9652_length_872_cov_16.204398	402	482	1	80	80	1.0000000
NODE_9652_length_872_cov_16.204398	478	558	0	18	80	0.2250000
NODE_9652_length_872_cov_16.204398	478	558	1	62	80	0.7750000
NODE_9652_length_872_cov_16.204398	531	611	0	71	80	0.8875000
NODE_9652_length_872_cov_16.204398	531	611	1	9	80	0.1125000
NODE_9653_length_872_cov_12.835705	376	456	2	14	80	0.1750000
NODE_9653_length_872_cov_12.835705	376	456	4	66	80	0.8250000
NODE_9653_length_872_cov_12.835705	429	509	2	13	80	0.1625000
NODE_9653_length_872_cov_12.835705	429	509	4	67	80	0.8375000
NODE_9654_length_872_cov_9.657180	356	431	0	75	75	1.0000000
NODE_9660_length_872_cov_3.531695	425	505	0	80	80	1.0000000
NODE_9660_length_872_cov_3.531695	478	559	0	81	81	1.0000000
NODE_9673_length_871_cov_56.841969	265	345	0	80	80	1.0000000
NODE_9673_length_871_cov_56.841969	318	398	0	80	80	1.0000000
NODE_9673_length_871_cov_56.841969	394	474	0	80	80	1.0000000
NODE_9673_length_871_cov_56.841969	447	527	0	80	80	1.0000000
NODE_9674_length_871_cov_47.528497	461	541	0	28	80	0.3500000
NODE_9674_length_871_cov_47.528497	461	541	2	52	80	0.6500000
NODE_9674_length_871_cov_47.528497	514	594	0	34	80	0.4250000
NODE_9674_length_871_cov_47.528497	514	594	2	46	80	0.5750000
NODE_9675_length_871_cov_31.145078	326	406	0	80	80	1.0000000
NODE_9675_length_871_cov_31.145078	379	459	0	80	80	1.0000000
NODE_9676_length_871_cov_27.993523	379	459	0	80	80	1.0000000
NODE_9676_length_871_cov_27.993523	432	512	0	80	80	1.0000000
NODE_9677_length_871_cov_25.954663	463	543	0	80	80	1.0000000
NODE_9677_length_871_cov_25.954663	516	596	0	80	80	1.0000000
NODE_9678_length_871_cov_24.069948	492	558	0	16	66	0.2424242
NODE_9678_length_871_cov_24.069948	492	558	2	50	66	0.7575758
NODE_9678_length_871_cov_24.069948	558	634	0	76	76	1.0000000
NODE_9679_length_871_cov_23.953368	445	522	13	6	77	0.0779221
NODE_9679_length_871_cov_23.953368	445	522	28	12	77	0.1558442
NODE_9679_length_871_cov_23.953368	445	522	30	12	77	0.1558442
NODE_9679_length_871_cov_23.953368	445	522	31	7	77	0.0909091
NODE_9679_length_871_cov_23.953368	445	522	32	23	77	0.2987013
NODE_9679_length_871_cov_23.953368	445	522	34	6	77	0.0779221
NODE_9679_length_871_cov_23.953368	445	522	35	3	77	0.0389610
NODE_9679_length_871_cov_23.953368	445	522	36	3	77	0.0389610
NODE_9679_length_871_cov_23.953368	445	522	42	5	77	0.0649351
NODE_9680_length_871_cov_19.304404	335	415	0	80	80	1.0000000
NODE_9680_length_871_cov_19.304404	388	468	0	80	80	1.0000000
NODE_9682_length_871_cov_18.108808	370	450	0	80	80	1.0000000
NODE_9682_length_871_cov_18.108808	423	503	0	80	80	1.0000000
NODE_9683_length_871_cov_17.034974	362	442	0	80	80	1.0000000
NODE_9683_length_871_cov_17.034974	415	495	0	80	80	1.0000000
NODE_9684_length_871_cov_16.768135	374	454	0	80	80	1.0000000
NODE_9685_length_871_cov_14.196891	267	347	0	9	80	0.1125000
NODE_9685_length_871_cov_14.196891	267	347	10	71	80	0.8875000
NODE_9685_length_871_cov_14.196891	320	400	10	80	80	1.0000000
NODE_9686_length_871_cov_13.443005	246	326	0	80	80	1.0000000
NODE_9686_length_871_cov_13.443005	299	322	0	23	23	1.0000000
NODE_9687_length_871_cov_11.839378	29	109	0	80	80	1.0000000
NODE_9687_length_871_cov_11.839378	82	149	0	67	67	1.0000000
NODE_9687_length_871_cov_11.839378	331	411	0	80	80	1.0000000
NODE_9687_length_871_cov_11.839378	384	464	0	80	80	1.0000000
NODE_9689_length_871_cov_5.730570	316	373	4	57	57	1.0000000
NODE_9694_length_871_cov_3.544041	428	508	1	29	80	0.3625000
NODE_9694_length_871_cov_3.544041	428	508	2	51	80	0.6375000
NODE_9694_length_871_cov_3.544041	481	561	1	80	80	1.0000000
NODE_9716_length_870_cov_43.400778	542	622	0	39	80	0.4875000
NODE_9716_length_870_cov_43.400778	542	622	4	41	80	0.5125000
NODE_9716_length_870_cov_43.400778	595	675	0	80	80	1.0000000
NODE_9719_length_870_cov_28.249027	442	524	0	82	82	1.0000000
NODE_9719_length_870_cov_28.249027	497	577	0	80	80	1.0000000
NODE_9720_length_870_cov_26.992218	240	320	0	80	80	1.0000000
NODE_9720_length_870_cov_26.992218	293	373	0	80	80	1.0000000
NODE_9720_length_870_cov_26.992218	369	449	0	80	80	1.0000000
NODE_9720_length_870_cov_26.992218	422	502	0	80	80	1.0000000
NODE_9721_length_870_cov_25.806744	186	237	6	7	51	0.1372549
NODE_9721_length_870_cov_25.806744	186	237	7	12	51	0.2352941
NODE_9721_length_870_cov_25.806744	186	237	8	31	51	0.6078432
NODE_9721_length_870_cov_25.806744	186	237	9	1	51	0.0196078
NODE_9721_length_870_cov_25.806744	391	471	0	80	80	1.0000000
NODE_9721_length_870_cov_25.806744	444	524	0	80	80	1.0000000
NODE_9722_length_870_cov_18.862516	345	425	0	80	80	1.0000000
NODE_9722_length_870_cov_18.862516	398	478	0	80	80	1.0000000
NODE_9723_length_870_cov_15.686122	330	410	0	80	80	1.0000000
NODE_9723_length_870_cov_15.686122	383	463	0	80	80	1.0000000
NODE_9725_length_870_cov_13.334630	479	559	0	80	80	1.0000000
NODE_9725_length_870_cov_13.334630	532	612	0	80	80	1.0000000
NODE_9726_length_870_cov_9.712062	410	490	0	80	80	1.0000000
NODE_9726_length_870_cov_9.712062	463	542	0	79	79	1.0000000
NODE_9728_length_870_cov_7.556420	448	528	0	80	80	1.0000000
NODE_9728_length_870_cov_7.556420	501	581	0	80	80	1.0000000
NODE_9746_length_869_cov_42.784416	395	475	2	80	80	1.0000000
NODE_9746_length_869_cov_42.784416	448	528	0	19	80	0.2375000
NODE_9746_length_869_cov_42.784416	448	528	2	61	80	0.7625000
NODE_9747_length_869_cov_29.525974	211	291	0	53	80	0.6625000
NODE_9747_length_869_cov_29.525974	211	291	14	27	80	0.3375000
NODE_9747_length_869_cov_29.525974	264	344	14	80	80	1.0000000
NODE_9748_length_869_cov_16.258442	389	469	0	63	80	0.7875000
NODE_9748_length_869_cov_16.258442	389	469	4	4	80	0.0500000
NODE_9748_length_869_cov_16.258442	389	469	6	13	80	0.1625000
NODE_9748_length_869_cov_16.258442	442	522	0	10	80	0.1250000
NODE_9748_length_869_cov_16.258442	442	522	4	4	80	0.0500000
NODE_9748_length_869_cov_16.258442	442	522	6	66	80	0.8250000
NODE_9749_length_869_cov_15.940260	321	401	0	80	80	1.0000000
NODE_9749_length_869_cov_15.940260	374	454	0	80	80	1.0000000
NODE_9750_length_869_cov_9.619481	402	442	180	2	40	0.0500000
NODE_9750_length_869_cov_9.619481	402	442	181	2	40	0.0500000
NODE_9750_length_869_cov_9.619481	402	442	182	2	40	0.0500000
NODE_9750_length_869_cov_9.619481	402	442	185	2	40	0.0500000
NODE_9750_length_869_cov_9.619481	402	442	186	4	40	0.1000000
NODE_9750_length_869_cov_9.619481	402	442	187	2	40	0.0500000
NODE_9750_length_869_cov_9.619481	402	442	188	2	40	0.0500000
NODE_9750_length_869_cov_9.619481	402	442	190	4	40	0.1000000
NODE_9750_length_869_cov_9.619481	402	442	191	1	40	0.0250000
NODE_9750_length_869_cov_9.619481	402	442	192	3	40	0.0750000
NODE_9750_length_869_cov_9.619481	402	442	194	4	40	0.1000000
NODE_9750_length_869_cov_9.619481	402	442	195	1	40	0.0250000
NODE_9750_length_869_cov_9.619481	402	442	196	6	40	0.1500000
NODE_9750_length_869_cov_9.619481	402	442	199	1	40	0.0250000
NODE_9750_length_869_cov_9.619481	402	442	203	1	40	0.0250000
NODE_9750_length_869_cov_9.619481	402	442	209	1	40	0.0250000
NODE_9750_length_869_cov_9.619481	402	442	216	1	40	0.0250000
NODE_9750_length_869_cov_9.619481	402	442	217	1	40	0.0250000
NODE_9751_length_869_cov_7.123377	392	472	0	80	80	1.0000000
NODE_9751_length_869_cov_7.123377	445	525	0	80	80	1.0000000
NODE_9753_length_869_cov_3.658442	310	378	0	68	68	1.0000000
NODE_9777_length_868_cov_57.465540	355	435	2	37	80	0.4625000
NODE_9777_length_868_cov_57.465540	355	435	4	43	80	0.5375000
NODE_9778_length_868_cov_46.509753	0	65	0	65	65	1.0000000
NODE_9778_length_868_cov_46.509753	0	65	0	65	65	1.0000000
NODE_9778_length_868_cov_46.509753	0	65	0	65	65	1.0000000
NODE_9778_length_868_cov_46.509753	0	65	0	65	65	1.0000000
NODE_9778_length_868_cov_46.509753	61	141	0	80	80	1.0000000
NODE_9778_length_868_cov_46.509753	61	141	0	80	80	1.0000000
NODE_9778_length_868_cov_46.509753	114	194	0	80	80	1.0000000
NODE_9778_length_868_cov_46.509753	114	194	0	80	80	1.0000000
NODE_9779_length_868_cov_26.092328	318	398	0	80	80	1.0000000
NODE_9779_length_868_cov_26.092328	371	451	0	66	80	0.8250000
NODE_9779_length_868_cov_26.092328	371	451	4	14	80	0.1750000
NODE_9781_length_868_cov_22.555267	377	457	0	6	80	0.0750000
NODE_9781_length_868_cov_22.555267	377	457	14	1	80	0.0125000
NODE_9781_length_868_cov_22.555267	377	457	16	54	80	0.6750000
NODE_9781_length_868_cov_22.555267	377	457	17	4	80	0.0500000
NODE_9781_length_868_cov_22.555267	377	457	18	15	80	0.1875000
NODE_9781_length_868_cov_22.555267	430	510	16	8	80	0.1000000
NODE_9781_length_868_cov_22.555267	430	510	17	57	80	0.7125000
NODE_9781_length_868_cov_22.555267	430	510	18	15	80	0.1875000
NODE_9782_length_868_cov_20.466840	259	339	0	80	80	1.0000000
NODE_9782_length_868_cov_20.466840	312	392	0	80	80	1.0000000
NODE_9782_length_868_cov_20.466840	388	468	0	80	80	1.0000000
NODE_9782_length_868_cov_20.466840	441	521	0	80	80	1.0000000
NODE_9783_length_868_cov_20.414824	311	391	0	9	80	0.1125000
NODE_9783_length_868_cov_20.414824	311	391	2	71	80	0.8875000
NODE_9783_length_868_cov_20.414824	364	444	0	62	80	0.7750000
NODE_9783_length_868_cov_20.414824	364	444	2	18	80	0.2250000
NODE_9784_length_868_cov_17.613784	340	420	0	80	80	1.0000000
NODE_9784_length_868_cov_17.613784	393	473	0	80	80	1.0000000
NODE_9785_length_868_cov_15.768531	353	433	0	80	80	1.0000000
NODE_9785_length_868_cov_15.768531	406	486	0	80	80	1.0000000
NODE_9786_length_868_cov_13.997399	611	691	1	69	80	0.8625000
NODE_9786_length_868_cov_13.997399	611	691	2	11	80	0.1375000
NODE_9786_length_868_cov_13.997399	664	744	1	80	80	1.0000000
NODE_9787_length_868_cov_13.224967	451	531	0	20	80	0.2500000
NODE_9787_length_868_cov_13.224967	451	531	4	60	80	0.7500000
NODE_9787_length_868_cov_13.224967	504	583	0	16	79	0.2025317
NODE_9787_length_868_cov_13.224967	504	583	4	63	79	0.7974684
NODE_9788_length_868_cov_11.851756	363	422	0	59	59	1.0000000
NODE_9788_length_868_cov_11.851756	395	475	0	80	80	1.0000000
NODE_9789_length_868_cov_11.352406	361	441	0	7	80	0.0875000
NODE_9789_length_868_cov_11.352406	361	441	2	73	80	0.9125000
NODE_9789_length_868_cov_11.352406	414	494	0	32	80	0.4000000
NODE_9789_length_868_cov_11.352406	414	494	2	48	80	0.6000000
NODE_9790_length_868_cov_11.335501	289	369	0	46	80	0.5750000
NODE_9790_length_868_cov_11.335501	289	369	2	34	80	0.4250000
NODE_9790_length_868_cov_11.335501	342	422	0	80	80	1.0000000
NODE_9791_length_868_cov_8.455137	401	481	0	80	80	1.0000000
NODE_9791_length_868_cov_8.455137	454	534	0	80	80	1.0000000
NODE_9816_length_867_cov_27.756510	333	376	2	43	43	1.0000000
NODE_9816_length_867_cov_27.756510	349	429	0	9	80	0.1125000
NODE_9816_length_867_cov_27.756510	349	429	2	71	80	0.8875000
NODE_9816_length_867_cov_27.756510	425	505	0	80	80	1.0000000
NODE_9816_length_867_cov_27.756510	478	542	0	64	64	1.0000000
NODE_9817_length_867_cov_25.354167	280	345	0	65	65	1.0000000
NODE_9817_length_867_cov_25.354167	325	397	0	72	72	1.0000000
NODE_9818_length_867_cov_23.968750	369	449	0	80	80	1.0000000
NODE_9818_length_867_cov_23.968750	422	502	0	80	80	1.0000000
NODE_9819_length_867_cov_21.220052	524	604	0	80	80	1.0000000
NODE_9819_length_867_cov_21.220052	577	657	0	80	80	1.0000000
NODE_9820_length_867_cov_15.042969	287	364	0	77	77	1.0000000
NODE_9821_length_867_cov_11.057292	305	373	0	68	68	1.0000000
NODE_9821_length_867_cov_11.057292	346	426	0	80	80	1.0000000
NODE_9821_length_867_cov_11.057292	475	555	0	80	80	1.0000000
NODE_9822_length_867_cov_8.127604	347	427	0	6	80	0.0750000
NODE_9822_length_867_cov_8.127604	347	427	4	74	80	0.9250000
NODE_9822_length_867_cov_8.127604	400	480	0	21	80	0.2625000
NODE_9822_length_867_cov_8.127604	400	480	4	59	80	0.7375000
NODE_9823_length_867_cov_7.621094	292	372	0	80	80	1.0000000
NODE_9823_length_867_cov_7.621094	345	425	0	80	80	1.0000000
NODE_9826_length_867_cov_5.494792	445	525	0	80	80	1.0000000
NODE_9826_length_867_cov_5.494792	498	578	0	80	80	1.0000000
NODE_9857_length_866_cov_49.224250	269	349	0	80	80	1.0000000
NODE_9857_length_866_cov_49.224250	322	402	0	37	80	0.4625000
NODE_9857_length_866_cov_49.224250	322	402	2	31	80	0.3875000
NODE_9857_length_866_cov_49.224250	322	402	3	12	80	0.1500000
NODE_9858_length_866_cov_47.160365	428	508	0	80	80	1.0000000
NODE_9858_length_866_cov_47.160365	481	561	0	80	80	1.0000000
NODE_9858_length_866_cov_47.160365	557	637	0	80	80	1.0000000
NODE_9858_length_866_cov_47.160365	610	690	0	68	80	0.8500000
NODE_9858_length_866_cov_47.160365	610	690	4	12	80	0.1500000
NODE_9859_length_866_cov_23.398957	281	361	0	80	80	1.0000000
NODE_9859_length_866_cov_23.398957	334	414	0	80	80	1.0000000
NODE_9860_length_866_cov_22.186441	455	535	0	80	80	1.0000000
NODE_9860_length_866_cov_22.186441	508	588	0	80	80	1.0000000
NODE_9861_length_866_cov_18.362451	451	531	10	80	80	1.0000000
NODE_9861_length_866_cov_18.362451	504	584	0	24	80	0.3000000
NODE_9861_length_866_cov_18.362451	504	584	10	56	80	0.7000000
NODE_9862_length_866_cov_16.830508	372	452	0	80	80	1.0000000
NODE_9862_length_866_cov_16.830508	425	505	0	80	80	1.0000000
NODE_9882_length_865_cov_63.137076	288	368	0	80	80	1.0000000
NODE_9882_length_865_cov_63.137076	341	421	0	80	80	1.0000000
NODE_9883_length_865_cov_19.882507	335	415	0	80	80	1.0000000
NODE_9883_length_865_cov_19.882507	388	468	0	80	80	1.0000000
NODE_9884_length_865_cov_17.784595	306	386	0	80	80	1.0000000
NODE_9884_length_865_cov_17.784595	359	439	0	80	80	1.0000000
NODE_9885_length_865_cov_16.150131	451	531	0	25	80	0.3125000
NODE_9885_length_865_cov_16.150131	451	531	1	41	80	0.5125000
NODE_9885_length_865_cov_16.150131	451	531	2	14	80	0.1750000
NODE_9885_length_865_cov_16.150131	504	584	1	13	80	0.1625000
NODE_9885_length_865_cov_16.150131	504	584	2	67	80	0.8375000
NODE_9886_length_865_cov_14.751958	473	553	0	80	80	1.0000000
NODE_9886_length_865_cov_14.751958	473	553	0	80	80	1.0000000
NODE_9886_length_865_cov_14.751958	526	589	0	63	63	1.0000000
NODE_9886_length_865_cov_14.751958	526	606	0	80	80	1.0000000
NODE_9887_length_865_cov_10.937337	422	502	0	80	80	1.0000000
NODE_9887_length_865_cov_10.937337	475	555	0	80	80	1.0000000
NODE_9889_length_865_cov_9.167102	389	469	0	80	80	1.0000000
NODE_9889_length_865_cov_9.167102	442	522	0	77	80	0.9625000
NODE_9889_length_865_cov_9.167102	442	522	2	3	80	0.0375000
NODE_9912_length_864_cov_13.398693	491	571	0	80	80	1.0000000
NODE_9912_length_864_cov_13.398693	544	624	0	80	80	1.0000000
NODE_9913_length_864_cov_8.466667	308	388	0	80	80	1.0000000
NODE_9913_length_864_cov_8.466667	361	441	0	80	80	1.0000000
NODE_9917_length_864_cov_3.947712	651	676	2	25	25	1.0000000
NODE_9917_length_864_cov_3.947712	725	805	2	40	80	0.5000000
NODE_9917_length_864_cov_3.947712	725	805	6	40	80	0.5000000
NODE_9917_length_864_cov_3.947712	778	844	0	1	66	0.0151515
NODE_9917_length_864_cov_3.947712	778	844	4	38	66	0.5757576
NODE_9917_length_864_cov_3.947712	778	844	6	27	66	0.4090909
NODE_9931_length_863_cov_72.856021	241	321	0	80	80	1.0000000
NODE_9931_length_863_cov_72.856021	294	374	0	80	80	1.0000000
NODE_9931_length_863_cov_72.856021	370	450	0	80	80	1.0000000
NODE_9931_length_863_cov_72.856021	423	503	0	31	80	0.3875000
NODE_9931_length_863_cov_72.856021	423	503	3	1	80	0.0125000
NODE_9931_length_863_cov_72.856021	423	503	4	2	80	0.0250000
NODE_9931_length_863_cov_72.856021	423	503	6	17	80	0.2125000
NODE_9931_length_863_cov_72.856021	423	503	10	29	80	0.3625000
NODE_9932_length_863_cov_37.130890	363	443	0	80	80	1.0000000
NODE_9932_length_863_cov_37.130890	416	496	0	80	80	1.0000000
NODE_9932_length_863_cov_37.130890	492	572	0	80	80	1.0000000
NODE_9932_length_863_cov_37.130890	545	617	0	67	72	0.9305556
NODE_9932_length_863_cov_37.130890	545	617	1	2	72	0.0277778
NODE_9932_length_863_cov_37.130890	545	617	6	1	72	0.0138889
NODE_9932_length_863_cov_37.130890	545	617	12	1	72	0.0138889
NODE_9932_length_863_cov_37.130890	545	617	38	1	72	0.0138889
NODE_9933_length_863_cov_33.159686	287	367	0	54	80	0.6750000
NODE_9933_length_863_cov_33.159686	287	367	2	26	80	0.3250000
NODE_9933_length_863_cov_33.159686	340	420	0	1	80	0.0125000
NODE_9933_length_863_cov_33.159686	340	420	2	79	80	0.9875000
NODE_9934_length_863_cov_24.714660	370	450	0	80	80	1.0000000
NODE_9934_length_863_cov_24.714660	423	503	0	80	80	1.0000000
NODE_9935_length_863_cov_21.945026	341	421	0	80	80	1.0000000
NODE_9935_length_863_cov_21.945026	394	474	0	80	80	1.0000000
NODE_9936_length_863_cov_19.794503	393	473	0	80	80	1.0000000
NODE_9936_length_863_cov_19.794503	446	526	0	80	80	1.0000000
NODE_9937_length_863_cov_11.778796	303	383	0	80	80	1.0000000
NODE_9937_length_863_cov_11.778796	356	436	0	64	80	0.8000000
NODE_9937_length_863_cov_11.778796	356	436	2	16	80	0.2000000
NODE_9938_length_863_cov_10.026178	283	363	0	80	80	1.0000000
NODE_9938_length_863_cov_10.026178	336	416	0	80	80	1.0000000
NODE_9957_length_862_cov_46.811271	272	352	0	80	80	1.0000000
NODE_9957_length_862_cov_46.811271	325	405	0	80	80	1.0000000
NODE_9957_length_862_cov_46.811271	401	481	0	80	80	1.0000000
NODE_9957_length_862_cov_46.811271	454	534	0	80	80	1.0000000
NODE_9958_length_862_cov_34.638270	259	339	0	80	80	1.0000000
NODE_9958_length_862_cov_34.638270	312	392	0	57	80	0.7125000
NODE_9958_length_862_cov_34.638270	312	392	2	23	80	0.2875000
NODE_9958_length_862_cov_34.638270	388	468	2	80	80	1.0000000
NODE_9958_length_862_cov_34.638270	441	521	0	51	80	0.6375000
NODE_9958_length_862_cov_34.638270	441	521	2	29	80	0.3625000
NODE_9959_length_862_cov_32.068152	468	548	0	80	80	1.0000000
NODE_9959_length_862_cov_32.068152	521	601	0	80	80	1.0000000
NODE_9960_length_862_cov_23.584535	526	606	0	80	80	1.0000000
NODE_9960_length_862_cov_23.584535	579	659	0	80	80	1.0000000
NODE_9961_length_862_cov_19.980341	347	427	0	52	80	0.6500000
NODE_9961_length_862_cov_19.980341	347	427	2	28	80	0.3500000
NODE_9961_length_862_cov_19.980341	400	480	2	80	80	1.0000000
NODE_9962_length_862_cov_19.079948	379	459	1	54	80	0.6750000
NODE_9962_length_862_cov_19.079948	379	459	2	26	80	0.3250000
NODE_9962_length_862_cov_19.079948	432	512	0	4	80	0.0500000
NODE_9962_length_862_cov_19.079948	432	512	1	76	80	0.9500000
NODE_9963_length_862_cov_18.425950	94	174	8	80	80	1.0000000
NODE_9963_length_862_cov_18.425950	147	201	0	20	54	0.3703704
NODE_9963_length_862_cov_18.425950	147	201	8	34	54	0.6296296
NODE_9963_length_862_cov_18.425950	392	472	0	80	80	1.0000000
NODE_9963_length_862_cov_18.425950	445	525	0	80	80	1.0000000
NODE_9964_length_862_cov_11.740498	348	428	0	80	80	1.0000000
NODE_9964_length_862_cov_11.740498	401	481	0	80	80	1.0000000
NODE_9965_length_862_cov_11.685452	292	372	0	80	80	1.0000000
NODE_9965_length_862_cov_11.685452	345	425	0	80	80	1.0000000
NODE_9966_length_862_cov_8.259502	385	465	0	80	80	1.0000000
NODE_9966_length_862_cov_8.259502	438	518	0	80	80	1.0000000
NODE_9970_length_862_cov_2.895151	388	468	0	24	80	0.3000000
NODE_9970_length_862_cov_2.895151	388	468	2	56	80	0.7000000
NODE_9970_length_862_cov_2.895151	441	521	0	77	80	0.9625000
NODE_9970_length_862_cov_2.895151	441	521	2	3	80	0.0375000
NODE_9984_length_861_cov_52.679790	450	530	0	80	80	1.0000000
NODE_9984_length_861_cov_52.679790	503	583	0	80	80	1.0000000
NODE_9985_length_861_cov_34.868766	470	550	0	80	80	1.0000000
NODE_9985_length_861_cov_34.868766	523	603	0	80	80	1.0000000
NODE_9986_length_861_cov_25.622047	145	225	0	80	80	1.0000000
NODE_9986_length_861_cov_25.622047	198	278	0	80	80	1.0000000
NODE_9987_length_861_cov_22.052493	401	481	0	51	80	0.6375000
NODE_9987_length_861_cov_22.052493	401	481	1	13	80	0.1625000
NODE_9987_length_861_cov_22.052493	401	481	2	16	80	0.2000000
NODE_9987_length_861_cov_22.052493	454	534	0	80	80	1.0000000
NODE_9988_length_861_cov_19.913386	400	480	0	80	80	1.0000000
NODE_9988_length_861_cov_19.913386	453	533	0	80	80	1.0000000
NODE_9989_length_861_cov_15.237533	492	572	0	80	80	1.0000000
NODE_9989_length_861_cov_15.237533	545	625	0	80	80	1.0000000
NODE_9990_length_861_cov_12.460630	451	531	0	80	80	1.0000000
NODE_9990_length_861_cov_12.460630	504	584	0	80	80	1.0000000
NODE_9991_length_861_cov_9.463255	446	526	0	80	80	1.0000000
NODE_9991_length_861_cov_9.463255	499	579	0	80	80	1.0000000
NODE_9992_length_861_cov_9.435696	348	423	0	75	75	1.0000000
NODE_9993_length_861_cov_7.009186	51	91	0	40	40	1.0000000
NODE_9993_length_861_cov_7.009186	185	265	0	80	80	1.0000000
NODE_9993_length_861_cov_7.009186	238	318	0	80	80	1.0000000
NODE_10019_length_860_cov_54.315375	245	325	0	80	80	1.0000000
NODE_10019_length_860_cov_54.315375	298	378	0	80	80	1.0000000
NODE_10019_length_860_cov_54.315375	374	454	0	33	80	0.4125000
NODE_10019_length_860_cov_54.315375	374	454	3	1	80	0.0125000
NODE_10019_length_860_cov_54.315375	374	454	4	27	80	0.3375000
NODE_10019_length_860_cov_54.315375	374	454	5	1	80	0.0125000
NODE_10019_length_860_cov_54.315375	374	454	6	18	80	0.2250000
NODE_10019_length_860_cov_54.315375	427	507	4	8	80	0.1000000
NODE_10019_length_860_cov_54.315375	427	507	5	1	80	0.0125000
NODE_10019_length_860_cov_54.315375	427	507	6	71	80	0.8875000
NODE_10020_length_860_cov_29.618922	356	436	0	80	80	1.0000000
NODE_10020_length_860_cov_29.618922	409	489	0	80	80	1.0000000
NODE_10021_length_860_cov_15.152431	393	473	0	63	80	0.7875000
NODE_10021_length_860_cov_15.152431	393	473	2	17	80	0.2125000
NODE_10021_length_860_cov_15.152431	446	526	0	80	80	1.0000000
NODE_10022_length_860_cov_11.320631	343	423	0	80	80	1.0000000
NODE_10022_length_860_cov_11.320631	396	476	0	80	80	1.0000000
NODE_10049_length_859_cov_48.173684	432	512	0	27	80	0.3375000
NODE_10049_length_859_cov_48.173684	432	512	6	53	80	0.6625000
NODE_10049_length_859_cov_48.173684	485	565	0	19	80	0.2375000
NODE_10049_length_859_cov_48.173684	485	565	6	61	80	0.7625000
NODE_10050_length_859_cov_24.957895	402	482	4	15	80	0.1875000
NODE_10050_length_859_cov_24.957895	402	482	6	65	80	0.8125000
NODE_10050_length_859_cov_24.957895	455	535	0	50	80	0.6250000
NODE_10050_length_859_cov_24.957895	455	535	4	18	80	0.2250000
NODE_10050_length_859_cov_24.957895	455	535	6	12	80	0.1500000
NODE_10051_length_859_cov_23.431579	251	331	0	80	80	1.0000000
NODE_10051_length_859_cov_23.431579	304	384	0	74	80	0.9250000
NODE_10051_length_859_cov_23.431579	304	384	2	1	80	0.0125000
NODE_10051_length_859_cov_23.431579	304	384	4	5	80	0.0625000
NODE_10052_length_859_cov_20.523684	341	421	0	27	80	0.3375000
NODE_10052_length_859_cov_20.523684	341	421	2	53	80	0.6625000
NODE_10052_length_859_cov_20.523684	394	474	0	69	80	0.8625000
NODE_10052_length_859_cov_20.523684	394	474	2	11	80	0.1375000
NODE_10053_length_859_cov_17.996053	316	396	0	43	80	0.5375000
NODE_10053_length_859_cov_17.996053	316	396	2	37	80	0.4625000
NODE_10053_length_859_cov_17.996053	369	449	0	29	80	0.3625000
NODE_10053_length_859_cov_17.996053	369	449	2	51	80	0.6375000
NODE_10054_length_859_cov_16.757895	404	484	0	80	80	1.0000000
NODE_10054_length_859_cov_16.757895	457	537	0	80	80	1.0000000
NODE_10055_length_859_cov_15.852632	346	426	0	13	80	0.1625000
NODE_10055_length_859_cov_15.852632	346	426	4	67	80	0.8375000
NODE_10055_length_859_cov_15.852632	399	479	0	54	80	0.6750000
NODE_10055_length_859_cov_15.852632	399	479	4	26	80	0.3250000
NODE_10056_length_859_cov_11.584211	407	487	0	80	80	1.0000000
NODE_10056_length_859_cov_11.584211	460	540	0	80	80	1.0000000
NODE_10057_length_859_cov_10.296053	368	448	0	80	80	1.0000000
NODE_10057_length_859_cov_10.296053	421	501	0	80	80	1.0000000
NODE_10066_length_859_cov_2.359211	498	578	0	80	80	1.0000000
NODE_10066_length_859_cov_2.359211	551	631	0	80	80	1.0000000
NODE_10079_length_858_cov_54.677207	277	357	0	80	80	1.0000000
NODE_10079_length_858_cov_54.677207	330	410	0	80	80	1.0000000
NODE_10080_length_858_cov_40.584980	500	580	4	80	80	1.0000000
NODE_10080_length_858_cov_40.584980	553	633	0	49	80	0.6125000
NODE_10080_length_858_cov_40.584980	553	633	4	31	80	0.3875000
NODE_10081_length_858_cov_30.177866	363	443	0	80	80	1.0000000
NODE_10081_length_858_cov_30.177866	416	496	0	80	80	1.0000000
NODE_10081_length_858_cov_30.177866	492	572	0	80	80	1.0000000
NODE_10081_length_858_cov_30.177866	545	625	0	80	80	1.0000000
NODE_10082_length_858_cov_18.534914	371	451	0	80	80	1.0000000
NODE_10082_length_858_cov_18.534914	424	504	0	80	80	1.0000000
NODE_10083_length_858_cov_15.378129	232	312	12	80	80	1.0000000
NODE_10083_length_858_cov_15.378129	285	365	0	41	80	0.5125000
NODE_10083_length_858_cov_15.378129	285	365	12	39	80	0.4875000
NODE_10084_length_858_cov_12.310935	335	415	0	80	80	1.0000000
NODE_10084_length_858_cov_12.310935	388	468	0	80	80	1.0000000
NODE_10085_length_858_cov_7.835310	396	479	2	7	83	0.0843373
NODE_10085_length_858_cov_7.835310	396	479	4	76	83	0.9156626
NODE_10085_length_858_cov_7.835310	452	532	2	44	80	0.5500000
NODE_10085_length_858_cov_7.835310	452	532	4	36	80	0.4500000
NODE_10088_length_858_cov_4.953887	474	554	0	46	80	0.5750000
NODE_10088_length_858_cov_4.953887	474	554	2	34	80	0.4250000
NODE_10088_length_858_cov_4.953887	527	607	0	6	80	0.0750000
NODE_10088_length_858_cov_4.953887	527	607	2	74	80	0.9250000
NODE_10091_length_858_cov_3.475626	428	502	0	74	74	1.0000000
NODE_10091_length_858_cov_3.475626	498	578	0	30	80	0.3750000
NODE_10091_length_858_cov_3.475626	498	578	2	50	80	0.6250000
NODE_10091_length_858_cov_3.475626	551	631	0	65	80	0.8125000
NODE_10091_length_858_cov_3.475626	551	631	2	15	80	0.1875000
NODE_10108_length_857_cov_33.449868	384	455	0	71	71	1.0000000
NODE_10108_length_857_cov_33.449868	437	518	0	25	81	0.3086420
NODE_10108_length_857_cov_33.449868	437	518	2	16	81	0.1975309
NODE_10108_length_857_cov_33.449868	437	518	4	22	81	0.2716049
NODE_10108_length_857_cov_33.449868	437	518	6	18	81	0.2222222
NODE_10109_length_857_cov_32.527704	391	471	0	75	80	0.9375000
NODE_10109_length_857_cov_32.527704	391	471	4	1	80	0.0125000
NODE_10109_length_857_cov_32.527704	391	471	6	4	80	0.0500000
NODE_10109_length_857_cov_32.527704	444	524	0	80	80	1.0000000
NODE_10110_length_857_cov_27.853562	310	390	0	80	80	1.0000000
NODE_10110_length_857_cov_27.853562	363	443	0	80	80	1.0000000
NODE_10111_length_857_cov_24.654354	282	362	0	63	80	0.7875000
NODE_10111_length_857_cov_24.654354	282	362	2	17	80	0.2125000
NODE_10111_length_857_cov_24.654354	335	415	0	80	80	1.0000000
NODE_10112_length_857_cov_22.604222	374	456	0	82	82	1.0000000
NODE_10112_length_857_cov_22.604222	427	509	0	82	82	1.0000000
NODE_10113_length_857_cov_17.399736	320	400	0	2	80	0.0250000
NODE_10113_length_857_cov_17.399736	320	400	4	8	80	0.1000000
NODE_10113_length_857_cov_17.399736	320	400	6	2	80	0.0250000
NODE_10113_length_857_cov_17.399736	320	400	8	68	80	0.8500000
NODE_10113_length_857_cov_17.399736	373	453	0	55	80	0.6875000
NODE_10113_length_857_cov_17.399736	373	453	4	8	80	0.1000000
NODE_10113_length_857_cov_17.399736	373	453	6	2	80	0.0250000
NODE_10113_length_857_cov_17.399736	373	453	8	15	80	0.1875000
NODE_10114_length_857_cov_17.069921	388	468	0	80	80	1.0000000
NODE_10114_length_857_cov_17.069921	441	521	0	80	80	1.0000000
NODE_10115_length_857_cov_11.816623	433	513	0	80	80	1.0000000
NODE_10115_length_857_cov_11.816623	486	566	0	80	80	1.0000000
NODE_10116_length_857_cov_6.733509	513	593	0	80	80	1.0000000
NODE_10117_length_857_cov_6.251979	298	378	0	80	80	1.0000000
NODE_10117_length_857_cov_6.251979	351	431	0	80	80	1.0000000
NODE_10118_length_857_cov_5.827177	323	403	0	15	80	0.1875000
NODE_10118_length_857_cov_5.827177	323	403	1	65	80	0.8125000
NODE_10118_length_857_cov_5.827177	376	456	0	17	80	0.2125000
NODE_10118_length_857_cov_5.827177	376	456	1	63	80	0.7875000
NODE_10120_length_857_cov_4.530343	362	442	0	80	80	1.0000000
NODE_10120_length_857_cov_4.530343	415	495	0	80	80	1.0000000
NODE_10128_length_857_cov_1.464380	179	249	4	39	70	0.5571429
NODE_10128_length_857_cov_1.464380	179	249	6	31	70	0.4428571
NODE_10128_length_857_cov_1.464380	222	288	4	57	66	0.8636364
NODE_10128_length_857_cov_1.464380	222	288	6	9	66	0.1363636
NODE_10138_length_856_cov_39.147952	157	237	0	80	80	1.0000000
NODE_10138_length_856_cov_39.147952	210	290	0	80	80	1.0000000
NODE_10138_length_856_cov_39.147952	286	366	0	31	80	0.3875000
NODE_10138_length_856_cov_39.147952	286	366	2	49	80	0.6125000
NODE_10138_length_856_cov_39.147952	339	419	0	6	80	0.0750000
NODE_10138_length_856_cov_39.147952	339	419	2	74	80	0.9250000
NODE_10139_length_856_cov_21.937913	353	433	0	80	80	1.0000000
NODE_10139_length_856_cov_21.937913	406	486	0	80	80	1.0000000
NODE_10140_length_856_cov_20.227213	375	459	0	84	84	1.0000000
NODE_10140_length_856_cov_20.227213	432	512	0	80	80	1.0000000
NODE_10141_length_856_cov_18.445178	340	420	0	80	80	1.0000000
NODE_10141_length_856_cov_18.445178	393	473	0	80	80	1.0000000
NODE_10142_length_856_cov_16.564069	462	543	1	18	81	0.2222222
NODE_10142_length_856_cov_16.564069	462	543	2	63	81	0.7777778
NODE_10142_length_856_cov_16.564069	516	596	1	71	80	0.8875000
NODE_10142_length_856_cov_16.564069	516	596	2	9	80	0.1125000
NODE_10142_length_856_cov_16.564069	516	593	1	68	77	0.8831169
NODE_10142_length_856_cov_16.564069	516	593	2	9	77	0.1168831
NODE_10143_length_856_cov_15.803170	403	483	0	80	80	1.0000000
NODE_10143_length_856_cov_15.803170	456	536	0	80	80	1.0000000
NODE_10144_length_856_cov_12.904888	345	425	0	80	80	1.0000000
NODE_10144_length_856_cov_12.904888	398	478	0	80	80	1.0000000
NODE_10145_length_856_cov_9.881110	338	418	0	80	80	1.0000000
NODE_10145_length_856_cov_9.881110	391	471	0	80	80	1.0000000
NODE_10146_length_856_cov_5.875826	405	485	0	80	80	1.0000000
NODE_10146_length_856_cov_5.875826	458	538	0	80	80	1.0000000
NODE_10149_length_856_cov_4.821664	466	546	0	80	80	1.0000000
NODE_10149_length_856_cov_4.821664	519	599	0	80	80	1.0000000
NODE_10151_length_856_cov_4.195509	248	328	0	80	80	1.0000000
NODE_10151_length_856_cov_4.195509	301	381	0	80	80	1.0000000
NODE_10152_length_856_cov_3.899604	262	339	0	51	77	0.6623377
NODE_10152_length_856_cov_3.899604	262	339	2	26	77	0.3376623
NODE_10152_length_856_cov_3.899604	312	392	0	6	80	0.0750000
NODE_10152_length_856_cov_3.899604	312	392	2	74	80	0.9250000
NODE_10176_length_855_cov_28.312169	541	621	0	80	80	1.0000000
NODE_10176_length_855_cov_28.312169	594	674	0	80	80	1.0000000
NODE_10177_length_855_cov_19.392857	692	772	0	80	80	1.0000000
NODE_10177_length_855_cov_19.392857	745	825	0	80	80	1.0000000
NODE_10178_length_855_cov_13.402116	343	423	0	80	80	1.0000000
NODE_10178_length_855_cov_13.402116	396	476	0	80	80	1.0000000
NODE_10179_length_855_cov_13.116402	295	375	0	80	80	1.0000000
NODE_10179_length_855_cov_13.116402	348	428	0	80	80	1.0000000
NODE_10180_length_855_cov_11.179894	360	436	0	76	76	1.0000000
NODE_10180_length_855_cov_11.179894	409	489	0	80	80	1.0000000
NODE_10183_length_855_cov_8.593915	339	419	0	80	80	1.0000000
NODE_10183_length_855_cov_8.593915	392	472	0	80	80	1.0000000
NODE_10206_length_854_cov_64.200000	586	666	0	6	80	0.0750000
NODE_10206_length_854_cov_64.200000	586	666	8	19	80	0.2375000
NODE_10206_length_854_cov_64.200000	586	666	19	25	80	0.3125000
NODE_10206_length_854_cov_64.200000	586	666	20	30	80	0.3750000
NODE_10206_length_854_cov_64.200000	639	719	12	36	80	0.4500000
NODE_10206_length_854_cov_64.200000	639	719	18	1	80	0.0125000
NODE_10206_length_854_cov_64.200000	639	719	19	40	80	0.5000000
NODE_10206_length_854_cov_64.200000	639	719	20	3	80	0.0375000
NODE_10207_length_854_cov_46.037086	348	428	1	80	80	1.0000000
NODE_10207_length_854_cov_46.037086	401	481	1	28	80	0.3500000
NODE_10207_length_854_cov_46.037086	401	481	2	52	80	0.6500000
NODE_10207_length_854_cov_46.037086	458	481	2	23	23	1.0000000
NODE_10208_length_854_cov_45.633113	393	473	0	80	80	1.0000000
NODE_10208_length_854_cov_45.633113	446	526	0	80	80	1.0000000
NODE_10209_length_854_cov_40.407947	489	569	0	80	80	1.0000000
NODE_10209_length_854_cov_40.407947	542	622	0	80	80	1.0000000
NODE_10210_length_854_cov_29.773510	450	530	0	26	80	0.3250000
NODE_10210_length_854_cov_29.773510	450	530	4	54	80	0.6750000
NODE_10210_length_854_cov_29.773510	503	583	0	79	80	0.9875000
NODE_10210_length_854_cov_29.773510	503	583	4	1	80	0.0125000
NODE_10211_length_854_cov_22.968212	318	398	1	80	80	1.0000000
NODE_10211_length_854_cov_22.968212	371	451	0	12	80	0.1500000
NODE_10211_length_854_cov_22.968212	371	451	1	68	80	0.8500000
NODE_10212_length_854_cov_18.038411	387	467	0	80	80	1.0000000
NODE_10212_length_854_cov_18.038411	440	520	0	80	80	1.0000000
NODE_10213_length_854_cov_13.774834	330	410	0	80	80	1.0000000
NODE_10213_length_854_cov_13.774834	383	463	0	80	80	1.0000000
NODE_10214_length_854_cov_11.998675	366	446	0	20	80	0.2500000
NODE_10214_length_854_cov_11.998675	366	446	2	60	80	0.7500000
NODE_10214_length_854_cov_11.998675	419	499	0	73	80	0.9125000
NODE_10214_length_854_cov_11.998675	419	499	2	7	80	0.0875000
NODE_10215_length_854_cov_7.600000	298	378	0	80	80	1.0000000
NODE_10215_length_854_cov_7.600000	351	431	0	80	80	1.0000000
NODE_10218_length_854_cov_4.939073	603	633	0	1	30	0.0333333
NODE_10218_length_854_cov_4.939073	603	633	2	6	30	0.2000000
NODE_10218_length_854_cov_4.939073	603	633	6	3	30	0.1000000
NODE_10218_length_854_cov_4.939073	603	633	8	20	30	0.6666667
NODE_10226_length_854_cov_2.354967	613	633	0	20	20	1.0000000
NODE_10239_length_853_cov_61.988064	380	460	0	80	80	1.0000000
NODE_10239_length_853_cov_61.988064	433	513	0	73	80	0.9125000
NODE_10239_length_853_cov_61.988064	433	513	2	7	80	0.0875000
NODE_10240_length_853_cov_33.683024	384	464	0	80	80	1.0000000
NODE_10240_length_853_cov_33.683024	437	517	0	80	80	1.0000000
NODE_10241_length_853_cov_31.965517	224	305	0	34	81	0.4197531
NODE_10241_length_853_cov_31.965517	224	305	2	47	81	0.5802469
NODE_10241_length_853_cov_31.965517	278	358	0	24	80	0.3000000
NODE_10241_length_853_cov_31.965517	278	358	2	56	80	0.7000000
NODE_10241_length_853_cov_31.965517	354	434	0	80	80	1.0000000
NODE_10241_length_853_cov_31.965517	407	466	0	59	59	1.0000000
NODE_10242_length_853_cov_16.551724	247	327	0	80	80	1.0000000
NODE_10242_length_853_cov_16.551724	300	380	0	80	80	1.0000000
NODE_10242_length_853_cov_16.551724	376	456	0	80	80	1.0000000
NODE_10242_length_853_cov_16.551724	429	509	0	80	80	1.0000000
NODE_10243_length_853_cov_15.395225	395	475	0	80	80	1.0000000
NODE_10243_length_853_cov_15.395225	448	528	0	80	80	1.0000000
NODE_10244_length_853_cov_15.086207	355	434	0	79	79	1.0000000
NODE_10244_length_853_cov_15.086207	408	488	0	80	80	1.0000000
NODE_10245_length_853_cov_14.929708	160	240	0	80	80	1.0000000
NODE_10245_length_853_cov_14.929708	213	293	0	80	80	1.0000000
NODE_10246_length_853_cov_11.299735	395	475	0	80	80	1.0000000
NODE_10246_length_853_cov_11.299735	448	528	0	80	80	1.0000000
NODE_10247_length_853_cov_9.571618	479	559	0	80	80	1.0000000
NODE_10247_length_853_cov_9.571618	532	612	0	80	80	1.0000000
NODE_10248_length_853_cov_7.828912	265	345	0	80	80	1.0000000
NODE_10248_length_853_cov_7.828912	318	398	0	80	80	1.0000000
NODE_10249_length_853_cov_7.623342	255	335	0	80	80	1.0000000
NODE_10249_length_853_cov_7.623342	308	388	0	80	80	1.0000000
NODE_10253_length_853_cov_3.173740	212	292	0	80	80	1.0000000
NODE_10253_length_853_cov_3.173740	265	343	0	78	78	1.0000000
NODE_10258_length_853_cov_1.823607	710	773	0	63	63	1.0000000
NODE_10258_length_853_cov_1.823607	711	773	0	62	62	1.0000000
NODE_10258_length_853_cov_1.823607	711	773	0	62	62	1.0000000
NODE_10258_length_853_cov_1.823607	746	826	0	80	80	1.0000000
NODE_10267_length_852_cov_30.022576	279	359	0	80	80	1.0000000
NODE_10267_length_852_cov_30.022576	332	412	0	80	80	1.0000000
NODE_10268_length_852_cov_19.373174	353	433	0	80	80	1.0000000
NODE_10268_length_852_cov_19.373174	406	486	0	80	80	1.0000000
NODE_10269_length_852_cov_18.853918	297	377	0	19	80	0.2375000
NODE_10269_length_852_cov_18.853918	297	377	2	61	80	0.7625000
NODE_10269_length_852_cov_18.853918	350	430	0	72	80	0.9000000
NODE_10269_length_852_cov_18.853918	350	430	2	8	80	0.1000000
NODE_10269_length_852_cov_18.853918	426	506	0	80	80	1.0000000
NODE_10269_length_852_cov_18.853918	489	559	0	70	70	1.0000000
NODE_10270_length_852_cov_17.391766	472	552	0	80	80	1.0000000
NODE_10270_length_852_cov_17.391766	525	605	0	61	80	0.7625000
NODE_10270_length_852_cov_17.391766	525	605	2	19	80	0.2375000
NODE_10271_length_852_cov_8.818061	513	593	0	80	80	1.0000000
NODE_10271_length_852_cov_8.818061	566	646	0	80	80	1.0000000
NODE_10274_length_852_cov_4.403718	493	573	0	80	80	1.0000000
NODE_10274_length_852_cov_4.403718	546	626	0	80	80	1.0000000
NODE_10285_length_851_cov_33.953457	329	409	0	80	80	1.0000000
NODE_10285_length_851_cov_33.953457	382	462	0	80	80	1.0000000
NODE_10286_length_851_cov_30.488032	395	475	0	27	80	0.3375000
NODE_10286_length_851_cov_30.488032	395	475	3	2	80	0.0250000
NODE_10286_length_851_cov_30.488032	395	475	4	51	80	0.6375000
NODE_10286_length_851_cov_30.488032	448	528	0	7	80	0.0875000
NODE_10286_length_851_cov_30.488032	448	528	4	73	80	0.9125000
NODE_10287_length_851_cov_27.481383	353	433	0	80	80	1.0000000
NODE_10287_length_851_cov_27.481383	406	486	0	80	80	1.0000000
NODE_10288_length_851_cov_23.656915	345	425	0	80	80	1.0000000
NODE_10288_length_851_cov_23.656915	398	478	0	75	80	0.9375000
NODE_10288_length_851_cov_23.656915	398	478	2	5	80	0.0625000
NODE_10289_length_851_cov_19.769947	298	378	0	80	80	1.0000000
NODE_10289_length_851_cov_19.769947	351	431	0	80	80	1.0000000
NODE_10290_length_851_cov_17.386968	459	539	0	80	80	1.0000000
NODE_10290_length_851_cov_17.386968	512	592	0	80	80	1.0000000
NODE_10291_length_851_cov_13.519947	323	403	0	80	80	1.0000000
NODE_10291_length_851_cov_13.519947	376	456	0	80	80	1.0000000
NODE_10292_length_851_cov_11.771277	403	483	0	80	80	1.0000000
NODE_10292_length_851_cov_11.771277	456	536	0	80	80	1.0000000
NODE_10293_length_851_cov_11.698138	227	307	2	10	80	0.1250000
NODE_10293_length_851_cov_11.698138	227	307	4	70	80	0.8750000
NODE_10293_length_851_cov_11.698138	280	360	0	42	80	0.5250000
NODE_10293_length_851_cov_11.698138	280	360	4	38	80	0.4750000
NODE_10293_length_851_cov_11.698138	356	436	0	80	80	1.0000000
NODE_10293_length_851_cov_11.698138	409	489	0	80	80	1.0000000
NODE_10294_length_851_cov_11.672872	372	452	0	80	80	1.0000000
NODE_10294_length_851_cov_11.672872	425	505	0	80	80	1.0000000
NODE_10295_length_851_cov_10.938830	418	499	0	81	81	1.0000000
NODE_10296_length_851_cov_10.074468	454	534	0	80	80	1.0000000
NODE_10296_length_851_cov_10.074468	507	587	0	80	80	1.0000000
NODE_10297_length_851_cov_7.599734	330	410	0	80	80	1.0000000
NODE_10297_length_851_cov_7.599734	383	463	0	80	80	1.0000000
NODE_10298_length_851_cov_5.639628	379	459	0	80	80	1.0000000
NODE_10298_length_851_cov_5.639628	432	512	0	80	80	1.0000000
NODE_10300_length_851_cov_3.880319	729	765	0	36	36	1.0000000
NODE_10300_length_851_cov_3.880319	743	824	0	81	81	1.0000000
NODE_10301_length_851_cov_3.823138	380	460	0	80	80	1.0000000
NODE_10301_length_851_cov_3.823138	433	513	0	80	80	1.0000000
NODE_10318_length_851_cov_1.130319	33	103	0	39	70	0.5571429
NODE_10318_length_851_cov_1.130319	33	103	2	31	70	0.4428571
NODE_10326_length_850_cov_36.527297	360	440	0	65	80	0.8125000
NODE_10326_length_850_cov_36.527297	360	440	2	15	80	0.1875000
NODE_10326_length_850_cov_36.527297	413	493	0	80	80	1.0000000
NODE_10327_length_850_cov_31.006658	330	410	0	80	80	1.0000000
NODE_10327_length_850_cov_31.006658	383	463	0	80	80	1.0000000
NODE_10328_length_850_cov_30.460719	251	331	0	73	80	0.9125000
NODE_10328_length_850_cov_30.460719	251	331	2	7	80	0.0875000
NODE_10328_length_850_cov_30.460719	304	384	0	20	80	0.2500000
NODE_10328_length_850_cov_30.460719	304	384	2	36	80	0.4500000
NODE_10328_length_850_cov_30.460719	304	384	5	1	80	0.0125000
NODE_10328_length_850_cov_30.460719	304	384	6	23	80	0.2875000
NODE_10329_length_850_cov_25.263648	355	435	0	47	80	0.5875000
NODE_10329_length_850_cov_25.263648	355	435	2	33	80	0.4125000
NODE_10329_length_850_cov_25.263648	408	488	0	80	80	1.0000000
NODE_10330_length_850_cov_21.368842	290	370	0	80	80	1.0000000
NODE_10330_length_850_cov_21.368842	343	423	0	80	80	1.0000000
NODE_10331_length_850_cov_20.500666	318	398	0	80	80	1.0000000
NODE_10331_length_850_cov_20.500666	371	451	0	80	80	1.0000000
NODE_10332_length_850_cov_17.268975	398	478	3	23	80	0.2875000
NODE_10332_length_850_cov_17.268975	398	478	4	9	80	0.1125000
NODE_10332_length_850_cov_17.268975	398	478	5	33	80	0.4125000
NODE_10332_length_850_cov_17.268975	398	478	6	15	80	0.1875000
NODE_10332_length_850_cov_17.268975	451	531	2	18	80	0.2250000
NODE_10332_length_850_cov_17.268975	451	531	5	12	80	0.1500000
NODE_10332_length_850_cov_17.268975	451	531	6	50	80	0.6250000
NODE_10333_length_850_cov_14.728362	379	459	0	80	80	1.0000000
NODE_10333_length_850_cov_14.728362	432	512	0	80	80	1.0000000
NODE_10334_length_850_cov_14.230360	313	393	0	80	80	1.0000000
NODE_10334_length_850_cov_14.230360	366	446	0	80	80	1.0000000
NODE_10335_length_850_cov_12.387483	337	417	0	80	80	1.0000000
NODE_10335_length_850_cov_12.387483	390	470	0	80	80	1.0000000
NODE_10335_length_850_cov_12.387483	466	545	0	33	79	0.4177215
NODE_10335_length_850_cov_12.387483	466	545	4	46	79	0.5822785
NODE_10335_length_850_cov_12.387483	518	598	4	80	80	1.0000000
NODE_10336_length_850_cov_11.402130	329	409	0	80	80	1.0000000
NODE_10336_length_850_cov_11.402130	382	462	0	80	80	1.0000000
NODE_10337_length_850_cov_10.326232	330	410	2	6	80	0.0750000
NODE_10337_length_850_cov_10.326232	330	410	6	74	80	0.9250000
NODE_10337_length_850_cov_10.326232	383	463	4	2	80	0.0250000
NODE_10337_length_850_cov_10.326232	383	463	5	18	80	0.2250000
NODE_10337_length_850_cov_10.326232	383	463	6	60	80	0.7500000
NODE_10338_length_850_cov_9.675100	464	544	0	80	80	1.0000000
NODE_10338_length_850_cov_9.675100	517	597	0	80	80	1.0000000
NODE_10367_length_849_cov_43.137333	336	416	0	80	80	1.0000000
NODE_10367_length_849_cov_43.137333	389	469	0	80	80	1.0000000
NODE_10368_length_849_cov_36.562667	326	406	0	80	80	1.0000000
NODE_10368_length_849_cov_36.562667	379	459	0	80	80	1.0000000
NODE_10369_length_849_cov_35.449333	408	488	0	80	80	1.0000000
NODE_10369_length_849_cov_35.449333	461	541	0	80	80	1.0000000
NODE_10370_length_849_cov_29.989333	332	412	0	80	80	1.0000000
NODE_10370_length_849_cov_29.989333	385	465	0	80	80	1.0000000
NODE_10371_length_849_cov_17.974667	343	423	0	45	80	0.5625000
NODE_10371_length_849_cov_17.974667	343	423	4	35	80	0.4375000
NODE_10371_length_849_cov_17.974667	396	476	0	5	80	0.0625000
NODE_10371_length_849_cov_17.974667	396	476	4	75	80	0.9375000
NODE_10372_length_849_cov_17.018667	360	440	0	80	80	1.0000000
NODE_10372_length_849_cov_17.018667	416	493	0	77	77	1.0000000
NODE_10373_length_849_cov_15.581333	287	367	0	6	80	0.0750000
NODE_10373_length_849_cov_15.581333	287	367	2	74	80	0.9250000
NODE_10373_length_849_cov_15.581333	340	420	0	4	80	0.0500000
NODE_10373_length_849_cov_15.581333	340	420	2	76	80	0.9500000
NODE_10373_length_849_cov_15.581333	416	496	0	80	80	1.0000000
NODE_10373_length_849_cov_15.581333	469	549	0	80	80	1.0000000
NODE_10374_length_849_cov_9.460000	370	450	0	80	80	1.0000000
NODE_10374_length_849_cov_9.460000	423	503	0	80	80	1.0000000
NODE_10375_length_849_cov_4.893333	427	507	0	25	80	0.3125000
NODE_10375_length_849_cov_4.893333	427	507	3	3	80	0.0375000
NODE_10375_length_849_cov_4.893333	427	507	6	52	80	0.6500000
NODE_10375_length_849_cov_4.893333	480	560	0	78	80	0.9750000
NODE_10375_length_849_cov_4.893333	480	560	3	2	80	0.0250000
NODE_10376_length_849_cov_4.860000	380	460	0	80	80	1.0000000
NODE_10376_length_849_cov_4.860000	433	513	0	80	80	1.0000000
NODE_10379_length_849_cov_2.761333	254	334	0	80	80	1.0000000
NODE_10396_length_848_cov_27.287049	253	333	0	80	80	1.0000000
NODE_10396_length_848_cov_27.287049	306	386	0	80	80	1.0000000
NODE_10396_length_848_cov_27.287049	382	458	0	76	76	1.0000000
NODE_10396_length_848_cov_27.287049	435	513	0	78	78	1.0000000
NODE_10397_length_848_cov_23.511348	248	328	0	80	80	1.0000000
NODE_10397_length_848_cov_23.511348	301	381	0	80	80	1.0000000
NODE_10397_length_848_cov_23.511348	377	457	0	80	80	1.0000000
NODE_10397_length_848_cov_23.511348	430	508	0	78	78	1.0000000
NODE_10398_length_848_cov_21.939920	295	375	0	5	80	0.0625000
NODE_10398_length_848_cov_21.939920	295	375	2	75	80	0.9375000
NODE_10398_length_848_cov_21.939920	348	428	0	58	80	0.7250000
NODE_10398_length_848_cov_21.939920	348	428	2	22	80	0.2750000
NODE_10399_length_848_cov_21.937250	434	514	0	80	80	1.0000000
NODE_10399_length_848_cov_21.937250	487	567	0	80	80	1.0000000
NODE_10400_length_848_cov_19.500668	367	392	2	25	25	1.0000000
NODE_10400_length_848_cov_19.500668	388	468	0	66	80	0.8250000
NODE_10400_length_848_cov_19.500668	388	468	2	14	80	0.1750000
NODE_10400_length_848_cov_19.500668	441	521	0	80	80	1.0000000
NODE_10400_length_848_cov_19.500668	443	512	0	69	69	1.0000000
NODE_10400_length_848_cov_19.500668	443	472	0	29	29	1.0000000
NODE_10401_length_848_cov_16.566088	323	403	0	20	80	0.2500000
NODE_10401_length_848_cov_16.566088	323	403	2	37	80	0.4625000
NODE_10401_length_848_cov_16.566088	323	403	4	23	80	0.2875000
NODE_10401_length_848_cov_16.566088	376	456	0	4	80	0.0500000
NODE_10401_length_848_cov_16.566088	376	456	4	70	80	0.8750000
NODE_10401_length_848_cov_16.566088	376	456	6	6	80	0.0750000
NODE_10402_length_848_cov_16.109479	256	336	0	17	80	0.2125000
NODE_10402_length_848_cov_16.109479	256	336	2	63	80	0.7875000
NODE_10402_length_848_cov_16.109479	309	389	0	15	80	0.1875000
NODE_10402_length_848_cov_16.109479	309	389	2	65	80	0.8125000
NODE_10402_length_848_cov_16.109479	385	465	0	80	80	1.0000000
NODE_10402_length_848_cov_16.109479	438	518	0	80	80	1.0000000
NODE_10403_length_848_cov_15.919893	492	568	0	76	76	1.0000000
NODE_10403_length_848_cov_15.919893	541	621	0	80	80	1.0000000
NODE_10404_length_848_cov_13.979973	269	349	0	80	80	1.0000000
NODE_10404_length_848_cov_13.979973	322	402	0	80	80	1.0000000
NODE_10405_length_848_cov_13.073431	343	423	0	80	80	1.0000000
NODE_10405_length_848_cov_13.073431	396	476	0	80	80	1.0000000
NODE_10406_length_848_cov_8.523364	232	312	0	80	80	1.0000000
NODE_10406_length_848_cov_8.523364	285	365	0	80	80	1.0000000
NODE_10406_length_848_cov_8.523364	361	441	0	80	80	1.0000000
NODE_10406_length_848_cov_8.523364	414	494	0	80	80	1.0000000
NODE_10408_length_848_cov_5.903872	251	331	0	71	80	0.8875000
NODE_10408_length_848_cov_5.903872	251	331	5	9	80	0.1125000
NODE_10408_length_848_cov_5.903872	304	383	0	79	79	1.0000000
NODE_10409_length_848_cov_5.236315	378	458	0	80	80	1.0000000
NODE_10409_length_848_cov_5.236315	431	507	0	76	76	1.0000000
NODE_10424_length_847_cov_56.417112	576	656	0	80	80	1.0000000
NODE_10424_length_847_cov_56.417112	629	709	0	80	80	1.0000000
NODE_10425_length_847_cov_27.292781	390	470	0	80	80	1.0000000
NODE_10425_length_847_cov_27.292781	443	523	0	80	80	1.0000000
NODE_10426_length_847_cov_24.954545	342	422	0	80	80	1.0000000
NODE_10426_length_847_cov_24.954545	395	475	0	80	80	1.0000000
NODE_10427_length_847_cov_20.310160	341	421	0	80	80	1.0000000
NODE_10427_length_847_cov_20.310160	394	474	0	80	80	1.0000000
NODE_10428_length_847_cov_19.002674	368	448	0	80	80	1.0000000
NODE_10428_length_847_cov_19.002674	421	501	0	80	80	1.0000000
NODE_10429_length_847_cov_16.879679	218	298	0	80	80	1.0000000
NODE_10429_length_847_cov_16.879679	271	351	0	80	80	1.0000000
NODE_10431_length_847_cov_11.784759	298	378	0	80	80	1.0000000
NODE_10431_length_847_cov_11.784759	351	431	0	80	80	1.0000000
NODE_10431_length_847_cov_11.784759	427	507	0	80	80	1.0000000
NODE_10431_length_847_cov_11.784759	480	560	0	80	80	1.0000000
NODE_10432_length_847_cov_11.604278	407	487	0	80	80	1.0000000
NODE_10432_length_847_cov_11.604278	460	540	0	80	80	1.0000000
NODE_10433_length_847_cov_10.221925	395	475	0	32	80	0.4000000
NODE_10433_length_847_cov_10.221925	395	475	3	16	80	0.2000000
NODE_10433_length_847_cov_10.221925	395	475	4	32	80	0.4000000
NODE_10433_length_847_cov_10.221925	448	528	0	80	80	1.0000000
NODE_10434_length_847_cov_4.602941	97	154	12	1	57	0.0175439
NODE_10434_length_847_cov_4.602941	97	154	14	3	57	0.0526316
NODE_10434_length_847_cov_4.602941	97	154	17	10	57	0.1754386
NODE_10434_length_847_cov_4.602941	97	154	18	16	57	0.2807018
NODE_10434_length_847_cov_4.602941	97	154	19	14	57	0.2456140
NODE_10434_length_847_cov_4.602941	97	154	20	13	57	0.2280702
NODE_10434_length_847_cov_4.602941	127	207	2	17	80	0.2125000
NODE_10434_length_847_cov_4.602941	127	207	4	5	80	0.0625000
NODE_10434_length_847_cov_4.602941	127	207	8	24	80	0.3000000
NODE_10434_length_847_cov_4.602941	127	207	10	3	80	0.0375000
NODE_10434_length_847_cov_4.602941	127	207	12	5	80	0.0625000
NODE_10434_length_847_cov_4.602941	127	207	14	3	80	0.0375000
NODE_10434_length_847_cov_4.602941	127	207	17	10	80	0.1250000
NODE_10434_length_847_cov_4.602941	127	207	18	5	80	0.0625000
NODE_10434_length_847_cov_4.602941	127	207	19	8	80	0.1000000
NODE_10456_length_846_cov_39.476573	336	416	0	80	80	1.0000000
NODE_10456_length_846_cov_39.476573	389	469	0	80	80	1.0000000
NODE_10456_length_846_cov_39.476573	465	545	0	80	80	1.0000000
NODE_10456_length_846_cov_39.476573	518	598	0	57	80	0.7125000
NODE_10456_length_846_cov_39.476573	518	598	2	23	80	0.2875000
NODE_10457_length_846_cov_37.297189	312	392	0	80	80	1.0000000
NODE_10457_length_846_cov_37.297189	365	445	0	80	80	1.0000000
NODE_10458_length_846_cov_32.852744	279	359	6	80	80	1.0000000
NODE_10458_length_846_cov_32.852744	332	412	0	2	80	0.0250000
NODE_10458_length_846_cov_32.852744	332	412	5	1	80	0.0125000
NODE_10458_length_846_cov_32.852744	332	412	6	77	80	0.9625000
NODE_10459_length_846_cov_31.717537	290	370	0	80	80	1.0000000
NODE_10459_length_846_cov_31.717537	343	423	0	80	80	1.0000000
NODE_10460_length_846_cov_24.380187	350	430	0	80	80	1.0000000
NODE_10460_length_846_cov_24.380187	403	483	0	80	80	1.0000000
NODE_10461_length_846_cov_16.155288	364	444	0	80	80	1.0000000
NODE_10461_length_846_cov_16.155288	417	497	0	80	80	1.0000000
NODE_10462_length_846_cov_15.917001	398	478	0	80	80	1.0000000
NODE_10462_length_846_cov_15.917001	451	531	0	80	80	1.0000000
NODE_10463_length_846_cov_15.275770	355	435	0	10	80	0.1250000
NODE_10463_length_846_cov_15.275770	355	435	2	70	80	0.8750000
NODE_10463_length_846_cov_15.275770	408	488	0	63	80	0.7875000
NODE_10463_length_846_cov_15.275770	408	488	2	17	80	0.2125000
NODE_10464_length_846_cov_13.618474	216	296	0	46	80	0.5750000
NODE_10464_length_846_cov_13.618474	216	296	2	34	80	0.4250000
NODE_10464_length_846_cov_13.618474	269	349	0	80	80	1.0000000
NODE_10464_length_846_cov_13.618474	345	425	0	80	80	1.0000000
NODE_10464_length_846_cov_13.618474	398	478	0	80	80	1.0000000
NODE_10465_length_846_cov_12.878179	425	505	0	28	80	0.3500000
NODE_10465_length_846_cov_12.878179	425	505	1	52	80	0.6500000
NODE_10465_length_846_cov_12.878179	478	558	0	58	80	0.7250000
NODE_10465_length_846_cov_12.878179	478	558	2	22	80	0.2750000
NODE_10467_length_846_cov_7.232932	407	487	4	80	80	1.0000000
NODE_10467_length_846_cov_7.232932	460	540	0	35	80	0.4375000
NODE_10467_length_846_cov_7.232932	460	540	4	45	80	0.5625000
NODE_10468_length_846_cov_6.776439	320	400	0	43	80	0.5375000
NODE_10468_length_846_cov_6.776439	320	400	2	37	80	0.4625000
NODE_10468_length_846_cov_6.776439	373	453	0	80	80	1.0000000
NODE_10472_length_846_cov_3.025435	190	270	0	80	80	1.0000000
NODE_10472_length_846_cov_3.025435	243	323	0	80	80	1.0000000
NODE_10488_length_845_cov_34.458445	213	293	0	8	80	0.1000000
NODE_10488_length_845_cov_34.458445	213	293	4	72	80	0.9000000
NODE_10488_length_845_cov_34.458445	266	346	0	26	80	0.3250000
NODE_10488_length_845_cov_34.458445	266	346	4	54	80	0.6750000
NODE_10489_length_845_cov_33.025469	309	389	0	80	80	1.0000000
NODE_10489_length_845_cov_33.025469	362	442	0	80	80	1.0000000
NODE_10490_length_845_cov_30.331099	288	368	0	80	80	1.0000000
NODE_10490_length_845_cov_30.331099	341	421	0	80	80	1.0000000
NODE_10491_length_845_cov_22.042895	455	535	0	3	80	0.0375000
NODE_10491_length_845_cov_22.042895	455	535	4	77	80	0.9625000
NODE_10491_length_845_cov_22.042895	508	588	0	56	80	0.7000000
NODE_10491_length_845_cov_22.042895	508	588	4	24	80	0.3000000
NODE_10492_length_845_cov_20.662198	325	406	0	81	81	1.0000000
NODE_10492_length_845_cov_20.662198	379	459	0	80	80	1.0000000
NODE_10493_length_845_cov_17.214477	352	432	0	62	80	0.7750000
NODE_10493_length_845_cov_17.214477	352	432	2	18	80	0.2250000
NODE_10493_length_845_cov_17.214477	405	485	0	16	80	0.2000000
NODE_10493_length_845_cov_17.214477	405	485	2	64	80	0.8000000
NODE_10494_length_845_cov_15.805630	409	489	0	80	80	1.0000000
NODE_10494_length_845_cov_15.805630	462	542	0	80	80	1.0000000
NODE_10495_length_845_cov_13.443700	329	409	0	80	80	1.0000000
NODE_10495_length_845_cov_13.443700	382	462	0	80	80	1.0000000
NODE_10496_length_845_cov_12.301609	334	414	0	80	80	1.0000000
NODE_10496_length_845_cov_12.301609	387	467	0	80	80	1.0000000
NODE_10497_length_845_cov_11.836461	389	469	0	80	80	1.0000000
NODE_10497_length_845_cov_11.836461	442	522	0	80	80	1.0000000
NODE_10499_length_845_cov_8.140751	439	519	2	80	80	1.0000000
NODE_10499_length_845_cov_8.140751	492	572	0	27	80	0.3375000
NODE_10499_length_845_cov_8.140751	492	572	1	13	80	0.1625000
NODE_10499_length_845_cov_8.140751	492	572	2	40	80	0.5000000
NODE_10516_length_845_cov_1.680965	447	491	0	5	44	0.1136364
NODE_10516_length_845_cov_1.680965	447	491	2	39	44	0.8863636
NODE_10528_length_844_cov_43.778523	313	393	0	80	80	1.0000000
NODE_10528_length_844_cov_43.778523	366	446	0	80	80	1.0000000
NODE_10528_length_844_cov_43.778523	442	522	0	80	80	1.0000000
NODE_10528_length_844_cov_43.778523	495	575	0	80	80	1.0000000
NODE_10529_length_844_cov_36.762416	381	461	0	80	80	1.0000000
NODE_10529_length_844_cov_36.762416	434	514	0	80	80	1.0000000
NODE_10529_length_844_cov_36.762416	510	590	0	31	80	0.3875000
NODE_10529_length_844_cov_36.762416	510	590	6	49	80	0.6125000
NODE_10529_length_844_cov_36.762416	563	644	0	25	81	0.3086420
NODE_10529_length_844_cov_36.762416	563	644	2	4	81	0.0493827
NODE_10529_length_844_cov_36.762416	563	644	6	52	81	0.6419753
NODE_10530_length_844_cov_35.765101	424	504	0	80	80	1.0000000
NODE_10530_length_844_cov_35.765101	477	557	0	80	80	1.0000000
NODE_10531_length_844_cov_18.445638	353	420	0	67	67	1.0000000
NODE_10531_length_844_cov_18.445638	393	473	0	80	80	1.0000000
NODE_10532_length_844_cov_12.616107	363	443	0	80	80	1.0000000
NODE_10532_length_844_cov_12.616107	416	496	0	80	80	1.0000000
NODE_10533_length_844_cov_12.092617	171	251	0	80	80	1.0000000
NODE_10533_length_844_cov_12.092617	224	304	0	80	80	1.0000000
NODE_10534_length_844_cov_11.883221	341	421	0	80	80	1.0000000
NODE_10534_length_844_cov_11.883221	394	474	0	80	80	1.0000000
NODE_10535_length_844_cov_10.571812	390	448	0	58	58	1.0000000
NODE_10537_length_844_cov_9.357047	370	450	0	9	80	0.1125000
NODE_10537_length_844_cov_9.357047	370	450	1	32	80	0.4000000
NODE_10537_length_844_cov_9.357047	370	450	2	4	80	0.0500000
NODE_10537_length_844_cov_9.357047	370	450	4	35	80	0.4375000
NODE_10537_length_844_cov_9.357047	423	503	0	62	80	0.7750000
NODE_10537_length_844_cov_9.357047	423	503	1	18	80	0.2250000
NODE_10538_length_844_cov_8.975839	355	435	0	80	80	1.0000000
NODE_10538_length_844_cov_8.975839	408	488	0	80	80	1.0000000
NODE_10539_length_844_cov_7.347651	357	438	0	10	81	0.1234568
NODE_10539_length_844_cov_7.347651	357	438	4	71	81	0.8765432
NODE_10539_length_844_cov_7.347651	410	491	4	81	81	1.0000000
NODE_10540_length_844_cov_6.975839	444	524	0	80	80	1.0000000
NODE_10540_length_844_cov_6.975839	497	577	0	80	80	1.0000000
NODE_10567_length_843_cov_48.258065	203	262	175	1	59	0.0169492
NODE_10567_length_843_cov_48.258065	203	262	178	1	59	0.0169492
NODE_10567_length_843_cov_48.258065	203	262	179	1	59	0.0169492
NODE_10567_length_843_cov_48.258065	203	262	185	1	59	0.0169492
NODE_10567_length_843_cov_48.258065	203	262	186	1	59	0.0169492
NODE_10567_length_843_cov_48.258065	203	262	187	1	59	0.0169492
NODE_10567_length_843_cov_48.258065	203	262	188	4	59	0.0677966
NODE_10567_length_843_cov_48.258065	203	262	189	1	59	0.0169492
NODE_10567_length_843_cov_48.258065	203	262	191	2	59	0.0338983
NODE_10567_length_843_cov_48.258065	203	262	192	5	59	0.0847458
NODE_10567_length_843_cov_48.258065	203	262	193	2	59	0.0338983
NODE_10567_length_843_cov_48.258065	203	262	194	2	59	0.0338983
NODE_10567_length_843_cov_48.258065	203	262	195	5	59	0.0847458
NODE_10567_length_843_cov_48.258065	203	262	196	2	59	0.0338983
NODE_10567_length_843_cov_48.258065	203	262	197	6	59	0.1016949
NODE_10567_length_843_cov_48.258065	203	262	198	6	59	0.1016949
NODE_10567_length_843_cov_48.258065	203	262	199	5	59	0.0847458
NODE_10567_length_843_cov_48.258065	203	262	200	2	59	0.0338983
NODE_10567_length_843_cov_48.258065	203	262	201	4	59	0.0677966
NODE_10567_length_843_cov_48.258065	203	262	203	7	59	0.1186441
NODE_10568_length_843_cov_31.279570	351	431	0	69	80	0.8625000
NODE_10568_length_843_cov_31.279570	351	431	2	11	80	0.1375000
NODE_10568_length_843_cov_31.279570	404	484	0	79	80	0.9875000
NODE_10568_length_843_cov_31.279570	404	484	2	1	80	0.0125000
NODE_10569_length_843_cov_27.060484	423	503	0	80	80	1.0000000
NODE_10569_length_843_cov_27.060484	476	556	0	80	80	1.0000000
NODE_10570_length_843_cov_22.725806	334	414	0	80	80	1.0000000
NODE_10570_length_843_cov_22.725806	339	396	0	57	57	1.0000000
NODE_10570_length_843_cov_22.725806	356	427	0	71	71	1.0000000
NODE_10570_length_843_cov_22.725806	387	455	0	68	68	1.0000000
NODE_10570_length_843_cov_22.725806	401	476	0	75	75	1.0000000
NODE_10570_length_843_cov_22.725806	418	486	0	68	68	1.0000000
NODE_10570_length_843_cov_22.725806	449	529	0	80	80	1.0000000
NODE_10571_length_843_cov_22.387097	412	492	0	11	80	0.1375000
NODE_10571_length_843_cov_22.387097	412	492	8	69	80	0.8625000
NODE_10571_length_843_cov_22.387097	465	545	0	2	80	0.0250000
NODE_10571_length_843_cov_22.387097	465	545	7	1	80	0.0125000
NODE_10571_length_843_cov_22.387097	465	545	8	77	80	0.9625000
NODE_10572_length_843_cov_16.326613	551	631	0	56	80	0.7000000
NODE_10572_length_843_cov_16.326613	551	631	2	24	80	0.3000000
NODE_10572_length_843_cov_16.326613	604	684	0	80	80	1.0000000
NODE_10573_length_843_cov_13.478495	381	461	0	64	80	0.8000000
NODE_10573_length_843_cov_13.478495	381	461	4	5	80	0.0625000
NODE_10573_length_843_cov_13.478495	381	461	6	11	80	0.1375000
NODE_10573_length_843_cov_13.478495	434	514	0	11	80	0.1375000
NODE_10573_length_843_cov_13.478495	434	514	4	5	80	0.0625000
NODE_10573_length_843_cov_13.478495	434	514	6	64	80	0.8000000
NODE_10574_length_843_cov_13.150538	448	528	0	80	80	1.0000000
NODE_10574_length_843_cov_13.150538	501	581	0	80	80	1.0000000
NODE_10575_length_843_cov_12.510753	360	440	0	80	80	1.0000000
NODE_10575_length_843_cov_12.510753	413	493	0	80	80	1.0000000
NODE_10576_length_843_cov_11.090054	457	537	0	80	80	1.0000000
NODE_10576_length_843_cov_11.090054	510	590	0	80	80	1.0000000
NODE_10577_length_843_cov_7.672043	472	552	0	80	80	1.0000000
NODE_10577_length_843_cov_7.672043	525	605	0	80	80	1.0000000
NODE_10601_length_842_cov_39.518170	390	470	0	80	80	1.0000000
NODE_10601_length_842_cov_39.518170	443	523	0	80	80	1.0000000
NODE_10602_length_842_cov_21.567968	331	411	0	47	80	0.5875000
NODE_10602_length_842_cov_21.567968	331	411	7	1	80	0.0125000
NODE_10602_length_842_cov_21.567968	331	411	8	32	80	0.4000000
NODE_10602_length_842_cov_21.567968	384	464	0	2	80	0.0250000
NODE_10602_length_842_cov_21.567968	384	464	8	78	80	0.9750000
NODE_10603_length_842_cov_19.761777	228	308	4	80	80	1.0000000
NODE_10603_length_842_cov_19.761777	281	361	0	9	80	0.1125000
NODE_10603_length_842_cov_19.761777	281	361	2	42	80	0.5250000
NODE_10603_length_842_cov_19.761777	281	361	4	29	80	0.3625000
NODE_10605_length_842_cov_8.703903	641	722	0	81	81	1.0000000
NODE_10608_length_842_cov_5.305518	287	367	0	80	80	1.0000000
NODE_10608_length_842_cov_5.305518	340	420	0	80	80	1.0000000
NODE_10617_length_842_cov_1.751009	35	66	0	31	31	1.0000000
NODE_10622_length_841_cov_23.815364	292	372	0	80	80	1.0000000
NODE_10622_length_841_cov_23.815364	345	425	0	80	80	1.0000000
NODE_10623_length_841_cov_18.871968	338	418	0	80	80	1.0000000
NODE_10623_length_841_cov_18.871968	391	471	0	80	80	1.0000000
NODE_10624_length_841_cov_14.663073	345	425	0	80	80	1.0000000
NODE_10624_length_841_cov_14.663073	398	478	0	80	80	1.0000000
NODE_10625_length_841_cov_14.149596	341	421	0	80	80	1.0000000
NODE_10625_length_841_cov_14.149596	394	474	0	80	80	1.0000000
NODE_10626_length_841_cov_12.452830	240	320	0	60	80	0.7500000
NODE_10626_length_841_cov_12.452830	240	320	4	20	80	0.2500000
NODE_10626_length_841_cov_12.452830	293	373	0	7	80	0.0875000
NODE_10626_length_841_cov_12.452830	293	373	4	73	80	0.9125000
NODE_10628_length_841_cov_9.925876	394	474	0	80	80	1.0000000
NODE_10628_length_841_cov_9.925876	447	527	0	80	80	1.0000000
NODE_10629_length_841_cov_7.407008	317	397	0	80	80	1.0000000
NODE_10629_length_841_cov_7.407008	370	450	0	80	80	1.0000000
NODE_10632_length_841_cov_3.865229	305	356	0	51	51	1.0000000
NODE_10651_length_840_cov_63.726046	461	541	0	80	80	1.0000000
NODE_10651_length_840_cov_63.726046	514	594	0	80	80	1.0000000
NODE_10652_length_840_cov_35.874494	486	566	0	80	80	1.0000000
NODE_10652_length_840_cov_35.874494	539	619	0	80	80	1.0000000
NODE_10653_length_840_cov_24.499325	224	304	0	80	80	1.0000000
NODE_10653_length_840_cov_24.499325	277	357	0	80	80	1.0000000
NODE_10653_length_840_cov_24.499325	353	433	0	80	80	1.0000000
NODE_10653_length_840_cov_24.499325	406	486	0	80	80	1.0000000
NODE_10654_length_840_cov_23.272605	309	389	0	80	80	1.0000000
NODE_10654_length_840_cov_23.272605	362	442	0	80	80	1.0000000
NODE_10655_length_840_cov_22.221323	293	373	0	46	80	0.5750000
NODE_10655_length_840_cov_22.221323	293	373	13	1	80	0.0125000
NODE_10655_length_840_cov_22.221323	293	373	14	33	80	0.4125000
NODE_10655_length_840_cov_22.221323	346	426	13	4	80	0.0500000
NODE_10655_length_840_cov_22.221323	346	426	14	76	80	0.9500000
NODE_10656_length_840_cov_17.026991	348	432	0	66	84	0.7857143
NODE_10656_length_840_cov_17.026991	348	432	2	18	84	0.2142857
NODE_10656_length_840_cov_17.026991	405	485	0	17	80	0.2125000
NODE_10656_length_840_cov_17.026991	405	485	2	63	80	0.7875000
NODE_10657_length_840_cov_16.635628	347	427	0	80	80	1.0000000
NODE_10657_length_840_cov_16.635628	400	480	0	80	80	1.0000000
NODE_10658_length_840_cov_12.133603	336	416	0	80	80	1.0000000
NODE_10658_length_840_cov_12.133603	389	469	0	80	80	1.0000000
NODE_10659_length_840_cov_12.041835	332	412	0	73	80	0.9125000
NODE_10659_length_840_cov_12.041835	332	412	2	7	80	0.0875000
NODE_10659_length_840_cov_12.041835	385	465	0	20	80	0.2500000
NODE_10659_length_840_cov_12.041835	385	465	2	60	80	0.7500000
NODE_10660_length_840_cov_10.719298	275	354	0	79	79	1.0000000
NODE_10660_length_840_cov_10.719298	327	407	0	80	80	1.0000000
NODE_10663_length_840_cov_5.207827	427	507	0	80	80	1.0000000
NODE_10663_length_840_cov_5.207827	480	560	0	80	80	1.0000000
NODE_10683_length_839_cov_274.987838	450	530	59	3	80	0.0375000
NODE_10683_length_839_cov_274.987838	450	530	61	1	80	0.0125000
NODE_10683_length_839_cov_274.987838	450	530	63	3	80	0.0375000
NODE_10683_length_839_cov_274.987838	450	530	65	2	80	0.0250000
NODE_10683_length_839_cov_274.987838	450	530	68	1	80	0.0125000
NODE_10683_length_839_cov_274.987838	450	530	70	3	80	0.0375000
NODE_10683_length_839_cov_274.987838	450	530	74	1	80	0.0125000
NODE_10683_length_839_cov_274.987838	450	530	75	2	80	0.0250000
NODE_10683_length_839_cov_274.987838	450	530	81	3	80	0.0375000
NODE_10683_length_839_cov_274.987838	450	530	84	2	80	0.0250000
NODE_10683_length_839_cov_274.987838	450	530	85	3	80	0.0375000
NODE_10683_length_839_cov_274.987838	450	530	87	2	80	0.0250000
NODE_10683_length_839_cov_274.987838	450	530	91	1	80	0.0125000
NODE_10683_length_839_cov_274.987838	450	530	96	2	80	0.0250000
NODE_10683_length_839_cov_274.987838	450	530	99	1	80	0.0125000
NODE_10683_length_839_cov_274.987838	450	530	105	2	80	0.0250000
NODE_10683_length_839_cov_274.987838	450	530	106	2	80	0.0250000
NODE_10683_length_839_cov_274.987838	450	530	108	1	80	0.0125000
NODE_10683_length_839_cov_274.987838	450	530	109	2	80	0.0250000
NODE_10683_length_839_cov_274.987838	450	530	111	7	80	0.0875000
NODE_10683_length_839_cov_274.987838	450	530	112	5	80	0.0625000
NODE_10683_length_839_cov_274.987838	450	530	118	3	80	0.0375000
NODE_10683_length_839_cov_274.987838	450	530	121	1	80	0.0125000
NODE_10683_length_839_cov_274.987838	450	530	124	1	80	0.0125000
NODE_10683_length_839_cov_274.987838	450	530	126	4	80	0.0500000
NODE_10683_length_839_cov_274.987838	450	530	127	2	80	0.0250000
NODE_10683_length_839_cov_274.987838	450	530	131	1	80	0.0125000
NODE_10683_length_839_cov_274.987838	450	530	133	2	80	0.0250000
NODE_10683_length_839_cov_274.987838	450	530	140	5	80	0.0625000
NODE_10683_length_839_cov_274.987838	450	530	141	1	80	0.0125000
NODE_10683_length_839_cov_274.987838	450	530	145	1	80	0.0125000
NODE_10683_length_839_cov_274.987838	450	530	146	2	80	0.0250000
NODE_10683_length_839_cov_274.987838	450	530	147	3	80	0.0375000
NODE_10683_length_839_cov_274.987838	450	530	148	4	80	0.0500000
NODE_10683_length_839_cov_274.987838	450	530	150	1	80	0.0125000
NODE_10683_length_839_cov_274.987838	503	583	124	1	80	0.0125000
NODE_10683_length_839_cov_274.987838	503	583	126	4	80	0.0500000
NODE_10683_length_839_cov_274.987838	503	583	127	2	80	0.0250000
NODE_10683_length_839_cov_274.987838	503	583	131	1	80	0.0125000
NODE_10683_length_839_cov_274.987838	503	583	133	2	80	0.0250000
NODE_10683_length_839_cov_274.987838	503	583	140	5	80	0.0625000
NODE_10683_length_839_cov_274.987838	503	583	141	1	80	0.0125000
NODE_10683_length_839_cov_274.987838	503	583	145	1	80	0.0125000
NODE_10683_length_839_cov_274.987838	503	583	146	2	80	0.0250000
NODE_10683_length_839_cov_274.987838	503	583	147	3	80	0.0375000
NODE_10683_length_839_cov_274.987838	503	583	148	4	80	0.0500000
NODE_10683_length_839_cov_274.987838	503	583	150	1	80	0.0125000
NODE_10683_length_839_cov_274.987838	503	583	152	1	80	0.0125000
NODE_10683_length_839_cov_274.987838	503	583	154	1	80	0.0125000
NODE_10683_length_839_cov_274.987838	503	583	159	1	80	0.0125000
NODE_10683_length_839_cov_274.987838	503	583	161	1	80	0.0125000
NODE_10683_length_839_cov_274.987838	503	583	165	2	80	0.0250000
NODE_10683_length_839_cov_274.987838	503	583	166	3	80	0.0375000
NODE_10683_length_839_cov_274.987838	503	583	167	1	80	0.0125000
NODE_10683_length_839_cov_274.987838	503	583	168	5	80	0.0625000
NODE_10683_length_839_cov_274.987838	503	583	170	2	80	0.0250000
NODE_10683_length_839_cov_274.987838	503	583	172	3	80	0.0375000
NODE_10683_length_839_cov_274.987838	503	583	173	3	80	0.0375000
NODE_10683_length_839_cov_274.987838	503	583	176	1	80	0.0125000
NODE_10683_length_839_cov_274.987838	503	583	180	2	80	0.0250000
NODE_10683_length_839_cov_274.987838	503	583	182	1	80	0.0125000
NODE_10683_length_839_cov_274.987838	503	583	183	1	80	0.0125000
NODE_10683_length_839_cov_274.987838	503	583	184	2	80	0.0250000
NODE_10683_length_839_cov_274.987838	503	583	186	1	80	0.0125000
NODE_10683_length_839_cov_274.987838	503	583	188	1	80	0.0125000
NODE_10683_length_839_cov_274.987838	503	583	190	2	80	0.0250000
NODE_10683_length_839_cov_274.987838	503	583	192	4	80	0.0500000
NODE_10683_length_839_cov_274.987838	503	583	193	2	80	0.0250000
NODE_10683_length_839_cov_274.987838	503	583	194	4	80	0.0500000
NODE_10683_length_839_cov_274.987838	503	583	195	2	80	0.0250000
NODE_10683_length_839_cov_274.987838	503	583	196	4	80	0.0500000
NODE_10683_length_839_cov_274.987838	503	583	197	1	80	0.0125000
NODE_10683_length_839_cov_274.987838	503	583	199	1	80	0.0125000
NODE_10683_length_839_cov_274.987838	503	583	200	1	80	0.0125000
NODE_10684_length_839_cov_24.500000	303	383	0	80	80	1.0000000
NODE_10684_length_839_cov_24.500000	356	436	0	80	80	1.0000000
NODE_10685_length_839_cov_16.390541	477	557	0	79	80	0.9875000
NODE_10685_length_839_cov_16.390541	477	557	2	1	80	0.0125000
NODE_10685_length_839_cov_16.390541	530	610	0	26	80	0.3250000
NODE_10685_length_839_cov_16.390541	530	610	2	54	80	0.6750000
NODE_10686_length_839_cov_10.006757	383	463	0	80	80	1.0000000
NODE_10686_length_839_cov_10.006757	436	516	0	80	80	1.0000000
NODE_10688_length_839_cov_7.612162	308	388	0	80	80	1.0000000
NODE_10688_length_839_cov_7.612162	361	441	0	80	80	1.0000000
NODE_10689_length_839_cov_6.693243	343	423	0	80	80	1.0000000
NODE_10706_length_838_cov_39.263870	383	463	2	21	80	0.2625000
NODE_10706_length_838_cov_39.263870	383	463	19	11	80	0.1375000
NODE_10706_length_838_cov_39.263870	383	463	20	48	80	0.6000000
NODE_10706_length_838_cov_39.263870	436	516	0	1	80	0.0125000
NODE_10706_length_838_cov_39.263870	436	516	1	13	80	0.1625000
NODE_10706_length_838_cov_39.263870	436	516	2	2	80	0.0250000
NODE_10706_length_838_cov_39.263870	436	516	19	48	80	0.6000000
NODE_10706_length_838_cov_39.263870	436	516	20	16	80	0.2000000
NODE_10707_length_838_cov_27.843031	473	553	0	80	80	1.0000000
NODE_10707_length_838_cov_27.843031	526	606	0	80	80	1.0000000
NODE_10708_length_838_cov_27.238160	432	512	0	80	80	1.0000000
NODE_10708_length_838_cov_27.238160	485	565	0	80	80	1.0000000
NODE_10709_length_838_cov_22.691475	380	460	0	13	80	0.1625000
NODE_10709_length_838_cov_22.691475	380	460	2	67	80	0.8375000
NODE_10709_length_838_cov_22.691475	433	513	0	35	80	0.4375000
NODE_10709_length_838_cov_22.691475	433	513	2	45	80	0.5625000
NODE_10710_length_838_cov_16.169147	312	392	0	52	80	0.6500000
NODE_10710_length_838_cov_16.169147	312	392	4	28	80	0.3500000
NODE_10710_length_838_cov_16.169147	365	445	0	4	80	0.0500000
NODE_10710_length_838_cov_16.169147	365	445	4	76	80	0.9500000
NODE_10711_length_838_cov_15.753721	328	408	0	80	80	1.0000000
NODE_10711_length_838_cov_15.753721	381	461	0	80	80	1.0000000
NODE_10712_length_838_cov_15.514208	294	374	0	80	80	1.0000000
NODE_10712_length_838_cov_15.514208	347	427	0	80	80	1.0000000
NODE_10713_length_838_cov_7.733424	350	430	0	80	80	1.0000000
NODE_10713_length_838_cov_7.733424	403	483	0	80	80	1.0000000
NODE_10716_length_838_cov_4.511502	131	213	0	61	82	0.7439024
NODE_10716_length_838_cov_4.511502	131	213	6	21	82	0.2560976
NODE_10716_length_838_cov_4.511502	184	252	0	68	68	1.0000000
NODE_10722_length_838_cov_2.247632	359	405	0	46	46	1.0000000
NODE_10727_length_838_cov_1.843031	732	752	0	20	20	1.0000000
NODE_10740_length_837_cov_32.691057	401	481	0	80	80	1.0000000
NODE_10740_length_837_cov_32.691057	454	534	0	80	80	1.0000000
NODE_10741_length_837_cov_30.995935	399	479	0	71	80	0.8875000
NODE_10741_length_837_cov_30.995935	399	479	5	1	80	0.0125000
NODE_10741_length_837_cov_30.995935	399	479	6	8	80	0.1000000
NODE_10741_length_837_cov_30.995935	452	532	0	18	80	0.2250000
NODE_10741_length_837_cov_30.995935	452	532	5	1	80	0.0125000
NODE_10741_length_837_cov_30.995935	452	532	6	21	80	0.2625000
NODE_10741_length_837_cov_30.995935	452	532	12	1	80	0.0125000
NODE_10741_length_837_cov_30.995935	452	532	14	39	80	0.4875000
NODE_10742_length_837_cov_30.883469	278	358	0	80	80	1.0000000
NODE_10742_length_837_cov_30.883469	331	411	0	34	80	0.4250000
NODE_10742_length_837_cov_30.883469	331	411	3	25	80	0.3125000
NODE_10742_length_837_cov_30.883469	331	411	6	21	80	0.2625000
NODE_10742_length_837_cov_30.883469	407	487	6	80	80	1.0000000
NODE_10742_length_837_cov_30.883469	460	540	3	25	80	0.3125000
NODE_10742_length_837_cov_30.883469	460	540	6	55	80	0.6875000
NODE_10743_length_837_cov_14.573171	205	280	0	75	75	1.0000000
NODE_10743_length_837_cov_14.573171	258	337	0	79	79	1.0000000
NODE_10743_length_837_cov_14.573171	333	413	0	80	80	1.0000000
NODE_10743_length_837_cov_14.573171	386	466	0	80	80	1.0000000
NODE_10744_length_837_cov_12.582656	226	306	0	80	80	1.0000000
NODE_10744_length_837_cov_12.582656	279	359	0	80	80	1.0000000
NODE_10745_length_837_cov_6.998645	389	474	0	85	85	1.0000000
NODE_10745_length_837_cov_6.998645	447	527	0	80	80	1.0000000
NODE_10750_length_837_cov_3.119241	373	453	0	80	80	1.0000000
NODE_10750_length_837_cov_3.119241	426	506	0	80	80	1.0000000
NODE_10769_length_836_cov_40.141113	224	304	0	80	80	1.0000000
NODE_10769_length_836_cov_40.141113	277	357	0	80	80	1.0000000
NODE_10769_length_836_cov_40.141113	353	433	0	80	80	1.0000000
NODE_10769_length_836_cov_40.141113	406	486	0	80	80	1.0000000
NODE_10770_length_836_cov_27.610583	344	424	0	80	80	1.0000000
NODE_10770_length_836_cov_27.610583	397	477	0	80	80	1.0000000
NODE_10771_length_836_cov_15.719132	295	375	0	80	80	1.0000000
NODE_10771_length_836_cov_15.719132	348	428	0	80	80	1.0000000
NODE_10772_length_836_cov_9.309362	295	375	0	80	80	1.0000000
NODE_10772_length_836_cov_9.309362	348	428	0	80	80	1.0000000
NODE_10773_length_836_cov_6.283582	336	416	0	46	80	0.5750000
NODE_10773_length_836_cov_6.283582	336	416	2	34	80	0.4250000
NODE_10773_length_836_cov_6.283582	389	469	2	80	80	1.0000000
NODE_10774_length_836_cov_4.979647	371	451	0	80	80	1.0000000
NODE_10774_length_836_cov_4.979647	424	504	0	80	80	1.0000000
NODE_10787_length_835_cov_61.033967	253	333	0	80	80	1.0000000
NODE_10787_length_835_cov_61.033967	306	386	0	80	80	1.0000000
NODE_10788_length_835_cov_32.380435	390	470	0	8	80	0.1000000
NODE_10788_length_835_cov_32.380435	390	470	2	72	80	0.9000000
NODE_10788_length_835_cov_32.380435	443	523	0	43	80	0.5375000
NODE_10788_length_835_cov_32.380435	443	523	2	37	80	0.4625000
NODE_10789_length_835_cov_20.779891	415	495	0	80	80	1.0000000
NODE_10789_length_835_cov_20.779891	468	548	0	80	80	1.0000000
NODE_10808_length_835_cov_1.694293	18	80	0	62	62	1.0000000
NODE_10820_length_834_cov_13.689796	213	293	0	80	80	1.0000000
NODE_10820_length_834_cov_13.689796	266	346	0	80	80	1.0000000
NODE_10822_length_834_cov_12.609524	406	486	0	45	80	0.5625000
NODE_10822_length_834_cov_12.609524	406	486	1	35	80	0.4375000
NODE_10822_length_834_cov_12.609524	459	539	0	80	80	1.0000000
NODE_10823_length_834_cov_11.492517	248	328	2	42	80	0.5250000
NODE_10823_length_834_cov_11.492517	248	328	5	7	80	0.0875000
NODE_10823_length_834_cov_11.492517	248	328	6	31	80	0.3875000
NODE_10823_length_834_cov_11.492517	301	381	2	80	80	1.0000000
NODE_10824_length_834_cov_9.957823	212	292	0	80	80	1.0000000
NODE_10824_length_834_cov_9.957823	265	345	0	80	80	1.0000000
NODE_10825_length_834_cov_6.448980	482	546	0	64	64	1.0000000
NODE_10833_length_834_cov_2.658503	589	641	0	32	52	0.6153846
NODE_10833_length_834_cov_2.658503	589	641	2	20	52	0.3846154
NODE_10846_length_833_cov_57.702997	338	418	0	80	80	1.0000000
NODE_10846_length_833_cov_57.702997	391	471	0	80	80	1.0000000
NODE_10847_length_833_cov_38.153951	364	444	0	80	80	1.0000000
NODE_10847_length_833_cov_38.153951	417	497	0	80	80	1.0000000
NODE_10848_length_833_cov_34.302452	368	448	0	80	80	1.0000000
NODE_10848_length_833_cov_34.302452	421	501	0	80	80	1.0000000
NODE_10849_length_833_cov_20.452316	311	392	0	81	81	1.0000000
NODE_10849_length_833_cov_20.452316	365	445	0	80	80	1.0000000
NODE_10850_length_833_cov_16.643052	238	318	0	80	80	1.0000000
NODE_10851_length_833_cov_16.536785	84	164	0	18	80	0.2250000
NODE_10851_length_833_cov_16.536785	84	164	4	62	80	0.7750000
NODE_10851_length_833_cov_16.536785	137	217	0	71	80	0.8875000
NODE_10851_length_833_cov_16.536785	137	217	4	9	80	0.1125000
NODE_10865_length_833_cov_3.089918	467	547	0	80	80	1.0000000
NODE_10865_length_833_cov_3.089918	520	600	0	80	80	1.0000000
NODE_10891_length_832_cov_35.728513	460	540	0	80	80	1.0000000
NODE_10891_length_832_cov_35.728513	513	593	0	80	80	1.0000000
NODE_10892_length_832_cov_25.450205	292	372	0	80	80	1.0000000
NODE_10892_length_832_cov_25.450205	345	425	0	80	80	1.0000000
NODE_10893_length_832_cov_18.858117	428	508	0	2	80	0.0250000
NODE_10893_length_832_cov_18.858117	428	508	2	31	80	0.3875000
NODE_10893_length_832_cov_18.858117	428	508	9	13	80	0.1625000
NODE_10893_length_832_cov_18.858117	428	508	10	34	80	0.4250000
NODE_10893_length_832_cov_18.858117	481	561	7	39	80	0.4875000
NODE_10893_length_832_cov_18.858117	481	561	9	27	80	0.3375000
NODE_10893_length_832_cov_18.858117	481	561	10	14	80	0.1750000
NODE_10894_length_832_cov_17.799454	314	394	0	44	80	0.5500000
NODE_10894_length_832_cov_17.799454	314	394	2	1	80	0.0125000
NODE_10894_length_832_cov_17.799454	314	394	4	35	80	0.4375000
NODE_10894_length_832_cov_17.799454	367	447	4	80	80	1.0000000
NODE_10895_length_832_cov_14.811733	353	433	0	14	80	0.1750000
NODE_10895_length_832_cov_14.811733	353	433	2	66	80	0.8250000
NODE_10896_length_832_cov_14.770805	259	339	0	80	80	1.0000000
NODE_10896_length_832_cov_14.770805	312	392	0	45	80	0.5625000
NODE_10896_length_832_cov_14.770805	312	392	2	5	80	0.0625000
NODE_10896_length_832_cov_14.770805	312	392	4	30	80	0.3750000
NODE_10897_length_832_cov_8.305593	266	346	0	80	80	1.0000000
NODE_10897_length_832_cov_8.305593	319	399	0	80	80	1.0000000
NODE_10918_length_831_cov_18.403005	371	451	0	80	80	1.0000000
NODE_10918_length_831_cov_18.403005	424	504	0	80	80	1.0000000
NODE_10919_length_831_cov_16.017760	357	437	0	80	80	1.0000000
NODE_10919_length_831_cov_16.017760	410	490	0	80	80	1.0000000
NODE_10920_length_831_cov_13.740437	405	485	0	80	80	1.0000000
NODE_10920_length_831_cov_13.740437	458	538	0	80	80	1.0000000
NODE_10921_length_831_cov_9.595628	281	361	0	80	80	1.0000000
NODE_10921_length_831_cov_9.595628	334	414	0	80	80	1.0000000
NODE_10922_length_831_cov_8.199454	433	482	0	49	49	1.0000000
NODE_10923_length_831_cov_7.607923	216	296	0	53	80	0.6625000
NODE_10923_length_831_cov_7.607923	216	296	1	5	80	0.0625000
NODE_10923_length_831_cov_7.607923	216	296	2	22	80	0.2750000
NODE_10923_length_831_cov_7.607923	269	349	1	5	80	0.0625000
NODE_10923_length_831_cov_7.607923	269	349	2	75	80	0.9375000
NODE_10924_length_831_cov_6.454918	334	409	0	75	75	1.0000000
NODE_10924_length_831_cov_6.454918	382	462	0	51	80	0.6375000
NODE_10924_length_831_cov_6.454918	382	462	4	29	80	0.3625000
NODE_10960_length_830_cov_40.856361	238	318	0	80	80	1.0000000
NODE_10960_length_830_cov_40.856361	291	371	0	44	80	0.5500000
NODE_10960_length_830_cov_40.856361	291	371	2	36	80	0.4500000
NODE_10961_length_830_cov_32.170999	302	378	0	76	76	1.0000000
NODE_10961_length_830_cov_32.170999	303	383	0	80	80	1.0000000
NODE_10961_length_830_cov_32.170999	356	436	0	80	80	1.0000000
NODE_10962_length_830_cov_28.041040	393	473	0	80	80	1.0000000
NODE_10962_length_830_cov_28.041040	446	526	0	80	80	1.0000000
NODE_10963_length_830_cov_20.280438	360	440	0	80	80	1.0000000
NODE_10963_length_830_cov_20.280438	413	492	0	79	79	1.0000000
NODE_10964_length_830_cov_19.495212	274	354	0	16	80	0.2000000
NODE_10964_length_830_cov_19.495212	274	354	5	64	80	0.8000000
NODE_10964_length_830_cov_19.495212	327	407	0	10	80	0.1250000
NODE_10964_length_830_cov_19.495212	327	407	5	27	80	0.3375000
NODE_10964_length_830_cov_19.495212	327	407	6	43	80	0.5375000
NODE_10965_length_830_cov_18.522572	368	448	0	40	80	0.5000000
NODE_10965_length_830_cov_18.522572	368	448	2	40	80	0.5000000
NODE_10965_length_830_cov_18.522572	421	501	0	32	80	0.4000000
NODE_10965_length_830_cov_18.522572	421	501	2	48	80	0.6000000
NODE_10966_length_830_cov_13.830369	278	358	0	80	80	1.0000000
NODE_10966_length_830_cov_13.830369	331	411	0	80	80	1.0000000
NODE_10967_length_830_cov_12.459644	201	281	0	80	80	1.0000000
NODE_10967_length_830_cov_12.459644	254	334	0	80	80	1.0000000
NODE_10968_length_830_cov_8.344733	450	530	0	80	80	1.0000000
NODE_10968_length_830_cov_8.344733	503	583	0	80	80	1.0000000
NODE_10969_length_830_cov_8.227086	634	714	0	80	80	1.0000000
NODE_10969_length_830_cov_8.227086	687	767	0	80	80	1.0000000
NODE_10995_length_829_cov_74.910959	271	351	0	80	80	1.0000000
NODE_10995_length_829_cov_74.910959	324	404	0	80	80	1.0000000
NODE_10996_length_829_cov_34.068493	302	382	0	80	80	1.0000000
NODE_10996_length_829_cov_34.068493	355	435	0	80	80	1.0000000
NODE_10997_length_829_cov_24.027397	441	521	0	40	80	0.5000000
NODE_10997_length_829_cov_24.027397	441	521	4	40	80	0.5000000
NODE_10997_length_829_cov_24.027397	494	574	0	11	80	0.1375000
NODE_10997_length_829_cov_24.027397	494	574	4	69	80	0.8625000
NODE_10998_length_829_cov_21.735616	420	500	0	80	80	1.0000000
NODE_10998_length_829_cov_21.735616	473	553	0	80	80	1.0000000
NODE_10999_length_829_cov_18.446575	407	487	0	80	80	1.0000000
NODE_10999_length_829_cov_18.446575	460	540	0	80	80	1.0000000
NODE_11000_length_829_cov_10.971233	368	448	0	80	80	1.0000000
NODE_11000_length_829_cov_10.971233	421	501	0	80	80	1.0000000
NODE_11001_length_829_cov_10.035616	387	467	0	9	80	0.1125000
NODE_11001_length_829_cov_10.035616	387	467	2	71	80	0.8875000
NODE_11001_length_829_cov_10.035616	440	520	0	40	80	0.5000000
NODE_11001_length_829_cov_10.035616	440	520	2	40	80	0.5000000
NODE_11002_length_829_cov_9.906849	326	406	0	80	80	1.0000000
NODE_11002_length_829_cov_9.906849	379	459	0	80	80	1.0000000
NODE_11003_length_829_cov_8.809589	450	530	0	80	80	1.0000000
NODE_11003_length_829_cov_8.809589	503	583	0	80	80	1.0000000
NODE_11006_length_829_cov_4.310959	473	553	0	80	80	1.0000000
NODE_11006_length_829_cov_4.310959	526	606	0	80	80	1.0000000
NODE_11008_length_829_cov_3.079452	507	587	0	80	80	1.0000000
NODE_11008_length_829_cov_3.079452	507	587	0	80	80	1.0000000
NODE_11008_length_829_cov_3.079452	560	640	0	80	80	1.0000000
NODE_11025_length_828_cov_41.116598	436	516	0	80	80	1.0000000
NODE_11025_length_828_cov_41.116598	489	569	0	46	80	0.5750000
NODE_11025_length_828_cov_41.116598	489	569	2	34	80	0.4250000
NODE_11026_length_828_cov_36.459534	372	452	0	80	80	1.0000000
NODE_11026_length_828_cov_36.459534	425	505	0	80	80	1.0000000
NODE_11027_length_828_cov_33.515775	443	523	0	80	80	1.0000000
NODE_11027_length_828_cov_33.515775	496	576	0	80	80	1.0000000
NODE_11028_length_828_cov_21.123457	380	460	2	80	80	1.0000000
NODE_11028_length_828_cov_21.123457	433	513	0	34	80	0.4250000
NODE_11028_length_828_cov_21.123457	433	513	2	46	80	0.5750000
NODE_11029_length_828_cov_17.406036	304	392	0	74	88	0.8409091
NODE_11029_length_828_cov_17.406036	304	392	2	14	88	0.1590909
NODE_11029_length_828_cov_17.406036	369	445	0	76	76	1.0000000
NODE_11030_length_828_cov_14.606310	287	367	0	80	80	1.0000000
NODE_11030_length_828_cov_14.606310	340	420	0	80	80	1.0000000
NODE_11031_length_828_cov_14.493827	326	406	0	80	80	1.0000000
NODE_11031_length_828_cov_14.493827	379	459	0	80	80	1.0000000
NODE_11031_length_828_cov_14.493827	455	535	0	80	80	1.0000000
NODE_11031_length_828_cov_14.493827	508	588	0	80	80	1.0000000
NODE_11032_length_828_cov_10.550069	280	360	0	80	80	1.0000000
NODE_11032_length_828_cov_10.550069	333	413	0	80	80	1.0000000
NODE_11033_length_828_cov_9.292181	594	674	0	80	80	1.0000000
NODE_11033_length_828_cov_9.292181	647	727	0	80	80	1.0000000
NODE_11034_length_828_cov_8.747599	298	378	0	62	80	0.7750000
NODE_11034_length_828_cov_8.747599	298	378	2	18	80	0.2250000
NODE_11034_length_828_cov_8.747599	351	431	0	9	80	0.1125000
NODE_11034_length_828_cov_8.747599	351	431	2	71	80	0.8875000
NODE_11035_length_828_cov_8.098765	199	279	0	80	80	1.0000000
NODE_11035_length_828_cov_8.098765	252	332	0	80	80	1.0000000
NODE_11037_length_828_cov_7.473251	300	380	0	80	80	1.0000000
NODE_11037_length_828_cov_7.473251	353	433	0	80	80	1.0000000
NODE_11039_length_828_cov_5.481481	543	623	0	80	80	1.0000000
NODE_11039_length_828_cov_5.481481	596	676	0	80	80	1.0000000
NODE_11041_length_828_cov_5.069959	259	339	0	80	80	1.0000000
NODE_11066_length_827_cov_34.567308	269	349	0	80	80	1.0000000
NODE_11066_length_827_cov_34.567308	322	402	0	80	80	1.0000000
NODE_11066_length_827_cov_34.567308	398	478	0	80	80	1.0000000
NODE_11066_length_827_cov_34.567308	451	531	0	80	80	1.0000000
NODE_11067_length_827_cov_31.538462	320	400	0	80	80	1.0000000
NODE_11067_length_827_cov_31.538462	373	453	0	80	80	1.0000000
NODE_11068_length_827_cov_19.548077	464	544	0	30	80	0.3750000
NODE_11068_length_827_cov_19.548077	464	544	12	50	80	0.6250000
NODE_11068_length_827_cov_19.548077	517	597	0	80	80	1.0000000
NODE_11069_length_827_cov_17.490385	320	400	0	80	80	1.0000000
NODE_11069_length_827_cov_17.490385	373	453	0	80	80	1.0000000
NODE_11070_length_827_cov_15.247253	205	285	0	80	80	1.0000000
NODE_11070_length_827_cov_15.247253	258	338	0	80	80	1.0000000
NODE_11071_length_827_cov_14.151099	372	452	0	80	80	1.0000000
NODE_11071_length_827_cov_14.151099	425	505	0	80	80	1.0000000
NODE_11072_length_827_cov_12.157967	262	342	0	80	80	1.0000000
NODE_11072_length_827_cov_12.157967	315	395	0	80	80	1.0000000
NODE_11073_length_827_cov_11.777473	316	396	0	80	80	1.0000000
NODE_11073_length_827_cov_11.777473	369	449	0	80	80	1.0000000
NODE_11074_length_827_cov_11.651099	393	473	0	40	80	0.5000000
NODE_11074_length_827_cov_11.651099	393	473	2	19	80	0.2375000
NODE_11074_length_827_cov_11.651099	393	473	4	21	80	0.2625000
NODE_11074_length_827_cov_11.651099	446	526	0	80	80	1.0000000
NODE_11075_length_827_cov_10.711538	286	366	0	80	80	1.0000000
NODE_11075_length_827_cov_10.711538	339	419	0	80	80	1.0000000
NODE_11076_length_827_cov_10.262363	273	353	0	80	80	1.0000000
NODE_11076_length_827_cov_10.262363	326	406	0	80	80	1.0000000
NODE_11077_length_827_cov_10.221154	256	336	9	8	80	0.1000000
NODE_11077_length_827_cov_10.221154	256	336	11	5	80	0.0625000
NODE_11077_length_827_cov_10.221154	256	336	13	5	80	0.0625000
NODE_11077_length_827_cov_10.221154	256	336	14	34	80	0.4250000
NODE_11077_length_827_cov_10.221154	256	336	15	8	80	0.1000000
NODE_11077_length_827_cov_10.221154	256	336	19	1	80	0.0125000
NODE_11077_length_827_cov_10.221154	256	336	20	19	80	0.2375000
NODE_11078_length_827_cov_9.576923	359	439	0	8	80	0.1000000
NODE_11078_length_827_cov_9.576923	359	439	8	72	80	0.9000000
NODE_11078_length_827_cov_9.576923	412	492	0	61	80	0.7625000
NODE_11078_length_827_cov_9.576923	412	492	8	19	80	0.2375000
NODE_11079_length_827_cov_8.780220	361	441	0	80	80	1.0000000
NODE_11079_length_827_cov_8.780220	414	494	0	80	80	1.0000000
NODE_11093_length_827_cov_1.412088	736	784	10	48	48	1.0000000
NODE_11106_length_826_cov_34.026135	211	291	0	80	80	1.0000000
NODE_11106_length_826_cov_34.026135	264	344	0	80	80	1.0000000
NODE_11107_length_826_cov_24.093535	282	362	0	80	80	1.0000000
NODE_11107_length_826_cov_24.093535	335	415	0	80	80	1.0000000
NODE_11108_length_826_cov_20.943604	207	287	0	80	80	1.0000000
NODE_11108_length_826_cov_20.943604	260	340	0	80	80	1.0000000
NODE_11109_length_826_cov_20.437414	413	493	0	27	80	0.3375000
NODE_11109_length_826_cov_20.437414	413	493	7	27	80	0.3375000
NODE_11109_length_826_cov_20.437414	413	493	8	26	80	0.3250000
NODE_11109_length_826_cov_20.437414	466	546	0	14	80	0.1750000
NODE_11109_length_826_cov_20.437414	466	546	7	1	80	0.0125000
NODE_11109_length_826_cov_20.437414	466	546	8	65	80	0.8125000
NODE_11110_length_826_cov_20.200825	432	512	0	80	80	1.0000000
NODE_11110_length_826_cov_20.200825	485	565	0	80	80	1.0000000
NODE_11111_length_826_cov_18.489684	345	425	0	80	80	1.0000000
NODE_11111_length_826_cov_18.489684	398	478	0	80	80	1.0000000
NODE_11112_length_826_cov_17.998624	336	416	0	80	80	1.0000000
NODE_11112_length_826_cov_17.998624	389	469	0	80	80	1.0000000
NODE_11113_length_826_cov_17.038514	358	438	0	80	80	1.0000000
NODE_11113_length_826_cov_17.038514	411	491	0	80	80	1.0000000
NODE_11114_length_826_cov_16.777166	514	603	0	89	89	1.0000000
NODE_11115_length_826_cov_16.177442	361	441	0	80	80	1.0000000
NODE_11115_length_826_cov_16.177442	414	494	0	80	80	1.0000000
NODE_11116_length_826_cov_15.134801	346	426	0	80	80	1.0000000
NODE_11116_length_826_cov_15.134801	399	479	0	80	80	1.0000000
NODE_11117_length_826_cov_9.943604	320	400	0	80	80	1.0000000
NODE_11117_length_826_cov_9.943604	373	453	0	80	80	1.0000000
NODE_11120_length_826_cov_4.852820	501	579	0	25	78	0.3205128
NODE_11120_length_826_cov_4.852820	501	579	4	53	78	0.6794872
NODE_11120_length_826_cov_4.852820	552	632	0	19	80	0.2375000
NODE_11120_length_826_cov_4.852820	552	632	4	61	80	0.7625000
NODE_11161_length_825_cov_61.804408	382	462	0	80	80	1.0000000
NODE_11161_length_825_cov_61.804408	435	514	0	27	79	0.3417721
NODE_11161_length_825_cov_61.804408	435	514	2	52	79	0.6582279
NODE_11162_length_825_cov_43.825069	488	568	0	18	80	0.2250000
NODE_11162_length_825_cov_43.825069	488	568	6	62	80	0.7750000
NODE_11162_length_825_cov_43.825069	541	621	0	71	80	0.8875000
NODE_11162_length_825_cov_43.825069	541	621	6	9	80	0.1125000
NODE_11162_length_825_cov_43.825069	617	697	0	80	80	1.0000000
NODE_11162_length_825_cov_43.825069	670	750	0	80	80	1.0000000
NODE_11163_length_825_cov_43.389807	496	576	0	80	80	1.0000000
NODE_11163_length_825_cov_43.389807	549	629	0	80	80	1.0000000
NODE_11164_length_825_cov_39.603306	386	466	0	46	80	0.5750000
NODE_11164_length_825_cov_39.603306	386	466	8	34	80	0.4250000
NODE_11164_length_825_cov_39.603306	439	519	0	2	80	0.0250000
NODE_11164_length_825_cov_39.603306	439	519	8	78	80	0.9750000
NODE_11165_length_825_cov_32.205234	354	434	0	80	80	1.0000000
NODE_11165_length_825_cov_32.205234	407	487	0	80	80	1.0000000
NODE_11166_length_825_cov_29.411846	503	583	0	80	80	1.0000000
NODE_11166_length_825_cov_29.411846	556	636	0	80	80	1.0000000
NODE_11167_length_825_cov_22.428375	312	392	0	20	80	0.2500000
NODE_11167_length_825_cov_22.428375	312	392	2	14	80	0.1750000
NODE_11167_length_825_cov_22.428375	312	392	4	46	80	0.5750000
NODE_11167_length_825_cov_22.428375	365	445	0	1	80	0.0125000
NODE_11167_length_825_cov_22.428375	365	445	2	7	80	0.0875000
NODE_11167_length_825_cov_22.428375	365	445	4	64	80	0.8000000
NODE_11167_length_825_cov_22.428375	365	445	6	8	80	0.1000000
NODE_11167_length_825_cov_22.428375	441	521	6	80	80	1.0000000
NODE_11167_length_825_cov_22.428375	494	574	0	7	80	0.0875000
NODE_11167_length_825_cov_22.428375	494	574	2	1	80	0.0125000
NODE_11167_length_825_cov_22.428375	494	574	6	72	80	0.9000000
NODE_11168_length_825_cov_19.964187	249	329	0	80	80	1.0000000
NODE_11168_length_825_cov_19.964187	302	382	0	80	80	1.0000000
NODE_11169_length_825_cov_13.790634	273	353	0	80	80	1.0000000
NODE_11169_length_825_cov_13.790634	326	406	0	80	80	1.0000000
NODE_11170_length_825_cov_11.834711	331	411	0	80	80	1.0000000
NODE_11170_length_825_cov_11.834711	384	464	0	80	80	1.0000000
NODE_11171_length_825_cov_11.477961	392	472	0	19	80	0.2375000
NODE_11171_length_825_cov_11.477961	392	472	4	61	80	0.7625000
NODE_11172_length_825_cov_8.947658	259	339	4	80	80	1.0000000
NODE_11172_length_825_cov_8.947658	312	392	0	46	80	0.5750000
NODE_11172_length_825_cov_8.947658	312	392	4	34	80	0.4250000
NODE_11173_length_825_cov_7.811295	379	459	0	80	80	1.0000000
NODE_11173_length_825_cov_7.811295	432	512	0	80	80	1.0000000
NODE_11174_length_825_cov_7.104683	464	544	0	80	80	1.0000000
NODE_11174_length_825_cov_7.104683	517	597	0	80	80	1.0000000
NODE_11176_length_825_cov_6.252066	542	622	0	31	80	0.3875000
NODE_11176_length_825_cov_6.252066	542	622	1	15	80	0.1875000
NODE_11176_length_825_cov_6.252066	542	622	2	34	80	0.4250000
NODE_11176_length_825_cov_6.252066	595	675	2	80	80	1.0000000
NODE_11178_length_825_cov_5.230028	264	344	0	80	80	1.0000000
NODE_11178_length_825_cov_5.230028	317	372	0	55	55	1.0000000
NODE_11178_length_825_cov_5.230028	383	463	0	80	80	1.0000000
NODE_11178_length_825_cov_5.230028	436	516	0	80	80	1.0000000
NODE_11205_length_825_cov_0.765840	0	50	0	50	50	1.0000000
NODE_11207_length_824_cov_27.074483	337	412	0	75	75	1.0000000
NODE_11207_length_824_cov_27.074483	390	470	0	80	80	1.0000000
NODE_11208_length_824_cov_23.936552	365	445	0	27	80	0.3375000
NODE_11208_length_824_cov_23.936552	365	445	4	53	80	0.6625000
NODE_11208_length_824_cov_23.936552	418	493	0	75	75	1.0000000
NODE_11209_length_824_cov_22.129655	377	457	0	36	80	0.4500000
NODE_11209_length_824_cov_22.129655	377	457	4	44	80	0.5500000
NODE_11209_length_824_cov_22.129655	430	510	0	19	80	0.2375000
NODE_11209_length_824_cov_22.129655	430	510	4	61	80	0.7625000
NODE_11210_length_824_cov_17.914483	387	467	0	80	80	1.0000000
NODE_11210_length_824_cov_17.914483	440	520	0	80	80	1.0000000
NODE_11211_length_824_cov_16.662069	362	442	0	25	80	0.3125000
NODE_11211_length_824_cov_16.662069	362	442	4	55	80	0.6875000
NODE_11211_length_824_cov_16.662069	415	495	0	78	80	0.9750000
NODE_11211_length_824_cov_16.662069	415	495	4	2	80	0.0250000
NODE_11212_length_824_cov_16.306207	352	432	1	80	80	1.0000000
NODE_11212_length_824_cov_16.306207	405	485	0	21	80	0.2625000
NODE_11212_length_824_cov_16.306207	405	485	1	59	80	0.7375000
NODE_11213_length_824_cov_15.891034	342	422	0	80	80	1.0000000
NODE_11213_length_824_cov_15.891034	395	475	0	80	80	1.0000000
NODE_11214_length_824_cov_12.485517	280	360	0	22	80	0.2750000
NODE_11214_length_824_cov_12.485517	280	360	2	58	80	0.7250000
NODE_11214_length_824_cov_12.485517	333	413	0	14	80	0.1750000
NODE_11214_length_824_cov_12.485517	333	413	2	66	80	0.8250000
NODE_11216_length_824_cov_5.924138	269	349	2	80	80	1.0000000
NODE_11216_length_824_cov_5.924138	322	402	0	6	80	0.0750000
NODE_11216_length_824_cov_5.924138	322	402	1	1	80	0.0125000
NODE_11216_length_824_cov_5.924138	322	402	2	73	80	0.9125000
NODE_11222_length_824_cov_3.849655	191	271	0	80	80	1.0000000
NODE_11251_length_823_cov_75.169890	207	287	0	27	80	0.3375000
NODE_11251_length_823_cov_75.169890	207	287	2	27	80	0.3375000
NODE_11251_length_823_cov_75.169890	207	287	3	26	80	0.3250000
NODE_11251_length_823_cov_75.169890	260	340	0	80	80	1.0000000
NODE_11251_length_823_cov_75.169890	336	416	0	61	80	0.7625000
NODE_11251_length_823_cov_75.169890	336	416	1	19	80	0.2375000
NODE_11251_length_823_cov_75.169890	389	469	0	8	80	0.1000000
NODE_11251_length_823_cov_75.169890	389	469	1	38	80	0.4750000
NODE_11251_length_823_cov_75.169890	389	469	2	34	80	0.4250000
NODE_11253_length_823_cov_37.738950	332	412	0	23	80	0.2875000
NODE_11253_length_823_cov_37.738950	332	412	4	57	80	0.7125000
NODE_11253_length_823_cov_37.738950	385	466	0	40	81	0.4938272
NODE_11253_length_823_cov_37.738950	385	466	4	41	81	0.5061728
NODE_11254_length_823_cov_29.349448	400	480	0	80	80	1.0000000
NODE_11254_length_823_cov_29.349448	453	533	0	80	80	1.0000000
NODE_11255_length_823_cov_25.730663	338	418	0	80	80	1.0000000
NODE_11255_length_823_cov_25.730663	391	471	0	80	80	1.0000000
NODE_11256_length_823_cov_24.599448	349	429	0	80	80	1.0000000
NODE_11256_length_823_cov_24.599448	402	482	0	80	80	1.0000000
NODE_11257_length_823_cov_22.149171	356	436	0	80	80	1.0000000
NODE_11257_length_823_cov_22.149171	409	489	0	80	80	1.0000000
NODE_11257_length_823_cov_22.149171	485	565	0	80	80	1.0000000
NODE_11257_length_823_cov_22.149171	538	618	0	80	80	1.0000000
NODE_11258_length_823_cov_20.892265	329	409	0	80	80	1.0000000
NODE_11258_length_823_cov_20.892265	382	462	0	80	80	1.0000000
NODE_11259_length_823_cov_19.281768	305	385	0	80	80	1.0000000
NODE_11259_length_823_cov_19.281768	358	438	0	80	80	1.0000000
NODE_11260_length_823_cov_15.738950	409	489	0	80	80	1.0000000
NODE_11260_length_823_cov_15.738950	462	542	0	80	80	1.0000000
NODE_11261_length_823_cov_10.729282	362	437	0	75	75	1.0000000
NODE_11261_length_823_cov_10.729282	410	484	0	74	74	1.0000000
NODE_11262_length_823_cov_9.110497	394	474	0	80	80	1.0000000
NODE_11262_length_823_cov_9.110497	447	527	0	80	80	1.0000000
NODE_11265_length_823_cov_5.511050	168	248	0	14	80	0.1750000
NODE_11265_length_823_cov_5.511050	168	248	3	21	80	0.2625000
NODE_11265_length_823_cov_5.511050	168	248	4	45	80	0.5625000
NODE_11265_length_823_cov_5.511050	434	485	0	51	51	1.0000000
NODE_11292_length_823_cov_0.968232	86	154	4	9	68	0.1323529
NODE_11292_length_823_cov_0.968232	86	154	6	30	68	0.4411765
NODE_11292_length_823_cov_0.968232	86	154	8	29	68	0.4264706
NODE_11298_length_822_cov_25.423237	377	459	0	82	82	1.0000000
NODE_11298_length_822_cov_25.423237	432	512	0	80	80	1.0000000
NODE_11299_length_822_cov_16.381743	394	474	0	80	80	1.0000000
NODE_11299_length_822_cov_16.381743	447	527	0	80	80	1.0000000
NODE_11300_length_822_cov_12.426003	223	296	0	73	73	1.0000000
NODE_11300_length_822_cov_12.426003	278	349	0	71	71	1.0000000
NODE_11301_length_822_cov_10.608575	464	544	0	66	80	0.8250000
NODE_11301_length_822_cov_10.608575	464	544	1	14	80	0.1750000
NODE_11301_length_822_cov_10.608575	517	597	0	13	80	0.1625000
NODE_11301_length_822_cov_10.608575	517	597	1	21	80	0.2625000
NODE_11301_length_822_cov_10.608575	517	597	2	46	80	0.5750000
NODE_11302_length_822_cov_9.496542	363	443	0	80	80	1.0000000
NODE_11302_length_822_cov_9.496542	416	496	0	80	80	1.0000000
NODE_11333_length_821_cov_39.818560	341	420	0	79	79	1.0000000
NODE_11333_length_821_cov_39.818560	393	473	0	63	80	0.7875000
NODE_11333_length_821_cov_39.818560	393	473	2	17	80	0.2125000
NODE_11334_length_821_cov_27.721607	299	379	0	80	80	1.0000000
NODE_11334_length_821_cov_27.721607	352	432	0	80	80	1.0000000
NODE_11335_length_821_cov_26.252078	386	466	0	80	80	1.0000000
NODE_11335_length_821_cov_26.252078	439	519	0	80	80	1.0000000
NODE_11336_length_821_cov_19.603878	353	433	0	80	80	1.0000000
NODE_11336_length_821_cov_19.603878	406	486	0	80	80	1.0000000
NODE_11337_length_821_cov_15.945983	310	390	0	80	80	1.0000000
NODE_11337_length_821_cov_15.945983	363	443	0	80	80	1.0000000
NODE_11339_length_821_cov_8.711911	288	368	0	80	80	1.0000000
NODE_11339_length_821_cov_8.711911	341	421	0	80	80	1.0000000
NODE_11349_length_821_cov_3.026316	310	390	0	80	80	1.0000000
NODE_11349_length_821_cov_3.026316	363	443	0	80	80	1.0000000
NODE_11361_length_820_cov_67.292649	328	408	0	80	80	1.0000000
NODE_11361_length_820_cov_67.292649	381	461	0	80	80	1.0000000
NODE_11362_length_820_cov_26.915395	308	388	0	80	80	1.0000000
NODE_11363_length_820_cov_25.253814	301	381	0	80	80	1.0000000
NODE_11363_length_820_cov_25.253814	354	434	0	80	80	1.0000000
NODE_11363_length_820_cov_25.253814	430	510	0	80	80	1.0000000
NODE_11363_length_820_cov_25.253814	483	563	0	80	80	1.0000000
NODE_11364_length_820_cov_16.015257	325	405	0	69	80	0.8625000
NODE_11364_length_820_cov_16.015257	325	405	1	11	80	0.1375000
NODE_11364_length_820_cov_16.015257	378	458	0	80	80	1.0000000
NODE_11365_length_820_cov_14.703190	371	451	2	80	80	1.0000000
NODE_11365_length_820_cov_14.703190	424	504	0	46	80	0.5750000
NODE_11365_length_820_cov_14.703190	424	504	2	34	80	0.4250000
NODE_11366_length_820_cov_14.527046	249	329	0	21	80	0.2625000
NODE_11366_length_820_cov_14.527046	249	329	2	32	80	0.4000000
NODE_11366_length_820_cov_14.527046	249	329	3	5	80	0.0625000
NODE_11366_length_820_cov_14.527046	249	329	4	22	80	0.2750000
NODE_11366_length_820_cov_14.527046	302	382	0	8	80	0.1000000
NODE_11366_length_820_cov_14.527046	302	382	2	72	80	0.9000000
NODE_11367_length_820_cov_14.284327	286	366	0	80	80	1.0000000
NODE_11367_length_820_cov_14.284327	339	419	0	80	80	1.0000000
NODE_11367_length_820_cov_14.284327	619	699	0	19	80	0.2375000
NODE_11367_length_820_cov_14.284327	619	699	2	61	80	0.7625000
NODE_11368_length_820_cov_13.036061	364	444	0	10	80	0.1250000
NODE_11368_length_820_cov_13.036061	364	444	2	70	80	0.8750000
NODE_11368_length_820_cov_13.036061	417	497	0	63	80	0.7875000
NODE_11368_length_820_cov_13.036061	417	497	2	17	80	0.2125000
NODE_11369_length_820_cov_12.830791	313	393	2	80	80	1.0000000
NODE_11369_length_820_cov_12.830791	366	446	0	44	80	0.5500000
NODE_11369_length_820_cov_12.830791	366	446	2	36	80	0.4500000
NODE_11370_length_820_cov_12.768377	366	443	0	77	77	1.0000000
NODE_11370_length_820_cov_12.768377	496	525	0	29	29	1.0000000
NODE_11371_length_820_cov_12.223301	452	519	0	67	67	1.0000000
NODE_11371_length_820_cov_12.223301	492	572	0	80	80	1.0000000
NODE_11396_length_819_cov_43.027778	403	483	0	80	80	1.0000000
NODE_11396_length_819_cov_43.027778	456	536	0	80	80	1.0000000
NODE_11396_length_819_cov_43.027778	532	612	0	48	80	0.6000000
NODE_11396_length_819_cov_43.027778	532	612	2	32	80	0.4000000
NODE_11396_length_819_cov_43.027778	585	665	0	4	80	0.0500000
NODE_11396_length_819_cov_43.027778	585	665	2	76	80	0.9500000
NODE_11397_length_819_cov_42.758333	391	471	0	25	80	0.3125000
NODE_11397_length_819_cov_42.758333	391	471	4	55	80	0.6875000
NODE_11397_length_819_cov_42.758333	444	524	0	78	80	0.9750000
NODE_11397_length_819_cov_42.758333	444	524	4	2	80	0.0250000
NODE_11398_length_819_cov_41.341667	86	166	0	80	80	1.0000000
NODE_11398_length_819_cov_41.341667	139	219	0	80	80	1.0000000
NODE_11398_length_819_cov_41.341667	215	295	0	80	80	1.0000000
NODE_11398_length_819_cov_41.341667	268	348	0	80	80	1.0000000
NODE_11399_length_819_cov_23.656944	335	415	0	80	80	1.0000000
NODE_11399_length_819_cov_23.656944	388	468	0	80	80	1.0000000
NODE_11400_length_819_cov_20.633333	475	555	0	80	80	1.0000000
NODE_11400_length_819_cov_20.633333	528	608	0	80	80	1.0000000
NODE_11401_length_819_cov_18.941667	307	387	0	34	80	0.4250000
NODE_11401_length_819_cov_18.941667	307	387	2	46	80	0.5750000
NODE_11401_length_819_cov_18.941667	360	440	2	80	80	1.0000000
NODE_11401_length_819_cov_18.941667	436	516	0	63	80	0.7875000
NODE_11401_length_819_cov_18.941667	436	516	2	17	80	0.2125000
NODE_11401_length_819_cov_18.941667	489	569	0	80	80	1.0000000
NODE_11402_length_819_cov_12.225000	431	511	0	52	80	0.6500000
NODE_11402_length_819_cov_12.225000	431	511	2	28	80	0.3500000
NODE_11402_length_819_cov_12.225000	484	564	0	16	80	0.2000000
NODE_11402_length_819_cov_12.225000	484	564	2	64	80	0.8000000
NODE_11403_length_819_cov_11.562500	273	353	0	80	80	1.0000000
NODE_11403_length_819_cov_11.562500	326	406	0	80	80	1.0000000
NODE_11404_length_819_cov_8.905556	477	557	0	80	80	1.0000000
NODE_11404_length_819_cov_8.905556	530	610	0	80	80	1.0000000
NODE_11405_length_819_cov_5.675000	232	312	0	80	80	1.0000000
NODE_11405_length_819_cov_5.675000	285	365	0	80	80	1.0000000
NODE_11431_length_818_cov_21.979138	342	422	0	80	80	1.0000000
NODE_11431_length_818_cov_21.979138	395	475	0	80	80	1.0000000
NODE_11432_length_818_cov_15.326843	334	414	0	80	80	1.0000000
NODE_11432_length_818_cov_15.326843	387	467	0	80	80	1.0000000
NODE_11433_length_818_cov_14.880389	392	472	0	80	80	1.0000000
NODE_11433_length_818_cov_14.880389	445	525	0	80	80	1.0000000
NODE_11434_length_818_cov_12.369958	390	470	0	80	80	1.0000000
NODE_11434_length_818_cov_12.369958	443	523	0	80	80	1.0000000
NODE_11436_length_818_cov_8.421419	370	450	0	80	80	1.0000000
NODE_11436_length_818_cov_8.421419	423	503	0	80	80	1.0000000
NODE_11437_length_818_cov_6.439499	706	741	0	34	35	0.9714286
NODE_11437_length_818_cov_6.439499	706	741	2	1	35	0.0285714
NODE_11439_length_818_cov_4.098748	320	390	0	70	70	1.0000000
NODE_11439_length_818_cov_4.098748	416	472	0	56	56	1.0000000
NODE_11457_length_817_cov_7.238162	494	574	0	40	80	0.5000000
NODE_11457_length_817_cov_7.238162	494	574	4	40	80	0.5000000
NODE_11457_length_817_cov_7.238162	547	627	0	80	80	1.0000000
NODE_11458_length_817_cov_5.789694	400	480	0	80	80	1.0000000
NODE_11458_length_817_cov_5.789694	476	555	0	79	79	1.0000000
NODE_11458_length_817_cov_5.789694	528	608	0	80	80	1.0000000
NODE_11462_length_817_cov_4.357939	433	513	0	80	80	1.0000000
NODE_11462_length_817_cov_4.357939	486	566	0	80	80	1.0000000
NODE_11486_length_817_cov_0.692201	626	696	0	11	70	0.1571429
NODE_11486_length_817_cov_0.692201	626	696	3	8	70	0.1142857
NODE_11486_length_817_cov_0.692201	626	696	5	15	70	0.2142857
NODE_11486_length_817_cov_0.692201	626	696	7	8	70	0.1142857
NODE_11486_length_817_cov_0.692201	626	696	9	3	70	0.0428571
NODE_11486_length_817_cov_0.692201	626	696	11	7	70	0.1000000
NODE_11486_length_817_cov_0.692201	626	696	13	18	70	0.2571429
NODE_11488_length_816_cov_69.800558	395	475	0	30	80	0.3750000
NODE_11488_length_816_cov_69.800558	395	475	5	1	80	0.0125000
NODE_11488_length_816_cov_69.800558	395	475	7	13	80	0.1625000
NODE_11488_length_816_cov_69.800558	395	475	11	29	80	0.3625000
NODE_11488_length_816_cov_69.800558	395	475	12	7	80	0.0875000
NODE_11488_length_816_cov_69.800558	448	520	0	10	72	0.1388889
NODE_11488_length_816_cov_69.800558	448	520	4	5	72	0.0694444
NODE_11488_length_816_cov_69.800558	448	520	11	20	72	0.2777778
NODE_11488_length_816_cov_69.800558	448	520	12	37	72	0.5138889
NODE_11489_length_816_cov_19.044630	77	154	0	77	77	1.0000000
NODE_11489_length_816_cov_19.044630	130	212	0	82	82	1.0000000
NODE_11490_length_816_cov_16.418410	381	461	0	80	80	1.0000000
NODE_11490_length_816_cov_16.418410	434	514	0	80	80	1.0000000
NODE_11491_length_816_cov_15.945607	319	399	0	80	80	1.0000000
NODE_11491_length_816_cov_15.945607	372	452	0	80	80	1.0000000
NODE_11492_length_816_cov_12.797768	358	438	0	80	80	1.0000000
NODE_11492_length_816_cov_12.797768	411	491	0	80	80	1.0000000
NODE_11493_length_816_cov_12.086471	242	322	0	43	80	0.5375000
NODE_11493_length_816_cov_12.086471	242	322	10	37	80	0.4625000
NODE_11493_length_816_cov_12.086471	295	375	10	80	80	1.0000000
NODE_11495_length_816_cov_3.873082	412	492	0	80	80	1.0000000
NODE_11495_length_816_cov_3.873082	465	545	0	80	80	1.0000000
NODE_11516_length_815_cov_48.090782	334	414	0	80	80	1.0000000
NODE_11516_length_815_cov_48.090782	387	467	0	80	80	1.0000000
NODE_11517_length_815_cov_27.748603	290	370	0	80	80	1.0000000
NODE_11517_length_815_cov_27.748603	343	423	0	80	80	1.0000000
NODE_11518_length_815_cov_23.748603	429	509	0	80	80	1.0000000
NODE_11518_length_815_cov_23.748603	482	562	0	80	80	1.0000000
NODE_11519_length_815_cov_14.870112	318	398	0	80	80	1.0000000
NODE_11519_length_815_cov_14.870112	371	451	0	80	80	1.0000000
NODE_11520_length_815_cov_13.317039	338	418	0	80	80	1.0000000
NODE_11520_length_815_cov_13.317039	391	471	0	34	80	0.4250000
NODE_11520_length_815_cov_13.317039	391	471	1	46	80	0.5750000
NODE_11521_length_815_cov_12.270950	315	395	0	80	80	1.0000000
NODE_11521_length_815_cov_12.270950	368	448	0	80	80	1.0000000
NODE_11522_length_815_cov_9.304469	150	230	0	80	80	1.0000000
NODE_11522_length_815_cov_9.304469	203	283	0	80	80	1.0000000
NODE_11524_length_815_cov_8.117318	437	517	0	80	80	1.0000000
NODE_11524_length_815_cov_8.117318	490	570	0	55	80	0.6875000
NODE_11524_length_815_cov_8.117318	490	570	2	25	80	0.3125000
NODE_11530_length_815_cov_3.963687	275	355	0	80	80	1.0000000
NODE_11530_length_815_cov_3.963687	328	408	0	80	80	1.0000000
NODE_11532_length_815_cov_2.976257	441	508	0	67	67	1.0000000
NODE_11554_length_814_cov_55.545455	304	384	0	44	80	0.5500000
NODE_11554_length_814_cov_55.545455	304	384	2	36	80	0.4500000
NODE_11554_length_814_cov_55.545455	357	437	0	8	80	0.1000000
NODE_11554_length_814_cov_55.545455	357	437	2	72	80	0.9000000
NODE_11554_length_814_cov_55.545455	517	559	0	41	42	0.9761904
NODE_11554_length_814_cov_55.545455	517	559	2	1	42	0.0238095
NODE_11554_length_814_cov_55.545455	724	804	6	2	80	0.0250000
NODE_11554_length_814_cov_55.545455	724	804	8	2	80	0.0250000
NODE_11554_length_814_cov_55.545455	724	804	9	1	80	0.0125000
NODE_11554_length_814_cov_55.545455	724	804	10	1	80	0.0125000
NODE_11554_length_814_cov_55.545455	724	804	12	6	80	0.0750000
NODE_11554_length_814_cov_55.545455	724	804	14	6	80	0.0750000
NODE_11554_length_814_cov_55.545455	724	804	16	1	80	0.0125000
NODE_11554_length_814_cov_55.545455	724	804	18	4	80	0.0500000
NODE_11554_length_814_cov_55.545455	724	804	22	2	80	0.0250000
NODE_11554_length_814_cov_55.545455	724	804	26	1	80	0.0125000
NODE_11554_length_814_cov_55.545455	724	804	28	1	80	0.0125000
NODE_11554_length_814_cov_55.545455	724	804	30	1	80	0.0125000
NODE_11554_length_814_cov_55.545455	724	804	32	8	80	0.1000000
NODE_11554_length_814_cov_55.545455	724	804	38	2	80	0.0250000
NODE_11554_length_814_cov_55.545455	724	804	42	4	80	0.0500000
NODE_11554_length_814_cov_55.545455	724	804	48	12	80	0.1500000
NODE_11554_length_814_cov_55.545455	724	804	50	20	80	0.2500000
NODE_11554_length_814_cov_55.545455	724	804	52	1	80	0.0125000
NODE_11554_length_814_cov_55.545455	724	804	54	5	80	0.0625000
NODE_11555_length_814_cov_32.216783	317	397	0	80	80	1.0000000
NODE_11555_length_814_cov_32.216783	370	450	0	80	80	1.0000000
NODE_11556_length_814_cov_19.507692	174	254	0	80	80	1.0000000
NODE_11556_length_814_cov_19.507692	227	307	0	80	80	1.0000000
NODE_11556_length_814_cov_19.507692	303	383	0	80	80	1.0000000
NODE_11556_length_814_cov_19.507692	356	436	0	80	80	1.0000000
NODE_11557_length_814_cov_18.579021	433	513	0	80	80	1.0000000
NODE_11557_length_814_cov_18.579021	486	566	0	80	80	1.0000000
NODE_11558_length_814_cov_17.183217	339	419	0	80	80	1.0000000
NODE_11558_length_814_cov_17.183217	392	472	0	80	80	1.0000000
NODE_11559_length_814_cov_15.306294	238	318	0	80	80	1.0000000
NODE_11559_length_814_cov_15.306294	291	371	0	80	80	1.0000000
NODE_11560_length_814_cov_11.511888	397	477	0	80	80	1.0000000
NODE_11560_length_814_cov_11.511888	459	530	0	71	71	1.0000000
NODE_11561_length_814_cov_10.395804	305	385	0	20	80	0.2500000
NODE_11561_length_814_cov_10.395804	305	385	2	60	80	0.7500000
NODE_11561_length_814_cov_10.395804	358	438	0	50	80	0.6250000
NODE_11561_length_814_cov_10.395804	358	438	2	30	80	0.3750000
NODE_11562_length_814_cov_9.692308	347	427	0	5	80	0.0625000
NODE_11562_length_814_cov_9.692308	347	427	2	17	80	0.2125000
NODE_11562_length_814_cov_9.692308	347	427	4	58	80	0.7250000
NODE_11562_length_814_cov_9.692308	400	480	0	58	80	0.7250000
NODE_11562_length_814_cov_9.692308	400	480	2	17	80	0.2125000
NODE_11562_length_814_cov_9.692308	400	480	4	5	80	0.0625000
NODE_11564_length_814_cov_9.274126	245	325	0	80	80	1.0000000
NODE_11564_length_814_cov_9.274126	298	378	0	80	80	1.0000000
NODE_11565_length_814_cov_8.973427	271	351	0	80	80	1.0000000
NODE_11565_length_814_cov_8.973427	324	404	0	80	80	1.0000000
NODE_11573_length_814_cov_2.145455	273	327	1	54	54	1.0000000
NODE_11573_length_814_cov_2.145455	307	371	1	64	64	1.0000000
NODE_11587_length_813_cov_39.228291	225	305	0	62	80	0.7750000
NODE_11587_length_813_cov_39.228291	225	305	2	6	80	0.0750000
NODE_11587_length_813_cov_39.228291	225	305	4	12	80	0.1500000
NODE_11587_length_813_cov_39.228291	278	358	0	9	80	0.1125000
NODE_11587_length_813_cov_39.228291	278	358	2	6	80	0.0750000
NODE_11587_length_813_cov_39.228291	278	358	4	65	80	0.8125000
NODE_11588_length_813_cov_36.570028	406	486	0	17	80	0.2125000
NODE_11588_length_813_cov_36.570028	406	486	7	2	80	0.0250000
NODE_11588_length_813_cov_36.570028	406	486	8	61	80	0.7625000
NODE_11588_length_813_cov_36.570028	459	539	0	70	80	0.8750000
NODE_11588_length_813_cov_36.570028	459	539	7	2	80	0.0250000
NODE_11588_length_813_cov_36.570028	459	539	8	8	80	0.1000000
NODE_11589_length_813_cov_26.718487	209	289	0	72	80	0.9000000
NODE_11589_length_813_cov_26.718487	209	289	2	8	80	0.1000000
NODE_11589_length_813_cov_26.718487	262	342	0	36	80	0.4500000
NODE_11589_length_813_cov_26.718487	262	342	2	44	80	0.5500000
NODE_11590_length_813_cov_17.537815	335	415	0	80	80	1.0000000
NODE_11590_length_813_cov_17.537815	388	468	0	80	80	1.0000000
NODE_11591_length_813_cov_14.243697	279	359	0	80	80	1.0000000
NODE_11591_length_813_cov_14.243697	332	412	0	80	80	1.0000000
NODE_11592_length_813_cov_13.984594	307	387	0	80	80	1.0000000
NODE_11592_length_813_cov_13.984594	360	440	0	80	80	1.0000000
NODE_11593_length_813_cov_13.242297	336	416	0	21	80	0.2625000
NODE_11593_length_813_cov_13.242297	336	416	2	59	80	0.7375000
NODE_11593_length_813_cov_13.242297	389	469	0	74	80	0.9250000
NODE_11593_length_813_cov_13.242297	389	469	2	6	80	0.0750000
NODE_11594_length_813_cov_11.985994	374	454	0	21	80	0.2625000
NODE_11594_length_813_cov_11.985994	374	454	4	59	80	0.7375000
NODE_11594_length_813_cov_11.985994	427	507	0	12	80	0.1500000
NODE_11594_length_813_cov_11.985994	427	507	3	1	80	0.0125000
NODE_11594_length_813_cov_11.985994	427	507	4	67	80	0.8375000
NODE_11595_length_813_cov_11.668067	279	359	0	80	80	1.0000000
NODE_11595_length_813_cov_11.668067	332	412	0	80	80	1.0000000
NODE_11596_length_813_cov_8.149860	538	618	0	80	80	1.0000000
NODE_11596_length_813_cov_8.149860	591	671	0	50	80	0.6250000
NODE_11596_length_813_cov_8.149860	591	671	2	30	80	0.3750000
NODE_11597_length_813_cov_7.098039	234	314	0	80	80	1.0000000
NODE_11597_length_813_cov_7.098039	287	367	0	80	80	1.0000000
NODE_11613_length_812_cov_45.183731	435	515	0	80	80	1.0000000
NODE_11613_length_812_cov_45.183731	488	568	0	80	80	1.0000000
NODE_11614_length_812_cov_23.862553	386	466	0	59	80	0.7375000
NODE_11614_length_812_cov_23.862553	386	466	2	21	80	0.2625000
NODE_11614_length_812_cov_23.862553	439	519	0	6	80	0.0750000
NODE_11614_length_812_cov_23.862553	439	519	2	74	80	0.9250000
NODE_11615_length_812_cov_23.516129	295	375	0	80	80	1.0000000
NODE_11615_length_812_cov_23.516129	348	428	0	80	80	1.0000000
NODE_11616_length_812_cov_15.577840	509	589	0	80	80	1.0000000
NODE_11616_length_812_cov_15.577840	562	644	0	82	82	1.0000000
NODE_11617_length_812_cov_13.277700	257	331	0	28	74	0.3783784
NODE_11617_length_812_cov_13.277700	257	331	2	46	74	0.6216216
NODE_11617_length_812_cov_13.277700	304	384	0	24	80	0.3000000
NODE_11617_length_812_cov_13.277700	304	384	2	56	80	0.7000000
NODE_11619_length_812_cov_6.697055	309	389	0	80	80	1.0000000
NODE_11619_length_812_cov_6.697055	362	442	0	80	80	1.0000000
NODE_11642_length_811_cov_65.762640	418	492	24	19	74	0.2567568
NODE_11642_length_811_cov_65.762640	418	492	28	55	74	0.7432432
NODE_11642_length_811_cov_65.762640	471	545	3	7	74	0.0945946
NODE_11642_length_811_cov_65.762640	471	545	6	8	74	0.1081081
NODE_11642_length_811_cov_65.762640	471	545	7	5	74	0.0675676
NODE_11642_length_811_cov_65.762640	471	545	9	1	74	0.0135135
NODE_11642_length_811_cov_65.762640	471	545	10	18	74	0.2432432
NODE_11642_length_811_cov_65.762640	471	545	18	8	74	0.1081081
NODE_11642_length_811_cov_65.762640	471	545	25	1	74	0.0135135
NODE_11642_length_811_cov_65.762640	471	545	27	1	74	0.0135135
NODE_11642_length_811_cov_65.762640	471	545	28	25	74	0.3378378
NODE_11643_length_811_cov_62.933989	457	537	0	80	80	1.0000000
NODE_11643_length_811_cov_62.933989	510	590	0	80	80	1.0000000
NODE_11644_length_811_cov_26.401685	397	477	0	80	80	1.0000000
NODE_11644_length_811_cov_26.401685	450	530	0	80	80	1.0000000
NODE_11645_length_811_cov_23.009831	189	269	0	80	80	1.0000000
NODE_11645_length_811_cov_23.009831	242	322	0	80	80	1.0000000
NODE_11646_length_811_cov_20.523876	375	455	0	80	80	1.0000000
NODE_11646_length_811_cov_20.523876	428	508	0	80	80	1.0000000
NODE_11647_length_811_cov_17.386236	421	501	0	80	80	1.0000000
NODE_11647_length_811_cov_17.386236	474	554	0	47	80	0.5875000
NODE_11647_length_811_cov_17.386236	474	554	2	33	80	0.4125000
NODE_11648_length_811_cov_15.279494	368	448	0	80	80	1.0000000
NODE_11648_length_811_cov_15.279494	421	502	0	81	81	1.0000000
NODE_11649_length_811_cov_14.543539	222	302	0	80	80	1.0000000
NODE_11649_length_811_cov_14.543539	275	355	0	80	80	1.0000000
NODE_11650_length_811_cov_12.196629	402	482	0	80	80	1.0000000
NODE_11650_length_811_cov_12.196629	455	535	0	80	80	1.0000000
NODE_11651_length_811_cov_12.117978	289	369	0	80	80	1.0000000
NODE_11651_length_811_cov_12.117978	342	422	0	80	80	1.0000000
NODE_11652_length_811_cov_11.886236	330	410	0	80	80	1.0000000
NODE_11652_length_811_cov_11.886236	383	463	0	80	80	1.0000000
NODE_11653_length_811_cov_10.602528	342	422	0	80	80	1.0000000
NODE_11653_length_811_cov_10.602528	395	461	0	66	66	1.0000000
NODE_11653_length_811_cov_10.602528	452	519	0	67	67	1.0000000
NODE_11653_length_811_cov_10.602528	492	572	0	80	80	1.0000000
NODE_11654_length_811_cov_7.539326	324	404	0	80	80	1.0000000
NODE_11654_length_811_cov_7.539326	377	457	0	80	80	1.0000000
NODE_11655_length_811_cov_6.398876	419	499	0	80	80	1.0000000
NODE_11655_length_811_cov_6.398876	472	552	0	80	80	1.0000000
NODE_11657_length_811_cov_5.939607	496	527	0	31	31	1.0000000
NODE_11657_length_811_cov_5.939607	528	603	0	51	75	0.6800000
NODE_11657_length_811_cov_5.939607	528	603	2	24	75	0.3200000
NODE_11669_length_811_cov_1.501404	645	676	0	31	31	1.0000000
NODE_11684_length_810_cov_42.358650	484	564	0	80	80	1.0000000
NODE_11684_length_810_cov_42.358650	537	617	0	80	80	1.0000000
NODE_11685_length_810_cov_38.604782	370	450	0	80	80	1.0000000
NODE_11685_length_810_cov_38.604782	423	499	0	76	76	1.0000000
NODE_11686_length_810_cov_20.354430	338	418	0	80	80	1.0000000
NODE_11686_length_810_cov_20.354430	391	471	0	80	80	1.0000000
NODE_11688_length_810_cov_12.367089	144	224	0	74	80	0.9250000
NODE_11688_length_810_cov_12.367089	144	224	2	6	80	0.0750000
NODE_11688_length_810_cov_12.367089	197	277	0	21	80	0.2625000
NODE_11688_length_810_cov_12.367089	197	277	2	59	80	0.7375000
NODE_11689_length_810_cov_8.886076	333	399	0	21	66	0.3181818
NODE_11689_length_810_cov_8.886076	333	399	4	45	66	0.6818182
NODE_11690_length_810_cov_8.291139	446	526	0	38	80	0.4750000
NODE_11690_length_810_cov_8.291139	446	526	2	1	80	0.0125000
NODE_11690_length_810_cov_8.291139	446	526	4	21	80	0.2625000
NODE_11690_length_810_cov_8.291139	446	526	6	20	80	0.2500000
NODE_11690_length_810_cov_8.291139	499	579	4	11	80	0.1375000
NODE_11690_length_810_cov_8.291139	499	579	6	69	80	0.8625000
NODE_11692_length_810_cov_7.213783	335	406	0	71	71	1.0000000
NODE_11692_length_810_cov_7.213783	335	416	0	81	81	1.0000000
NODE_11692_length_810_cov_7.213783	379	459	0	80	80	1.0000000
NODE_11714_length_809_cov_40.536620	428	500	0	72	72	1.0000000
NODE_11714_length_809_cov_40.536620	473	553	0	80	80	1.0000000
NODE_11715_length_809_cov_15.871831	385	465	0	80	80	1.0000000
NODE_11715_length_809_cov_15.871831	402	465	0	63	63	1.0000000
NODE_11715_length_809_cov_15.871831	438	518	0	80	80	1.0000000
NODE_11715_length_809_cov_15.871831	438	518	0	80	80	1.0000000
NODE_11716_length_809_cov_15.019718	286	366	0	80	80	1.0000000
NODE_11716_length_809_cov_15.019718	339	419	0	80	80	1.0000000
NODE_11718_length_809_cov_4.483099	244	324	0	80	80	1.0000000
NODE_11718_length_809_cov_4.483099	278	324	0	46	46	1.0000000
NODE_11718_length_809_cov_4.483099	298	377	0	79	79	1.0000000
NODE_11718_length_809_cov_4.483099	308	377	0	69	69	1.0000000
NODE_11738_length_808_cov_45.023977	325	405	0	80	80	1.0000000
NODE_11738_length_808_cov_45.023977	378	458	0	80	80	1.0000000
NODE_11739_length_808_cov_24.087447	287	367	0	80	80	1.0000000
NODE_11739_length_808_cov_24.087447	340	420	0	80	80	1.0000000
NODE_11740_length_808_cov_21.867419	324	404	0	54	80	0.6750000
NODE_11740_length_808_cov_21.867419	324	404	1	26	80	0.3250000
NODE_11740_length_808_cov_21.867419	377	457	0	26	80	0.3250000
NODE_11740_length_808_cov_21.867419	377	457	1	54	80	0.6750000
NODE_11741_length_808_cov_16.289140	333	413	0	67	80	0.8375000
NODE_11741_length_808_cov_16.289140	333	413	2	13	80	0.1625000
NODE_11741_length_808_cov_16.289140	386	466	0	14	80	0.1750000
NODE_11741_length_808_cov_16.289140	386	466	1	6	80	0.0750000
NODE_11741_length_808_cov_16.289140	386	466	2	60	80	0.7500000
NODE_11742_length_808_cov_14.489422	307	387	0	16	80	0.2000000
NODE_11742_length_808_cov_14.489422	307	387	4	64	80	0.8000000
NODE_11742_length_808_cov_14.489422	360	440	0	25	80	0.3125000
NODE_11742_length_808_cov_14.489422	360	440	4	55	80	0.6875000
NODE_11744_length_808_cov_10.507757	317	397	0	80	80	1.0000000
NODE_11744_length_808_cov_10.507757	370	450	0	80	80	1.0000000
NODE_11745_length_808_cov_10.066291	483	563	0	80	80	1.0000000
NODE_11745_length_808_cov_10.066291	536	616	0	80	80	1.0000000
NODE_11746_length_808_cov_7.581100	358	438	0	80	80	1.0000000
NODE_11746_length_808_cov_7.581100	411	491	0	80	80	1.0000000
NODE_11756_length_808_cov_3.283498	471	551	0	80	80	1.0000000
NODE_11756_length_808_cov_3.283498	524	604	0	80	80	1.0000000
NODE_11783_length_807_cov_67.341808	2	25	26	1	23	0.0434783
NODE_11783_length_807_cov_67.341808	2	25	33	1	23	0.0434783
NODE_11783_length_807_cov_67.341808	2	25	35	1	23	0.0434783
NODE_11783_length_807_cov_67.341808	2	25	46	1	23	0.0434783
NODE_11783_length_807_cov_67.341808	2	25	56	1	23	0.0434783
NODE_11783_length_807_cov_67.341808	2	25	58	1	23	0.0434783
NODE_11783_length_807_cov_67.341808	2	25	64	1	23	0.0434783
NODE_11783_length_807_cov_67.341808	2	25	70	1	23	0.0434783
NODE_11783_length_807_cov_67.341808	2	25	72	1	23	0.0434783
NODE_11783_length_807_cov_67.341808	2	25	79	1	23	0.0434783
NODE_11783_length_807_cov_67.341808	2	25	81	1	23	0.0434783
NODE_11783_length_807_cov_67.341808	2	25	83	1	23	0.0434783
NODE_11783_length_807_cov_67.341808	2	25	88	1	23	0.0434783
NODE_11783_length_807_cov_67.341808	2	25	89	1	23	0.0434783
NODE_11783_length_807_cov_67.341808	2	25	97	2	23	0.0869565
NODE_11783_length_807_cov_67.341808	2	25	109	1	23	0.0434783
NODE_11783_length_807_cov_67.341808	2	25	117	1	23	0.0434783
NODE_11783_length_807_cov_67.341808	2	25	123	1	23	0.0434783
NODE_11783_length_807_cov_67.341808	2	25	127	2	23	0.0869565
NODE_11783_length_807_cov_67.341808	2	25	133	1	23	0.0434783
NODE_11783_length_807_cov_67.341808	2	25	135	1	23	0.0434783
NODE_11783_length_807_cov_67.341808	339	370	150	2	31	0.0645161
NODE_11783_length_807_cov_67.341808	339	370	153	3	31	0.0967742
NODE_11783_length_807_cov_67.341808	339	370	155	2	31	0.0645161
NODE_11783_length_807_cov_67.341808	339	370	159	1	31	0.0322581
NODE_11783_length_807_cov_67.341808	339	370	161	1	31	0.0322581
NODE_11783_length_807_cov_67.341808	339	370	174	2	31	0.0645161
NODE_11783_length_807_cov_67.341808	339	370	176	1	31	0.0322581
NODE_11783_length_807_cov_67.341808	339	370	177	2	31	0.0645161
NODE_11783_length_807_cov_67.341808	339	370	179	1	31	0.0322581
NODE_11783_length_807_cov_67.341808	339	370	182	1	31	0.0322581
NODE_11783_length_807_cov_67.341808	339	370	192	1	31	0.0322581
NODE_11783_length_807_cov_67.341808	339	370	196	1	31	0.0322581
NODE_11783_length_807_cov_67.341808	339	370	212	2	31	0.0645161
NODE_11783_length_807_cov_67.341808	339	370	220	1	31	0.0322581
NODE_11783_length_807_cov_67.341808	339	370	222	1	31	0.0322581
NODE_11783_length_807_cov_67.341808	339	370	228	1	31	0.0322581
NODE_11783_length_807_cov_67.341808	339	370	229	1	31	0.0322581
NODE_11783_length_807_cov_67.341808	339	370	231	1	31	0.0322581
NODE_11783_length_807_cov_67.341808	339	370	235	1	31	0.0322581
NODE_11783_length_807_cov_67.341808	339	370	237	1	31	0.0322581
NODE_11783_length_807_cov_67.341808	339	370	238	3	31	0.0967742
NODE_11783_length_807_cov_67.341808	339	370	240	1	31	0.0322581
NODE_11783_length_807_cov_67.341808	343	423	153	1	80	0.0125000
NODE_11783_length_807_cov_67.341808	343	423	155	2	80	0.0250000
NODE_11783_length_807_cov_67.341808	343	423	159	1	80	0.0125000
NODE_11783_length_807_cov_67.341808	343	423	161	1	80	0.0125000
NODE_11783_length_807_cov_67.341808	343	423	174	2	80	0.0250000
NODE_11783_length_807_cov_67.341808	343	423	176	1	80	0.0125000
NODE_11783_length_807_cov_67.341808	343	423	177	2	80	0.0250000
NODE_11783_length_807_cov_67.341808	343	423	179	1	80	0.0125000
NODE_11783_length_807_cov_67.341808	343	423	182	1	80	0.0125000
NODE_11783_length_807_cov_67.341808	343	423	192	1	80	0.0125000
NODE_11783_length_807_cov_67.341808	343	423	196	1	80	0.0125000
NODE_11783_length_807_cov_67.341808	343	423	212	2	80	0.0250000
NODE_11783_length_807_cov_67.341808	343	423	220	1	80	0.0125000
NODE_11783_length_807_cov_67.341808	343	423	222	1	80	0.0125000
NODE_11783_length_807_cov_67.341808	343	423	228	1	80	0.0125000
NODE_11783_length_807_cov_67.341808	343	423	229	1	80	0.0125000
NODE_11783_length_807_cov_67.341808	343	423	231	1	80	0.0125000
NODE_11783_length_807_cov_67.341808	343	423	235	1	80	0.0125000
NODE_11783_length_807_cov_67.341808	343	423	236	3	80	0.0375000
NODE_11783_length_807_cov_67.341808	343	423	237	1	80	0.0125000
NODE_11783_length_807_cov_67.341808	343	423	238	3	80	0.0375000
NODE_11783_length_807_cov_67.341808	343	423	240	2	80	0.0250000
NODE_11783_length_807_cov_67.341808	343	423	241	3	80	0.0375000
NODE_11783_length_807_cov_67.341808	343	423	249	1	80	0.0125000
NODE_11783_length_807_cov_67.341808	343	423	252	7	80	0.0875000
NODE_11783_length_807_cov_67.341808	343	423	254	2	80	0.0250000
NODE_11783_length_807_cov_67.341808	343	423	256	3	80	0.0375000
NODE_11783_length_807_cov_67.341808	343	423	257	1	80	0.0125000
NODE_11783_length_807_cov_67.341808	343	423	259	2	80	0.0250000
NODE_11783_length_807_cov_67.341808	343	423	260	1	80	0.0125000
NODE_11783_length_807_cov_67.341808	343	423	261	2	80	0.0250000
NODE_11783_length_807_cov_67.341808	343	423	268	1	80	0.0125000
NODE_11783_length_807_cov_67.341808	343	423	270	1	80	0.0125000
NODE_11783_length_807_cov_67.341808	343	423	278	1	80	0.0125000
NODE_11783_length_807_cov_67.341808	343	423	280	1	80	0.0125000
NODE_11783_length_807_cov_67.341808	343	423	292	2	80	0.0250000
NODE_11783_length_807_cov_67.341808	343	423	294	1	80	0.0125000
NODE_11783_length_807_cov_67.341808	343	423	295	3	80	0.0375000
NODE_11783_length_807_cov_67.341808	343	423	296	3	80	0.0375000
NODE_11783_length_807_cov_67.341808	343	423	297	1	80	0.0125000
NODE_11783_length_807_cov_67.341808	343	423	300	2	80	0.0250000
NODE_11783_length_807_cov_67.341808	343	423	304	1	80	0.0125000
NODE_11783_length_807_cov_67.341808	343	423	310	1	80	0.0125000
NODE_11783_length_807_cov_67.341808	343	423	312	2	80	0.0250000
NODE_11783_length_807_cov_67.341808	343	423	313	1	80	0.0125000
NODE_11783_length_807_cov_67.341808	343	423	315	1	80	0.0125000
NODE_11783_length_807_cov_67.341808	343	423	317	1	80	0.0125000
NODE_11783_length_807_cov_67.341808	343	423	319	1	80	0.0125000
NODE_11783_length_807_cov_67.341808	343	423	320	1	80	0.0125000
NODE_11783_length_807_cov_67.341808	343	423	321	1	80	0.0125000
NODE_11783_length_807_cov_67.341808	343	423	334	1	80	0.0125000
NODE_11784_length_807_cov_54.980226	683	749	113	1	66	0.0151515
NODE_11784_length_807_cov_54.980226	683	749	114	1	66	0.0151515
NODE_11784_length_807_cov_54.980226	683	749	116	1	66	0.0151515
NODE_11784_length_807_cov_54.980226	683	749	120	1	66	0.0151515
NODE_11784_length_807_cov_54.980226	683	749	124	1	66	0.0151515
NODE_11784_length_807_cov_54.980226	683	749	129	4	66	0.0606061
NODE_11784_length_807_cov_54.980226	683	749	131	2	66	0.0303030
NODE_11784_length_807_cov_54.980226	683	749	133	2	66	0.0303030
NODE_11784_length_807_cov_54.980226	683	749	135	1	66	0.0151515
NODE_11784_length_807_cov_54.980226	683	749	138	1	66	0.0151515
NODE_11784_length_807_cov_54.980226	683	749	139	3	66	0.0454545
NODE_11784_length_807_cov_54.980226	683	749	141	1	66	0.0151515
NODE_11784_length_807_cov_54.980226	683	749	143	3	66	0.0454545
NODE_11784_length_807_cov_54.980226	683	749	145	1	66	0.0151515
NODE_11784_length_807_cov_54.980226	683	749	147	1	66	0.0151515
NODE_11784_length_807_cov_54.980226	683	749	149	1	66	0.0151515
NODE_11784_length_807_cov_54.980226	683	749	150	1	66	0.0151515
NODE_11784_length_807_cov_54.980226	683	749	151	1	66	0.0151515
NODE_11784_length_807_cov_54.980226	683	749	154	3	66	0.0454545
NODE_11784_length_807_cov_54.980226	683	749	155	3	66	0.0454545
NODE_11784_length_807_cov_54.980226	683	749	157	1	66	0.0151515
NODE_11784_length_807_cov_54.980226	683	749	159	3	66	0.0454545
NODE_11784_length_807_cov_54.980226	683	749	162	3	66	0.0454545
NODE_11784_length_807_cov_54.980226	683	749	163	3	66	0.0454545
NODE_11784_length_807_cov_54.980226	683	749	164	4	66	0.0606061
NODE_11784_length_807_cov_54.980226	683	749	165	10	66	0.1515152
NODE_11784_length_807_cov_54.980226	683	749	166	3	66	0.0454545
NODE_11784_length_807_cov_54.980226	683	749	167	4	66	0.0606061
NODE_11784_length_807_cov_54.980226	683	749	168	1	66	0.0151515
NODE_11784_length_807_cov_54.980226	683	749	170	1	66	0.0151515
NODE_11784_length_807_cov_54.980226	727	802	14	1	75	0.0133333
NODE_11784_length_807_cov_54.980226	727	802	19	2	75	0.0266667
NODE_11784_length_807_cov_54.980226	727	802	28	2	75	0.0266667
NODE_11784_length_807_cov_54.980226	727	802	31	1	75	0.0133333
NODE_11784_length_807_cov_54.980226	727	802	35	1	75	0.0133333
NODE_11784_length_807_cov_54.980226	727	802	39	3	75	0.0400000
NODE_11784_length_807_cov_54.980226	727	802	41	1	75	0.0133333
NODE_11784_length_807_cov_54.980226	727	802	42	2	75	0.0266667
NODE_11784_length_807_cov_54.980226	727	802	49	1	75	0.0133333
NODE_11784_length_807_cov_54.980226	727	802	50	1	75	0.0133333
NODE_11784_length_807_cov_54.980226	727	802	52	1	75	0.0133333
NODE_11784_length_807_cov_54.980226	727	802	54	2	75	0.0266667
NODE_11784_length_807_cov_54.980226	727	802	56	1	75	0.0133333
NODE_11784_length_807_cov_54.980226	727	802	58	1	75	0.0133333
NODE_11784_length_807_cov_54.980226	727	802	66	1	75	0.0133333
NODE_11784_length_807_cov_54.980226	727	802	68	1	75	0.0133333
NODE_11784_length_807_cov_54.980226	727	802	72	1	75	0.0133333
NODE_11784_length_807_cov_54.980226	727	802	74	2	75	0.0266667
NODE_11784_length_807_cov_54.980226	727	802	75	3	75	0.0400000
NODE_11784_length_807_cov_54.980226	727	802	84	5	75	0.0666667
NODE_11784_length_807_cov_54.980226	727	802	86	1	75	0.0133333
NODE_11784_length_807_cov_54.980226	727	802	89	6	75	0.0800000
NODE_11784_length_807_cov_54.980226	727	802	93	1	75	0.0133333
NODE_11784_length_807_cov_54.980226	727	802	96	4	75	0.0533333
NODE_11784_length_807_cov_54.980226	727	802	98	1	75	0.0133333
NODE_11784_length_807_cov_54.980226	727	802	100	1	75	0.0133333
NODE_11784_length_807_cov_54.980226	727	802	102	1	75	0.0133333
NODE_11784_length_807_cov_54.980226	727	802	104	1	75	0.0133333
NODE_11784_length_807_cov_54.980226	727	802	106	3	75	0.0400000
NODE_11784_length_807_cov_54.980226	727	802	108	1	75	0.0133333
NODE_11784_length_807_cov_54.980226	727	802	113	1	75	0.0133333
NODE_11784_length_807_cov_54.980226	727	802	114	1	75	0.0133333
NODE_11784_length_807_cov_54.980226	727	802	116	1	75	0.0133333
NODE_11784_length_807_cov_54.980226	727	802	120	1	75	0.0133333
NODE_11784_length_807_cov_54.980226	727	802	124	1	75	0.0133333
NODE_11784_length_807_cov_54.980226	727	802	129	4	75	0.0533333
NODE_11784_length_807_cov_54.980226	727	802	131	2	75	0.0266667
NODE_11784_length_807_cov_54.980226	727	802	133	2	75	0.0266667
NODE_11784_length_807_cov_54.980226	727	802	135	1	75	0.0133333
NODE_11784_length_807_cov_54.980226	727	802	138	1	75	0.0133333
NODE_11784_length_807_cov_54.980226	727	802	139	3	75	0.0400000
NODE_11784_length_807_cov_54.980226	727	802	141	1	75	0.0133333
NODE_11784_length_807_cov_54.980226	727	802	143	3	75	0.0400000
NODE_11785_length_807_cov_37.306497	435	515	0	80	80	1.0000000
NODE_11785_length_807_cov_37.306497	488	568	0	80	80	1.0000000
NODE_11786_length_807_cov_31.177966	287	367	0	41	80	0.5125000
NODE_11786_length_807_cov_31.177966	287	367	2	39	80	0.4875000
NODE_11786_length_807_cov_31.177966	340	420	2	80	80	1.0000000
NODE_11787_length_807_cov_30.638418	250	329	0	79	79	1.0000000
NODE_11787_length_807_cov_30.638418	302	382	0	80	80	1.0000000
NODE_11787_length_807_cov_30.638418	378	458	0	80	80	1.0000000
NODE_11787_length_807_cov_30.638418	431	511	0	80	80	1.0000000
NODE_11788_length_807_cov_29.725989	362	442	0	45	80	0.5625000
NODE_11788_length_807_cov_29.725989	362	442	4	35	80	0.4375000
NODE_11788_length_807_cov_29.725989	415	495	0	1	80	0.0125000
NODE_11788_length_807_cov_29.725989	415	495	3	1	80	0.0125000
NODE_11788_length_807_cov_29.725989	415	495	4	78	80	0.9750000
NODE_11789_length_807_cov_23.200565	441	521	0	74	80	0.9250000
NODE_11789_length_807_cov_23.200565	441	521	4	6	80	0.0750000
NODE_11789_length_807_cov_23.200565	494	574	0	21	80	0.2625000
NODE_11789_length_807_cov_23.200565	494	574	4	59	80	0.7375000
NODE_11790_length_807_cov_21.888418	319	386	0	67	67	1.0000000
NODE_11790_length_807_cov_21.888418	390	440	0	50	50	1.0000000
NODE_11791_length_807_cov_17.480226	339	419	0	80	80	1.0000000
NODE_11791_length_807_cov_17.480226	392	472	0	80	80	1.0000000
NODE_11792_length_807_cov_14.895480	350	430	0	80	80	1.0000000
NODE_11792_length_807_cov_14.895480	403	483	0	80	80	1.0000000
NODE_11794_length_807_cov_12.255650	440	520	0	1	80	0.0125000
NODE_11794_length_807_cov_12.255650	440	520	2	79	80	0.9875000
NODE_11794_length_807_cov_12.255650	493	573	0	54	80	0.6750000
NODE_11794_length_807_cov_12.255650	493	573	2	26	80	0.3250000
NODE_11795_length_807_cov_11.129944	359	439	0	80	80	1.0000000
NODE_11795_length_807_cov_11.129944	412	492	0	80	80	1.0000000
NODE_11801_length_807_cov_3.847458	322	385	0	63	63	1.0000000
NODE_11822_length_806_cov_35.650636	397	477	0	17	80	0.2125000
NODE_11822_length_806_cov_35.650636	397	477	4	63	80	0.7875000
NODE_11822_length_806_cov_35.650636	450	530	0	36	80	0.4500000
NODE_11822_length_806_cov_35.650636	450	530	4	44	80	0.5500000
NODE_11822_length_806_cov_35.650636	526	606	0	80	80	1.0000000
NODE_11822_length_806_cov_35.650636	579	667	0	64	88	0.7272727
NODE_11822_length_806_cov_35.650636	579	667	4	24	88	0.2727273
NODE_11823_length_806_cov_29.615276	377	457	0	80	80	1.0000000
NODE_11823_length_806_cov_29.615276	430	510	0	80	80	1.0000000
NODE_11824_length_806_cov_23.680339	394	474	0	80	80	1.0000000
NODE_11824_length_806_cov_23.680339	447	527	0	80	80	1.0000000
NODE_11825_length_806_cov_19.107496	239	293	0	54	54	1.0000000
NODE_11825_length_806_cov_19.107496	248	293	0	45	45	1.0000000
NODE_11825_length_806_cov_19.107496	266	345	0	79	79	1.0000000
NODE_11825_length_806_cov_19.107496	266	345	0	79	79	1.0000000
NODE_11825_length_806_cov_19.107496	421	501	0	80	80	1.0000000
NODE_11826_length_806_cov_17.551627	308	388	0	80	80	1.0000000
NODE_11826_length_806_cov_17.551627	361	441	0	80	80	1.0000000
NODE_11827_length_806_cov_15.608204	408	488	0	80	80	1.0000000
NODE_11827_length_806_cov_15.608204	461	543	0	82	82	1.0000000
NODE_11864_length_805_cov_94.121813	398	478	0	80	80	1.0000000
NODE_11864_length_805_cov_94.121813	451	531	0	80	80	1.0000000
NODE_11865_length_805_cov_54.001416	284	364	0	80	80	1.0000000
NODE_11865_length_805_cov_54.001416	337	417	0	80	80	1.0000000
NODE_11865_length_805_cov_54.001416	413	493	0	80	80	1.0000000
NODE_11865_length_805_cov_54.001416	466	546	0	80	80	1.0000000
NODE_11866_length_805_cov_42.325779	377	457	0	80	80	1.0000000
NODE_11866_length_805_cov_42.325779	430	510	0	80	80	1.0000000
NODE_11867_length_805_cov_36.742210	345	425	0	80	80	1.0000000
NODE_11867_length_805_cov_36.742210	398	478	0	80	80	1.0000000
NODE_11868_length_805_cov_25.879603	361	441	0	80	80	1.0000000
NODE_11868_length_805_cov_25.879603	414	494	0	56	80	0.7000000
NODE_11868_length_805_cov_25.879603	414	494	4	24	80	0.3000000
NODE_11869_length_805_cov_25.048159	306	386	0	13	80	0.1625000
NODE_11869_length_805_cov_25.048159	306	386	2	67	80	0.8375000
NODE_11869_length_805_cov_25.048159	359	439	0	1	80	0.0125000
NODE_11869_length_805_cov_25.048159	359	439	2	79	80	0.9875000
NODE_11870_length_805_cov_15.453258	311	391	0	57	80	0.7125000
NODE_11870_length_805_cov_15.453258	311	391	2	12	80	0.1500000
NODE_11870_length_805_cov_15.453258	311	391	4	11	80	0.1375000
NODE_11870_length_805_cov_15.453258	364	444	0	4	80	0.0500000
NODE_11870_length_805_cov_15.453258	364	444	2	12	80	0.1500000
NODE_11870_length_805_cov_15.453258	364	444	4	64	80	0.8000000
NODE_11871_length_805_cov_14.930595	264	344	0	80	80	1.0000000
NODE_11871_length_805_cov_14.930595	317	397	0	80	80	1.0000000
NODE_11872_length_805_cov_10.888102	259	339	0	80	80	1.0000000
NODE_11872_length_805_cov_10.888102	312	392	0	80	80	1.0000000
NODE_11873_length_805_cov_10.716714	348	428	0	80	80	1.0000000
NODE_11873_length_805_cov_10.716714	401	481	0	80	80	1.0000000
NODE_11876_length_805_cov_7.212465	374	454	0	80	80	1.0000000
NODE_11876_length_805_cov_7.212465	427	507	0	80	80	1.0000000
NODE_11877_length_805_cov_5.637394	323	403	0	62	80	0.7750000
NODE_11877_length_805_cov_5.637394	323	403	2	18	80	0.2250000
NODE_11877_length_805_cov_5.637394	376	456	0	9	80	0.1125000
NODE_11877_length_805_cov_5.637394	376	456	2	71	80	0.8875000
NODE_11878_length_805_cov_4.001416	304	384	0	80	80	1.0000000
NODE_11878_length_805_cov_4.001416	357	437	0	80	80	1.0000000
NODE_11903_length_804_cov_26.204255	319	399	0	80	80	1.0000000
NODE_11903_length_804_cov_26.204255	372	452	0	80	80	1.0000000
NODE_11904_length_804_cov_25.978723	242	322	0	38	80	0.4750000
NODE_11904_length_804_cov_25.978723	242	322	2	25	80	0.3125000
NODE_11904_length_804_cov_25.978723	242	322	4	17	80	0.2125000
NODE_11904_length_804_cov_25.978723	295	375	2	20	80	0.2500000
NODE_11904_length_804_cov_25.978723	295	375	4	60	80	0.7500000
NODE_11904_length_804_cov_25.978723	371	451	2	73	80	0.9125000
NODE_11904_length_804_cov_25.978723	371	451	4	7	80	0.0875000
NODE_11904_length_804_cov_25.978723	424	504	0	26	80	0.3250000
NODE_11904_length_804_cov_25.978723	424	504	1	9	80	0.1125000
NODE_11904_length_804_cov_25.978723	424	504	2	45	80	0.5625000
NODE_11905_length_804_cov_25.628369	444	524	0	80	80	1.0000000
NODE_11905_length_804_cov_25.628369	497	577	0	80	80	1.0000000
NODE_11906_length_804_cov_22.438298	269	349	0	80	80	1.0000000
NODE_11906_length_804_cov_22.438298	322	402	0	80	80	1.0000000
NODE_11907_length_804_cov_17.425532	273	353	0	80	80	1.0000000
NODE_11907_length_804_cov_17.425532	326	406	0	80	80	1.0000000
NODE_11908_length_804_cov_16.849645	229	309	0	19	80	0.2375000
NODE_11908_length_804_cov_16.849645	229	309	2	61	80	0.7625000
NODE_11908_length_804_cov_16.849645	282	362	0	72	80	0.9000000
NODE_11908_length_804_cov_16.849645	282	362	2	8	80	0.1000000
NODE_11909_length_804_cov_16.024113	499	579	2	80	80	1.0000000
NODE_11909_length_804_cov_16.024113	552	632	0	30	80	0.3750000
NODE_11909_length_804_cov_16.024113	552	632	2	50	80	0.6250000
NODE_11910_length_804_cov_14.567376	375	455	0	80	80	1.0000000
NODE_11910_length_804_cov_14.567376	428	508	0	28	80	0.3500000
NODE_11910_length_804_cov_14.567376	428	508	2	52	80	0.6500000
NODE_11911_length_804_cov_14.011348	262	342	0	80	80	1.0000000
NODE_11911_length_804_cov_14.011348	315	395	0	80	80	1.0000000
NODE_11912_length_804_cov_13.800000	289	318	0	29	29	1.0000000
NODE_11913_length_804_cov_12.585816	396	476	0	80	80	1.0000000
NODE_11913_length_804_cov_12.585816	449	529	0	80	80	1.0000000
NODE_11914_length_804_cov_12.375887	190	270	0	80	80	1.0000000
NODE_11914_length_804_cov_12.375887	243	323	0	80	80	1.0000000
NODE_11915_length_804_cov_10.947518	363	443	0	80	80	1.0000000
NODE_11915_length_804_cov_10.947518	416	496	0	62	80	0.7750000
NODE_11915_length_804_cov_10.947518	416	496	2	18	80	0.2250000
NODE_11916_length_804_cov_8.164539	427	507	0	80	80	1.0000000
NODE_11916_length_804_cov_8.164539	480	560	0	80	80	1.0000000
NODE_11917_length_804_cov_7.462411	345	425	0	4	80	0.0500000
NODE_11917_length_804_cov_7.462411	345	425	2	76	80	0.9500000
NODE_11917_length_804_cov_7.462411	398	478	0	33	80	0.4125000
NODE_11917_length_804_cov_7.462411	398	478	2	47	80	0.5875000
NODE_11919_length_804_cov_3.663830	736	799	0	63	63	1.0000000
NODE_11933_length_804_cov_1.303546	480	560	0	26	80	0.3250000
NODE_11933_length_804_cov_1.303546	480	560	4	54	80	0.6750000
NODE_11933_length_804_cov_1.303546	533	613	0	6	80	0.0750000
NODE_11933_length_804_cov_1.303546	533	613	4	74	80	0.9250000
NODE_11942_length_803_cov_40.930398	374	454	0	80	80	1.0000000
NODE_11942_length_803_cov_40.930398	427	507	0	80	80	1.0000000
NODE_11944_length_803_cov_28.346591	242	322	0	80	80	1.0000000
NODE_11944_length_803_cov_28.346591	295	375	0	80	80	1.0000000
NODE_11945_length_803_cov_23.420455	288	368	0	80	80	1.0000000
NODE_11945_length_803_cov_23.420455	341	421	0	80	80	1.0000000
NODE_11946_length_803_cov_20.977273	316	396	0	80	80	1.0000000
NODE_11946_length_803_cov_20.977273	369	449	0	80	80	1.0000000
NODE_11947_length_803_cov_18.458807	307	387	0	80	80	1.0000000
NODE_11947_length_803_cov_18.458807	360	440	0	80	80	1.0000000
NODE_11948_length_803_cov_14.411932	386	466	0	80	80	1.0000000
NODE_11948_length_803_cov_14.411932	439	519	0	80	80	1.0000000
NODE_11949_length_803_cov_10.157670	319	399	0	80	80	1.0000000
NODE_11949_length_803_cov_10.157670	372	452	0	80	80	1.0000000
NODE_11950_length_803_cov_8.977273	362	442	0	29	80	0.3625000
NODE_11950_length_803_cov_8.977273	362	442	2	51	80	0.6375000
NODE_11950_length_803_cov_8.977273	415	485	0	70	70	1.0000000
NODE_11951_length_803_cov_7.735795	195	275	0	80	80	1.0000000
NODE_11951_length_803_cov_7.735795	248	328	0	80	80	1.0000000
NODE_11955_length_803_cov_4.613636	266	346	0	4	80	0.0500000
NODE_11955_length_803_cov_4.613636	266	346	2	76	80	0.9500000
NODE_11955_length_803_cov_4.613636	319	399	0	25	80	0.3125000
NODE_11955_length_803_cov_4.613636	319	399	2	55	80	0.6875000
NODE_11957_length_803_cov_4.220170	72	152	0	2	80	0.0250000
NODE_11957_length_803_cov_4.220170	72	152	4	78	80	0.9750000
NODE_11957_length_803_cov_4.220170	130	207	0	46	77	0.5974026
NODE_11957_length_803_cov_4.220170	130	207	4	31	77	0.4025974
NODE_11985_length_802_cov_42.294452	289	369	2	80	80	1.0000000
NODE_11985_length_802_cov_42.294452	342	422	0	5	80	0.0625000
NODE_11985_length_802_cov_42.294452	342	422	2	75	80	0.9375000
NODE_11986_length_802_cov_31.896159	246	326	0	80	80	1.0000000
NODE_11986_length_802_cov_31.896159	299	379	0	80	80	1.0000000
NODE_11987_length_802_cov_30.786629	419	499	0	80	80	1.0000000
NODE_11987_length_802_cov_30.786629	472	552	0	80	80	1.0000000
NODE_11988_length_802_cov_19.540541	368	448	0	80	80	1.0000000
NODE_11988_length_802_cov_19.540541	421	501	0	80	80	1.0000000
NODE_11989_length_802_cov_17.689900	268	348	0	80	80	1.0000000
NODE_11989_length_802_cov_17.689900	321	401	0	80	80	1.0000000
NODE_11990_length_802_cov_16.432432	364	444	0	80	80	1.0000000
NODE_11990_length_802_cov_16.432432	417	497	0	80	80	1.0000000
NODE_11991_length_802_cov_15.409673	317	397	0	80	80	1.0000000
NODE_11991_length_802_cov_15.409673	370	450	0	80	80	1.0000000
NODE_11992_length_802_cov_12.507824	340	420	0	66	80	0.8250000
NODE_11992_length_802_cov_12.507824	340	420	2	12	80	0.1500000
NODE_11992_length_802_cov_12.507824	340	420	4	2	80	0.0250000
NODE_11992_length_802_cov_12.507824	393	473	0	80	80	1.0000000
NODE_11993_length_802_cov_9.310100	374	454	0	80	80	1.0000000
NODE_11993_length_802_cov_9.310100	427	507	0	80	80	1.0000000
NODE_11994_length_802_cov_8.421053	272	351	0	79	79	1.0000000
NODE_11994_length_802_cov_8.421053	324	404	0	80	80	1.0000000
NODE_11997_length_802_cov_5.576102	294	374	0	80	80	1.0000000
NODE_11997_length_802_cov_5.576102	347	427	0	80	80	1.0000000
NODE_12025_length_801_cov_35.199430	334	414	0	80	80	1.0000000
NODE_12025_length_801_cov_35.199430	387	467	0	80	80	1.0000000
NODE_12026_length_801_cov_20.096866	347	427	0	80	80	1.0000000
NODE_12026_length_801_cov_20.096866	400	480	0	80	80	1.0000000
NODE_12027_length_801_cov_18.643875	355	435	0	20	80	0.2500000
NODE_12027_length_801_cov_18.643875	355	435	2	55	80	0.6875000
NODE_12027_length_801_cov_18.643875	355	435	4	5	80	0.0625000
NODE_12027_length_801_cov_18.643875	408	488	0	20	80	0.2500000
NODE_12027_length_801_cov_18.643875	408	488	2	2	80	0.0250000
NODE_12027_length_801_cov_18.643875	408	488	4	58	80	0.7250000
NODE_12028_length_801_cov_16.099715	427	507	0	80	80	1.0000000
NODE_12028_length_801_cov_16.099715	480	560	0	80	80	1.0000000
NODE_12029_length_801_cov_12.307692	332	412	6	80	80	1.0000000
NODE_12029_length_801_cov_12.307692	385	465	0	12	80	0.1500000
NODE_12029_length_801_cov_12.307692	385	465	6	68	80	0.8500000
NODE_12030_length_801_cov_11.464387	293	373	0	80	80	1.0000000
NODE_12030_length_801_cov_11.464387	346	426	0	28	80	0.3500000
NODE_12030_length_801_cov_11.464387	346	426	2	52	80	0.6500000
NODE_12031_length_801_cov_8.562678	309	389	0	80	80	1.0000000
NODE_12031_length_801_cov_8.562678	362	442	0	80	80	1.0000000
NODE_12032_length_801_cov_3.927350	339	419	0	80	80	1.0000000
NODE_12032_length_801_cov_3.927350	392	472	0	80	80	1.0000000
NODE_12053_length_800_cov_72.029957	245	325	0	80	80	1.0000000
NODE_12053_length_800_cov_72.029957	298	378	0	80	80	1.0000000
NODE_12054_length_800_cov_22.631954	297	377	0	80	80	1.0000000
NODE_12054_length_800_cov_22.631954	350	430	0	47	80	0.5875000
NODE_12054_length_800_cov_22.631954	350	430	1	33	80	0.4125000
NODE_12055_length_800_cov_9.457917	409	489	0	80	80	1.0000000
NODE_12055_length_800_cov_9.457917	462	542	0	80	80	1.0000000
NODE_12084_length_799_cov_101.640000	101	132	45	1	31	0.0322581
NODE_12084_length_799_cov_101.640000	101	132	46	1	31	0.0322581
NODE_12084_length_799_cov_101.640000	101	132	47	1	31	0.0322581
NODE_12084_length_799_cov_101.640000	101	132	56	1	31	0.0322581
NODE_12084_length_799_cov_101.640000	101	132	58	1	31	0.0322581
NODE_12084_length_799_cov_101.640000	101	132	63	2	31	0.0645161
NODE_12084_length_799_cov_101.640000	101	132	64	1	31	0.0322581
NODE_12084_length_799_cov_101.640000	101	132	65	1	31	0.0322581
NODE_12084_length_799_cov_101.640000	101	132	70	1	31	0.0322581
NODE_12084_length_799_cov_101.640000	101	132	72	2	31	0.0645161
NODE_12084_length_799_cov_101.640000	101	132	74	2	31	0.0645161
NODE_12084_length_799_cov_101.640000	101	132	78	2	31	0.0645161
NODE_12084_length_799_cov_101.640000	101	132	89	2	31	0.0645161
NODE_12084_length_799_cov_101.640000	101	132	90	1	31	0.0322581
NODE_12084_length_799_cov_101.640000	101	132	93	1	31	0.0322581
NODE_12084_length_799_cov_101.640000	101	132	95	2	31	0.0645161
NODE_12084_length_799_cov_101.640000	101	132	100	1	31	0.0322581
NODE_12084_length_799_cov_101.640000	101	132	105	1	31	0.0322581
NODE_12084_length_799_cov_101.640000	101	132	112	1	31	0.0322581
NODE_12084_length_799_cov_101.640000	101	132	114	1	31	0.0322581
NODE_12084_length_799_cov_101.640000	101	132	117	1	31	0.0322581
NODE_12084_length_799_cov_101.640000	101	132	127	1	31	0.0322581
NODE_12084_length_799_cov_101.640000	101	132	128	1	31	0.0322581
NODE_12084_length_799_cov_101.640000	101	132	132	1	31	0.0322581
NODE_12084_length_799_cov_101.640000	101	132	135	1	31	0.0322581
NODE_12085_length_799_cov_33.630000	367	447	2	80	80	1.0000000
NODE_12085_length_799_cov_33.630000	420	500	0	20	80	0.2500000
NODE_12085_length_799_cov_33.630000	420	500	2	60	80	0.7500000
NODE_12086_length_799_cov_15.717143	408	488	0	80	80	1.0000000
NODE_12086_length_799_cov_15.717143	461	541	0	80	80	1.0000000
NODE_12087_length_799_cov_15.175714	293	373	0	73	80	0.9125000
NODE_12087_length_799_cov_15.175714	293	373	2	7	80	0.0875000
NODE_12087_length_799_cov_15.175714	346	426	0	20	80	0.2500000
NODE_12087_length_799_cov_15.175714	346	426	2	60	80	0.7500000
NODE_12088_length_799_cov_8.444286	408	488	0	80	80	1.0000000
NODE_12088_length_799_cov_8.444286	461	541	0	80	80	1.0000000
NODE_12120_length_798_cov_42.629471	148	228	0	80	80	1.0000000
NODE_12120_length_798_cov_42.629471	201	281	0	80	80	1.0000000
NODE_12121_length_798_cov_23.658083	368	448	0	80	80	1.0000000
NODE_12121_length_798_cov_23.658083	421	501	0	80	80	1.0000000
NODE_12122_length_798_cov_15.037196	341	421	0	80	80	1.0000000
NODE_12122_length_798_cov_15.037196	394	474	0	80	80	1.0000000
NODE_12123_length_798_cov_6.816881	404	483	0	79	79	1.0000000
NODE_12123_length_798_cov_6.816881	457	536	0	79	79	1.0000000
NODE_12129_length_798_cov_2.796853	246	326	0	80	80	1.0000000
NODE_12129_length_798_cov_2.796853	299	379	0	80	80	1.0000000
NODE_12151_length_797_cov_24.340974	207	287	2	80	80	1.0000000
NODE_12151_length_797_cov_24.340974	260	340	0	41	80	0.5125000
NODE_12151_length_797_cov_24.340974	260	340	2	39	80	0.4875000
NODE_12152_length_797_cov_21.071633	372	452	0	80	80	1.0000000
NODE_12152_length_797_cov_21.071633	425	505	0	80	80	1.0000000
NODE_12153_length_797_cov_18.286533	346	426	0	80	80	1.0000000
NODE_12153_length_797_cov_18.286533	399	479	0	80	80	1.0000000
NODE_12154_length_797_cov_16.628940	322	402	0	80	80	1.0000000
NODE_12154_length_797_cov_16.628940	375	455	0	80	80	1.0000000
NODE_12155_length_797_cov_15.266476	299	379	0	80	80	1.0000000
NODE_12155_length_797_cov_15.266476	352	432	0	80	80	1.0000000
NODE_12156_length_797_cov_15.035817	263	343	0	80	80	1.0000000
NODE_12156_length_797_cov_15.035817	316	396	0	80	80	1.0000000
NODE_12157_length_797_cov_12.934097	403	484	0	81	81	1.0000000
NODE_12157_length_797_cov_12.934097	457	537	0	80	80	1.0000000
NODE_12158_length_797_cov_11.140401	201	281	0	80	80	1.0000000
NODE_12158_length_797_cov_11.140401	254	334	0	80	80	1.0000000
NODE_12159_length_797_cov_8.681948	284	364	0	4	80	0.0500000
NODE_12159_length_797_cov_8.681948	284	364	1	76	80	0.9500000
NODE_12159_length_797_cov_8.681948	337	417	1	39	80	0.4875000
NODE_12159_length_797_cov_8.681948	337	417	2	41	80	0.5125000
NODE_12160_length_797_cov_7.616046	314	397	0	83	83	1.0000000
NODE_12160_length_797_cov_7.616046	370	450	0	80	80	1.0000000
NODE_12161_length_797_cov_7.487106	275	347	0	72	72	1.0000000
NODE_12161_length_797_cov_7.487106	320	400	0	80	80	1.0000000
NODE_12163_length_797_cov_6.068768	357	437	0	33	80	0.4125000
NODE_12163_length_797_cov_6.068768	357	437	2	32	80	0.4000000
NODE_12163_length_797_cov_6.068768	357	437	3	15	80	0.1875000
NODE_12163_length_797_cov_6.068768	410	490	2	12	80	0.1500000
NODE_12163_length_797_cov_6.068768	410	490	3	53	80	0.6625000
NODE_12163_length_797_cov_6.068768	410	490	4	15	80	0.1875000
NODE_12186_length_796_cov_20.862267	262	342	0	80	80	1.0000000
NODE_12186_length_796_cov_20.862267	315	395	0	80	80	1.0000000
NODE_12187_length_796_cov_18.291248	283	363	0	80	80	1.0000000
NODE_12187_length_796_cov_18.291248	336	416	0	80	80	1.0000000
NODE_12189_length_796_cov_7.880918	388	460	0	72	72	1.0000000
NODE_12189_length_796_cov_7.880918	442	513	0	71	71	1.0000000
NODE_12216_length_795_cov_31.729885	298	378	0	80	80	1.0000000
NODE_12216_length_795_cov_31.729885	351	431	0	80	80	1.0000000
NODE_12217_length_795_cov_26.760057	367	447	2	21	80	0.2625000
NODE_12217_length_795_cov_26.760057	367	447	4	59	80	0.7375000
NODE_12217_length_795_cov_26.760057	420	500	4	80	80	1.0000000
NODE_12218_length_795_cov_24.522989	352	432	0	80	80	1.0000000
NODE_12218_length_795_cov_24.522989	405	485	0	80	80	1.0000000
NODE_12219_length_795_cov_22.747126	363	443	0	80	80	1.0000000
NODE_12219_length_795_cov_22.747126	416	496	0	80	80	1.0000000
NODE_12220_length_795_cov_9.439655	425	505	0	75	80	0.9375000
NODE_12220_length_795_cov_9.439655	425	505	2	5	80	0.0625000
NODE_12220_length_795_cov_9.439655	478	558	0	22	80	0.2750000
NODE_12220_length_795_cov_9.439655	478	558	2	58	80	0.7250000
NODE_12232_length_795_cov_3.359195	349	429	0	80	80	1.0000000
NODE_12232_length_795_cov_3.359195	402	482	0	80	80	1.0000000
NODE_12256_length_794_cov_24.680576	326	406	51	32	80	0.4000000
NODE_12256_length_794_cov_24.680576	326	406	52	26	80	0.3250000
NODE_12256_length_794_cov_24.680576	326	406	53	10	80	0.1250000
NODE_12256_length_794_cov_24.680576	326	406	54	12	80	0.1500000
NODE_12256_length_794_cov_24.680576	379	459	0	25	80	0.3125000
NODE_12256_length_794_cov_24.680576	379	459	50	19	80	0.2375000
NODE_12256_length_794_cov_24.680576	379	459	51	36	80	0.4500000
NODE_12257_length_794_cov_20.057554	153	233	0	80	80	1.0000000
NODE_12257_length_794_cov_20.057554	206	286	0	80	80	1.0000000
NODE_12257_length_794_cov_20.057554	282	362	0	80	80	1.0000000
NODE_12257_length_794_cov_20.057554	335	415	0	80	80	1.0000000
NODE_12258_length_794_cov_16.602878	361	441	0	80	80	1.0000000
NODE_12258_length_794_cov_16.602878	414	494	0	80	80	1.0000000
NODE_12259_length_794_cov_16.362590	337	417	0	80	80	1.0000000
NODE_12259_length_794_cov_16.362590	390	470	0	80	80	1.0000000
NODE_12260_length_794_cov_14.444604	101	160	0	59	59	1.0000000
NODE_12260_length_794_cov_14.444604	409	489	0	80	80	1.0000000
NODE_12260_length_794_cov_14.444604	462	542	0	80	80	1.0000000
NODE_12261_length_794_cov_12.866187	442	522	0	80	80	1.0000000
NODE_12261_length_794_cov_12.866187	495	575	0	80	80	1.0000000
NODE_12262_length_794_cov_12.287770	235	315	2	15	80	0.1875000
NODE_12262_length_794_cov_12.287770	235	315	4	22	80	0.2750000
NODE_12262_length_794_cov_12.287770	235	315	6	43	80	0.5375000
NODE_12262_length_794_cov_12.287770	288	368	0	46	80	0.5750000
NODE_12262_length_794_cov_12.287770	288	368	2	22	80	0.2750000
NODE_12262_length_794_cov_12.287770	288	368	4	2	80	0.0250000
NODE_12262_length_794_cov_12.287770	288	368	6	10	80	0.1250000
NODE_12263_length_794_cov_11.210072	315	395	0	80	80	1.0000000
NODE_12263_length_794_cov_11.210072	368	448	0	80	80	1.0000000
NODE_12264_length_794_cov_10.638849	325	406	0	81	81	1.0000000
NODE_12264_length_794_cov_10.638849	379	459	0	80	80	1.0000000
NODE_12266_length_794_cov_6.274820	412	492	0	34	80	0.4250000
NODE_12266_length_794_cov_6.274820	412	492	2	46	80	0.5750000
NODE_12266_length_794_cov_6.274820	465	545	0	27	80	0.3375000
NODE_12266_length_794_cov_6.274820	465	545	2	53	80	0.6625000
NODE_12271_length_794_cov_3.197122	273	338	0	65	65	1.0000000
NODE_12282_length_794_cov_1.848921	246	326	0	55	80	0.6875000
NODE_12282_length_794_cov_1.848921	246	326	2	25	80	0.3125000
NODE_12282_length_794_cov_1.848921	299	379	0	2	80	0.0250000
NODE_12282_length_794_cov_1.848921	299	379	2	78	80	0.9750000
NODE_12295_length_793_cov_29.878963	326	406	6	80	80	1.0000000
NODE_12295_length_793_cov_29.878963	379	459	0	31	80	0.3875000
NODE_12295_length_793_cov_29.878963	379	459	6	49	80	0.6125000
NODE_12296_length_793_cov_25.981268	310	390	0	80	80	1.0000000
NODE_12296_length_793_cov_25.981268	363	445	0	82	82	1.0000000
NODE_12297_length_793_cov_24.840058	331	411	0	64	80	0.8000000
NODE_12297_length_793_cov_24.840058	331	411	4	16	80	0.2000000
NODE_12297_length_793_cov_24.840058	384	464	0	11	80	0.1375000
NODE_12297_length_793_cov_24.840058	384	464	4	69	80	0.8625000
NODE_12298_length_793_cov_21.707493	398	478	0	80	80	1.0000000
NODE_12298_length_793_cov_21.707493	451	531	0	80	80	1.0000000
NODE_12299_length_793_cov_8.358790	257	337	0	80	80	1.0000000
NODE_12299_length_793_cov_8.358790	310	390	0	80	80	1.0000000
NODE_12300_length_793_cov_8.236311	477	557	0	80	80	1.0000000
NODE_12300_length_793_cov_8.236311	530	610	0	80	80	1.0000000
NODE_12302_length_793_cov_6.763689	461	541	0	80	80	1.0000000
NODE_12302_length_793_cov_6.763689	514	594	0	80	80	1.0000000
NODE_12307_length_793_cov_4.465418	501	549	0	48	48	1.0000000
NODE_12311_length_793_cov_4.138329	174	254	4	74	80	0.9250000
NODE_12311_length_793_cov_4.138329	174	254	6	6	80	0.0750000
NODE_12311_length_793_cov_4.138329	227	307	0	4	80	0.0500000
NODE_12311_length_793_cov_4.138329	227	307	3	1	80	0.0125000
NODE_12311_length_793_cov_4.138329	227	307	4	75	80	0.9375000
NODE_12338_length_792_cov_40.025974	198	278	0	80	80	1.0000000
NODE_12338_length_792_cov_40.025974	251	331	0	80	80	1.0000000
NODE_12338_length_792_cov_40.025974	327	408	0	81	81	1.0000000
NODE_12338_length_792_cov_40.025974	381	461	0	80	80	1.0000000
NODE_12339_length_792_cov_31.176046	331	411	0	80	80	1.0000000
NODE_12339_length_792_cov_31.176046	384	463	0	79	79	1.0000000
NODE_12339_length_792_cov_31.176046	459	539	0	80	80	1.0000000
NODE_12339_length_792_cov_31.176046	512	546	0	34	34	1.0000000
NODE_12340_length_792_cov_21.347763	303	383	0	80	80	1.0000000
NODE_12340_length_792_cov_21.347763	356	436	0	80	80	1.0000000
NODE_12341_length_792_cov_20.142857	361	441	0	33	80	0.4125000
NODE_12341_length_792_cov_20.142857	361	441	2	47	80	0.5875000
NODE_12341_length_792_cov_20.142857	414	494	0	20	80	0.2500000
NODE_12341_length_792_cov_20.142857	414	494	2	60	80	0.7500000
NODE_12342_length_792_cov_18.733045	320	400	0	80	80	1.0000000
NODE_12342_length_792_cov_18.733045	373	453	0	80	80	1.0000000
NODE_12343_length_792_cov_12.024531	369	449	0	80	80	1.0000000
NODE_12343_length_792_cov_12.024531	422	502	0	80	80	1.0000000
NODE_12372_length_791_cov_53.573699	287	359	0	72	72	1.0000000
NODE_12372_length_791_cov_53.573699	332	412	0	80	80	1.0000000
NODE_12373_length_791_cov_40.416185	238	318	0	34	80	0.4250000
NODE_12373_length_791_cov_40.416185	238	318	4	46	80	0.5750000
NODE_12373_length_791_cov_40.416185	291	371	0	23	80	0.2875000
NODE_12373_length_791_cov_40.416185	291	371	3	1	80	0.0125000
NODE_12373_length_791_cov_40.416185	291	371	4	56	80	0.7000000
NODE_12374_length_791_cov_38.791908	309	389	0	80	80	1.0000000
NODE_12374_length_791_cov_38.791908	362	442	0	80	80	1.0000000
NODE_12375_length_791_cov_23.468208	328	408	0	80	80	1.0000000
NODE_12375_length_791_cov_23.468208	381	461	0	80	80	1.0000000
NODE_12376_length_791_cov_20.897399	299	379	0	80	80	1.0000000
NODE_12376_length_791_cov_20.897399	352	432	0	80	80	1.0000000
NODE_12377_length_791_cov_13.504335	339	419	0	38	80	0.4750000
NODE_12377_length_791_cov_13.504335	339	419	2	42	80	0.5250000
NODE_12377_length_791_cov_13.504335	392	472	0	59	80	0.7375000
NODE_12377_length_791_cov_13.504335	392	472	2	21	80	0.2625000
NODE_12379_length_791_cov_12.547688	338	418	0	9	80	0.1125000
NODE_12379_length_791_cov_12.547688	338	418	2	71	80	0.8875000
NODE_12379_length_791_cov_12.547688	391	471	2	80	80	1.0000000
NODE_12380_length_791_cov_11.791908	440	520	0	80	80	1.0000000
NODE_12380_length_791_cov_11.791908	493	573	0	80	80	1.0000000
NODE_12381_length_791_cov_11.011561	337	417	0	80	80	1.0000000
NODE_12381_length_791_cov_11.011561	390	470	0	80	80	1.0000000
NODE_12382_length_791_cov_8.757225	325	405	0	80	80	1.0000000
NODE_12382_length_791_cov_8.757225	378	458	0	80	80	1.0000000
NODE_12384_length_791_cov_8.125723	416	496	0	80	80	1.0000000
NODE_12384_length_791_cov_8.125723	469	549	0	80	80	1.0000000
NODE_12409_length_790_cov_48.021708	526	606	0	80	80	1.0000000
NODE_12409_length_790_cov_48.021708	579	659	0	80	80	1.0000000
NODE_12410_length_790_cov_44.151954	343	423	0	80	80	1.0000000
NODE_12410_length_790_cov_44.151954	396	438	0	42	42	1.0000000
NODE_12410_length_790_cov_44.151954	696	776	2	80	80	1.0000000
NODE_12411_length_790_cov_27.144718	291	371	0	80	80	1.0000000
NODE_12411_length_790_cov_27.144718	344	424	0	80	80	1.0000000
NODE_12412_length_790_cov_16.973951	232	312	0	80	80	1.0000000
NODE_12412_length_790_cov_16.973951	285	365	0	80	80	1.0000000
NODE_12413_length_790_cov_13.374819	204	284	0	80	80	1.0000000
NODE_12413_length_790_cov_13.374819	257	337	0	80	80	1.0000000
NODE_12415_length_790_cov_10.613603	302	382	0	80	80	1.0000000
NODE_12415_length_790_cov_10.613603	355	435	0	80	80	1.0000000
NODE_12418_length_790_cov_5.493488	271	351	0	80	80	1.0000000
NODE_12418_length_790_cov_5.493488	324	404	0	80	80	1.0000000
NODE_12434_length_790_cov_1.463097	313	376	0	63	63	1.0000000
NODE_12452_length_789_cov_39.123188	226	306	0	80	80	1.0000000
NODE_12452_length_789_cov_39.123188	279	359	0	80	80	1.0000000
NODE_12453_length_789_cov_37.205797	423	503	0	80	80	1.0000000
NODE_12453_length_789_cov_37.205797	476	556	0	80	80	1.0000000
NODE_12454_length_789_cov_31.311594	223	303	0	6	80	0.0750000
NODE_12454_length_789_cov_31.311594	223	303	2	74	80	0.9250000
NODE_12454_length_789_cov_31.311594	276	356	0	6	80	0.0750000
NODE_12454_length_789_cov_31.311594	276	356	2	74	80	0.9250000
NODE_12455_length_789_cov_30.536232	306	386	0	80	80	1.0000000
NODE_12455_length_789_cov_30.536232	359	439	0	80	80	1.0000000
NODE_12456_length_789_cov_24.886957	343	423	0	80	80	1.0000000
NODE_12456_length_789_cov_24.886957	396	476	0	80	80	1.0000000
NODE_12457_length_789_cov_23.539130	357	437	0	18	80	0.2250000
NODE_12457_length_789_cov_23.539130	357	437	4	62	80	0.7750000
NODE_12457_length_789_cov_23.539130	410	490	0	71	80	0.8875000
NODE_12457_length_789_cov_23.539130	410	490	4	9	80	0.1125000
NODE_12458_length_789_cov_16.169565	392	472	0	80	80	1.0000000
NODE_12458_length_789_cov_16.169565	445	525	0	80	80	1.0000000
NODE_12459_length_789_cov_15.175362	242	322	0	80	80	1.0000000
NODE_12459_length_789_cov_15.175362	295	375	0	80	80	1.0000000
NODE_12459_length_789_cov_15.175362	371	451	0	80	80	1.0000000
NODE_12459_length_789_cov_15.175362	424	504	0	80	80	1.0000000
NODE_12460_length_789_cov_7.276812	306	386	0	80	80	1.0000000
NODE_12460_length_789_cov_7.276812	359	439	0	80	80	1.0000000
NODE_12482_length_788_cov_43.091437	335	415	0	80	80	1.0000000
NODE_12482_length_788_cov_43.091437	388	460	0	72	72	1.0000000
NODE_12483_length_788_cov_38.914369	345	425	2	19	80	0.2375000
NODE_12483_length_788_cov_38.914369	345	425	12	57	80	0.7125000
NODE_12483_length_788_cov_38.914369	345	425	14	4	80	0.0500000
NODE_12483_length_788_cov_38.914369	398	478	0	10	80	0.1250000
NODE_12483_length_788_cov_38.914369	398	478	11	1	80	0.0125000
NODE_12483_length_788_cov_38.914369	398	478	12	69	80	0.8625000
NODE_12484_length_788_cov_36.148041	320	400	0	62	80	0.7750000
NODE_12484_length_788_cov_36.148041	320	400	2	18	80	0.2250000
NODE_12484_length_788_cov_36.148041	373	453	0	9	80	0.1125000
NODE_12484_length_788_cov_36.148041	373	453	2	71	80	0.8875000
NODE_12485_length_788_cov_35.460087	346	426	7	40	80	0.5000000
NODE_12485_length_788_cov_35.460087	346	426	8	40	80	0.5000000
NODE_12485_length_788_cov_35.460087	399	479	1	9	80	0.1125000
NODE_12485_length_788_cov_35.460087	399	479	2	44	80	0.5500000
NODE_12485_length_788_cov_35.460087	399	479	8	27	80	0.3375000
NODE_12486_length_788_cov_30.785196	278	358	0	80	80	1.0000000
NODE_12486_length_788_cov_30.785196	331	411	0	80	80	1.0000000
NODE_12488_length_788_cov_20.867925	300	380	0	48	80	0.6000000
NODE_12488_length_788_cov_20.867925	300	380	4	32	80	0.4000000
NODE_12488_length_788_cov_20.867925	353	430	4	77	77	1.0000000
NODE_12489_length_788_cov_20.821480	322	402	0	80	80	1.0000000
NODE_12489_length_788_cov_20.821480	375	455	0	80	80	1.0000000
NODE_12490_length_788_cov_15.570392	342	422	0	30	80	0.3750000
NODE_12490_length_788_cov_15.570392	342	422	2	11	80	0.1375000
NODE_12490_length_788_cov_15.570392	342	422	4	39	80	0.4875000
NODE_12490_length_788_cov_15.570392	395	475	4	80	80	1.0000000
NODE_12491_length_788_cov_12.235123	241	321	0	80	80	1.0000000
NODE_12491_length_788_cov_12.235123	294	374	0	80	80	1.0000000
NODE_12492_length_788_cov_10.509434	405	480	0	75	75	1.0000000
NODE_12493_length_788_cov_9.737300	310	390	4	80	80	1.0000000
NODE_12493_length_788_cov_9.737300	363	443	0	51	80	0.6375000
NODE_12493_length_788_cov_9.737300	363	443	4	29	80	0.3625000
NODE_12494_length_788_cov_8.872279	280	360	0	80	80	1.0000000
NODE_12494_length_788_cov_8.872279	333	413	0	80	80	1.0000000
NODE_12516_length_787_cov_34.683140	274	335	0	61	61	1.0000000
NODE_12516_length_787_cov_34.683140	319	380	0	61	61	1.0000000
NODE_12517_length_787_cov_28.039244	252	329	0	77	77	1.0000000
NODE_12517_length_787_cov_28.039244	302	370	0	68	68	1.0000000
NODE_12518_length_787_cov_25.422965	351	431	0	5	80	0.0625000
NODE_12518_length_787_cov_25.422965	351	431	1	65	80	0.8125000
NODE_12518_length_787_cov_25.422965	351	431	2	10	80	0.1250000
NODE_12518_length_787_cov_25.422965	404	484	0	58	80	0.7250000
NODE_12518_length_787_cov_25.422965	404	484	1	22	80	0.2750000
NODE_12519_length_787_cov_24.857558	319	399	0	80	80	1.0000000
NODE_12519_length_787_cov_24.857558	372	452	0	80	80	1.0000000
NODE_12520_length_787_cov_21.357558	291	371	0	80	80	1.0000000
NODE_12520_length_787_cov_21.357558	344	424	0	80	80	1.0000000
NODE_12521_length_787_cov_17.360465	396	476	0	80	80	1.0000000
NODE_12521_length_787_cov_17.360465	449	529	0	80	80	1.0000000
NODE_12522_length_787_cov_14.677326	178	258	0	80	80	1.0000000
NODE_12522_length_787_cov_14.677326	231	311	0	75	80	0.9375000
NODE_12522_length_787_cov_14.677326	231	311	2	5	80	0.0625000
NODE_12523_length_787_cov_12.959302	331	411	0	80	80	1.0000000
NODE_12523_length_787_cov_12.959302	384	464	0	80	80	1.0000000
NODE_12524_length_787_cov_12.748547	426	506	0	80	80	1.0000000
NODE_12524_length_787_cov_12.748547	479	559	0	80	80	1.0000000
NODE_12525_length_787_cov_12.369186	338	418	0	80	80	1.0000000
NODE_12525_length_787_cov_12.369186	391	471	0	80	80	1.0000000
NODE_12526_length_787_cov_9.213663	376	456	0	80	80	1.0000000
NODE_12527_length_787_cov_8.857558	344	424	0	80	80	1.0000000
NODE_12527_length_787_cov_8.857558	397	477	0	80	80	1.0000000
NODE_12529_length_787_cov_8.186047	508	552	0	44	44	1.0000000
NODE_12541_length_787_cov_2.188953	505	552	8	3	47	0.0638298
NODE_12541_length_787_cov_2.188953	505	552	12	1	47	0.0212766
NODE_12541_length_787_cov_2.188953	505	552	14	23	47	0.4893617
NODE_12541_length_787_cov_2.188953	505	552	16	20	47	0.4255319
NODE_12562_length_786_cov_36.441048	431	511	0	80	80	1.0000000
NODE_12562_length_786_cov_36.441048	484	564	0	80	80	1.0000000
NODE_12563_length_786_cov_23.771470	235	315	0	80	80	1.0000000
NODE_12563_length_786_cov_23.771470	288	368	0	80	80	1.0000000
NODE_12564_length_786_cov_23.333333	361	436	1	32	75	0.4266667
NODE_12564_length_786_cov_23.333333	361	436	3	3	75	0.0400000
NODE_12564_length_786_cov_23.333333	361	436	4	26	75	0.3466667
NODE_12564_length_786_cov_23.333333	361	436	5	1	75	0.0133333
NODE_12564_length_786_cov_23.333333	361	436	6	5	75	0.0666667
NODE_12564_length_786_cov_23.333333	361	436	7	1	75	0.0133333
NODE_12564_length_786_cov_23.333333	361	436	8	7	75	0.0933333
NODE_12564_length_786_cov_23.333333	362	436	1	31	74	0.4189189
NODE_12564_length_786_cov_23.333333	362	436	3	3	74	0.0405405
NODE_12564_length_786_cov_23.333333	362	436	4	26	74	0.3513514
NODE_12564_length_786_cov_23.333333	362	436	5	1	74	0.0135135
NODE_12564_length_786_cov_23.333333	362	436	6	5	74	0.0675676
NODE_12564_length_786_cov_23.333333	362	436	7	1	74	0.0135135
NODE_12564_length_786_cov_23.333333	362	436	8	7	74	0.0945946
NODE_12564_length_786_cov_23.333333	375	436	1	18	61	0.2950820
NODE_12564_length_786_cov_23.333333	375	436	3	3	61	0.0491803
NODE_12564_length_786_cov_23.333333	375	436	4	26	61	0.4262295
NODE_12564_length_786_cov_23.333333	375	436	5	1	61	0.0163934
NODE_12564_length_786_cov_23.333333	375	436	6	5	61	0.0819672
NODE_12564_length_786_cov_23.333333	375	436	7	1	61	0.0163934
NODE_12564_length_786_cov_23.333333	375	436	8	7	61	0.1147541
NODE_12564_length_786_cov_23.333333	414	489	4	8	75	0.1066667
NODE_12564_length_786_cov_23.333333	414	489	5	11	75	0.1466667
NODE_12564_length_786_cov_23.333333	414	489	6	5	75	0.0666667
NODE_12564_length_786_cov_23.333333	414	489	7	2	75	0.0266667
NODE_12564_length_786_cov_23.333333	414	489	8	49	75	0.6533333
NODE_12564_length_786_cov_23.333333	414	489	4	8	75	0.1066667
NODE_12564_length_786_cov_23.333333	414	489	5	11	75	0.1466667
NODE_12564_length_786_cov_23.333333	414	489	6	5	75	0.0666667
NODE_12564_length_786_cov_23.333333	414	489	7	2	75	0.0266667
NODE_12564_length_786_cov_23.333333	414	489	8	49	75	0.6533333
NODE_12564_length_786_cov_23.333333	414	489	4	8	75	0.1066667
NODE_12564_length_786_cov_23.333333	414	489	5	11	75	0.1466667
NODE_12564_length_786_cov_23.333333	414	489	6	5	75	0.0666667
NODE_12564_length_786_cov_23.333333	414	489	7	2	75	0.0266667
NODE_12564_length_786_cov_23.333333	414	489	8	49	75	0.6533333
NODE_12564_length_786_cov_23.333333	490	564	4	21	74	0.2837838
NODE_12564_length_786_cov_23.333333	490	564	5	11	74	0.1486486
NODE_12564_length_786_cov_23.333333	490	564	6	20	74	0.2702703
NODE_12564_length_786_cov_23.333333	490	564	8	22	74	0.2972973
NODE_12565_length_786_cov_19.279476	310	375	0	65	65	1.0000000
NODE_12565_length_786_cov_19.279476	371	441	0	70	70	1.0000000
NODE_12565_length_786_cov_19.279476	371	451	0	80	80	1.0000000
NODE_12565_length_786_cov_19.279476	424	491	0	67	67	1.0000000
NODE_12566_length_786_cov_18.652111	251	331	0	80	80	1.0000000
NODE_12566_length_786_cov_18.652111	304	384	0	80	80	1.0000000
NODE_12567_length_786_cov_16.704512	319	399	0	80	80	1.0000000
NODE_12567_length_786_cov_16.704512	372	452	0	66	80	0.8250000
NODE_12567_length_786_cov_16.704512	372	452	2	14	80	0.1750000
NODE_12568_length_786_cov_16.254731	378	458	0	80	80	1.0000000
NODE_12568_length_786_cov_16.254731	431	511	0	80	80	1.0000000
NODE_12571_length_786_cov_10.053857	381	461	0	80	80	1.0000000
NODE_12571_length_786_cov_10.053857	434	514	0	80	80	1.0000000
NODE_12572_length_786_cov_7.455604	400	473	0	73	73	1.0000000
NODE_12572_length_786_cov_7.455604	453	533	0	80	80	1.0000000
NODE_12573_length_786_cov_7.119360	276	356	0	80	80	1.0000000
NODE_12573_length_786_cov_7.119360	329	409	0	80	80	1.0000000
NODE_12575_length_786_cov_6.771470	382	462	0	80	80	1.0000000
NODE_12575_length_786_cov_6.771470	435	515	0	80	80	1.0000000
NODE_12603_length_785_cov_83.972303	315	395	0	80	80	1.0000000
NODE_12603_length_785_cov_83.972303	368	448	0	80	80	1.0000000
NODE_12604_length_785_cov_33.911079	477	557	0	80	80	1.0000000
NODE_12604_length_785_cov_33.911079	530	610	0	80	80	1.0000000
NODE_12605_length_785_cov_21.174927	265	299	0	34	34	1.0000000
NODE_12605_length_785_cov_21.174927	295	375	0	80	80	1.0000000
NODE_12605_length_785_cov_21.174927	348	428	0	80	80	1.0000000
NODE_12606_length_785_cov_18.612245	291	371	0	80	80	1.0000000
NODE_12606_length_785_cov_18.612245	344	424	0	80	80	1.0000000
NODE_12606_length_785_cov_18.612245	684	705	0	21	21	1.0000000
NODE_12607_length_785_cov_9.893586	153	233	0	47	80	0.5875000
NODE_12607_length_785_cov_9.893586	153	233	2	33	80	0.4125000
NODE_12607_length_785_cov_9.893586	206	286	0	80	80	1.0000000
NODE_12645_length_784_cov_203.604380	5	85	5	4	80	0.0500000
NODE_12645_length_784_cov_203.604380	5	85	9	1	80	0.0125000
NODE_12645_length_784_cov_203.604380	5	85	11	1	80	0.0125000
NODE_12645_length_784_cov_203.604380	5	85	19	2	80	0.0250000
NODE_12645_length_784_cov_203.604380	5	85	21	5	80	0.0625000
NODE_12645_length_784_cov_203.604380	5	85	27	1	80	0.0125000
NODE_12645_length_784_cov_203.604380	5	85	30	1	80	0.0125000
NODE_12645_length_784_cov_203.604380	5	85	31	8	80	0.1000000
NODE_12645_length_784_cov_203.604380	5	85	37	2	80	0.0250000
NODE_12645_length_784_cov_203.604380	5	85	40	8	80	0.1000000
NODE_12645_length_784_cov_203.604380	5	85	41	1	80	0.0125000
NODE_12645_length_784_cov_203.604380	5	85	43	1	80	0.0125000
NODE_12645_length_784_cov_203.604380	5	85	49	1	80	0.0125000
NODE_12645_length_784_cov_203.604380	5	85	51	2	80	0.0250000
NODE_12645_length_784_cov_203.604380	5	85	55	8	80	0.1000000
NODE_12645_length_784_cov_203.604380	5	85	59	2	80	0.0250000
NODE_12645_length_784_cov_203.604380	5	85	61	1	80	0.0125000
NODE_12645_length_784_cov_203.604380	5	85	63	1	80	0.0125000
NODE_12645_length_784_cov_203.604380	5	85	68	2	80	0.0250000
NODE_12645_length_784_cov_203.604380	5	85	75	3	80	0.0375000
NODE_12645_length_784_cov_203.604380	5	85	79	3	80	0.0375000
NODE_12645_length_784_cov_203.604380	5	85	81	1	80	0.0125000
NODE_12645_length_784_cov_203.604380	5	85	82	1	80	0.0125000
NODE_12645_length_784_cov_203.604380	5	85	83	4	80	0.0500000
NODE_12645_length_784_cov_203.604380	5	85	85	1	80	0.0125000
NODE_12645_length_784_cov_203.604380	5	85	86	1	80	0.0125000
NODE_12645_length_784_cov_203.604380	5	85	88	2	80	0.0250000
NODE_12645_length_784_cov_203.604380	5	85	91	4	80	0.0500000
NODE_12645_length_784_cov_203.604380	5	85	98	1	80	0.0125000
NODE_12645_length_784_cov_203.604380	5	85	100	1	80	0.0125000
NODE_12645_length_784_cov_203.604380	5	85	102	1	80	0.0125000
NODE_12645_length_784_cov_203.604380	5	85	104	1	80	0.0125000
NODE_12645_length_784_cov_203.604380	5	85	106	1	80	0.0125000
NODE_12645_length_784_cov_203.604380	5	85	108	1	80	0.0125000
NODE_12645_length_784_cov_203.604380	5	85	109	2	80	0.0250000
NODE_12645_length_784_cov_203.604380	58	138	75	2	80	0.0250000
NODE_12645_length_784_cov_203.604380	58	138	79	3	80	0.0375000
NODE_12645_length_784_cov_203.604380	58	138	81	1	80	0.0125000
NODE_12645_length_784_cov_203.604380	58	138	82	1	80	0.0125000
NODE_12645_length_784_cov_203.604380	58	138	83	4	80	0.0500000
NODE_12645_length_784_cov_203.604380	58	138	85	1	80	0.0125000
NODE_12645_length_784_cov_203.604380	58	138	86	1	80	0.0125000
NODE_12645_length_784_cov_203.604380	58	138	88	2	80	0.0250000
NODE_12645_length_784_cov_203.604380	58	138	91	4	80	0.0500000
NODE_12645_length_784_cov_203.604380	58	138	98	1	80	0.0125000
NODE_12645_length_784_cov_203.604380	58	138	100	1	80	0.0125000
NODE_12645_length_784_cov_203.604380	58	138	102	1	80	0.0125000
NODE_12645_length_784_cov_203.604380	58	138	104	1	80	0.0125000
NODE_12645_length_784_cov_203.604380	58	138	106	1	80	0.0125000
NODE_12645_length_784_cov_203.604380	58	138	108	1	80	0.0125000
NODE_12645_length_784_cov_203.604380	58	138	109	2	80	0.0250000
NODE_12645_length_784_cov_203.604380	58	138	113	3	80	0.0375000
NODE_12645_length_784_cov_203.604380	58	138	117	1	80	0.0125000
NODE_12645_length_784_cov_203.604380	58	138	122	1	80	0.0125000
NODE_12645_length_784_cov_203.604380	58	138	124	2	80	0.0250000
NODE_12645_length_784_cov_203.604380	58	138	133	1	80	0.0125000
NODE_12645_length_784_cov_203.604380	58	138	139	1	80	0.0125000
NODE_12645_length_784_cov_203.604380	58	138	151	1	80	0.0125000
NODE_12645_length_784_cov_203.604380	58	138	153	1	80	0.0125000
NODE_12645_length_784_cov_203.604380	58	138	159	1	80	0.0125000
NODE_12645_length_784_cov_203.604380	58	138	161	1	80	0.0125000
NODE_12645_length_784_cov_203.604380	58	138	165	1	80	0.0125000
NODE_12645_length_784_cov_203.604380	58	138	169	1	80	0.0125000
NODE_12645_length_784_cov_203.604380	58	138	172	3	80	0.0375000
NODE_12645_length_784_cov_203.604380	58	138	174	1	80	0.0125000
NODE_12645_length_784_cov_203.604380	58	138	175	2	80	0.0250000
NODE_12645_length_784_cov_203.604380	58	138	178	1	80	0.0125000
NODE_12645_length_784_cov_203.604380	58	138	180	1	80	0.0125000
NODE_12645_length_784_cov_203.604380	58	138	186	2	80	0.0250000
NODE_12645_length_784_cov_203.604380	58	138	189	4	80	0.0500000
NODE_12645_length_784_cov_203.604380	58	138	190	2	80	0.0250000
NODE_12645_length_784_cov_203.604380	58	138	191	1	80	0.0125000
NODE_12645_length_784_cov_203.604380	58	138	192	1	80	0.0125000
NODE_12645_length_784_cov_203.604380	58	138	193	1	80	0.0125000
NODE_12645_length_784_cov_203.604380	58	138	194	1	80	0.0125000
NODE_12645_length_784_cov_203.604380	58	138	195	2	80	0.0250000
NODE_12645_length_784_cov_203.604380	58	138	196	1	80	0.0125000
NODE_12645_length_784_cov_203.604380	58	138	200	1	80	0.0125000
NODE_12645_length_784_cov_203.604380	58	138	207	1	80	0.0125000
NODE_12645_length_784_cov_203.604380	58	138	213	4	80	0.0500000
NODE_12645_length_784_cov_203.604380	58	138	215	2	80	0.0250000
NODE_12645_length_784_cov_203.604380	58	138	219	2	80	0.0250000
NODE_12645_length_784_cov_203.604380	58	138	222	2	80	0.0250000
NODE_12645_length_784_cov_203.604380	58	138	226	1	80	0.0125000
NODE_12645_length_784_cov_203.604380	58	138	232	1	80	0.0125000
NODE_12645_length_784_cov_203.604380	58	138	234	1	80	0.0125000
NODE_12646_length_784_cov_45.210219	49	129	0	80	80	1.0000000
NODE_12646_length_784_cov_45.210219	102	182	0	80	80	1.0000000
NODE_12646_length_784_cov_45.210219	218	298	0	80	80	1.0000000
NODE_12646_length_784_cov_45.210219	271	351	0	42	80	0.5250000
NODE_12646_length_784_cov_45.210219	271	351	4	38	80	0.4750000
NODE_12646_length_784_cov_45.210219	347	427	4	80	80	1.0000000
NODE_12646_length_784_cov_45.210219	347	427	4	80	80	1.0000000
NODE_12646_length_784_cov_45.210219	347	427	4	80	80	1.0000000
NODE_12646_length_784_cov_45.210219	400	447	0	20	47	0.4255319
NODE_12646_length_784_cov_45.210219	400	447	4	27	47	0.5744681
NODE_12646_length_784_cov_45.210219	400	480	0	53	80	0.6625000
NODE_12646_length_784_cov_45.210219	400	480	4	27	80	0.3375000
NODE_12646_length_784_cov_45.210219	400	455	0	28	55	0.5090909
NODE_12646_length_784_cov_45.210219	400	455	4	27	55	0.4909091
NODE_12647_length_784_cov_33.543066	405	485	0	80	80	1.0000000
NODE_12647_length_784_cov_33.543066	458	538	0	80	80	1.0000000
NODE_12648_length_784_cov_21.762044	318	398	0	80	80	1.0000000
NODE_12648_length_784_cov_21.762044	371	451	0	80	80	1.0000000
NODE_12649_length_784_cov_20.583942	286	366	0	80	80	1.0000000
NODE_12649_length_784_cov_20.583942	339	419	0	80	80	1.0000000
NODE_12649_length_784_cov_20.583942	415	495	0	80	80	1.0000000
NODE_12649_length_784_cov_20.583942	468	548	0	80	80	1.0000000
NODE_12650_length_784_cov_19.448175	217	297	0	80	80	1.0000000
NODE_12650_length_784_cov_19.448175	270	350	0	80	80	1.0000000
NODE_12652_length_784_cov_12.480292	297	377	0	80	80	1.0000000
NODE_12652_length_784_cov_12.480292	350	430	0	80	80	1.0000000
NODE_12653_length_784_cov_9.296350	250	330	0	80	80	1.0000000
NODE_12653_length_784_cov_9.296350	303	383	0	80	80	1.0000000
NODE_12653_length_784_cov_9.296350	379	459	0	80	80	1.0000000
NODE_12653_length_784_cov_9.296350	432	512	0	80	80	1.0000000
NODE_12654_length_784_cov_6.316788	274	354	0	80	80	1.0000000
NODE_12654_length_784_cov_6.316788	327	407	0	80	80	1.0000000
NODE_12688_length_783_cov_41.849415	459	539	0	80	80	1.0000000
NODE_12688_length_783_cov_41.849415	512	592	0	80	80	1.0000000
NODE_12689_length_783_cov_39.881579	230	310	0	80	80	1.0000000
NODE_12689_length_783_cov_39.881579	283	363	0	80	80	1.0000000
NODE_12689_length_783_cov_39.881579	359	439	0	80	80	1.0000000
NODE_12689_length_783_cov_39.881579	412	492	0	80	80	1.0000000
NODE_12690_length_783_cov_35.967836	229	309	0	80	80	1.0000000
NODE_12690_length_783_cov_35.967836	282	362	0	80	80	1.0000000
NODE_12691_length_783_cov_28.203216	292	372	0	80	80	1.0000000
NODE_12691_length_783_cov_28.203216	345	425	0	80	80	1.0000000
NODE_12692_length_783_cov_16.695906	393	473	0	8	80	0.1000000
NODE_12692_length_783_cov_16.695906	393	473	2	72	80	0.9000000
NODE_12692_length_783_cov_16.695906	446	526	0	61	80	0.7625000
NODE_12692_length_783_cov_16.695906	446	526	2	19	80	0.2375000
NODE_12693_length_783_cov_15.656433	418	498	0	68	80	0.8500000
NODE_12693_length_783_cov_15.656433	418	498	2	12	80	0.1500000
NODE_12693_length_783_cov_15.656433	471	551	0	15	80	0.1875000
NODE_12693_length_783_cov_15.656433	471	551	2	65	80	0.8125000
NODE_12694_length_783_cov_14.904971	321	401	0	15	80	0.1875000
NODE_12694_length_783_cov_14.904971	321	401	9	1	80	0.0125000
NODE_12694_length_783_cov_14.904971	321	401	10	64	80	0.8000000
NODE_12694_length_783_cov_14.904971	374	454	10	80	80	1.0000000
NODE_12728_length_782_cov_22.461201	347	427	0	80	80	1.0000000
NODE_12728_length_782_cov_22.461201	400	480	0	80	80	1.0000000
NODE_12729_length_782_cov_19.163982	306	386	0	80	80	1.0000000
NODE_12729_length_782_cov_19.163982	382	462	0	80	80	1.0000000
NODE_12729_length_782_cov_19.163982	435	515	0	80	80	1.0000000
NODE_12730_length_782_cov_19.090776	295	375	0	80	80	1.0000000
NODE_12730_length_782_cov_19.090776	348	428	0	80	80	1.0000000
NODE_12731_length_782_cov_13.509517	323	403	0	80	80	1.0000000
NODE_12731_length_782_cov_13.509517	376	456	0	80	80	1.0000000
NODE_12732_length_782_cov_11.364568	367	447	0	80	80	1.0000000
NODE_12732_length_782_cov_11.364568	420	500	0	80	80	1.0000000
NODE_12735_length_782_cov_7.976574	245	325	0	80	80	1.0000000
NODE_12735_length_782_cov_7.976574	298	378	0	80	80	1.0000000
NODE_12737_length_782_cov_5.500732	384	464	0	80	80	1.0000000
NODE_12737_length_782_cov_5.500732	437	517	0	80	80	1.0000000
NODE_12739_length_782_cov_4.434846	309	389	0	80	80	1.0000000
NODE_12739_length_782_cov_4.434846	362	442	0	80	80	1.0000000
NODE_12740_length_782_cov_3.352855	177	196	0	19	19	1.0000000
NODE_12741_length_782_cov_3.231332	160	240	0	19	80	0.2375000
NODE_12741_length_782_cov_3.231332	160	240	2	61	80	0.7625000
NODE_12741_length_782_cov_3.231332	213	298	0	30	85	0.3529412
NODE_12741_length_782_cov_3.231332	213	298	2	55	85	0.6470588
NODE_12765_length_781_cov_34.247801	174	254	0	80	80	1.0000000
NODE_12765_length_781_cov_34.247801	227	307	0	80	80	1.0000000
NODE_12766_length_781_cov_27.530792	490	570	28	5	80	0.0625000
NODE_12766_length_781_cov_27.530792	490	570	29	6	80	0.0750000
NODE_12766_length_781_cov_27.530792	490	570	30	23	80	0.2875000
NODE_12766_length_781_cov_27.530792	490	570	31	8	80	0.1000000
NODE_12766_length_781_cov_27.530792	490	570	32	38	80	0.4750000
NODE_12766_length_781_cov_27.530792	543	623	0	2	80	0.0250000
NODE_12766_length_781_cov_27.530792	543	623	2	31	80	0.3875000
NODE_12766_length_781_cov_27.530792	543	623	16	12	80	0.1500000
NODE_12766_length_781_cov_27.530792	543	623	17	1	80	0.0125000
NODE_12766_length_781_cov_27.530792	543	623	28	12	80	0.1500000
NODE_12766_length_781_cov_27.530792	543	623	29	6	80	0.0750000
NODE_12766_length_781_cov_27.530792	543	623	30	2	80	0.0250000
NODE_12766_length_781_cov_27.530792	543	623	31	8	80	0.1000000
NODE_12766_length_781_cov_27.530792	543	623	32	6	80	0.0750000
NODE_12766_length_781_cov_27.530792	619	699	0	78	80	0.9750000
NODE_12766_length_781_cov_27.530792	619	699	2	2	80	0.0250000
NODE_12766_length_781_cov_27.530792	672	752	0	80	80	1.0000000
NODE_12767_length_781_cov_22.768328	427	507	0	80	80	1.0000000
NODE_12767_length_781_cov_22.768328	480	560	0	80	80	1.0000000
NODE_12768_length_781_cov_17.894428	411	491	1	80	80	1.0000000
NODE_12768_length_781_cov_17.894428	464	544	0	13	80	0.1625000
NODE_12768_length_781_cov_17.894428	464	544	1	67	80	0.8375000
NODE_12769_length_781_cov_14.922287	486	565	0	79	79	1.0000000
NODE_12769_length_781_cov_14.922287	538	618	0	80	80	1.0000000
NODE_12770_length_781_cov_12.529326	318	398	0	80	80	1.0000000
NODE_12770_length_781_cov_12.529326	371	451	0	80	80	1.0000000
NODE_12771_length_781_cov_10.303519	444	524	1	2	80	0.0250000
NODE_12771_length_781_cov_10.303519	444	524	2	24	80	0.3000000
NODE_12771_length_781_cov_10.303519	444	524	3	7	80	0.0875000
NODE_12771_length_781_cov_10.303519	444	524	4	47	80	0.5875000
NODE_12772_length_781_cov_9.851906	374	454	0	80	80	1.0000000
NODE_12772_length_781_cov_9.851906	427	507	0	80	80	1.0000000
NODE_12775_length_781_cov_8.557185	113	194	0	81	81	1.0000000
NODE_12775_length_781_cov_8.557185	166	239	0	73	73	1.0000000
NODE_12778_length_781_cov_4.734604	30	110	2	80	80	1.0000000
NODE_12778_length_781_cov_4.734604	83	163	0	51	80	0.6375000
NODE_12778_length_781_cov_4.734604	83	163	2	29	80	0.3625000
NODE_12780_length_781_cov_4.077713	269	349	0	80	80	1.0000000
NODE_12780_length_781_cov_4.077713	322	402	0	80	80	1.0000000
NODE_12812_length_780_cov_37.693098	165	245	0	80	80	1.0000000
NODE_12812_length_780_cov_37.693098	218	298	0	80	80	1.0000000
NODE_12813_length_780_cov_22.132159	407	487	6	80	80	1.0000000
NODE_12813_length_780_cov_22.132159	460	540	0	17	80	0.2125000
NODE_12813_length_780_cov_22.132159	460	540	4	8	80	0.1000000
NODE_12813_length_780_cov_22.132159	460	540	6	55	80	0.6875000
NODE_12814_length_780_cov_21.831131	299	379	2	57	80	0.7125000
NODE_12814_length_780_cov_21.831131	299	379	3	15	80	0.1875000
NODE_12814_length_780_cov_21.831131	299	379	4	8	80	0.1000000
NODE_12814_length_780_cov_21.831131	352	432	2	19	80	0.2375000
NODE_12814_length_780_cov_21.831131	352	432	3	53	80	0.6625000
NODE_12814_length_780_cov_21.831131	352	432	4	8	80	0.1000000
NODE_12815_length_780_cov_16.722467	165	245	0	80	80	1.0000000
NODE_12815_length_780_cov_16.722467	218	298	0	80	80	1.0000000
NODE_12816_length_780_cov_13.189427	150	254	0	102	104	0.9807692
NODE_12816_length_780_cov_13.189427	150	254	2	2	104	0.0192308
NODE_12816_length_780_cov_13.189427	227	307	0	80	80	1.0000000
NODE_12817_length_780_cov_12.910426	276	356	0	80	80	1.0000000
NODE_12817_length_780_cov_12.910426	329	409	0	80	80	1.0000000
NODE_12818_length_780_cov_8.455213	141	221	0	80	80	1.0000000
NODE_12818_length_780_cov_8.455213	194	274	0	80	80	1.0000000
NODE_12848_length_779_cov_51.022059	8	43	0	35	35	1.0000000
NODE_12848_length_779_cov_51.022059	53	96	0	23	43	0.5348837
NODE_12848_length_779_cov_51.022059	53	96	2	20	43	0.4651163
NODE_12848_length_779_cov_51.022059	97	177	2	80	80	1.0000000
NODE_12848_length_779_cov_51.022059	150	230	0	44	80	0.5500000
NODE_12848_length_779_cov_51.022059	150	230	2	36	80	0.4500000
NODE_12849_length_779_cov_23.682353	362	442	4	80	80	1.0000000
NODE_12849_length_779_cov_23.682353	415	495	0	42	80	0.5250000
NODE_12849_length_779_cov_23.682353	415	495	2	9	80	0.1125000
NODE_12849_length_779_cov_23.682353	415	495	4	29	80	0.3625000
NODE_12850_length_779_cov_15.994118	320	400	0	4	80	0.0500000
NODE_12850_length_779_cov_15.994118	320	400	17	39	80	0.4875000
NODE_12850_length_779_cov_15.994118	320	400	23	2	80	0.0250000
NODE_12850_length_779_cov_15.994118	320	400	26	35	80	0.4375000
NODE_12850_length_779_cov_15.994118	373	453	0	57	80	0.7125000
NODE_12850_length_779_cov_15.994118	373	453	17	23	80	0.2875000
NODE_12851_length_779_cov_14.386765	258	320	90	6	62	0.0967742
NODE_12851_length_779_cov_14.386765	258	320	91	25	62	0.4032258
NODE_12851_length_779_cov_14.386765	258	320	102	2	62	0.0322581
NODE_12851_length_779_cov_14.386765	258	320	105	3	62	0.0483871
NODE_12851_length_779_cov_14.386765	258	320	106	9	62	0.1451613
NODE_12851_length_779_cov_14.386765	258	320	110	3	62	0.0483871
NODE_12851_length_779_cov_14.386765	258	320	116	14	62	0.2258064
NODE_12851_length_779_cov_14.386765	293	368	103	8	75	0.1066667
NODE_12851_length_779_cov_14.386765	293	368	105	1	75	0.0133333
NODE_12851_length_779_cov_14.386765	293	368	106	9	75	0.1200000
NODE_12851_length_779_cov_14.386765	293	368	110	3	75	0.0400000
NODE_12851_length_779_cov_14.386765	293	368	112	10	75	0.1333333
NODE_12851_length_779_cov_14.386765	293	368	114	1	75	0.0133333
NODE_12851_length_779_cov_14.386765	293	368	115	3	75	0.0400000
NODE_12851_length_779_cov_14.386765	293	368	116	40	75	0.5333334
NODE_12851_length_779_cov_14.386765	369	443	7	2	74	0.0270270
NODE_12851_length_779_cov_14.386765	369	443	10	2	74	0.0270270
NODE_12851_length_779_cov_14.386765	369	443	13	33	74	0.4459459
NODE_12851_length_779_cov_14.386765	369	443	14	4	74	0.0540541
NODE_12851_length_779_cov_14.386765	369	443	21	2	74	0.0270270
NODE_12851_length_779_cov_14.386765	369	443	27	8	74	0.1081081
NODE_12851_length_779_cov_14.386765	369	443	38	11	74	0.1486486
NODE_12851_length_779_cov_14.386765	369	443	39	2	74	0.0270270
NODE_12851_length_779_cov_14.386765	369	443	89	4	74	0.0540541
NODE_12851_length_779_cov_14.386765	369	443	103	6	74	0.0810811
NODE_12852_length_779_cov_11.861765	180	263	0	49	83	0.5903614
NODE_12852_length_779_cov_11.861765	180	263	4	34	83	0.4096386
NODE_12852_length_779_cov_11.861765	236	316	0	80	80	1.0000000
NODE_12852_length_779_cov_11.861765	312	392	0	21	80	0.2625000
NODE_12852_length_779_cov_11.861765	312	392	2	59	80	0.7375000
NODE_12852_length_779_cov_11.861765	365	445	0	47	80	0.5875000
NODE_12852_length_779_cov_11.861765	365	445	2	33	80	0.4125000
NODE_12853_length_779_cov_11.735294	285	365	0	62	80	0.7750000
NODE_12853_length_779_cov_11.735294	285	365	2	18	80	0.2250000
NODE_12853_length_779_cov_11.735294	338	418	0	80	80	1.0000000
NODE_12854_length_779_cov_7.211765	333	413	0	80	80	1.0000000
NODE_12854_length_779_cov_7.211765	386	466	0	80	80	1.0000000
NODE_12857_length_779_cov_5.611765	271	351	0	80	80	1.0000000
NODE_12857_length_779_cov_5.611765	324	404	0	80	80	1.0000000
NODE_12859_length_779_cov_4.695588	216	296	0	40	80	0.5000000
NODE_12859_length_779_cov_4.695588	216	296	6	40	80	0.5000000
NODE_12859_length_779_cov_4.695588	269	349	0	80	80	1.0000000
NODE_12863_length_779_cov_2.329412	615	672	4	46	57	0.8070176
NODE_12863_length_779_cov_2.329412	615	672	6	11	57	0.1929825
NODE_12883_length_778_cov_21.615611	325	405	0	80	80	1.0000000
NODE_12883_length_778_cov_21.615611	378	458	0	80	80	1.0000000
NODE_12884_length_778_cov_19.549337	348	428	0	80	80	1.0000000
NODE_12884_length_778_cov_19.549337	401	481	0	80	80	1.0000000
NODE_12885_length_778_cov_15.403535	312	392	0	80	80	1.0000000
NODE_12885_length_778_cov_15.403535	365	445	0	71	80	0.8875000
NODE_12885_length_778_cov_15.403535	365	445	2	9	80	0.1125000
NODE_12886_length_778_cov_14.614138	101	181	0	80	80	1.0000000
NODE_12886_length_778_cov_14.614138	154	234	0	59	80	0.7375000
NODE_12886_length_778_cov_14.614138	154	234	2	19	80	0.2375000
NODE_12886_length_778_cov_14.614138	154	234	4	2	80	0.0250000
NODE_12887_length_778_cov_13.368189	256	336	4	16	80	0.2000000
NODE_12887_length_778_cov_13.368189	256	336	5	64	80	0.8000000
NODE_12887_length_778_cov_13.368189	309	389	0	49	80	0.6125000
NODE_12887_length_778_cov_13.368189	309	389	4	20	80	0.2500000
NODE_12887_length_778_cov_13.368189	309	389	5	11	80	0.1375000
NODE_12891_length_778_cov_6.307806	349	429	0	80	80	1.0000000
NODE_12891_length_778_cov_6.307806	402	482	0	80	80	1.0000000
NODE_12893_length_778_cov_5.985272	385	465	0	80	80	1.0000000
NODE_12893_length_778_cov_5.985272	438	518	0	80	80	1.0000000
NODE_12928_length_777_cov_25.504425	323	403	0	80	80	1.0000000
NODE_12928_length_777_cov_25.504425	376	456	0	80	80	1.0000000
NODE_12929_length_777_cov_25.410029	346	426	0	80	80	1.0000000
NODE_12929_length_777_cov_25.410029	399	479	0	80	80	1.0000000
NODE_12930_length_777_cov_25.333333	97	177	0	50	80	0.6250000
NODE_12930_length_777_cov_25.333333	97	177	4	30	80	0.3750000
NODE_12930_length_777_cov_25.333333	150	230	0	12	80	0.1500000
NODE_12930_length_777_cov_25.333333	150	230	4	68	80	0.8500000
NODE_12931_length_777_cov_21.600295	408	485	0	77	77	1.0000000
NODE_12931_length_777_cov_21.600295	458	538	0	80	80	1.0000000
NODE_12932_length_777_cov_19.561947	343	423	0	80	80	1.0000000
NODE_12932_length_777_cov_19.561947	396	476	0	80	80	1.0000000
NODE_12933_length_777_cov_16.961652	264	344	0	80	80	1.0000000
NODE_12933_length_777_cov_16.961652	317	397	0	31	80	0.3875000
NODE_12933_length_777_cov_16.961652	317	397	2	49	80	0.6125000
NODE_12934_length_777_cov_16.081121	299	379	0	80	80	1.0000000
NODE_12934_length_777_cov_16.081121	352	432	0	80	80	1.0000000
NODE_12935_length_777_cov_13.827434	380	460	0	80	80	1.0000000
NODE_12935_length_777_cov_13.827434	433	513	0	80	80	1.0000000
NODE_12936_length_777_cov_12.497050	413	493	0	80	80	1.0000000
NODE_12936_length_777_cov_12.497050	466	546	0	80	80	1.0000000
NODE_12937_length_777_cov_10.787611	213	286	0	73	73	1.0000000
NODE_12938_length_777_cov_8.530973	362	422	0	5	60	0.0833333
NODE_12938_length_777_cov_8.530973	362	422	2	55	60	0.9166667
NODE_12939_length_777_cov_7.634218	79	159	0	80	80	1.0000000
NODE_12939_length_777_cov_7.634218	132	212	0	80	80	1.0000000
NODE_12940_length_777_cov_6.963127	256	336	0	80	80	1.0000000
NODE_12940_length_777_cov_6.963127	309	389	0	80	80	1.0000000
NODE_12941_length_777_cov_6.417404	565	638	0	73	73	1.0000000
NODE_12942_length_777_cov_5.868732	443	523	0	80	80	1.0000000
NODE_12942_length_777_cov_5.868732	496	576	0	80	80	1.0000000
NODE_12971_length_776_cov_81.002954	237	317	0	62	80	0.7750000
NODE_12971_length_776_cov_81.002954	237	317	3	1	80	0.0125000
NODE_12971_length_776_cov_81.002954	237	317	5	3	80	0.0375000
NODE_12971_length_776_cov_81.002954	237	317	19	1	80	0.0125000
NODE_12971_length_776_cov_81.002954	237	317	20	1	80	0.0125000
NODE_12971_length_776_cov_81.002954	237	317	25	1	80	0.0125000
NODE_12971_length_776_cov_81.002954	237	317	31	1	80	0.0125000
NODE_12971_length_776_cov_81.002954	237	317	41	1	80	0.0125000
NODE_12971_length_776_cov_81.002954	237	317	59	1	80	0.0125000
NODE_12971_length_776_cov_81.002954	237	317	67	1	80	0.0125000
NODE_12971_length_776_cov_81.002954	237	317	72	1	80	0.0125000
NODE_12971_length_776_cov_81.002954	237	317	83	1	80	0.0125000
NODE_12971_length_776_cov_81.002954	237	317	87	2	80	0.0250000
NODE_12971_length_776_cov_81.002954	237	317	93	1	80	0.0125000
NODE_12971_length_776_cov_81.002954	237	317	103	1	80	0.0125000
NODE_12971_length_776_cov_81.002954	237	317	109	1	80	0.0125000
NODE_12971_length_776_cov_81.002954	290	370	0	80	80	1.0000000
NODE_12972_length_776_cov_40.502216	345	425	0	80	80	1.0000000
NODE_12972_length_776_cov_40.502216	398	478	0	80	80	1.0000000
NODE_12973_length_776_cov_34.921713	204	284	0	80	80	1.0000000
NODE_12973_length_776_cov_34.921713	257	337	0	66	80	0.8250000
NODE_12973_length_776_cov_34.921713	257	337	2	14	80	0.1750000
NODE_12974_length_776_cov_29.998523	177	257	0	51	80	0.6375000
NODE_12974_length_776_cov_29.998523	177	257	2	29	80	0.3625000
NODE_12974_length_776_cov_29.998523	230	310	0	11	80	0.1375000
NODE_12974_length_776_cov_29.998523	230	310	2	69	80	0.8625000
NODE_12975_length_776_cov_25.683900	417	497	0	80	80	1.0000000
NODE_12975_length_776_cov_25.683900	470	550	0	80	80	1.0000000
NODE_12976_length_776_cov_22.276219	367	447	0	80	80	1.0000000
NODE_12976_length_776_cov_22.276219	420	500	0	80	80	1.0000000
NODE_12977_length_776_cov_19.574594	242	322	0	80	80	1.0000000
NODE_12977_length_776_cov_19.574594	295	375	0	80	80	1.0000000
NODE_12978_length_776_cov_18.262925	384	464	0	80	80	1.0000000
NODE_12978_length_776_cov_18.262925	437	517	0	80	80	1.0000000
NODE_12979_length_776_cov_16.023634	334	414	0	80	80	1.0000000
NODE_12979_length_776_cov_16.023634	387	467	0	80	80	1.0000000
NODE_12980_length_776_cov_15.841950	282	362	0	80	80	1.0000000
NODE_12980_length_776_cov_15.841950	335	415	0	80	80	1.0000000
NODE_12981_length_776_cov_14.131462	240	320	0	35	80	0.4375000
NODE_12981_length_776_cov_14.131462	240	320	2	45	80	0.5625000
NODE_12981_length_776_cov_14.131462	293	373	0	25	80	0.3125000
NODE_12981_length_776_cov_14.131462	293	373	2	55	80	0.6875000
NODE_12981_length_776_cov_14.131462	369	449	0	80	80	1.0000000
NODE_12981_length_776_cov_14.131462	422	502	0	80	80	1.0000000
NODE_12983_length_776_cov_13.890694	302	382	0	26	80	0.3250000
NODE_12983_length_776_cov_13.890694	302	382	2	54	80	0.6750000
NODE_12983_length_776_cov_13.890694	355	435	0	40	80	0.5000000
NODE_12983_length_776_cov_13.890694	355	435	2	40	80	0.5000000
NODE_12984_length_776_cov_12.097489	488	568	0	80	80	1.0000000
NODE_12984_length_776_cov_12.097489	541	621	0	80	80	1.0000000
NODE_12985_length_776_cov_11.923191	422	498	0	76	76	1.0000000
NODE_12985_length_776_cov_11.923191	475	551	0	76	76	1.0000000
NODE_12986_length_776_cov_11.163959	312	392	0	80	80	1.0000000
NODE_12986_length_776_cov_11.163959	365	445	0	80	80	1.0000000
NODE_12987_length_776_cov_9.754801	370	450	0	80	80	1.0000000
NODE_12987_length_776_cov_9.754801	423	503	0	80	80	1.0000000
NODE_12989_length_776_cov_8.271787	332	412	0	20	80	0.2500000
NODE_12989_length_776_cov_8.271787	332	412	3	1	80	0.0125000
NODE_12989_length_776_cov_8.271787	332	412	4	59	80	0.7375000
NODE_12989_length_776_cov_8.271787	385	465	4	80	80	1.0000000
NODE_12990_length_776_cov_4.874446	330	410	0	80	80	1.0000000
NODE_12990_length_776_cov_4.874446	383	463	0	80	80	1.0000000
NODE_13022_length_775_cov_33.612426	372	452	0	80	80	1.0000000
NODE_13022_length_775_cov_33.612426	425	505	0	80	80	1.0000000
NODE_13023_length_775_cov_25.500000	361	434	0	73	73	1.0000000
NODE_13023_length_775_cov_25.500000	413	487	0	25	74	0.3378378
NODE_13023_length_775_cov_25.500000	413	487	2	49	74	0.6621622
NODE_13024_length_775_cov_24.128698	220	300	0	80	80	1.0000000
NODE_13024_length_775_cov_24.128698	273	353	0	80	80	1.0000000
NODE_13026_length_775_cov_16.165680	358	438	4	80	80	1.0000000
NODE_13026_length_775_cov_16.165680	411	491	0	47	80	0.5875000
NODE_13026_length_775_cov_16.165680	411	491	4	33	80	0.4125000
NODE_13027_length_775_cov_8.522189	440	520	0	39	80	0.4875000
NODE_13027_length_775_cov_8.522189	440	520	2	41	80	0.5125000
NODE_13027_length_775_cov_8.522189	493	573	2	59	80	0.7375000
NODE_13027_length_775_cov_8.522189	493	573	4	21	80	0.2625000
NODE_13028_length_775_cov_8.258876	247	327	1	80	80	1.0000000
NODE_13028_length_775_cov_8.258876	300	380	0	19	80	0.2375000
NODE_13028_length_775_cov_8.258876	300	380	1	61	80	0.7625000
NODE_13031_length_775_cov_3.786982	299	379	0	80	80	1.0000000
NODE_13031_length_775_cov_3.786982	352	432	0	80	80	1.0000000
NODE_13059_length_774_cov_27.386667	433	514	0	81	81	1.0000000
NODE_13059_length_774_cov_27.386667	487	567	0	80	80	1.0000000
NODE_13060_length_774_cov_19.721481	239	319	0	80	80	1.0000000
NODE_13060_length_774_cov_19.721481	292	372	0	80	80	1.0000000
NODE_13063_length_774_cov_4.594074	216	294	2	34	78	0.4358974
NODE_13063_length_774_cov_4.594074	216	294	4	44	78	0.5641026
NODE_13063_length_774_cov_4.594074	269	347	2	46	78	0.5897436
NODE_13063_length_774_cov_4.594074	269	347	4	32	78	0.4102564
NODE_13063_length_774_cov_4.594074	405	485	0	80	80	1.0000000
NODE_13103_length_773_cov_60.566766	249	328	0	79	79	1.0000000
NODE_13103_length_773_cov_60.566766	304	381	0	77	77	1.0000000
NODE_13104_length_773_cov_27.299703	230	310	0	80	80	1.0000000
NODE_13104_length_773_cov_27.299703	283	363	0	80	80	1.0000000
NODE_13105_length_773_cov_24.250742	392	470	0	78	78	1.0000000
NODE_13105_length_773_cov_24.250742	443	523	0	80	80	1.0000000
NODE_13106_length_773_cov_20.683976	367	447	0	80	80	1.0000000
NODE_13106_length_773_cov_20.683976	420	500	0	80	80	1.0000000
NODE_13107_length_773_cov_18.498516	248	328	0	80	80	1.0000000
NODE_13107_length_773_cov_18.498516	301	381	0	80	80	1.0000000
NODE_13108_length_773_cov_14.063798	405	485	0	80	80	1.0000000
NODE_13108_length_773_cov_14.063798	458	538	0	80	80	1.0000000
NODE_13109_length_773_cov_12.482196	421	501	0	80	80	1.0000000
NODE_13109_length_773_cov_12.482196	474	554	0	80	80	1.0000000
NODE_13114_length_773_cov_9.136499	214	294	0	80	80	1.0000000
NODE_13114_length_773_cov_9.136499	267	347	0	80	80	1.0000000
NODE_13115_length_773_cov_8.609792	461	541	0	80	80	1.0000000
NODE_13115_length_773_cov_8.609792	514	594	0	80	80	1.0000000
NODE_13116_length_773_cov_7.224036	200	280	0	38	80	0.4750000
NODE_13116_length_773_cov_7.224036	200	280	2	42	80	0.5250000
NODE_13116_length_773_cov_7.224036	253	333	0	35	80	0.4375000
NODE_13116_length_773_cov_7.224036	253	333	2	45	80	0.5625000
NODE_13117_length_773_cov_6.910979	522	615	0	93	93	1.0000000
NODE_13117_length_773_cov_6.910979	588	668	0	80	80	1.0000000
NODE_13147_length_772_cov_28.044577	231	311	0	19	80	0.2375000
NODE_13147_length_772_cov_28.044577	231	311	2	31	80	0.3875000
NODE_13147_length_772_cov_28.044577	231	311	8	30	80	0.3750000
NODE_13147_length_772_cov_28.044577	284	364	6	13	80	0.1625000
NODE_13147_length_772_cov_28.044577	284	364	8	67	80	0.8375000
NODE_13149_length_772_cov_9.523031	288	368	0	75	80	0.9375000
NODE_13149_length_772_cov_9.523031	288	368	2	5	80	0.0625000
NODE_13149_length_772_cov_9.523031	341	421	0	80	80	1.0000000
NODE_13150_length_772_cov_8.778603	133	213	0	80	80	1.0000000
NODE_13150_length_772_cov_8.778603	186	266	0	80	80	1.0000000
NODE_13151_length_772_cov_7.921248	351	431	0	80	80	1.0000000
NODE_13151_length_772_cov_7.921248	404	480	0	76	76	1.0000000
NODE_13152_length_772_cov_7.059435	276	356	0	80	80	1.0000000
NODE_13152_length_772_cov_7.059435	329	409	0	50	80	0.6250000
NODE_13152_length_772_cov_7.059435	329	409	2	27	80	0.3375000
NODE_13152_length_772_cov_7.059435	329	409	4	3	80	0.0375000
NODE_13153_length_772_cov_5.536404	269	299	0	30	30	1.0000000
NODE_13153_length_772_cov_5.536404	272	341	0	69	69	1.0000000
NODE_13156_length_772_cov_4.838039	430	510	0	80	80	1.0000000
NODE_13156_length_772_cov_4.838039	483	563	0	80	80	1.0000000
NODE_13162_length_772_cov_3.041605	339	419	0	80	80	1.0000000
NODE_13162_length_772_cov_3.041605	392	472	0	80	80	1.0000000
NODE_13195_length_771_cov_36.729167	223	304	0	81	81	1.0000000
NODE_13195_length_771_cov_36.729167	277	357	0	80	80	1.0000000
NODE_13195_length_771_cov_36.729167	353	434	0	81	81	1.0000000
NODE_13195_length_771_cov_36.729167	407	487	0	80	80	1.0000000
NODE_13196_length_771_cov_28.903274	337	417	0	80	80	1.0000000
NODE_13196_length_771_cov_28.903274	390	470	0	80	80	1.0000000
NODE_13197_length_771_cov_28.165179	453	533	0	80	80	1.0000000
NODE_13197_length_771_cov_28.165179	506	586	0	80	80	1.0000000
NODE_13198_length_771_cov_14.336310	259	339	0	80	80	1.0000000
NODE_13198_length_771_cov_14.336310	312	392	0	80	80	1.0000000
NODE_13199_length_771_cov_13.592262	428	508	0	80	80	1.0000000
NODE_13199_length_771_cov_13.592262	481	561	0	80	80	1.0000000
NODE_13200_length_771_cov_12.226190	407	487	0	80	80	1.0000000
NODE_13200_length_771_cov_12.226190	460	540	0	80	80	1.0000000
NODE_13201_length_771_cov_11.188988	348	428	0	80	80	1.0000000
NODE_13201_length_771_cov_11.188988	401	481	0	80	80	1.0000000
NODE_13202_length_771_cov_10.525298	171	251	0	80	80	1.0000000
NODE_13202_length_771_cov_10.525298	224	304	0	80	80	1.0000000
NODE_13207_length_771_cov_3.357143	238	318	2	80	80	1.0000000
NODE_13207_length_771_cov_3.357143	291	371	0	47	80	0.5875000
NODE_13207_length_771_cov_3.357143	291	371	2	33	80	0.4125000
NODE_13209_length_771_cov_3.129464	476	518	0	42	42	1.0000000
NODE_13238_length_770_cov_45.312966	212	292	0	80	80	1.0000000
NODE_13238_length_770_cov_45.312966	265	345	0	80	80	1.0000000
NODE_13239_length_770_cov_23.153502	348	428	0	80	80	1.0000000
NODE_13239_length_770_cov_23.153502	401	481	0	80	80	1.0000000
NODE_13240_length_770_cov_22.463487	340	420	0	80	80	1.0000000
NODE_13240_length_770_cov_22.463487	393	473	0	80	80	1.0000000
NODE_13241_length_770_cov_18.594635	335	416	0	79	81	0.9753087
NODE_13241_length_770_cov_18.594635	335	416	2	2	81	0.0246914
NODE_13241_length_770_cov_18.594635	389	469	0	80	80	1.0000000
NODE_13242_length_770_cov_18.092399	292	372	6	80	80	1.0000000
NODE_13242_length_770_cov_18.092399	345	425	0	45	80	0.5625000
NODE_13242_length_770_cov_18.092399	345	425	6	35	80	0.4375000
NODE_13243_length_770_cov_7.064083	294	374	0	80	80	1.0000000
NODE_13243_length_770_cov_7.064083	347	426	0	79	79	1.0000000
NODE_13246_length_770_cov_5.184799	341	421	0	80	80	1.0000000
NODE_13246_length_770_cov_5.184799	394	474	0	80	80	1.0000000
NODE_13250_length_770_cov_4.120715	325	405	0	80	80	1.0000000
NODE_13250_length_770_cov_4.120715	378	458	0	80	80	1.0000000
NODE_13272_length_769_cov_11.008955	355	435	0	41	80	0.5125000
NODE_13272_length_769_cov_11.008955	355	435	2	39	80	0.4875000
NODE_13272_length_769_cov_11.008955	408	488	0	9	80	0.1125000
NODE_13272_length_769_cov_11.008955	408	488	2	71	80	0.8875000
NODE_13274_length_769_cov_9.077612	263	343	0	76	80	0.9500000
NODE_13274_length_769_cov_9.077612	263	343	2	4	80	0.0500000
NODE_13274_length_769_cov_9.077612	316	396	0	23	80	0.2875000
NODE_13274_length_769_cov_9.077612	316	396	2	57	80	0.7125000
NODE_13275_length_769_cov_7.034328	289	367	0	78	78	1.0000000
NODE_13275_length_769_cov_7.034328	340	420	0	80	80	1.0000000
NODE_13307_length_769_cov_1.262687	620	668	0	48	48	1.0000000
NODE_13316_length_768_cov_19.195815	266	346	0	30	80	0.3750000
NODE_13316_length_768_cov_19.195815	266	346	2	50	80	0.6250000
NODE_13316_length_768_cov_19.195815	319	399	0	80	80	1.0000000
NODE_13316_length_768_cov_19.195815	395	475	0	80	80	1.0000000
NODE_13316_length_768_cov_19.195815	448	528	0	80	80	1.0000000
NODE_13317_length_768_cov_16.420030	246	326	0	80	80	1.0000000
NODE_13317_length_768_cov_16.420030	299	379	0	80	80	1.0000000
NODE_13318_length_768_cov_14.508221	309	389	0	80	80	1.0000000
NODE_13318_length_768_cov_14.508221	362	442	0	80	80	1.0000000
NODE_13319_length_768_cov_11.635277	309	389	0	80	80	1.0000000
NODE_13319_length_768_cov_11.635277	362	442	0	80	80	1.0000000
NODE_13321_length_768_cov_9.064275	392	472	0	80	80	1.0000000
NODE_13321_length_768_cov_9.064275	445	525	0	80	80	1.0000000
NODE_13324_length_768_cov_3.605381	512	592	0	80	80	1.0000000
NODE_13324_length_768_cov_3.605381	565	645	0	80	80	1.0000000
NODE_13354_length_767_cov_38.161677	28	108	0	1	80	0.0125000
NODE_13354_length_767_cov_38.161677	28	108	2	2	80	0.0250000
NODE_13354_length_767_cov_38.161677	28	108	6	5	80	0.0625000
NODE_13354_length_767_cov_38.161677	28	108	8	72	80	0.9000000
NODE_13354_length_767_cov_38.161677	254	334	0	80	80	1.0000000
NODE_13354_length_767_cov_38.161677	307	387	0	80	80	1.0000000
NODE_13355_length_767_cov_24.107784	279	359	0	80	80	1.0000000
NODE_13355_length_767_cov_24.107784	332	412	0	80	80	1.0000000
NODE_13356_length_767_cov_22.823353	286	366	2	80	80	1.0000000
NODE_13356_length_767_cov_22.823353	339	419	0	22	80	0.2750000
NODE_13356_length_767_cov_22.823353	339	419	2	58	80	0.7250000
NODE_13357_length_767_cov_20.898204	312	392	0	80	80	1.0000000
NODE_13357_length_767_cov_20.898204	365	445	0	80	80	1.0000000
NODE_13358_length_767_cov_20.058383	357	439	0	82	82	1.0000000
NODE_13358_length_767_cov_20.058383	410	490	0	80	80	1.0000000
NODE_13359_length_767_cov_20.020958	191	271	0	80	80	1.0000000
NODE_13359_length_767_cov_20.020958	244	324	0	80	80	1.0000000
NODE_13360_length_767_cov_18.687126	270	350	0	80	80	1.0000000
NODE_13360_length_767_cov_18.687126	323	403	0	80	80	1.0000000
NODE_13362_length_767_cov_13.323353	45	125	0	62	80	0.7750000
NODE_13362_length_767_cov_13.323353	45	125	2	18	80	0.2250000
NODE_13362_length_767_cov_13.323353	98	178	0	9	80	0.1125000
NODE_13362_length_767_cov_13.323353	98	178	2	71	80	0.8875000
NODE_13366_length_767_cov_8.787425	377	447	0	4	70	0.0571429
NODE_13366_length_767_cov_8.787425	377	447	2	66	70	0.9428571
NODE_13366_length_767_cov_8.787425	420	500	0	3	80	0.0375000
NODE_13366_length_767_cov_8.787425	420	500	2	77	80	0.9625000
NODE_13367_length_767_cov_7.206587	306	386	0	80	80	1.0000000
NODE_13367_length_767_cov_7.206587	359	440	0	81	81	1.0000000
NODE_13403_length_766_cov_59.388306	322	402	0	74	80	0.9250000
NODE_13403_length_766_cov_59.388306	322	402	4	6	80	0.0750000
NODE_13403_length_766_cov_59.388306	375	455	0	21	80	0.2625000
NODE_13403_length_766_cov_59.388306	375	455	4	59	80	0.7375000
NODE_13403_length_766_cov_59.388306	451	531	0	52	80	0.6500000
NODE_13403_length_766_cov_59.388306	451	531	4	28	80	0.3500000
NODE_13403_length_766_cov_59.388306	504	584	0	80	80	1.0000000
NODE_13404_length_766_cov_23.361319	308	388	5	27	80	0.3375000
NODE_13404_length_766_cov_23.361319	308	388	6	53	80	0.6625000
NODE_13404_length_766_cov_23.361319	361	441	0	24	80	0.3000000
NODE_13404_length_766_cov_23.361319	361	441	6	56	80	0.7000000
NODE_13405_length_766_cov_22.751124	229	309	0	80	80	1.0000000
NODE_13405_length_766_cov_22.751124	282	362	0	80	80	1.0000000
NODE_13406_length_766_cov_20.011994	285	363	0	57	78	0.7307692
NODE_13406_length_766_cov_20.011994	285	363	4	21	78	0.2692308
NODE_13406_length_766_cov_20.011994	336	416	0	6	80	0.0750000
NODE_13406_length_766_cov_20.011994	336	416	4	74	80	0.9250000
NODE_13407_length_766_cov_18.685157	288	368	0	80	80	1.0000000
NODE_13407_length_766_cov_18.685157	341	421	0	33	80	0.4125000
NODE_13407_length_766_cov_18.685157	341	421	2	47	80	0.5875000
NODE_13408_length_766_cov_13.131934	271	351	0	80	80	1.0000000
NODE_13408_length_766_cov_13.131934	324	404	0	80	80	1.0000000
NODE_13410_length_766_cov_9.479760	274	354	0	80	80	1.0000000
NODE_13410_length_766_cov_9.479760	327	407	0	80	80	1.0000000
NODE_13415_length_766_cov_4.500750	333	413	2	31	80	0.3875000
NODE_13415_length_766_cov_4.500750	333	413	3	14	80	0.1750000
NODE_13415_length_766_cov_4.500750	333	413	7	7	80	0.0875000
NODE_13415_length_766_cov_4.500750	333	413	8	28	80	0.3500000
NODE_13415_length_766_cov_4.500750	369	404	3	9	35	0.2571429
NODE_13415_length_766_cov_4.500750	369	404	7	7	35	0.2000000
NODE_13415_length_766_cov_4.500750	369	404	8	19	35	0.5428572
NODE_13415_length_766_cov_4.500750	371	413	3	7	42	0.1666667
NODE_13415_length_766_cov_4.500750	371	413	7	7	42	0.1666667
NODE_13415_length_766_cov_4.500750	371	413	8	28	42	0.6666667
NODE_13415_length_766_cov_4.500750	397	466	6	20	69	0.2898551
NODE_13415_length_766_cov_4.500750	397	466	8	49	69	0.7101449
NODE_13447_length_765_cov_92.851351	16	96	11	8	80	0.1000000
NODE_13447_length_765_cov_92.851351	16	96	13	4	80	0.0500000
NODE_13447_length_765_cov_92.851351	16	96	14	14	80	0.1750000
NODE_13447_length_765_cov_92.851351	16	96	16	2	80	0.0250000
NODE_13447_length_765_cov_92.851351	16	96	18	1	80	0.0125000
NODE_13447_length_765_cov_92.851351	16	96	24	1	80	0.0125000
NODE_13447_length_765_cov_92.851351	16	96	26	14	80	0.1750000
NODE_13447_length_765_cov_92.851351	16	96	28	7	80	0.0875000
NODE_13447_length_765_cov_92.851351	16	96	29	1	80	0.0125000
NODE_13447_length_765_cov_92.851351	16	96	31	5	80	0.0625000
NODE_13447_length_765_cov_92.851351	16	96	33	7	80	0.0875000
NODE_13447_length_765_cov_92.851351	16	96	35	1	80	0.0125000
NODE_13447_length_765_cov_92.851351	16	96	37	5	80	0.0625000
NODE_13447_length_765_cov_92.851351	16	96	43	2	80	0.0250000
NODE_13447_length_765_cov_92.851351	16	96	45	3	80	0.0375000
NODE_13447_length_765_cov_92.851351	16	96	47	3	80	0.0375000
NODE_13447_length_765_cov_92.851351	16	96	49	2	80	0.0250000
NODE_13448_length_765_cov_36.345345	504	584	0	80	80	1.0000000
NODE_13448_length_765_cov_36.345345	557	637	0	80	80	1.0000000
NODE_13449_length_765_cov_27.334835	370	450	0	80	80	1.0000000
NODE_13449_length_765_cov_27.334835	423	503	0	80	80	1.0000000
NODE_13450_length_765_cov_23.355856	251	331	0	80	80	1.0000000
NODE_13450_length_765_cov_23.355856	304	384	0	80	80	1.0000000
NODE_13450_length_765_cov_23.355856	380	460	0	80	80	1.0000000
NODE_13450_length_765_cov_23.355856	433	506	0	73	73	1.0000000
NODE_13451_length_765_cov_23.322823	256	336	0	80	80	1.0000000
NODE_13451_length_765_cov_23.322823	309	389	0	80	80	1.0000000
NODE_13452_length_765_cov_21.741742	379	452	0	73	73	1.0000000
NODE_13452_length_765_cov_21.741742	425	505	0	80	80	1.0000000
NODE_13453_length_765_cov_14.253754	450	530	0	80	80	1.0000000
NODE_13453_length_765_cov_14.253754	503	583	0	80	80	1.0000000
NODE_13454_length_765_cov_13.627628	313	393	0	80	80	1.0000000
NODE_13454_length_765_cov_13.627628	366	446	0	80	80	1.0000000
NODE_13455_length_765_cov_5.561562	319	349	0	30	30	1.0000000
NODE_13458_length_765_cov_4.367868	433	513	0	80	80	1.0000000
NODE_13458_length_765_cov_4.367868	486	566	0	80	80	1.0000000
NODE_13483_length_764_cov_30.096241	436	516	0	80	80	1.0000000
NODE_13483_length_764_cov_30.096241	489	569	0	80	80	1.0000000
NODE_13484_length_764_cov_29.218045	304	384	0	80	80	1.0000000
NODE_13484_length_764_cov_29.218045	357	437	0	80	80	1.0000000
NODE_13485_length_764_cov_25.951880	421	501	1	76	80	0.9500000
NODE_13485_length_764_cov_25.951880	421	501	2	4	80	0.0500000
NODE_13485_length_764_cov_25.951880	474	554	0	47	80	0.5875000
NODE_13485_length_764_cov_25.951880	474	554	1	33	80	0.4125000
NODE_13486_length_764_cov_23.590977	204	284	0	80	80	1.0000000
NODE_13486_length_764_cov_23.590977	257	337	0	80	80	1.0000000
NODE_13488_length_764_cov_6.804511	281	361	0	80	80	1.0000000
NODE_13488_length_764_cov_6.804511	334	414	0	80	80	1.0000000
NODE_13489_length_764_cov_6.700752	392	458	0	3	66	0.0454545
NODE_13489_length_764_cov_6.700752	392	458	2	19	66	0.2878788
NODE_13489_length_764_cov_6.700752	392	458	4	44	66	0.6666667
NODE_13508_length_764_cov_1.171429	475	537	0	62	62	1.0000000
NODE_13520_length_763_cov_28.807229	311	391	0	80	80	1.0000000
NODE_13520_length_763_cov_28.807229	364	444	0	80	80	1.0000000
NODE_13521_length_763_cov_25.299699	598	673	0	75	75	1.0000000
NODE_13521_length_763_cov_25.299699	598	678	0	80	80	1.0000000
NODE_13521_length_763_cov_25.299699	605	675	0	70	70	1.0000000
NODE_13521_length_763_cov_25.299699	607	678	0	71	71	1.0000000
NODE_13521_length_763_cov_25.299699	651	731	0	80	80	1.0000000
NODE_13521_length_763_cov_25.299699	651	731	0	80	80	1.0000000
NODE_13521_length_763_cov_25.299699	651	731	0	80	80	1.0000000
NODE_13521_length_763_cov_25.299699	651	731	0	80	80	1.0000000
NODE_13522_length_763_cov_12.887048	336	416	0	80	80	1.0000000
NODE_13522_length_763_cov_12.887048	389	469	0	80	80	1.0000000
NODE_13523_length_763_cov_11.599398	547	627	0	80	80	1.0000000
NODE_13523_length_763_cov_11.599398	600	680	0	80	80	1.0000000
NODE_13524_length_763_cov_9.378012	297	377	0	80	80	1.0000000
NODE_13524_length_763_cov_9.378012	350	430	0	80	80	1.0000000
NODE_13526_length_763_cov_7.246988	368	448	0	80	80	1.0000000
NODE_13526_length_763_cov_7.246988	421	501	0	80	80	1.0000000
NODE_13527_length_763_cov_6.414157	371	451	0	80	80	1.0000000
NODE_13527_length_763_cov_6.414157	424	504	0	80	80	1.0000000
NODE_13558_length_762_cov_21.236802	368	448	0	80	80	1.0000000
NODE_13558_length_762_cov_21.236802	421	501	0	80	80	1.0000000
NODE_13559_length_762_cov_19.984917	327	407	0	80	80	1.0000000
NODE_13559_length_762_cov_19.984917	380	460	0	80	80	1.0000000
NODE_13560_length_762_cov_15.975867	318	398	0	80	80	1.0000000
NODE_13560_length_762_cov_15.975867	371	439	0	68	68	1.0000000
NODE_13561_length_762_cov_12.728507	381	461	0	80	80	1.0000000
NODE_13561_length_762_cov_12.728507	434	514	0	80	80	1.0000000
NODE_13562_length_762_cov_10.078431	277	357	0	22	80	0.2750000
NODE_13562_length_762_cov_10.078431	277	357	2	58	80	0.7250000
NODE_13562_length_762_cov_10.078431	330	410	0	49	80	0.6125000
NODE_13562_length_762_cov_10.078431	330	410	2	31	80	0.3875000
NODE_13563_length_762_cov_9.705882	339	419	0	75	80	0.9375000
NODE_13563_length_762_cov_9.705882	339	419	2	5	80	0.0625000
NODE_13563_length_762_cov_9.705882	392	472	0	80	80	1.0000000
NODE_13564_length_762_cov_7.276018	316	395	0	79	79	1.0000000
NODE_13564_length_762_cov_7.276018	368	448	0	80	80	1.0000000
NODE_13565_length_762_cov_6.168929	222	302	0	63	80	0.7875000
NODE_13565_length_762_cov_6.168929	222	302	2	17	80	0.2125000
NODE_13565_length_762_cov_6.168929	275	355	0	10	80	0.1250000
NODE_13565_length_762_cov_6.168929	275	355	2	70	80	0.8750000
NODE_13613_length_761_cov_44.243202	531	582	7	11	51	0.2156863
NODE_13613_length_761_cov_44.243202	531	582	9	5	51	0.0980392
NODE_13613_length_761_cov_44.243202	531	582	11	6	51	0.1176471
NODE_13613_length_761_cov_44.243202	531	582	12	5	51	0.0980392
NODE_13613_length_761_cov_44.243202	531	582	13	17	51	0.3333333
NODE_13613_length_761_cov_44.243202	531	582	14	7	51	0.1372549
NODE_13614_length_761_cov_38.809668	342	422	3	8	80	0.1000000
NODE_13614_length_761_cov_38.809668	342	422	4	72	80	0.9000000
NODE_13614_length_761_cov_38.809668	395	475	0	22	80	0.2750000
NODE_13614_length_761_cov_38.809668	395	475	2	25	80	0.3125000
NODE_13614_length_761_cov_38.809668	395	475	3	14	80	0.1750000
NODE_13614_length_761_cov_38.809668	395	475	4	19	80	0.2375000
NODE_13615_length_761_cov_38.694864	314	394	0	80	80	1.0000000
NODE_13615_length_761_cov_38.694864	367	447	0	80	80	1.0000000
NODE_13616_length_761_cov_32.382175	432	512	1	34	80	0.4250000
NODE_13616_length_761_cov_32.382175	432	512	2	46	80	0.5750000
NODE_13616_length_761_cov_32.382175	485	565	0	3	80	0.0375000
NODE_13616_length_761_cov_32.382175	485	565	1	77	80	0.9625000
NODE_13617_length_761_cov_31.444109	323	403	0	80	80	1.0000000
NODE_13617_length_761_cov_31.444109	376	467	0	91	91	1.0000000
NODE_13618_length_761_cov_14.004532	366	446	0	80	80	1.0000000
NODE_13618_length_761_cov_14.004532	419	499	0	80	80	1.0000000
NODE_13619_length_761_cov_13.287009	336	415	0	79	79	1.0000000
NODE_13619_length_761_cov_13.287009	388	468	0	80	80	1.0000000
NODE_13621_length_761_cov_9.654079	274	354	0	3	80	0.0375000
NODE_13621_length_761_cov_9.654079	274	354	4	77	80	0.9625000
NODE_13621_length_761_cov_9.654079	327	407	0	30	80	0.3750000
NODE_13621_length_761_cov_9.654079	327	407	4	50	80	0.6250000
NODE_13622_length_761_cov_7.306647	308	388	0	80	80	1.0000000
NODE_13622_length_761_cov_7.306647	361	441	0	80	80	1.0000000
NODE_13625_length_761_cov_4.314199	354	434	0	80	80	1.0000000
NODE_13625_length_761_cov_4.314199	407	487	0	80	80	1.0000000
NODE_13658_length_760_cov_48.290469	215	295	0	23	80	0.2875000
NODE_13658_length_760_cov_48.290469	215	295	2	57	80	0.7125000
NODE_13658_length_760_cov_48.290469	268	348	0	76	80	0.9500000
NODE_13658_length_760_cov_48.290469	268	348	2	4	80	0.0500000
NODE_13658_length_760_cov_48.290469	344	424	0	80	80	1.0000000
NODE_13658_length_760_cov_48.290469	397	477	0	80	80	1.0000000
NODE_13659_length_760_cov_28.314675	384	464	0	80	80	1.0000000
NODE_13659_length_760_cov_28.314675	437	517	0	80	80	1.0000000
NODE_13660_length_760_cov_27.981846	432	512	0	80	80	1.0000000
NODE_13660_length_760_cov_27.981846	485	565	0	80	80	1.0000000
NODE_13661_length_760_cov_17.500756	372	452	0	8	80	0.1000000
NODE_13661_length_760_cov_17.500756	372	452	23	38	80	0.4750000
NODE_13661_length_760_cov_17.500756	372	452	24	34	80	0.4250000
NODE_13661_length_760_cov_17.500756	425	505	0	11	80	0.1375000
NODE_13661_length_760_cov_17.500756	425	505	23	69	80	0.8625000
NODE_13662_length_760_cov_17.420575	183	263	0	6	80	0.0750000
NODE_13662_length_760_cov_17.420575	183	263	2	74	80	0.9250000
NODE_13662_length_760_cov_17.420575	236	316	0	33	80	0.4125000
NODE_13662_length_760_cov_17.420575	236	316	2	47	80	0.5875000
NODE_13663_length_760_cov_13.444781	357	437	0	80	80	1.0000000
NODE_13663_length_760_cov_13.444781	410	490	0	80	80	1.0000000
NODE_13664_length_760_cov_13.196672	282	362	0	80	80	1.0000000
NODE_13664_length_760_cov_13.196672	335	415	0	80	80	1.0000000
NODE_13665_length_760_cov_12.692890	295	375	0	80	80	1.0000000
NODE_13665_length_760_cov_12.692890	348	428	0	80	80	1.0000000
NODE_13671_length_760_cov_4.282905	388	468	0	80	80	1.0000000
NODE_13671_length_760_cov_4.282905	441	521	0	80	80	1.0000000
NODE_13671_length_760_cov_4.282905	517	597	0	80	80	1.0000000
NODE_13683_length_760_cov_1.990923	490	570	3	7	80	0.0875000
NODE_13683_length_760_cov_1.990923	490	570	4	63	80	0.7875000
NODE_13683_length_760_cov_1.990923	490	570	6	2	80	0.0250000
NODE_13683_length_760_cov_1.990923	490	570	8	8	80	0.1000000
NODE_13683_length_760_cov_1.990923	543	623	4	17	80	0.2125000
NODE_13683_length_760_cov_1.990923	543	623	5	3	80	0.0375000
NODE_13683_length_760_cov_1.990923	543	623	6	16	80	0.2000000
NODE_13683_length_760_cov_1.990923	543	623	7	7	80	0.0875000
NODE_13683_length_760_cov_1.990923	543	623	8	16	80	0.2000000
NODE_13683_length_760_cov_1.990923	543	623	9	21	80	0.2625000
NODE_13709_length_759_cov_24.757576	376	456	9	6	80	0.0750000
NODE_13709_length_759_cov_24.757576	376	456	11	54	80	0.6750000
NODE_13709_length_759_cov_24.757576	376	456	12	20	80	0.2500000
NODE_13709_length_759_cov_24.757576	429	509	0	41	80	0.5125000
NODE_13709_length_759_cov_24.757576	429	509	8	1	80	0.0125000
NODE_13709_length_759_cov_24.757576	429	509	9	17	80	0.2125000
NODE_13709_length_759_cov_24.757576	429	509	11	21	80	0.2625000
NODE_13710_length_759_cov_14.356061	210	290	0	80	80	1.0000000
NODE_13710_length_759_cov_14.356061	263	343	0	80	80	1.0000000
NODE_13711_length_759_cov_10.956061	328	408	2	80	80	1.0000000
NODE_13711_length_759_cov_10.956061	381	461	0	37	80	0.4625000
NODE_13711_length_759_cov_10.956061	381	461	2	43	80	0.5375000
NODE_13712_length_759_cov_10.639394	330	410	0	80	80	1.0000000
NODE_13712_length_759_cov_10.639394	383	463	0	80	80	1.0000000
NODE_13713_length_759_cov_9.192424	209	290	36	2	81	0.0246914
NODE_13713_length_759_cov_9.192424	209	290	38	1	81	0.0123457
NODE_13713_length_759_cov_9.192424	209	290	40	1	81	0.0123457
NODE_13713_length_759_cov_9.192424	209	290	44	3	81	0.0370370
NODE_13713_length_759_cov_9.192424	209	290	48	1	81	0.0123457
NODE_13713_length_759_cov_9.192424	209	290	50	5	81	0.0617284
NODE_13713_length_759_cov_9.192424	209	290	52	13	81	0.1604938
NODE_13713_length_759_cov_9.192424	209	290	53	2	81	0.0246914
NODE_13713_length_759_cov_9.192424	209	290	57	1	81	0.0123457
NODE_13713_length_759_cov_9.192424	209	290	58	5	81	0.0617284
NODE_13713_length_759_cov_9.192424	209	290	60	1	81	0.0123457
NODE_13713_length_759_cov_9.192424	209	290	62	5	81	0.0617284
NODE_13713_length_759_cov_9.192424	209	290	68	4	81	0.0493827
NODE_13713_length_759_cov_9.192424	209	290	70	1	81	0.0123457
NODE_13713_length_759_cov_9.192424	209	290	74	2	81	0.0246914
NODE_13713_length_759_cov_9.192424	209	290	76	8	81	0.0987654
NODE_13713_length_759_cov_9.192424	209	290	80	3	81	0.0370370
NODE_13713_length_759_cov_9.192424	209	290	82	9	81	0.1111111
NODE_13713_length_759_cov_9.192424	209	290	84	5	81	0.0617284
NODE_13713_length_759_cov_9.192424	209	290	86	9	81	0.1111111
NODE_13713_length_759_cov_9.192424	262	310	5	1	48	0.0208333
NODE_13713_length_759_cov_9.192424	262	310	13	3	48	0.0625000
NODE_13713_length_759_cov_9.192424	262	310	15	4	48	0.0833333
NODE_13713_length_759_cov_9.192424	262	310	16	2	48	0.0416667
NODE_13713_length_759_cov_9.192424	262	310	18	2	48	0.0416667
NODE_13713_length_759_cov_9.192424	262	310	20	4	48	0.0833333
NODE_13713_length_759_cov_9.192424	262	310	22	1	48	0.0208333
NODE_13713_length_759_cov_9.192424	262	310	25	1	48	0.0208333
NODE_13713_length_759_cov_9.192424	262	310	34	1	48	0.0208333
NODE_13713_length_759_cov_9.192424	262	310	36	3	48	0.0625000
NODE_13713_length_759_cov_9.192424	262	310	38	1	48	0.0208333
NODE_13713_length_759_cov_9.192424	262	310	40	1	48	0.0208333
NODE_13713_length_759_cov_9.192424	262	310	44	3	48	0.0625000
NODE_13713_length_759_cov_9.192424	262	310	48	1	48	0.0208333
NODE_13713_length_759_cov_9.192424	262	310	50	5	48	0.1041667
NODE_13713_length_759_cov_9.192424	262	310	52	13	48	0.2708333
NODE_13713_length_759_cov_9.192424	262	310	53	2	48	0.0416667
NODE_13714_length_759_cov_8.771212	292	372	0	80	80	1.0000000
NODE_13714_length_759_cov_8.771212	345	425	0	80	80	1.0000000
NODE_13715_length_759_cov_8.650000	324	404	0	80	80	1.0000000
NODE_13715_length_759_cov_8.650000	377	457	0	29	80	0.3625000
NODE_13715_length_759_cov_8.650000	377	457	2	51	80	0.6375000
NODE_13716_length_759_cov_8.268182	604	684	0	80	80	1.0000000
NODE_13716_length_759_cov_8.268182	657	737	0	80	80	1.0000000
NODE_13717_length_759_cov_6.833333	381	461	0	80	80	1.0000000
NODE_13717_length_759_cov_6.833333	434	515	0	81	81	1.0000000
NODE_13718_length_759_cov_6.407576	319	399	0	47	80	0.5875000
NODE_13718_length_759_cov_6.407576	319	399	2	33	80	0.4125000
NODE_13718_length_759_cov_6.407576	372	452	2	80	80	1.0000000
NODE_13725_length_759_cov_3.400000	355	435	0	80	80	1.0000000
NODE_13725_length_759_cov_3.400000	408	488	0	80	80	1.0000000
NODE_13726_length_759_cov_3.346970	240	322	0	82	82	1.0000000
NODE_13760_length_758_cov_38.414264	215	295	0	80	80	1.0000000
NODE_13760_length_758_cov_38.414264	268	348	0	80	80	1.0000000
NODE_13760_length_758_cov_38.414264	344	424	0	80	80	1.0000000
NODE_13760_length_758_cov_38.414264	397	477	0	80	80	1.0000000
NODE_13761_length_758_cov_36.722307	331	411	0	80	80	1.0000000
NODE_13761_length_758_cov_36.722307	384	464	0	80	80	1.0000000
NODE_13762_length_758_cov_29.910470	235	315	0	80	80	1.0000000
NODE_13762_length_758_cov_29.910470	288	368	0	80	80	1.0000000
NODE_13763_length_758_cov_16.226100	386	466	0	80	80	1.0000000
NODE_13763_length_758_cov_16.226100	439	519	0	80	80	1.0000000
NODE_13764_length_758_cov_16.097117	311	391	0	80	80	1.0000000
NODE_13764_length_758_cov_16.097117	364	444	0	80	80	1.0000000
NODE_13765_length_758_cov_15.525038	260	340	0	80	80	1.0000000
NODE_13765_length_758_cov_15.525038	313	393	0	80	80	1.0000000
NODE_13768_length_758_cov_9.153263	224	299	0	75	75	1.0000000
NODE_13771_length_758_cov_4.241275	508	588	4	80	80	1.0000000
NODE_13772_length_758_cov_3.902883	346	426	0	80	80	1.0000000
NODE_13772_length_758_cov_3.902883	399	479	0	80	80	1.0000000
NODE_13794_length_757_cov_49.057751	155	235	4	80	80	1.0000000
NODE_13794_length_757_cov_49.057751	208	288	0	16	80	0.2000000
NODE_13794_length_757_cov_49.057751	208	288	4	64	80	0.8000000
NODE_13795_length_757_cov_29.954407	181	262	0	81	81	1.0000000
NODE_13795_length_757_cov_29.954407	235	315	0	80	80	1.0000000
NODE_13795_length_757_cov_29.954407	311	391	0	80	80	1.0000000
NODE_13795_length_757_cov_29.954407	364	444	0	80	80	1.0000000
NODE_13796_length_757_cov_25.565350	352	432	0	80	80	1.0000000
NODE_13796_length_757_cov_25.565350	405	483	0	78	78	1.0000000
NODE_13797_length_757_cov_18.338906	264	344	0	70	80	0.8750000
NODE_13797_length_757_cov_18.338906	264	344	8	10	80	0.1250000
NODE_13797_length_757_cov_18.338906	317	397	0	17	80	0.2125000
NODE_13797_length_757_cov_18.338906	317	397	8	63	80	0.7875000
NODE_13798_length_757_cov_15.879939	58	138	0	80	80	1.0000000
NODE_13798_length_757_cov_15.879939	111	191	0	80	80	1.0000000
NODE_13800_length_757_cov_15.291793	314	394	0	80	80	1.0000000
NODE_13800_length_757_cov_15.291793	367	447	0	80	80	1.0000000
NODE_13807_length_757_cov_3.182371	423	503	0	80	80	1.0000000
NODE_13807_length_757_cov_3.182371	476	556	0	80	80	1.0000000
NODE_13832_length_756_cov_26.441400	287	367	0	80	80	1.0000000
NODE_13832_length_756_cov_26.441400	340	420	0	80	80	1.0000000
NODE_13834_length_756_cov_13.097412	154	234	0	80	80	1.0000000
NODE_13834_length_756_cov_13.097412	207	287	0	80	80	1.0000000
NODE_13835_length_756_cov_12.732116	377	457	0	67	80	0.8375000
NODE_13835_length_756_cov_12.732116	377	457	4	13	80	0.1625000
NODE_13836_length_756_cov_9.254186	241	321	0	5	80	0.0625000
NODE_13836_length_756_cov_9.254186	241	321	4	75	80	0.9375000
NODE_13836_length_756_cov_9.254186	294	374	0	58	80	0.7250000
NODE_13836_length_756_cov_9.254186	294	374	4	22	80	0.2750000
NODE_13837_length_756_cov_8.304414	363	409	0	46	46	1.0000000
NODE_13838_length_756_cov_8.105023	271	351	0	80	80	1.0000000
NODE_13838_length_756_cov_8.105023	324	404	0	39	80	0.4875000
NODE_13838_length_756_cov_8.105023	324	404	2	41	80	0.5125000
NODE_13840_length_756_cov_6.622527	431	511	1	32	80	0.4000000
NODE_13840_length_756_cov_6.622527	431	511	2	48	80	0.6000000
NODE_13840_length_756_cov_6.622527	484	565	1	15	81	0.1851852
NODE_13840_length_756_cov_6.622527	484	565	2	66	81	0.8148148
NODE_13888_length_755_cov_64.705793	303	383	0	42	80	0.5250000
NODE_13888_length_755_cov_64.705793	303	383	1	38	80	0.4750000
NODE_13888_length_755_cov_64.705793	356	436	0	80	80	1.0000000
NODE_13889_length_755_cov_58.214939	425	505	0	80	80	1.0000000
NODE_13889_length_755_cov_58.214939	425	505	0	80	80	1.0000000
NODE_13889_length_755_cov_58.214939	478	556	0	78	78	1.0000000
NODE_13889_length_755_cov_58.214939	478	556	0	78	78	1.0000000
NODE_13890_length_755_cov_25.945122	237	317	0	80	80	1.0000000
NODE_13890_length_755_cov_25.945122	290	370	0	80	80	1.0000000
NODE_13891_length_755_cov_24.263720	334	414	0	80	80	1.0000000
NODE_13891_length_755_cov_24.263720	387	467	0	80	80	1.0000000
NODE_13892_length_755_cov_15.559451	306	386	0	1	80	0.0125000
NODE_13892_length_755_cov_15.559451	306	386	2	79	80	0.9875000
NODE_13892_length_755_cov_15.559451	359	439	0	54	80	0.6750000
NODE_13892_length_755_cov_15.559451	359	439	2	26	80	0.3250000
NODE_13894_length_755_cov_10.196646	332	412	0	80	80	1.0000000
NODE_13894_length_755_cov_10.196646	385	465	0	80	80	1.0000000
NODE_13895_length_755_cov_9.772866	210	290	0	23	80	0.2875000
NODE_13895_length_755_cov_9.772866	210	290	2	57	80	0.7125000
NODE_13895_length_755_cov_9.772866	263	343	0	24	80	0.3000000
NODE_13895_length_755_cov_9.772866	263	343	2	56	80	0.7000000
NODE_13936_length_754_cov_87.432061	208	288	0	80	80	1.0000000
NODE_13936_length_754_cov_87.432061	261	341	0	80	80	1.0000000
NODE_13937_length_754_cov_16.549618	156	236	0	80	80	1.0000000
NODE_13937_length_754_cov_16.549618	209	289	0	80	80	1.0000000
NODE_13939_length_754_cov_9.068702	316	396	0	80	80	1.0000000
NODE_13939_length_754_cov_9.068702	369	449	0	80	80	1.0000000
NODE_13940_length_754_cov_5.925191	287	367	0	80	80	1.0000000
NODE_13940_length_754_cov_5.925191	340	420	0	80	80	1.0000000
NODE_13974_length_753_cov_10.434251	386	466	0	80	80	1.0000000
NODE_13974_length_753_cov_10.434251	439	519	0	80	80	1.0000000
NODE_13976_length_753_cov_7.056575	344	424	0	80	80	1.0000000
NODE_13976_length_753_cov_7.056575	397	477	0	80	80	1.0000000
NODE_13977_length_753_cov_4.597859	321	401	0	9	80	0.1125000
NODE_13977_length_753_cov_4.597859	321	401	2	71	80	0.8875000
NODE_13977_length_753_cov_4.597859	374	454	0	62	80	0.7750000
NODE_13977_length_753_cov_4.597859	374	454	2	18	80	0.2250000
NODE_14003_length_752_cov_66.281776	617	697	12	15	80	0.1875000
NODE_14003_length_752_cov_66.281776	617	697	14	11	80	0.1375000
NODE_14003_length_752_cov_66.281776	617	697	16	13	80	0.1625000
NODE_14003_length_752_cov_66.281776	617	697	18	41	80	0.5125000
NODE_14003_length_752_cov_66.281776	670	751	0	15	81	0.1851852
NODE_14003_length_752_cov_66.281776	670	751	2	33	81	0.4074074
NODE_14003_length_752_cov_66.281776	670	751	4	1	81	0.0123457
NODE_14003_length_752_cov_66.281776	670	751	8	1	81	0.0123457
NODE_14003_length_752_cov_66.281776	670	751	12	19	81	0.2345679
NODE_14003_length_752_cov_66.281776	670	751	16	12	81	0.1481481
NODE_14004_length_752_cov_60.274119	193	273	0	80	80	1.0000000
NODE_14004_length_752_cov_60.274119	246	326	0	80	80	1.0000000
NODE_14005_length_752_cov_19.811639	299	379	0	80	80	1.0000000
NODE_14005_length_752_cov_19.811639	352	432	0	80	80	1.0000000
NODE_14006_length_752_cov_17.661562	118	198	0	80	80	1.0000000
NODE_14006_length_752_cov_17.661562	171	251	0	80	80	1.0000000
NODE_14007_length_752_cov_13.275651	241	321	0	51	80	0.6375000
NODE_14007_length_752_cov_13.275651	241	321	4	29	80	0.3625000
NODE_14007_length_752_cov_13.275651	294	374	4	80	80	1.0000000
NODE_14008_length_752_cov_10.928025	313	393	2	40	80	0.5000000
NODE_14008_length_752_cov_10.928025	313	393	10	40	80	0.5000000
NODE_14011_length_752_cov_9.558959	249	329	0	80	80	1.0000000
NODE_14011_length_752_cov_9.558959	302	382	0	80	80	1.0000000
NODE_14014_length_752_cov_8.281776	237	317	0	80	80	1.0000000
NODE_14014_length_752_cov_8.281776	290	370	0	80	80	1.0000000
NODE_14015_length_752_cov_8.082695	352	432	0	80	80	1.0000000
NODE_14015_length_752_cov_8.082695	405	485	0	80	80	1.0000000
NODE_14044_length_751_cov_20.730061	238	318	0	80	80	1.0000000
NODE_14044_length_751_cov_20.730061	291	371	0	80	80	1.0000000
NODE_14045_length_751_cov_18.478528	328	409	0	81	81	1.0000000
NODE_14045_length_751_cov_18.478528	382	462	0	80	80	1.0000000
NODE_14046_length_751_cov_13.016871	172	252	0	80	80	1.0000000
NODE_14046_length_751_cov_13.016871	225	305	0	73	80	0.9125000
NODE_14046_length_751_cov_13.016871	225	305	4	2	80	0.0250000
NODE_14046_length_751_cov_13.016871	225	305	6	5	80	0.0625000
NODE_14047_length_751_cov_12.363497	397	477	0	80	80	1.0000000
NODE_14047_length_751_cov_12.363497	450	530	0	80	80	1.0000000
NODE_14085_length_750_cov_46.371736	396	476	0	80	80	1.0000000
NODE_14085_length_750_cov_46.371736	449	529	0	80	80	1.0000000
NODE_14086_length_750_cov_24.428571	524	604	19	1	80	0.0125000
NODE_14086_length_750_cov_24.428571	524	604	22	2	80	0.0250000
NODE_14086_length_750_cov_24.428571	524	604	25	1	80	0.0125000
NODE_14086_length_750_cov_24.428571	524	604	27	3	80	0.0375000
NODE_14086_length_750_cov_24.428571	524	604	29	9	80	0.1125000
NODE_14086_length_750_cov_24.428571	524	604	30	2	80	0.0250000
NODE_14086_length_750_cov_24.428571	524	604	32	1	80	0.0125000
NODE_14086_length_750_cov_24.428571	524	604	33	11	80	0.1375000
NODE_14086_length_750_cov_24.428571	524	604	35	2	80	0.0250000
NODE_14086_length_750_cov_24.428571	524	604	38	8	80	0.1000000
NODE_14086_length_750_cov_24.428571	524	604	42	1	80	0.0125000
NODE_14086_length_750_cov_24.428571	524	604	43	20	80	0.2500000
NODE_14086_length_750_cov_24.428571	524	604	44	19	80	0.2375000
NODE_14086_length_750_cov_24.428571	683	746	0	63	63	1.0000000
NODE_14087_length_750_cov_24.311828	325	405	4	76	80	0.9500000
NODE_14087_length_750_cov_24.311828	325	405	7	1	80	0.0125000
NODE_14087_length_750_cov_24.311828	325	405	8	3	80	0.0375000
NODE_14087_length_750_cov_24.311828	378	458	4	80	80	1.0000000
NODE_14089_length_750_cov_8.529954	336	416	0	80	80	1.0000000
NODE_14089_length_750_cov_8.529954	395	469	0	74	74	1.0000000
NODE_14137_length_749_cov_18.986154	221	301	0	80	80	1.0000000
NODE_14137_length_749_cov_18.986154	274	354	0	80	80	1.0000000
NODE_14138_length_749_cov_18.836923	273	355	0	82	82	1.0000000
NODE_14138_length_749_cov_18.836923	328	408	0	80	80	1.0000000
NODE_14138_length_749_cov_18.836923	404	484	0	80	80	1.0000000
NODE_14138_length_749_cov_18.836923	457	535	0	78	78	1.0000000
NODE_14139_length_749_cov_16.160000	232	253	0	21	21	1.0000000
NODE_14139_length_749_cov_16.160000	232	306	0	74	74	1.0000000
NODE_14140_length_749_cov_16.115385	307	387	0	26	80	0.3250000
NODE_14140_length_749_cov_16.115385	307	387	2	54	80	0.6750000
NODE_14140_length_749_cov_16.115385	360	440	0	33	80	0.4125000
NODE_14140_length_749_cov_16.115385	360	440	2	47	80	0.5875000
NODE_14141_length_749_cov_11.210769	340	420	0	80	80	1.0000000
NODE_14141_length_749_cov_11.210769	393	473	0	80	80	1.0000000
NODE_14142_length_749_cov_8.424615	372	452	0	80	80	1.0000000
NODE_14142_length_749_cov_8.424615	425	505	0	80	80	1.0000000
NODE_14145_length_749_cov_4.521538	550	630	0	80	80	1.0000000
NODE_14145_length_749_cov_4.521538	603	683	0	80	80	1.0000000
NODE_14185_length_748_cov_55.348228	393	473	0	80	80	1.0000000
NODE_14185_length_748_cov_55.348228	446	526	0	80	80	1.0000000
NODE_14186_length_748_cov_51.838213	369	449	0	80	80	1.0000000
NODE_14186_length_748_cov_51.838213	422	502	0	80	80	1.0000000
NODE_14187_length_748_cov_46.952234	293	373	0	80	80	1.0000000
NODE_14187_length_748_cov_46.952234	346	426	0	80	80	1.0000000
NODE_14188_length_748_cov_45.001541	272	352	0	80	80	1.0000000
NODE_14188_length_748_cov_45.001541	325	405	0	80	80	1.0000000
NODE_14189_length_748_cov_34.355932	488	568	0	80	80	1.0000000
NODE_14189_length_748_cov_34.355932	541	621	0	80	80	1.0000000
NODE_14190_length_748_cov_25.972265	297	377	0	8	80	0.1000000
NODE_14190_length_748_cov_25.972265	297	377	2	72	80	0.9000000
NODE_14190_length_748_cov_25.972265	350	430	0	61	80	0.7625000
NODE_14190_length_748_cov_25.972265	350	430	2	19	80	0.2375000
NODE_14191_length_748_cov_21.050847	362	442	0	69	80	0.8625000
NODE_14191_length_748_cov_21.050847	362	442	2	11	80	0.1375000
NODE_14191_length_748_cov_21.050847	415	495	0	80	80	1.0000000
NODE_14192_length_748_cov_20.682589	353	433	0	80	80	1.0000000
NODE_14192_length_748_cov_20.682589	406	486	0	80	80	1.0000000
NODE_14193_length_748_cov_19.081664	261	341	0	15	80	0.1875000
NODE_14193_length_748_cov_19.081664	261	341	2	65	80	0.8125000
NODE_14193_length_748_cov_19.081664	314	394	0	29	80	0.3625000
NODE_14193_length_748_cov_19.081664	314	394	2	51	80	0.6375000
NODE_14193_length_748_cov_19.081664	390	470	2	80	80	1.0000000
NODE_14193_length_748_cov_19.081664	443	522	0	45	79	0.5696203
NODE_14193_length_748_cov_19.081664	443	522	2	34	79	0.4303797
NODE_14194_length_748_cov_16.579353	81	161	6	34	80	0.4250000
NODE_14194_length_748_cov_16.579353	81	161	10	46	80	0.5750000
NODE_14194_length_748_cov_16.579353	134	214	0	8	80	0.1000000
NODE_14194_length_748_cov_16.579353	134	214	4	45	80	0.5625000
NODE_14194_length_748_cov_16.579353	134	214	10	27	80	0.3375000
NODE_14194_length_748_cov_16.579353	210	290	0	80	80	1.0000000
NODE_14194_length_748_cov_16.579353	263	343	0	80	80	1.0000000
NODE_14196_length_748_cov_11.983051	375	455	0	80	80	1.0000000
NODE_14196_length_748_cov_11.983051	428	508	0	80	80	1.0000000
NODE_14197_length_748_cov_11.474576	257	337	0	80	80	1.0000000
NODE_14197_length_748_cov_11.474576	310	390	0	80	80	1.0000000
NODE_14200_length_748_cov_7.979969	223	303	0	80	80	1.0000000
NODE_14200_length_748_cov_7.979969	276	356	0	80	80	1.0000000
NODE_14240_length_747_cov_24.279321	205	285	0	63	80	0.7875000
NODE_14240_length_747_cov_24.279321	205	285	2	17	80	0.2125000
NODE_14240_length_747_cov_24.279321	258	338	0	10	80	0.1250000
NODE_14240_length_747_cov_24.279321	258	338	2	70	80	0.8750000
NODE_14241_length_747_cov_15.438272	352	432	0	80	80	1.0000000
NODE_14241_length_747_cov_15.438272	405	485	0	80	80	1.0000000
NODE_14244_length_747_cov_7.979938	237	317	0	80	80	1.0000000
NODE_14244_length_747_cov_7.979938	290	370	0	80	80	1.0000000
NODE_14248_length_747_cov_4.918210	157	237	0	80	80	1.0000000
NODE_14248_length_747_cov_4.918210	210	290	0	80	80	1.0000000
NODE_14277_length_746_cov_44.041731	153	233	0	80	80	1.0000000
NODE_14277_length_746_cov_44.041731	206	286	0	80	80	1.0000000
NODE_14278_length_746_cov_24.435858	334	414	0	80	80	1.0000000
NODE_14278_length_746_cov_24.435858	387	467	0	80	80	1.0000000
NODE_14279_length_746_cov_20.225657	114	194	0	80	80	1.0000000
NODE_14279_length_746_cov_20.225657	167	247	0	80	80	1.0000000
NODE_14280_length_746_cov_17.919629	330	410	0	52	80	0.6500000
NODE_14280_length_746_cov_17.919629	330	410	6	28	80	0.3500000
NODE_14280_length_746_cov_17.919629	383	463	6	80	80	1.0000000
NODE_14281_length_746_cov_17.523957	292	372	0	80	80	1.0000000
NODE_14281_length_746_cov_17.523957	345	425	0	80	80	1.0000000
NODE_14282_length_746_cov_17.214838	306	386	0	80	80	1.0000000
NODE_14282_length_746_cov_17.214838	359	439	0	80	80	1.0000000
NODE_14283_length_746_cov_16.765070	344	424	0	80	80	1.0000000
NODE_14283_length_746_cov_16.765070	397	477	0	80	80	1.0000000
NODE_14284_length_746_cov_13.153014	126	206	0	80	80	1.0000000
NODE_14284_length_746_cov_13.153014	179	259	0	80	80	1.0000000
NODE_14284_length_746_cov_13.153014	244	263	0	19	19	1.0000000
NODE_14285_length_746_cov_12.316847	364	442	0	78	78	1.0000000
NODE_14286_length_746_cov_11.301391	349	429	0	80	80	1.0000000
NODE_14286_length_746_cov_11.301391	402	482	0	80	80	1.0000000
NODE_14302_length_746_cov_2.639876	331	411	0	21	80	0.2625000
NODE_14302_length_746_cov_2.639876	331	411	2	11	80	0.1375000
NODE_14302_length_746_cov_2.639876	331	411	4	48	80	0.6000000
NODE_14307_length_746_cov_1.879444	435	502	0	67	67	1.0000000
NODE_14310_length_746_cov_1.727975	65	121	0	56	56	1.0000000
NODE_14310_length_746_cov_1.727975	494	540	0	33	46	0.7173913
NODE_14310_length_746_cov_1.727975	494	540	2	13	46	0.2826087
NODE_14329_length_745_cov_40.360681	257	337	0	80	80	1.0000000
NODE_14329_length_745_cov_40.360681	310	390	0	80	80	1.0000000
NODE_14330_length_745_cov_30.817337	339	419	11	56	80	0.7000000
NODE_14330_length_745_cov_30.817337	339	419	12	24	80	0.3000000
NODE_14330_length_745_cov_30.817337	392	459	0	34	67	0.5074627
NODE_14330_length_745_cov_30.817337	392	459	11	33	67	0.4925373
NODE_14335_length_745_cov_8.620743	225	275	0	45	50	0.9000000
NODE_14335_length_745_cov_8.620743	225	275	7	1	50	0.0200000
NODE_14335_length_745_cov_8.620743	225	275	9	4	50	0.0800000
NODE_14335_length_745_cov_8.620743	248	328	0	22	80	0.2750000
NODE_14335_length_745_cov_8.620743	248	328	7	1	80	0.0125000
NODE_14335_length_745_cov_8.620743	248	328	9	57	80	0.7125000
NODE_14343_length_745_cov_3.922601	249	280	24	3	31	0.0967742
NODE_14343_length_745_cov_3.922601	249	280	26	3	31	0.0967742
NODE_14343_length_745_cov_3.922601	249	280	27	2	31	0.0645161
NODE_14343_length_745_cov_3.922601	249	280	29	5	31	0.1612903
NODE_14343_length_745_cov_3.922601	249	280	30	9	31	0.2903226
NODE_14343_length_745_cov_3.922601	249	280	31	3	31	0.0967742
NODE_14343_length_745_cov_3.922601	249	280	32	2	31	0.0645161
NODE_14343_length_745_cov_3.922601	249	280	33	4	31	0.1290323
NODE_14343_length_745_cov_3.922601	253	333	23	15	80	0.1875000
NODE_14343_length_745_cov_3.922601	253	333	24	3	80	0.0375000
NODE_14343_length_745_cov_3.922601	253	333	25	4	80	0.0500000
NODE_14343_length_745_cov_3.922601	253	333	26	3	80	0.0375000
NODE_14343_length_745_cov_3.922601	253	333	27	3	80	0.0375000
NODE_14343_length_745_cov_3.922601	253	333	29	13	80	0.1625000
NODE_14343_length_745_cov_3.922601	253	333	30	9	80	0.1125000
NODE_14343_length_745_cov_3.922601	253	333	31	25	80	0.3125000
NODE_14343_length_745_cov_3.922601	253	333	32	2	80	0.0250000
NODE_14343_length_745_cov_3.922601	253	333	33	3	80	0.0375000
NODE_14381_length_744_cov_44.953488	553	633	0	80	80	1.0000000
NODE_14381_length_744_cov_44.953488	553	633	0	80	80	1.0000000
NODE_14381_length_744_cov_44.953488	553	633	0	80	80	1.0000000
NODE_14381_length_744_cov_44.953488	553	633	0	80	80	1.0000000
NODE_14382_length_744_cov_35.333333	163	243	0	13	80	0.1625000
NODE_14382_length_744_cov_35.333333	163	243	10	1	80	0.0125000
NODE_14382_length_744_cov_35.333333	163	243	11	6	80	0.0750000
NODE_14382_length_744_cov_35.333333	163	243	22	60	80	0.7500000
NODE_14382_length_744_cov_35.333333	216	296	22	44	80	0.5500000
NODE_14382_length_744_cov_35.333333	216	296	24	36	80	0.4500000
NODE_14382_length_744_cov_35.333333	292	372	0	38	80	0.4750000
NODE_14382_length_744_cov_35.333333	292	372	2	1	80	0.0125000
NODE_14382_length_744_cov_35.333333	292	372	12	2	80	0.0250000
NODE_14382_length_744_cov_35.333333	292	372	13	5	80	0.0625000
NODE_14382_length_744_cov_35.333333	292	372	24	34	80	0.4250000
NODE_14382_length_744_cov_35.333333	345	425	0	80	80	1.0000000
NODE_14383_length_744_cov_34.503876	294	374	0	80	80	1.0000000
NODE_14383_length_744_cov_34.503876	347	427	0	80	80	1.0000000
NODE_14384_length_744_cov_32.282171	333	403	0	70	70	1.0000000
NODE_14384_length_744_cov_32.282171	440	520	0	80	80	1.0000000
NODE_14384_length_744_cov_32.282171	493	573	0	80	80	1.0000000
NODE_14390_length_744_cov_4.537984	260	340	0	80	80	1.0000000
NODE_14390_length_744_cov_4.537984	313	393	0	80	80	1.0000000
NODE_14396_length_744_cov_2.784496	335	387	0	3	52	0.0576923
NODE_14396_length_744_cov_2.784496	335	387	2	49	52	0.9423077
NODE_14396_length_744_cov_2.784496	360	437	2	41	77	0.5324675
NODE_14396_length_744_cov_2.784496	360	437	3	5	77	0.0649351
NODE_14396_length_744_cov_2.784496	360	437	4	31	77	0.4025974
NODE_14427_length_743_cov_26.369565	354	434	0	64	80	0.8000000
NODE_14427_length_743_cov_26.369565	354	434	4	16	80	0.2000000
NODE_14427_length_743_cov_26.369565	407	487	0	41	80	0.5125000
NODE_14427_length_743_cov_26.369565	407	487	2	39	80	0.4875000
NODE_14428_length_743_cov_21.759317	138	218	0	80	80	1.0000000
NODE_14428_length_743_cov_21.759317	191	271	0	80	80	1.0000000
NODE_14429_length_743_cov_18.173913	213	293	0	80	80	1.0000000
NODE_14429_length_743_cov_18.173913	266	346	0	80	80	1.0000000
NODE_14431_length_743_cov_17.066770	400	480	0	80	80	1.0000000
NODE_14431_length_743_cov_17.066770	453	532	0	79	79	1.0000000
NODE_14432_length_743_cov_16.354037	350	430	0	26	80	0.3250000
NODE_14432_length_743_cov_16.354037	350	430	4	54	80	0.6750000
NODE_14432_length_743_cov_16.354037	403	483	0	21	80	0.2625000
NODE_14432_length_743_cov_16.354037	403	483	4	59	80	0.7375000
NODE_14433_length_743_cov_15.667702	220	300	0	59	80	0.7375000
NODE_14433_length_743_cov_15.667702	220	300	4	21	80	0.2625000
NODE_14433_length_743_cov_15.667702	273	353	0	6	80	0.0750000
NODE_14433_length_743_cov_15.667702	273	353	4	74	80	0.9250000
NODE_14433_length_743_cov_15.667702	349	429	0	27	80	0.3375000
NODE_14433_length_743_cov_15.667702	349	429	4	53	80	0.6625000
NODE_14433_length_743_cov_15.667702	402	482	0	80	80	1.0000000
NODE_14434_length_743_cov_14.975155	289	362	0	73	73	1.0000000
NODE_14435_length_743_cov_14.100932	232	312	0	80	80	1.0000000
NODE_14435_length_743_cov_14.100932	285	365	0	80	80	1.0000000
NODE_14435_length_743_cov_14.100932	361	441	0	80	80	1.0000000
NODE_14435_length_743_cov_14.100932	414	494	0	80	80	1.0000000
NODE_14436_length_743_cov_12.968944	268	348	0	80	80	1.0000000
NODE_14436_length_743_cov_12.968944	321	401	0	80	80	1.0000000
NODE_14437_length_743_cov_12.847826	485	565	0	80	80	1.0000000
NODE_14437_length_743_cov_12.847826	538	618	0	80	80	1.0000000
NODE_14438_length_743_cov_11.871118	403	483	0	80	80	1.0000000
NODE_14438_length_743_cov_11.871118	456	536	0	80	80	1.0000000
NODE_14439_length_743_cov_11.760870	337	417	0	80	80	1.0000000
NODE_14439_length_743_cov_11.760870	390	470	0	80	80	1.0000000
NODE_14440_length_743_cov_9.006211	351	431	0	80	80	1.0000000
NODE_14440_length_743_cov_9.006211	404	484	0	80	80	1.0000000
NODE_14441_length_743_cov_8.063665	290	370	0	80	80	1.0000000
NODE_14441_length_743_cov_8.063665	343	423	0	80	80	1.0000000
NODE_14456_length_743_cov_2.029503	260	284	0	11	24	0.4583333
NODE_14456_length_743_cov_2.029503	260	284	2	13	24	0.5416667
NODE_14456_length_743_cov_2.029503	301	363	2	62	62	1.0000000
NODE_14473_length_743_cov_0.989130	592	670	8	15	78	0.1923077
NODE_14473_length_743_cov_0.989130	592	670	16	25	78	0.3205128
NODE_14473_length_743_cov_0.989130	592	670	22	38	78	0.4871795
NODE_14477_length_742_cov_23.664075	271	351	0	80	80	1.0000000
NODE_14477_length_742_cov_23.664075	324	404	0	80	80	1.0000000
NODE_14478_length_742_cov_19.488336	288	368	0	80	80	1.0000000
NODE_14478_length_742_cov_19.488336	341	421	0	80	80	1.0000000
NODE_14479_length_742_cov_18.528771	319	399	0	20	80	0.2500000
NODE_14479_length_742_cov_18.528771	319	399	2	60	80	0.7500000
NODE_14479_length_742_cov_18.528771	372	452	0	73	80	0.9125000
NODE_14479_length_742_cov_18.528771	372	452	2	7	80	0.0875000
NODE_14480_length_742_cov_17.401244	126	206	0	80	80	1.0000000
NODE_14480_length_742_cov_17.401244	179	259	0	27	80	0.3375000
NODE_14480_length_742_cov_17.401244	179	259	2	53	80	0.6625000
NODE_14482_length_742_cov_7.679627	274	354	0	80	80	1.0000000
NODE_14482_length_742_cov_7.679627	327	407	0	80	80	1.0000000
NODE_14521_length_741_cov_12.168224	316	392	0	76	76	1.0000000
NODE_14521_length_741_cov_12.168224	598	663	0	65	65	1.0000000
NODE_14522_length_741_cov_8.542056	198	278	0	2	80	0.0250000
NODE_14522_length_741_cov_8.542056	198	278	5	45	80	0.5625000
NODE_14522_length_741_cov_8.542056	198	278	6	33	80	0.4125000
NODE_14522_length_741_cov_8.542056	251	331	0	55	80	0.6875000
NODE_14522_length_741_cov_8.542056	251	331	5	25	80	0.3125000
NODE_14525_length_741_cov_5.989097	457	538	2	19	81	0.2345679
NODE_14525_length_741_cov_5.989097	457	538	6	62	81	0.7654321
NODE_14536_length_741_cov_2.556075	212	289	0	75	77	0.9740260
NODE_14536_length_741_cov_2.556075	212	289	2	1	77	0.0129870
NODE_14536_length_741_cov_2.556075	212	289	3	1	77	0.0129870
NODE_14571_length_740_cov_54.372855	192	272	0	4	80	0.0500000
NODE_14571_length_740_cov_54.372855	192	272	2	76	80	0.9500000
NODE_14571_length_740_cov_54.372855	245	325	0	52	80	0.6500000
NODE_14571_length_740_cov_54.372855	245	325	2	28	80	0.3500000
NODE_14571_length_740_cov_54.372855	321	401	0	80	80	1.0000000
NODE_14571_length_740_cov_54.372855	374	454	0	80	80	1.0000000
NODE_14572_length_740_cov_51.758190	194	274	0	80	80	1.0000000
NODE_14572_length_740_cov_51.758190	247	327	0	80	80	1.0000000
NODE_14573_length_740_cov_34.185647	359	439	0	1	80	0.0125000
NODE_14573_length_740_cov_34.185647	359	439	1	2	80	0.0250000
NODE_14573_length_740_cov_34.185647	359	439	2	77	80	0.9625000
NODE_14573_length_740_cov_34.185647	412	492	0	54	80	0.6750000
NODE_14573_length_740_cov_34.185647	412	492	1	2	80	0.0250000
NODE_14573_length_740_cov_34.185647	412	492	2	24	80	0.3000000
NODE_14574_length_740_cov_24.794072	286	366	0	80	80	1.0000000
NODE_14574_length_740_cov_24.794072	339	419	0	80	80	1.0000000
NODE_14575_length_740_cov_20.361934	316	396	0	80	80	1.0000000
NODE_14575_length_740_cov_20.361934	369	449	0	80	80	1.0000000
NODE_14576_length_740_cov_18.982839	266	348	0	82	82	1.0000000
NODE_14576_length_740_cov_18.982839	321	401	0	80	80	1.0000000
NODE_14577_length_740_cov_16.755070	354	434	8	52	80	0.6500000
NODE_14577_length_740_cov_16.755070	354	434	12	28	80	0.3500000
NODE_14577_length_740_cov_16.755070	407	487	4	51	80	0.6375000
NODE_14577_length_740_cov_16.755070	407	487	12	29	80	0.3625000
NODE_14579_length_740_cov_7.585023	206	286	0	60	80	0.7500000
NODE_14579_length_740_cov_7.585023	206	286	2	20	80	0.2500000
NODE_14579_length_740_cov_7.585023	259	339	0	7	80	0.0875000
NODE_14579_length_740_cov_7.585023	259	339	2	73	80	0.9125000
NODE_14580_length_740_cov_7.174727	165	245	0	80	80	1.0000000
NODE_14580_length_740_cov_7.174727	218	298	0	80	80	1.0000000
NODE_14614_length_739_cov_52.970312	346	426	0	80	80	1.0000000
NODE_14614_length_739_cov_52.970312	399	479	0	80	80	1.0000000
NODE_14615_length_739_cov_31.175000	204	284	10	80	80	1.0000000
NODE_14615_length_739_cov_31.175000	257	337	0	32	80	0.4000000
NODE_14615_length_739_cov_31.175000	257	337	10	48	80	0.6000000
NODE_14616_length_739_cov_25.482813	487	567	0	80	80	1.0000000
NODE_14616_length_739_cov_25.482813	540	620	0	80	80	1.0000000
NODE_14617_length_739_cov_24.871875	191	271	0	80	80	1.0000000
NODE_14617_length_739_cov_24.871875	244	324	0	80	80	1.0000000
NODE_14618_length_739_cov_18.360937	146	226	0	80	80	1.0000000
NODE_14618_length_739_cov_18.360937	199	279	0	80	80	1.0000000
NODE_14619_length_739_cov_13.195312	273	353	0	80	80	1.0000000
NODE_14619_length_739_cov_13.195312	326	406	0	80	80	1.0000000
NODE_14620_length_739_cov_10.314063	231	311	0	80	80	1.0000000
NODE_14620_length_739_cov_10.314063	284	364	0	80	80	1.0000000
NODE_14622_length_739_cov_8.523438	468	548	0	80	80	1.0000000
NODE_14622_length_739_cov_8.523438	521	600	0	79	79	1.0000000
NODE_14623_length_739_cov_7.398438	342	422	0	80	80	1.0000000
NODE_14623_length_739_cov_7.398438	395	475	0	80	80	1.0000000
NODE_14625_length_739_cov_5.826562	252	332	0	80	80	1.0000000
NODE_14625_length_739_cov_5.826562	305	385	0	80	80	1.0000000
NODE_14634_length_739_cov_3.232813	355	435	0	80	80	1.0000000
NODE_14634_length_739_cov_3.232813	408	488	0	80	80	1.0000000
NODE_14679_length_738_cov_35.278560	274	318	44	4	44	0.0909091
NODE_14679_length_738_cov_35.278560	274	318	46	1	44	0.0227273
NODE_14679_length_738_cov_35.278560	274	318	51	1	44	0.0227273
NODE_14679_length_738_cov_35.278560	274	318	52	1	44	0.0227273
NODE_14679_length_738_cov_35.278560	274	318	53	7	44	0.1590909
NODE_14679_length_738_cov_35.278560	274	318	55	4	44	0.0909091
NODE_14679_length_738_cov_35.278560	274	318	56	3	44	0.0681818
NODE_14679_length_738_cov_35.278560	274	318	57	1	44	0.0227273
NODE_14679_length_738_cov_35.278560	274	318	58	8	44	0.1818182
NODE_14679_length_738_cov_35.278560	274	318	59	3	44	0.0681818
NODE_14679_length_738_cov_35.278560	274	318	61	3	44	0.0681818
NODE_14679_length_738_cov_35.278560	274	318	62	1	44	0.0227273
NODE_14679_length_738_cov_35.278560	274	318	63	2	44	0.0454545
NODE_14679_length_738_cov_35.278560	274	318	69	4	44	0.0909091
NODE_14679_length_738_cov_35.278560	274	318	70	1	44	0.0227273
NODE_14680_length_738_cov_21.672926	208	288	0	80	80	1.0000000
NODE_14680_length_738_cov_21.672926	261	341	0	80	80	1.0000000
NODE_14681_length_738_cov_15.665102	302	382	0	80	80	1.0000000
NODE_14681_length_738_cov_15.665102	355	435	0	80	80	1.0000000
NODE_14682_length_738_cov_15.661972	338	418	0	80	80	1.0000000
NODE_14682_length_738_cov_15.661972	391	471	0	80	80	1.0000000
NODE_14683_length_738_cov_12.594679	49	129	0	80	80	1.0000000
NODE_14683_length_738_cov_12.594679	102	182	0	80	80	1.0000000
NODE_14683_length_738_cov_12.594679	178	258	0	80	80	1.0000000
NODE_14683_length_738_cov_12.594679	231	311	0	80	80	1.0000000
NODE_14691_length_738_cov_4.056338	254	326	0	72	72	1.0000000
NODE_14691_length_738_cov_4.056338	437	528	0	51	91	0.5604396
NODE_14691_length_738_cov_4.056338	437	528	2	39	91	0.4285714
NODE_14691_length_738_cov_4.056338	437	528	4	1	91	0.0109890
NODE_14724_length_737_cov_22.363636	303	383	0	80	80	1.0000000
NODE_14724_length_737_cov_22.363636	356	436	0	80	80	1.0000000
NODE_14725_length_737_cov_21.318182	208	288	0	80	80	1.0000000
NODE_14725_length_737_cov_21.318182	261	341	0	80	80	1.0000000
NODE_14726_length_737_cov_17.161442	346	426	0	80	80	1.0000000
NODE_14726_length_737_cov_17.161442	399	479	0	80	80	1.0000000
NODE_14727_length_737_cov_11.835423	211	291	0	80	80	1.0000000
NODE_14727_length_737_cov_11.835423	264	344	0	80	80	1.0000000
NODE_14729_length_737_cov_6.782132	488	548	0	60	60	1.0000000
NODE_14732_length_737_cov_6.089342	241	321	0	69	80	0.8625000
NODE_14732_length_737_cov_6.089342	241	321	2	11	80	0.1375000
NODE_14732_length_737_cov_6.089342	294	374	0	80	80	1.0000000
NODE_14747_length_737_cov_2.548589	386	416	4	30	30	1.0000000
NODE_14781_length_736_cov_46.601256	226	306	0	80	80	1.0000000
NODE_14781_length_736_cov_46.601256	279	359	0	80	80	1.0000000
NODE_14782_length_736_cov_32.442700	215	295	0	80	80	1.0000000
NODE_14782_length_736_cov_32.442700	268	350	0	82	82	1.0000000
NODE_14783_length_736_cov_26.364207	220	300	0	80	80	1.0000000
NODE_14783_length_736_cov_26.364207	273	353	0	44	80	0.5500000
NODE_14783_length_736_cov_26.364207	273	353	2	36	80	0.4500000
NODE_14785_length_736_cov_10.317111	313	393	0	80	80	1.0000000
NODE_14785_length_736_cov_10.317111	366	446	0	37	80	0.4625000
NODE_14785_length_736_cov_10.317111	366	446	2	43	80	0.5375000
NODE_14786_length_736_cov_9.188383	292	372	0	80	80	1.0000000
NODE_14786_length_736_cov_9.188383	345	425	0	80	80	1.0000000
NODE_14787_length_736_cov_8.149137	315	391	0	76	76	1.0000000
NODE_14787_length_736_cov_8.149137	365	445	0	80	80	1.0000000
NODE_14788_length_736_cov_8.103611	295	375	0	19	80	0.2375000
NODE_14788_length_736_cov_8.103611	295	375	2	61	80	0.7625000
NODE_14788_length_736_cov_8.103611	348	428	0	39	80	0.4875000
NODE_14788_length_736_cov_8.103611	348	428	2	41	80	0.5125000
NODE_14789_length_736_cov_7.513344	239	319	1	56	80	0.7000000
NODE_14789_length_736_cov_7.513344	239	319	2	24	80	0.3000000
NODE_14789_length_736_cov_7.513344	292	372	1	30	80	0.3750000
NODE_14789_length_736_cov_7.513344	292	372	2	50	80	0.6250000
NODE_14792_length_736_cov_5.967033	253	333	0	80	80	1.0000000
NODE_14792_length_736_cov_5.967033	306	386	0	80	80	1.0000000
NODE_14795_length_736_cov_4.908948	258	338	0	80	80	1.0000000
NODE_14795_length_736_cov_4.908948	311	391	0	80	80	1.0000000
NODE_14825_length_735_cov_21.099057	265	345	0	80	80	1.0000000
NODE_14825_length_735_cov_21.099057	318	398	0	80	80	1.0000000
NODE_14826_length_735_cov_16.696541	190	270	0	80	80	1.0000000
NODE_14826_length_735_cov_16.696541	243	323	0	80	80	1.0000000
NODE_14826_length_735_cov_16.696541	479	538	0	31	59	0.5254237
NODE_14826_length_735_cov_16.696541	479	538	2	28	59	0.4745763
NODE_14827_length_735_cov_13.143082	231	311	0	80	80	1.0000000
NODE_14827_length_735_cov_13.143082	284	364	0	80	80	1.0000000
NODE_14828_length_735_cov_12.415094	434	514	0	80	80	1.0000000
NODE_14828_length_735_cov_12.415094	487	567	0	80	80	1.0000000
NODE_14836_length_735_cov_5.603774	326	394	0	68	68	1.0000000
NODE_14836_length_735_cov_5.603774	367	409	0	42	42	1.0000000
NODE_14880_length_734_cov_26.787402	209	289	0	80	80	1.0000000
NODE_14880_length_734_cov_26.787402	262	342	0	33	80	0.4125000
NODE_14880_length_734_cov_26.787402	262	342	2	47	80	0.5875000
NODE_14881_length_734_cov_23.214173	200	280	0	80	80	1.0000000
NODE_14881_length_734_cov_23.214173	253	333	0	80	80	1.0000000
NODE_14883_length_734_cov_21.645669	245	325	0	80	80	1.0000000
NODE_14883_length_734_cov_21.645669	298	378	0	80	80	1.0000000
NODE_14884_length_734_cov_14.393701	249	329	0	80	80	1.0000000
NODE_14884_length_734_cov_14.393701	302	382	0	80	80	1.0000000
NODE_14885_length_734_cov_11.324409	133	196	0	63	63	1.0000000
NODE_14885_length_734_cov_11.324409	169	229	0	60	60	1.0000000
NODE_14886_length_734_cov_10.872441	302	331	0	29	29	1.0000000
NODE_14890_length_734_cov_6.352756	371	451	0	80	80	1.0000000
NODE_14890_length_734_cov_6.352756	424	504	0	80	80	1.0000000
NODE_14896_length_734_cov_2.705512	231	302	0	71	71	1.0000000
NODE_14934_length_733_cov_35.041009	268	348	0	53	80	0.6625000
NODE_14934_length_733_cov_35.041009	268	348	2	27	80	0.3375000
NODE_14934_length_733_cov_35.041009	321	402	0	81	81	1.0000000
NODE_14935_length_733_cov_29.810726	28	108	0	80	80	1.0000000
NODE_14935_length_733_cov_29.810726	81	161	0	47	80	0.5875000
NODE_14935_length_733_cov_29.810726	81	161	2	33	80	0.4125000
NODE_14935_length_733_cov_29.810726	157	237	0	12	80	0.1500000
NODE_14935_length_733_cov_29.810726	157	237	2	68	80	0.8500000
NODE_14935_length_733_cov_29.810726	210	290	0	65	80	0.8125000
NODE_14935_length_733_cov_29.810726	210	290	2	15	80	0.1875000
NODE_14936_length_733_cov_13.738170	333	413	0	80	80	1.0000000
NODE_14936_length_733_cov_13.738170	386	466	0	80	80	1.0000000
NODE_14937_length_733_cov_11.471609	314	389	0	7	75	0.0933333
NODE_14937_length_733_cov_11.471609	314	389	2	68	75	0.9066667
NODE_14938_length_733_cov_11.321767	245	325	0	80	80	1.0000000
NODE_14938_length_733_cov_11.321767	298	378	0	80	80	1.0000000
NODE_14940_length_733_cov_8.481073	318	395	0	77	77	1.0000000
NODE_14940_length_733_cov_8.481073	371	451	0	80	80	1.0000000
NODE_14944_length_733_cov_5.485804	659	715	20	7	56	0.1250000
NODE_14944_length_733_cov_5.485804	659	715	24	4	56	0.0714286
NODE_14944_length_733_cov_5.485804	659	715	26	9	56	0.1607143
NODE_14944_length_733_cov_5.485804	659	715	28	9	56	0.1607143
NODE_14944_length_733_cov_5.485804	659	715	30	16	56	0.2857143
NODE_14944_length_733_cov_5.485804	659	715	32	3	56	0.0535714
NODE_14944_length_733_cov_5.485804	659	715	34	1	56	0.0178571
NODE_14944_length_733_cov_5.485804	659	715	36	4	56	0.0714286
NODE_14944_length_733_cov_5.485804	659	715	37	3	56	0.0535714
NODE_14944_length_733_cov_5.485804	696	733	8	4	37	0.1081081
NODE_14944_length_733_cov_5.485804	696	733	12	4	37	0.1081081
NODE_14944_length_733_cov_5.485804	696	733	14	1	37	0.0270270
NODE_14944_length_733_cov_5.485804	696	733	16	1	37	0.0270270
NODE_14944_length_733_cov_5.485804	696	733	20	15	37	0.4054054
NODE_14944_length_733_cov_5.485804	696	733	24	4	37	0.1081081
NODE_14944_length_733_cov_5.485804	696	733	26	8	37	0.2162162
NODE_14957_length_733_cov_2.272871	312	392	0	80	80	1.0000000
NODE_14957_length_733_cov_2.272871	365	445	0	80	80	1.0000000
NODE_14975_length_732_cov_19.519747	229	309	0	80	80	1.0000000
NODE_14975_length_732_cov_19.519747	282	362	0	80	80	1.0000000
NODE_14976_length_732_cov_10.846761	247	327	0	80	80	1.0000000
NODE_14976_length_732_cov_10.846761	300	380	0	80	80	1.0000000
NODE_14977_length_732_cov_9.807267	276	356	0	80	80	1.0000000
NODE_14977_length_732_cov_9.807267	329	409	0	80	80	1.0000000
NODE_14978_length_732_cov_8.053712	415	495	0	80	80	1.0000000
NODE_14978_length_732_cov_8.053712	468	548	0	80	80	1.0000000
NODE_14980_length_732_cov_5.194313	319	399	0	80	80	1.0000000
NODE_14980_length_732_cov_5.194313	372	452	0	80	80	1.0000000
NODE_14981_length_732_cov_4.998420	293	373	0	80	80	1.0000000
NODE_14981_length_732_cov_4.998420	346	426	0	80	80	1.0000000
NODE_14983_length_732_cov_4.758294	483	524	0	41	41	1.0000000
NODE_15021_length_731_cov_36.123418	464	544	2	80	80	1.0000000
NODE_15021_length_731_cov_36.123418	517	597	2	80	80	1.0000000
NODE_15022_length_731_cov_27.721519	294	374	0	80	80	1.0000000
NODE_15022_length_731_cov_27.721519	347	427	0	80	80	1.0000000
NODE_15023_length_731_cov_19.655063	394	474	0	80	80	1.0000000
NODE_15023_length_731_cov_19.655063	447	527	0	80	80	1.0000000
NODE_15024_length_731_cov_16.346519	429	509	0	80	80	1.0000000
NODE_15024_length_731_cov_16.346519	482	562	0	80	80	1.0000000
NODE_15025_length_731_cov_13.892405	321	401	0	12	80	0.1500000
NODE_15025_length_731_cov_13.892405	321	401	4	68	80	0.8500000
NODE_15025_length_731_cov_13.892405	374	454	0	65	80	0.8125000
NODE_15025_length_731_cov_13.892405	374	454	4	15	80	0.1875000
NODE_15027_length_731_cov_8.800633	218	298	0	43	80	0.5375000
NODE_15027_length_731_cov_8.800633	218	298	2	37	80	0.4625000
NODE_15027_length_731_cov_8.800633	271	352	2	81	81	1.0000000
NODE_15028_length_731_cov_7.658228	335	406	0	53	71	0.7464789
NODE_15028_length_731_cov_7.658228	335	406	4	18	71	0.2535211
NODE_15028_length_731_cov_7.658228	387	468	0	1	81	0.0123457
NODE_15028_length_731_cov_7.658228	387	468	4	80	81	0.9876543
NODE_15031_length_731_cov_5.471519	261	341	0	5	80	0.0625000
NODE_15031_length_731_cov_5.471519	261	341	4	14	80	0.1750000
NODE_15031_length_731_cov_5.471519	261	341	5	3	80	0.0375000
NODE_15031_length_731_cov_5.471519	261	341	6	58	80	0.7250000
NODE_15031_length_731_cov_5.471519	314	394	0	31	80	0.3875000
NODE_15031_length_731_cov_5.471519	314	394	4	36	80	0.4500000
NODE_15031_length_731_cov_5.471519	314	394	5	3	80	0.0375000
NODE_15031_length_731_cov_5.471519	314	394	6	10	80	0.1250000
NODE_15034_length_731_cov_4.083861	361	441	2	28	80	0.3500000
NODE_15034_length_731_cov_4.083861	361	441	4	52	80	0.6500000
NODE_15034_length_731_cov_4.083861	458	482	4	24	24	1.0000000
NODE_15050_length_731_cov_2.226266	466	548	2	82	82	1.0000000
NODE_15077_length_730_cov_51.556260	349	429	0	80	80	1.0000000
NODE_15077_length_730_cov_51.556260	402	482	0	80	80	1.0000000
NODE_15078_length_730_cov_39.862124	370	450	11	76	80	0.9500000
NODE_15078_length_730_cov_39.862124	370	450	12	4	80	0.0500000
NODE_15078_length_730_cov_39.862124	423	503	0	28	80	0.3500000
NODE_15078_length_730_cov_39.862124	423	503	11	52	80	0.6500000
NODE_15079_length_730_cov_15.801902	261	341	0	9	80	0.1125000
NODE_15079_length_730_cov_15.801902	261	341	2	71	80	0.8875000
NODE_15079_length_730_cov_15.801902	314	394	0	57	80	0.7125000
NODE_15079_length_730_cov_15.801902	314	394	2	23	80	0.2875000
NODE_15080_length_730_cov_11.746434	242	322	0	80	80	1.0000000
NODE_15080_length_730_cov_11.746434	295	375	0	80	80	1.0000000
NODE_15081_length_730_cov_9.209192	358	438	0	12	80	0.1500000
NODE_15081_length_730_cov_9.209192	358	438	2	68	80	0.8500000
NODE_15081_length_730_cov_9.209192	411	483	0	44	72	0.6111111
NODE_15081_length_730_cov_9.209192	411	483	2	28	72	0.3888889
NODE_15131_length_729_cov_44.188889	418	498	0	80	80	1.0000000
NODE_15131_length_729_cov_44.188889	471	551	0	80	80	1.0000000
NODE_15132_length_729_cov_40.390476	330	410	0	50	80	0.6250000
NODE_15132_length_729_cov_40.390476	330	410	2	30	80	0.3750000
NODE_15132_length_729_cov_40.390476	383	463	2	80	80	1.0000000
NODE_15133_length_729_cov_35.973016	231	311	0	80	80	1.0000000
NODE_15133_length_729_cov_35.973016	284	363	0	79	79	1.0000000
NODE_15134_length_729_cov_18.357143	170	250	2	53	80	0.6625000
NODE_15134_length_729_cov_18.357143	170	250	4	11	80	0.1375000
NODE_15134_length_729_cov_18.357143	170	250	6	16	80	0.2000000
NODE_15134_length_729_cov_18.357143	223	303	4	44	80	0.5500000
NODE_15134_length_729_cov_18.357143	223	303	6	36	80	0.4500000
NODE_15135_length_729_cov_17.928571	194	274	0	80	80	1.0000000
NODE_15135_length_729_cov_17.928571	247	327	0	80	80	1.0000000
NODE_15136_length_729_cov_17.373016	369	449	0	80	80	1.0000000
NODE_15136_length_729_cov_17.373016	422	502	0	80	80	1.0000000
NODE_15137_length_729_cov_12.452381	347	427	0	80	80	1.0000000
NODE_15137_length_729_cov_12.452381	400	480	0	80	80	1.0000000
NODE_15138_length_729_cov_10.388889	296	376	0	80	80	1.0000000
NODE_15138_length_729_cov_10.388889	349	429	0	80	80	1.0000000
NODE_15185_length_728_cov_23.503975	338	418	0	80	80	1.0000000
NODE_15185_length_728_cov_23.503975	391	471	0	80	80	1.0000000
NODE_15186_length_728_cov_22.496025	310	390	0	80	80	1.0000000
NODE_15186_length_728_cov_22.496025	363	443	0	80	80	1.0000000
NODE_15187_length_728_cov_16.596184	257	337	2	39	80	0.4875000
NODE_15187_length_728_cov_16.596184	257	337	4	41	80	0.5125000
NODE_15187_length_728_cov_16.596184	310	387	2	37	77	0.4805195
NODE_15187_length_728_cov_16.596184	310	387	4	40	77	0.5194805
NODE_15188_length_728_cov_16.114467	192	272	0	61	80	0.7625000
NODE_15188_length_728_cov_16.114467	192	272	2	19	80	0.2375000
NODE_15188_length_728_cov_16.114467	245	325	0	80	80	1.0000000
NODE_15189_length_728_cov_15.128776	298	377	0	1	79	0.0126582
NODE_15189_length_728_cov_15.128776	298	377	6	78	79	0.9873418
NODE_15189_length_728_cov_15.128776	350	430	0	54	80	0.6750000
NODE_15189_length_728_cov_15.128776	350	430	6	26	80	0.3250000
NODE_15190_length_728_cov_10.613672	269	349	0	80	80	1.0000000
NODE_15190_length_728_cov_10.613672	322	402	0	80	80	1.0000000
NODE_15191_length_728_cov_7.613672	408	488	0	80	80	1.0000000
NODE_15191_length_728_cov_7.613672	461	541	0	80	80	1.0000000
NODE_15196_length_728_cov_3.405405	335	415	4	27	80	0.3375000
NODE_15196_length_728_cov_3.405405	335	415	5	25	80	0.3125000
NODE_15196_length_728_cov_3.405405	335	415	6	22	80	0.2750000
NODE_15196_length_728_cov_3.405405	335	415	8	6	80	0.0750000
NODE_15244_length_727_cov_34.883758	57	137	0	80	80	1.0000000
NODE_15244_length_727_cov_34.883758	57	137	0	80	80	1.0000000
NODE_15244_length_727_cov_34.883758	57	137	0	80	80	1.0000000
NODE_15244_length_727_cov_34.883758	110	190	0	80	80	1.0000000
NODE_15244_length_727_cov_34.883758	110	190	0	80	80	1.0000000
NODE_15245_length_727_cov_32.025478	275	355	0	80	80	1.0000000
NODE_15245_length_727_cov_32.025478	328	408	0	80	80	1.0000000
NODE_15246_length_727_cov_28.523885	307	381	0	71	74	0.9594595
NODE_15246_length_727_cov_28.523885	307	381	2	3	74	0.0405405
NODE_15246_length_727_cov_28.523885	360	381	0	18	21	0.8571429
NODE_15246_length_727_cov_28.523885	360	381	2	3	21	0.1428571
NODE_15246_length_727_cov_28.523885	378	415	2	37	37	1.0000000
NODE_15247_length_727_cov_25.826433	325	405	0	80	80	1.0000000
NODE_15247_length_727_cov_25.826433	378	458	0	80	80	1.0000000
NODE_15248_length_727_cov_22.253185	150	230	9	19	80	0.2375000
NODE_15248_length_727_cov_22.253185	150	230	10	61	80	0.7625000
NODE_15248_length_727_cov_22.253185	203	283	0	9	80	0.1125000
NODE_15248_length_727_cov_22.253185	203	283	10	71	80	0.8875000
NODE_15249_length_727_cov_18.972930	263	343	0	43	80	0.5375000
NODE_15249_length_727_cov_18.972930	263	343	2	21	80	0.2625000
NODE_15249_length_727_cov_18.972930	263	343	4	16	80	0.2000000
NODE_15249_length_727_cov_18.972930	316	396	0	80	80	1.0000000
NODE_15250_length_727_cov_15.531847	269	349	0	80	80	1.0000000
NODE_15250_length_727_cov_15.531847	322	402	0	42	80	0.5250000
NODE_15250_length_727_cov_15.531847	322	402	2	38	80	0.4750000
NODE_15252_length_727_cov_10.178344	280	360	0	80	80	1.0000000
NODE_15252_length_727_cov_10.178344	333	413	0	80	80	1.0000000
NODE_15258_length_727_cov_4.955414	360	440	0	80	80	1.0000000
NODE_15258_length_727_cov_4.955414	413	493	0	80	80	1.0000000
NODE_15287_length_726_cov_52.923445	415	495	0	74	80	0.9250000
NODE_15287_length_726_cov_52.923445	415	495	4	6	80	0.0750000
NODE_15287_length_726_cov_52.923445	468	548	0	21	80	0.2625000
NODE_15287_length_726_cov_52.923445	468	548	4	59	80	0.7375000
NODE_15288_length_726_cov_35.896332	108	188	0	7	80	0.0875000
NODE_15288_length_726_cov_35.896332	108	188	2	73	80	0.9125000
NODE_15288_length_726_cov_35.896332	161	241	0	60	80	0.7500000
NODE_15288_length_726_cov_35.896332	161	241	2	20	80	0.2500000
NODE_15288_length_726_cov_35.896332	237	317	0	80	80	1.0000000
NODE_15288_length_726_cov_35.896332	290	370	0	80	80	1.0000000
NODE_15291_length_726_cov_8.534290	355	435	0	80	80	1.0000000
NODE_15291_length_726_cov_8.534290	408	488	0	80	80	1.0000000
NODE_15330_length_725_cov_40.856230	203	283	0	28	80	0.3500000
NODE_15330_length_725_cov_40.856230	203	283	4	52	80	0.6500000
NODE_15330_length_725_cov_40.856230	256	336	4	80	80	1.0000000
NODE_15330_length_725_cov_40.856230	332	412	0	64	80	0.8000000
NODE_15330_length_725_cov_40.856230	332	412	4	16	80	0.2000000
NODE_15330_length_725_cov_40.856230	385	465	0	80	80	1.0000000
NODE_15331_length_725_cov_25.036741	366	446	0	80	80	1.0000000
NODE_15331_length_725_cov_25.036741	419	499	0	80	80	1.0000000
NODE_15332_length_725_cov_23.009585	455	536	6	81	81	1.0000000
NODE_15333_length_725_cov_20.474441	112	192	0	80	80	1.0000000
NODE_15333_length_725_cov_20.474441	165	245	0	80	80	1.0000000
NODE_15334_length_725_cov_15.455272	106	186	0	80	80	1.0000000
NODE_15334_length_725_cov_15.455272	159	239	0	80	80	1.0000000
NODE_15334_length_725_cov_15.455272	235	315	0	80	80	1.0000000
NODE_15334_length_725_cov_15.455272	288	368	0	80	80	1.0000000
NODE_15335_length_725_cov_10.426518	289	369	0	80	80	1.0000000
NODE_15335_length_725_cov_10.426518	342	422	0	80	80	1.0000000
NODE_15337_length_725_cov_7.781150	189	269	0	80	80	1.0000000
NODE_15337_length_725_cov_7.781150	242	322	0	80	80	1.0000000
NODE_15388_length_724_cov_28.132800	354	434	0	80	80	1.0000000
NODE_15388_length_724_cov_28.132800	407	473	0	66	66	1.0000000
NODE_15389_length_724_cov_24.710400	376	461	4	81	85	0.9529412
NODE_15389_length_724_cov_24.710400	376	461	6	4	85	0.0470588
NODE_15389_length_724_cov_24.710400	434	514	2	23	80	0.2875000
NODE_15389_length_724_cov_24.710400	434	514	4	23	80	0.2875000
NODE_15389_length_724_cov_24.710400	434	514	6	34	80	0.4250000
NODE_15390_length_724_cov_13.960000	152	232	0	80	80	1.0000000
NODE_15390_length_724_cov_13.960000	205	248	0	43	43	1.0000000
NODE_15390_length_724_cov_13.960000	237	286	0	49	49	1.0000000
NODE_15390_length_724_cov_13.960000	259	302	0	43	43	1.0000000
NODE_15390_length_724_cov_13.960000	288	340	0	52	52	1.0000000
NODE_15390_length_724_cov_13.960000	313	393	0	80	80	1.0000000
NODE_15391_length_724_cov_13.065600	215	295	0	80	80	1.0000000
NODE_15391_length_724_cov_13.065600	268	347	0	79	79	1.0000000
NODE_15393_length_724_cov_10.358400	257	337	0	80	80	1.0000000
NODE_15393_length_724_cov_10.358400	310	385	0	75	75	1.0000000
NODE_15396_length_724_cov_6.451200	151	231	0	36	80	0.4500000
NODE_15396_length_724_cov_6.451200	151	231	2	44	80	0.5500000
NODE_15396_length_724_cov_6.451200	202	282	0	27	80	0.3375000
NODE_15396_length_724_cov_6.451200	202	282	2	53	80	0.6625000
NODE_15397_length_724_cov_5.921600	165	213	0	48	48	1.0000000
NODE_15399_length_724_cov_5.028800	416	469	0	53	53	1.0000000
NODE_15399_length_724_cov_5.028800	488	526	0	38	38	1.0000000
NODE_15403_length_724_cov_3.315200	166	246	0	80	80	1.0000000
NODE_15403_length_724_cov_3.315200	219	299	0	41	80	0.5125000
NODE_15403_length_724_cov_3.315200	219	299	2	39	80	0.4875000
NODE_15442_length_723_cov_81.453526	205	285	0	80	80	1.0000000
NODE_15442_length_723_cov_81.453526	258	338	0	80	80	1.0000000
NODE_15443_length_723_cov_33.075321	254	329	0	75	75	1.0000000
NODE_15443_length_723_cov_33.075321	307	387	0	80	80	1.0000000
NODE_15444_length_723_cov_25.410256	291	371	0	80	80	1.0000000
NODE_15444_length_723_cov_25.410256	344	424	0	80	80	1.0000000
NODE_15445_length_723_cov_18.097756	233	313	0	80	80	1.0000000
NODE_15445_length_723_cov_18.097756	286	351	0	65	65	1.0000000
NODE_15446_length_723_cov_14.113782	311	391	0	80	80	1.0000000
NODE_15446_length_723_cov_14.113782	364	444	0	80	80	1.0000000
NODE_15447_length_723_cov_11.634615	299	379	0	80	80	1.0000000
NODE_15447_length_723_cov_11.634615	352	432	0	80	80	1.0000000
NODE_15448_length_723_cov_8.342949	357	437	0	80	80	1.0000000
NODE_15448_length_723_cov_8.342949	410	490	0	80	80	1.0000000
NODE_15455_length_723_cov_2.711538	379	422	0	43	43	1.0000000
NODE_15459_length_723_cov_2.573718	383	413	0	30	30	1.0000000
NODE_15495_length_722_cov_19.182986	180	260	0	80	80	1.0000000
NODE_15495_length_722_cov_19.182986	233	313	0	80	80	1.0000000
NODE_15496_length_722_cov_13.582665	192	272	0	80	80	1.0000000
NODE_15496_length_722_cov_13.582665	245	326	0	81	81	1.0000000
NODE_15497_length_722_cov_9.202247	347	427	0	57	80	0.7125000
NODE_15497_length_722_cov_9.202247	347	427	2	23	80	0.2875000
NODE_15497_length_722_cov_9.202247	400	480	0	8	80	0.1000000
NODE_15497_length_722_cov_9.202247	400	480	2	72	80	0.9000000
NODE_15500_length_722_cov_6.707865	343	423	0	37	80	0.4625000
NODE_15500_length_722_cov_6.707865	343	423	2	43	80	0.5375000
NODE_15500_length_722_cov_6.707865	396	476	0	80	80	1.0000000
NODE_15504_length_722_cov_4.985554	332	393	0	61	61	1.0000000
NODE_15508_length_722_cov_3.977528	217	297	0	80	80	1.0000000
NODE_15508_length_722_cov_3.977528	270	350	0	76	80	0.9500000
NODE_15508_length_722_cov_3.977528	270	350	1	4	80	0.0500000
NODE_15553_length_721_cov_105.927653	425	505	0	64	80	0.8000000
NODE_15553_length_721_cov_105.927653	425	505	2	16	80	0.2000000
NODE_15553_length_721_cov_105.927653	478	558	0	11	80	0.1375000
NODE_15553_length_721_cov_105.927653	478	558	2	69	80	0.8625000
NODE_15554_length_721_cov_49.660772	304	384	0	80	80	1.0000000
NODE_15554_length_721_cov_49.660772	357	437	0	80	80	1.0000000
NODE_15555_length_721_cov_46.991961	341	421	0	8	80	0.1000000
NODE_15555_length_721_cov_46.991961	341	421	6	72	80	0.9000000
NODE_15555_length_721_cov_46.991961	394	474	0	39	80	0.4875000
NODE_15555_length_721_cov_46.991961	394	474	6	41	80	0.5125000
NODE_15556_length_721_cov_38.864952	208	288	0	80	80	1.0000000
NODE_15556_length_721_cov_38.864952	269	341	0	72	72	1.0000000
NODE_15556_length_721_cov_38.864952	337	417	0	80	80	1.0000000
NODE_15556_length_721_cov_38.864952	390	467	0	77	77	1.0000000
NODE_15557_length_721_cov_29.016077	192	272	0	80	80	1.0000000
NODE_15557_length_721_cov_29.016077	251	325	0	74	74	1.0000000
NODE_15558_length_721_cov_26.196141	398	478	0	80	80	1.0000000
NODE_15558_length_721_cov_26.196141	451	531	0	80	80	1.0000000
NODE_15560_length_721_cov_20.054662	178	258	0	80	80	1.0000000
NODE_15560_length_721_cov_20.054662	231	311	0	80	80	1.0000000
NODE_15561_length_721_cov_13.670418	263	343	0	28	80	0.3500000
NODE_15561_length_721_cov_13.670418	263	343	2	52	80	0.6500000
NODE_15561_length_721_cov_13.670418	316	396	0	21	80	0.2625000
NODE_15561_length_721_cov_13.670418	316	396	2	59	80	0.7375000
NODE_15562_length_721_cov_13.652733	268	350	0	82	82	1.0000000
NODE_15562_length_721_cov_13.652733	321	403	0	82	82	1.0000000
NODE_15563_length_721_cov_13.120579	312	392	0	27	80	0.3375000
NODE_15563_length_721_cov_13.120579	312	392	2	53	80	0.6625000
NODE_15563_length_721_cov_13.120579	365	445	0	80	80	1.0000000
NODE_15572_length_721_cov_4.491961	210	280	0	70	70	1.0000000
NODE_15572_length_721_cov_4.491961	253	333	0	80	80	1.0000000
NODE_15572_length_721_cov_4.491961	470	521	0	51	51	1.0000000
NODE_15608_length_720_cov_17.449275	267	347	0	80	80	1.0000000
NODE_15608_length_720_cov_17.449275	320	400	0	80	80	1.0000000
NODE_15609_length_720_cov_14.814815	261	341	0	80	80	1.0000000
NODE_15609_length_720_cov_14.814815	314	394	0	80	80	1.0000000
NODE_15610_length_720_cov_14.107890	290	370	0	80	80	1.0000000
NODE_15610_length_720_cov_14.107890	343	423	0	80	80	1.0000000
NODE_15612_length_720_cov_12.924316	314	394	0	68	80	0.8500000
NODE_15612_length_720_cov_12.924316	314	394	2	12	80	0.1500000
NODE_15612_length_720_cov_12.924316	367	447	0	15	80	0.1875000
NODE_15612_length_720_cov_12.924316	367	447	2	65	80	0.8125000
NODE_15614_length_720_cov_10.389694	435	515	0	80	80	1.0000000
NODE_15614_length_720_cov_10.389694	488	568	0	80	80	1.0000000
NODE_15620_length_720_cov_5.278583	309	389	0	57	80	0.7125000
NODE_15620_length_720_cov_5.278583	309	389	2	23	80	0.2875000
NODE_15620_length_720_cov_5.278583	362	442	0	4	80	0.0500000
NODE_15620_length_720_cov_5.278583	362	442	2	76	80	0.9500000
NODE_15624_length_720_cov_3.792271	157	235	0	28	78	0.3589744
NODE_15624_length_720_cov_3.792271	157	235	2	50	78	0.6410257
NODE_15624_length_720_cov_3.792271	215	265	2	50	50	1.0000000
NODE_15658_length_719_cov_30.256452	279	359	0	20	80	0.2500000
NODE_15658_length_719_cov_30.256452	279	359	1	10	80	0.1250000
NODE_15658_length_719_cov_30.256452	279	359	2	50	80	0.6250000
NODE_15658_length_719_cov_30.256452	332	412	2	80	80	1.0000000
NODE_15659_length_719_cov_29.093548	310	390	0	80	80	1.0000000
NODE_15659_length_719_cov_29.093548	363	443	0	80	80	1.0000000
NODE_15660_length_719_cov_10.988710	195	275	0	20	80	0.2500000
NODE_15660_length_719_cov_10.988710	195	275	7	1	80	0.0125000
NODE_15660_length_719_cov_10.988710	195	275	8	59	80	0.7375000
NODE_15660_length_719_cov_10.988710	248	328	8	80	80	1.0000000
NODE_15661_length_719_cov_10.837097	259	339	0	80	80	1.0000000
NODE_15661_length_719_cov_10.837097	312	392	0	80	80	1.0000000
NODE_15662_length_719_cov_7.622581	288	368	0	5	80	0.0625000
NODE_15662_length_719_cov_7.622581	288	368	5	1	80	0.0125000
NODE_15662_length_719_cov_7.622581	288	368	6	74	80	0.9250000
NODE_15662_length_719_cov_7.622581	341	421	6	80	80	1.0000000
NODE_15663_length_719_cov_7.570968	351	431	0	80	80	1.0000000
NODE_15663_length_719_cov_7.570968	404	484	0	80	80	1.0000000
NODE_15672_length_719_cov_4.264516	251	281	4	30	30	1.0000000
NODE_15684_length_719_cov_1.629032	88	163	12	64	75	0.8533334
NODE_15684_length_719_cov_1.629032	88	163	14	4	75	0.0533333
NODE_15684_length_719_cov_1.629032	88	163	16	7	75	0.0933333
NODE_15706_length_718_cov_35.382876	296	376	0	80	80	1.0000000
NODE_15706_length_718_cov_35.382876	296	376	0	80	80	1.0000000
NODE_15706_length_718_cov_35.382876	349	429	0	80	80	1.0000000
NODE_15706_length_718_cov_35.382876	349	429	0	80	80	1.0000000
NODE_15707_length_718_cov_24.211632	313	393	0	80	80	1.0000000
NODE_15707_length_718_cov_24.211632	366	446	0	80	80	1.0000000
NODE_15708_length_718_cov_18.300485	217	297	0	80	80	1.0000000
NODE_15708_length_718_cov_18.300485	270	350	0	80	80	1.0000000
NODE_15709_length_718_cov_14.757674	383	463	2	80	80	1.0000000
NODE_15709_length_718_cov_14.757674	436	516	0	52	80	0.6500000
NODE_15709_length_718_cov_14.757674	436	516	2	28	80	0.3500000
NODE_15710_length_718_cov_14.355412	254	334	0	80	80	1.0000000
NODE_15710_length_718_cov_14.355412	307	387	0	80	80	1.0000000
NODE_15715_length_718_cov_4.804523	263	343	0	80	80	1.0000000
NODE_15715_length_718_cov_4.804523	316	396	0	80	80	1.0000000
NODE_15750_length_717_cov_28.377023	335	415	0	80	80	1.0000000
NODE_15750_length_717_cov_28.377023	388	468	0	80	80	1.0000000
NODE_15751_length_717_cov_23.275081	162	242	0	80	80	1.0000000
NODE_15751_length_717_cov_23.275081	215	295	0	80	80	1.0000000
NODE_15752_length_717_cov_18.564725	319	399	0	80	80	1.0000000
NODE_15752_length_717_cov_18.564725	372	452	0	80	80	1.0000000
NODE_15753_length_717_cov_18.389968	358	438	0	80	80	1.0000000
NODE_15753_length_717_cov_18.389968	411	491	0	52	80	0.6500000
NODE_15753_length_717_cov_18.389968	411	491	2	28	80	0.3500000
NODE_15754_length_717_cov_17.932039	241	321	2	80	80	1.0000000
NODE_15754_length_717_cov_17.932039	294	374	0	46	80	0.5750000
NODE_15754_length_717_cov_17.932039	294	374	1	1	80	0.0125000
NODE_15754_length_717_cov_17.932039	294	374	2	33	80	0.4125000
NODE_15755_length_717_cov_14.637540	298	378	0	80	80	1.0000000
NODE_15755_length_717_cov_14.637540	351	431	0	80	80	1.0000000
NODE_15756_length_717_cov_12.279935	113	196	0	83	83	1.0000000
NODE_15756_length_717_cov_12.279935	169	249	0	80	80	1.0000000
NODE_15757_length_717_cov_10.711974	353	431	0	5	78	0.0641026
NODE_15757_length_717_cov_10.711974	353	431	2	29	78	0.3717949
NODE_15757_length_717_cov_10.711974	353	431	6	44	78	0.5641026
NODE_15758_length_717_cov_9.399676	331	411	0	80	80	1.0000000
NODE_15758_length_717_cov_9.399676	384	464	0	80	80	1.0000000
NODE_15762_length_717_cov_5.341424	475	555	0	80	80	1.0000000
NODE_15762_length_717_cov_5.341424	528	608	0	80	80	1.0000000
NODE_15770_length_717_cov_3.187702	285	322	0	37	37	1.0000000
NODE_15805_length_716_cov_16.800648	430	510	0	80	80	1.0000000
NODE_15805_length_716_cov_16.800648	483	563	0	80	80	1.0000000
NODE_15806_length_716_cov_12.565640	356	436	0	80	80	1.0000000
NODE_15806_length_716_cov_12.565640	409	489	0	80	80	1.0000000
NODE_15807_length_716_cov_9.277147	385	465	0	80	80	1.0000000
NODE_15807_length_716_cov_9.277147	438	518	0	80	80	1.0000000
NODE_15808_length_716_cov_9.257699	302	382	0	4	80	0.0500000
NODE_15808_length_716_cov_9.257699	302	382	2	76	80	0.9500000
NODE_15808_length_716_cov_9.257699	355	435	0	57	80	0.7125000
NODE_15808_length_716_cov_9.257699	355	435	2	23	80	0.2875000
NODE_15809_length_716_cov_6.761750	263	343	0	80	80	1.0000000
NODE_15809_length_716_cov_6.761750	316	396	0	80	80	1.0000000
NODE_15812_length_716_cov_4.909238	236	316	0	80	80	1.0000000
NODE_15812_length_716_cov_4.909238	289	369	0	80	80	1.0000000
NODE_15824_length_716_cov_2.068071	453	481	3	28	28	1.0000000
NODE_15853_length_715_cov_38.795455	260	340	0	80	80	1.0000000
NODE_15853_length_715_cov_38.795455	313	393	0	80	80	1.0000000
NODE_15854_length_715_cov_30.344156	316	396	1	56	80	0.7000000
NODE_15854_length_715_cov_30.344156	316	396	2	24	80	0.3000000
NODE_15854_length_715_cov_30.344156	369	449	0	45	80	0.5625000
NODE_15854_length_715_cov_30.344156	369	449	1	35	80	0.4375000
NODE_15857_length_715_cov_11.209416	484	564	0	80	80	1.0000000
NODE_15857_length_715_cov_11.209416	537	617	0	80	80	1.0000000
NODE_15858_length_715_cov_10.894481	189	242	15	53	53	1.0000000
NODE_15859_length_715_cov_10.628247	502	582	0	80	80	1.0000000
NODE_15859_length_715_cov_10.628247	555	635	0	80	80	1.0000000
NODE_15860_length_715_cov_8.647727	138	218	0	80	80	1.0000000
NODE_15860_length_715_cov_8.647727	191	271	0	80	80	1.0000000
NODE_15861_length_715_cov_8.412338	364	444	0	80	80	1.0000000
NODE_15861_length_715_cov_8.412338	417	497	0	80	80	1.0000000
NODE_15864_length_715_cov_5.373377	318	398	0	80	80	1.0000000
NODE_15864_length_715_cov_5.373377	371	451	0	80	80	1.0000000
NODE_15898_length_715_cov_1.271104	331	397	0	66	66	1.0000000
NODE_15910_length_714_cov_18.621138	297	377	0	6	80	0.0750000
NODE_15910_length_714_cov_18.621138	297	377	2	74	80	0.9250000
NODE_15910_length_714_cov_18.621138	350	430	2	80	80	1.0000000
NODE_15911_length_714_cov_15.468293	268	348	0	64	80	0.8000000
NODE_15911_length_714_cov_15.468293	268	348	2	16	80	0.2000000
NODE_15911_length_714_cov_15.468293	321	401	0	11	80	0.1375000
NODE_15911_length_714_cov_15.468293	321	401	2	69	80	0.8625000
NODE_15913_length_714_cov_10.530081	218	298	0	80	80	1.0000000
NODE_15913_length_714_cov_10.530081	271	351	0	80	80	1.0000000
NODE_15913_length_714_cov_10.530081	354	434	0	80	80	1.0000000
NODE_15913_length_714_cov_10.530081	407	487	0	80	80	1.0000000
NODE_15914_length_714_cov_8.365854	285	365	0	34	80	0.4250000
NODE_15914_length_714_cov_8.365854	285	365	2	46	80	0.5750000
NODE_15914_length_714_cov_8.365854	338	418	2	80	80	1.0000000
NODE_15919_length_714_cov_6.993496	263	343	0	68	80	0.8500000
NODE_15919_length_714_cov_6.993496	263	343	2	12	80	0.1500000
NODE_15919_length_714_cov_6.993496	316	384	0	68	68	1.0000000
NODE_15921_length_714_cov_4.224390	218	288	0	70	70	1.0000000
NODE_15921_length_714_cov_4.224390	271	351	0	80	80	1.0000000
NODE_15969_length_713_cov_19.304560	271	351	0	80	80	1.0000000
NODE_15969_length_713_cov_19.304560	324	404	0	80	80	1.0000000
NODE_15970_length_713_cov_16.926710	262	342	0	51	80	0.6375000
NODE_15970_length_713_cov_16.926710	262	342	2	29	80	0.3625000
NODE_15970_length_713_cov_16.926710	315	395	0	25	80	0.3125000
NODE_15970_length_713_cov_16.926710	315	395	2	55	80	0.6875000
NODE_15973_length_713_cov_7.159609	351	431	0	9	80	0.1125000
NODE_15973_length_713_cov_7.159609	351	431	2	71	80	0.8875000
NODE_15973_length_713_cov_7.159609	404	484	0	50	80	0.6250000
NODE_15973_length_713_cov_7.159609	404	484	2	30	80	0.3750000
NODE_15974_length_713_cov_6.723127	379	427	6	9	48	0.1875000
NODE_15974_length_713_cov_6.723127	379	427	10	33	48	0.6875000
NODE_15974_length_713_cov_6.723127	379	427	12	6	48	0.1250000
NODE_15975_length_713_cov_4.954397	90	171	0	81	81	1.0000000
NODE_15975_length_713_cov_4.954397	144	224	0	80	80	1.0000000
NODE_15980_length_713_cov_4.302932	402	482	0	80	80	1.0000000
NODE_15980_length_713_cov_4.302932	455	535	0	80	80	1.0000000
NODE_16004_length_713_cov_1.939739	15	75	0	60	60	1.0000000
NODE_16010_length_713_cov_1.605863	81	161	0	80	80	1.0000000
NODE_16010_length_713_cov_1.605863	134	214	0	80	80	1.0000000
NODE_16052_length_712_cov_32.931485	289	369	0	80	80	1.0000000
NODE_16052_length_712_cov_32.931485	342	422	0	80	80	1.0000000
NODE_16053_length_712_cov_31.752039	185	251	0	66	66	1.0000000
NODE_16053_length_712_cov_31.752039	228	307	0	79	79	1.0000000
NODE_16054_length_712_cov_22.567700	228	308	0	80	80	1.0000000
NODE_16054_length_712_cov_22.567700	281	361	0	80	80	1.0000000
NODE_16055_length_712_cov_19.306688	238	318	0	80	80	1.0000000
NODE_16055_length_712_cov_19.306688	291	371	0	80	80	1.0000000
NODE_16056_length_712_cov_14.929853	332	412	0	80	80	1.0000000
NODE_16056_length_712_cov_14.929853	385	465	0	80	80	1.0000000
NODE_16057_length_712_cov_14.228385	250	330	0	80	80	1.0000000
NODE_16057_length_712_cov_14.228385	303	383	0	80	80	1.0000000
NODE_16059_length_712_cov_9.221860	326	406	0	80	80	1.0000000
NODE_16059_length_712_cov_9.221860	379	463	0	84	84	1.0000000
NODE_16060_length_712_cov_8.368679	331	411	0	80	80	1.0000000
NODE_16060_length_712_cov_8.368679	384	464	0	80	80	1.0000000
NODE_16079_length_712_cov_2.350734	466	510	0	44	44	1.0000000
NODE_16118_length_711_cov_36.459150	146	223	0	77	77	1.0000000
NODE_16118_length_711_cov_36.459150	199	280	0	81	81	1.0000000
NODE_16119_length_711_cov_26.702614	460	540	2	80	80	1.0000000
NODE_16119_length_711_cov_26.702614	513	593	0	34	80	0.4250000
NODE_16119_length_711_cov_26.702614	513	593	2	46	80	0.5750000
NODE_16120_length_711_cov_19.632353	329	409	0	80	80	1.0000000
NODE_16120_length_711_cov_19.632353	382	462	0	80	80	1.0000000
NODE_16121_length_711_cov_19.267974	283	363	0	80	80	1.0000000
NODE_16121_length_711_cov_19.267974	336	416	0	80	80	1.0000000
NODE_16122_length_711_cov_12.813725	255	334	0	47	79	0.5949367
NODE_16122_length_711_cov_12.813725	255	334	2	32	79	0.4050633
NODE_16123_length_711_cov_12.147059	314	394	0	80	80	1.0000000
NODE_16123_length_711_cov_12.147059	367	447	0	80	80	1.0000000
NODE_16124_length_711_cov_10.009804	336	415	4	73	79	0.9240506
NODE_16124_length_711_cov_10.009804	336	415	6	6	79	0.0759494
NODE_16127_length_711_cov_5.619281	276	356	0	80	80	1.0000000
NODE_16127_length_711_cov_5.619281	329	409	0	80	80	1.0000000
NODE_16130_length_711_cov_4.040850	165	245	0	16	80	0.2000000
NODE_16130_length_711_cov_4.040850	165	245	2	64	80	0.8000000
NODE_16130_length_711_cov_4.040850	218	298	0	17	80	0.2125000
NODE_16130_length_711_cov_4.040850	218	298	2	63	80	0.7875000
NODE_16167_length_710_cov_73.721768	626	706	0	80	80	1.0000000
NODE_16168_length_710_cov_21.772504	292	372	0	80	80	1.0000000
NODE_16168_length_710_cov_21.772504	345	425	0	80	80	1.0000000
NODE_16169_length_710_cov_21.597381	18	54	0	35	36	0.9722222
NODE_16169_length_710_cov_21.597381	18	54	2	1	36	0.0277778
NODE_16170_length_710_cov_13.155483	306	386	0	9	80	0.1125000
NODE_16170_length_710_cov_13.155483	306	386	6	41	80	0.5125000
NODE_16170_length_710_cov_13.155483	306	386	8	30	80	0.3750000
NODE_16170_length_710_cov_13.155483	359	439	0	62	80	0.7750000
NODE_16170_length_710_cov_13.155483	359	439	6	18	80	0.2250000
NODE_16173_length_710_cov_8.031097	316	396	0	80	80	1.0000000
NODE_16173_length_710_cov_8.031097	369	449	0	80	80	1.0000000
NODE_16175_length_710_cov_6.664484	264	344	0	80	80	1.0000000
NODE_16178_length_710_cov_5.590835	352	421	0	69	69	1.0000000
NODE_16178_length_710_cov_5.590835	394	474	0	80	80	1.0000000
NODE_16180_length_710_cov_5.356792	248	328	0	63	80	0.7875000
NODE_16180_length_710_cov_5.356792	248	328	2	17	80	0.2125000
NODE_16180_length_710_cov_5.356792	301	381	0	80	80	1.0000000
NODE_16233_length_709_cov_12.227869	347	427	0	80	80	1.0000000
NODE_16233_length_709_cov_12.227869	400	480	0	80	80	1.0000000
NODE_16234_length_709_cov_10.531148	279	359	0	80	80	1.0000000
NODE_16234_length_709_cov_10.531148	332	412	0	80	80	1.0000000
NODE_16238_length_709_cov_7.181967	225	305	0	20	80	0.2500000
NODE_16238_length_709_cov_7.181967	225	305	2	60	80	0.7500000
NODE_16238_length_709_cov_7.181967	279	312	2	33	33	1.0000000
NODE_16241_length_709_cov_5.888525	239	319	0	17	80	0.2125000
NODE_16241_length_709_cov_5.888525	239	319	4	50	80	0.6250000
NODE_16241_length_709_cov_5.888525	239	319	8	13	80	0.1625000
NODE_16241_length_709_cov_5.888525	292	372	0	70	80	0.8750000
NODE_16241_length_709_cov_5.888525	292	372	4	10	80	0.1250000
NODE_16294_length_708_cov_42.435140	307	387	0	80	80	1.0000000
NODE_16294_length_708_cov_42.435140	360	440	0	80	80	1.0000000
NODE_16296_length_708_cov_33.412151	235	315	0	80	80	1.0000000
NODE_16296_length_708_cov_33.412151	288	368	0	80	80	1.0000000
NODE_16297_length_708_cov_23.034483	316	396	2	31	80	0.3875000
NODE_16297_length_708_cov_23.034483	316	396	3	39	80	0.4875000
NODE_16297_length_708_cov_23.034483	316	396	5	10	80	0.1250000
NODE_16297_length_708_cov_23.034483	369	449	3	80	80	1.0000000
NODE_16298_length_708_cov_20.449918	254	334	0	80	80	1.0000000
NODE_16298_length_708_cov_20.449918	307	387	0	80	80	1.0000000
NODE_16299_length_708_cov_19.998358	238	318	0	80	80	1.0000000
NODE_16299_length_708_cov_19.998358	291	371	0	80	80	1.0000000
NODE_16300_length_708_cov_19.021346	366	446	0	80	80	1.0000000
NODE_16300_length_708_cov_19.021346	419	499	0	80	80	1.0000000
NODE_16302_length_708_cov_12.228243	181	263	6	25	82	0.3048781
NODE_16302_length_708_cov_12.228243	181	263	8	57	82	0.6951219
NODE_16302_length_708_cov_12.228243	188	268	6	18	80	0.2250000
NODE_16302_length_708_cov_12.228243	188	268	8	62	80	0.7750000
NODE_16302_length_708_cov_12.228243	236	316	0	5	80	0.0625000
NODE_16302_length_708_cov_12.228243	236	316	1	6	80	0.0750000
NODE_16302_length_708_cov_12.228243	236	316	2	28	80	0.3500000
NODE_16302_length_708_cov_12.228243	236	316	6	2	80	0.0250000
NODE_16302_length_708_cov_12.228243	236	316	8	39	80	0.4875000
NODE_16302_length_708_cov_12.228243	312	392	1	18	80	0.2250000
NODE_16302_length_708_cov_12.228243	312	392	2	30	80	0.3750000
NODE_16302_length_708_cov_12.228243	312	392	6	32	80	0.4000000
NODE_16302_length_708_cov_12.228243	312	392	1	18	80	0.2250000
NODE_16302_length_708_cov_12.228243	312	392	2	30	80	0.3750000
NODE_16302_length_708_cov_12.228243	312	392	6	32	80	0.4000000
NODE_16302_length_708_cov_12.228243	365	445	4	18	80	0.2250000
NODE_16302_length_708_cov_12.228243	365	445	6	62	80	0.7750000
NODE_16303_length_708_cov_11.338259	255	335	0	80	80	1.0000000
NODE_16303_length_708_cov_11.338259	308	388	0	80	80	1.0000000
NODE_16305_length_708_cov_9.676519	219	299	0	80	80	1.0000000
NODE_16305_length_708_cov_9.676519	272	352	0	80	80	1.0000000
NODE_16306_length_708_cov_8.638752	324	399	0	75	75	1.0000000
NODE_16330_length_708_cov_2.699507	358	398	0	40	40	1.0000000
NODE_16370_length_707_cov_30.067434	325	405	0	47	80	0.5875000
NODE_16370_length_707_cov_30.067434	325	405	6	33	80	0.4125000
NODE_16370_length_707_cov_30.067434	378	458	0	22	80	0.2750000
NODE_16370_length_707_cov_30.067434	378	458	6	58	80	0.7250000
NODE_16371_length_707_cov_26.555921	241	321	0	80	80	1.0000000
NODE_16371_length_707_cov_26.555921	294	374	0	80	80	1.0000000
NODE_16372_length_707_cov_23.972039	322	402	0	80	80	1.0000000
NODE_16372_length_707_cov_23.972039	375	455	0	80	80	1.0000000
NODE_16373_length_707_cov_20.348684	157	237	0	80	80	1.0000000
NODE_16373_length_707_cov_20.348684	210	281	0	71	71	1.0000000
NODE_16374_length_707_cov_18.970395	253	333	0	80	80	1.0000000
NODE_16374_length_707_cov_18.970395	306	386	0	80	80	1.0000000
NODE_16375_length_707_cov_14.324013	302	382	0	6	80	0.0750000
NODE_16375_length_707_cov_14.324013	302	382	2	74	80	0.9250000
NODE_16375_length_707_cov_14.324013	355	435	0	58	80	0.7250000
NODE_16375_length_707_cov_14.324013	355	435	2	22	80	0.2750000
NODE_16378_length_707_cov_5.062500	313	393	0	80	80	1.0000000
NODE_16441_length_706_cov_34.116969	272	352	0	80	80	1.0000000
NODE_16441_length_706_cov_34.116969	325	405	0	78	80	0.9750000
NODE_16441_length_706_cov_34.116969	325	405	2	2	80	0.0250000
NODE_16442_length_706_cov_27.220758	229	309	0	20	80	0.2500000
NODE_16442_length_706_cov_27.220758	229	309	2	60	80	0.7500000
NODE_16442_length_706_cov_27.220758	282	362	0	60	80	0.7500000
NODE_16442_length_706_cov_27.220758	282	362	2	20	80	0.2500000
NODE_16443_length_706_cov_20.380560	264	344	1	5	80	0.0625000
NODE_16443_length_706_cov_20.380560	264	344	2	72	80	0.9000000
NODE_16443_length_706_cov_20.380560	264	344	3	3	80	0.0375000
NODE_16443_length_706_cov_20.380560	317	397	1	5	80	0.0625000
NODE_16443_length_706_cov_20.380560	317	397	2	19	80	0.2375000
NODE_16443_length_706_cov_20.380560	317	397	3	56	80	0.7000000
NODE_16444_length_706_cov_19.525535	289	369	0	80	80	1.0000000
NODE_16444_length_706_cov_19.525535	342	422	0	80	80	1.0000000
NODE_16454_length_706_cov_3.344316	465	545	0	64	80	0.8000000
NODE_16454_length_706_cov_3.344316	465	545	2	16	80	0.2000000
NODE_16454_length_706_cov_3.344316	518	598	0	11	80	0.1375000
NODE_16454_length_706_cov_3.344316	518	598	2	47	80	0.5875000
NODE_16454_length_706_cov_3.344316	518	598	4	22	80	0.2750000
NODE_16494_length_705_cov_19.211221	118	198	0	32	80	0.4000000
NODE_16494_length_705_cov_19.211221	118	198	4	48	80	0.6000000
NODE_16494_length_705_cov_19.211221	171	250	0	79	79	1.0000000
NODE_16495_length_705_cov_16.338284	291	339	0	48	48	1.0000000
NODE_16495_length_705_cov_16.338284	336	406	0	70	70	1.0000000
NODE_16496_length_705_cov_14.354785	209	289	0	80	80	1.0000000
NODE_16496_length_705_cov_14.354785	262	342	0	80	80	1.0000000
NODE_16497_length_705_cov_12.231023	293	373	0	80	80	1.0000000
NODE_16497_length_705_cov_12.231023	346	426	0	80	80	1.0000000
NODE_16498_length_705_cov_11.836634	390	470	0	35	80	0.4375000
NODE_16498_length_705_cov_11.836634	390	470	4	45	80	0.5625000
NODE_16498_length_705_cov_11.836634	443	523	0	80	80	1.0000000
NODE_16499_length_705_cov_10.049505	382	479	0	97	97	1.0000000
NODE_16499_length_705_cov_10.049505	452	532	0	80	80	1.0000000
NODE_16507_length_705_cov_4.275578	358	438	0	7	80	0.0875000
NODE_16507_length_705_cov_4.275578	358	438	6	1	80	0.0125000
NODE_16507_length_705_cov_4.275578	358	438	7	72	80	0.9000000
NODE_16507_length_705_cov_4.275578	411	491	0	37	80	0.4625000
NODE_16507_length_705_cov_4.275578	411	491	7	43	80	0.5375000
NODE_16509_length_705_cov_4.018152	306	364	2	58	58	1.0000000
NODE_16509_length_705_cov_4.018152	337	410	0	30	73	0.4109589
NODE_16509_length_705_cov_4.018152	337	410	2	43	73	0.5890411
NODE_16511_length_705_cov_3.620462	253	315	4	62	62	1.0000000
NODE_16511_length_705_cov_3.620462	308	368	2	11	60	0.1833333
NODE_16511_length_705_cov_3.620462	308	368	4	31	60	0.5166667
NODE_16511_length_705_cov_3.620462	308	368	6	7	60	0.1166667
NODE_16511_length_705_cov_3.620462	308	368	7	5	60	0.0833333
NODE_16511_length_705_cov_3.620462	308	368	9	1	60	0.0166667
NODE_16511_length_705_cov_3.620462	308	368	14	1	60	0.0166667
NODE_16511_length_705_cov_3.620462	308	368	15	4	60	0.0666667
NODE_16527_length_705_cov_1.607261	462	531	0	69	69	1.0000000
NODE_16549_length_705_cov_0.529703	33	97	8	64	64	1.0000000
NODE_16549_length_705_cov_0.529703	86	150	1	5	64	0.0781250
NODE_16549_length_705_cov_0.529703	86	150	3	3	64	0.0468750
NODE_16549_length_705_cov_0.529703	86	150	4	9	64	0.1406250
NODE_16549_length_705_cov_0.529703	86	150	6	33	64	0.5156250
NODE_16549_length_705_cov_0.529703	86	150	8	14	64	0.2187500
NODE_16550_length_704_cov_18.256198	295	375	0	80	80	1.0000000
NODE_16550_length_704_cov_18.256198	348	428	0	80	80	1.0000000
NODE_16552_length_704_cov_16.662810	264	344	8	80	80	1.0000000
NODE_16552_length_704_cov_16.662810	317	397	0	29	80	0.3625000
NODE_16552_length_704_cov_16.662810	317	397	3	1	80	0.0125000
NODE_16552_length_704_cov_16.662810	317	397	4	19	80	0.2375000
NODE_16552_length_704_cov_16.662810	317	397	5	1	80	0.0125000
NODE_16552_length_704_cov_16.662810	317	397	7	1	80	0.0125000
NODE_16552_length_704_cov_16.662810	317	397	8	29	80	0.3625000
NODE_16553_length_704_cov_12.641322	294	374	0	80	80	1.0000000
NODE_16553_length_704_cov_12.641322	347	427	0	80	80	1.0000000
NODE_16557_length_704_cov_5.603306	440	498	0	58	58	1.0000000
NODE_16564_length_704_cov_3.535537	303	383	2	1	80	0.0125000
NODE_16564_length_704_cov_3.535537	303	383	6	20	80	0.2500000
NODE_16564_length_704_cov_3.535537	303	383	8	59	80	0.7375000
NODE_16564_length_704_cov_3.535537	369	436	6	6	67	0.0895522
NODE_16564_length_704_cov_3.535537	369	436	8	61	67	0.9104478
NODE_16578_length_704_cov_1.963636	345	425	2	2	80	0.0250000
NODE_16578_length_704_cov_1.963636	345	425	4	58	80	0.7250000
NODE_16578_length_704_cov_1.963636	345	425	6	6	80	0.0750000
NODE_16578_length_704_cov_1.963636	345	425	8	14	80	0.1750000
NODE_16578_length_704_cov_1.963636	398	478	4	37	80	0.4625000
NODE_16578_length_704_cov_1.963636	398	478	6	18	80	0.2250000
NODE_16578_length_704_cov_1.963636	398	478	8	25	80	0.3125000
NODE_16598_length_703_cov_44.102649	514	594	0	80	80	1.0000000
NODE_16598_length_703_cov_44.102649	567	647	0	80	80	1.0000000
NODE_16599_length_703_cov_33.067881	521	594	109	4	73	0.0547945
NODE_16599_length_703_cov_33.067881	521	594	111	1	73	0.0136986
NODE_16599_length_703_cov_33.067881	521	594	112	3	73	0.0410959
NODE_16599_length_703_cov_33.067881	521	594	114	5	73	0.0684932
NODE_16599_length_703_cov_33.067881	521	594	115	5	73	0.0684932
NODE_16599_length_703_cov_33.067881	521	594	116	6	73	0.0821918
NODE_16599_length_703_cov_33.067881	521	594	117	14	73	0.1917808
NODE_16599_length_703_cov_33.067881	521	594	118	5	73	0.0684932
NODE_16599_length_703_cov_33.067881	521	594	119	2	73	0.0273973
NODE_16599_length_703_cov_33.067881	521	594	120	3	73	0.0410959
NODE_16599_length_703_cov_33.067881	521	594	121	3	73	0.0410959
NODE_16599_length_703_cov_33.067881	521	594	124	1	73	0.0136986
NODE_16599_length_703_cov_33.067881	521	594	125	6	73	0.0821918
NODE_16599_length_703_cov_33.067881	521	594	127	2	73	0.0273973
NODE_16599_length_703_cov_33.067881	521	594	129	12	73	0.1643836
NODE_16599_length_703_cov_33.067881	521	594	132	1	73	0.0136986
NODE_16599_length_703_cov_33.067881	561	602	109	11	41	0.2682927
NODE_16599_length_703_cov_33.067881	561	602	111	1	41	0.0243902
NODE_16599_length_703_cov_33.067881	561	602	114	1	41	0.0243902
NODE_16599_length_703_cov_33.067881	561	602	117	2	41	0.0487805
NODE_16599_length_703_cov_33.067881	561	602	118	4	41	0.0975610
NODE_16599_length_703_cov_33.067881	561	602	119	2	41	0.0487805
NODE_16599_length_703_cov_33.067881	561	602	120	3	41	0.0731707
NODE_16599_length_703_cov_33.067881	561	602	121	3	41	0.0731707
NODE_16599_length_703_cov_33.067881	561	602	127	1	41	0.0243902
NODE_16599_length_703_cov_33.067881	561	602	129	12	41	0.2926829
NODE_16599_length_703_cov_33.067881	561	602	132	1	41	0.0243902
NODE_16600_length_703_cov_30.266556	312	392	0	80	80	1.0000000
NODE_16600_length_703_cov_30.266556	365	445	0	80	80	1.0000000
NODE_16601_length_703_cov_17.006623	449	529	0	80	80	1.0000000
NODE_16601_length_703_cov_17.006623	502	582	0	80	80	1.0000000
NODE_16602_length_703_cov_14.801325	383	463	0	80	80	1.0000000
NODE_16602_length_703_cov_14.801325	436	516	0	80	80	1.0000000
NODE_16603_length_703_cov_11.766556	308	388	0	80	80	1.0000000
NODE_16603_length_703_cov_11.766556	361	441	0	80	80	1.0000000
NODE_16604_length_703_cov_10.405629	213	293	2	80	80	1.0000000
NODE_16604_length_703_cov_10.405629	266	301	2	35	35	1.0000000
NODE_16605_length_703_cov_6.966887	381	440	0	59	59	1.0000000
NODE_16616_length_703_cov_3.491722	256	309	0	43	53	0.8113208
NODE_16616_length_703_cov_3.491722	256	309	2	10	53	0.1886792
NODE_16616_length_703_cov_3.491722	257	337	0	71	80	0.8875000
NODE_16616_length_703_cov_3.491722	257	337	2	9	80	0.1125000
NODE_16616_length_703_cov_3.491722	305	362	0	57	57	1.0000000
NODE_16624_length_703_cov_2.687086	216	296	0	80	80	1.0000000
NODE_16624_length_703_cov_2.687086	269	349	0	80	80	1.0000000
NODE_16663_length_702_cov_49.784411	221	299	0	60	78	0.7692308
NODE_16663_length_702_cov_49.784411	221	299	3	18	78	0.2307692
NODE_16663_length_702_cov_49.784411	277	352	0	4	75	0.0533333
NODE_16663_length_702_cov_49.784411	277	352	3	67	75	0.8933333
NODE_16663_length_702_cov_49.784411	277	352	6	4	75	0.0533333
NODE_16664_length_702_cov_26.570481	201	281	0	80	80	1.0000000
NODE_16664_length_702_cov_26.570481	254	334	0	80	80	1.0000000
NODE_16665_length_702_cov_23.971808	139	219	0	80	80	1.0000000
NODE_16665_length_702_cov_23.971808	192	272	0	80	80	1.0000000
NODE_16665_length_702_cov_23.971808	268	348	0	56	80	0.7000000
NODE_16665_length_702_cov_23.971808	268	348	2	24	80	0.3000000
NODE_16665_length_702_cov_23.971808	321	401	0	3	80	0.0375000
NODE_16665_length_702_cov_23.971808	321	401	2	77	80	0.9625000
NODE_16666_length_702_cov_23.827529	448	528	0	44	80	0.5500000
NODE_16666_length_702_cov_23.827529	448	528	2	36	80	0.4500000
NODE_16666_length_702_cov_23.827529	501	581	0	80	80	1.0000000
NODE_16667_length_702_cov_14.661692	424	504	0	80	80	1.0000000
NODE_16667_length_702_cov_14.661692	477	557	0	80	80	1.0000000
NODE_16668_length_702_cov_13.908789	259	304	0	34	45	0.7555556
NODE_16668_length_702_cov_13.908789	259	304	2	11	45	0.2444444
NODE_16668_length_702_cov_13.908789	277	357	0	16	80	0.2000000
NODE_16668_length_702_cov_13.908789	277	357	2	19	80	0.2375000
NODE_16668_length_702_cov_13.908789	277	357	4	45	80	0.5625000
NODE_16668_length_702_cov_13.908789	289	357	0	4	68	0.0588235
NODE_16668_length_702_cov_13.908789	289	357	2	19	68	0.2794118
NODE_16668_length_702_cov_13.908789	289	357	4	45	68	0.6617647
NODE_16669_length_702_cov_8.502488	337	417	6	80	80	1.0000000
NODE_16669_length_702_cov_8.502488	390	470	3	12	80	0.1500000
NODE_16669_length_702_cov_8.502488	390	470	6	68	80	0.8500000
NODE_16671_length_702_cov_6.470978	209	289	0	80	80	1.0000000
NODE_16671_length_702_cov_6.470978	262	342	0	80	80	1.0000000
NODE_16729_length_701_cov_38.715947	178	258	12	74	80	0.9250000
NODE_16729_length_701_cov_38.715947	178	258	22	6	80	0.0750000
NODE_16729_length_701_cov_38.715947	231	311	12	21	80	0.2625000
NODE_16729_length_701_cov_38.715947	231	311	22	59	80	0.7375000
NODE_16729_length_701_cov_38.715947	307	387	10	5	80	0.0625000
NODE_16729_length_701_cov_38.715947	307	387	11	11	80	0.1375000
NODE_16729_length_701_cov_38.715947	307	387	12	53	80	0.6625000
NODE_16729_length_701_cov_38.715947	307	387	21	7	80	0.0875000
NODE_16729_length_701_cov_38.715947	307	387	22	4	80	0.0500000
NODE_16729_length_701_cov_38.715947	360	440	0	38	80	0.4750000
NODE_16729_length_701_cov_38.715947	360	440	11	1	80	0.0125000
NODE_16729_length_701_cov_38.715947	360	440	12	41	80	0.5125000
NODE_16730_length_701_cov_28.059801	432	513	0	81	81	1.0000000
NODE_16730_length_701_cov_28.059801	486	566	0	80	80	1.0000000
NODE_16731_length_701_cov_18.387043	258	338	0	5	80	0.0625000
NODE_16731_length_701_cov_18.387043	258	338	2	44	80	0.5500000
NODE_16731_length_701_cov_18.387043	258	338	4	31	80	0.3875000
NODE_16731_length_701_cov_18.387043	311	391	0	37	80	0.4625000
NODE_16731_length_701_cov_18.387043	311	391	2	17	80	0.2125000
NODE_16731_length_701_cov_18.387043	311	391	4	26	80	0.3250000
NODE_16732_length_701_cov_17.122924	295	367	8	11	72	0.1527778
NODE_16732_length_701_cov_17.122924	295	367	12	22	72	0.3055556
NODE_16732_length_701_cov_17.122924	295	367	15	30	72	0.4166667
NODE_16732_length_701_cov_17.122924	295	367	18	9	72	0.1250000
NODE_16733_length_701_cov_16.114618	242	322	0	77	80	0.9625000
NODE_16733_length_701_cov_16.114618	242	322	2	3	80	0.0375000
NODE_16733_length_701_cov_16.114618	295	375	0	24	80	0.3000000
NODE_16733_length_701_cov_16.114618	295	375	2	56	80	0.7000000
NODE_16734_length_701_cov_15.588040	399	479	0	80	80	1.0000000
NODE_16734_length_701_cov_15.588040	452	532	0	80	80	1.0000000
NODE_16736_length_701_cov_11.420266	229	309	0	80	80	1.0000000
NODE_16736_length_701_cov_11.420266	282	362	0	80	80	1.0000000
NODE_16737_length_701_cov_10.411960	202	283	0	81	81	1.0000000
NODE_16737_length_701_cov_10.411960	256	336	0	80	80	1.0000000
NODE_16738_length_701_cov_9.107973	400	480	0	80	80	1.0000000
NODE_16738_length_701_cov_9.107973	453	533	0	80	80	1.0000000
NODE_16739_length_701_cov_8.877076	283	363	0	80	80	1.0000000
NODE_16739_length_701_cov_8.877076	336	416	0	80	80	1.0000000
NODE_16740_length_701_cov_8.543189	341	421	0	80	80	1.0000000
NODE_16740_length_701_cov_8.543189	394	474	0	80	80	1.0000000
NODE_16742_length_701_cov_6.317276	273	353	0	80	80	1.0000000
NODE_16742_length_701_cov_6.317276	326	382	0	56	56	1.0000000
NODE_16747_length_701_cov_5.081395	318	374	6	1	56	0.0178571
NODE_16747_length_701_cov_5.081395	318	374	8	2	56	0.0357143
NODE_16747_length_701_cov_5.081395	318	374	10	11	56	0.1964286
NODE_16747_length_701_cov_5.081395	318	374	12	5	56	0.0892857
NODE_16747_length_701_cov_5.081395	318	374	14	37	56	0.6607143
NODE_16752_length_701_cov_3.320598	207	287	0	80	80	1.0000000
NODE_16752_length_701_cov_3.320598	260	340	0	80	80	1.0000000
NODE_16794_length_700_cov_22.241265	326	406	23	9	80	0.1125000
NODE_16794_length_700_cov_22.241265	326	406	25	2	80	0.0250000
NODE_16794_length_700_cov_22.241265	326	406	26	3	80	0.0375000
NODE_16794_length_700_cov_22.241265	326	406	30	14	80	0.1750000
NODE_16794_length_700_cov_22.241265	326	406	32	10	80	0.1250000
NODE_16794_length_700_cov_22.241265	326	406	33	1	80	0.0125000
NODE_16794_length_700_cov_22.241265	326	406	34	1	80	0.0125000
NODE_16794_length_700_cov_22.241265	326	406	35	2	80	0.0250000
NODE_16794_length_700_cov_22.241265	326	406	38	6	80	0.0750000
NODE_16794_length_700_cov_22.241265	326	406	42	12	80	0.1500000
NODE_16794_length_700_cov_22.241265	326	406	44	9	80	0.1125000
NODE_16794_length_700_cov_22.241265	326	406	46	1	80	0.0125000
NODE_16794_length_700_cov_22.241265	326	406	47	10	80	0.1250000
NODE_16796_length_700_cov_11.730449	294	374	0	80	80	1.0000000
NODE_16796_length_700_cov_11.730449	347	427	0	80	80	1.0000000
NODE_16800_length_700_cov_7.291181	317	397	0	80	80	1.0000000
NODE_16800_length_700_cov_7.291181	370	450	0	80	80	1.0000000
NODE_16801_length_700_cov_6.557404	353	404	0	51	51	1.0000000
NODE_16802_length_700_cov_5.475874	301	381	0	80	80	1.0000000
NODE_16802_length_700_cov_5.475874	354	434	0	80	80	1.0000000
NODE_16803_length_700_cov_3.960067	158	234	0	76	76	1.0000000
NODE_16803_length_700_cov_3.960067	209	291	0	82	82	1.0000000
NODE_16822_length_700_cov_1.517471	324	404	0	80	80	1.0000000
NODE_16822_length_700_cov_1.517471	377	457	0	80	80	1.0000000
NODE_16844_length_699_cov_18.446667	185	265	0	80	80	1.0000000
NODE_16844_length_699_cov_18.446667	238	318	0	80	80	1.0000000
NODE_16845_length_699_cov_18.383333	258	338	0	34	80	0.4250000
NODE_16845_length_699_cov_18.383333	258	338	2	46	80	0.5750000
NODE_16845_length_699_cov_18.383333	311	391	0	80	80	1.0000000
NODE_16846_length_699_cov_18.103333	218	298	0	80	80	1.0000000
NODE_16846_length_699_cov_18.103333	271	351	0	80	80	1.0000000
NODE_16847_length_699_cov_15.636667	279	359	0	80	80	1.0000000
NODE_16847_length_699_cov_15.636667	332	412	0	80	80	1.0000000
NODE_16848_length_699_cov_15.113333	313	393	0	80	80	1.0000000
NODE_16848_length_699_cov_15.113333	366	446	0	80	80	1.0000000
NODE_16849_length_699_cov_10.070000	233	313	0	80	80	1.0000000
NODE_16849_length_699_cov_10.070000	286	366	0	80	80	1.0000000
NODE_16849_length_699_cov_10.070000	362	442	0	80	80	1.0000000
NODE_16849_length_699_cov_10.070000	415	495	0	80	80	1.0000000
NODE_16850_length_699_cov_8.083333	347	427	0	80	80	1.0000000
NODE_16850_length_699_cov_8.083333	400	480	0	80	80	1.0000000
NODE_16851_length_699_cov_7.758333	307	387	0	80	80	1.0000000
NODE_16851_length_699_cov_7.758333	360	440	0	80	80	1.0000000
NODE_16852_length_699_cov_7.713333	252	332	0	80	80	1.0000000
NODE_16852_length_699_cov_7.713333	305	385	0	80	80	1.0000000
NODE_16853_length_699_cov_7.186667	271	332	0	1	61	0.0163934
NODE_16853_length_699_cov_7.186667	271	332	2	60	61	0.9836066
NODE_16853_length_699_cov_7.186667	348	428	0	80	80	1.0000000
NODE_16857_length_699_cov_5.815000	243	316	1	21	73	0.2876712
NODE_16857_length_699_cov_5.815000	243	316	2	52	73	0.7123288
NODE_16857_length_699_cov_5.815000	293	374	1	62	81	0.7654321
NODE_16857_length_699_cov_5.815000	293	374	2	19	81	0.2345679
NODE_16858_length_699_cov_5.520000	302	382	0	80	80	1.0000000
NODE_16858_length_699_cov_5.520000	355	435	0	80	80	1.0000000
NODE_16860_length_699_cov_4.051667	289	369	0	80	80	1.0000000
NODE_16860_length_699_cov_4.051667	342	422	0	80	80	1.0000000
NODE_16868_length_699_cov_2.498333	204	284	0	80	80	1.0000000
NODE_16868_length_699_cov_2.498333	257	337	0	80	80	1.0000000
NODE_16908_length_698_cov_47.350584	321	401	0	80	80	1.0000000
NODE_16908_length_698_cov_47.350584	374	454	0	80	80	1.0000000
NODE_16909_length_698_cov_42.848080	255	335	0	80	80	1.0000000
NODE_16909_length_698_cov_42.848080	308	388	0	80	80	1.0000000
NODE_16910_length_698_cov_36.697830	366	446	0	80	80	1.0000000
NODE_16910_length_698_cov_36.697830	419	484	0	65	65	1.0000000
NODE_16911_length_698_cov_23.874791	222	302	0	80	80	1.0000000
NODE_16911_length_698_cov_23.874791	275	355	0	80	80	1.0000000
NODE_16912_length_698_cov_7.133556	360	440	0	80	80	1.0000000
NODE_16912_length_698_cov_7.133556	413	493	0	80	80	1.0000000
NODE_16913_length_698_cov_6.520868	267	347	0	80	80	1.0000000
NODE_16913_length_698_cov_6.520868	320	400	0	80	80	1.0000000
NODE_16917_length_698_cov_4.762938	329	359	0	30	30	1.0000000
NODE_16926_length_698_cov_2.577629	309	389	0	80	80	1.0000000
NODE_16926_length_698_cov_2.577629	362	442	0	80	80	1.0000000
NODE_16962_length_697_cov_16.013378	305	385	0	80	80	1.0000000
NODE_16962_length_697_cov_16.013378	358	438	0	80	80	1.0000000
NODE_16963_length_697_cov_14.411371	440	520	0	63	80	0.7875000
NODE_16963_length_697_cov_14.411371	440	520	2	17	80	0.2125000
NODE_16963_length_697_cov_14.411371	493	573	0	80	80	1.0000000
NODE_16964_length_697_cov_14.282609	257	354	0	97	97	1.0000000
NODE_16964_length_697_cov_14.282609	327	385	0	58	58	1.0000000
NODE_16965_length_697_cov_9.969900	360	440	0	80	80	1.0000000
NODE_16965_length_697_cov_9.969900	413	493	0	80	80	1.0000000
NODE_16968_length_697_cov_6.117057	236	316	0	80	80	1.0000000
NODE_16968_length_697_cov_6.117057	289	369	0	80	80	1.0000000
NODE_17025_length_696_cov_28.360134	319	399	0	80	80	1.0000000
NODE_17025_length_696_cov_28.360134	372	452	0	80	80	1.0000000
NODE_17026_length_696_cov_18.708543	367	447	0	80	80	1.0000000
NODE_17026_length_696_cov_18.708543	420	500	0	80	80	1.0000000
NODE_17027_length_696_cov_18.170854	390	470	0	80	80	1.0000000
NODE_17027_length_696_cov_18.170854	443	523	0	50	80	0.6250000
NODE_17027_length_696_cov_18.170854	443	523	2	30	80	0.3750000
NODE_17028_length_696_cov_13.738693	266	346	0	80	80	1.0000000
NODE_17028_length_696_cov_13.738693	319	399	0	80	80	1.0000000
NODE_17030_length_696_cov_10.693467	239	266	0	27	27	1.0000000
NODE_17031_length_696_cov_9.949749	248	328	0	80	80	1.0000000
NODE_17031_length_696_cov_9.949749	301	381	0	80	80	1.0000000
NODE_17032_length_696_cov_8.658291	247	327	0	80	80	1.0000000
NODE_17032_length_696_cov_8.658291	300	380	0	80	80	1.0000000
NODE_17032_length_696_cov_8.658291	376	456	0	80	80	1.0000000
NODE_17032_length_696_cov_8.658291	429	509	0	80	80	1.0000000
NODE_17068_length_696_cov_1.675042	498	543	2	17	45	0.3777778
NODE_17068_length_696_cov_1.675042	498	543	4	28	45	0.6222222
NODE_17100_length_695_cov_24.112416	388	468	0	80	80	1.0000000
NODE_17100_length_695_cov_24.112416	441	521	0	80	80	1.0000000
NODE_17101_length_695_cov_12.152685	349	429	0	80	80	1.0000000
NODE_17101_length_695_cov_12.152685	402	482	0	80	80	1.0000000
NODE_17103_length_695_cov_8.466443	345	425	0	80	80	1.0000000
NODE_17103_length_695_cov_8.466443	398	478	0	80	80	1.0000000
NODE_17106_length_695_cov_5.661074	283	363	0	80	80	1.0000000
NODE_17106_length_695_cov_5.661074	346	416	0	70	70	1.0000000
NODE_17124_length_695_cov_2.050336	36	112	0	76	76	1.0000000
NODE_17161_length_694_cov_46.675630	30	110	0	46	80	0.5750000
NODE_17161_length_694_cov_46.675630	30	110	2	34	80	0.4250000
NODE_17161_length_694_cov_46.675630	83	163	2	80	80	1.0000000
NODE_17161_length_694_cov_46.675630	159	239	0	63	80	0.7875000
NODE_17161_length_694_cov_46.675630	159	239	2	17	80	0.2125000
NODE_17161_length_694_cov_46.675630	212	292	0	80	80	1.0000000
NODE_17162_length_694_cov_12.850420	326	406	0	80	80	1.0000000
NODE_17162_length_694_cov_12.850420	379	459	0	80	80	1.0000000
NODE_17163_length_694_cov_7.236975	318	396	0	78	78	1.0000000
NODE_17163_length_694_cov_7.236975	371	450	0	79	79	1.0000000
NODE_17166_length_694_cov_5.554622	404	484	0	80	80	1.0000000
NODE_17166_length_694_cov_5.554622	457	537	0	80	80	1.0000000
NODE_17168_length_694_cov_5.373109	152	232	0	80	80	1.0000000
NODE_17168_length_694_cov_5.373109	205	285	0	80	80	1.0000000
NODE_17227_length_693_cov_26.616162	435	515	0	80	80	1.0000000
NODE_17227_length_693_cov_26.616162	488	568	0	80	80	1.0000000
NODE_17228_length_693_cov_23.552189	193	273	0	71	80	0.8875000
NODE_17228_length_693_cov_23.552189	193	273	4	9	80	0.1125000
NODE_17228_length_693_cov_23.552189	246	326	0	18	80	0.2250000
NODE_17228_length_693_cov_23.552189	246	326	4	62	80	0.7750000
NODE_17229_length_693_cov_22.848485	231	311	0	26	80	0.3250000
NODE_17229_length_693_cov_22.848485	231	311	2	54	80	0.6750000
NODE_17229_length_693_cov_22.848485	284	364	0	30	80	0.3750000
NODE_17229_length_693_cov_22.848485	284	364	2	50	80	0.6250000
NODE_17230_length_693_cov_13.616162	219	299	0	52	80	0.6500000
NODE_17230_length_693_cov_13.616162	219	299	2	28	80	0.3500000
NODE_17230_length_693_cov_13.616162	272	352	0	3	80	0.0375000
NODE_17230_length_693_cov_13.616162	272	352	2	77	80	0.9625000
NODE_17231_length_693_cov_12.382155	305	385	0	80	80	1.0000000
NODE_17231_length_693_cov_12.382155	358	424	0	66	66	1.0000000
NODE_17232_length_693_cov_10.053872	279	359	0	80	80	1.0000000
NODE_17232_length_693_cov_10.053872	332	412	0	80	80	1.0000000
NODE_17233_length_693_cov_9.659933	247	327	0	80	80	1.0000000
NODE_17233_length_693_cov_9.659933	300	380	0	80	80	1.0000000
NODE_17235_length_693_cov_8.077441	343	423	0	80	80	1.0000000
NODE_17235_length_693_cov_8.077441	396	476	0	80	80	1.0000000
NODE_17243_length_693_cov_3.680135	250	321	0	71	71	1.0000000
NODE_17280_length_692_cov_33.416526	462	542	0	48	80	0.6000000
NODE_17280_length_692_cov_33.416526	462	542	2	32	80	0.4000000
NODE_17280_length_692_cov_33.416526	515	595	0	29	80	0.3625000
NODE_17280_length_692_cov_33.416526	515	595	2	51	80	0.6375000
NODE_17281_length_692_cov_17.559865	291	371	6	24	80	0.3000000
NODE_17281_length_692_cov_17.559865	291	371	7	19	80	0.2375000
NODE_17281_length_692_cov_17.559865	291	371	9	35	80	0.4375000
NODE_17281_length_692_cov_17.559865	291	371	11	2	80	0.0250000
NODE_17282_length_692_cov_15.070826	304	375	0	71	71	1.0000000
NODE_17283_length_692_cov_13.279933	308	388	0	22	80	0.2750000
NODE_17283_length_692_cov_13.279933	308	388	2	58	80	0.7250000
NODE_17283_length_692_cov_13.279933	361	441	0	58	80	0.7250000
NODE_17283_length_692_cov_13.279933	361	441	2	22	80	0.2750000
NODE_17285_length_692_cov_10.750422	317	397	0	80	80	1.0000000
NODE_17287_length_692_cov_7.497470	175	255	0	80	80	1.0000000
NODE_17287_length_692_cov_7.497470	228	312	0	84	84	1.0000000
NODE_17289_length_692_cov_7.370995	235	315	0	44	80	0.5500000
NODE_17289_length_692_cov_7.370995	235	315	1	36	80	0.4500000
NODE_17289_length_692_cov_7.370995	288	369	0	81	81	1.0000000
NODE_17328_length_692_cov_1.514334	404	484	0	21	80	0.2625000
NODE_17328_length_692_cov_1.514334	404	484	2	2	80	0.0250000
NODE_17328_length_692_cov_1.514334	404	484	6	7	80	0.0875000
NODE_17328_length_692_cov_1.514334	404	484	8	6	80	0.0750000
NODE_17328_length_692_cov_1.514334	404	484	12	22	80	0.2750000
NODE_17328_length_692_cov_1.514334	404	484	14	22	80	0.2750000
NODE_17350_length_691_cov_115.233108	276	356	0	14	80	0.1750000
NODE_17350_length_691_cov_115.233108	276	356	2	33	80	0.4125000
NODE_17350_length_691_cov_115.233108	276	356	14	33	80	0.4125000
NODE_17350_length_691_cov_115.233108	329	409	14	31	80	0.3875000
NODE_17350_length_691_cov_115.233108	329	409	18	6	80	0.0750000
NODE_17350_length_691_cov_115.233108	329	409	19	16	80	0.2000000
NODE_17350_length_691_cov_115.233108	329	409	21	27	80	0.3375000
NODE_17350_length_691_cov_115.233108	405	485	9	1	80	0.0125000
NODE_17350_length_691_cov_115.233108	405	485	10	6	80	0.0750000
NODE_17350_length_691_cov_115.233108	405	485	11	14	80	0.1750000
NODE_17350_length_691_cov_115.233108	405	485	15	9	80	0.1125000
NODE_17350_length_691_cov_115.233108	405	485	19	10	80	0.1250000
NODE_17350_length_691_cov_115.233108	405	485	21	9	80	0.1125000
NODE_17350_length_691_cov_115.233108	405	485	22	1	80	0.0125000
NODE_17350_length_691_cov_115.233108	405	485	31	1	80	0.0125000
NODE_17350_length_691_cov_115.233108	405	485	34	1	80	0.0125000
NODE_17350_length_691_cov_115.233108	405	485	35	9	80	0.1125000
NODE_17350_length_691_cov_115.233108	405	485	47	2	80	0.0250000
NODE_17350_length_691_cov_115.233108	405	485	49	1	80	0.0125000
NODE_17350_length_691_cov_115.233108	405	485	51	5	80	0.0625000
NODE_17350_length_691_cov_115.233108	405	485	53	2	80	0.0250000
NODE_17350_length_691_cov_115.233108	405	485	56	4	80	0.0500000
NODE_17350_length_691_cov_115.233108	405	485	58	3	80	0.0375000
NODE_17350_length_691_cov_115.233108	405	485	62	2	80	0.0250000
NODE_17350_length_691_cov_115.233108	458	538	35	8	80	0.1000000
NODE_17350_length_691_cov_115.233108	458	538	47	2	80	0.0250000
NODE_17350_length_691_cov_115.233108	458	538	49	1	80	0.0125000
NODE_17350_length_691_cov_115.233108	458	538	51	5	80	0.0625000
NODE_17350_length_691_cov_115.233108	458	538	53	2	80	0.0250000
NODE_17350_length_691_cov_115.233108	458	538	56	4	80	0.0500000
NODE_17350_length_691_cov_115.233108	458	538	58	3	80	0.0375000
NODE_17350_length_691_cov_115.233108	458	538	62	8	80	0.1000000
NODE_17350_length_691_cov_115.233108	458	538	68	13	80	0.1625000
NODE_17350_length_691_cov_115.233108	458	538	69	6	80	0.0750000
NODE_17350_length_691_cov_115.233108	458	538	70	10	80	0.1250000
NODE_17350_length_691_cov_115.233108	458	538	71	7	80	0.0875000
NODE_17350_length_691_cov_115.233108	458	538	73	6	80	0.0750000
NODE_17350_length_691_cov_115.233108	458	538	75	5	80	0.0625000
NODE_17351_length_691_cov_26.076014	188	268	0	27	80	0.3375000
NODE_17351_length_691_cov_26.076014	188	268	6	53	80	0.6625000
NODE_17351_length_691_cov_26.076014	241	321	0	12	80	0.1500000
NODE_17351_length_691_cov_26.076014	241	321	6	68	80	0.8500000
NODE_17352_length_691_cov_21.991554	288	368	0	80	80	1.0000000
NODE_17352_length_691_cov_21.991554	341	419	0	78	78	1.0000000
NODE_17353_length_691_cov_14.908784	226	306	0	80	80	1.0000000
NODE_17353_length_691_cov_14.908784	279	359	0	80	80	1.0000000
NODE_17358_length_691_cov_5.670608	325	402	0	77	77	1.0000000
NODE_17358_length_691_cov_5.670608	375	455	0	80	80	1.0000000
NODE_17361_length_691_cov_4.866554	103	183	0	80	80	1.0000000
NODE_17361_length_691_cov_4.866554	156	236	0	80	80	1.0000000
NODE_17367_length_691_cov_3.388514	304	384	0	80	80	1.0000000
NODE_17367_length_691_cov_3.388514	357	437	0	80	80	1.0000000
NODE_17415_length_690_cov_39.538071	563	612	0	49	49	1.0000000
NODE_17415_length_690_cov_39.538071	598	678	0	80	80	1.0000000
NODE_17415_length_690_cov_39.538071	651	690	0	39	39	1.0000000
NODE_17417_length_690_cov_30.336717	319	394	0	75	75	1.0000000
NODE_17417_length_690_cov_30.336717	372	453	0	81	81	1.0000000
NODE_17417_length_690_cov_30.336717	449	529	0	80	80	1.0000000
NODE_17417_length_690_cov_30.336717	502	582	0	80	80	1.0000000
NODE_17418_length_690_cov_26.888325	270	350	0	80	80	1.0000000
NODE_17418_length_690_cov_26.888325	323	403	0	80	80	1.0000000
NODE_17419_length_690_cov_23.360406	131	211	0	80	80	1.0000000
NODE_17419_length_690_cov_23.360406	188	264	0	76	76	1.0000000
NODE_17420_length_690_cov_18.737733	316	396	0	80	80	1.0000000
NODE_17420_length_690_cov_18.737733	369	449	0	80	80	1.0000000
NODE_17421_length_690_cov_16.593909	364	444	0	80	80	1.0000000
NODE_17421_length_690_cov_16.593909	417	497	0	80	80	1.0000000
NODE_17422_length_690_cov_12.896785	320	400	0	80	80	1.0000000
NODE_17422_length_690_cov_12.896785	373	453	0	80	80	1.0000000
NODE_17423_length_690_cov_10.818951	349	429	0	80	80	1.0000000
NODE_17424_length_690_cov_7.015228	273	353	0	80	80	1.0000000
NODE_17424_length_690_cov_7.015228	326	406	0	80	80	1.0000000
NODE_17429_length_690_cov_4.793570	316	365	27	2	49	0.0408163
NODE_17429_length_690_cov_4.793570	316	365	28	2	49	0.0408163
NODE_17429_length_690_cov_4.793570	316	365	29	2	49	0.0408163
NODE_17429_length_690_cov_4.793570	316	365	30	9	49	0.1836735
NODE_17429_length_690_cov_4.793570	316	365	31	18	49	0.3673469
NODE_17429_length_690_cov_4.793570	316	365	32	4	49	0.0816327
NODE_17429_length_690_cov_4.793570	316	365	33	1	49	0.0204082
NODE_17429_length_690_cov_4.793570	316	365	35	4	49	0.0816327
NODE_17429_length_690_cov_4.793570	316	365	36	3	49	0.0612245
NODE_17429_length_690_cov_4.793570	316	365	37	3	49	0.0612245
NODE_17429_length_690_cov_4.793570	316	365	38	1	49	0.0204082
NODE_17430_length_690_cov_4.717428	316	396	0	75	80	0.9375000
NODE_17430_length_690_cov_4.717428	316	396	4	5	80	0.0625000
NODE_17430_length_690_cov_4.717428	369	449	0	80	80	1.0000000
NODE_17484_length_689_cov_45.984746	244	322	0	78	78	1.0000000
NODE_17484_length_689_cov_45.984746	297	377	0	80	80	1.0000000
NODE_17485_length_689_cov_35.705085	436	516	0	80	80	1.0000000
NODE_17485_length_689_cov_35.705085	489	569	0	80	80	1.0000000
NODE_17486_length_689_cov_25.372881	211	291	0	12	80	0.1500000
NODE_17486_length_689_cov_25.372881	211	291	1	31	80	0.3875000
NODE_17486_length_689_cov_25.372881	211	291	2	37	80	0.4625000
NODE_17486_length_689_cov_25.372881	264	344	2	30	80	0.3750000
NODE_17486_length_689_cov_25.372881	264	344	4	50	80	0.6250000
NODE_17487_length_689_cov_20.138983	319	399	4	80	80	1.0000000
NODE_17487_length_689_cov_20.138983	372	452	4	80	80	1.0000000
NODE_17488_length_689_cov_14.377966	351	431	0	2	80	0.0250000
NODE_17488_length_689_cov_14.377966	351	431	2	78	80	0.9750000
NODE_17488_length_689_cov_14.377966	404	484	0	55	80	0.6875000
NODE_17488_length_689_cov_14.377966	404	484	2	25	80	0.3125000
NODE_17489_length_689_cov_9.477966	201	281	2	6	80	0.0750000
NODE_17489_length_689_cov_9.477966	201	281	4	74	80	0.9250000
NODE_17489_length_689_cov_9.477966	254	334	0	24	80	0.3000000
NODE_17489_length_689_cov_9.477966	254	334	2	35	80	0.4375000
NODE_17489_length_689_cov_9.477966	254	334	4	21	80	0.2625000
NODE_17491_length_689_cov_7.367797	122	207	18	8	85	0.0941176
NODE_17491_length_689_cov_7.367797	122	207	20	7	85	0.0823529
NODE_17491_length_689_cov_7.367797	122	207	24	29	85	0.3411765
NODE_17491_length_689_cov_7.367797	122	207	26	41	85	0.4823529
NODE_17492_length_689_cov_6.649153	242	322	0	80	80	1.0000000
NODE_17492_length_689_cov_6.649153	295	375	0	80	80	1.0000000
NODE_17504_length_689_cov_2.788136	128	208	0	80	80	1.0000000
NODE_17504_length_689_cov_2.788136	181	261	0	80	80	1.0000000
NODE_17548_length_688_cov_52.256367	198	278	10	22	80	0.2750000
NODE_17548_length_688_cov_52.256367	198	278	18	26	80	0.3250000
NODE_17548_length_688_cov_52.256367	198	278	19	32	80	0.4000000
NODE_17548_length_688_cov_52.256367	251	331	19	68	80	0.8500000
NODE_17548_length_688_cov_52.256367	251	331	20	12	80	0.1500000
NODE_17549_length_688_cov_37.563667	373	453	0	64	80	0.8000000
NODE_17549_length_688_cov_37.563667	373	453	2	16	80	0.2000000
NODE_17549_length_688_cov_37.563667	426	506	0	11	80	0.1375000
NODE_17549_length_688_cov_37.563667	426	506	2	69	80	0.8625000
NODE_17549_length_688_cov_37.563667	514	594	0	42	80	0.5250000
NODE_17549_length_688_cov_37.563667	514	594	4	14	80	0.1750000
NODE_17549_length_688_cov_37.563667	514	594	6	5	80	0.0625000
NODE_17549_length_688_cov_37.563667	514	594	8	2	80	0.0250000
NODE_17549_length_688_cov_37.563667	514	594	10	17	80	0.2125000
NODE_17549_length_688_cov_37.563667	514	594	0	42	80	0.5250000
NODE_17549_length_688_cov_37.563667	514	594	4	14	80	0.1750000
NODE_17549_length_688_cov_37.563667	514	594	6	5	80	0.0625000
NODE_17549_length_688_cov_37.563667	514	594	8	2	80	0.0250000
NODE_17549_length_688_cov_37.563667	514	594	10	17	80	0.2125000
NODE_17549_length_688_cov_37.563667	514	584	0	42	70	0.6000000
NODE_17549_length_688_cov_37.563667	514	584	4	14	70	0.2000000
NODE_17549_length_688_cov_37.563667	514	584	6	5	70	0.0714286
NODE_17549_length_688_cov_37.563667	514	584	8	2	70	0.0285714
NODE_17549_length_688_cov_37.563667	514	584	10	7	70	0.1000000
NODE_17549_length_688_cov_37.563667	567	647	4	3	80	0.0375000
NODE_17549_length_688_cov_37.563667	567	647	6	5	80	0.0625000
NODE_17549_length_688_cov_37.563667	567	647	8	2	80	0.0250000
NODE_17549_length_688_cov_37.563667	567	647	10	70	80	0.8750000
NODE_17549_length_688_cov_37.563667	567	646	4	3	79	0.0379747
NODE_17549_length_688_cov_37.563667	567	646	6	5	79	0.0632911
NODE_17549_length_688_cov_37.563667	567	646	8	2	79	0.0253165
NODE_17549_length_688_cov_37.563667	567	646	10	69	79	0.8734177
NODE_17550_length_688_cov_33.898132	373	453	0	80	80	1.0000000
NODE_17550_length_688_cov_33.898132	426	506	0	80	80	1.0000000
NODE_17551_length_688_cov_26.769100	457	537	0	7	80	0.0875000
NODE_17551_length_688_cov_26.769100	457	537	2	73	80	0.9125000
NODE_17551_length_688_cov_26.769100	510	590	0	50	80	0.6250000
NODE_17551_length_688_cov_26.769100	510	590	2	30	80	0.3750000
NODE_17552_length_688_cov_22.517827	332	412	0	73	80	0.9125000
NODE_17552_length_688_cov_22.517827	332	412	2	7	80	0.0875000
NODE_17552_length_688_cov_22.517827	385	465	0	20	80	0.2500000
NODE_17552_length_688_cov_22.517827	385	465	2	60	80	0.7500000
NODE_17553_length_688_cov_16.796265	225	305	0	8	80	0.1000000
NODE_17553_length_688_cov_16.796265	225	305	2	72	80	0.9000000
NODE_17553_length_688_cov_16.796265	278	358	0	61	80	0.7625000
NODE_17553_length_688_cov_16.796265	278	358	2	19	80	0.2375000
NODE_17555_length_688_cov_13.758913	378	458	0	80	80	1.0000000
NODE_17555_length_688_cov_13.758913	431	511	0	80	80	1.0000000
NODE_17556_length_688_cov_12.511036	330	410	0	80	80	1.0000000
NODE_17556_length_688_cov_12.511036	383	463	0	80	80	1.0000000
NODE_17561_length_688_cov_5.446520	366	414	0	47	48	0.9791667
NODE_17561_length_688_cov_5.446520	366	414	3	1	48	0.0208333
NODE_17567_length_688_cov_3.692699	265	345	0	80	80	1.0000000
NODE_17567_length_688_cov_3.692699	322	380	0	54	58	0.9310345
NODE_17567_length_688_cov_3.692699	322	380	2	4	58	0.0689655
NODE_17621_length_687_cov_50.214286	430	510	0	80	80	1.0000000
NODE_17621_length_687_cov_50.214286	483	563	0	80	80	1.0000000
NODE_17622_length_687_cov_32.564626	204	284	0	80	80	1.0000000
NODE_17622_length_687_cov_32.564626	257	337	0	80	80	1.0000000
NODE_17623_length_687_cov_22.365646	231	311	0	80	80	1.0000000
NODE_17623_length_687_cov_22.365646	284	364	0	80	80	1.0000000
NODE_17626_length_687_cov_11.943878	233	313	0	80	80	1.0000000
NODE_17626_length_687_cov_11.943878	286	366	0	80	80	1.0000000
NODE_17627_length_687_cov_7.865646	311	391	0	20	80	0.2500000
NODE_17627_length_687_cov_7.865646	311	391	2	60	80	0.7500000
NODE_17627_length_687_cov_7.865646	364	444	0	73	80	0.9125000
NODE_17627_length_687_cov_7.865646	364	444	2	7	80	0.0875000
NODE_17628_length_687_cov_7.353741	286	366	0	10	80	0.1250000
NODE_17628_length_687_cov_7.353741	286	366	2	17	80	0.2125000
NODE_17628_length_687_cov_7.353741	286	366	6	53	80	0.6625000
NODE_17628_length_687_cov_7.353741	339	419	0	8	80	0.1000000
NODE_17628_length_687_cov_7.353741	339	419	2	17	80	0.2125000
NODE_17628_length_687_cov_7.353741	339	419	6	55	80	0.6875000
NODE_17631_length_687_cov_5.903061	369	449	0	80	80	1.0000000
NODE_17631_length_687_cov_5.903061	422	502	0	80	80	1.0000000
NODE_17695_length_686_cov_34.642249	355	440	0	85	85	1.0000000
NODE_17695_length_686_cov_34.642249	413	493	0	80	80	1.0000000
NODE_17697_length_686_cov_26.357751	413	493	0	80	80	1.0000000
NODE_17697_length_686_cov_26.357751	466	546	0	80	80	1.0000000
NODE_17698_length_686_cov_16.715503	400	480	0	80	80	1.0000000
NODE_17698_length_686_cov_16.715503	453	533	0	80	80	1.0000000
NODE_17757_length_685_cov_8.769625	178	258	0	15	80	0.1875000
NODE_17757_length_685_cov_8.769625	178	258	1	45	80	0.5625000
NODE_17757_length_685_cov_8.769625	178	258	2	20	80	0.2500000
NODE_17757_length_685_cov_8.769625	222	250	0	7	28	0.2500000
NODE_17757_length_685_cov_8.769625	222	250	1	21	28	0.7500000
NODE_17757_length_685_cov_8.769625	231	311	0	68	80	0.8500000
NODE_17757_length_685_cov_8.769625	231	311	1	12	80	0.1500000
NODE_17764_length_685_cov_4.447099	249	329	0	59	80	0.7375000
NODE_17764_length_685_cov_4.447099	249	329	4	21	80	0.2625000
NODE_17764_length_685_cov_4.447099	302	382	0	6	80	0.0750000
NODE_17764_length_685_cov_4.447099	302	382	4	74	80	0.9250000
NODE_17768_length_685_cov_3.556314	338	418	0	56	80	0.7000000
NODE_17768_length_685_cov_3.556314	338	418	2	24	80	0.3000000
NODE_17768_length_685_cov_3.556314	391	471	0	80	80	1.0000000
NODE_17821_length_684_cov_7.521368	189	269	0	80	80	1.0000000
NODE_17821_length_684_cov_7.521368	242	322	0	80	80	1.0000000
NODE_17832_length_684_cov_3.639316	306	386	0	80	80	1.0000000
NODE_17832_length_684_cov_3.639316	359	439	0	80	80	1.0000000
NODE_17866_length_683_cov_27.493151	346	426	0	34	80	0.4250000
NODE_17866_length_683_cov_27.493151	346	426	4	8	80	0.1000000
NODE_17866_length_683_cov_27.493151	346	426	5	38	80	0.4750000
NODE_17866_length_683_cov_27.493151	399	479	0	80	80	1.0000000
NODE_17867_length_683_cov_12.880137	242	321	0	34	79	0.4303797
NODE_17867_length_683_cov_12.880137	242	321	6	45	79	0.5696203
NODE_17868_length_683_cov_11.772260	218	274	0	56	56	1.0000000
NODE_17868_length_683_cov_11.772260	247	333	0	86	86	1.0000000
NODE_17869_length_683_cov_9.936644	435	515	0	80	80	1.0000000
NODE_17869_length_683_cov_9.936644	488	568	0	80	80	1.0000000
NODE_17871_length_683_cov_9.017123	296	364	0	68	68	1.0000000
NODE_17871_length_683_cov_9.017123	337	417	0	80	80	1.0000000
NODE_17873_length_683_cov_6.797945	359	415	0	56	56	1.0000000
NODE_17884_length_683_cov_3.176370	113	186	0	73	73	1.0000000
NODE_17947_length_682_cov_33.516295	423	503	0	80	80	1.0000000
NODE_17947_length_682_cov_33.516295	476	556	0	80	80	1.0000000
NODE_17948_length_682_cov_27.022298	479	559	0	64	80	0.8000000
NODE_17948_length_682_cov_27.022298	479	559	4	11	80	0.1375000
NODE_17948_length_682_cov_27.022298	479	559	10	1	80	0.0125000
NODE_17948_length_682_cov_27.022298	479	559	12	3	80	0.0375000
NODE_17948_length_682_cov_27.022298	479	559	14	1	80	0.0125000
NODE_17948_length_682_cov_27.022298	532	612	0	11	80	0.1375000
NODE_17948_length_682_cov_27.022298	532	612	4	11	80	0.1375000
NODE_17948_length_682_cov_27.022298	532	612	10	1	80	0.0125000
NODE_17948_length_682_cov_27.022298	532	612	12	3	80	0.0375000
NODE_17948_length_682_cov_27.022298	532	612	14	1	80	0.0125000
NODE_17948_length_682_cov_27.022298	532	612	16	16	80	0.2000000
NODE_17948_length_682_cov_27.022298	532	612	18	37	80	0.4625000
NODE_17949_length_682_cov_19.612350	434	514	2	80	80	1.0000000
NODE_17949_length_682_cov_19.612350	487	567	0	47	80	0.5875000
NODE_17949_length_682_cov_19.612350	487	567	2	33	80	0.4125000
NODE_17950_length_682_cov_16.620926	261	341	0	80	80	1.0000000
NODE_17950_length_682_cov_16.620926	314	394	0	80	80	1.0000000
NODE_17951_length_682_cov_13.735849	251	331	0	80	80	1.0000000
NODE_17951_length_682_cov_13.735849	304	384	0	80	80	1.0000000
NODE_17952_length_682_cov_12.835334	228	308	0	22	80	0.2750000
NODE_17952_length_682_cov_12.835334	228	308	2	58	80	0.7250000
NODE_17952_length_682_cov_12.835334	281	361	0	44	80	0.5500000
NODE_17952_length_682_cov_12.835334	281	361	2	36	80	0.4500000
NODE_17956_length_682_cov_7.504288	224	304	0	80	80	1.0000000
NODE_17956_length_682_cov_7.504288	277	357	0	80	80	1.0000000
NODE_17960_length_682_cov_5.102916	314	351	0	37	37	1.0000000
NODE_17963_length_682_cov_4.579760	152	232	0	80	80	1.0000000
NODE_17963_length_682_cov_4.579760	205	285	0	80	80	1.0000000
NODE_17967_length_682_cov_4.006861	317	397	0	80	80	1.0000000
NODE_17967_length_682_cov_4.006861	370	450	0	80	80	1.0000000
NODE_17968_length_682_cov_3.859348	160	240	0	80	80	1.0000000
NODE_17968_length_682_cov_3.859348	213	293	0	80	80	1.0000000
NODE_18010_length_681_cov_51.810997	181	261	0	80	80	1.0000000
NODE_18010_length_681_cov_51.810997	234	316	0	82	82	1.0000000
NODE_18011_length_681_cov_32.128866	347	427	0	6	80	0.0750000
NODE_18011_length_681_cov_32.128866	347	427	6	1	80	0.0125000
NODE_18011_length_681_cov_32.128866	347	427	14	18	80	0.2250000
NODE_18011_length_681_cov_32.128866	347	427	15	55	80	0.6875000
NODE_18011_length_681_cov_32.128866	400	475	0	54	75	0.7200000
NODE_18011_length_681_cov_32.128866	400	475	6	1	75	0.0133333
NODE_18011_length_681_cov_32.128866	400	475	15	20	75	0.2666667
NODE_18012_length_681_cov_19.079038	282	362	0	80	80	1.0000000
NODE_18012_length_681_cov_19.079038	335	415	0	80	80	1.0000000
NODE_18013_length_681_cov_17.053265	294	374	0	80	80	1.0000000
NODE_18013_length_681_cov_17.053265	347	427	0	80	80	1.0000000
NODE_18014_length_681_cov_11.183849	306	386	0	80	80	1.0000000
NODE_18014_length_681_cov_11.183849	359	439	0	80	80	1.0000000
NODE_18015_length_681_cov_8.065292	236	316	0	80	80	1.0000000
NODE_18015_length_681_cov_8.065292	289	369	0	80	80	1.0000000
NODE_18017_length_681_cov_6.888316	344	424	0	79	80	0.9875000
NODE_18017_length_681_cov_6.888316	344	424	4	1	80	0.0125000
NODE_18017_length_681_cov_6.888316	397	477	0	80	80	1.0000000
NODE_18080_length_680_cov_35.695353	348	428	0	80	80	1.0000000
NODE_18080_length_680_cov_35.695353	401	481	0	41	80	0.5125000
NODE_18080_length_680_cov_35.695353	401	481	1	22	80	0.2750000
NODE_18080_length_680_cov_35.695353	401	481	2	17	80	0.2125000
NODE_18081_length_680_cov_17.500861	296	376	0	80	80	1.0000000
NODE_18081_length_680_cov_17.500861	349	429	0	80	80	1.0000000
NODE_18082_length_680_cov_16.685026	260	340	0	40	80	0.5000000
NODE_18082_length_680_cov_16.685026	260	340	2	40	80	0.5000000
NODE_18082_length_680_cov_16.685026	313	393	0	30	80	0.3750000
NODE_18082_length_680_cov_16.685026	313	393	2	50	80	0.6250000
NODE_18083_length_680_cov_15.345955	332	412	0	80	80	1.0000000
NODE_18083_length_680_cov_15.345955	385	465	0	80	80	1.0000000
NODE_18089_length_680_cov_3.858864	458	538	0	80	80	1.0000000
NODE_18107_length_680_cov_1.879518	236	256	0	20	20	1.0000000
NODE_18146_length_679_cov_52.046552	367	447	0	80	80	1.0000000
NODE_18146_length_679_cov_52.046552	420	500	0	27	80	0.3375000
NODE_18146_length_679_cov_52.046552	420	500	2	53	80	0.6625000
NODE_18147_length_679_cov_40.353448	179	259	0	80	80	1.0000000
NODE_18147_length_679_cov_40.353448	232	312	0	80	80	1.0000000
NODE_18148_length_679_cov_38.144828	364	428	0	64	64	1.0000000
NODE_18148_length_679_cov_38.144828	401	481	0	80	80	1.0000000
NODE_18149_length_679_cov_17.134483	277	357	0	80	80	1.0000000
NODE_18149_length_679_cov_17.134483	330	410	0	80	80	1.0000000
NODE_18150_length_679_cov_15.046552	310	375	0	65	65	1.0000000
NODE_18151_length_679_cov_12.586207	247	327	0	80	80	1.0000000
NODE_18151_length_679_cov_12.586207	303	381	0	78	78	1.0000000
NODE_18152_length_679_cov_12.282759	337	417	0	80	80	1.0000000
NODE_18152_length_679_cov_12.282759	390	470	0	80	80	1.0000000
NODE_18153_length_679_cov_11.532759	205	285	0	80	80	1.0000000
NODE_18153_length_679_cov_11.532759	258	338	0	80	80	1.0000000
NODE_18155_length_679_cov_8.043103	269	341	0	72	72	1.0000000
NODE_18155_length_679_cov_8.043103	314	394	0	80	80	1.0000000
NODE_18156_length_679_cov_7.267241	191	271	0	25	80	0.3125000
NODE_18156_length_679_cov_7.267241	191	271	8	55	80	0.6875000
NODE_18156_length_679_cov_7.267241	244	324	8	80	80	1.0000000
NODE_18162_length_679_cov_5.391379	279	331	0	16	52	0.3076923
NODE_18162_length_679_cov_5.391379	279	331	2	30	52	0.5769231
NODE_18162_length_679_cov_5.391379	279	331	4	6	52	0.1153846
NODE_18164_length_679_cov_3.813793	10	69	4	10	59	0.1694915
NODE_18164_length_679_cov_3.813793	10	69	6	49	59	0.8305085
NODE_18164_length_679_cov_3.813793	48	122	6	74	74	1.0000000
NODE_18217_length_678_cov_38.910190	252	332	0	80	80	1.0000000
NODE_18217_length_678_cov_38.910190	305	385	0	80	80	1.0000000
NODE_18217_length_678_cov_38.910190	381	461	0	80	80	1.0000000
NODE_18217_length_678_cov_38.910190	434	514	0	80	80	1.0000000
NODE_18218_length_678_cov_20.663212	243	323	0	80	80	1.0000000
NODE_18218_length_678_cov_20.663212	296	376	0	80	80	1.0000000
NODE_18219_length_678_cov_12.081174	243	323	0	80	80	1.0000000
NODE_18219_length_678_cov_12.081174	296	376	0	80	80	1.0000000
NODE_18224_length_678_cov_6.559585	195	264	0	69	69	1.0000000
NODE_18224_length_678_cov_6.559585	237	317	0	80	80	1.0000000
NODE_18228_length_678_cov_4.462867	133	213	0	80	80	1.0000000
NODE_18228_length_678_cov_4.462867	186	266	0	80	80	1.0000000
NODE_18239_length_678_cov_2.716753	351	431	0	80	80	1.0000000
NODE_18239_length_678_cov_2.716753	404	484	0	80	80	1.0000000
NODE_18289_length_677_cov_22.235294	274	354	0	80	80	1.0000000
NODE_18289_length_677_cov_22.235294	327	407	0	80	80	1.0000000
NODE_18290_length_677_cov_16.410035	124	206	0	82	82	1.0000000
NODE_18290_length_677_cov_16.410035	177	261	0	84	84	1.0000000
NODE_18291_length_677_cov_11.031142	393	473	0	80	80	1.0000000
NODE_18291_length_677_cov_11.031142	446	526	0	80	80	1.0000000
NODE_18292_length_677_cov_10.129758	258	338	0	80	80	1.0000000
NODE_18292_length_677_cov_10.129758	311	391	0	80	80	1.0000000
NODE_18295_length_677_cov_6.660900	217	297	55	2	80	0.0250000
NODE_18295_length_677_cov_6.660900	217	297	57	5	80	0.0625000
NODE_18295_length_677_cov_6.660900	217	297	61	1	80	0.0125000
NODE_18295_length_677_cov_6.660900	217	297	67	2	80	0.0250000
NODE_18295_length_677_cov_6.660900	217	297	68	16	80	0.2000000
NODE_18295_length_677_cov_6.660900	217	297	73	2	80	0.0250000
NODE_18295_length_677_cov_6.660900	217	297	75	17	80	0.2125000
NODE_18295_length_677_cov_6.660900	217	297	76	5	80	0.0625000
NODE_18295_length_677_cov_6.660900	217	297	77	6	80	0.0750000
NODE_18295_length_677_cov_6.660900	217	297	80	24	80	0.3000000
NODE_18297_length_677_cov_5.228374	366	446	0	80	80	1.0000000
NODE_18312_length_677_cov_2.306228	230	278	3	8	48	0.1666667
NODE_18312_length_677_cov_2.306228	230	278	9	31	48	0.6458333
NODE_18312_length_677_cov_2.306228	230	278	12	9	48	0.1875000
NODE_18329_length_677_cov_1.709343	369	449	0	42	80	0.5250000
NODE_18329_length_677_cov_1.709343	369	449	1	5	80	0.0625000
NODE_18329_length_677_cov_1.709343	369	449	2	1	80	0.0125000
NODE_18329_length_677_cov_1.709343	369	449	6	23	80	0.2875000
NODE_18329_length_677_cov_1.709343	369	449	8	9	80	0.1125000
NODE_18329_length_677_cov_1.709343	422	502	6	30	80	0.3750000
NODE_18329_length_677_cov_1.709343	422	502	8	50	80	0.6250000
NODE_18368_length_676_cov_66.473137	286	366	0	80	80	1.0000000
NODE_18368_length_676_cov_66.473137	339	419	0	43	80	0.5375000
NODE_18368_length_676_cov_66.473137	339	419	2	1	80	0.0125000
NODE_18368_length_676_cov_66.473137	339	419	16	1	80	0.0125000
NODE_18368_length_676_cov_66.473137	339	419	17	1	80	0.0125000
NODE_18368_length_676_cov_66.473137	339	419	18	1	80	0.0125000
NODE_18368_length_676_cov_66.473137	339	419	23	2	80	0.0250000
NODE_18368_length_676_cov_66.473137	339	419	26	1	80	0.0125000
NODE_18368_length_676_cov_66.473137	339	419	32	2	80	0.0250000
NODE_18368_length_676_cov_66.473137	339	419	34	1	80	0.0125000
NODE_18368_length_676_cov_66.473137	339	419	35	1	80	0.0125000
NODE_18368_length_676_cov_66.473137	339	419	36	1	80	0.0125000
NODE_18368_length_676_cov_66.473137	339	419	37	1	80	0.0125000
NODE_18368_length_676_cov_66.473137	339	419	38	1	80	0.0125000
NODE_18368_length_676_cov_66.473137	339	419	39	2	80	0.0250000
NODE_18368_length_676_cov_66.473137	339	419	40	21	80	0.2625000
NODE_18368_length_676_cov_66.473137	383	419	16	1	36	0.0277778
NODE_18368_length_676_cov_66.473137	383	419	17	1	36	0.0277778
NODE_18368_length_676_cov_66.473137	383	419	18	1	36	0.0277778
NODE_18368_length_676_cov_66.473137	383	419	23	2	36	0.0555556
NODE_18368_length_676_cov_66.473137	383	419	26	1	36	0.0277778
NODE_18368_length_676_cov_66.473137	383	419	32	2	36	0.0555556
NODE_18368_length_676_cov_66.473137	383	419	34	1	36	0.0277778
NODE_18368_length_676_cov_66.473137	383	419	35	1	36	0.0277778
NODE_18368_length_676_cov_66.473137	383	419	36	1	36	0.0277778
NODE_18368_length_676_cov_66.473137	383	419	37	1	36	0.0277778
NODE_18368_length_676_cov_66.473137	383	419	38	1	36	0.0277778
NODE_18368_length_676_cov_66.473137	383	419	39	2	36	0.0555556
NODE_18368_length_676_cov_66.473137	383	419	40	21	36	0.5833333
NODE_18368_length_676_cov_66.473137	383	419	16	1	36	0.0277778
NODE_18368_length_676_cov_66.473137	383	419	17	1	36	0.0277778
NODE_18368_length_676_cov_66.473137	383	419	18	1	36	0.0277778
NODE_18368_length_676_cov_66.473137	383	419	23	2	36	0.0555556
NODE_18368_length_676_cov_66.473137	383	419	26	1	36	0.0277778
NODE_18368_length_676_cov_66.473137	383	419	32	2	36	0.0555556
NODE_18368_length_676_cov_66.473137	383	419	34	1	36	0.0277778
NODE_18368_length_676_cov_66.473137	383	419	35	1	36	0.0277778
NODE_18368_length_676_cov_66.473137	383	419	36	1	36	0.0277778
NODE_18368_length_676_cov_66.473137	383	419	37	1	36	0.0277778
NODE_18368_length_676_cov_66.473137	383	419	38	1	36	0.0277778
NODE_18368_length_676_cov_66.473137	383	419	39	2	36	0.0555556
NODE_18368_length_676_cov_66.473137	383	419	40	21	36	0.5833333
NODE_18368_length_676_cov_66.473137	398	419	40	21	21	1.0000000
NODE_18369_length_676_cov_14.429809	259	330	0	71	71	1.0000000
NODE_18370_length_676_cov_13.882149	292	372	0	80	80	1.0000000
NODE_18370_length_676_cov_13.882149	345	425	0	80	80	1.0000000
NODE_18374_length_676_cov_7.225303	363	443	0	80	80	1.0000000
NODE_18374_length_676_cov_7.225303	416	496	0	80	80	1.0000000
NODE_18375_length_676_cov_6.740035	373	433	0	60	60	1.0000000
NODE_18375_length_676_cov_6.740035	406	486	0	80	80	1.0000000
NODE_18378_length_676_cov_4.658579	167	240	0	73	73	1.0000000
NODE_18397_length_676_cov_2.292894	146	226	0	80	80	1.0000000
NODE_18401_length_676_cov_2.157712	175	226	2	9	51	0.1764706
NODE_18401_length_676_cov_2.157712	175	226	4	42	51	0.8235294
NODE_18417_length_676_cov_1.547660	133	164	2	31	31	1.0000000
NODE_18447_length_675_cov_27.574653	190	270	0	57	80	0.7125000
NODE_18447_length_675_cov_27.574653	190	270	8	23	80	0.2875000
NODE_18447_length_675_cov_27.574653	243	323	0	4	80	0.0500000
NODE_18447_length_675_cov_27.574653	243	323	8	23	80	0.2875000
NODE_18447_length_675_cov_27.574653	243	323	10	53	80	0.6625000
NODE_18448_length_675_cov_11.895833	336	416	0	80	80	1.0000000
NODE_18448_length_675_cov_11.895833	389	469	0	80	80	1.0000000
NODE_18449_length_675_cov_8.157986	414	494	0	80	80	1.0000000
NODE_18449_length_675_cov_8.157986	467	547	0	80	80	1.0000000
NODE_18450_length_675_cov_8.026042	320	400	0	80	80	1.0000000
NODE_18450_length_675_cov_8.026042	373	453	0	80	80	1.0000000
NODE_18451_length_675_cov_7.277778	317	397	0	80	80	1.0000000
NODE_18455_length_675_cov_5.666667	142	222	0	80	80	1.0000000
NODE_18455_length_675_cov_5.666667	195	275	0	80	80	1.0000000
NODE_18464_length_675_cov_2.751736	67	122	0	55	55	1.0000000
NODE_18467_length_675_cov_2.623264	251	289	0	38	38	1.0000000
NODE_18467_length_675_cov_2.623264	279	343	0	64	64	1.0000000
NODE_18467_length_675_cov_2.623264	432	494	0	62	62	1.0000000
NODE_18515_length_674_cov_38.401739	225	305	0	80	80	1.0000000
NODE_18515_length_674_cov_38.401739	278	358	0	80	80	1.0000000
NODE_18516_length_674_cov_30.215652	519	599	6	6	80	0.0750000
NODE_18516_length_674_cov_30.215652	519	599	10	3	80	0.0375000
NODE_18516_length_674_cov_30.215652	519	599	12	6	80	0.0750000
NODE_18516_length_674_cov_30.215652	519	599	16	65	80	0.8125000
NODE_18516_length_674_cov_30.215652	572	602	10	6	30	0.2000000
NODE_18516_length_674_cov_30.215652	572	602	12	6	30	0.2000000
NODE_18516_length_674_cov_30.215652	572	602	16	18	30	0.6000000
NODE_18517_length_674_cov_19.636522	283	363	0	80	80	1.0000000
NODE_18517_length_674_cov_19.636522	336	416	0	80	80	1.0000000
NODE_18518_length_674_cov_19.436522	81	161	0	80	80	1.0000000
NODE_18518_length_674_cov_19.436522	134	214	0	80	80	1.0000000
NODE_18519_length_674_cov_16.819130	185	265	0	80	80	1.0000000
NODE_18519_length_674_cov_16.819130	238	318	0	80	80	1.0000000
NODE_18520_length_674_cov_14.733913	169	249	0	80	80	1.0000000
NODE_18520_length_674_cov_14.733913	222	302	0	80	80	1.0000000
NODE_18524_length_674_cov_7.086957	357	437	0	80	80	1.0000000
NODE_18524_length_674_cov_7.086957	410	490	0	80	80	1.0000000
NODE_18528_length_674_cov_4.808696	262	342	0	80	80	1.0000000
NODE_18528_length_674_cov_4.808696	315	395	0	80	80	1.0000000
NODE_18592_length_673_cov_47.109756	405	485	0	80	80	1.0000000
NODE_18592_length_673_cov_47.109756	458	538	0	80	80	1.0000000
NODE_18593_length_673_cov_20.548780	214	294	0	46	80	0.5750000
NODE_18593_length_673_cov_20.548780	214	294	3	1	80	0.0125000
NODE_18593_length_673_cov_20.548780	214	294	4	33	80	0.4125000
NODE_18593_length_673_cov_20.548780	267	347	0	80	80	1.0000000
NODE_18596_length_673_cov_8.306620	337	426	0	56	89	0.6292135
NODE_18596_length_673_cov_8.306620	337	426	2	3	89	0.0337079
NODE_18596_length_673_cov_8.306620	337	426	4	30	89	0.3370787
NODE_18607_length_673_cov_3.041812	196	276	1	80	80	1.0000000
NODE_18607_length_673_cov_3.041812	249	329	0	33	80	0.4125000
NODE_18607_length_673_cov_3.041812	249	329	1	47	80	0.5875000
NODE_18660_length_672_cov_15.380454	282	362	0	80	80	1.0000000
NODE_18660_length_672_cov_15.380454	335	415	0	80	80	1.0000000
NODE_18661_length_672_cov_9.902269	328	408	0	80	80	1.0000000
NODE_18661_length_672_cov_9.902269	381	461	0	80	80	1.0000000
NODE_18662_length_672_cov_9.462478	309	389	0	80	80	1.0000000
NODE_18662_length_672_cov_9.462478	362	442	0	80	80	1.0000000
NODE_18666_length_672_cov_6.516579	354	434	0	80	80	1.0000000
NODE_18666_length_672_cov_6.516579	407	487	0	80	80	1.0000000
NODE_18668_length_672_cov_6.108202	135	215	0	80	80	1.0000000
NODE_18668_length_672_cov_6.108202	188	268	0	80	80	1.0000000
NODE_18670_length_672_cov_4.949389	115	152	0	37	37	1.0000000
NODE_18670_length_672_cov_4.949389	125	205	0	80	80	1.0000000
NODE_18670_length_672_cov_4.949389	278	326	0	48	48	1.0000000
NODE_18672_length_672_cov_4.753927	378	450	0	72	72	1.0000000
NODE_18704_length_672_cov_1.713787	340	401	2	61	61	1.0000000
NODE_18742_length_671_cov_28.874126	306	387	2	81	81	1.0000000
NODE_18742_length_671_cov_28.874126	360	440	0	5	80	0.0625000
NODE_18742_length_671_cov_28.874126	360	440	2	75	80	0.9375000
NODE_18744_length_671_cov_18.526224	294	333	0	39	39	1.0000000
NODE_18744_length_671_cov_18.526224	331	404	0	73	73	1.0000000
NODE_18744_length_671_cov_18.526224	331	351	0	20	20	1.0000000
NODE_18745_length_671_cov_16.094406	417	497	0	80	80	1.0000000
NODE_18745_length_671_cov_16.094406	470	550	0	80	80	1.0000000
NODE_18746_length_671_cov_11.756993	337	417	0	80	80	1.0000000
NODE_18746_length_671_cov_11.756993	390	470	0	80	80	1.0000000
NODE_18747_length_671_cov_9.237762	305	382	0	77	77	1.0000000
NODE_18748_length_671_cov_8.491259	298	379	0	81	81	1.0000000
NODE_18748_length_671_cov_8.491259	352	430	0	78	78	1.0000000
NODE_18749_length_671_cov_8.241259	97	128	2	31	31	1.0000000
NODE_18752_length_671_cov_7.201049	368	448	0	80	80	1.0000000
NODE_18752_length_671_cov_7.201049	421	501	0	80	80	1.0000000
NODE_18753_length_671_cov_5.680070	370	450	0	80	80	1.0000000
NODE_18753_length_671_cov_5.680070	423	503	0	80	80	1.0000000
NODE_18754_length_671_cov_4.769231	362	414	2	52	52	1.0000000
NODE_18760_length_671_cov_3.804196	360	440	0	80	80	1.0000000
NODE_18812_length_670_cov_21.017513	443	523	0	80	80	1.0000000
NODE_18812_length_670_cov_21.017513	496	576	0	80	80	1.0000000
NODE_18813_length_670_cov_20.346760	372	452	0	80	80	1.0000000
NODE_18813_length_670_cov_20.346760	425	505	0	80	80	1.0000000
NODE_18814_length_670_cov_15.728546	157	237	0	80	80	1.0000000
NODE_18814_length_670_cov_15.728546	210	290	0	80	80	1.0000000
NODE_18814_length_670_cov_15.728546	286	366	0	80	80	1.0000000
NODE_18814_length_670_cov_15.728546	339	419	0	80	80	1.0000000
NODE_18818_length_670_cov_6.499124	390	470	0	17	80	0.2125000
NODE_18818_length_670_cov_6.499124	390	470	2	63	80	0.7875000
NODE_18834_length_670_cov_3.099825	159	217	2	58	58	1.0000000
NODE_18838_length_670_cov_2.700525	252	332	0	35	80	0.4375000
NODE_18838_length_670_cov_2.700525	252	332	2	45	80	0.5625000
NODE_18838_length_670_cov_2.700525	305	385	0	36	80	0.4500000
NODE_18838_length_670_cov_2.700525	305	385	2	44	80	0.5500000
NODE_18883_length_669_cov_13.307018	432	512	0	80	80	1.0000000
NODE_18883_length_669_cov_13.307018	485	565	0	80	80	1.0000000
NODE_18886_length_669_cov_6.921053	245	325	0	80	80	1.0000000
NODE_18886_length_669_cov_6.921053	298	370	0	72	72	1.0000000
NODE_18901_length_669_cov_3.633333	277	347	0	70	70	1.0000000
NODE_18909_length_669_cov_2.361404	434	490	0	56	56	1.0000000
NODE_18958_length_668_cov_23.131810	275	355	2	80	80	1.0000000
NODE_18958_length_668_cov_23.131810	328	408	0	50	80	0.6250000
NODE_18958_length_668_cov_23.131810	328	408	2	30	80	0.3750000
NODE_18959_length_668_cov_14.978910	324	404	0	80	80	1.0000000
NODE_18959_length_668_cov_14.978910	377	457	0	80	80	1.0000000
NODE_18962_length_668_cov_11.184534	187	267	1	34	80	0.4250000
NODE_18962_length_668_cov_11.184534	187	267	2	46	80	0.5750000
NODE_18962_length_668_cov_11.184534	240	320	1	8	80	0.1000000
NODE_18962_length_668_cov_11.184534	240	320	2	72	80	0.9000000
NODE_18963_length_668_cov_10.548330	211	291	0	80	80	1.0000000
NODE_18963_length_668_cov_10.548330	264	344	0	80	80	1.0000000
NODE_18964_length_668_cov_10.370826	226	308	0	82	82	1.0000000
NODE_18964_length_668_cov_10.370826	279	361	0	82	82	1.0000000
NODE_18965_length_668_cov_10.223199	238	318	0	80	80	1.0000000
NODE_18965_length_668_cov_10.223199	291	371	0	67	80	0.8375000
NODE_18965_length_668_cov_10.223199	291	371	4	13	80	0.1625000
NODE_18967_length_668_cov_9.340949	310	390	0	80	80	1.0000000
NODE_18967_length_668_cov_9.340949	363	443	0	80	80	1.0000000
NODE_18975_length_668_cov_4.077329	304	384	0	43	80	0.5375000
NODE_18975_length_668_cov_4.077329	304	384	2	37	80	0.4625000
NODE_18975_length_668_cov_4.077329	338	367	0	26	29	0.8965517
NODE_18975_length_668_cov_4.077329	338	367	2	3	29	0.1034483
NODE_18975_length_668_cov_4.077329	358	427	0	69	69	1.0000000
NODE_19032_length_667_cov_33.848592	168	248	0	80	80	1.0000000
NODE_19032_length_667_cov_33.848592	221	301	0	80	80	1.0000000
NODE_19033_length_667_cov_21.218310	270	350	0	80	80	1.0000000
NODE_19033_length_667_cov_21.218310	323	403	0	80	80	1.0000000
NODE_19034_length_667_cov_19.204225	258	338	0	80	80	1.0000000
NODE_19034_length_667_cov_19.204225	311	391	0	80	80	1.0000000
NODE_19036_length_667_cov_8.264085	299	379	0	80	80	1.0000000
NODE_19036_length_667_cov_8.264085	352	432	0	80	80	1.0000000
NODE_19037_length_667_cov_8.248239	76	156	0	32	80	0.4000000
NODE_19037_length_667_cov_8.248239	76	156	2	48	80	0.6000000
NODE_19037_length_667_cov_8.248239	129	209	0	40	80	0.5000000
NODE_19037_length_667_cov_8.248239	129	209	2	40	80	0.5000000
NODE_19038_length_667_cov_8.207746	257	323	0	66	66	1.0000000
NODE_19038_length_667_cov_8.207746	296	376	0	80	80	1.0000000
NODE_19039_length_667_cov_7.232394	357	437	0	80	80	1.0000000
NODE_19039_length_667_cov_7.232394	410	490	0	80	80	1.0000000
NODE_19042_length_667_cov_4.941901	199	279	0	80	80	1.0000000
NODE_19042_length_667_cov_4.941901	252	332	0	80	80	1.0000000
NODE_19053_length_667_cov_3.404930	501	536	0	12	35	0.3428572
NODE_19053_length_667_cov_3.404930	501	536	2	23	35	0.6571429
NODE_19053_length_667_cov_3.404930	503	533	0	10	30	0.3333333
NODE_19053_length_667_cov_3.404930	503	533	2	20	30	0.6666667
NODE_19100_length_666_cov_24.811287	179	254	2	7	75	0.0933333
NODE_19100_length_666_cov_24.811287	179	254	6	68	75	0.9066667
NODE_19100_length_666_cov_24.811287	182	254	2	7	72	0.0972222
NODE_19100_length_666_cov_24.811287	182	254	6	65	72	0.9027778
NODE_19100_length_666_cov_24.811287	227	307	0	3	80	0.0375000
NODE_19100_length_666_cov_24.811287	227	307	2	36	80	0.4500000
NODE_19100_length_666_cov_24.811287	227	307	6	20	80	0.2500000
NODE_19100_length_666_cov_24.811287	227	307	8	21	80	0.2625000
NODE_19100_length_666_cov_24.811287	227	307	0	3	80	0.0375000
NODE_19100_length_666_cov_24.811287	227	307	2	36	80	0.4500000
NODE_19100_length_666_cov_24.811287	227	307	6	20	80	0.2500000
NODE_19100_length_666_cov_24.811287	227	307	8	21	80	0.2625000
NODE_19100_length_666_cov_24.811287	303	383	8	33	80	0.4125000
NODE_19100_length_666_cov_24.811287	303	383	10	9	80	0.1125000
NODE_19100_length_666_cov_24.811287	303	383	12	10	80	0.1250000
NODE_19100_length_666_cov_24.811287	303	383	14	28	80	0.3500000
NODE_19100_length_666_cov_24.811287	356	436	6	43	80	0.5375000
NODE_19100_length_666_cov_24.811287	356	436	14	37	80	0.4625000
NODE_19102_length_666_cov_20.114638	172	252	0	33	80	0.4125000
NODE_19102_length_666_cov_20.114638	172	252	2	47	80	0.5875000
NODE_19102_length_666_cov_20.114638	225	305	0	76	80	0.9500000
NODE_19102_length_666_cov_20.114638	225	305	2	4	80	0.0500000
NODE_19103_length_666_cov_16.813051	220	286	0	66	66	1.0000000
NODE_19103_length_666_cov_16.813051	259	344	0	85	85	1.0000000
NODE_19104_length_666_cov_15.384480	306	386	4	80	80	1.0000000
NODE_19104_length_666_cov_15.384480	359	439	0	41	80	0.5125000
NODE_19104_length_666_cov_15.384480	359	439	4	39	80	0.4875000
NODE_19105_length_666_cov_14.195767	485	565	0	80	80	1.0000000
NODE_19105_length_666_cov_14.195767	538	618	0	80	80	1.0000000
NODE_19108_length_666_cov_7.770723	226	306	0	80	80	1.0000000
NODE_19108_length_666_cov_7.770723	279	359	0	80	80	1.0000000
NODE_19163_length_665_cov_28.786219	391	471	0	80	80	1.0000000
NODE_19163_length_665_cov_28.786219	444	524	0	80	80	1.0000000
NODE_19164_length_665_cov_21.740283	311	391	0	80	80	1.0000000
NODE_19164_length_665_cov_21.740283	364	444	0	80	80	1.0000000
NODE_19165_length_665_cov_15.904594	390	470	0	80	80	1.0000000
NODE_19165_length_665_cov_15.904594	443	523	0	80	80	1.0000000
NODE_19224_length_664_cov_27.208850	259	339	0	79	80	0.9875000
NODE_19224_length_664_cov_27.208850	259	339	2	1	80	0.0125000
NODE_19224_length_664_cov_27.208850	345	404	2	59	59	1.0000000
NODE_19225_length_664_cov_16.116814	241	321	0	34	80	0.4250000
NODE_19225_length_664_cov_16.116814	241	321	4	46	80	0.5750000
NODE_19225_length_664_cov_16.116814	294	374	0	6	80	0.0750000
NODE_19225_length_664_cov_16.116814	294	374	4	74	80	0.9250000
NODE_19227_length_664_cov_14.185841	332	412	0	6	80	0.0750000
NODE_19227_length_664_cov_14.185841	332	412	4	74	80	0.9250000
NODE_19227_length_664_cov_14.185841	385	465	0	27	80	0.3375000
NODE_19227_length_664_cov_14.185841	385	465	4	53	80	0.6625000
NODE_19228_length_664_cov_12.256637	325	405	0	80	80	1.0000000
NODE_19228_length_664_cov_12.256637	378	454	0	76	76	1.0000000
NODE_19229_length_664_cov_8.378761	252	332	4	35	80	0.4375000
NODE_19229_length_664_cov_8.378761	252	332	7	1	80	0.0125000
NODE_19229_length_664_cov_8.378761	252	332	8	44	80	0.5500000
NODE_19229_length_664_cov_8.378761	305	385	0	26	80	0.3250000
NODE_19229_length_664_cov_8.378761	305	385	4	28	80	0.3500000
NODE_19229_length_664_cov_8.378761	305	385	8	26	80	0.3250000
NODE_19229_length_664_cov_8.378761	381	461	0	41	80	0.5125000
NODE_19229_length_664_cov_8.378761	381	461	2	37	80	0.4625000
NODE_19229_length_664_cov_8.378761	381	461	6	2	80	0.0250000
NODE_19229_length_664_cov_8.378761	434	514	2	25	80	0.3125000
NODE_19229_length_664_cov_8.378761	434	514	4	10	80	0.1250000
NODE_19229_length_664_cov_8.378761	434	514	6	45	80	0.5625000
NODE_19254_length_664_cov_1.922124	393	434	0	41	41	1.0000000
NODE_19298_length_663_cov_26.601064	398	478	0	80	80	1.0000000
NODE_19298_length_663_cov_26.601064	451	531	0	80	80	1.0000000
NODE_19299_length_663_cov_16.948582	368	448	6	80	80	1.0000000
NODE_19299_length_663_cov_16.948582	421	501	0	26	80	0.3250000
NODE_19299_length_663_cov_16.948582	421	501	5	1	80	0.0125000
NODE_19299_length_663_cov_16.948582	421	501	6	53	80	0.6625000
NODE_19300_length_663_cov_16.225177	118	198	0	80	80	1.0000000
NODE_19300_length_663_cov_16.225177	171	251	0	80	80	1.0000000
NODE_19302_length_663_cov_13.748227	277	357	0	80	80	1.0000000
NODE_19302_length_663_cov_13.748227	330	410	0	80	80	1.0000000
NODE_19303_length_663_cov_10.377660	300	380	0	4	80	0.0500000
NODE_19303_length_663_cov_10.377660	300	380	4	76	80	0.9500000
NODE_19304_length_663_cov_9.549645	199	279	0	80	80	1.0000000
NODE_19304_length_663_cov_9.549645	252	332	0	80	80	1.0000000
NODE_19305_length_663_cov_7.397163	151	231	0	80	80	1.0000000
NODE_19305_length_663_cov_7.397163	204	284	0	80	80	1.0000000
NODE_19307_length_663_cov_5.081560	317	397	0	80	80	1.0000000
NODE_19368_length_662_cov_29.218472	233	313	0	80	80	1.0000000
NODE_19368_length_662_cov_29.218472	286	366	0	80	80	1.0000000
NODE_19369_length_662_cov_18.717584	193	273	0	80	80	1.0000000
NODE_19369_length_662_cov_18.717584	246	326	0	80	80	1.0000000
NODE_19370_length_662_cov_16.358792	258	338	0	80	80	1.0000000
NODE_19370_length_662_cov_16.358792	311	391	0	80	80	1.0000000
NODE_19371_length_662_cov_12.845471	259	339	0	80	80	1.0000000
NODE_19371_length_662_cov_12.845471	312	392	0	80	80	1.0000000
NODE_19372_length_662_cov_12.476021	299	379	0	80	80	1.0000000
NODE_19372_length_662_cov_12.476021	352	432	0	80	80	1.0000000
NODE_19373_length_662_cov_10.252220	239	319	0	8	80	0.1000000
NODE_19373_length_662_cov_10.252220	239	319	9	4	80	0.0500000
NODE_19373_length_662_cov_10.252220	239	319	10	68	80	0.8500000
NODE_19373_length_662_cov_10.252220	292	372	0	13	80	0.1625000
NODE_19373_length_662_cov_10.252220	292	372	9	44	80	0.5500000
NODE_19373_length_662_cov_10.252220	292	372	10	23	80	0.2875000
NODE_19376_length_662_cov_6.335702	267	347	0	80	80	1.0000000
NODE_19376_length_662_cov_6.335702	320	400	0	80	80	1.0000000
NODE_19378_length_662_cov_5.738899	295	331	0	36	36	1.0000000
NODE_19378_length_662_cov_5.738899	301	322	0	21	21	1.0000000
NODE_19402_length_662_cov_1.905861	150	230	0	80	80	1.0000000
NODE_19402_length_662_cov_1.905861	203	277	0	74	74	1.0000000
NODE_19441_length_661_cov_55.176157	236	316	0	80	80	1.0000000
NODE_19441_length_661_cov_55.176157	289	369	0	80	80	1.0000000
NODE_19442_length_661_cov_38.501779	231	311	0	80	80	1.0000000
NODE_19442_length_661_cov_38.501779	284	364	0	70	80	0.8750000
NODE_19442_length_661_cov_38.501779	284	364	2	10	80	0.1250000
NODE_19442_length_661_cov_38.501779	360	440	2	80	80	1.0000000
NODE_19442_length_661_cov_38.501779	413	493	0	43	80	0.5375000
NODE_19442_length_661_cov_38.501779	413	493	1	1	80	0.0125000
NODE_19442_length_661_cov_38.501779	413	493	2	36	80	0.4500000
NODE_19443_length_661_cov_31.460854	128	208	0	80	80	1.0000000
NODE_19443_length_661_cov_31.460854	181	261	0	80	80	1.0000000
NODE_19444_length_661_cov_18.960854	216	296	0	80	80	1.0000000
NODE_19444_length_661_cov_18.960854	269	349	0	80	80	1.0000000
NODE_19445_length_661_cov_16.035587	201	281	0	27	80	0.3375000
NODE_19445_length_661_cov_16.035587	201	281	16	53	80	0.6625000
NODE_19445_length_661_cov_16.035587	254	334	16	80	80	1.0000000
NODE_19447_length_661_cov_13.005338	281	343	0	62	62	1.0000000
NODE_19447_length_661_cov_13.005338	353	433	0	80	80	1.0000000
NODE_19447_length_661_cov_13.005338	406	486	0	80	80	1.0000000
NODE_19452_length_661_cov_5.670819	374	454	0	80	80	1.0000000
NODE_19452_length_661_cov_5.670819	427	507	0	80	80	1.0000000
NODE_19457_length_661_cov_4.601423	319	395	0	6	76	0.0789474
NODE_19457_length_661_cov_4.601423	319	395	4	70	76	0.9210526
NODE_19459_length_661_cov_3.532028	282	362	0	80	80	1.0000000
NODE_19459_length_661_cov_3.532028	335	415	0	80	80	1.0000000
NODE_19515_length_660_cov_20.741533	343	423	0	70	80	0.8750000
NODE_19515_length_660_cov_20.741533	343	423	2	10	80	0.1250000
NODE_19515_length_660_cov_20.741533	396	476	0	80	80	1.0000000
NODE_19516_length_660_cov_15.089127	148	228	0	80	80	1.0000000
NODE_19516_length_660_cov_15.089127	201	281	0	80	80	1.0000000
NODE_19518_length_660_cov_13.301248	276	356	0	40	80	0.5000000
NODE_19518_length_660_cov_13.301248	276	356	2	40	80	0.5000000
NODE_19518_length_660_cov_13.301248	329	409	0	80	80	1.0000000
NODE_19519_length_660_cov_12.393939	234	314	0	11	80	0.1375000
NODE_19519_length_660_cov_12.393939	234	314	2	69	80	0.8625000
NODE_19519_length_660_cov_12.393939	287	367	0	23	80	0.2875000
NODE_19519_length_660_cov_12.393939	287	367	2	57	80	0.7125000
NODE_19521_length_660_cov_11.495544	399	479	0	80	80	1.0000000
NODE_19521_length_660_cov_11.495544	452	532	0	80	80	1.0000000
NODE_19522_length_660_cov_10.522282	177	257	0	60	80	0.7500000
NODE_19522_length_660_cov_10.522282	177	257	1	20	80	0.2500000
NODE_19522_length_660_cov_10.522282	230	311	0	7	81	0.0864198
NODE_19522_length_660_cov_10.522282	230	311	1	35	81	0.4320988
NODE_19522_length_660_cov_10.522282	230	311	2	39	81	0.4814815
NODE_19524_length_660_cov_8.887701	254	325	2	71	71	1.0000000
NODE_19527_length_660_cov_7.278075	225	305	0	80	80	1.0000000
NODE_19527_length_660_cov_7.278075	278	358	0	80	80	1.0000000
NODE_19529_length_660_cov_6.577540	350	430	0	22	80	0.2750000
NODE_19529_length_660_cov_6.577540	350	430	2	58	80	0.7250000
NODE_19529_length_660_cov_6.577540	403	483	0	14	80	0.1750000
NODE_19529_length_660_cov_6.577540	403	483	2	66	80	0.8250000
NODE_19549_length_660_cov_2.354724	421	470	0	8	49	0.1632653
NODE_19549_length_660_cov_2.354724	421	470	2	35	49	0.7142857
NODE_19549_length_660_cov_2.354724	421	470	4	6	49	0.1224490
NODE_19594_length_659_cov_43.587500	2	82	0	80	80	1.0000000
NODE_19594_length_659_cov_43.587500	55	135	0	80	80	1.0000000
NODE_19594_length_659_cov_43.587500	131	211	0	20	80	0.2500000
NODE_19594_length_659_cov_43.587500	131	211	4	2	80	0.0250000
NODE_19594_length_659_cov_43.587500	131	211	8	53	80	0.6625000
NODE_19594_length_659_cov_43.587500	131	211	10	5	80	0.0625000
NODE_19594_length_659_cov_43.587500	184	264	8	22	80	0.2750000
NODE_19594_length_659_cov_43.587500	184	264	10	58	80	0.7250000
NODE_19595_length_659_cov_23.330357	236	316	0	80	80	1.0000000
NODE_19595_length_659_cov_23.330357	289	369	0	80	80	1.0000000
NODE_19596_length_659_cov_12.775000	255	335	0	80	80	1.0000000
NODE_19596_length_659_cov_12.775000	308	388	0	80	80	1.0000000
NODE_19598_length_659_cov_9.683929	220	298	0	78	78	1.0000000
NODE_19598_length_659_cov_9.683929	271	351	0	80	80	1.0000000
NODE_19613_length_659_cov_3.658929	305	385	0	5	80	0.0625000
NODE_19613_length_659_cov_3.658929	305	385	4	75	80	0.9375000
NODE_19613_length_659_cov_3.658929	358	438	0	28	80	0.3500000
NODE_19613_length_659_cov_3.658929	358	438	4	52	80	0.6500000
NODE_19678_length_658_cov_38.479428	289	369	0	80	80	1.0000000
NODE_19678_length_658_cov_38.479428	342	422	0	80	80	1.0000000
NODE_19679_length_658_cov_35.409660	242	322	0	80	80	1.0000000
NODE_19679_length_658_cov_35.409660	295	375	0	80	80	1.0000000
NODE_19680_length_658_cov_20.322004	191	271	0	80	80	1.0000000
NODE_19680_length_658_cov_20.322004	244	321	0	77	77	1.0000000
NODE_19680_length_658_cov_20.322004	317	397	0	80	80	1.0000000
NODE_19680_length_658_cov_20.322004	370	449	0	79	79	1.0000000
NODE_19681_length_658_cov_11.352415	324	404	0	80	80	1.0000000
NODE_19681_length_658_cov_11.352415	377	457	0	80	80	1.0000000
NODE_19685_length_658_cov_8.241503	227	307	0	80	80	1.0000000
NODE_19685_length_658_cov_8.241503	280	360	0	80	80	1.0000000
NODE_19689_length_658_cov_5.477639	450	530	0	80	80	1.0000000
NODE_19705_length_658_cov_2.277281	286	366	0	44	80	0.5500000
NODE_19705_length_658_cov_2.277281	286	366	3	36	80	0.4500000
NODE_19705_length_658_cov_2.277281	339	419	3	39	80	0.4875000
NODE_19705_length_658_cov_2.277281	339	419	5	11	80	0.1375000
NODE_19705_length_658_cov_2.277281	339	419	6	4	80	0.0500000
NODE_19705_length_658_cov_2.277281	339	419	7	1	80	0.0125000
NODE_19705_length_658_cov_2.277281	339	419	8	7	80	0.0875000
NODE_19705_length_658_cov_2.277281	339	419	9	6	80	0.0750000
NODE_19705_length_658_cov_2.277281	339	419	10	10	80	0.1250000
NODE_19705_length_658_cov_2.277281	339	419	11	2	80	0.0250000
NODE_19750_length_657_cov_71.087814	306	372	0	5	66	0.0757576
NODE_19750_length_657_cov_71.087814	306	372	4	61	66	0.9242424
NODE_19750_length_657_cov_71.087814	382	462	4	9	80	0.1125000
NODE_19750_length_657_cov_71.087814	382	462	6	1	80	0.0125000
NODE_19750_length_657_cov_71.087814	382	462	8	5	80	0.0625000
NODE_19750_length_657_cov_71.087814	382	462	26	14	80	0.1750000
NODE_19750_length_657_cov_71.087814	382	462	27	4	80	0.0500000
NODE_19750_length_657_cov_71.087814	382	462	28	2	80	0.0250000
NODE_19750_length_657_cov_71.087814	382	462	29	1	80	0.0125000
NODE_19750_length_657_cov_71.087814	382	462	31	2	80	0.0250000
NODE_19750_length_657_cov_71.087814	382	462	32	42	80	0.5250000
NODE_19750_length_657_cov_71.087814	382	462	4	9	80	0.1125000
NODE_19750_length_657_cov_71.087814	382	462	6	1	80	0.0125000
NODE_19750_length_657_cov_71.087814	382	462	8	5	80	0.0625000
NODE_19750_length_657_cov_71.087814	382	462	26	14	80	0.1750000
NODE_19750_length_657_cov_71.087814	382	462	27	4	80	0.0500000
NODE_19750_length_657_cov_71.087814	382	462	28	2	80	0.0250000
NODE_19750_length_657_cov_71.087814	382	462	29	1	80	0.0125000
NODE_19750_length_657_cov_71.087814	382	462	31	2	80	0.0250000
NODE_19750_length_657_cov_71.087814	382	462	32	42	80	0.5250000
NODE_19750_length_657_cov_71.087814	435	515	1	30	80	0.3750000
NODE_19750_length_657_cov_71.087814	435	515	19	1	80	0.0125000
NODE_19750_length_657_cov_71.087814	435	515	20	1	80	0.0125000
NODE_19750_length_657_cov_71.087814	435	515	22	3	80	0.0375000
NODE_19750_length_657_cov_71.087814	435	515	24	13	80	0.1625000
NODE_19750_length_657_cov_71.087814	435	515	26	19	80	0.2375000
NODE_19750_length_657_cov_71.087814	435	515	27	4	80	0.0500000
NODE_19750_length_657_cov_71.087814	435	515	28	2	80	0.0250000
NODE_19750_length_657_cov_71.087814	435	515	32	7	80	0.0875000
NODE_19750_length_657_cov_71.087814	440	515	1	30	75	0.4000000
NODE_19750_length_657_cov_71.087814	440	515	19	1	75	0.0133333
NODE_19750_length_657_cov_71.087814	440	515	20	1	75	0.0133333
NODE_19750_length_657_cov_71.087814	440	515	22	3	75	0.0400000
NODE_19750_length_657_cov_71.087814	440	515	24	13	75	0.1733333
NODE_19750_length_657_cov_71.087814	440	515	26	19	75	0.2533333
NODE_19750_length_657_cov_71.087814	440	515	27	4	75	0.0533333
NODE_19750_length_657_cov_71.087814	440	515	28	2	75	0.0266667
NODE_19750_length_657_cov_71.087814	440	515	32	2	75	0.0266667
NODE_19751_length_657_cov_67.408602	98	178	0	80	80	1.0000000
NODE_19751_length_657_cov_67.408602	151	231	0	80	80	1.0000000
NODE_19752_length_657_cov_15.568100	265	345	0	80	80	1.0000000
NODE_19752_length_657_cov_15.568100	341	421	0	80	80	1.0000000
NODE_19759_length_657_cov_5.161290	185	256	0	71	71	1.0000000
NODE_19759_length_657_cov_5.161290	229	309	0	80	80	1.0000000
NODE_19824_length_656_cov_37.023339	470	550	0	80	80	1.0000000
NODE_19824_length_656_cov_37.023339	523	603	0	80	80	1.0000000
NODE_19825_length_656_cov_22.804309	173	253	0	80	80	1.0000000
NODE_19825_length_656_cov_22.804309	226	306	0	80	80	1.0000000
NODE_19826_length_656_cov_19.280072	345	425	46	1	80	0.0125000
NODE_19826_length_656_cov_19.280072	345	425	47	4	80	0.0500000
NODE_19826_length_656_cov_19.280072	345	425	56	1	80	0.0125000
NODE_19826_length_656_cov_19.280072	345	425	57	6	80	0.0750000
NODE_19826_length_656_cov_19.280072	345	425	58	2	80	0.0250000
NODE_19826_length_656_cov_19.280072	345	425	59	5	80	0.0625000
NODE_19826_length_656_cov_19.280072	345	425	61	13	80	0.1625000
NODE_19826_length_656_cov_19.280072	345	425	64	9	80	0.1125000
NODE_19826_length_656_cov_19.280072	345	425	65	33	80	0.4125000
NODE_19826_length_656_cov_19.280072	345	425	66	6	80	0.0750000
NODE_19826_length_656_cov_19.280072	398	478	0	27	80	0.3375000
NODE_19826_length_656_cov_19.280072	398	478	9	1	80	0.0125000
NODE_19826_length_656_cov_19.280072	398	478	10	1	80	0.0125000
NODE_19826_length_656_cov_19.280072	398	478	63	2	80	0.0250000
NODE_19826_length_656_cov_19.280072	398	478	64	31	80	0.3875000
NODE_19826_length_656_cov_19.280072	398	478	65	18	80	0.2250000
NODE_19827_length_656_cov_18.267504	272	352	0	67	80	0.8375000
NODE_19827_length_656_cov_18.267504	272	352	2	13	80	0.1625000
NODE_19827_length_656_cov_18.267504	325	405	0	80	80	1.0000000
NODE_19828_length_656_cov_15.928187	223	303	0	80	80	1.0000000
NODE_19829_length_656_cov_15.091562	297	377	0	80	80	1.0000000
NODE_19829_length_656_cov_15.091562	350	430	0	80	80	1.0000000
NODE_19830_length_656_cov_12.773788	269	349	0	80	80	1.0000000
NODE_19830_length_656_cov_12.773788	322	399	0	77	77	1.0000000
NODE_19831_length_656_cov_12.493716	212	292	0	80	80	1.0000000
NODE_19831_length_656_cov_12.493716	265	345	0	80	80	1.0000000
NODE_19832_length_656_cov_10.946140	197	277	0	80	80	1.0000000
NODE_19832_length_656_cov_10.946140	250	330	0	80	80	1.0000000
NODE_19833_length_656_cov_9.412926	295	375	0	80	80	1.0000000
NODE_19833_length_656_cov_9.412926	348	428	0	80	80	1.0000000
NODE_19904_length_655_cov_31.019784	212	292	0	80	80	1.0000000
NODE_19904_length_655_cov_31.019784	265	345	0	80	80	1.0000000
NODE_19907_length_655_cov_8.672662	216	296	0	80	80	1.0000000
NODE_19907_length_655_cov_8.672662	269	349	0	80	80	1.0000000
NODE_19908_length_655_cov_8.250000	204	234	0	30	30	1.0000000
NODE_19909_length_655_cov_7.910072	366	446	0	80	80	1.0000000
NODE_19909_length_655_cov_7.910072	419	499	0	80	80	1.0000000
NODE_19916_length_655_cov_5.478417	178	255	0	77	77	1.0000000
NODE_19916_length_655_cov_5.478417	178	221	0	43	43	1.0000000
NODE_19919_length_655_cov_5.174460	347	428	0	4	81	0.0493827
NODE_19919_length_655_cov_5.174460	347	428	2	29	81	0.3580247
NODE_19919_length_655_cov_5.174460	347	428	4	27	81	0.3333333
NODE_19919_length_655_cov_5.174460	347	428	6	21	81	0.2592593
NODE_19919_length_655_cov_5.174460	401	481	0	11	80	0.1375000
NODE_19919_length_655_cov_5.174460	401	481	2	69	80	0.8625000
NODE_19979_length_654_cov_17.086486	323	403	0	80	80	1.0000000
NODE_19979_length_654_cov_17.086486	376	456	0	80	80	1.0000000
NODE_19980_length_654_cov_16.194595	318	398	0	80	80	1.0000000
NODE_19980_length_654_cov_16.194595	371	451	0	80	80	1.0000000
NODE_19983_length_654_cov_5.556757	341	412	0	71	71	1.0000000
NODE_19990_length_654_cov_3.236036	105	181	0	60	76	0.7894737
NODE_19990_length_654_cov_3.236036	105	181	2	16	76	0.2105263
NODE_19990_length_654_cov_3.236036	158	236	0	7	78	0.0897436
NODE_19990_length_654_cov_3.236036	158	236	2	71	78	0.9102564
NODE_19998_length_654_cov_2.549550	279	366	2	84	87	0.9655172
NODE_19998_length_654_cov_2.549550	279	366	4	3	87	0.0344828
NODE_20013_length_654_cov_1.790991	480	560	5	3	80	0.0375000
NODE_20013_length_654_cov_1.790991	480	560	6	77	80	0.9625000
NODE_20044_length_653_cov_70.296029	277	357	0	80	80	1.0000000
NODE_20044_length_653_cov_70.296029	330	410	0	80	80	1.0000000
NODE_20045_length_653_cov_28.072202	302	382	0	80	80	1.0000000
NODE_20045_length_653_cov_28.072202	355	435	0	80	80	1.0000000
NODE_20046_length_653_cov_18.382671	214	294	0	38	80	0.4750000
NODE_20046_length_653_cov_18.382671	214	294	5	1	80	0.0125000
NODE_20046_length_653_cov_18.382671	214	294	6	41	80	0.5125000
NODE_20046_length_653_cov_18.382671	267	347	6	80	80	1.0000000
NODE_20047_length_653_cov_8.821300	292	372	0	80	80	1.0000000
NODE_20047_length_653_cov_8.821300	345	425	0	80	80	1.0000000
NODE_20048_length_653_cov_8.660650	200	280	0	80	80	1.0000000
NODE_20048_length_653_cov_8.660650	253	333	0	80	80	1.0000000
NODE_20052_length_653_cov_5.777978	308	383	8	8	75	0.1066667
NODE_20052_length_653_cov_5.777978	308	383	10	49	75	0.6533333
NODE_20052_length_653_cov_5.777978	308	383	16	18	75	0.2400000
NODE_20052_length_653_cov_5.777978	361	435	6	45	74	0.6081081
NODE_20052_length_653_cov_5.777978	361	435	8	4	74	0.0540541
NODE_20052_length_653_cov_5.777978	361	435	10	4	74	0.0540541
NODE_20052_length_653_cov_5.777978	361	435	15	2	74	0.0270270
NODE_20052_length_653_cov_5.777978	361	435	16	19	74	0.2567568
NODE_20054_length_653_cov_5.193141	304	356	4	52	52	1.0000000
NODE_20058_length_653_cov_4.823105	178	251	0	73	73	1.0000000
NODE_20058_length_653_cov_4.823105	178	256	0	78	78	1.0000000
NODE_20058_length_653_cov_4.823105	229	309	0	80	80	1.0000000
NODE_20058_length_653_cov_4.823105	229	309	0	80	80	1.0000000
NODE_20058_length_653_cov_4.823105	239	309	0	70	70	1.0000000
NODE_20127_length_652_cov_215.211573	185	248	2	59	63	0.9365079
NODE_20127_length_652_cov_215.211573	185	248	4	4	63	0.0634921
NODE_20127_length_652_cov_215.211573	221	301	2	23	80	0.2875000
NODE_20127_length_652_cov_215.211573	221	301	4	8	80	0.1000000
NODE_20127_length_652_cov_215.211573	221	301	8	35	80	0.4375000
NODE_20127_length_652_cov_215.211573	221	301	10	1	80	0.0125000
NODE_20127_length_652_cov_215.211573	221	301	16	6	80	0.0750000
NODE_20127_length_652_cov_215.211573	221	301	18	7	80	0.0875000
NODE_20128_length_652_cov_21.267631	299	379	0	80	80	1.0000000
NODE_20128_length_652_cov_21.267631	352	432	0	80	80	1.0000000
NODE_20138_length_652_cov_4.622061	266	315	4	49	49	1.0000000
NODE_20138_length_652_cov_4.622061	288	368	0	22	80	0.2750000
NODE_20138_length_652_cov_4.622061	288	368	2	22	80	0.2750000
NODE_20138_length_652_cov_4.622061	288	368	4	36	80	0.4500000
NODE_20210_length_651_cov_49.981884	425	505	0	21	80	0.2625000
NODE_20210_length_651_cov_49.981884	425	505	2	24	80	0.3000000
NODE_20210_length_651_cov_49.981884	425	505	4	35	80	0.4375000
NODE_20210_length_651_cov_49.981884	425	505	0	21	80	0.2625000
NODE_20210_length_651_cov_49.981884	425	505	2	24	80	0.3000000
NODE_20210_length_651_cov_49.981884	425	505	4	35	80	0.4375000
NODE_20210_length_651_cov_49.981884	425	505	0	21	80	0.2625000
NODE_20210_length_651_cov_49.981884	425	505	2	24	80	0.3000000
NODE_20210_length_651_cov_49.981884	425	505	4	35	80	0.4375000
NODE_20210_length_651_cov_49.981884	425	505	0	21	80	0.2625000
NODE_20210_length_651_cov_49.981884	425	505	2	24	80	0.3000000
NODE_20210_length_651_cov_49.981884	425	505	4	35	80	0.4375000
NODE_20210_length_651_cov_49.981884	478	540	0	56	62	0.9032258
NODE_20210_length_651_cov_49.981884	478	540	2	6	62	0.0967742
NODE_20210_length_651_cov_49.981884	478	540	0	56	62	0.9032258
NODE_20210_length_651_cov_49.981884	478	540	2	6	62	0.0967742
NODE_20210_length_651_cov_49.981884	478	540	0	56	62	0.9032258
NODE_20210_length_651_cov_49.981884	478	540	2	6	62	0.0967742
NODE_20210_length_651_cov_49.981884	478	542	0	58	64	0.9062500
NODE_20210_length_651_cov_49.981884	478	542	2	6	64	0.0937500
NODE_20211_length_651_cov_36.121377	422	502	0	17	80	0.2125000
NODE_20211_length_651_cov_36.121377	422	502	2	63	80	0.7875000
NODE_20211_length_651_cov_36.121377	475	555	0	70	80	0.8750000
NODE_20211_length_651_cov_36.121377	475	555	2	10	80	0.1250000
NODE_20212_length_651_cov_20.045290	252	332	0	80	80	1.0000000
NODE_20212_length_651_cov_20.045290	305	385	0	80	80	1.0000000
NODE_20213_length_651_cov_12.704710	264	344	0	80	80	1.0000000
NODE_20213_length_651_cov_12.704710	317	397	0	80	80	1.0000000
NODE_20214_length_651_cov_11.632246	205	285	0	80	80	1.0000000
NODE_20214_length_651_cov_11.632246	258	338	0	80	80	1.0000000
NODE_20215_length_651_cov_10.074275	369	449	0	68	80	0.8500000
NODE_20215_length_651_cov_10.074275	369	449	2	12	80	0.1500000
NODE_20215_length_651_cov_10.074275	422	502	0	26	80	0.3250000
NODE_20215_length_651_cov_10.074275	422	502	2	54	80	0.6750000
NODE_20216_length_651_cov_9.699275	199	279	0	80	80	1.0000000
NODE_20216_length_651_cov_9.699275	252	332	0	80	80	1.0000000
NODE_20219_length_651_cov_8.309783	217	296	0	79	79	1.0000000
NODE_20219_length_651_cov_8.309783	269	349	0	80	80	1.0000000
NODE_20220_length_651_cov_5.621377	148	228	0	80	80	1.0000000
NODE_20220_length_651_cov_5.621377	201	281	0	64	80	0.8000000
NODE_20220_length_651_cov_5.621377	201	281	1	16	80	0.2000000
NODE_20221_length_651_cov_5.610507	342	422	0	12	80	0.1500000
NODE_20221_length_651_cov_5.610507	342	422	2	50	80	0.6250000
NODE_20221_length_651_cov_5.610507	342	422	3	6	80	0.0750000
NODE_20221_length_651_cov_5.610507	342	422	4	12	80	0.1500000
NODE_20221_length_651_cov_5.610507	395	475	0	65	80	0.8125000
NODE_20221_length_651_cov_5.610507	395	475	2	15	80	0.1875000
NODE_20225_length_651_cov_4.246377	299	359	0	60	60	1.0000000
NODE_20238_length_651_cov_2.744565	340	421	0	81	81	1.0000000
NODE_20252_length_651_cov_2.016304	280	311	0	31	31	1.0000000
NODE_20292_length_650_cov_22.644283	233	313	0	80	80	1.0000000
NODE_20292_length_650_cov_22.644283	286	366	0	80	80	1.0000000
NODE_20293_length_650_cov_22.156080	269	349	0	80	80	1.0000000
NODE_20293_length_650_cov_22.156080	322	402	0	80	80	1.0000000
NODE_20294_length_650_cov_20.012704	186	266	0	80	80	1.0000000
NODE_20294_length_650_cov_20.012704	239	319	0	80	80	1.0000000
NODE_20295_length_650_cov_17.626134	52	132	0	44	80	0.5500000
NODE_20295_length_650_cov_17.626134	52	132	3	28	80	0.3500000
NODE_20295_length_650_cov_17.626134	52	132	6	8	80	0.1000000
NODE_20295_length_650_cov_17.626134	105	185	3	19	80	0.2375000
NODE_20295_length_650_cov_17.626134	105	185	6	61	80	0.7625000
NODE_20297_length_650_cov_10.687840	289	369	0	28	80	0.3500000
NODE_20297_length_650_cov_10.687840	289	369	4	52	80	0.6500000
NODE_20297_length_650_cov_10.687840	342	422	0	24	80	0.3000000
NODE_20297_length_650_cov_10.687840	342	422	4	56	80	0.7000000
NODE_20301_length_650_cov_6.519056	312	365	0	43	53	0.8113208
NODE_20301_length_650_cov_6.519056	312	365	2	10	53	0.1886792
NODE_20301_length_650_cov_6.519056	338	417	0	17	79	0.2151899
NODE_20301_length_650_cov_6.519056	338	417	2	62	79	0.7848101
NODE_20302_length_650_cov_6.159710	243	323	0	80	80	1.0000000
NODE_20302_length_650_cov_6.159710	296	376	0	80	80	1.0000000
NODE_20318_length_650_cov_2.488203	213	266	0	32	53	0.6037736
NODE_20318_length_650_cov_2.488203	213	266	2	21	53	0.3962264
NODE_20370_length_649_cov_20.780000	111	140	0	29	29	1.0000000
NODE_20370_length_649_cov_20.780000	111	191	0	80	80	1.0000000
NODE_20370_length_649_cov_20.780000	138	161	0	23	23	1.0000000
NODE_20370_length_649_cov_20.780000	138	214	0	76	76	1.0000000
NODE_20370_length_649_cov_20.780000	164	244	0	80	80	1.0000000
NODE_20371_length_649_cov_17.938182	162	242	0	80	80	1.0000000
NODE_20371_length_649_cov_17.938182	215	295	0	80	80	1.0000000
NODE_20372_length_649_cov_16.761818	395	475	0	37	80	0.4625000
NODE_20372_length_649_cov_16.761818	395	475	4	43	80	0.5375000
NODE_20372_length_649_cov_16.761818	448	528	0	80	80	1.0000000
NODE_20373_length_649_cov_15.632727	226	306	0	43	80	0.5375000
NODE_20373_length_649_cov_15.632727	226	306	2	37	80	0.4625000
NODE_20373_length_649_cov_15.632727	279	359	2	80	80	1.0000000
NODE_20374_length_649_cov_15.516364	329	409	0	32	80	0.4000000
NODE_20374_length_649_cov_15.516364	329	409	2	48	80	0.6000000
NODE_20374_length_649_cov_15.516364	382	462	0	80	80	1.0000000
NODE_20375_length_649_cov_10.374545	453	533	0	80	80	1.0000000
NODE_20375_length_649_cov_10.374545	506	586	0	80	80	1.0000000
NODE_20382_length_649_cov_4.403636	213	293	0	80	80	1.0000000
NODE_20382_length_649_cov_4.403636	266	346	0	80	80	1.0000000
NODE_20454_length_648_cov_34.287796	343	423	0	80	80	1.0000000
NODE_20454_length_648_cov_34.287796	396	476	0	80	80	1.0000000
NODE_20454_length_648_cov_34.287796	472	552	0	80	80	1.0000000
NODE_20454_length_648_cov_34.287796	525	605	0	80	80	1.0000000
NODE_20455_length_648_cov_19.433515	259	339	0	80	80	1.0000000
NODE_20455_length_648_cov_19.433515	312	392	0	80	80	1.0000000
NODE_20457_length_648_cov_8.391621	206	286	0	80	80	1.0000000
NODE_20457_length_648_cov_8.391621	259	339	0	80	80	1.0000000
NODE_20459_length_648_cov_6.573770	293	373	0	80	80	1.0000000
NODE_20459_length_648_cov_6.573770	346	426	0	80	80	1.0000000
NODE_20460_length_648_cov_6.431694	285	328	0	43	43	1.0000000
NODE_20463_length_648_cov_6.085610	257	337	0	80	80	1.0000000
NODE_20463_length_648_cov_6.085610	310	390	0	80	80	1.0000000
NODE_20483_length_648_cov_2.333333	19	86	0	67	67	1.0000000
NODE_20531_length_647_cov_18.489051	295	375	0	37	80	0.4625000
NODE_20531_length_647_cov_18.489051	295	375	2	43	80	0.5375000
NODE_20531_length_647_cov_18.489051	348	428	2	80	80	1.0000000
NODE_20532_length_647_cov_14.677007	286	366	0	32	80	0.4000000
NODE_20532_length_647_cov_14.677007	286	366	4	48	80	0.6000000
NODE_20532_length_647_cov_14.677007	339	419	0	19	80	0.2375000
NODE_20532_length_647_cov_14.677007	339	419	4	61	80	0.7625000
NODE_20533_length_647_cov_10.895985	231	311	0	80	80	1.0000000
NODE_20533_length_647_cov_10.895985	284	364	0	80	80	1.0000000
NODE_20534_length_647_cov_9.116788	372	452	0	80	80	1.0000000
NODE_20534_length_647_cov_9.116788	425	505	0	80	80	1.0000000
NODE_20536_length_647_cov_6.410584	150	221	0	71	71	1.0000000
NODE_20536_length_647_cov_6.410584	194	274	0	80	80	1.0000000
NODE_20539_length_647_cov_5.567518	239	319	0	23	80	0.2875000
NODE_20539_length_647_cov_5.567518	239	319	4	57	80	0.7125000
NODE_20539_length_647_cov_5.567518	292	355	0	26	63	0.4126984
NODE_20539_length_647_cov_5.567518	292	355	4	37	63	0.5873016
NODE_20539_length_647_cov_5.567518	348	416	0	68	68	1.0000000
NODE_20539_length_647_cov_5.567518	401	469	0	68	68	1.0000000
NODE_20544_length_647_cov_3.775547	356	399	0	43	43	1.0000000
NODE_20550_length_647_cov_2.678832	239	319	0	80	80	1.0000000
NODE_20550_length_647_cov_2.678832	292	372	0	80	80	1.0000000
NODE_20561_length_647_cov_1.937956	254	304	0	21	50	0.4200000
NODE_20561_length_647_cov_1.937956	254	304	2	29	50	0.5800000
NODE_20607_length_646_cov_56.226691	267	347	0	80	80	1.0000000
NODE_20607_length_646_cov_56.226691	320	400	0	80	80	1.0000000
NODE_20608_length_646_cov_23.747715	76	153	0	77	77	1.0000000
NODE_20608_length_646_cov_23.747715	129	209	0	80	80	1.0000000
NODE_20609_length_646_cov_22.740402	326	406	0	80	80	1.0000000
NODE_20609_length_646_cov_22.740402	379	459	0	80	80	1.0000000
NODE_20610_length_646_cov_15.160878	363	443	0	80	80	1.0000000
NODE_20610_length_646_cov_15.160878	416	496	0	80	80	1.0000000
NODE_20611_length_646_cov_9.429616	309	389	0	40	80	0.5000000
NODE_20611_length_646_cov_9.429616	309	389	2	40	80	0.5000000
NODE_20611_length_646_cov_9.429616	362	442	0	80	80	1.0000000
NODE_20612_length_646_cov_9.246801	149	221	0	72	72	1.0000000
NODE_20613_length_646_cov_7.539305	227	307	0	80	80	1.0000000
NODE_20613_length_646_cov_7.539305	280	360	0	80	80	1.0000000
NODE_20614_length_646_cov_6.756856	236	316	0	80	80	1.0000000
NODE_20614_length_646_cov_6.756856	289	369	0	80	80	1.0000000
NODE_20615_length_646_cov_6.480804	373	437	0	64	64	1.0000000
NODE_20615_length_646_cov_6.480804	410	490	0	80	80	1.0000000
NODE_20616_length_646_cov_6.396709	194	274	0	80	80	1.0000000
NODE_20616_length_646_cov_6.396709	254	327	0	73	73	1.0000000
NODE_20619_length_646_cov_4.652651	265	345	0	80	80	1.0000000
NODE_20623_length_646_cov_4.122486	401	452	0	51	51	1.0000000
NODE_20688_length_645_cov_95.882784	179	259	0	80	80	1.0000000
NODE_20688_length_645_cov_95.882784	232	312	0	80	80	1.0000000
NODE_20689_length_645_cov_12.985348	343	423	0	80	80	1.0000000
NODE_20689_length_645_cov_12.985348	396	476	0	80	80	1.0000000
NODE_20691_length_645_cov_9.228938	254	334	4	80	80	1.0000000
NODE_20691_length_645_cov_9.228938	307	387	4	80	80	1.0000000
NODE_20692_length_645_cov_9.172161	293	373	0	80	80	1.0000000
NODE_20692_length_645_cov_9.172161	346	426	0	80	80	1.0000000
NODE_20697_length_645_cov_5.609890	461	541	0	80	80	1.0000000
NODE_20697_length_645_cov_5.609890	514	594	0	27	80	0.3375000
NODE_20697_length_645_cov_5.609890	514	594	2	53	80	0.6625000
NODE_20698_length_645_cov_4.743590	237	317	0	80	80	1.0000000
NODE_20698_length_645_cov_4.743590	290	370	0	80	80	1.0000000
NODE_20716_length_645_cov_2.177656	373	416	0	43	43	1.0000000
NODE_20762_length_644_cov_59.286239	323	401	196	4	78	0.0512821
NODE_20762_length_644_cov_59.286239	323	401	203	1	78	0.0128205
NODE_20762_length_644_cov_59.286239	323	401	206	1	78	0.0128205
NODE_20762_length_644_cov_59.286239	323	401	216	1	78	0.0128205
NODE_20762_length_644_cov_59.286239	323	401	218	1	78	0.0128205
NODE_20762_length_644_cov_59.286239	323	401	223	1	78	0.0128205
NODE_20762_length_644_cov_59.286239	323	401	225	1	78	0.0128205
NODE_20762_length_644_cov_59.286239	323	401	231	1	78	0.0128205
NODE_20762_length_644_cov_59.286239	323	401	234	4	78	0.0512821
NODE_20762_length_644_cov_59.286239	323	401	237	1	78	0.0128205
NODE_20762_length_644_cov_59.286239	323	401	245	1	78	0.0128205
NODE_20762_length_644_cov_59.286239	323	401	251	1	78	0.0128205
NODE_20762_length_644_cov_59.286239	323	401	254	1	78	0.0128205
NODE_20762_length_644_cov_59.286239	323	401	257	1	78	0.0128205
NODE_20762_length_644_cov_59.286239	323	401	263	1	78	0.0128205
NODE_20762_length_644_cov_59.286239	323	401	264	1	78	0.0128205
NODE_20762_length_644_cov_59.286239	323	401	267	2	78	0.0256410
NODE_20762_length_644_cov_59.286239	323	401	268	1	78	0.0128205
NODE_20762_length_644_cov_59.286239	323	401	270	1	78	0.0128205
NODE_20762_length_644_cov_59.286239	323	401	274	1	78	0.0128205
NODE_20762_length_644_cov_59.286239	323	401	280	1	78	0.0128205
NODE_20762_length_644_cov_59.286239	323	401	282	1	78	0.0128205
NODE_20762_length_644_cov_59.286239	323	401	289	1	78	0.0128205
NODE_20762_length_644_cov_59.286239	323	401	295	1	78	0.0128205
NODE_20762_length_644_cov_59.286239	323	401	296	1	78	0.0128205
NODE_20762_length_644_cov_59.286239	323	401	307	1	78	0.0128205
NODE_20762_length_644_cov_59.286239	323	401	310	1	78	0.0128205
NODE_20762_length_644_cov_59.286239	323	401	314	1	78	0.0128205
NODE_20762_length_644_cov_59.286239	323	401	319	1	78	0.0128205
NODE_20762_length_644_cov_59.286239	323	401	324	1	78	0.0128205
NODE_20762_length_644_cov_59.286239	323	401	326	2	78	0.0256410
NODE_20762_length_644_cov_59.286239	323	401	328	1	78	0.0128205
NODE_20762_length_644_cov_59.286239	323	401	334	1	78	0.0128205
NODE_20762_length_644_cov_59.286239	323	401	336	1	78	0.0128205
NODE_20762_length_644_cov_59.286239	323	401	342	1	78	0.0128205
NODE_20762_length_644_cov_59.286239	323	401	348	1	78	0.0128205
NODE_20762_length_644_cov_59.286239	323	401	350	1	78	0.0128205
NODE_20762_length_644_cov_59.286239	323	401	360	1	78	0.0128205
NODE_20762_length_644_cov_59.286239	323	401	364	1	78	0.0128205
NODE_20762_length_644_cov_59.286239	323	401	367	1	78	0.0128205
NODE_20762_length_644_cov_59.286239	323	401	372	1	78	0.0128205
NODE_20762_length_644_cov_59.286239	323	401	378	1	78	0.0128205
NODE_20762_length_644_cov_59.286239	323	401	383	1	78	0.0128205
NODE_20762_length_644_cov_59.286239	323	401	388	1	78	0.0128205
NODE_20762_length_644_cov_59.286239	323	401	393	1	78	0.0128205
NODE_20762_length_644_cov_59.286239	323	401	396	1	78	0.0128205
NODE_20762_length_644_cov_59.286239	323	401	404	1	78	0.0128205
NODE_20762_length_644_cov_59.286239	323	401	413	1	78	0.0128205
NODE_20762_length_644_cov_59.286239	323	401	416	1	78	0.0128205
NODE_20762_length_644_cov_59.286239	323	401	420	1	78	0.0128205
NODE_20762_length_644_cov_59.286239	323	401	424	1	78	0.0128205
NODE_20762_length_644_cov_59.286239	323	401	432	1	78	0.0128205
NODE_20762_length_644_cov_59.286239	323	401	434	1	78	0.0128205
NODE_20762_length_644_cov_59.286239	323	401	436	1	78	0.0128205
NODE_20762_length_644_cov_59.286239	323	401	437	1	78	0.0128205
NODE_20762_length_644_cov_59.286239	323	401	438	1	78	0.0128205
NODE_20762_length_644_cov_59.286239	323	401	447	2	78	0.0256410
NODE_20762_length_644_cov_59.286239	323	401	451	3	78	0.0384615
NODE_20762_length_644_cov_59.286239	323	401	452	1	78	0.0128205
NODE_20762_length_644_cov_59.286239	323	401	453	3	78	0.0384615
NODE_20762_length_644_cov_59.286239	323	401	454	1	78	0.0128205
NODE_20762_length_644_cov_59.286239	323	401	455	1	78	0.0128205
NODE_20762_length_644_cov_59.286239	323	401	459	1	78	0.0128205
NODE_20762_length_644_cov_59.286239	323	401	461	1	78	0.0128205
NODE_20762_length_644_cov_59.286239	323	401	464	1	78	0.0128205
NODE_20763_length_644_cov_27.577982	63	143	0	79	80	0.9875000
NODE_20763_length_644_cov_27.577982	63	143	2	1	80	0.0125000
NODE_20763_length_644_cov_27.577982	116	196	0	80	80	1.0000000
NODE_20765_length_644_cov_10.073394	284	364	0	28	80	0.3500000
NODE_20765_length_644_cov_10.073394	284	364	2	52	80	0.6500000
NODE_20765_length_644_cov_10.073394	337	417	0	80	80	1.0000000
NODE_20845_length_643_cov_27.562500	201	281	0	80	80	1.0000000
NODE_20845_length_643_cov_27.562500	254	334	0	80	80	1.0000000
NODE_20845_length_643_cov_27.562500	330	410	0	80	80	1.0000000
NODE_20845_length_643_cov_27.562500	383	463	0	80	80	1.0000000
NODE_20846_length_643_cov_12.895221	203	283	0	80	80	1.0000000
NODE_20846_length_643_cov_12.895221	256	336	0	80	80	1.0000000
NODE_20847_length_643_cov_10.501838	280	360	0	80	80	1.0000000
NODE_20847_length_643_cov_10.501838	333	413	0	80	80	1.0000000
NODE_20848_length_643_cov_9.136029	307	385	0	69	78	0.8846154
NODE_20848_length_643_cov_9.136029	307	385	4	9	78	0.1153846
NODE_20848_length_643_cov_9.136029	358	438	0	80	80	1.0000000
NODE_20849_length_643_cov_8.264706	202	282	0	41	80	0.5125000
NODE_20849_length_643_cov_8.264706	202	282	2	39	80	0.4875000
NODE_20849_length_643_cov_8.264706	255	335	0	7	80	0.0875000
NODE_20849_length_643_cov_8.264706	255	335	2	73	80	0.9125000
NODE_20851_length_643_cov_7.137868	173	253	0	80	80	1.0000000
NODE_20851_length_643_cov_7.137868	226	306	0	80	80	1.0000000
NODE_20855_length_643_cov_5.851103	255	335	8	16	80	0.2000000
NODE_20855_length_643_cov_5.851103	255	335	10	2	80	0.0250000
NODE_20855_length_643_cov_5.851103	255	335	12	21	80	0.2625000
NODE_20855_length_643_cov_5.851103	255	335	14	6	80	0.0750000
NODE_20855_length_643_cov_5.851103	255	335	16	9	80	0.1125000
NODE_20855_length_643_cov_5.851103	255	335	18	26	80	0.3250000
NODE_20855_length_643_cov_5.851103	308	388	0	2	80	0.0250000
NODE_20855_length_643_cov_5.851103	308	388	2	32	80	0.4000000
NODE_20855_length_643_cov_5.851103	308	388	4	15	80	0.1875000
NODE_20855_length_643_cov_5.851103	308	388	6	4	80	0.0500000
NODE_20855_length_643_cov_5.851103	308	388	8	16	80	0.2000000
NODE_20855_length_643_cov_5.851103	308	388	10	2	80	0.0250000
NODE_20855_length_643_cov_5.851103	308	388	12	9	80	0.1125000
NODE_20869_length_643_cov_3.121324	283	348	0	65	65	1.0000000
NODE_20872_length_643_cov_2.806985	387	451	0	64	64	1.0000000
NODE_20942_length_642_cov_36.309392	156	236	0	80	80	1.0000000
NODE_20942_length_642_cov_36.309392	209	289	0	80	80	1.0000000
NODE_20943_length_642_cov_27.046041	154	234	0	80	80	1.0000000
NODE_20943_length_642_cov_27.046041	207	287	0	80	80	1.0000000
NODE_20944_length_642_cov_26.290976	209	289	0	80	80	1.0000000
NODE_20944_length_642_cov_26.290976	262	342	0	80	80	1.0000000
NODE_20945_length_642_cov_11.651934	309	389	0	80	80	1.0000000
NODE_20945_length_642_cov_11.651934	362	442	0	80	80	1.0000000
NODE_20947_length_642_cov_6.692449	453	533	0	80	80	1.0000000
NODE_20947_length_642_cov_6.692449	506	586	0	80	80	1.0000000
NODE_20951_length_642_cov_5.933702	260	340	0	80	80	1.0000000
NODE_20951_length_642_cov_5.933702	313	391	0	78	78	1.0000000
NODE_20967_length_642_cov_2.823204	115	158	8	14	43	0.3255814
NODE_20967_length_642_cov_2.823204	115	158	9	1	43	0.0232558
NODE_20967_length_642_cov_2.823204	115	158	10	10	43	0.2325581
NODE_20967_length_642_cov_2.823204	115	158	16	2	43	0.0465116
NODE_20967_length_642_cov_2.823204	115	158	22	2	43	0.0465116
NODE_20967_length_642_cov_2.823204	115	158	23	10	43	0.2325581
NODE_20967_length_642_cov_2.823204	115	158	25	2	43	0.0465116
NODE_20967_length_642_cov_2.823204	115	158	27	2	43	0.0465116
NODE_20967_length_642_cov_2.823204	245	300	12	5	55	0.0909091
NODE_20967_length_642_cov_2.823204	245	300	14	2	55	0.0363636
NODE_20967_length_642_cov_2.823204	245	300	15	2	55	0.0363636
NODE_20967_length_642_cov_2.823204	245	300	19	8	55	0.1454545
NODE_20967_length_642_cov_2.823204	245	300	21	5	55	0.0909091
NODE_20967_length_642_cov_2.823204	245	300	23	2	55	0.0363636
NODE_20967_length_642_cov_2.823204	245	300	25	4	55	0.0727273
NODE_20967_length_642_cov_2.823204	245	300	31	2	55	0.0363636
NODE_20967_length_642_cov_2.823204	245	300	33	7	55	0.1272727
NODE_20967_length_642_cov_2.823204	245	300	35	1	55	0.0181818
NODE_20967_length_642_cov_2.823204	245	300	39	4	55	0.0727273
NODE_20967_length_642_cov_2.823204	245	300	45	4	55	0.0727273
NODE_20967_length_642_cov_2.823204	245	300	47	9	55	0.1636364
NODE_20967_length_642_cov_2.823204	329	410	4	13	81	0.1604938
NODE_20967_length_642_cov_2.823204	329	410	6	67	81	0.8271605
NODE_20967_length_642_cov_2.823204	329	410	8	1	81	0.0123457
NODE_20991_length_642_cov_1.357274	0	75	0	75	75	1.0000000
NODE_21018_length_641_cov_38.675277	284	345	2	3	61	0.0491803
NODE_21018_length_641_cov_38.675277	284	345	8	5	61	0.0819672
NODE_21018_length_641_cov_38.675277	284	345	9	12	61	0.1967213
NODE_21018_length_641_cov_38.675277	284	345	11	13	61	0.2131148
NODE_21018_length_641_cov_38.675277	284	345	13	5	61	0.0819672
NODE_21018_length_641_cov_38.675277	284	345	14	6	61	0.0983607
NODE_21018_length_641_cov_38.675277	284	345	16	2	61	0.0327869
NODE_21018_length_641_cov_38.675277	284	345	24	2	61	0.0327869
NODE_21018_length_641_cov_38.675277	284	345	30	5	61	0.0819672
NODE_21018_length_641_cov_38.675277	284	345	31	4	61	0.0655738
NODE_21018_length_641_cov_38.675277	284	345	33	4	61	0.0655738
NODE_21018_length_641_cov_38.675277	318	369	13	4	51	0.0784314
NODE_21018_length_641_cov_38.675277	318	369	14	6	51	0.1176471
NODE_21018_length_641_cov_38.675277	318	369	16	2	51	0.0392157
NODE_21018_length_641_cov_38.675277	318	369	24	2	51	0.0392157
NODE_21018_length_641_cov_38.675277	318	369	30	5	51	0.0980392
NODE_21018_length_641_cov_38.675277	318	369	31	9	51	0.1764706
NODE_21018_length_641_cov_38.675277	318	369	33	23	51	0.4509804
NODE_21019_length_641_cov_15.271218	260	340	0	80	80	1.0000000
NODE_21019_length_641_cov_15.271218	313	393	0	80	80	1.0000000
NODE_21021_length_641_cov_12.584871	363	443	0	80	80	1.0000000
NODE_21021_length_641_cov_12.584871	416	496	0	80	80	1.0000000
NODE_21022_length_641_cov_11.125461	38	118	0	80	80	1.0000000
NODE_21022_length_641_cov_11.125461	91	171	0	80	80	1.0000000
NODE_21025_length_641_cov_7.719557	84	138	0	54	54	1.0000000
NODE_21025_length_641_cov_7.719557	113	193	0	80	80	1.0000000
NODE_21026_length_641_cov_7.675277	232	312	0	80	80	1.0000000
NODE_21026_length_641_cov_7.675277	285	365	0	80	80	1.0000000
NODE_21027_length_641_cov_7.675277	255	335	2	80	80	1.0000000
NODE_21027_length_641_cov_7.675277	308	388	0	53	80	0.6625000
NODE_21027_length_641_cov_7.675277	308	388	2	27	80	0.3375000
NODE_21028_length_641_cov_7.627306	262	342	0	80	80	1.0000000
NODE_21028_length_641_cov_7.627306	315	395	0	80	80	1.0000000
NODE_21029_length_641_cov_7.282288	247	300	0	53	53	1.0000000
NODE_21031_length_641_cov_5.029520	138	218	0	80	80	1.0000000
NODE_21031_length_641_cov_5.029520	191	271	0	80	80	1.0000000
NODE_21034_length_641_cov_4.701107	238	282	0	44	44	1.0000000
NODE_21109_length_640_cov_39.676525	524	597	77	1	73	0.0136986
NODE_21109_length_640_cov_39.676525	524	597	79	1	73	0.0136986
NODE_21109_length_640_cov_39.676525	524	597	80	2	73	0.0273973
NODE_21109_length_640_cov_39.676525	524	597	84	1	73	0.0136986
NODE_21109_length_640_cov_39.676525	524	597	86	5	73	0.0684932
NODE_21109_length_640_cov_39.676525	524	597	88	2	73	0.0273973
NODE_21109_length_640_cov_39.676525	524	597	92	1	73	0.0136986
NODE_21109_length_640_cov_39.676525	524	597	94	1	73	0.0136986
NODE_21109_length_640_cov_39.676525	524	597	96	1	73	0.0136986
NODE_21109_length_640_cov_39.676525	524	597	98	5	73	0.0684932
NODE_21109_length_640_cov_39.676525	524	597	100	3	73	0.0410959
NODE_21109_length_640_cov_39.676525	524	597	108	3	73	0.0410959
NODE_21109_length_640_cov_39.676525	524	597	111	1	73	0.0136986
NODE_21109_length_640_cov_39.676525	524	597	113	5	73	0.0684932
NODE_21109_length_640_cov_39.676525	524	597	117	2	73	0.0273973
NODE_21109_length_640_cov_39.676525	524	597	119	1	73	0.0136986
NODE_21109_length_640_cov_39.676525	524	597	121	2	73	0.0273973
NODE_21109_length_640_cov_39.676525	524	597	122	2	73	0.0273973
NODE_21109_length_640_cov_39.676525	524	597	128	2	73	0.0273973
NODE_21109_length_640_cov_39.676525	524	597	131	2	73	0.0273973
NODE_21109_length_640_cov_39.676525	524	597	133	3	73	0.0410959
NODE_21109_length_640_cov_39.676525	524	597	141	2	73	0.0273973
NODE_21109_length_640_cov_39.676525	524	597	143	2	73	0.0273973
NODE_21109_length_640_cov_39.676525	524	597	145	1	73	0.0136986
NODE_21109_length_640_cov_39.676525	524	597	147	4	73	0.0547945
NODE_21109_length_640_cov_39.676525	524	597	149	7	73	0.0958904
NODE_21109_length_640_cov_39.676525	524	597	150	9	73	0.1232877
NODE_21109_length_640_cov_39.676525	524	597	152	2	73	0.0273973
NODE_21109_length_640_cov_39.676525	564	605	61	2	41	0.0487805
NODE_21109_length_640_cov_39.676525	564	605	63	2	41	0.0487805
NODE_21109_length_640_cov_39.676525	564	605	65	1	41	0.0243902
NODE_21109_length_640_cov_39.676525	564	605	67	1	41	0.0243902
NODE_21109_length_640_cov_39.676525	564	605	69	1	41	0.0243902
NODE_21109_length_640_cov_39.676525	564	605	73	1	41	0.0243902
NODE_21109_length_640_cov_39.676525	564	605	77	1	41	0.0243902
NODE_21109_length_640_cov_39.676525	564	605	79	1	41	0.0243902
NODE_21109_length_640_cov_39.676525	564	605	80	2	41	0.0487805
NODE_21109_length_640_cov_39.676525	564	605	84	1	41	0.0243902
NODE_21109_length_640_cov_39.676525	564	605	86	5	41	0.1219512
NODE_21109_length_640_cov_39.676525	564	605	88	2	41	0.0487805
NODE_21109_length_640_cov_39.676525	564	605	92	1	41	0.0243902
NODE_21109_length_640_cov_39.676525	564	605	94	1	41	0.0243902
NODE_21109_length_640_cov_39.676525	564	605	96	1	41	0.0243902
NODE_21109_length_640_cov_39.676525	564	605	98	5	41	0.1219512
NODE_21109_length_640_cov_39.676525	564	605	100	3	41	0.0731707
NODE_21109_length_640_cov_39.676525	564	605	108	3	41	0.0731707
NODE_21109_length_640_cov_39.676525	564	605	111	1	41	0.0243902
NODE_21109_length_640_cov_39.676525	564	605	113	5	41	0.1219512
NODE_21109_length_640_cov_39.676525	564	605	117	1	41	0.0243902
NODE_21110_length_640_cov_19.578558	273	353	0	41	80	0.5125000
NODE_21110_length_640_cov_19.578558	273	353	2	39	80	0.4875000
NODE_21110_length_640_cov_19.578558	326	406	2	80	80	1.0000000
NODE_21111_length_640_cov_15.717190	178	258	0	80	80	1.0000000
NODE_21111_length_640_cov_15.717190	231	311	0	80	80	1.0000000
NODE_21112_length_640_cov_15.338262	319	399	0	80	80	1.0000000
NODE_21112_length_640_cov_15.338262	372	452	0	80	80	1.0000000
NODE_21113_length_640_cov_9.523105	20	43	0	23	23	1.0000000
NODE_21118_length_640_cov_5.123845	272	335	0	63	63	1.0000000
NODE_21121_length_640_cov_4.410351	254	334	0	80	80	1.0000000
NODE_21121_length_640_cov_4.410351	307	387	0	80	80	1.0000000
NODE_21129_length_640_cov_3.406654	244	324	0	80	80	1.0000000
NODE_21140_length_640_cov_2.316081	21	57	0	36	36	1.0000000
NODE_21190_length_639_cov_58.092593	302	377	0	75	75	1.0000000
NODE_21190_length_639_cov_58.092593	350	430	0	80	80	1.0000000
NODE_21191_length_639_cov_32.951852	213	293	0	80	80	1.0000000
NODE_21191_length_639_cov_32.951852	266	346	0	80	80	1.0000000
NODE_21192_length_639_cov_24.564815	290	370	0	22	80	0.2750000
NODE_21192_length_639_cov_24.564815	290	370	2	58	80	0.7250000
NODE_21192_length_639_cov_24.564815	343	423	0	67	80	0.8375000
NODE_21192_length_639_cov_24.564815	343	423	2	13	80	0.1625000
NODE_21193_length_639_cov_14.448148	288	368	2	80	80	1.0000000
NODE_21193_length_639_cov_14.448148	341	421	0	41	80	0.5125000
NODE_21193_length_639_cov_14.448148	341	421	2	39	80	0.4875000
NODE_21195_length_639_cov_9.001852	265	345	0	80	80	1.0000000
NODE_21195_length_639_cov_9.001852	318	398	0	80	80	1.0000000
NODE_21197_length_639_cov_8.444444	161	241	0	80	80	1.0000000
NODE_21197_length_639_cov_8.444444	214	294	0	80	80	1.0000000
NODE_21202_length_639_cov_6.283333	157	176	0	19	19	1.0000000
NODE_21207_length_639_cov_4.188889	258	335	0	77	77	1.0000000
NODE_21207_length_639_cov_4.188889	308	354	0	46	46	1.0000000
NODE_21213_length_639_cov_3.448148	126	206	0	80	80	1.0000000
NODE_21213_length_639_cov_3.448148	179	259	0	80	80	1.0000000
NODE_21223_length_639_cov_2.683333	256	288	2	32	32	1.0000000
NODE_21224_length_639_cov_2.555556	189	240	2	51	51	1.0000000
NODE_21225_length_639_cov_2.477778	562	635	0	73	73	1.0000000
NODE_21265_length_639_cov_1.179630	542	564	2	22	22	1.0000000
NODE_21269_length_639_cov_1.051852	404	455	0	51	51	1.0000000
NODE_21278_length_638_cov_13.018553	273	353	0	80	80	1.0000000
NODE_21278_length_638_cov_13.018553	326	406	0	80	80	1.0000000
NODE_21279_length_638_cov_12.656772	343	423	0	80	80	1.0000000
NODE_21279_length_638_cov_12.656772	396	476	0	32	80	0.4000000
NODE_21279_length_638_cov_12.656772	396	476	2	48	80	0.6000000
NODE_21280_length_638_cov_11.877551	298	378	0	80	80	1.0000000
NODE_21280_length_638_cov_11.877551	351	431	0	80	80	1.0000000
NODE_21281_length_638_cov_8.779221	330	408	0	78	78	1.0000000
NODE_21281_length_638_cov_8.779221	383	461	0	78	78	1.0000000
NODE_21284_length_638_cov_5.543599	315	395	0	80	80	1.0000000
NODE_21290_length_638_cov_3.966605	307	387	0	80	80	1.0000000
NODE_21301_length_638_cov_2.786642	157	208	0	51	51	1.0000000
NODE_21301_length_638_cov_2.786642	181	261	0	80	80	1.0000000
NODE_21364_length_637_cov_67.157993	285	365	0	80	80	1.0000000
NODE_21364_length_637_cov_67.157993	338	418	0	80	80	1.0000000
NODE_21364_length_637_cov_67.157993	414	494	0	80	80	1.0000000
NODE_21364_length_637_cov_67.157993	467	547	0	80	80	1.0000000
NODE_21365_length_637_cov_63.029740	195	275	0	80	80	1.0000000
NODE_21365_length_637_cov_63.029740	248	328	0	80	80	1.0000000
NODE_21366_length_637_cov_44.923792	53	133	0	11	80	0.1375000
NODE_21366_length_637_cov_44.923792	53	133	2	69	80	0.8625000
NODE_21366_length_637_cov_44.923792	54	133	0	10	79	0.1265823
NODE_21366_length_637_cov_44.923792	54	133	2	69	79	0.8734177
NODE_21366_length_637_cov_44.923792	106	186	0	62	80	0.7750000
NODE_21366_length_637_cov_44.923792	106	186	2	18	80	0.2250000
NODE_21366_length_637_cov_44.923792	106	186	0	62	80	0.7750000
NODE_21366_length_637_cov_44.923792	106	186	2	18	80	0.2250000
NODE_21366_length_637_cov_44.923792	182	262	0	80	80	1.0000000
NODE_21366_length_637_cov_44.923792	235	315	0	80	80	1.0000000
NODE_21367_length_637_cov_44.193309	193	273	0	80	80	1.0000000
NODE_21367_length_637_cov_44.193309	246	326	0	80	80	1.0000000
NODE_21368_length_637_cov_37.855019	215	295	0	5	80	0.0625000
NODE_21368_length_637_cov_37.855019	215	295	10	2	80	0.0250000
NODE_21368_length_637_cov_37.855019	215	295	11	21	80	0.2625000
NODE_21368_length_637_cov_37.855019	215	295	12	52	80	0.6500000
NODE_21368_length_637_cov_37.855019	268	347	0	51	79	0.6455696
NODE_21368_length_637_cov_37.855019	268	347	12	28	79	0.3544304
NODE_21369_length_637_cov_33.957249	332	412	0	80	80	1.0000000
NODE_21369_length_637_cov_33.957249	385	465	0	80	80	1.0000000
NODE_21370_length_637_cov_23.682156	275	355	0	80	80	1.0000000
NODE_21370_length_637_cov_23.682156	328	408	0	80	80	1.0000000
NODE_21371_length_637_cov_19.676580	267	347	0	80	80	1.0000000
NODE_21371_length_637_cov_19.676580	320	400	0	80	80	1.0000000
NODE_21373_length_637_cov_9.182156	226	276	0	50	50	1.0000000
NODE_21373_length_637_cov_9.182156	312	357	0	45	45	1.0000000
NODE_21374_length_637_cov_9.078067	276	357	0	42	81	0.5185185
NODE_21374_length_637_cov_9.078067	276	357	2	3	81	0.0370370
NODE_21374_length_637_cov_9.078067	276	357	4	23	81	0.2839506
NODE_21374_length_637_cov_9.078067	276	357	6	13	81	0.1604938
NODE_21374_length_637_cov_9.078067	330	410	0	80	80	1.0000000
NODE_21375_length_637_cov_8.566914	235	315	0	33	80	0.4125000
NODE_21375_length_637_cov_8.566914	235	315	2	47	80	0.5875000
NODE_21375_length_637_cov_8.566914	288	368	0	31	80	0.3875000
NODE_21375_length_637_cov_8.566914	288	368	2	49	80	0.6125000
NODE_21378_length_637_cov_6.652416	337	415	0	78	78	1.0000000
NODE_21378_length_637_cov_6.652416	390	472	0	82	82	1.0000000
NODE_21385_length_637_cov_4.522305	284	364	0	80	80	1.0000000
NODE_21385_length_637_cov_4.522305	337	417	0	80	80	1.0000000
NODE_21389_length_637_cov_4.131970	292	370	0	78	78	1.0000000
NODE_21389_length_637_cov_4.131970	343	423	0	80	80	1.0000000
NODE_21457_length_636_cov_19.938547	214	294	0	80	80	1.0000000
NODE_21457_length_636_cov_19.938547	267	347	0	80	80	1.0000000
NODE_21458_length_636_cov_12.283054	295	375	0	80	80	1.0000000
NODE_21458_length_636_cov_12.283054	348	428	0	80	80	1.0000000
NODE_21460_length_636_cov_8.312849	346	413	0	33	67	0.4925373
NODE_21460_length_636_cov_8.312849	346	413	2	34	67	0.5074627
NODE_21460_length_636_cov_8.312849	399	479	0	21	80	0.2625000
NODE_21460_length_636_cov_8.312849	399	479	2	59	80	0.7375000
NODE_21467_length_636_cov_4.324022	185	251	2	37	66	0.5606061
NODE_21467_length_636_cov_4.324022	185	251	4	29	66	0.4393939
NODE_21467_length_636_cov_4.324022	224	266	4	42	42	1.0000000
NODE_21467_length_636_cov_4.324022	224	264	4	40	40	1.0000000
NODE_21539_length_635_cov_45.483209	195	239	92	1	44	0.0227273
NODE_21539_length_635_cov_45.483209	195	239	93	11	44	0.2500000
NODE_21539_length_635_cov_45.483209	195	239	94	1	44	0.0227273
NODE_21539_length_635_cov_45.483209	195	239	95	3	44	0.0681818
NODE_21539_length_635_cov_45.483209	195	239	96	1	44	0.0227273
NODE_21539_length_635_cov_45.483209	195	239	97	2	44	0.0454545
NODE_21539_length_635_cov_45.483209	195	239	98	1	44	0.0227273
NODE_21539_length_635_cov_45.483209	195	239	99	6	44	0.1363636
NODE_21539_length_635_cov_45.483209	195	239	100	3	44	0.0681818
NODE_21539_length_635_cov_45.483209	195	239	101	12	44	0.2727273
NODE_21539_length_635_cov_45.483209	195	239	102	3	44	0.0681818
NODE_21539_length_635_cov_45.483209	225	268	74	2	43	0.0465116
NODE_21539_length_635_cov_45.483209	225	268	75	1	43	0.0232558
NODE_21539_length_635_cov_45.483209	225	268	76	4	43	0.0930233
NODE_21539_length_635_cov_45.483209	225	268	77	1	43	0.0232558
NODE_21539_length_635_cov_45.483209	225	268	79	1	43	0.0232558
NODE_21539_length_635_cov_45.483209	225	268	87	1	43	0.0232558
NODE_21539_length_635_cov_45.483209	225	268	92	3	43	0.0697674
NODE_21539_length_635_cov_45.483209	225	268	94	1	43	0.0232558
NODE_21539_length_635_cov_45.483209	225	268	98	3	43	0.0697674
NODE_21539_length_635_cov_45.483209	225	268	99	4	43	0.0930233
NODE_21539_length_635_cov_45.483209	225	268	100	3	43	0.0697674
NODE_21539_length_635_cov_45.483209	225	268	101	13	43	0.3023256
NODE_21539_length_635_cov_45.483209	225	268	102	5	43	0.1162791
NODE_21539_length_635_cov_45.483209	225	268	103	1	43	0.0232558
NODE_21539_length_635_cov_45.483209	248	298	45	5	50	0.1000000
NODE_21539_length_635_cov_45.483209	248	298	53	1	50	0.0200000
NODE_21539_length_635_cov_45.483209	248	298	57	1	50	0.0200000
NODE_21539_length_635_cov_45.483209	248	298	59	1	50	0.0200000
NODE_21539_length_635_cov_45.483209	248	298	64	2	50	0.0400000
NODE_21539_length_635_cov_45.483209	248	298	69	2	50	0.0400000
NODE_21539_length_635_cov_45.483209	248	298	71	1	50	0.0200000
NODE_21539_length_635_cov_45.483209	248	298	73	7	50	0.1400000
NODE_21539_length_635_cov_45.483209	248	298	74	2	50	0.0400000
NODE_21539_length_635_cov_45.483209	248	298	75	7	50	0.1400000
NODE_21539_length_635_cov_45.483209	248	298	76	4	50	0.0800000
NODE_21539_length_635_cov_45.483209	248	298	77	1	50	0.0200000
NODE_21539_length_635_cov_45.483209	248	298	79	5	50	0.1000000
NODE_21539_length_635_cov_45.483209	248	298	87	1	50	0.0200000
NODE_21539_length_635_cov_45.483209	248	298	92	3	50	0.0600000
NODE_21539_length_635_cov_45.483209	248	298	94	1	50	0.0200000
NODE_21539_length_635_cov_45.483209	248	298	98	3	50	0.0600000
NODE_21539_length_635_cov_45.483209	248	298	102	2	50	0.0400000
NODE_21539_length_635_cov_45.483209	248	298	103	1	50	0.0200000
NODE_21541_length_635_cov_23.895522	179	259	0	80	80	1.0000000
NODE_21541_length_635_cov_23.895522	232	312	0	80	80	1.0000000
NODE_21543_length_635_cov_14.772388	48	128	0	80	80	1.0000000
NODE_21543_length_635_cov_14.772388	101	181	0	80	80	1.0000000
NODE_21549_length_635_cov_6.180970	276	356	0	80	80	1.0000000
NODE_21549_length_635_cov_6.180970	329	409	0	80	80	1.0000000
NODE_21554_length_635_cov_4.421642	442	522	0	80	80	1.0000000
NODE_21560_length_635_cov_2.985075	296	376	8	5	80	0.0625000
NODE_21560_length_635_cov_2.985075	296	376	9	4	80	0.0500000
NODE_21560_length_635_cov_2.985075	296	376	15	6	80	0.0750000
NODE_21560_length_635_cov_2.985075	296	376	16	4	80	0.0500000
NODE_21560_length_635_cov_2.985075	296	376	17	3	80	0.0375000
NODE_21560_length_635_cov_2.985075	296	376	18	58	80	0.7250000
NODE_21625_length_634_cov_53.315888	349	429	0	80	80	1.0000000
NODE_21625_length_634_cov_53.315888	402	482	0	80	80	1.0000000
NODE_21626_length_634_cov_28.530841	156	236	0	26	80	0.3250000
NODE_21626_length_634_cov_28.530841	156	236	2	44	80	0.5500000
NODE_21626_length_634_cov_28.530841	156	236	4	10	80	0.1250000
NODE_21626_length_634_cov_28.530841	209	289	2	38	80	0.4750000
NODE_21626_length_634_cov_28.530841	209	289	4	42	80	0.5250000
NODE_21627_length_634_cov_19.117757	151	229	0	78	78	1.0000000
NODE_21627_length_634_cov_19.117757	204	268	0	64	64	1.0000000
NODE_21628_length_634_cov_18.762617	84	164	0	80	80	1.0000000
NODE_21628_length_634_cov_18.762617	137	217	0	80	80	1.0000000
NODE_21629_length_634_cov_18.136449	162	242	0	80	80	1.0000000
NODE_21629_length_634_cov_18.136449	215	295	0	80	80	1.0000000
NODE_21635_length_634_cov_9.988785	508	553	0	45	45	1.0000000
NODE_21636_length_634_cov_9.381308	267	353	0	86	86	1.0000000
NODE_21636_length_634_cov_9.381308	324	404	0	80	80	1.0000000
NODE_21651_length_634_cov_3.702804	460	532	0	72	72	1.0000000
NODE_21720_length_633_cov_30.076779	180	214	0	34	34	1.0000000
NODE_21720_length_633_cov_30.076779	187	267	0	80	80	1.0000000
NODE_21720_length_633_cov_30.076779	263	343	0	80	80	1.0000000
NODE_21720_length_633_cov_30.076779	316	396	0	80	80	1.0000000
NODE_21721_length_633_cov_17.595506	282	362	0	80	80	1.0000000
NODE_21721_length_633_cov_17.595506	335	415	0	80	80	1.0000000
NODE_21722_length_633_cov_17.327715	228	308	0	80	80	1.0000000
NODE_21722_length_633_cov_17.327715	281	361	0	80	80	1.0000000
NODE_21723_length_633_cov_9.689139	79	147	6	7	68	0.1029412
NODE_21723_length_633_cov_9.689139	79	147	8	3	68	0.0441176
NODE_21723_length_633_cov_9.689139	79	147	12	14	68	0.2058824
NODE_21723_length_633_cov_9.689139	79	147	16	1	68	0.0147059
NODE_21723_length_633_cov_9.689139	79	147	18	4	68	0.0588235
NODE_21723_length_633_cov_9.689139	79	147	20	35	68	0.5147059
NODE_21723_length_633_cov_9.689139	79	147	22	4	68	0.0588235
NODE_21729_length_633_cov_7.018727	309	389	0	80	80	1.0000000
NODE_21729_length_633_cov_7.018727	362	442	0	50	80	0.6250000
NODE_21729_length_633_cov_7.018727	362	442	2	30	80	0.3750000
NODE_21755_length_633_cov_2.644195	166	240	0	74	74	1.0000000
NODE_21816_length_632_cov_25.425891	332	412	0	80	80	1.0000000
NODE_21816_length_632_cov_25.425891	385	465	0	80	80	1.0000000
NODE_21817_length_632_cov_21.613508	243	323	0	80	80	1.0000000
NODE_21817_length_632_cov_21.613508	296	376	0	80	80	1.0000000
NODE_21818_length_632_cov_16.465291	293	373	0	80	80	1.0000000
NODE_21818_length_632_cov_16.465291	346	426	0	80	80	1.0000000
NODE_21819_length_632_cov_13.260788	232	312	0	80	80	1.0000000
NODE_21819_length_632_cov_13.260788	285	365	0	80	80	1.0000000
NODE_21821_length_632_cov_9.106942	188	268	0	80	80	1.0000000
NODE_21821_length_632_cov_9.106942	241	321	0	80	80	1.0000000
NODE_21834_length_632_cov_4.135084	229	309	0	80	80	1.0000000
NODE_21834_length_632_cov_4.135084	282	359	0	77	77	1.0000000
NODE_21841_length_632_cov_2.939962	216	274	0	58	58	1.0000000
NODE_21841_length_632_cov_2.939962	247	327	0	80	80	1.0000000
NODE_21848_length_632_cov_2.330206	57	76	0	19	19	1.0000000
NODE_21912_length_631_cov_31.469925	321	396	0	75	75	1.0000000
NODE_21912_length_631_cov_31.469925	369	449	0	80	80	1.0000000
NODE_21913_length_631_cov_26.453008	383	463	0	80	80	1.0000000
NODE_21913_length_631_cov_26.453008	436	516	0	80	80	1.0000000
NODE_21917_length_631_cov_8.374060	318	398	0	80	80	1.0000000
NODE_21917_length_631_cov_8.374060	371	451	0	80	80	1.0000000
NODE_21924_length_631_cov_5.507519	335	386	2	51	51	1.0000000
NODE_21927_length_631_cov_5.227444	443	523	4	80	80	1.0000000
NODE_21927_length_631_cov_5.227444	496	576	0	34	80	0.4250000
NODE_21927_length_631_cov_5.227444	496	576	2	14	80	0.1750000
NODE_21927_length_631_cov_5.227444	496	576	4	32	80	0.4000000
NODE_21942_length_631_cov_2.926692	307	354	0	47	47	1.0000000
NODE_21983_length_631_cov_1.383459	248	267	0	19	19	1.0000000
NODE_22011_length_630_cov_41.728814	6	86	0	80	80	1.0000000
NODE_22011_length_630_cov_41.728814	59	139	0	80	80	1.0000000
NODE_22012_length_630_cov_24.856874	421	501	0	80	80	1.0000000
NODE_22012_length_630_cov_24.856874	474	554	0	80	80	1.0000000
NODE_22013_length_630_cov_14.323917	196	276	0	70	80	0.8750000
NODE_22013_length_630_cov_14.323917	196	276	2	10	80	0.1250000
NODE_22013_length_630_cov_14.323917	249	329	0	18	80	0.2250000
NODE_22013_length_630_cov_14.323917	249	329	2	62	80	0.7750000
NODE_22014_length_630_cov_9.964218	284	364	0	47	80	0.5875000
NODE_22014_length_630_cov_9.964218	284	364	2	33	80	0.4125000
NODE_22014_length_630_cov_9.964218	337	417	0	80	80	1.0000000
NODE_22086_length_629_cov_38.271698	288	368	0	80	80	1.0000000
NODE_22086_length_629_cov_38.271698	341	421	0	80	80	1.0000000
NODE_22087_length_629_cov_27.556604	212	292	0	80	80	1.0000000
NODE_22087_length_629_cov_27.556604	265	345	0	80	80	1.0000000
NODE_22088_length_629_cov_24.150943	356	436	0	80	80	1.0000000
NODE_22088_length_629_cov_24.150943	409	489	0	80	80	1.0000000
NODE_22091_length_629_cov_13.641509	176	256	0	80	80	1.0000000
NODE_22091_length_629_cov_13.641509	229	309	0	80	80	1.0000000
NODE_22101_length_629_cov_4.264151	362	442	0	52	80	0.6500000
NODE_22101_length_629_cov_4.264151	362	442	2	28	80	0.3500000
NODE_22188_length_628_cov_5.015123	210	274	0	64	64	1.0000000
NODE_22257_length_627_cov_24.500000	217	297	0	80	80	1.0000000
NODE_22257_length_627_cov_24.500000	270	350	0	80	80	1.0000000
NODE_22258_length_627_cov_20.395833	84	164	4	2	80	0.0250000
NODE_22258_length_627_cov_20.395833	84	164	8	78	80	0.9750000
NODE_22258_length_627_cov_20.395833	137	217	0	14	80	0.1750000
NODE_22258_length_627_cov_20.395833	137	217	4	41	80	0.5125000
NODE_22258_length_627_cov_20.395833	137	217	8	25	80	0.3125000
NODE_22259_length_627_cov_19.676136	308	388	1	80	80	1.0000000
NODE_22259_length_627_cov_19.676136	361	441	1	65	80	0.8125000
NODE_22259_length_627_cov_19.676136	361	441	2	15	80	0.1875000
NODE_22260_length_627_cov_17.634470	264	296	0	32	32	1.0000000
NODE_22260_length_627_cov_17.634470	360	385	2	25	25	1.0000000
NODE_22260_length_627_cov_17.634470	365	385	2	20	20	1.0000000
NODE_22260_length_627_cov_17.634470	385	424	2	39	39	1.0000000
NODE_22267_length_627_cov_5.634470	298	346	0	6	48	0.1250000
NODE_22267_length_627_cov_5.634470	298	346	2	42	48	0.8750000
NODE_22274_length_627_cov_4.517045	323	403	0	80	80	1.0000000
NODE_22274_length_627_cov_4.517045	376	456	0	80	80	1.0000000
NODE_22357_length_626_cov_24.184061	140	220	0	80	80	1.0000000
NODE_22357_length_626_cov_24.184061	193	273	0	80	80	1.0000000
NODE_22358_length_626_cov_21.189753	342	419	4	21	77	0.2727273
NODE_22358_length_626_cov_21.189753	342	419	8	56	77	0.7272727
NODE_22358_length_626_cov_21.189753	342	419	4	21	77	0.2727273
NODE_22358_length_626_cov_21.189753	342	419	8	56	77	0.7272727
NODE_22358_length_626_cov_21.189753	392	453	0	15	61	0.2459016
NODE_22358_length_626_cov_21.189753	392	453	4	40	61	0.6557377
NODE_22358_length_626_cov_21.189753	392	453	8	6	61	0.0983607
NODE_22364_length_626_cov_7.100569	236	311	0	75	75	1.0000000
NODE_22364_length_626_cov_7.100569	284	364	0	80	80	1.0000000
NODE_22366_length_626_cov_6.296015	193	273	2	80	80	1.0000000
NODE_22366_length_626_cov_6.296015	246	326	0	42	80	0.5250000
NODE_22366_length_626_cov_6.296015	246	326	2	38	80	0.4750000
NODE_22367_length_626_cov_6.163188	257	337	0	80	80	1.0000000
NODE_22367_length_626_cov_6.163188	310	390	0	80	80	1.0000000
NODE_22438_length_625_cov_33.100760	239	319	0	80	80	1.0000000
NODE_22438_length_625_cov_33.100760	292	372	0	80	80	1.0000000
NODE_22438_length_625_cov_33.100760	368	448	0	80	80	1.0000000
NODE_22438_length_625_cov_33.100760	421	501	0	80	80	1.0000000
NODE_22439_length_625_cov_21.062738	267	347	0	80	80	1.0000000
NODE_22439_length_625_cov_21.062738	320	400	0	80	80	1.0000000
NODE_22440_length_625_cov_14.237643	28	108	0	80	80	1.0000000
NODE_22440_length_625_cov_14.237643	81	161	0	80	80	1.0000000
NODE_22441_length_625_cov_14.207224	358	438	0	80	80	1.0000000
NODE_22441_length_625_cov_14.207224	411	491	0	80	80	1.0000000
NODE_22455_length_625_cov_4.157795	548	600	0	52	52	1.0000000
NODE_22466_length_625_cov_2.929658	118	198	0	80	80	1.0000000
NODE_22466_length_625_cov_2.929658	171	251	0	80	80	1.0000000
NODE_22491_length_625_cov_1.570342	471	502	0	31	31	1.0000000
NODE_22542_length_624_cov_9.598095	77	126	0	49	49	1.0000000
NODE_22542_length_624_cov_9.598095	103	183	0	80	80	1.0000000
NODE_22544_length_624_cov_8.485714	271	351	0	80	80	1.0000000
NODE_22544_length_624_cov_8.485714	324	404	0	80	80	1.0000000
NODE_22546_length_624_cov_6.691429	386	466	0	80	80	1.0000000
NODE_22546_length_624_cov_6.691429	439	519	0	80	80	1.0000000
NODE_22547_length_624_cov_5.592381	312	387	0	66	75	0.8800000
NODE_22547_length_624_cov_5.592381	312	387	2	9	75	0.1200000
NODE_22551_length_624_cov_4.638095	328	388	6	60	60	1.0000000
NODE_22642_length_623_cov_41.877863	419	499	0	80	80	1.0000000
NODE_22642_length_623_cov_41.877863	472	552	0	80	80	1.0000000
NODE_22643_length_623_cov_31.875954	148	228	0	80	80	1.0000000
NODE_22643_length_623_cov_31.875954	201	281	0	80	80	1.0000000
NODE_22644_length_623_cov_31.192748	313	393	0	80	80	1.0000000
NODE_22644_length_623_cov_31.192748	366	446	0	80	80	1.0000000
NODE_22645_length_623_cov_20.187023	287	367	2	51	80	0.6375000
NODE_22645_length_623_cov_20.187023	287	367	4	29	80	0.3625000
NODE_22645_length_623_cov_20.187023	340	420	0	21	80	0.2625000
NODE_22645_length_623_cov_20.187023	340	420	2	47	80	0.5875000
NODE_22645_length_623_cov_20.187023	340	420	3	12	80	0.1500000
NODE_22646_length_623_cov_12.045802	377	457	0	80	80	1.0000000
NODE_22646_length_623_cov_12.045802	430	510	0	80	80	1.0000000
NODE_22668_length_623_cov_2.891221	457	535	0	78	78	1.0000000
NODE_22725_length_622_cov_19.042065	368	448	0	31	80	0.3875000
NODE_22725_length_622_cov_19.042065	368	448	2	49	80	0.6125000
NODE_22725_length_622_cov_19.042065	421	501	0	30	80	0.3750000
NODE_22725_length_622_cov_19.042065	421	501	2	50	80	0.6250000
NODE_22726_length_622_cov_13.470363	109	189	0	80	80	1.0000000
NODE_22726_length_622_cov_13.470363	162	242	0	80	80	1.0000000
NODE_22752_length_622_cov_2.407266	94	170	2	2	76	0.0263158
NODE_22752_length_622_cov_2.407266	94	170	4	74	76	0.9736842
NODE_22796_length_622_cov_1.353728	346	376	0	30	30	1.0000000
NODE_22819_length_621_cov_46.247126	0	52	0	52	52	1.0000000
NODE_22819_length_621_cov_46.247126	25	105	0	80	80	1.0000000
NODE_22819_length_621_cov_46.247126	101	181	0	80	80	1.0000000
NODE_22819_length_621_cov_46.247126	154	234	0	80	80	1.0000000
NODE_22820_length_621_cov_45.764368	344	424	0	67	80	0.8375000
NODE_22820_length_621_cov_45.764368	344	424	2	13	80	0.1625000
NODE_22820_length_621_cov_45.764368	397	477	0	14	80	0.1750000
NODE_22820_length_621_cov_45.764368	397	477	2	66	80	0.8250000
NODE_22821_length_621_cov_35.147510	393	473	0	80	80	1.0000000
NODE_22821_length_621_cov_35.147510	446	526	0	80	80	1.0000000
NODE_22822_length_621_cov_13.842912	231	311	0	80	80	1.0000000
NODE_22822_length_621_cov_13.842912	284	364	0	80	80	1.0000000
NODE_22825_length_621_cov_6.279693	376	406	0	30	30	1.0000000
NODE_22845_length_621_cov_2.645594	367	426	0	59	59	1.0000000
NODE_22914_length_620_cov_23.913628	433	513	0	80	80	1.0000000
NODE_22914_length_620_cov_23.913628	486	566	0	80	80	1.0000000
NODE_22915_length_620_cov_9.222649	186	266	0	80	80	1.0000000
NODE_22915_length_620_cov_9.222649	239	319	0	80	80	1.0000000
NODE_22919_length_620_cov_7.804223	57	137	1	1	80	0.0125000
NODE_22919_length_620_cov_7.804223	57	137	2	68	80	0.8500000
NODE_22919_length_620_cov_7.804223	57	137	3	11	80	0.1375000
NODE_22919_length_620_cov_7.804223	110	190	1	1	80	0.0125000
NODE_22919_length_620_cov_7.804223	110	190	2	68	80	0.8500000
NODE_22919_length_620_cov_7.804223	110	190	3	11	80	0.1375000
NODE_22920_length_620_cov_6.909789	199	279	0	80	80	1.0000000
NODE_22920_length_620_cov_6.909789	252	332	0	80	80	1.0000000
NODE_22930_length_620_cov_4.560461	309	347	27	25	38	0.6578947
NODE_22930_length_620_cov_4.560461	309	347	29	8	38	0.2105263
NODE_22930_length_620_cov_4.560461	309	347	30	5	38	0.1315790
NODE_22930_length_620_cov_4.560461	395	421	0	7	26	0.2692308
NODE_22930_length_620_cov_4.560461	395	421	6	18	26	0.6923077
NODE_22930_length_620_cov_4.560461	395	421	10	1	26	0.0384615
NODE_22930_length_620_cov_4.560461	395	451	0	8	56	0.1428571
NODE_22930_length_620_cov_4.560461	395	451	2	29	56	0.5178571
NODE_22930_length_620_cov_4.560461	395	451	6	18	56	0.3214286
NODE_22930_length_620_cov_4.560461	395	451	10	1	56	0.0178571
NODE_23031_length_619_cov_26.309615	118	198	0	80	80	1.0000000
NODE_23031_length_619_cov_26.309615	171	251	0	80	80	1.0000000
NODE_23033_length_619_cov_10.417308	427	487	0	42	60	0.7000000
NODE_23033_length_619_cov_10.417308	427	487	2	18	60	0.3000000
NODE_23034_length_619_cov_7.944231	213	293	0	80	80	1.0000000
NODE_23034_length_619_cov_7.944231	266	346	0	80	80	1.0000000
NODE_23135_length_618_cov_14.477842	223	299	2	28	76	0.3684210
NODE_23135_length_618_cov_14.477842	223	299	8	48	76	0.6315789
NODE_23135_length_618_cov_14.477842	223	299	2	28	76	0.3684210
NODE_23135_length_618_cov_14.477842	223	299	8	48	76	0.6315789
NODE_23135_length_618_cov_14.477842	276	337	6	2	61	0.0327869
NODE_23135_length_618_cov_14.477842	276	337	8	59	61	0.9672131
NODE_23136_length_618_cov_13.840077	377	457	0	80	80	1.0000000
NODE_23136_length_618_cov_13.840077	430	510	0	80	80	1.0000000
NODE_23137_length_618_cov_12.048170	348	428	0	80	80	1.0000000
NODE_23137_length_618_cov_12.048170	401	481	0	80	80	1.0000000
NODE_23138_length_618_cov_8.799615	353	433	0	80	80	1.0000000
NODE_23138_length_618_cov_8.799615	406	486	0	80	80	1.0000000
NODE_23147_length_618_cov_3.793834	412	478	0	66	66	1.0000000
NODE_23148_length_618_cov_3.761079	305	385	0	80	80	1.0000000
NODE_23252_length_617_cov_29.565637	378	458	0	80	80	1.0000000
NODE_23252_length_617_cov_29.565637	431	511	0	80	80	1.0000000
NODE_23253_length_617_cov_16.781853	253	333	0	80	80	1.0000000
NODE_23253_length_617_cov_16.781853	306	386	0	80	80	1.0000000
NODE_23254_length_617_cov_9.175676	373	453	0	80	80	1.0000000
NODE_23254_length_617_cov_9.175676	426	506	0	80	80	1.0000000
NODE_23255_length_617_cov_8.774131	320	406	0	86	86	1.0000000
NODE_23255_length_617_cov_8.774131	379	458	0	79	79	1.0000000
NODE_23257_length_617_cov_8.416988	359	439	0	80	80	1.0000000
NODE_23257_length_617_cov_8.416988	412	492	0	80	80	1.0000000
NODE_23259_length_617_cov_7.683398	197	275	0	78	78	1.0000000
NODE_23259_length_617_cov_7.683398	250	330	0	80	80	1.0000000
NODE_23263_length_617_cov_5.330116	288	360	8	72	72	1.0000000
NODE_23263_length_617_cov_5.330116	333	413	0	3	80	0.0375000
NODE_23263_length_617_cov_5.330116	333	413	1	1	80	0.0125000
NODE_23263_length_617_cov_5.330116	333	413	6	32	80	0.4000000
NODE_23263_length_617_cov_5.330116	333	413	8	44	80	0.5500000
NODE_23302_length_617_cov_1.967181	384	430	0	46	46	1.0000000
NODE_23311_length_617_cov_1.847490	273	344	0	71	71	1.0000000
NODE_23331_length_617_cov_1.322394	269	318	26	4	49	0.0816327
NODE_23331_length_617_cov_1.322394	269	318	28	23	49	0.4693878
NODE_23331_length_617_cov_1.322394	269	318	30	21	49	0.4285714
NODE_23331_length_617_cov_1.322394	269	318	32	1	49	0.0204082
NODE_23365_length_616_cov_15.914894	292	370	0	78	78	1.0000000
NODE_23365_length_616_cov_15.914894	343	423	0	80	80	1.0000000
NODE_23366_length_616_cov_14.276596	191	271	0	80	80	1.0000000
NODE_23366_length_616_cov_14.276596	244	319	0	75	75	1.0000000
NODE_23366_length_616_cov_14.276596	368	448	0	80	80	1.0000000
NODE_23367_length_616_cov_12.119923	273	353	0	80	80	1.0000000
NODE_23367_length_616_cov_12.119923	326	406	0	80	80	1.0000000
NODE_23373_length_616_cov_6.379110	305	385	0	80	80	1.0000000
NODE_23373_length_616_cov_6.379110	358	438	0	80	80	1.0000000
NODE_23381_length_616_cov_4.441006	286	350	0	64	64	1.0000000
NODE_23381_length_616_cov_4.441006	286	306	0	20	20	1.0000000
NODE_23400_length_616_cov_2.541586	375	415	0	30	40	0.7500000
NODE_23400_length_616_cov_2.541586	375	415	4	10	40	0.2500000
NODE_23430_length_616_cov_1.491296	105	183	8	10	78	0.1282051
NODE_23430_length_616_cov_1.491296	105	183	10	21	78	0.2692308
NODE_23430_length_616_cov_1.491296	105	183	12	13	78	0.1666667
NODE_23430_length_616_cov_1.491296	105	183	13	1	78	0.0128205
NODE_23430_length_616_cov_1.491296	105	183	14	33	78	0.4230769
NODE_23474_length_615_cov_27.519380	302	382	0	17	80	0.2125000
NODE_23474_length_615_cov_27.519380	302	382	4	63	80	0.7875000
NODE_23474_length_615_cov_27.519380	355	435	0	16	80	0.2000000
NODE_23474_length_615_cov_27.519380	355	435	4	64	80	0.8000000
NODE_23475_length_615_cov_17.792636	239	319	0	80	80	1.0000000
NODE_23475_length_615_cov_17.792636	292	372	0	80	80	1.0000000
NODE_23477_length_615_cov_11.835271	240	320	0	80	80	1.0000000
NODE_23477_length_615_cov_11.835271	293	373	0	80	80	1.0000000
NODE_23478_length_615_cov_8.591085	287	367	0	80	80	1.0000000
NODE_23478_length_615_cov_8.591085	340	420	0	80	80	1.0000000
NODE_23513_length_615_cov_2.461240	429	509	0	80	80	1.0000000
NODE_23513_length_615_cov_2.461240	482	562	0	80	80	1.0000000
NODE_23516_length_615_cov_2.379845	405	467	0	62	62	1.0000000
NODE_23516_length_615_cov_2.379845	440	520	0	80	80	1.0000000
NODE_23517_length_615_cov_2.294574	205	268	0	63	63	1.0000000
NODE_23554_length_615_cov_1.122093	255	335	0	29	80	0.3625000
NODE_23554_length_615_cov_1.122093	255	335	4	51	80	0.6375000
NODE_23566_length_615_cov_0.887597	561	582	0	21	21	1.0000000
NODE_23575_length_614_cov_17.772816	257	337	0	80	80	1.0000000
NODE_23575_length_614_cov_17.772816	310	390	0	80	80	1.0000000
NODE_23576_length_614_cov_10.706796	425	505	0	35	80	0.4375000
NODE_23576_length_614_cov_10.706796	425	505	2	34	80	0.4250000
NODE_23576_length_614_cov_10.706796	425	505	4	11	80	0.1375000
NODE_23576_length_614_cov_10.706796	478	558	0	80	80	1.0000000
NODE_23578_length_614_cov_8.545631	193	273	0	53	80	0.6625000
NODE_23578_length_614_cov_8.545631	193	273	2	2	80	0.0250000
NODE_23578_length_614_cov_8.545631	193	273	4	5	80	0.0625000
NODE_23578_length_614_cov_8.545631	193	273	8	5	80	0.0625000
NODE_23578_length_614_cov_8.545631	193	273	10	10	80	0.1250000
NODE_23578_length_614_cov_8.545631	193	273	12	5	80	0.0625000
NODE_23578_length_614_cov_8.545631	246	326	0	77	80	0.9625000
NODE_23578_length_614_cov_8.545631	246	326	2	3	80	0.0375000
NODE_23604_length_614_cov_2.450485	315	393	0	57	78	0.7307692
NODE_23604_length_614_cov_2.450485	315	393	2	21	78	0.2692308
NODE_23604_length_614_cov_2.450485	355	383	0	17	28	0.6071429
NODE_23604_length_614_cov_2.450485	355	383	2	11	28	0.3928571
NODE_23604_length_614_cov_2.450485	368	448	0	4	80	0.0500000
NODE_23604_length_614_cov_2.450485	368	448	2	76	80	0.9500000
NODE_23604_length_614_cov_2.450485	379	448	2	69	69	1.0000000
NODE_23662_length_613_cov_18.075875	211	291	0	80	80	1.0000000
NODE_23662_length_613_cov_18.075875	264	344	0	80	80	1.0000000
NODE_23663_length_613_cov_16.118677	283	363	0	80	80	1.0000000
NODE_23663_length_613_cov_16.118677	336	416	0	80	80	1.0000000
NODE_23665_length_613_cov_12.883268	155	235	0	80	80	1.0000000
NODE_23665_length_613_cov_12.883268	208	288	0	80	80	1.0000000
NODE_23674_length_613_cov_3.857977	167	247	0	80	80	1.0000000
NODE_23674_length_613_cov_3.857977	220	300	0	80	80	1.0000000
NODE_23771_length_612_cov_24.023392	173	253	0	80	80	1.0000000
NODE_23771_length_612_cov_24.023392	226	306	0	80	80	1.0000000
NODE_23772_length_612_cov_23.846004	141	221	0	80	80	1.0000000
NODE_23772_length_612_cov_23.846004	194	274	0	80	80	1.0000000
NODE_23773_length_612_cov_12.448343	244	324	0	51	80	0.6375000
NODE_23773_length_612_cov_12.448343	244	324	2	29	80	0.3625000
NODE_23773_length_612_cov_12.448343	297	377	2	80	80	1.0000000
NODE_23774_length_612_cov_12.068226	267	347	0	80	80	1.0000000
NODE_23774_length_612_cov_12.068226	320	400	0	80	80	1.0000000
NODE_23779_length_612_cov_6.393762	242	322	0	80	80	1.0000000
NODE_23779_length_612_cov_6.393762	295	375	0	80	80	1.0000000
NODE_23814_length_612_cov_1.904483	288	354	0	66	66	1.0000000
NODE_23869_length_611_cov_38.705078	132	212	0	2	80	0.0250000
NODE_23869_length_611_cov_38.705078	132	212	1	6	80	0.0750000
NODE_23869_length_611_cov_38.705078	132	212	2	56	80	0.7000000
NODE_23869_length_611_cov_38.705078	132	212	4	16	80	0.2000000
NODE_23869_length_611_cov_38.705078	185	262	2	37	77	0.4805195
NODE_23869_length_611_cov_38.705078	185	262	4	40	77	0.5194805
NODE_23869_length_611_cov_38.705078	185	262	2	37	77	0.4805195
NODE_23869_length_611_cov_38.705078	185	262	4	40	77	0.5194805
NODE_23871_length_611_cov_12.669922	264	344	0	80	80	1.0000000
NODE_23871_length_611_cov_12.669922	317	397	0	80	80	1.0000000
NODE_23880_length_611_cov_4.943359	27	107	0	80	80	1.0000000
NODE_23880_length_611_cov_4.943359	80	137	0	57	57	1.0000000
NODE_23880_length_611_cov_4.943359	143	209	0	34	66	0.5151515
NODE_23880_length_611_cov_4.943359	143	209	2	32	66	0.4848485
NODE_23880_length_611_cov_4.943359	182	262	2	80	80	1.0000000
NODE_23894_length_611_cov_3.294922	271	300	0	29	29	1.0000000
NODE_23894_length_611_cov_3.294922	434	469	2	35	35	1.0000000
NODE_23897_length_611_cov_3.162109	313	342	0	29	29	1.0000000
NODE_23973_length_610_cov_20.673190	87	167	0	80	80	1.0000000
NODE_23973_length_610_cov_20.673190	140	220	0	80	80	1.0000000
NODE_23974_length_610_cov_10.191781	250	330	1	65	80	0.8125000
NODE_23974_length_610_cov_10.191781	250	330	2	15	80	0.1875000
NODE_23974_length_610_cov_10.191781	303	383	1	63	80	0.7875000
NODE_23974_length_610_cov_10.191781	303	383	2	17	80	0.2125000
NODE_23980_length_610_cov_4.998043	129	181	4	15	52	0.2884615
NODE_23980_length_610_cov_4.998043	129	181	8	37	52	0.7115384
NODE_23980_length_610_cov_4.998043	182	234	0	5	52	0.0961538
NODE_23980_length_610_cov_4.998043	182	234	4	22	52	0.4230769
NODE_23980_length_610_cov_4.998043	182	234	8	25	52	0.4807692
NODE_23989_length_610_cov_3.479452	215	267	0	52	52	1.0000000
NODE_24059_length_609_cov_21.117647	80	160	0	80	80	1.0000000
NODE_24059_length_609_cov_21.117647	133	213	0	80	80	1.0000000
NODE_24060_length_609_cov_11.300000	218	298	0	38	80	0.4750000
NODE_24060_length_609_cov_11.300000	218	298	2	42	80	0.5250000
NODE_24060_length_609_cov_11.300000	271	351	0	19	80	0.2375000
NODE_24060_length_609_cov_11.300000	271	351	2	61	80	0.7625000
NODE_24061_length_609_cov_10.778431	239	319	0	80	80	1.0000000
NODE_24061_length_609_cov_10.778431	292	372	0	80	80	1.0000000
NODE_24062_length_609_cov_10.298039	340	420	0	80	80	1.0000000
NODE_24062_length_609_cov_10.298039	393	473	0	80	80	1.0000000
NODE_24062_length_609_cov_10.298039	469	537	0	68	68	1.0000000
NODE_24063_length_609_cov_10.270588	217	297	0	80	80	1.0000000
NODE_24063_length_609_cov_10.270588	270	353	0	83	83	1.0000000
NODE_24064_length_609_cov_8.345098	408	488	0	14	80	0.1750000
NODE_24064_length_609_cov_8.345098	408	488	2	66	80	0.8250000
NODE_24064_length_609_cov_8.345098	461	515	0	6	54	0.1111111
NODE_24064_length_609_cov_8.345098	461	515	2	48	54	0.8888889
NODE_24064_length_609_cov_8.345098	537	566	0	29	29	1.0000000
NODE_24066_length_609_cov_6.054902	219	299	0	28	80	0.3500000
NODE_24066_length_609_cov_6.054902	219	299	1	17	80	0.2125000
NODE_24066_length_609_cov_6.054902	219	299	2	35	80	0.4375000
NODE_24066_length_609_cov_6.054902	272	352	2	80	80	1.0000000
NODE_24067_length_609_cov_5.986275	219	299	0	80	80	1.0000000
NODE_24067_length_609_cov_5.986275	272	352	0	80	80	1.0000000
NODE_24160_length_608_cov_76.257367	300	380	0	53	80	0.6625000
NODE_24160_length_608_cov_76.257367	300	380	2	27	80	0.3375000
NODE_24160_length_608_cov_76.257367	353	433	2	80	80	1.0000000
NODE_24161_length_608_cov_13.271120	252	332	4	80	80	1.0000000
NODE_24161_length_608_cov_13.271120	305	385	0	51	80	0.6375000
NODE_24161_length_608_cov_13.271120	305	385	4	29	80	0.3625000
NODE_24162_length_608_cov_11.583497	63	139	0	76	76	1.0000000
NODE_24162_length_608_cov_11.583497	112	192	0	80	80	1.0000000
NODE_24164_length_608_cov_8.076621	53	133	109	1	80	0.0125000
NODE_24164_length_608_cov_8.076621	53	133	111	1	80	0.0125000
NODE_24164_length_608_cov_8.076621	53	133	116	1	80	0.0125000
NODE_24164_length_608_cov_8.076621	53	133	120	3	80	0.0375000
NODE_24164_length_608_cov_8.076621	53	133	126	2	80	0.0250000
NODE_24164_length_608_cov_8.076621	53	133	130	1	80	0.0125000
NODE_24164_length_608_cov_8.076621	53	133	133	1	80	0.0125000
NODE_24164_length_608_cov_8.076621	53	133	145	2	80	0.0250000
NODE_24164_length_608_cov_8.076621	53	133	149	1	80	0.0125000
NODE_24164_length_608_cov_8.076621	53	133	167	3	80	0.0375000
NODE_24164_length_608_cov_8.076621	53	133	169	1	80	0.0125000
NODE_24164_length_608_cov_8.076621	53	133	171	6	80	0.0750000
NODE_24164_length_608_cov_8.076621	53	133	173	10	80	0.1250000
NODE_24164_length_608_cov_8.076621	53	133	175	2	80	0.0250000
NODE_24164_length_608_cov_8.076621	53	133	177	4	80	0.0500000
NODE_24164_length_608_cov_8.076621	53	133	179	1	80	0.0125000
NODE_24164_length_608_cov_8.076621	53	133	181	4	80	0.0500000
NODE_24164_length_608_cov_8.076621	53	133	183	2	80	0.0250000
NODE_24164_length_608_cov_8.076621	53	133	185	7	80	0.0875000
NODE_24164_length_608_cov_8.076621	53	133	187	22	80	0.2750000
NODE_24164_length_608_cov_8.076621	53	133	189	5	80	0.0625000
NODE_24164_length_608_cov_8.076621	106	186	0	19	80	0.2375000
NODE_24164_length_608_cov_8.076621	106	186	4	1	80	0.0125000
NODE_24164_length_608_cov_8.076621	106	186	6	4	80	0.0500000
NODE_24164_length_608_cov_8.076621	106	186	9	1	80	0.0125000
NODE_24164_length_608_cov_8.076621	106	186	17	1	80	0.0125000
NODE_24164_length_608_cov_8.076621	106	186	29	1	80	0.0125000
NODE_24164_length_608_cov_8.076621	106	186	35	1	80	0.0125000
NODE_24164_length_608_cov_8.076621	106	186	37	1	80	0.0125000
NODE_24164_length_608_cov_8.076621	106	186	39	1	80	0.0125000
NODE_24164_length_608_cov_8.076621	106	186	41	1	80	0.0125000
NODE_24164_length_608_cov_8.076621	106	186	43	1	80	0.0125000
NODE_24164_length_608_cov_8.076621	106	186	44	2	80	0.0250000
NODE_24164_length_608_cov_8.076621	106	186	50	1	80	0.0125000
NODE_24164_length_608_cov_8.076621	106	186	52	2	80	0.0250000
NODE_24164_length_608_cov_8.076621	106	186	59	1	80	0.0125000
NODE_24164_length_608_cov_8.076621	106	186	69	2	80	0.0250000
NODE_24164_length_608_cov_8.076621	106	186	95	2	80	0.0250000
NODE_24164_length_608_cov_8.076621	106	186	97	1	80	0.0125000
NODE_24164_length_608_cov_8.076621	106	186	101	2	80	0.0250000
NODE_24164_length_608_cov_8.076621	106	186	105	4	80	0.0500000
NODE_24164_length_608_cov_8.076621	106	186	109	5	80	0.0625000
NODE_24164_length_608_cov_8.076621	106	186	111	1	80	0.0125000
NODE_24164_length_608_cov_8.076621	106	186	116	1	80	0.0125000
NODE_24164_length_608_cov_8.076621	106	186	120	3	80	0.0375000
NODE_24164_length_608_cov_8.076621	106	186	126	2	80	0.0250000
NODE_24164_length_608_cov_8.076621	106	186	130	1	80	0.0125000
NODE_24164_length_608_cov_8.076621	106	186	133	1	80	0.0125000
NODE_24164_length_608_cov_8.076621	106	186	145	2	80	0.0250000
NODE_24164_length_608_cov_8.076621	106	186	149	1	80	0.0125000
NODE_24164_length_608_cov_8.076621	106	186	167	1	80	0.0125000
NODE_24164_length_608_cov_8.076621	106	186	171	2	80	0.0250000
NODE_24164_length_608_cov_8.076621	106	186	173	10	80	0.1250000
NODE_24164_length_608_cov_8.076621	106	186	175	1	80	0.0125000
NODE_24165_length_608_cov_7.994106	279	326	0	47	47	1.0000000
NODE_24165_length_608_cov_7.994106	348	373	0	25	25	1.0000000
NODE_24166_length_608_cov_7.939096	247	277	0	30	30	1.0000000
NODE_24177_length_608_cov_3.829077	313	393	0	80	80	1.0000000
NODE_24177_length_608_cov_3.829077	366	446	0	80	80	1.0000000
NODE_24251_length_608_cov_1.064833	472	512	4	37	40	0.9250000
NODE_24251_length_608_cov_1.064833	472	512	6	3	40	0.0750000
NODE_24281_length_607_cov_61.316929	347	427	31	20	80	0.2500000
NODE_24281_length_607_cov_61.316929	347	427	34	17	80	0.2125000
NODE_24281_length_607_cov_61.316929	347	427	37	14	80	0.1750000
NODE_24281_length_607_cov_61.316929	347	427	46	2	80	0.0250000
NODE_24281_length_607_cov_61.316929	347	427	47	22	80	0.2750000
NODE_24281_length_607_cov_61.316929	347	427	48	5	80	0.0625000
NODE_24281_length_607_cov_61.316929	347	427	31	20	80	0.2500000
NODE_24281_length_607_cov_61.316929	347	427	34	17	80	0.2125000
NODE_24281_length_607_cov_61.316929	347	427	37	14	80	0.1750000
NODE_24281_length_607_cov_61.316929	347	427	46	2	80	0.0250000
NODE_24281_length_607_cov_61.316929	347	427	47	22	80	0.2750000
NODE_24281_length_607_cov_61.316929	347	427	48	5	80	0.0625000
NODE_24281_length_607_cov_61.316929	347	427	31	20	80	0.2500000
NODE_24281_length_607_cov_61.316929	347	427	34	17	80	0.2125000
NODE_24281_length_607_cov_61.316929	347	427	37	14	80	0.1750000
NODE_24281_length_607_cov_61.316929	347	427	46	2	80	0.0250000
NODE_24281_length_607_cov_61.316929	347	427	47	22	80	0.2750000
NODE_24281_length_607_cov_61.316929	347	427	48	5	80	0.0625000
NODE_24281_length_607_cov_61.316929	364	427	31	3	63	0.0476190
NODE_24281_length_607_cov_61.316929	364	427	34	17	63	0.2698413
NODE_24281_length_607_cov_61.316929	364	427	37	14	63	0.2222222
NODE_24281_length_607_cov_61.316929	364	427	46	2	63	0.0317460
NODE_24281_length_607_cov_61.316929	364	427	47	22	63	0.3492064
NODE_24281_length_607_cov_61.316929	364	427	48	5	63	0.0793651
NODE_24281_length_607_cov_61.316929	400	480	47	22	80	0.2750000
NODE_24281_length_607_cov_61.316929	400	480	48	20	80	0.2500000
NODE_24281_length_607_cov_61.316929	400	480	50	38	80	0.4750000
NODE_24281_length_607_cov_61.316929	400	480	47	22	80	0.2750000
NODE_24281_length_607_cov_61.316929	400	480	48	20	80	0.2500000
NODE_24281_length_607_cov_61.316929	400	480	50	38	80	0.4750000
NODE_24281_length_607_cov_61.316929	400	480	47	22	80	0.2750000
NODE_24281_length_607_cov_61.316929	400	480	48	20	80	0.2500000
NODE_24281_length_607_cov_61.316929	400	480	50	38	80	0.4750000
NODE_24281_length_607_cov_61.316929	400	480	47	22	80	0.2750000
NODE_24281_length_607_cov_61.316929	400	480	48	20	80	0.2500000
NODE_24281_length_607_cov_61.316929	400	480	50	38	80	0.4750000
NODE_24281_length_607_cov_61.316929	476	556	4	22	80	0.2750000
NODE_24281_length_607_cov_61.316929	476	556	7	6	80	0.0750000
NODE_24281_length_607_cov_61.316929	476	556	9	11	80	0.1375000
NODE_24281_length_607_cov_61.316929	476	556	12	12	80	0.1500000
NODE_24281_length_607_cov_61.316929	476	556	22	13	80	0.1625000
NODE_24281_length_607_cov_61.316929	476	556	34	9	80	0.1125000
NODE_24281_length_607_cov_61.316929	476	556	37	1	80	0.0125000
NODE_24281_length_607_cov_61.316929	476	556	38	1	80	0.0125000
NODE_24281_length_607_cov_61.316929	476	556	50	5	80	0.0625000
NODE_24281_length_607_cov_61.316929	476	556	4	22	80	0.2750000
NODE_24281_length_607_cov_61.316929	476	556	7	6	80	0.0750000
NODE_24281_length_607_cov_61.316929	476	556	9	11	80	0.1375000
NODE_24281_length_607_cov_61.316929	476	556	12	12	80	0.1500000
NODE_24281_length_607_cov_61.316929	476	556	22	13	80	0.1625000
NODE_24281_length_607_cov_61.316929	476	556	34	9	80	0.1125000
NODE_24281_length_607_cov_61.316929	476	556	37	1	80	0.0125000
NODE_24281_length_607_cov_61.316929	476	556	38	1	80	0.0125000
NODE_24281_length_607_cov_61.316929	476	556	50	5	80	0.0625000
NODE_24281_length_607_cov_61.316929	476	556	4	22	80	0.2750000
NODE_24281_length_607_cov_61.316929	476	556	7	6	80	0.0750000
NODE_24281_length_607_cov_61.316929	476	556	9	11	80	0.1375000
NODE_24281_length_607_cov_61.316929	476	556	12	12	80	0.1500000
NODE_24281_length_607_cov_61.316929	476	556	22	13	80	0.1625000
NODE_24281_length_607_cov_61.316929	476	556	34	9	80	0.1125000
NODE_24281_length_607_cov_61.316929	476	556	37	1	80	0.0125000
NODE_24281_length_607_cov_61.316929	476	556	38	1	80	0.0125000
NODE_24281_length_607_cov_61.316929	476	556	50	5	80	0.0625000
NODE_24281_length_607_cov_61.316929	529	595	0	32	66	0.4848485
NODE_24281_length_607_cov_61.316929	529	595	2	1	66	0.0151515
NODE_24281_length_607_cov_61.316929	529	595	4	28	66	0.4242424
NODE_24281_length_607_cov_61.316929	529	595	7	5	66	0.0757576
NODE_24281_length_607_cov_61.316929	529	607	0	44	78	0.5641026
NODE_24281_length_607_cov_61.316929	529	607	2	1	78	0.0128205
NODE_24281_length_607_cov_61.316929	529	607	4	28	78	0.3589744
NODE_24281_length_607_cov_61.316929	529	607	7	5	78	0.0641026
NODE_24281_length_607_cov_61.316929	529	600	0	37	71	0.5211267
NODE_24281_length_607_cov_61.316929	529	600	2	1	71	0.0140845
NODE_24281_length_607_cov_61.316929	529	600	4	28	71	0.3943662
NODE_24281_length_607_cov_61.316929	529	600	7	5	71	0.0704225
NODE_24281_length_607_cov_61.316929	534	607	0	44	73	0.6027398
NODE_24281_length_607_cov_61.316929	534	607	2	1	73	0.0136986
NODE_24281_length_607_cov_61.316929	534	607	4	28	73	0.3835616
NODE_24282_length_607_cov_16.852362	383	463	0	80	80	1.0000000
NODE_24282_length_607_cov_16.852362	436	516	0	80	80	1.0000000
NODE_24283_length_607_cov_12.889764	67	147	0	80	80	1.0000000
NODE_24283_length_607_cov_12.889764	120	200	0	80	80	1.0000000
NODE_24284_length_607_cov_11.023622	122	202	0	80	80	1.0000000
NODE_24284_length_607_cov_11.023622	175	255	0	80	80	1.0000000
NODE_24285_length_607_cov_10.690945	199	279	0	80	80	1.0000000
NODE_24285_length_607_cov_10.690945	252	332	0	80	80	1.0000000
NODE_24290_length_607_cov_5.818898	301	386	0	85	85	1.0000000
NODE_24291_length_607_cov_5.771654	278	358	0	6	80	0.0750000
NODE_24291_length_607_cov_5.771654	278	358	1	38	80	0.4750000
NODE_24291_length_607_cov_5.771654	278	358	4	2	80	0.0250000
NODE_24291_length_607_cov_5.771654	278	358	5	34	80	0.4250000
NODE_24291_length_607_cov_5.771654	331	411	5	28	80	0.3500000
NODE_24291_length_607_cov_5.771654	331	411	6	52	80	0.6500000
NODE_24295_length_607_cov_4.816929	282	362	0	80	80	1.0000000
NODE_24295_length_607_cov_4.816929	335	415	0	80	80	1.0000000
NODE_24300_length_607_cov_4.015748	295	354	0	59	59	1.0000000
NODE_24310_length_607_cov_3.088583	107	158	0	51	51	1.0000000
NODE_24331_length_607_cov_1.791339	204	247	4	43	43	1.0000000
NODE_24400_length_606_cov_42.264300	182	262	0	80	80	1.0000000
NODE_24400_length_606_cov_42.264300	235	315	0	32	80	0.4000000
NODE_24400_length_606_cov_42.264300	235	315	4	48	80	0.6000000
NODE_24402_length_606_cov_26.341223	371	451	0	80	80	1.0000000
NODE_24402_length_606_cov_26.341223	424	504	0	80	80	1.0000000
NODE_24403_length_606_cov_14.895464	308	388	0	80	80	1.0000000
NODE_24403_length_606_cov_14.895464	361	441	0	80	80	1.0000000
NODE_24406_length_606_cov_7.934911	412	492	0	80	80	1.0000000
NODE_24406_length_606_cov_7.934911	465	545	0	59	80	0.7375000
NODE_24406_length_606_cov_7.934911	465	545	2	21	80	0.2625000
NODE_24407_length_606_cov_7.481262	250	330	0	54	80	0.6750000
NODE_24407_length_606_cov_7.481262	250	330	5	6	80	0.0750000
NODE_24407_length_606_cov_7.481262	250	330	11	20	80	0.2500000
NODE_24407_length_606_cov_7.481262	303	383	0	1	80	0.0125000
NODE_24407_length_606_cov_7.481262	303	383	5	6	80	0.0750000
NODE_24407_length_606_cov_7.481262	303	383	11	32	80	0.4000000
NODE_24407_length_606_cov_7.481262	303	383	15	2	80	0.0250000
NODE_24407_length_606_cov_7.481262	303	383	16	11	80	0.1375000
NODE_24407_length_606_cov_7.481262	303	383	18	2	80	0.0250000
NODE_24407_length_606_cov_7.481262	303	383	20	22	80	0.2750000
NODE_24407_length_606_cov_7.481262	303	383	21	3	80	0.0375000
NODE_24407_length_606_cov_7.481262	303	383	23	1	80	0.0125000
NODE_24409_length_606_cov_6.842209	139	219	0	80	80	1.0000000
NODE_24409_length_606_cov_6.842209	192	272	0	80	80	1.0000000
NODE_24428_length_606_cov_3.384615	156	206	0	50	50	1.0000000
NODE_24433_length_606_cov_2.670611	113	193	2	20	80	0.2500000
NODE_24433_length_606_cov_2.670611	113	193	4	11	80	0.1375000
NODE_24433_length_606_cov_2.670611	113	193	5	12	80	0.1500000
NODE_24433_length_606_cov_2.670611	113	193	6	37	80	0.4625000
NODE_24525_length_605_cov_63.343874	7	83	0	30	76	0.3947369
NODE_24525_length_605_cov_63.343874	7	83	4	46	76	0.6052632
NODE_24525_length_605_cov_63.343874	12	83	0	25	71	0.3521127
NODE_24525_length_605_cov_63.343874	12	83	4	46	71	0.6478873
NODE_24525_length_605_cov_63.343874	17	83	0	20	66	0.3030303
NODE_24525_length_605_cov_63.343874	17	83	4	46	66	0.6969697
NODE_24525_length_605_cov_63.343874	56	136	4	78	80	0.9750000
NODE_24525_length_605_cov_63.343874	56	136	6	2	80	0.0250000
NODE_24525_length_605_cov_63.343874	56	136	4	78	80	0.9750000
NODE_24525_length_605_cov_63.343874	56	136	6	2	80	0.0250000
NODE_24525_length_605_cov_63.343874	56	136	4	78	80	0.9750000
NODE_24525_length_605_cov_63.343874	56	136	6	2	80	0.0250000
NODE_24525_length_605_cov_63.343874	132	212	2	70	80	0.8750000
NODE_24525_length_605_cov_63.343874	132	212	4	2	80	0.0250000
NODE_24525_length_605_cov_63.343874	132	212	6	8	80	0.1000000
NODE_24525_length_605_cov_63.343874	132	212	2	70	80	0.8750000
NODE_24525_length_605_cov_63.343874	132	212	4	2	80	0.0250000
NODE_24525_length_605_cov_63.343874	132	212	6	8	80	0.1000000
NODE_24525_length_605_cov_63.343874	132	210	2	68	78	0.8717949
NODE_24525_length_605_cov_63.343874	132	210	4	2	78	0.0256410
NODE_24525_length_605_cov_63.343874	132	210	6	8	78	0.1025641
NODE_24525_length_605_cov_63.343874	132	212	2	70	80	0.8750000
NODE_24525_length_605_cov_63.343874	132	212	4	2	80	0.0250000
NODE_24525_length_605_cov_63.343874	132	212	6	8	80	0.1000000
NODE_24525_length_605_cov_63.343874	132	212	2	70	80	0.8750000
NODE_24525_length_605_cov_63.343874	132	212	4	2	80	0.0250000
NODE_24525_length_605_cov_63.343874	132	212	6	8	80	0.1000000
NODE_24525_length_605_cov_63.343874	185	265	2	80	80	1.0000000
NODE_24526_length_605_cov_48.191700	298	374	0	76	76	1.0000000
NODE_24526_length_605_cov_48.191700	347	427	0	80	80	1.0000000
NODE_24528_length_605_cov_33.328063	57	137	146	1	80	0.0125000
NODE_24528_length_605_cov_33.328063	57	137	148	1	80	0.0125000
NODE_24528_length_605_cov_33.328063	57	137	151	1	80	0.0125000
NODE_24528_length_605_cov_33.328063	57	137	158	1	80	0.0125000
NODE_24528_length_605_cov_33.328063	57	137	162	1	80	0.0125000
NODE_24528_length_605_cov_33.328063	57	137	166	3	80	0.0375000
NODE_24528_length_605_cov_33.328063	57	137	168	2	80	0.0250000
NODE_24528_length_605_cov_33.328063	57	137	174	4	80	0.0500000
NODE_24528_length_605_cov_33.328063	57	137	177	1	80	0.0125000
NODE_24528_length_605_cov_33.328063	57	137	179	1	80	0.0125000
NODE_24528_length_605_cov_33.328063	57	137	188	1	80	0.0125000
NODE_24528_length_605_cov_33.328063	57	137	190	2	80	0.0250000
NODE_24528_length_605_cov_33.328063	57	137	192	3	80	0.0375000
NODE_24528_length_605_cov_33.328063	57	137	193	1	80	0.0125000
NODE_24528_length_605_cov_33.328063	57	137	201	1	80	0.0125000
NODE_24528_length_605_cov_33.328063	57	137	205	1	80	0.0125000
NODE_24528_length_605_cov_33.328063	57	137	207	3	80	0.0375000
NODE_24528_length_605_cov_33.328063	57	137	215	1	80	0.0125000
NODE_24528_length_605_cov_33.328063	57	137	218	2	80	0.0250000
NODE_24528_length_605_cov_33.328063	57	137	221	1	80	0.0125000
NODE_24528_length_605_cov_33.328063	57	137	226	1	80	0.0125000
NODE_24528_length_605_cov_33.328063	57	137	234	1	80	0.0125000
NODE_24528_length_605_cov_33.328063	57	137	236	1	80	0.0125000
NODE_24528_length_605_cov_33.328063	57	137	238	1	80	0.0125000
NODE_24528_length_605_cov_33.328063	57	137	239	1	80	0.0125000
NODE_24528_length_605_cov_33.328063	57	137	240	1	80	0.0125000
NODE_24528_length_605_cov_33.328063	57	137	241	2	80	0.0250000
NODE_24528_length_605_cov_33.328063	57	137	242	7	80	0.0875000
NODE_24528_length_605_cov_33.328063	57	137	243	2	80	0.0250000
NODE_24528_length_605_cov_33.328063	57	137	245	1	80	0.0125000
NODE_24528_length_605_cov_33.328063	57	137	246	1	80	0.0125000
NODE_24528_length_605_cov_33.328063	57	137	249	2	80	0.0250000
NODE_24528_length_605_cov_33.328063	57	137	260	1	80	0.0125000
NODE_24528_length_605_cov_33.328063	57	137	268	1	80	0.0125000
NODE_24528_length_605_cov_33.328063	57	137	269	1	80	0.0125000
NODE_24528_length_605_cov_33.328063	57	137	270	4	80	0.0500000
NODE_24528_length_605_cov_33.328063	57	137	272	1	80	0.0125000
NODE_24528_length_605_cov_33.328063	57	137	273	1	80	0.0125000
NODE_24528_length_605_cov_33.328063	57	137	274	1	80	0.0125000
NODE_24528_length_605_cov_33.328063	57	137	276	4	80	0.0500000
NODE_24528_length_605_cov_33.328063	57	137	277	4	80	0.0500000
NODE_24528_length_605_cov_33.328063	57	137	280	3	80	0.0375000
NODE_24528_length_605_cov_33.328063	57	137	281	2	80	0.0250000
NODE_24528_length_605_cov_33.328063	57	137	282	1	80	0.0125000
NODE_24528_length_605_cov_33.328063	57	137	283	3	80	0.0375000
NODE_24528_length_605_cov_33.328063	140	175	281	2	35	0.0571429
NODE_24528_length_605_cov_33.328063	140	175	282	1	35	0.0285714
NODE_24528_length_605_cov_33.328063	140	175	283	1	35	0.0285714
NODE_24528_length_605_cov_33.328063	140	175	284	1	35	0.0285714
NODE_24528_length_605_cov_33.328063	140	175	285	1	35	0.0285714
NODE_24528_length_605_cov_33.328063	140	175	287	2	35	0.0571429
NODE_24528_length_605_cov_33.328063	140	175	290	1	35	0.0285714
NODE_24528_length_605_cov_33.328063	140	175	294	1	35	0.0285714
NODE_24528_length_605_cov_33.328063	140	175	295	2	35	0.0571429
NODE_24528_length_605_cov_33.328063	140	175	296	1	35	0.0285714
NODE_24528_length_605_cov_33.328063	140	175	297	1	35	0.0285714
NODE_24528_length_605_cov_33.328063	140	175	304	1	35	0.0285714
NODE_24528_length_605_cov_33.328063	140	175	310	1	35	0.0285714
NODE_24528_length_605_cov_33.328063	140	175	322	1	35	0.0285714
NODE_24528_length_605_cov_33.328063	140	175	324	1	35	0.0285714
NODE_24528_length_605_cov_33.328063	140	175	331	1	35	0.0285714
NODE_24528_length_605_cov_33.328063	140	175	336	1	35	0.0285714
NODE_24528_length_605_cov_33.328063	140	175	338	2	35	0.0571429
NODE_24528_length_605_cov_33.328063	140	175	339	1	35	0.0285714
NODE_24528_length_605_cov_33.328063	140	175	340	1	35	0.0285714
NODE_24528_length_605_cov_33.328063	140	175	341	1	35	0.0285714
NODE_24528_length_605_cov_33.328063	140	175	347	1	35	0.0285714
NODE_24528_length_605_cov_33.328063	140	175	351	1	35	0.0285714
NODE_24528_length_605_cov_33.328063	140	175	353	1	35	0.0285714
NODE_24528_length_605_cov_33.328063	140	175	354	1	35	0.0285714
NODE_24528_length_605_cov_33.328063	140	175	355	2	35	0.0571429
NODE_24528_length_605_cov_33.328063	140	175	358	1	35	0.0285714
NODE_24528_length_605_cov_33.328063	140	175	361	1	35	0.0285714
NODE_24528_length_605_cov_33.328063	140	175	363	1	35	0.0285714
NODE_24528_length_605_cov_33.328063	140	175	364	1	35	0.0285714
NODE_24529_length_605_cov_26.717391	353	433	0	80	80	1.0000000
NODE_24529_length_605_cov_26.717391	406	486	0	80	80	1.0000000
NODE_24530_length_605_cov_17.677866	215	295	0	80	80	1.0000000
NODE_24530_length_605_cov_17.677866	268	348	0	80	80	1.0000000
NODE_24531_length_605_cov_15.225296	144	224	0	80	80	1.0000000
NODE_24531_length_605_cov_15.225296	197	277	0	80	80	1.0000000
NODE_24532_length_605_cov_14.990119	136	216	0	80	80	1.0000000
NODE_24532_length_605_cov_14.990119	189	269	0	80	80	1.0000000
NODE_24533_length_605_cov_10.835968	103	183	0	80	80	1.0000000
NODE_24533_length_605_cov_10.835968	156	236	0	80	80	1.0000000
NODE_24534_length_605_cov_9.169960	306	377	0	71	71	1.0000000
NODE_24534_length_605_cov_9.169960	359	432	0	73	73	1.0000000
NODE_24546_length_605_cov_4.308300	159	239	0	80	80	1.0000000
NODE_24546_length_605_cov_4.308300	271	338	8	14	67	0.2089552
NODE_24546_length_605_cov_4.308300	271	338	10	53	67	0.7910448
NODE_24546_length_605_cov_4.308300	275	350	6	11	75	0.1466667
NODE_24546_length_605_cov_4.308300	275	350	8	10	75	0.1333333
NODE_24546_length_605_cov_4.308300	275	350	10	54	75	0.7200000
NODE_24546_length_605_cov_4.308300	315	372	2	8	57	0.1403509
NODE_24546_length_605_cov_4.308300	315	372	6	25	57	0.4385965
NODE_24546_length_605_cov_4.308300	315	372	10	24	57	0.4210526
NODE_24546_length_605_cov_4.308300	328	373	2	9	45	0.2000000
NODE_24546_length_605_cov_4.308300	328	373	6	25	45	0.5555556
NODE_24546_length_605_cov_4.308300	328	373	10	11	45	0.2444444
NODE_24558_length_605_cov_3.120553	216	287	0	71	71	1.0000000
NODE_24561_length_605_cov_2.909091	408	487	0	12	79	0.1518987
NODE_24561_length_605_cov_2.909091	408	487	2	67	79	0.8481013
NODE_24577_length_605_cov_1.897233	230	273	0	43	43	1.0000000
NODE_24603_length_605_cov_1.339921	168	210	0	42	42	1.0000000
NODE_24636_length_604_cov_30.411881	93	173	0	80	80	1.0000000
NODE_24636_length_604_cov_30.411881	146	226	0	80	80	1.0000000
NODE_24637_length_604_cov_20.099010	414	494	0	80	80	1.0000000
NODE_24637_length_604_cov_20.099010	467	547	0	80	80	1.0000000
NODE_24639_length_604_cov_10.291089	184	264	0	6	80	0.0750000
NODE_24639_length_604_cov_10.291089	184	264	2	74	80	0.9250000
NODE_24639_length_604_cov_10.291089	237	317	0	59	80	0.7375000
NODE_24639_length_604_cov_10.291089	237	317	2	21	80	0.2625000
NODE_24646_length_604_cov_6.033663	265	345	6	15	80	0.1875000
NODE_24646_length_604_cov_6.033663	265	345	8	17	80	0.2125000
NODE_24646_length_604_cov_6.033663	265	345	10	5	80	0.0625000
NODE_24646_length_604_cov_6.033663	265	345	12	43	80	0.5375000
NODE_24646_length_604_cov_6.033663	318	397	8	5	79	0.0632911
NODE_24646_length_604_cov_6.033663	318	397	10	9	79	0.1139240
NODE_24646_length_604_cov_6.033663	318	397	12	65	79	0.8227848
NODE_24654_length_604_cov_4.316832	40	106	0	46	66	0.6969697
NODE_24654_length_604_cov_4.316832	40	106	2	20	66	0.3030303
NODE_24654_length_604_cov_4.316832	377	435	0	18	58	0.3103448
NODE_24654_length_604_cov_4.316832	377	435	2	40	58	0.6896552
NODE_24692_length_604_cov_1.805941	299	380	0	81	81	1.0000000
NODE_24692_length_604_cov_1.805941	353	433	0	80	80	1.0000000
NODE_24732_length_603_cov_18.761905	108	188	0	80	80	1.0000000
NODE_24732_length_603_cov_18.761905	161	241	0	80	80	1.0000000
NODE_24734_length_603_cov_8.996032	163	243	0	80	80	1.0000000
NODE_24734_length_603_cov_8.996032	216	296	0	80	80	1.0000000
NODE_24735_length_603_cov_8.970238	413	493	0	80	80	1.0000000
NODE_24736_length_603_cov_7.212302	324	404	0	80	80	1.0000000
NODE_24736_length_603_cov_7.212302	377	457	0	80	80	1.0000000
NODE_24739_length_603_cov_5.831349	351	385	0	34	34	1.0000000
NODE_24744_length_603_cov_4.744048	103	183	0	80	80	1.0000000
NODE_24744_length_603_cov_4.744048	156	236	0	80	80	1.0000000
NODE_24748_length_603_cov_4.115079	219	259	0	40	40	1.0000000
NODE_24755_length_603_cov_3.269841	186	223	0	37	37	1.0000000
NODE_24755_length_603_cov_3.269841	196	276	0	80	80	1.0000000
NODE_24755_length_603_cov_3.269841	367	441	0	74	74	1.0000000
NODE_24843_length_602_cov_33.208748	106	186	0	80	80	1.0000000
NODE_24843_length_602_cov_33.208748	159	239	0	80	80	1.0000000
NODE_24844_length_602_cov_28.922465	319	399	0	80	80	1.0000000
NODE_24844_length_602_cov_28.922465	372	452	0	80	80	1.0000000
NODE_24846_length_602_cov_10.930417	248	328	0	80	80	1.0000000
NODE_24846_length_602_cov_10.930417	301	381	0	80	80	1.0000000
NODE_24847_length_602_cov_10.447316	148	207	2	39	59	0.6610169
NODE_24847_length_602_cov_10.447316	148	207	6	20	59	0.3389831
NODE_24847_length_602_cov_10.447316	181	207	2	6	26	0.2307692
NODE_24847_length_602_cov_10.447316	181	207	6	20	26	0.7692308
NODE_24847_length_602_cov_10.447316	259	291	4	2	32	0.0625000
NODE_24847_length_602_cov_10.447316	259	291	6	30	32	0.9375000
NODE_24851_length_602_cov_7.787276	544	565	0	21	21	1.0000000
NODE_24875_length_602_cov_3.332008	157	239	7	12	82	0.1463415
NODE_24875_length_602_cov_3.332008	157	239	10	31	82	0.3780488
NODE_24875_length_602_cov_3.332008	157	239	12	24	82	0.2926829
NODE_24875_length_602_cov_3.332008	157	239	13	11	82	0.1341463
NODE_24875_length_602_cov_3.332008	157	239	14	4	82	0.0487805
NODE_24957_length_601_cov_14.952191	183	263	0	80	80	1.0000000
NODE_24957_length_601_cov_14.952191	236	316	0	80	80	1.0000000
NODE_24958_length_601_cov_14.747012	324	404	0	50	80	0.6250000
NODE_24958_length_601_cov_14.747012	324	404	4	30	80	0.3750000
NODE_24958_length_601_cov_14.747012	377	457	4	80	80	1.0000000
NODE_24959_length_601_cov_11.561753	226	306	0	80	80	1.0000000
NODE_24959_length_601_cov_11.561753	279	359	0	80	80	1.0000000
NODE_24960_length_601_cov_10.826693	320	388	0	68	68	1.0000000
NODE_24961_length_601_cov_10.392430	243	323	0	80	80	1.0000000
NODE_24961_length_601_cov_10.392430	296	375	0	79	79	1.0000000
NODE_24965_length_601_cov_7.037849	236	316	0	43	80	0.5375000
NODE_24965_length_601_cov_7.037849	236	316	2	37	80	0.4625000
NODE_24965_length_601_cov_7.037849	289	369	2	80	80	1.0000000
NODE_24969_length_601_cov_5.798805	290	361	4	6	71	0.0845070
NODE_24969_length_601_cov_5.798805	290	361	8	32	71	0.4507042
NODE_24969_length_601_cov_5.798805	290	361	10	21	71	0.2957746
NODE_24969_length_601_cov_5.798805	290	361	11	9	71	0.1267606
NODE_24969_length_601_cov_5.798805	290	361	14	3	71	0.0422535
NODE_24970_length_601_cov_5.657371	228	308	0	80	80	1.0000000
NODE_24973_length_601_cov_5.039841	395	462	0	67	67	1.0000000
NODE_24975_length_601_cov_4.735060	184	247	0	63	63	1.0000000
NODE_24995_length_601_cov_2.599602	371	430	0	59	59	1.0000000
NODE_24995_length_601_cov_2.599602	441	494	0	53	53	1.0000000
NODE_25090_length_600_cov_6.341317	125	147	0	22	22	1.0000000
NODE_25103_length_600_cov_3.754491	142	222	6	20	80	0.2500000
NODE_25103_length_600_cov_3.754491	142	222	7	8	80	0.1000000
NODE_25103_length_600_cov_3.754491	142	222	9	52	80	0.6500000
NODE_25126_length_600_cov_2.081836	282	328	0	26	46	0.5652174
NODE_25126_length_600_cov_2.081836	282	328	2	20	46	0.4347826
NODE_25141_length_600_cov_1.728543	381	423	0	42	42	1.0000000
NODE_25190_length_599_cov_36.488000	25	105	22	4	80	0.0500000
NODE_25190_length_599_cov_36.488000	25	105	24	2	80	0.0250000
NODE_25190_length_599_cov_36.488000	25	105	26	1	80	0.0125000
NODE_25190_length_599_cov_36.488000	25	105	28	1	80	0.0125000
NODE_25190_length_599_cov_36.488000	25	105	30	1	80	0.0125000
NODE_25190_length_599_cov_36.488000	25	105	32	2	80	0.0250000
NODE_25190_length_599_cov_36.488000	25	105	34	1	80	0.0125000
NODE_25190_length_599_cov_36.488000	25	105	36	14	80	0.1750000
NODE_25190_length_599_cov_36.488000	25	105	38	54	80	0.6750000
NODE_25191_length_599_cov_27.870000	255	335	0	80	80	1.0000000
NODE_25191_length_599_cov_27.870000	308	388	0	80	80	1.0000000
NODE_25192_length_599_cov_22.640000	229	309	0	4	80	0.0500000
NODE_25192_length_599_cov_22.640000	229	309	2	76	80	0.9500000
NODE_25192_length_599_cov_22.640000	229	309	0	4	80	0.0500000
NODE_25192_length_599_cov_22.640000	229	309	2	76	80	0.9500000
NODE_25192_length_599_cov_22.640000	229	309	0	4	80	0.0500000
NODE_25192_length_599_cov_22.640000	229	309	2	76	80	0.9500000
NODE_25192_length_599_cov_22.640000	229	309	0	4	80	0.0500000
NODE_25192_length_599_cov_22.640000	229	309	2	76	80	0.9500000
NODE_25192_length_599_cov_22.640000	229	309	0	4	80	0.0500000
NODE_25192_length_599_cov_22.640000	229	309	2	76	80	0.9500000
NODE_25192_length_599_cov_22.640000	282	362	0	57	80	0.7125000
NODE_25192_length_599_cov_22.640000	282	362	2	23	80	0.2875000
NODE_25192_length_599_cov_22.640000	282	362	0	57	80	0.7125000
NODE_25192_length_599_cov_22.640000	282	362	2	23	80	0.2875000
NODE_25192_length_599_cov_22.640000	282	353	0	48	71	0.6760563
NODE_25192_length_599_cov_22.640000	282	353	2	23	71	0.3239437
NODE_25192_length_599_cov_22.640000	285	355	0	50	70	0.7142857
NODE_25192_length_599_cov_22.640000	285	355	2	20	70	0.2857143
NODE_25192_length_599_cov_22.640000	287	362	0	57	75	0.7600000
NODE_25192_length_599_cov_22.640000	287	362	2	18	75	0.2400000
NODE_25193_length_599_cov_14.618000	279	359	0	51	80	0.6375000
NODE_25193_length_599_cov_14.618000	279	359	2	29	80	0.3625000
NODE_25193_length_599_cov_14.618000	332	412	0	80	80	1.0000000
NODE_25195_length_599_cov_10.308000	245	325	0	80	80	1.0000000
NODE_25195_length_599_cov_10.308000	298	378	0	80	80	1.0000000
NODE_25196_length_599_cov_9.224000	160	240	0	80	80	1.0000000
NODE_25196_length_599_cov_9.224000	213	297	0	70	84	0.8333333
NODE_25196_length_599_cov_9.224000	213	297	2	14	84	0.1666667
NODE_25201_length_599_cov_5.536000	58	112	0	54	54	1.0000000
NODE_25208_length_599_cov_3.810000	271	334	0	63	63	1.0000000
NODE_25208_length_599_cov_3.810000	324	390	0	66	66	1.0000000
NODE_25211_length_599_cov_3.598000	238	318	0	80	80	1.0000000
NODE_25211_length_599_cov_3.598000	291	371	0	80	80	1.0000000
NODE_25308_length_598_cov_54.450902	264	344	0	80	80	1.0000000
NODE_25308_length_598_cov_54.450902	317	397	0	80	80	1.0000000
NODE_25309_length_598_cov_8.326653	204	284	0	80	80	1.0000000
NODE_25309_length_598_cov_8.326653	257	337	0	80	80	1.0000000
NODE_25316_length_598_cov_5.623246	169	240	2	56	71	0.7887324
NODE_25316_length_598_cov_5.623246	169	240	4	15	71	0.2112676
NODE_25320_length_598_cov_4.929860	73	153	0	80	80	1.0000000
NODE_25320_length_598_cov_4.929860	126	206	0	80	80	1.0000000
NODE_25421_length_597_cov_15.142570	197	277	0	16	80	0.2000000
NODE_25421_length_597_cov_15.142570	197	277	2	64	80	0.8000000
NODE_25421_length_597_cov_15.142570	250	330	2	80	80	1.0000000
NODE_25422_length_597_cov_12.387550	118	198	0	80	80	1.0000000
NODE_25422_length_597_cov_12.387550	171	251	0	80	80	1.0000000
NODE_25423_length_597_cov_7.016064	213	293	0	80	80	1.0000000
NODE_25423_length_597_cov_7.016064	266	346	0	80	80	1.0000000
NODE_25426_length_597_cov_6.212851	374	449	0	75	75	1.0000000
NODE_25434_length_597_cov_4.273092	368	448	0	80	80	1.0000000
NODE_25434_length_597_cov_4.273092	421	507	0	86	86	1.0000000
NODE_25464_length_597_cov_2.162651	92	172	0	80	80	1.0000000
NODE_25464_length_597_cov_2.162651	145	225	0	80	80	1.0000000
NODE_25467_length_597_cov_2.096386	440	509	0	69	69	1.0000000
NODE_25469_length_597_cov_1.977912	392	472	0	7	80	0.0875000
NODE_25469_length_597_cov_1.977912	392	472	2	73	80	0.9125000
NODE_25469_length_597_cov_1.977912	437	494	2	51	57	0.8947368
NODE_25469_length_597_cov_1.977912	437	494	4	6	57	0.1052632
NODE_25469_length_597_cov_1.977912	445	525	2	71	80	0.8875000
NODE_25469_length_597_cov_1.977912	445	525	4	9	80	0.1125000
NODE_25552_length_596_cov_32.293763	221	301	0	80	80	1.0000000
NODE_25552_length_596_cov_32.293763	274	354	0	80	80	1.0000000
NODE_25552_length_596_cov_32.293763	351	406	0	55	55	1.0000000
NODE_25552_length_596_cov_32.293763	381	459	0	78	78	1.0000000
NODE_25553_length_596_cov_26.891348	199	279	0	80	80	1.0000000
NODE_25553_length_596_cov_26.891348	252	332	0	80	80	1.0000000
NODE_25554_length_596_cov_17.082495	179	259	0	80	80	1.0000000
NODE_25554_length_596_cov_17.082495	232	312	0	80	80	1.0000000
NODE_25555_length_596_cov_10.372233	354	434	0	80	80	1.0000000
NODE_25555_length_596_cov_10.372233	407	487	0	80	80	1.0000000
NODE_25557_length_596_cov_6.955734	142	222	0	80	80	1.0000000
NODE_25558_length_596_cov_6.225352	242	322	0	18	80	0.2250000
NODE_25558_length_596_cov_6.225352	242	322	2	62	80	0.7750000
NODE_25558_length_596_cov_6.225352	308	375	0	32	67	0.4776119
NODE_25558_length_596_cov_6.225352	308	375	2	35	67	0.5223880
NODE_25567_length_596_cov_4.197183	369	444	0	13	75	0.1733333
NODE_25567_length_596_cov_4.197183	369	444	2	46	75	0.6133333
NODE_25567_length_596_cov_4.197183	369	444	4	16	75	0.2133333
NODE_25593_length_596_cov_2.066398	534	583	0	49	49	1.0000000
NODE_25666_length_595_cov_52.532258	248	328	0	80	80	1.0000000
NODE_25666_length_595_cov_52.532258	301	381	0	80	80	1.0000000
NODE_25667_length_595_cov_38.584677	122	202	0	80	80	1.0000000
NODE_25667_length_595_cov_38.584677	175	255	0	80	80	1.0000000
NODE_25669_length_595_cov_10.576613	323	403	0	80	80	1.0000000
NODE_25669_length_595_cov_10.576613	376	456	0	80	80	1.0000000
NODE_25672_length_595_cov_7.917339	342	415	12	25	73	0.3424658
NODE_25672_length_595_cov_7.917339	342	415	16	11	73	0.1506849
NODE_25672_length_595_cov_7.917339	342	415	19	9	73	0.1232877
NODE_25672_length_595_cov_7.917339	342	415	20	28	73	0.3835616
NODE_25672_length_595_cov_7.917339	388	438	10	1	50	0.0200000
NODE_25672_length_595_cov_7.917339	388	438	13	1	50	0.0200000
NODE_25672_length_595_cov_7.917339	388	438	17	3	50	0.0600000
NODE_25672_length_595_cov_7.917339	388	438	19	27	50	0.5400000
NODE_25672_length_595_cov_7.917339	388	438	20	18	50	0.3600000
NODE_25702_length_595_cov_2.792339	178	258	0	72	80	0.9000000
NODE_25702_length_595_cov_2.792339	178	258	1	8	80	0.1000000
NODE_25702_length_595_cov_2.792339	231	311	0	80	80	1.0000000
NODE_25807_length_594_cov_34.157576	283	363	0	80	80	1.0000000
NODE_25807_length_594_cov_34.157576	336	416	0	80	80	1.0000000
NODE_25811_length_594_cov_8.933333	258	338	0	80	80	1.0000000
NODE_25811_length_594_cov_8.933333	311	389	0	78	78	1.0000000
NODE_25815_length_594_cov_5.759596	82	118	0	36	36	1.0000000
NODE_25815_length_594_cov_5.759596	114	194	0	80	80	1.0000000
NODE_25815_length_594_cov_5.759596	167	242	0	75	75	1.0000000
NODE_25825_length_594_cov_3.913131	275	355	0	5	80	0.0625000
NODE_25825_length_594_cov_3.913131	275	355	2	75	80	0.9375000
NODE_25844_length_594_cov_2.470707	209	247	0	7	38	0.1842105
NODE_25844_length_594_cov_2.470707	209	247	2	11	38	0.2894737
NODE_25844_length_594_cov_2.470707	209	247	3	11	38	0.2894737
NODE_25844_length_594_cov_2.470707	209	247	4	9	38	0.2368421
NODE_25919_length_594_cov_0.698990	33	73	0	40	40	1.0000000
NODE_25928_length_593_cov_124.985830	247	285	9	6	38	0.1578947
NODE_25928_length_593_cov_124.985830	247	285	16	4	38	0.1052632
NODE_25928_length_593_cov_124.985830	247	285	30	3	38	0.0789474
NODE_25928_length_593_cov_124.985830	247	285	34	23	38	0.6052632
NODE_25928_length_593_cov_124.985830	247	285	38	1	38	0.0263158
NODE_25928_length_593_cov_124.985830	247	285	51	1	38	0.0263158
NODE_25929_length_593_cov_36.161943	150	230	0	21	80	0.2625000
NODE_25929_length_593_cov_36.161943	150	230	4	59	80	0.7375000
NODE_25929_length_593_cov_36.161943	203	283	0	74	80	0.9250000
NODE_25929_length_593_cov_36.161943	203	283	4	6	80	0.0750000
NODE_25930_length_593_cov_14.979757	219	299	0	80	80	1.0000000
NODE_25930_length_593_cov_14.979757	272	352	0	80	80	1.0000000
NODE_25931_length_593_cov_11.018219	324	404	0	39	80	0.4875000
NODE_25931_length_593_cov_11.018219	324	404	6	41	80	0.5125000
NODE_25931_length_593_cov_11.018219	377	457	0	9	80	0.1125000
NODE_25931_length_593_cov_11.018219	377	457	6	71	80	0.8875000
NODE_25946_length_593_cov_3.232794	210	273	0	63	63	1.0000000
NODE_25946_length_593_cov_3.232794	263	326	0	63	63	1.0000000
NODE_25996_length_593_cov_1.261134	227	249	0	22	22	1.0000000
NODE_26033_length_592_cov_18.908722	163	243	0	80	80	1.0000000
NODE_26033_length_592_cov_18.908722	230	296	0	66	66	1.0000000
NODE_26034_length_592_cov_7.531440	232	312	0	80	80	1.0000000
NODE_26034_length_592_cov_7.531440	285	361	0	76	76	1.0000000
NODE_26035_length_592_cov_7.000000	77	157	0	80	80	1.0000000
NODE_26035_length_592_cov_7.000000	130	210	0	80	80	1.0000000
NODE_26040_length_592_cov_5.036511	270	349	0	79	79	1.0000000
NODE_26041_length_592_cov_5.024341	205	285	2	80	80	1.0000000
NODE_26041_length_592_cov_5.024341	258	309	2	36	51	0.7058824
NODE_26041_length_592_cov_5.024341	258	309	4	15	51	0.2941177
NODE_26062_length_592_cov_2.866126	61	127	0	66	66	1.0000000
NODE_26069_length_592_cov_2.361055	476	526	0	50	50	1.0000000
NODE_26142_length_591_cov_11.286585	245	325	0	80	80	1.0000000
NODE_26142_length_591_cov_11.286585	298	378	0	80	80	1.0000000
NODE_26143_length_591_cov_9.432927	241	321	0	80	80	1.0000000
NODE_26143_length_591_cov_9.432927	294	374	0	80	80	1.0000000
NODE_26184_length_591_cov_2.365854	396	476	0	80	80	1.0000000
NODE_26184_length_591_cov_2.365854	449	529	0	80	80	1.0000000
NODE_26272_length_590_cov_29.661914	26	106	0	80	80	1.0000000
NODE_26272_length_590_cov_29.661914	79	159	0	80	80	1.0000000
NODE_26272_length_590_cov_29.661914	155	235	0	80	80	1.0000000
NODE_26272_length_590_cov_29.661914	208	288	0	80	80	1.0000000
NODE_26273_length_590_cov_21.360489	178	258	0	80	80	1.0000000
NODE_26273_length_590_cov_21.360489	231	311	0	80	80	1.0000000
NODE_26274_length_590_cov_18.395112	161	241	0	80	80	1.0000000
NODE_26274_length_590_cov_18.395112	214	294	0	80	80	1.0000000
NODE_26275_length_590_cov_17.376782	238	318	0	80	80	1.0000000
NODE_26275_length_590_cov_17.376782	291	371	0	80	80	1.0000000
NODE_26279_length_590_cov_6.205703	262	333	0	71	71	1.0000000
NODE_26283_length_590_cov_5.319756	224	304	0	80	80	1.0000000
NODE_26283_length_590_cov_5.319756	277	357	0	80	80	1.0000000
NODE_26366_length_590_cov_0.971487	0	32	0	29	32	0.9062500
NODE_26366_length_590_cov_0.971487	0	32	2	3	32	0.0937500
NODE_26390_length_589_cov_15.810204	384	464	0	80	80	1.0000000
NODE_26390_length_589_cov_15.810204	437	517	0	80	80	1.0000000
NODE_26391_length_589_cov_13.855102	320	400	0	57	80	0.7125000
NODE_26391_length_589_cov_13.855102	320	400	1	23	80	0.2875000
NODE_26391_length_589_cov_13.855102	373	453	0	4	80	0.0500000
NODE_26391_length_589_cov_13.855102	373	453	1	54	80	0.6750000
NODE_26391_length_589_cov_13.855102	373	453	2	22	80	0.2750000
NODE_26395_length_589_cov_6.297959	186	266	0	80	80	1.0000000
NODE_26395_length_589_cov_6.297959	239	319	0	80	80	1.0000000
NODE_26430_length_589_cov_2.320408	431	511	0	80	80	1.0000000
NODE_26515_length_588_cov_49.936605	264	341	0	77	77	1.0000000
NODE_26515_length_588_cov_49.936605	314	394	0	80	80	1.0000000
NODE_26516_length_588_cov_33.691207	273	353	0	80	80	1.0000000
NODE_26516_length_588_cov_33.691207	326	406	0	65	80	0.8125000
NODE_26516_length_588_cov_33.691207	326	406	3	1	80	0.0125000
NODE_26516_length_588_cov_33.691207	326	406	4	14	80	0.1750000
NODE_26517_length_588_cov_16.564417	245	325	0	80	80	1.0000000
NODE_26517_length_588_cov_16.564417	298	378	0	80	80	1.0000000
NODE_26518_length_588_cov_14.595092	266	346	0	80	80	1.0000000
NODE_26518_length_588_cov_14.595092	319	399	0	80	80	1.0000000
NODE_26522_length_588_cov_7.439673	155	235	0	80	80	1.0000000
NODE_26522_length_588_cov_7.439673	208	288	0	78	80	0.9750000
NODE_26522_length_588_cov_7.439673	208	288	4	2	80	0.0250000
NODE_26523_length_588_cov_7.094070	191	263	0	72	72	1.0000000
NODE_26523_length_588_cov_7.094070	244	310	0	66	66	1.0000000
NODE_26523_length_588_cov_7.094070	439	519	0	80	80	1.0000000
NODE_26523_length_588_cov_7.094070	492	572	0	80	80	1.0000000
NODE_26534_length_588_cov_4.167689	65	122	0	1	57	0.0175439
NODE_26534_length_588_cov_4.167689	65	122	4	16	57	0.2807018
NODE_26534_length_588_cov_4.167689	65	122	8	40	57	0.7017544
NODE_26634_length_587_cov_39.782787	123	203	0	80	80	1.0000000
NODE_26634_length_587_cov_39.782787	176	256	0	80	80	1.0000000
NODE_26634_length_587_cov_39.782787	252	332	0	80	80	1.0000000
NODE_26634_length_587_cov_39.782787	305	385	0	80	80	1.0000000
NODE_26635_length_587_cov_31.807377	141	221	0	80	80	1.0000000
NODE_26635_length_587_cov_31.807377	194	274	0	80	80	1.0000000
NODE_26636_length_587_cov_12.629098	219	299	2	26	80	0.3250000
NODE_26636_length_587_cov_12.629098	219	299	4	4	80	0.0500000
NODE_26636_length_587_cov_12.629098	219	299	8	5	80	0.0625000
NODE_26636_length_587_cov_12.629098	219	299	10	9	80	0.1125000
NODE_26636_length_587_cov_12.629098	219	299	12	36	80	0.4500000
NODE_26636_length_587_cov_12.629098	272	352	0	43	80	0.5375000
NODE_26636_length_587_cov_12.629098	272	352	2	36	80	0.4500000
NODE_26636_length_587_cov_12.629098	272	352	4	1	80	0.0125000
NODE_26639_length_587_cov_9.067623	203	283	0	80	80	1.0000000
NODE_26639_length_587_cov_9.067623	256	336	0	80	80	1.0000000
NODE_26640_length_587_cov_8.411885	253	311	0	6	58	0.1034483
NODE_26640_length_587_cov_8.411885	253	311	11	36	58	0.6206896
NODE_26640_length_587_cov_8.411885	253	311	20	3	58	0.0517241
NODE_26640_length_587_cov_8.411885	253	311	21	13	58	0.2241379
NODE_26656_length_587_cov_3.231557	201	256	2	33	55	0.6000000
NODE_26656_length_587_cov_3.231557	201	256	4	14	55	0.2545455
NODE_26656_length_587_cov_3.231557	201	256	5	8	55	0.1454545
NODE_26665_length_587_cov_2.850410	255	288	2	3	33	0.0909091
NODE_26665_length_587_cov_2.850410	255	288	4	20	33	0.6060606
NODE_26665_length_587_cov_2.850410	255	288	6	10	33	0.3030303
NODE_26749_length_586_cov_37.843943	268	348	0	80	80	1.0000000
NODE_26749_length_586_cov_37.843943	321	401	0	80	80	1.0000000
NODE_26749_length_586_cov_37.843943	397	477	0	80	80	1.0000000
NODE_26749_length_586_cov_37.843943	450	531	0	81	81	1.0000000
NODE_26750_length_586_cov_12.831622	186	266	0	80	80	1.0000000
NODE_26750_length_586_cov_12.831622	239	319	0	80	80	1.0000000
NODE_26752_length_586_cov_11.264887	108	188	0	16	80	0.2000000
NODE_26752_length_586_cov_11.264887	108	188	2	64	80	0.8000000
NODE_26752_length_586_cov_11.264887	161	241	0	38	80	0.4750000
NODE_26752_length_586_cov_11.264887	161	241	2	42	80	0.5250000
NODE_26754_length_586_cov_9.624230	299	360	0	61	61	1.0000000
NODE_26754_length_586_cov_9.624230	299	360	0	61	61	1.0000000
NODE_26754_length_586_cov_9.624230	299	360	0	61	61	1.0000000
NODE_26754_length_586_cov_9.624230	301	360	0	59	59	1.0000000
NODE_26756_length_586_cov_8.591376	273	353	0	8	80	0.1000000
NODE_26756_length_586_cov_8.591376	273	353	2	72	80	0.9000000
NODE_26756_length_586_cov_8.591376	326	406	0	41	80	0.5125000
NODE_26756_length_586_cov_8.591376	326	406	2	39	80	0.4875000
NODE_26758_length_586_cov_6.135524	334	375	0	41	41	1.0000000
NODE_26758_length_586_cov_6.135524	334	375	0	41	41	1.0000000
NODE_26760_length_586_cov_5.634497	150	230	0	80	80	1.0000000
NODE_26760_length_586_cov_5.634497	203	283	0	80	80	1.0000000
NODE_26765_length_586_cov_4.626283	296	362	0	66	66	1.0000000
NODE_26765_length_586_cov_4.626283	453	533	0	80	80	1.0000000
NODE_26885_length_585_cov_112.094650	456	536	48	3	80	0.0375000
NODE_26885_length_585_cov_112.094650	456	536	50	4	80	0.0500000
NODE_26885_length_585_cov_112.094650	456	536	52	3	80	0.0375000
NODE_26885_length_585_cov_112.094650	456	536	54	2	80	0.0250000
NODE_26885_length_585_cov_112.094650	456	536	57	2	80	0.0250000
NODE_26885_length_585_cov_112.094650	456	536	63	2	80	0.0250000
NODE_26885_length_585_cov_112.094650	456	536	74	4	80	0.0500000
NODE_26885_length_585_cov_112.094650	456	536	77	6	80	0.0750000
NODE_26885_length_585_cov_112.094650	456	536	78	2	80	0.0250000
NODE_26885_length_585_cov_112.094650	456	536	80	17	80	0.2125000
NODE_26885_length_585_cov_112.094650	456	536	81	1	80	0.0125000
NODE_26885_length_585_cov_112.094650	456	536	82	1	80	0.0125000
NODE_26885_length_585_cov_112.094650	456	536	83	3	80	0.0375000
NODE_26885_length_585_cov_112.094650	456	536	84	3	80	0.0375000
NODE_26885_length_585_cov_112.094650	456	536	86	17	80	0.2125000
NODE_26885_length_585_cov_112.094650	456	536	87	1	80	0.0125000
NODE_26885_length_585_cov_112.094650	456	536	88	4	80	0.0500000
NODE_26885_length_585_cov_112.094650	456	536	89	4	80	0.0500000
NODE_26885_length_585_cov_112.094650	456	536	90	1	80	0.0125000
NODE_26885_length_585_cov_112.094650	509	585	10	2	76	0.0263158
NODE_26885_length_585_cov_112.094650	509	585	12	1	76	0.0131579
NODE_26885_length_585_cov_112.094650	509	585	14	1	76	0.0131579
NODE_26885_length_585_cov_112.094650	509	585	16	3	76	0.0394737
NODE_26885_length_585_cov_112.094650	509	585	18	1	76	0.0131579
NODE_26885_length_585_cov_112.094650	509	585	26	8	76	0.1052632
NODE_26885_length_585_cov_112.094650	509	585	32	1	76	0.0131579
NODE_26885_length_585_cov_112.094650	509	585	36	6	76	0.0789474
NODE_26885_length_585_cov_112.094650	509	585	38	3	76	0.0394737
NODE_26885_length_585_cov_112.094650	509	585	40	8	76	0.1052632
NODE_26885_length_585_cov_112.094650	509	585	42	3	76	0.0394737
NODE_26885_length_585_cov_112.094650	509	585	46	3	76	0.0394737
NODE_26885_length_585_cov_112.094650	509	585	48	5	76	0.0657895
NODE_26885_length_585_cov_112.094650	509	585	50	1	76	0.0131579
NODE_26885_length_585_cov_112.094650	509	585	74	4	76	0.0526316
NODE_26885_length_585_cov_112.094650	509	585	78	2	76	0.0263158
NODE_26885_length_585_cov_112.094650	509	585	80	16	76	0.2105263
NODE_26885_length_585_cov_112.094650	509	585	86	8	76	0.1052632
NODE_26886_length_585_cov_23.872428	168	248	0	80	80	1.0000000
NODE_26886_length_585_cov_23.872428	222	301	0	79	79	1.0000000
NODE_26887_length_585_cov_18.981481	360	440	0	80	80	1.0000000
NODE_26887_length_585_cov_18.981481	413	493	0	80	80	1.0000000
NODE_26888_length_585_cov_13.967078	323	387	0	64	64	1.0000000
NODE_26889_length_585_cov_10.555556	229	309	0	80	80	1.0000000
NODE_26889_length_585_cov_10.555556	282	362	0	80	80	1.0000000
NODE_26891_length_585_cov_9.216049	233	313	0	80	80	1.0000000
NODE_26891_length_585_cov_9.216049	286	366	0	80	80	1.0000000
NODE_26894_length_585_cov_8.090535	292	372	0	80	80	1.0000000
NODE_26894_length_585_cov_8.090535	345	425	0	80	80	1.0000000
NODE_26895_length_585_cov_8.018519	339	381	0	42	42	1.0000000
NODE_26895_length_585_cov_8.018519	354	419	0	65	65	1.0000000
NODE_26900_length_585_cov_4.954733	147	227	0	13	80	0.1625000
NODE_26900_length_585_cov_4.954733	147	227	1	67	80	0.8375000
NODE_26912_length_585_cov_3.751029	288	368	0	50	80	0.6250000
NODE_26912_length_585_cov_3.751029	288	368	4	25	80	0.3125000
NODE_26912_length_585_cov_3.751029	288	368	6	5	80	0.0625000
NODE_26912_length_585_cov_3.751029	341	421	4	22	80	0.2750000
NODE_26912_length_585_cov_3.751029	341	421	6	58	80	0.7250000
NODE_27019_length_584_cov_21.657732	57	137	0	80	80	1.0000000
NODE_27019_length_584_cov_21.657732	110	190	0	80	80	1.0000000
NODE_27020_length_584_cov_11.915464	280	360	0	80	80	1.0000000
NODE_27020_length_584_cov_11.915464	333	413	0	80	80	1.0000000
NODE_27021_length_584_cov_11.197938	217	297	0	80	80	1.0000000
NODE_27021_length_584_cov_11.197938	270	350	0	80	80	1.0000000
NODE_27022_length_584_cov_9.824742	375	441	0	66	66	1.0000000
NODE_27022_length_584_cov_9.824742	375	441	0	66	66	1.0000000
NODE_27023_length_584_cov_9.160825	369	449	0	80	80	1.0000000
NODE_27023_length_584_cov_9.160825	422	502	0	80	80	1.0000000
NODE_27023_length_584_cov_9.160825	422	502	0	80	80	1.0000000
NODE_27026_length_584_cov_7.736082	51	131	2	80	80	1.0000000
NODE_27026_length_584_cov_7.736082	104	184	0	21	80	0.2625000
NODE_27026_length_584_cov_7.736082	104	184	2	59	80	0.7375000
NODE_27031_length_584_cov_7.113402	213	293	0	80	80	1.0000000
NODE_27031_length_584_cov_7.113402	266	346	0	80	80	1.0000000
NODE_27035_length_584_cov_5.843299	281	341	0	60	60	1.0000000
NODE_27039_length_584_cov_5.032990	240	320	0	13	80	0.1625000
NODE_27039_length_584_cov_5.032990	240	320	2	67	80	0.8375000
NODE_27039_length_584_cov_5.032990	293	373	0	66	80	0.8250000
NODE_27039_length_584_cov_5.032990	293	373	2	14	80	0.1750000
NODE_27061_length_584_cov_2.707216	186	257	0	26	71	0.3661972
NODE_27061_length_584_cov_2.707216	186	257	2	45	71	0.6338028
NODE_27147_length_583_cov_7.973140	232	312	0	80	80	1.0000000
NODE_27147_length_583_cov_7.973140	285	365	0	80	80	1.0000000
NODE_27148_length_583_cov_6.731405	328	408	0	80	80	1.0000000
NODE_27148_length_583_cov_6.731405	381	461	0	80	80	1.0000000
NODE_27149_length_583_cov_6.363636	161	231	0	25	70	0.3571429
NODE_27149_length_583_cov_6.363636	161	231	2	45	70	0.6428571
NODE_27152_length_583_cov_5.766529	132	186	0	54	54	1.0000000
NODE_27263_length_583_cov_0.762397	9	50	0	41	41	1.0000000
NODE_27278_length_582_cov_74.269151	295	375	0	80	80	1.0000000
NODE_27278_length_582_cov_74.269151	348	428	0	30	80	0.3750000
NODE_27278_length_582_cov_74.269151	348	428	2	50	80	0.6250000
NODE_27279_length_582_cov_53.093168	11	91	0	80	80	1.0000000
NODE_27279_length_582_cov_53.093168	64	144	0	80	80	1.0000000
NODE_27279_length_582_cov_53.093168	140	220	0	80	80	1.0000000
NODE_27279_length_582_cov_53.093168	193	273	0	80	80	1.0000000
NODE_27280_length_582_cov_47.393375	345	425	0	78	80	0.9750000
NODE_27280_length_582_cov_47.393375	345	425	2	2	80	0.0250000
NODE_27280_length_582_cov_47.393375	398	478	0	25	80	0.3125000
NODE_27280_length_582_cov_47.393375	398	478	2	55	80	0.6875000
NODE_27281_length_582_cov_16.358178	297	377	0	75	80	0.9375000
NODE_27281_length_582_cov_16.358178	297	377	2	5	80	0.0625000
NODE_27281_length_582_cov_16.358178	350	431	0	81	81	1.0000000
NODE_27282_length_582_cov_14.107660	128	208	0	20	80	0.2500000
NODE_27282_length_582_cov_14.107660	128	208	2	60	80	0.7500000
NODE_27282_length_582_cov_14.107660	181	261	0	73	80	0.9125000
NODE_27282_length_582_cov_14.107660	181	261	2	7	80	0.0875000
NODE_27283_length_582_cov_7.923395	208	287	0	79	79	1.0000000
NODE_27283_length_582_cov_7.923395	262	340	0	78	78	1.0000000
NODE_27284_length_582_cov_7.722567	216	296	0	80	80	1.0000000
NODE_27284_length_582_cov_7.722567	269	349	0	80	80	1.0000000
NODE_27289_length_582_cov_4.956522	294	325	0	31	31	1.0000000
NODE_27295_length_582_cov_4.308489	151	192	12	7	41	0.1707317
NODE_27295_length_582_cov_4.308489	151	192	14	27	41	0.6585366
NODE_27295_length_582_cov_4.308489	151	192	22	2	41	0.0487805
NODE_27295_length_582_cov_4.308489	151	192	23	5	41	0.1219512
NODE_27297_length_582_cov_3.838509	223	299	2	3	76	0.0394737
NODE_27297_length_582_cov_3.838509	223	299	4	73	76	0.9605263
NODE_27297_length_582_cov_3.838509	272	354	0	27	82	0.3292683
NODE_27297_length_582_cov_3.838509	272	354	2	25	82	0.3048781
NODE_27297_length_582_cov_3.838509	272	354	4	30	82	0.3658537
NODE_27350_length_582_cov_1.650104	375	450	0	15	75	0.2000000
NODE_27350_length_582_cov_1.650104	375	450	4	60	75	0.8000000
NODE_27405_length_581_cov_16.890041	244	316	0	72	72	1.0000000
NODE_27413_length_581_cov_6.340249	262	342	0	80	80	1.0000000
NODE_27413_length_581_cov_6.340249	315	395	0	80	80	1.0000000
NODE_27416_length_581_cov_5.827801	122	192	4	20	70	0.2857143
NODE_27416_length_581_cov_5.827801	122	192	6	29	70	0.4142857
NODE_27416_length_581_cov_5.827801	122	192	8	21	70	0.3000000
NODE_27420_length_581_cov_5.072614	392	466	0	74	74	1.0000000
NODE_27420_length_581_cov_5.072614	424	444	0	20	20	1.0000000
NODE_27464_length_581_cov_1.881743	474	538	0	64	64	1.0000000
NODE_27541_length_580_cov_39.353430	358	438	2	1	80	0.0125000
NODE_27541_length_580_cov_39.353430	358	438	3	9	80	0.1125000
NODE_27541_length_580_cov_39.353430	358	438	4	10	80	0.1250000
NODE_27541_length_580_cov_39.353430	358	438	5	6	80	0.0750000
NODE_27541_length_580_cov_39.353430	358	438	6	54	80	0.6750000
NODE_27541_length_580_cov_39.353430	411	491	2	14	80	0.1750000
NODE_27541_length_580_cov_39.353430	411	491	3	15	80	0.1875000
NODE_27541_length_580_cov_39.353430	411	491	5	6	80	0.0750000
NODE_27541_length_580_cov_39.353430	411	491	6	12	80	0.1500000
NODE_27541_length_580_cov_39.353430	411	491	16	17	80	0.2125000
NODE_27541_length_580_cov_39.353430	411	491	24	1	80	0.0125000
NODE_27541_length_580_cov_39.353430	411	491	28	15	80	0.1875000
NODE_27541_length_580_cov_39.353430	487	567	14	8	80	0.1000000
NODE_27541_length_580_cov_39.353430	487	567	21	1	80	0.0125000
NODE_27541_length_580_cov_39.353430	487	567	22	3	80	0.0375000
NODE_27541_length_580_cov_39.353430	487	567	26	53	80	0.6625000
NODE_27541_length_580_cov_39.353430	487	567	28	15	80	0.1875000
NODE_27541_length_580_cov_39.353430	487	567	14	8	80	0.1000000
NODE_27541_length_580_cov_39.353430	487	567	21	1	80	0.0125000
NODE_27541_length_580_cov_39.353430	487	567	22	3	80	0.0375000
NODE_27541_length_580_cov_39.353430	487	567	26	53	80	0.6625000
NODE_27541_length_580_cov_39.353430	487	567	28	15	80	0.1875000
NODE_27541_length_580_cov_39.353430	487	567	14	8	80	0.1000000
NODE_27541_length_580_cov_39.353430	487	567	21	1	80	0.0125000
NODE_27541_length_580_cov_39.353430	487	567	22	3	80	0.0375000
NODE_27541_length_580_cov_39.353430	487	567	26	53	80	0.6625000
NODE_27541_length_580_cov_39.353430	487	567	28	15	80	0.1875000
NODE_27541_length_580_cov_39.353430	487	567	14	8	80	0.1000000
NODE_27541_length_580_cov_39.353430	487	567	21	1	80	0.0125000
NODE_27541_length_580_cov_39.353430	487	567	22	3	80	0.0375000
NODE_27541_length_580_cov_39.353430	487	567	26	53	80	0.6625000
NODE_27541_length_580_cov_39.353430	487	567	28	15	80	0.1875000
NODE_27541_length_580_cov_39.353430	487	567	14	8	80	0.1000000
NODE_27541_length_580_cov_39.353430	487	567	21	1	80	0.0125000
NODE_27541_length_580_cov_39.353430	487	567	22	3	80	0.0375000
NODE_27541_length_580_cov_39.353430	487	567	26	53	80	0.6625000
NODE_27541_length_580_cov_39.353430	487	567	28	15	80	0.1875000
NODE_27541_length_580_cov_39.353430	487	567	14	8	80	0.1000000
NODE_27541_length_580_cov_39.353430	487	567	21	1	80	0.0125000
NODE_27541_length_580_cov_39.353430	487	567	22	3	80	0.0375000
NODE_27541_length_580_cov_39.353430	487	567	26	53	80	0.6625000
NODE_27541_length_580_cov_39.353430	487	567	28	15	80	0.1875000
NODE_27544_length_580_cov_8.925156	198	238	0	40	40	1.0000000
NODE_27544_length_580_cov_8.925156	258	338	0	80	80	1.0000000
NODE_27545_length_580_cov_8.634096	197	277	3	15	80	0.1875000
NODE_27545_length_580_cov_8.634096	197	277	5	65	80	0.8125000
NODE_27545_length_580_cov_8.634096	250	330	1	24	80	0.3000000
NODE_27545_length_580_cov_8.634096	250	330	3	21	80	0.2625000
NODE_27545_length_580_cov_8.634096	250	330	5	35	80	0.4375000
NODE_27551_length_580_cov_6.291060	356	398	0	42	42	1.0000000
NODE_27554_length_580_cov_5.494802	110	190	0	80	80	1.0000000
NODE_27554_length_580_cov_5.494802	163	243	0	80	80	1.0000000
NODE_27559_length_580_cov_4.563410	231	292	4	25	61	0.4098361
NODE_27559_length_580_cov_4.563410	231	292	8	36	61	0.5901639
NODE_27559_length_580_cov_4.563410	322	357	0	35	35	1.0000000
NODE_27590_length_580_cov_2.264033	215	277	0	44	62	0.7096774
NODE_27590_length_580_cov_2.264033	215	277	2	5	62	0.0806452
NODE_27590_length_580_cov_2.264033	215	277	4	13	62	0.2096774
NODE_27597_length_580_cov_2.116424	265	345	0	80	80	1.0000000
NODE_27659_length_579_cov_24.231250	159	239	0	80	80	1.0000000
NODE_27659_length_579_cov_24.231250	212	287	0	75	75	1.0000000
NODE_27660_length_579_cov_12.602083	246	326	0	80	80	1.0000000
NODE_27660_length_579_cov_12.602083	299	377	0	78	78	1.0000000
NODE_27663_length_579_cov_9.195833	254	334	2	23	80	0.2875000
NODE_27663_length_579_cov_9.195833	254	334	3	9	80	0.1125000
NODE_27663_length_579_cov_9.195833	254	334	4	16	80	0.2000000
NODE_27663_length_579_cov_9.195833	254	334	5	1	80	0.0125000
NODE_27663_length_579_cov_9.195833	254	334	7	16	80	0.2000000
NODE_27663_length_579_cov_9.195833	254	334	9	15	80	0.1875000
NODE_27663_length_579_cov_9.195833	307	387	7	16	80	0.2000000
NODE_27663_length_579_cov_9.195833	307	387	8	53	80	0.6625000
NODE_27663_length_579_cov_9.195833	307	387	9	11	80	0.1375000
NODE_27663_length_579_cov_9.195833	383	463	1	11	80	0.1375000
NODE_27663_length_579_cov_9.195833	383	463	2	16	80	0.2000000
NODE_27663_length_579_cov_9.195833	383	463	3	9	80	0.1125000
NODE_27663_length_579_cov_9.195833	383	463	4	17	80	0.2125000
NODE_27663_length_579_cov_9.195833	383	463	8	27	80	0.3375000
NODE_27664_length_579_cov_6.600000	169	249	0	80	80	1.0000000
NODE_27664_length_579_cov_6.600000	222	302	0	80	80	1.0000000
NODE_27667_length_579_cov_5.956250	225	295	6	34	70	0.4857143
NODE_27667_length_579_cov_5.956250	225	295	8	32	70	0.4571429
NODE_27667_length_579_cov_5.956250	225	295	10	4	70	0.0571429
NODE_27667_length_579_cov_5.956250	279	316	4	19	37	0.5135135
NODE_27667_length_579_cov_5.956250	279	316	6	18	37	0.4864865
NODE_27674_length_579_cov_4.850000	105	185	0	80	80	1.0000000
NODE_27674_length_579_cov_4.850000	158	238	0	80	80	1.0000000
NODE_27688_length_579_cov_3.291667	290	343	0	53	53	1.0000000
NODE_27695_length_579_cov_2.420833	251	331	0	44	80	0.5500000
NODE_27695_length_579_cov_2.420833	251	331	2	36	80	0.4500000
NODE_27695_length_579_cov_2.420833	304	384	0	80	80	1.0000000
NODE_27724_length_579_cov_1.435417	463	497	0	34	34	1.0000000
NODE_27781_length_578_cov_70.192067	100	180	0	80	80	1.0000000
NODE_27781_length_578_cov_70.192067	153	233	0	80	80	1.0000000
NODE_27782_length_578_cov_51.676409	129	209	0	80	80	1.0000000
NODE_27782_length_578_cov_51.676409	182	262	0	80	80	1.0000000
NODE_27783_length_578_cov_32.152401	310	390	0	80	80	1.0000000
NODE_27783_length_578_cov_32.152401	363	443	0	80	80	1.0000000
NODE_27784_length_578_cov_30.484342	215	295	0	80	80	1.0000000
NODE_27784_length_578_cov_30.484342	268	348	0	80	80	1.0000000
NODE_27785_length_578_cov_15.983299	213	265	0	52	52	1.0000000
NODE_27786_length_578_cov_14.968685	147	227	0	80	80	1.0000000
NODE_27786_length_578_cov_14.968685	200	280	0	80	80	1.0000000
NODE_27787_length_578_cov_9.567850	273	328	0	55	55	1.0000000
NODE_27792_length_578_cov_6.670146	273	353	0	36	80	0.4500000
NODE_27792_length_578_cov_6.670146	273	353	1	44	80	0.5500000
NODE_27792_length_578_cov_6.670146	326	406	1	38	80	0.4750000
NODE_27792_length_578_cov_6.670146	326	406	2	42	80	0.5250000
NODE_27793_length_578_cov_6.465553	320	400	0	80	80	1.0000000
NODE_27793_length_578_cov_6.465553	373	453	0	80	80	1.0000000
NODE_27863_length_578_cov_1.480167	185	265	0	80	80	1.0000000
NODE_27863_length_578_cov_1.480167	238	318	0	80	80	1.0000000
NODE_27935_length_577_cov_11.638075	312	392	0	80	80	1.0000000
NODE_27942_length_577_cov_4.912134	218	249	4	20	31	0.6451613
NODE_27942_length_577_cov_4.912134	218	249	6	11	31	0.3548387
NODE_27942_length_577_cov_4.912134	301	330	4	29	29	1.0000000
NODE_27961_length_577_cov_2.970711	78	126	14	13	48	0.2708333
NODE_27961_length_577_cov_2.970711	78	126	16	2	48	0.0416667
NODE_27961_length_577_cov_2.970711	78	126	17	4	48	0.0833333
NODE_27961_length_577_cov_2.970711	78	126	18	29	48	0.6041667
NODE_27968_length_577_cov_2.631799	169	253	6	16	84	0.1904762
NODE_27968_length_577_cov_2.631799	169	253	8	10	84	0.1190476
NODE_27968_length_577_cov_2.631799	169	253	10	1	84	0.0119048
NODE_27968_length_577_cov_2.631799	169	253	12	6	84	0.0714286
NODE_27968_length_577_cov_2.631799	169	253	14	6	84	0.0714286
NODE_27968_length_577_cov_2.631799	169	253	15	38	84	0.4523810
NODE_27968_length_577_cov_2.631799	169	253	17	7	84	0.0833333
NODE_27968_length_577_cov_2.631799	226	269	15	20	43	0.4651163
NODE_27968_length_577_cov_2.631799	226	269	16	10	43	0.2325581
NODE_27968_length_577_cov_2.631799	226	269	17	9	43	0.2093023
NODE_27968_length_577_cov_2.631799	226	269	18	4	43	0.0930233
NODE_28003_length_577_cov_1.468619	71	146	0	75	75	1.0000000
NODE_28003_length_577_cov_1.468619	119	199	0	80	80	1.0000000
NODE_28058_length_576_cov_10.903564	194	274	0	80	80	1.0000000
NODE_28059_length_576_cov_9.039832	271	351	0	80	80	1.0000000
NODE_28059_length_576_cov_9.039832	324	404	0	80	80	1.0000000
NODE_28060_length_576_cov_8.490566	338	418	2	23	80	0.2875000
NODE_28060_length_576_cov_8.490566	338	418	3	31	80	0.3875000
NODE_28060_length_576_cov_8.490566	338	418	4	26	80	0.3250000
NODE_28060_length_576_cov_8.490566	391	471	1	43	80	0.5375000
NODE_28060_length_576_cov_8.490566	391	471	2	33	80	0.4125000
NODE_28060_length_576_cov_8.490566	391	471	4	4	80	0.0500000
NODE_28061_length_576_cov_7.002096	157	237	0	80	80	1.0000000
NODE_28061_length_576_cov_7.002096	210	290	0	80	80	1.0000000
NODE_28076_length_576_cov_3.322851	118	183	5	16	65	0.2461538
NODE_28076_length_576_cov_3.322851	118	183	6	22	65	0.3384615
NODE_28076_length_576_cov_3.322851	118	183	7	20	65	0.3076923
NODE_28076_length_576_cov_3.322851	118	183	8	7	65	0.1076923
NODE_28102_length_576_cov_1.964361	148	228	0	80	80	1.0000000
NODE_28102_length_576_cov_1.964361	201	281	0	80	80	1.0000000
NODE_28104_length_576_cov_1.951782	159	239	0	80	80	1.0000000
NODE_28104_length_576_cov_1.951782	212	292	0	80	80	1.0000000
NODE_28116_length_576_cov_1.584906	381	455	2	1	74	0.0135135
NODE_28116_length_576_cov_1.584906	381	455	4	73	74	0.9864865
NODE_28179_length_575_cov_15.319328	319	399	0	80	80	1.0000000
NODE_28179_length_575_cov_15.319328	372	452	0	61	80	0.7625000
NODE_28179_length_575_cov_15.319328	372	452	2	19	80	0.2375000
NODE_28181_length_575_cov_8.254202	286	366	0	80	80	1.0000000
NODE_28181_length_575_cov_8.254202	339	419	0	80	80	1.0000000
NODE_28182_length_575_cov_7.558824	300	380	0	80	80	1.0000000
NODE_28313_length_574_cov_6.282105	185	265	0	65	80	0.8125000
NODE_28313_length_574_cov_6.282105	185	265	1	1	80	0.0125000
NODE_28313_length_574_cov_6.282105	185	265	2	7	80	0.0875000
NODE_28313_length_574_cov_6.282105	185	265	4	7	80	0.0875000
NODE_28313_length_574_cov_6.282105	238	318	0	80	80	1.0000000
NODE_28330_length_574_cov_2.993684	215	234	0	19	19	1.0000000
NODE_28438_length_573_cov_53.668776	393	473	0	80	80	1.0000000
NODE_28438_length_573_cov_53.668776	446	526	0	80	80	1.0000000
NODE_28439_length_573_cov_30.658228	451	531	2	43	80	0.5375000
NODE_28439_length_573_cov_30.658228	451	531	7	37	80	0.4625000
NODE_28440_length_573_cov_30.116034	435	515	43	3	80	0.0375000
NODE_28440_length_573_cov_30.116034	435	515	46	3	80	0.0375000
NODE_28440_length_573_cov_30.116034	435	515	48	3	80	0.0375000
NODE_28440_length_573_cov_30.116034	435	515	50	1	80	0.0125000
NODE_28440_length_573_cov_30.116034	435	515	53	3	80	0.0375000
NODE_28440_length_573_cov_30.116034	435	515	54	2	80	0.0250000
NODE_28440_length_573_cov_30.116034	435	515	55	3	80	0.0375000
NODE_28440_length_573_cov_30.116034	435	515	57	1	80	0.0125000
NODE_28440_length_573_cov_30.116034	435	515	60	4	80	0.0500000
NODE_28440_length_573_cov_30.116034	435	515	61	2	80	0.0250000
NODE_28440_length_573_cov_30.116034	435	515	62	1	80	0.0125000
NODE_28440_length_573_cov_30.116034	435	515	63	6	80	0.0750000
NODE_28440_length_573_cov_30.116034	435	515	69	8	80	0.1000000
NODE_28440_length_573_cov_30.116034	435	515	70	3	80	0.0375000
NODE_28440_length_573_cov_30.116034	435	515	72	5	80	0.0625000
NODE_28440_length_573_cov_30.116034	435	515	73	3	80	0.0375000
NODE_28440_length_573_cov_30.116034	435	515	74	5	80	0.0625000
NODE_28440_length_573_cov_30.116034	435	515	79	1	80	0.0125000
NODE_28440_length_573_cov_30.116034	435	515	80	3	80	0.0375000
NODE_28440_length_573_cov_30.116034	435	515	83	3	80	0.0375000
NODE_28440_length_573_cov_30.116034	435	515	84	3	80	0.0375000
NODE_28440_length_573_cov_30.116034	435	515	87	1	80	0.0125000
NODE_28440_length_573_cov_30.116034	435	515	88	1	80	0.0125000
NODE_28440_length_573_cov_30.116034	435	515	89	1	80	0.0125000
NODE_28440_length_573_cov_30.116034	435	515	90	2	80	0.0250000
NODE_28440_length_573_cov_30.116034	435	515	91	2	80	0.0250000
NODE_28440_length_573_cov_30.116034	435	515	92	3	80	0.0375000
NODE_28440_length_573_cov_30.116034	435	515	95	1	80	0.0125000
NODE_28440_length_573_cov_30.116034	435	515	97	1	80	0.0125000
NODE_28440_length_573_cov_30.116034	435	515	105	1	80	0.0125000
NODE_28440_length_573_cov_30.116034	435	515	116	1	80	0.0125000
NODE_28440_length_573_cov_30.116034	488	568	2	6	80	0.0750000
NODE_28440_length_573_cov_30.116034	488	568	4	2	80	0.0250000
NODE_28440_length_573_cov_30.116034	488	568	8	3	80	0.0375000
NODE_28440_length_573_cov_30.116034	488	568	10	2	80	0.0250000
NODE_28440_length_573_cov_30.116034	488	568	13	1	80	0.0125000
NODE_28440_length_573_cov_30.116034	488	568	16	2	80	0.0250000
NODE_28440_length_573_cov_30.116034	488	568	18	4	80	0.0500000
NODE_28440_length_573_cov_30.116034	488	568	20	4	80	0.0500000
NODE_28440_length_573_cov_30.116034	488	568	22	6	80	0.0750000
NODE_28440_length_573_cov_30.116034	488	568	26	2	80	0.0250000
NODE_28440_length_573_cov_30.116034	488	568	32	4	80	0.0500000
NODE_28440_length_573_cov_30.116034	488	568	34	2	80	0.0250000
NODE_28440_length_573_cov_30.116034	488	568	38	2	80	0.0250000
NODE_28440_length_573_cov_30.116034	488	568	41	5	80	0.0625000
NODE_28440_length_573_cov_30.116034	488	568	42	8	80	0.1000000
NODE_28440_length_573_cov_30.116034	488	568	43	3	80	0.0375000
NODE_28440_length_573_cov_30.116034	488	568	46	3	80	0.0375000
NODE_28440_length_573_cov_30.116034	488	568	48	3	80	0.0375000
NODE_28440_length_573_cov_30.116034	488	568	50	1	80	0.0125000
NODE_28440_length_573_cov_30.116034	488	568	53	3	80	0.0375000
NODE_28440_length_573_cov_30.116034	488	568	54	2	80	0.0250000
NODE_28440_length_573_cov_30.116034	488	568	55	3	80	0.0375000
NODE_28440_length_573_cov_30.116034	488	568	57	1	80	0.0125000
NODE_28440_length_573_cov_30.116034	488	568	60	4	80	0.0500000
NODE_28440_length_573_cov_30.116034	488	568	61	2	80	0.0250000
NODE_28440_length_573_cov_30.116034	488	568	62	1	80	0.0125000
NODE_28440_length_573_cov_30.116034	488	568	63	1	80	0.0125000
NODE_28441_length_573_cov_24.234177	210	290	0	80	80	1.0000000
NODE_28441_length_573_cov_24.234177	263	343	0	80	80	1.0000000
NODE_28442_length_573_cov_13.464135	278	358	0	80	80	1.0000000
NODE_28442_length_573_cov_13.464135	331	411	0	80	80	1.0000000
NODE_28443_length_573_cov_8.761603	124	204	2	7	80	0.0875000
NODE_28443_length_573_cov_8.761603	124	204	3	5	80	0.0625000
NODE_28443_length_573_cov_8.761603	124	204	4	68	80	0.8500000
NODE_28443_length_573_cov_8.761603	177	257	0	46	80	0.5750000
NODE_28443_length_573_cov_8.761603	177	257	2	14	80	0.1750000
NODE_28443_length_573_cov_8.761603	177	257	3	5	80	0.0625000
NODE_28443_length_573_cov_8.761603	177	257	4	15	80	0.1875000
NODE_28456_length_573_cov_3.364979	365	398	36	17	33	0.5151515
NODE_28456_length_573_cov_3.364979	365	398	38	16	33	0.4848485
NODE_28565_length_572_cov_17.530655	312	392	0	80	80	1.0000000
NODE_28565_length_572_cov_17.530655	365	445	0	80	80	1.0000000
NODE_28567_length_572_cov_8.059197	250	321	0	71	71	1.0000000
NODE_28568_length_572_cov_7.873150	134	214	0	80	80	1.0000000
NODE_28568_length_572_cov_7.873150	187	267	0	80	80	1.0000000
NODE_28570_length_572_cov_6.706131	365	445	0	80	80	1.0000000
NODE_28570_length_572_cov_6.706131	418	498	0	80	80	1.0000000
NODE_28573_length_572_cov_5.625793	137	217	0	80	80	1.0000000
NODE_28573_length_572_cov_5.625793	190	270	0	80	80	1.0000000
NODE_28574_length_572_cov_5.617336	331	401	0	70	70	1.0000000
NODE_28578_length_572_cov_4.596195	212	288	0	76	76	1.0000000
NODE_28578_length_572_cov_4.596195	261	341	0	80	80	1.0000000
NODE_28585_length_572_cov_3.843552	210	290	2	25	80	0.3125000
NODE_28585_length_572_cov_3.843552	210	290	4	46	80	0.5750000
NODE_28585_length_572_cov_3.843552	210	290	6	9	80	0.1125000
NODE_28585_length_572_cov_3.843552	263	343	4	80	80	1.0000000
NODE_28621_length_572_cov_2.319239	357	431	2	1	74	0.0135135
NODE_28621_length_572_cov_2.319239	357	431	4	73	74	0.9864865
NODE_28621_length_572_cov_2.319239	410	478	2	27	68	0.3970588
NODE_28621_length_572_cov_2.319239	410	478	4	41	68	0.6029412
NODE_28625_length_572_cov_2.107822	184	254	0	70	70	1.0000000
NODE_28625_length_572_cov_2.107822	415	493	0	78	78	1.0000000
NODE_28631_length_572_cov_1.947146	327	363	0	36	36	1.0000000
NODE_28631_length_572_cov_1.947146	328	354	0	26	26	1.0000000
NODE_28700_length_571_cov_14.262712	237	317	0	80	80	1.0000000
NODE_28700_length_571_cov_14.262712	290	370	0	80	80	1.0000000
NODE_28717_length_571_cov_4.033898	154	234	0	80	80	1.0000000
NODE_28717_length_571_cov_4.033898	207	273	0	66	66	1.0000000
NODE_28809_length_570_cov_28.269639	487	559	28	13	72	0.1805556
NODE_28809_length_570_cov_28.269639	487	559	31	10	72	0.1388889
NODE_28809_length_570_cov_28.269639	487	559	33	2	72	0.0277778
NODE_28809_length_570_cov_28.269639	487	559	56	1	72	0.0138889
NODE_28809_length_570_cov_28.269639	487	559	57	5	72	0.0694444
NODE_28809_length_570_cov_28.269639	487	559	59	2	72	0.0277778
NODE_28809_length_570_cov_28.269639	487	559	61	32	72	0.4444444
NODE_28809_length_570_cov_28.269639	487	559	62	7	72	0.0972222
NODE_28812_length_570_cov_10.161359	167	247	0	80	80	1.0000000
NODE_28812_length_570_cov_10.161359	220	256	0	36	36	1.0000000
NODE_28819_length_570_cov_5.010616	179	216	0	37	37	1.0000000
NODE_28819_length_570_cov_5.010616	189	269	0	80	80	1.0000000
NODE_28828_length_570_cov_3.898089	236	316	0	80	80	1.0000000
NODE_28828_length_570_cov_3.898089	289	369	0	80	80	1.0000000
NODE_28840_length_570_cov_2.938429	202	280	2	27	78	0.3461539
NODE_28840_length_570_cov_2.938429	202	280	4	49	78	0.6282051
NODE_28840_length_570_cov_2.938429	202	280	6	1	78	0.0128205
NODE_28840_length_570_cov_2.938429	202	280	8	1	78	0.0128205
NODE_28840_length_570_cov_2.938429	262	333	0	37	71	0.5211267
NODE_28840_length_570_cov_2.938429	262	333	2	34	71	0.4788733
NODE_28842_length_570_cov_2.891720	204	260	0	56	56	1.0000000
NODE_28950_length_569_cov_20.559574	275	355	4	80	80	1.0000000
NODE_28950_length_569_cov_20.559574	328	408	0	23	80	0.2875000
NODE_28950_length_569_cov_20.559574	328	408	4	57	80	0.7125000
NODE_28951_length_569_cov_15.282979	272	352	0	80	80	1.0000000
NODE_28951_length_569_cov_15.282979	325	405	0	80	80	1.0000000
NODE_28952_length_569_cov_11.023404	280	360	0	80	80	1.0000000
NODE_28952_length_569_cov_11.023404	333	413	0	80	80	1.0000000
NODE_28953_length_569_cov_9.310638	231	277	2	27	46	0.5869565
NODE_28953_length_569_cov_9.310638	231	277	4	19	46	0.4130435
NODE_28956_length_569_cov_6.989362	258	338	0	12	80	0.1500000
NODE_28956_length_569_cov_6.989362	258	338	2	13	80	0.1625000
NODE_28956_length_569_cov_6.989362	258	338	6	55	80	0.6875000
NODE_28956_length_569_cov_6.989362	294	329	0	3	35	0.0857143
NODE_28956_length_569_cov_6.989362	294	329	2	13	35	0.3714286
NODE_28956_length_569_cov_6.989362	294	329	6	19	35	0.5428572
NODE_28956_length_569_cov_6.989362	296	338	0	12	42	0.2857143
NODE_28956_length_569_cov_6.989362	296	338	2	13	42	0.3095238
NODE_28956_length_569_cov_6.989362	296	338	6	17	42	0.4047619
NODE_28957_length_569_cov_6.978723	264	344	0	80	80	1.0000000
NODE_28957_length_569_cov_6.978723	317	397	0	80	80	1.0000000
NODE_28960_length_569_cov_6.434043	228	308	0	80	80	1.0000000
NODE_28973_length_569_cov_3.353191	340	419	0	41	79	0.5189874
NODE_28973_length_569_cov_3.353191	340	419	2	38	79	0.4810127
NODE_28981_length_569_cov_3.027660	277	348	0	71	71	1.0000000
NODE_29072_length_568_cov_59.729211	124	204	0	80	80	1.0000000
NODE_29072_length_568_cov_59.729211	177	257	0	80	80	1.0000000
NODE_29075_length_568_cov_7.763326	215	294	0	79	79	1.0000000
NODE_29075_length_568_cov_7.763326	267	347	0	80	80	1.0000000
NODE_29078_length_568_cov_6.257996	397	471	0	74	74	1.0000000
NODE_29091_length_568_cov_3.748401	170	236	0	66	66	1.0000000
NODE_29091_length_568_cov_3.748401	262	311	0	49	49	1.0000000
NODE_29133_length_568_cov_1.769723	192	233	0	24	41	0.5853658
NODE_29133_length_568_cov_1.769723	192	233	3	17	41	0.4146341
NODE_29160_length_568_cov_1.358209	355	432	0	2	77	0.0259740
NODE_29160_length_568_cov_1.358209	355	432	2	18	77	0.2337662
NODE_29160_length_568_cov_1.358209	355	432	4	19	77	0.2467532
NODE_29160_length_568_cov_1.358209	355	432	8	38	77	0.4935065
NODE_29182_length_568_cov_1.038380	195	275	0	80	80	1.0000000
NODE_29216_length_567_cov_21.155983	347	427	0	80	80	1.0000000
NODE_29216_length_567_cov_21.155983	400	480	0	80	80	1.0000000
NODE_29217_length_567_cov_18.292735	367	447	0	80	80	1.0000000
NODE_29217_length_567_cov_18.292735	420	500	0	80	80	1.0000000
NODE_29218_length_567_cov_17.579060	259	339	0	80	80	1.0000000
NODE_29218_length_567_cov_17.579060	312	392	0	80	80	1.0000000
NODE_29220_length_567_cov_15.457265	276	356	0	80	80	1.0000000
NODE_29220_length_567_cov_15.457265	329	409	0	80	80	1.0000000
NODE_29221_length_567_cov_14.393162	270	350	0	80	80	1.0000000
NODE_29221_length_567_cov_14.393162	323	403	0	43	80	0.5375000
NODE_29221_length_567_cov_14.393162	323	403	2	37	80	0.4625000
NODE_29225_length_567_cov_6.611111	356	436	0	80	80	1.0000000
NODE_29225_length_567_cov_6.611111	409	489	0	80	80	1.0000000
NODE_29245_length_567_cov_2.884615	204	284	0	80	80	1.0000000
NODE_29245_length_567_cov_2.884615	204	254	0	50	50	1.0000000
NODE_29245_length_567_cov_2.884615	266	297	0	31	31	1.0000000
NODE_29363_length_566_cov_47.747323	157	237	0	80	80	1.0000000
NODE_29363_length_566_cov_47.747323	210	290	0	80	80	1.0000000
NODE_29364_length_566_cov_44.824411	14	94	2	3	80	0.0375000
NODE_29364_length_566_cov_44.824411	14	94	4	8	80	0.1000000
NODE_29364_length_566_cov_44.824411	14	94	5	1	80	0.0125000
NODE_29364_length_566_cov_44.824411	14	94	7	2	80	0.0250000
NODE_29364_length_566_cov_44.824411	14	94	9	1	80	0.0125000
NODE_29364_length_566_cov_44.824411	14	94	13	3	80	0.0375000
NODE_29364_length_566_cov_44.824411	14	94	14	6	80	0.0750000
NODE_29364_length_566_cov_44.824411	14	94	16	56	80	0.7000000
NODE_29364_length_566_cov_44.824411	15	94	2	2	79	0.0253165
NODE_29364_length_566_cov_44.824411	15	94	4	8	79	0.1012658
NODE_29364_length_566_cov_44.824411	15	94	5	1	79	0.0126582
NODE_29364_length_566_cov_44.824411	15	94	7	2	79	0.0253165
NODE_29364_length_566_cov_44.824411	15	94	9	1	79	0.0126582
NODE_29364_length_566_cov_44.824411	15	94	13	3	79	0.0379747
NODE_29364_length_566_cov_44.824411	15	94	14	6	79	0.0759494
NODE_29364_length_566_cov_44.824411	15	94	16	56	79	0.7088608
NODE_29364_length_566_cov_44.824411	67	147	0	3	80	0.0375000
NODE_29364_length_566_cov_44.824411	67	147	2	16	80	0.2000000
NODE_29364_length_566_cov_44.824411	67	147	6	3	80	0.0375000
NODE_29364_length_566_cov_44.824411	67	147	10	4	80	0.0500000
NODE_29364_length_566_cov_44.824411	67	147	12	1	80	0.0125000
NODE_29364_length_566_cov_44.824411	67	147	14	1	80	0.0125000
NODE_29364_length_566_cov_44.824411	67	147	16	52	80	0.6500000
NODE_29364_length_566_cov_44.824411	67	147	0	3	80	0.0375000
NODE_29364_length_566_cov_44.824411	67	147	2	16	80	0.2000000
NODE_29364_length_566_cov_44.824411	67	147	6	3	80	0.0375000
NODE_29364_length_566_cov_44.824411	67	147	10	4	80	0.0500000
NODE_29364_length_566_cov_44.824411	67	147	12	1	80	0.0125000
NODE_29364_length_566_cov_44.824411	67	147	14	1	80	0.0125000
NODE_29364_length_566_cov_44.824411	67	147	16	52	80	0.6500000
NODE_29364_length_566_cov_44.824411	77	147	0	3	70	0.0428571
NODE_29364_length_566_cov_44.824411	77	147	2	16	70	0.2285714
NODE_29364_length_566_cov_44.824411	77	147	6	3	70	0.0428571
NODE_29364_length_566_cov_44.824411	77	147	10	4	70	0.0571429
NODE_29364_length_566_cov_44.824411	77	147	12	1	70	0.0142857
NODE_29364_length_566_cov_44.824411	77	147	14	1	70	0.0142857
NODE_29364_length_566_cov_44.824411	77	147	16	42	70	0.6000000
NODE_29364_length_566_cov_44.824411	143	223	0	79	80	0.9875000
NODE_29364_length_566_cov_44.824411	143	223	2	1	80	0.0125000
NODE_29364_length_566_cov_44.824411	196	276	0	80	80	1.0000000
NODE_29367_length_566_cov_18.494647	344	424	0	80	80	1.0000000
NODE_29367_length_566_cov_18.494647	397	477	0	80	80	1.0000000
NODE_29368_length_566_cov_17.537473	324	404	0	80	80	1.0000000
NODE_29368_length_566_cov_17.537473	377	457	0	80	80	1.0000000
NODE_29369_length_566_cov_13.019272	157	237	0	80	80	1.0000000
NODE_29369_length_566_cov_13.019272	210	290	0	80	80	1.0000000
NODE_29371_length_566_cov_9.513919	191	279	0	88	88	1.0000000
NODE_29371_length_566_cov_9.513919	252	332	0	80	80	1.0000000
NODE_29397_length_566_cov_3.239829	292	334	0	42	42	1.0000000
NODE_29397_length_566_cov_3.239829	351	375	0	24	24	1.0000000
NODE_29437_length_566_cov_1.698073	432	481	0	49	49	1.0000000
NODE_29472_length_566_cov_0.957173	378	405	2	27	27	1.0000000
NODE_29503_length_565_cov_10.508584	202	280	0	78	78	1.0000000
NODE_29503_length_565_cov_10.508584	253	334	0	81	81	1.0000000
NODE_29509_length_565_cov_7.560086	170	246	2	19	76	0.2500000
NODE_29509_length_565_cov_7.560086	170	246	6	49	76	0.6447368
NODE_29509_length_565_cov_7.560086	170	246	10	5	76	0.0657895
NODE_29509_length_565_cov_7.560086	170	246	12	3	76	0.0394737
NODE_29520_length_565_cov_4.045064	231	311	0	80	80	1.0000000
NODE_29520_length_565_cov_4.045064	284	364	0	80	80	1.0000000
NODE_29528_length_565_cov_3.399142	161	241	0	80	80	1.0000000
NODE_29528_length_565_cov_3.399142	214	294	0	80	80	1.0000000
NODE_29542_length_565_cov_2.542918	302	382	0	80	80	1.0000000
NODE_29542_length_565_cov_2.542918	355	435	0	80	80	1.0000000
NODE_29650_length_564_cov_46.901075	129	209	0	20	80	0.2500000
NODE_29650_length_564_cov_46.901075	129	209	11	21	80	0.2625000
NODE_29650_length_564_cov_46.901075	129	209	12	39	80	0.4875000
NODE_29650_length_564_cov_46.901075	182	262	0	43	80	0.5375000
NODE_29650_length_564_cov_46.901075	182	262	11	31	80	0.3875000
NODE_29650_length_564_cov_46.901075	182	262	12	6	80	0.0750000
NODE_29651_length_564_cov_13.520430	300	380	0	80	80	1.0000000
NODE_29651_length_564_cov_13.520430	353	433	0	80	80	1.0000000
NODE_29653_length_564_cov_7.965591	291	332	0	41	41	1.0000000
NODE_29796_length_563_cov_24.487069	97	177	0	80	80	1.0000000
NODE_29796_length_563_cov_24.487069	150	230	0	80	80	1.0000000
NODE_29800_length_563_cov_6.758621	301	367	0	11	66	0.1666667
NODE_29800_length_563_cov_6.758621	301	367	4	8	66	0.1212121
NODE_29800_length_563_cov_6.758621	301	367	6	6	66	0.0909091
NODE_29800_length_563_cov_6.758621	301	367	10	2	66	0.0303030
NODE_29800_length_563_cov_6.758621	301	367	16	9	66	0.1363636
NODE_29800_length_563_cov_6.758621	301	367	17	1	66	0.0151515
NODE_29800_length_563_cov_6.758621	301	367	18	6	66	0.0909091
NODE_29800_length_563_cov_6.758621	301	367	20	8	66	0.1212121
NODE_29800_length_563_cov_6.758621	301	367	22	3	66	0.0454545
NODE_29800_length_563_cov_6.758621	301	367	23	2	66	0.0303030
NODE_29800_length_563_cov_6.758621	301	367	24	10	66	0.1515152
NODE_29800_length_563_cov_6.758621	378	422	0	44	44	1.0000000
NODE_29802_length_563_cov_5.762931	48	135	0	87	87	1.0000000
NODE_29802_length_563_cov_5.762931	108	188	0	80	80	1.0000000
NODE_29808_length_563_cov_4.176724	197	277	0	80	80	1.0000000
NODE_29808_length_563_cov_4.176724	250	330	0	80	80	1.0000000
NODE_29809_length_563_cov_4.155172	273	315	2	42	42	1.0000000
NODE_29809_length_563_cov_4.155172	288	358	2	70	70	1.0000000
NODE_29925_length_562_cov_31.194384	47	127	6	80	80	1.0000000
NODE_29925_length_562_cov_31.194384	100	180	3	5	80	0.0625000
NODE_29925_length_562_cov_31.194384	100	180	6	75	80	0.9375000
NODE_29926_length_562_cov_29.857451	33	113	0	80	80	1.0000000
NODE_29926_length_562_cov_29.857451	86	166	0	80	80	1.0000000
NODE_29927_length_562_cov_23.194384	245	325	0	80	80	1.0000000
NODE_29927_length_562_cov_23.194384	298	378	0	80	80	1.0000000
NODE_29930_length_562_cov_10.304536	271	321	8	50	50	1.0000000
NODE_29931_length_562_cov_9.131749	265	346	0	81	81	1.0000000
NODE_29931_length_562_cov_9.131749	319	399	0	80	80	1.0000000
NODE_29960_length_562_cov_2.961123	350	398	0	48	48	1.0000000
NODE_30083_length_561_cov_18.049784	54	134	0	27	80	0.3375000
NODE_30083_length_561_cov_18.049784	54	134	2	53	80	0.6625000
NODE_30083_length_561_cov_18.049784	107	187	0	31	80	0.3875000
NODE_30083_length_561_cov_18.049784	107	187	2	49	80	0.6125000
NODE_30087_length_561_cov_5.348485	208	274	0	1	66	0.0151515
NODE_30087_length_561_cov_5.348485	208	274	2	31	66	0.4696970
NODE_30087_length_561_cov_5.348485	208	274	3	34	66	0.5151515
NODE_30105_length_561_cov_2.787879	216	285	0	69	69	1.0000000
NODE_30120_length_561_cov_2.233766	339	419	0	80	80	1.0000000
NODE_30120_length_561_cov_2.233766	391	445	0	54	54	1.0000000
NODE_30120_length_561_cov_2.233766	392	438	0	46	46	1.0000000
NODE_30133_length_561_cov_1.803030	258	334	0	76	76	1.0000000
NODE_30224_length_560_cov_41.433839	67	147	0	28	80	0.3500000
NODE_30224_length_560_cov_41.433839	67	147	2	52	80	0.6500000
NODE_30224_length_560_cov_41.433839	120	200	2	80	80	1.0000000
NODE_30225_length_560_cov_35.993492	366	446	0	80	80	1.0000000
NODE_30225_length_560_cov_35.993492	419	499	0	80	80	1.0000000
NODE_30226_length_560_cov_20.433839	342	422	0	80	80	1.0000000
NODE_30226_length_560_cov_20.433839	395	475	0	80	80	1.0000000
NODE_30227_length_560_cov_13.850325	274	327	0	53	53	1.0000000
NODE_30228_length_560_cov_12.075922	233	314	2	23	81	0.2839506
NODE_30228_length_560_cov_12.075922	233	314	4	43	81	0.5308642
NODE_30228_length_560_cov_12.075922	233	314	5	1	81	0.0123457
NODE_30228_length_560_cov_12.075922	233	314	6	14	81	0.1728395
NODE_30229_length_560_cov_8.594360	263	343	0	80	80	1.0000000
NODE_30229_length_560_cov_8.594360	316	396	0	80	80	1.0000000
NODE_30237_length_560_cov_5.227766	264	328	14	20	64	0.3125000
NODE_30237_length_560_cov_5.227766	264	328	16	44	64	0.6875000
NODE_30238_length_560_cov_5.056399	299	379	0	45	80	0.5625000
NODE_30238_length_560_cov_5.056399	299	379	2	35	80	0.4375000
NODE_30238_length_560_cov_5.056399	352	432	2	80	80	1.0000000
NODE_30244_length_560_cov_4.518438	156	236	0	80	80	1.0000000
NODE_30281_length_560_cov_2.154013	204	275	0	71	71	1.0000000
NODE_30281_length_560_cov_2.154013	255	335	0	80	80	1.0000000
NODE_30288_length_560_cov_2.017354	52	114	0	62	62	1.0000000
NODE_30363_length_559_cov_37.526087	289	370	0	81	81	1.0000000
NODE_30363_length_559_cov_37.526087	343	423	0	80	80	1.0000000
NODE_30363_length_559_cov_37.526087	419	500	0	81	81	1.0000000
NODE_30363_length_559_cov_37.526087	473	553	0	80	80	1.0000000
NODE_30365_length_559_cov_19.126087	388	468	0	35	80	0.4375000
NODE_30365_length_559_cov_19.126087	388	468	2	45	80	0.5625000
NODE_30365_length_559_cov_19.126087	441	521	0	80	80	1.0000000
NODE_30366_length_559_cov_12.489130	262	341	0	49	79	0.6202531
NODE_30366_length_559_cov_12.489130	262	341	2	30	79	0.3797468
NODE_30366_length_559_cov_12.489130	316	394	0	14	78	0.1794872
NODE_30366_length_559_cov_12.489130	316	394	2	64	78	0.8205128
NODE_30370_length_559_cov_6.530435	283	363	0	80	80	1.0000000
NODE_30377_length_559_cov_4.930435	112	192	0	80	80	1.0000000
NODE_30377_length_559_cov_4.930435	165	244	0	79	79	1.0000000
NODE_30419_length_559_cov_1.776087	395	433	68	2	38	0.0526316
NODE_30419_length_559_cov_1.776087	395	433	69	1	38	0.0263158
NODE_30419_length_559_cov_1.776087	395	433	73	3	38	0.0789474
NODE_30419_length_559_cov_1.776087	395	433	74	1	38	0.0263158
NODE_30419_length_559_cov_1.776087	395	433	75	5	38	0.1315790
NODE_30419_length_559_cov_1.776087	395	433	76	9	38	0.2368421
NODE_30419_length_559_cov_1.776087	395	433	78	8	38	0.2105263
NODE_30419_length_559_cov_1.776087	395	433	80	6	38	0.1578947
NODE_30419_length_559_cov_1.776087	395	433	82	3	38	0.0789474
NODE_30480_length_558_cov_13.102397	297	364	0	67	67	1.0000000
NODE_30482_length_558_cov_9.309368	369	449	0	80	80	1.0000000
NODE_30482_length_558_cov_9.309368	422	502	0	80	80	1.0000000
NODE_30489_length_558_cov_5.921569	304	361	0	57	57	1.0000000
NODE_30493_length_558_cov_4.801743	197	266	0	69	69	1.0000000
NODE_30493_length_558_cov_4.801743	197	277	0	80	80	1.0000000
NODE_30493_length_558_cov_4.801743	250	330	0	80	80	1.0000000
NODE_30493_length_558_cov_4.801743	250	330	0	80	80	1.0000000
NODE_30495_length_558_cov_4.570806	188	244	6	2	56	0.0357143
NODE_30495_length_558_cov_4.570806	188	244	7	8	56	0.1428571
NODE_30495_length_558_cov_4.570806	188	244	8	46	56	0.8214286
NODE_30536_length_558_cov_2.259259	236	294	0	58	58	1.0000000
NODE_30536_length_558_cov_2.259259	267	347	0	80	80	1.0000000
NODE_30568_length_558_cov_1.544662	403	483	0	80	80	1.0000000
NODE_30568_length_558_cov_1.544662	456	536	0	80	80	1.0000000
NODE_30623_length_557_cov_9.141921	255	335	0	80	80	1.0000000
NODE_30623_length_557_cov_9.141921	308	388	0	80	80	1.0000000
NODE_30626_length_557_cov_7.316594	210	290	0	80	80	1.0000000
NODE_30626_length_557_cov_7.316594	263	341	0	78	78	1.0000000
NODE_30636_length_557_cov_4.259825	185	267	0	67	82	0.8170732
NODE_30636_length_557_cov_4.259825	185	267	2	15	82	0.1829268
NODE_30646_length_557_cov_3.794760	131	188	2	11	57	0.1929825
NODE_30646_length_557_cov_3.794760	131	188	5	7	57	0.1228070
NODE_30646_length_557_cov_3.794760	131	188	6	1	57	0.0175439
NODE_30646_length_557_cov_3.794760	131	188	7	38	57	0.6666667
NODE_30646_length_557_cov_3.794760	139	219	2	3	80	0.0375000
NODE_30646_length_557_cov_3.794760	139	219	4	5	80	0.0625000
NODE_30646_length_557_cov_3.794760	139	219	5	7	80	0.0875000
NODE_30646_length_557_cov_3.794760	139	219	6	27	80	0.3375000
NODE_30646_length_557_cov_3.794760	139	219	7	38	80	0.4750000
NODE_30650_length_557_cov_3.517467	246	325	0	79	79	1.0000000
NODE_30650_length_557_cov_3.517467	298	378	0	80	80	1.0000000
NODE_30652_length_557_cov_3.390830	366	395	10	1	29	0.0344828
NODE_30652_length_557_cov_3.390830	366	395	12	1	29	0.0344828
NODE_30652_length_557_cov_3.390830	366	395	16	2	29	0.0689655
NODE_30652_length_557_cov_3.390830	366	395	20	8	29	0.2758621
NODE_30652_length_557_cov_3.390830	366	395	22	4	29	0.1379310
NODE_30652_length_557_cov_3.390830	366	395	24	11	29	0.3793103
NODE_30652_length_557_cov_3.390830	366	395	26	2	29	0.0689655
NODE_30792_length_556_cov_37.258206	122	202	0	80	80	1.0000000
NODE_30792_length_556_cov_37.258206	175	255	0	80	80	1.0000000
NODE_30793_length_556_cov_15.266958	360	440	0	80	80	1.0000000
NODE_30793_length_556_cov_15.266958	413	493	0	80	80	1.0000000
NODE_30794_length_556_cov_12.781182	341	421	0	80	80	1.0000000
NODE_30794_length_556_cov_12.781182	394	474	0	80	80	1.0000000
NODE_30795_length_556_cov_11.131291	304	384	0	80	80	1.0000000
NODE_30795_length_556_cov_11.131291	357	437	0	80	80	1.0000000
NODE_30797_length_556_cov_7.168490	163	243	0	80	80	1.0000000
NODE_30797_length_556_cov_7.168490	216	296	0	80	80	1.0000000
NODE_30798_length_556_cov_7.089716	325	379	0	54	54	1.0000000
NODE_30801_length_556_cov_6.505470	232	312	0	80	80	1.0000000
NODE_30801_length_556_cov_6.505470	285	365	0	80	80	1.0000000
NODE_30802_length_556_cov_6.496718	140	179	0	16	39	0.4102564
NODE_30802_length_556_cov_6.496718	140	179	1	23	39	0.5897436
NODE_30802_length_556_cov_6.496718	226	255	0	29	29	1.0000000
NODE_30809_length_556_cov_4.457330	197	277	26	19	80	0.2375000
NODE_30809_length_556_cov_4.457330	197	277	36	6	80	0.0750000
NODE_30809_length_556_cov_4.457330	197	277	38	2	80	0.0250000
NODE_30809_length_556_cov_4.457330	197	277	39	8	80	0.1000000
NODE_30809_length_556_cov_4.457330	197	277	41	2	80	0.0250000
NODE_30809_length_556_cov_4.457330	197	277	42	9	80	0.1125000
NODE_30809_length_556_cov_4.457330	197	277	43	1	80	0.0125000
NODE_30809_length_556_cov_4.457330	197	277	44	24	80	0.3000000
NODE_30809_length_556_cov_4.457330	197	277	46	2	80	0.0250000
NODE_30809_length_556_cov_4.457330	197	277	48	7	80	0.0875000
NODE_30818_length_556_cov_3.761488	234	307	0	73	73	1.0000000
NODE_30930_length_555_cov_20.949561	322	402	0	17	80	0.2125000
NODE_30930_length_555_cov_20.949561	322	402	4	63	80	0.7875000
NODE_30930_length_555_cov_20.949561	375	455	0	70	80	0.8750000
NODE_30930_length_555_cov_20.949561	375	455	4	10	80	0.1250000
NODE_30931_length_555_cov_16.822368	268	348	0	80	80	1.0000000
NODE_30931_length_555_cov_16.822368	321	401	0	80	80	1.0000000
NODE_30933_length_555_cov_9.912281	313	393	0	80	80	1.0000000
NODE_30935_length_555_cov_8.057018	277	357	0	80	80	1.0000000
NODE_30935_length_555_cov_8.057018	330	410	0	80	80	1.0000000
NODE_30938_length_555_cov_6.778509	62	92	0	30	30	1.0000000
NODE_30986_length_555_cov_2.177632	208	288	0	24	80	0.3000000
NODE_30986_length_555_cov_2.177632	208	288	8	56	80	0.7000000
NODE_30986_length_555_cov_2.177632	261	329	0	65	68	0.9558824
NODE_30986_length_555_cov_2.177632	261	329	8	3	68	0.0441176
NODE_31092_length_554_cov_11.942857	118	198	0	80	80	1.0000000
NODE_31092_length_554_cov_11.942857	171	251	0	80	80	1.0000000
NODE_31096_length_554_cov_8.426374	242	322	0	80	80	1.0000000
NODE_31096_length_554_cov_8.426374	295	375	0	80	80	1.0000000
NODE_31101_length_554_cov_6.116484	264	344	0	80	80	1.0000000
NODE_31101_length_554_cov_6.116484	317	393	0	76	76	1.0000000
NODE_31115_length_554_cov_3.586813	207	286	0	9	79	0.1139240
NODE_31115_length_554_cov_3.586813	207	286	2	70	79	0.8860760
NODE_31240_length_553_cov_42.017621	197	277	0	80	80	1.0000000
NODE_31240_length_553_cov_42.017621	250	330	0	80	80	1.0000000
NODE_31241_length_553_cov_28.944934	333	413	0	7	80	0.0875000
NODE_31241_length_553_cov_28.944934	333	413	6	73	80	0.9125000
NODE_31241_length_553_cov_28.944934	386	466	5	4	80	0.0500000
NODE_31241_length_553_cov_28.944934	386	466	6	76	80	0.9500000
NODE_31242_length_553_cov_12.176211	242	322	0	50	80	0.6250000
NODE_31242_length_553_cov_12.176211	242	322	2	30	80	0.3750000
NODE_31242_length_553_cov_12.176211	295	375	0	80	80	1.0000000
NODE_31244_length_553_cov_9.876652	232	312	0	80	80	1.0000000
NODE_31244_length_553_cov_9.876652	285	365	0	80	80	1.0000000
NODE_31246_length_553_cov_9.306167	207	287	0	80	80	1.0000000
NODE_31246_length_553_cov_9.306167	207	287	0	80	80	1.0000000
NODE_31246_length_553_cov_9.306167	260	340	0	80	80	1.0000000
NODE_31259_length_553_cov_3.729075	36	93	16	57	57	1.0000000
NODE_31259_length_553_cov_3.729075	89	146	5	3	57	0.0526316
NODE_31259_length_553_cov_3.729075	89	146	8	2	57	0.0350877
NODE_31259_length_553_cov_3.729075	89	146	10	5	57	0.0877193
NODE_31259_length_553_cov_3.729075	89	146	12	20	57	0.3508772
NODE_31259_length_553_cov_3.729075	89	146	16	27	57	0.4736842
NODE_31266_length_553_cov_3.310573	226	293	0	67	67	1.0000000
NODE_31279_length_553_cov_2.678414	102	180	0	47	78	0.6025641
NODE_31279_length_553_cov_2.678414	102	180	2	31	78	0.3974359
NODE_31279_length_553_cov_2.678414	248	275	0	27	27	1.0000000
NODE_31295_length_553_cov_1.958150	416	462	7	1	46	0.0217391
NODE_31295_length_553_cov_1.958150	416	462	8	2	46	0.0434783
NODE_31295_length_553_cov_1.958150	416	462	10	3	46	0.0652174
NODE_31295_length_553_cov_1.958150	416	462	12	8	46	0.1739130
NODE_31295_length_553_cov_1.958150	416	462	18	9	46	0.1956522
NODE_31295_length_553_cov_1.958150	416	462	19	1	46	0.0217391
NODE_31295_length_553_cov_1.958150	416	462	23	4	46	0.0869565
NODE_31295_length_553_cov_1.958150	416	462	24	18	46	0.3913043
NODE_31295_length_553_cov_1.958150	469	515	14	9	46	0.1956522
NODE_31295_length_553_cov_1.958150	469	515	16	4	46	0.0869565
NODE_31295_length_553_cov_1.958150	469	515	20	2	46	0.0434783
NODE_31295_length_553_cov_1.958150	469	515	22	14	46	0.3043478
NODE_31295_length_553_cov_1.958150	469	515	24	17	46	0.3695652
NODE_31377_length_552_cov_92.070640	298	378	0	61	80	0.7625000
NODE_31377_length_552_cov_92.070640	298	378	13	1	80	0.0125000
NODE_31377_length_552_cov_92.070640	298	378	14	18	80	0.2250000
NODE_31377_length_552_cov_92.070640	298	378	0	61	80	0.7625000
NODE_31377_length_552_cov_92.070640	298	378	13	1	80	0.0125000
NODE_31377_length_552_cov_92.070640	298	378	14	18	80	0.2250000
NODE_31377_length_552_cov_92.070640	374	454	2	2	80	0.0250000
NODE_31377_length_552_cov_92.070640	374	454	14	28	80	0.3500000
NODE_31377_length_552_cov_92.070640	374	454	15	16	80	0.2000000
NODE_31377_length_552_cov_92.070640	374	454	16	34	80	0.4250000
NODE_31377_length_552_cov_92.070640	374	454	2	2	80	0.0250000
NODE_31377_length_552_cov_92.070640	374	454	14	28	80	0.3500000
NODE_31377_length_552_cov_92.070640	374	454	15	16	80	0.2000000
NODE_31377_length_552_cov_92.070640	374	454	16	34	80	0.4250000
NODE_31377_length_552_cov_92.070640	374	454	2	2	80	0.0250000
NODE_31377_length_552_cov_92.070640	374	454	14	28	80	0.3500000
NODE_31377_length_552_cov_92.070640	374	454	15	16	80	0.2000000
NODE_31377_length_552_cov_92.070640	374	454	16	34	80	0.4250000
NODE_31377_length_552_cov_92.070640	374	454	2	2	80	0.0250000
NODE_31377_length_552_cov_92.070640	374	454	14	28	80	0.3500000
NODE_31377_length_552_cov_92.070640	374	454	15	16	80	0.2000000
NODE_31377_length_552_cov_92.070640	374	454	16	34	80	0.4250000
NODE_31377_length_552_cov_92.070640	374	450	14	28	76	0.3684210
NODE_31377_length_552_cov_92.070640	374	450	15	14	76	0.1842105
NODE_31377_length_552_cov_92.070640	374	450	16	34	76	0.4473684
NODE_31377_length_552_cov_92.070640	427	507	0	28	80	0.3500000
NODE_31377_length_552_cov_92.070640	427	507	2	27	80	0.3375000
NODE_31377_length_552_cov_92.070640	427	507	15	16	80	0.2000000
NODE_31377_length_552_cov_92.070640	427	507	16	9	80	0.1125000
NODE_31377_length_552_cov_92.070640	427	507	0	28	80	0.3500000
NODE_31377_length_552_cov_92.070640	427	507	2	27	80	0.3375000
NODE_31377_length_552_cov_92.070640	427	507	15	16	80	0.2000000
NODE_31377_length_552_cov_92.070640	427	507	16	9	80	0.1125000
NODE_31377_length_552_cov_92.070640	427	498	0	19	71	0.2676056
NODE_31377_length_552_cov_92.070640	427	498	2	27	71	0.3802817
NODE_31377_length_552_cov_92.070640	427	498	15	16	71	0.2253521
NODE_31377_length_552_cov_92.070640	427	498	16	9	71	0.1267606
NODE_31377_length_552_cov_92.070640	430	500	0	21	70	0.3000000
NODE_31377_length_552_cov_92.070640	430	500	2	27	70	0.3857143
NODE_31377_length_552_cov_92.070640	430	500	15	16	70	0.2285714
NODE_31377_length_552_cov_92.070640	430	500	16	6	70	0.0857143
NODE_31377_length_552_cov_92.070640	432	507	0	28	75	0.3733333
NODE_31377_length_552_cov_92.070640	432	507	2	27	75	0.3600000
NODE_31377_length_552_cov_92.070640	432	507	15	16	75	0.2133333
NODE_31377_length_552_cov_92.070640	432	507	16	4	75	0.0533333
NODE_31378_length_552_cov_20.432671	151	231	0	80	80	1.0000000
NODE_31378_length_552_cov_20.432671	204	284	0	80	80	1.0000000
NODE_31379_length_552_cov_18.075055	257	333	0	76	76	1.0000000
NODE_31380_length_552_cov_13.331126	214	294	0	80	80	1.0000000
NODE_31380_length_552_cov_13.331126	267	347	0	80	80	1.0000000
NODE_31381_length_552_cov_12.774834	360	440	0	80	80	1.0000000
NODE_31381_length_552_cov_12.774834	413	493	0	80	80	1.0000000
NODE_31384_length_552_cov_8.883002	310	390	0	8	80	0.1000000
NODE_31384_length_552_cov_8.883002	310	390	1	2	80	0.0250000
NODE_31384_length_552_cov_8.883002	310	390	2	70	80	0.8750000
NODE_31384_length_552_cov_8.883002	363	443	0	24	80	0.3000000
NODE_31384_length_552_cov_8.883002	363	443	2	56	80	0.7000000
NODE_31385_length_552_cov_6.916115	206	281	7	31	75	0.4133333
NODE_31385_length_552_cov_6.916115	206	281	8	31	75	0.4133333
NODE_31385_length_552_cov_6.916115	206	281	10	13	75	0.1733333
NODE_31538_length_551_cov_34.070796	324	406	0	82	82	1.0000000
NODE_31538_length_551_cov_34.070796	379	444	0	65	65	1.0000000
NODE_31541_length_551_cov_10.252212	164	244	0	80	80	1.0000000
NODE_31541_length_551_cov_10.252212	217	297	0	80	80	1.0000000
NODE_31543_length_551_cov_8.075221	363	406	2	43	43	1.0000000
NODE_31547_length_551_cov_5.668142	213	293	0	6	80	0.0750000
NODE_31547_length_551_cov_5.668142	213	293	2	74	80	0.9250000
NODE_31547_length_551_cov_5.668142	266	346	0	1	80	0.0125000
NODE_31547_length_551_cov_5.668142	266	346	2	79	80	0.9875000
NODE_31552_length_551_cov_4.212389	171	242	6	9	71	0.1267606
NODE_31552_length_551_cov_4.212389	171	242	12	24	71	0.3380282
NODE_31552_length_551_cov_4.212389	171	242	13	1	71	0.0140845
NODE_31552_length_551_cov_4.212389	171	242	14	37	71	0.5211267
NODE_31552_length_551_cov_4.212389	215	263	10	2	48	0.0416667
NODE_31552_length_551_cov_4.212389	215	263	12	38	48	0.7916667
NODE_31552_length_551_cov_4.212389	215	263	14	8	48	0.1666667
NODE_31563_length_551_cov_3.307522	227	307	0	80	80	1.0000000
NODE_31563_length_551_cov_3.307522	280	360	0	80	80	1.0000000
NODE_31693_length_550_cov_17.308204	101	181	0	80	80	1.0000000
NODE_31693_length_550_cov_17.308204	154	234	0	80	80	1.0000000
NODE_31700_length_550_cov_5.580931	286	329	0	43	43	1.0000000
NODE_31701_length_550_cov_5.490022	458	500	0	42	42	1.0000000
NODE_31701_length_550_cov_5.490022	459	523	0	64	64	1.0000000
NODE_31703_length_550_cov_5.243902	194	274	0	80	80	1.0000000
NODE_31703_length_550_cov_5.243902	247	327	0	80	80	1.0000000
NODE_31706_length_550_cov_4.815965	184	264	0	80	80	1.0000000
NODE_31726_length_550_cov_3.252772	308	388	0	7	80	0.0875000
NODE_31726_length_550_cov_3.252772	308	388	2	73	80	0.9125000
NODE_31756_length_550_cov_1.864745	189	259	0	1	70	0.0142857
NODE_31756_length_550_cov_1.864745	189	259	2	69	70	0.9857143
NODE_31756_length_550_cov_1.864745	189	258	2	69	69	1.0000000
NODE_31847_length_549_cov_31.826667	216	292	9	7	76	0.0921053
NODE_31847_length_549_cov_31.826667	216	292	11	5	76	0.0657895
NODE_31847_length_549_cov_31.826667	216	292	14	17	76	0.2236842
NODE_31847_length_549_cov_31.826667	216	292	15	2	76	0.0263158
NODE_31847_length_549_cov_31.826667	216	292	18	42	76	0.5526316
NODE_31847_length_549_cov_31.826667	216	292	20	3	76	0.0394737
NODE_31847_length_549_cov_31.826667	267	331	8	8	64	0.1250000
NODE_31847_length_549_cov_31.826667	267	331	12	4	64	0.0625000
NODE_31847_length_549_cov_31.826667	267	331	14	35	64	0.5468750
NODE_31847_length_549_cov_31.826667	267	331	18	14	64	0.2187500
NODE_31847_length_549_cov_31.826667	267	331	20	3	64	0.0468750
NODE_31848_length_549_cov_14.124444	174	263	0	89	89	1.0000000
NODE_31848_length_549_cov_14.124444	242	315	0	73	73	1.0000000
NODE_31857_length_549_cov_5.375556	181	257	163	1	76	0.0131579
NODE_31857_length_549_cov_5.375556	181	257	165	1	76	0.0131579
NODE_31857_length_549_cov_5.375556	181	257	168	1	76	0.0131579
NODE_31857_length_549_cov_5.375556	181	257	170	2	76	0.0263158
NODE_31857_length_549_cov_5.375556	181	257	171	2	76	0.0263158
NODE_31857_length_549_cov_5.375556	181	257	178	1	76	0.0131579
NODE_31857_length_549_cov_5.375556	181	257	179	1	76	0.0131579
NODE_31857_length_549_cov_5.375556	181	257	183	3	76	0.0394737
NODE_31857_length_549_cov_5.375556	181	257	185	1	76	0.0131579
NODE_31857_length_549_cov_5.375556	181	257	187	1	76	0.0131579
NODE_31857_length_549_cov_5.375556	181	257	194	1	76	0.0131579
NODE_31857_length_549_cov_5.375556	181	257	197	2	76	0.0263158
NODE_31857_length_549_cov_5.375556	181	257	201	4	76	0.0526316
NODE_31857_length_549_cov_5.375556	181	257	202	2	76	0.0263158
NODE_31857_length_549_cov_5.375556	181	257	203	1	76	0.0131579
NODE_31857_length_549_cov_5.375556	181	257	204	1	76	0.0131579
NODE_31857_length_549_cov_5.375556	181	257	205	1	76	0.0131579
NODE_31857_length_549_cov_5.375556	181	257	206	3	76	0.0394737
NODE_31857_length_549_cov_5.375556	181	257	208	1	76	0.0131579
NODE_31857_length_549_cov_5.375556	181	257	209	1	76	0.0131579
NODE_31857_length_549_cov_5.375556	181	257	211	1	76	0.0131579
NODE_31857_length_549_cov_5.375556	181	257	214	1	76	0.0131579
NODE_31857_length_549_cov_5.375556	181	257	215	2	76	0.0263158
NODE_31857_length_549_cov_5.375556	181	257	216	1	76	0.0131579
NODE_31857_length_549_cov_5.375556	181	257	218	3	76	0.0394737
NODE_31857_length_549_cov_5.375556	181	257	219	1	76	0.0131579
NODE_31857_length_549_cov_5.375556	181	257	220	4	76	0.0526316
NODE_31857_length_549_cov_5.375556	181	257	224	3	76	0.0394737
NODE_31857_length_549_cov_5.375556	181	257	227	1	76	0.0131579
NODE_31857_length_549_cov_5.375556	181	257	229	1	76	0.0131579
NODE_31857_length_549_cov_5.375556	181	257	230	2	76	0.0263158
NODE_31857_length_549_cov_5.375556	181	257	231	3	76	0.0394737
NODE_31857_length_549_cov_5.375556	181	257	233	4	76	0.0526316
NODE_31857_length_549_cov_5.375556	181	257	235	3	76	0.0394737
NODE_31857_length_549_cov_5.375556	181	257	236	1	76	0.0131579
NODE_31857_length_549_cov_5.375556	181	257	238	6	76	0.0789474
NODE_31857_length_549_cov_5.375556	181	257	239	1	76	0.0131579
NODE_31857_length_549_cov_5.375556	181	257	241	3	76	0.0394737
NODE_31857_length_549_cov_5.375556	181	257	243	1	76	0.0131579
NODE_31857_length_549_cov_5.375556	181	257	244	2	76	0.0263158
NODE_31857_length_549_cov_5.375556	181	257	245	1	76	0.0131579
NODE_31859_length_549_cov_4.933333	260	340	0	80	80	1.0000000
NODE_31864_length_549_cov_4.537778	345	430	0	23	85	0.2705882
NODE_31864_length_549_cov_4.537778	345	430	2	62	85	0.7294118
NODE_31864_length_549_cov_4.537778	403	483	0	35	80	0.4375000
NODE_31864_length_549_cov_4.537778	403	483	2	45	80	0.5625000
NODE_31865_length_549_cov_4.124444	406	486	8	37	80	0.4625000
NODE_31865_length_549_cov_4.124444	406	486	10	43	80	0.5375000
NODE_31866_length_549_cov_3.931111	182	219	0	37	37	1.0000000
NODE_31868_length_549_cov_3.893333	287	367	0	80	80	1.0000000
NODE_31868_length_549_cov_3.893333	340	420	0	80	80	1.0000000
NODE_31887_length_549_cov_2.673333	282	343	2	15	61	0.2459016
NODE_31887_length_549_cov_2.673333	282	343	4	16	61	0.2622951
NODE_31887_length_549_cov_2.673333	282	343	6	30	61	0.4918033
NODE_31890_length_549_cov_2.622222	144	220	0	76	76	1.0000000
NODE_32013_length_548_cov_13.962138	285	371	0	86	86	1.0000000
NODE_32013_length_548_cov_13.962138	344	424	0	80	80	1.0000000
NODE_32022_length_548_cov_4.683742	261	336	1	17	75	0.2266667
NODE_32022_length_548_cov_4.683742	261	336	2	53	75	0.7066666
NODE_32022_length_548_cov_4.683742	261	336	3	5	75	0.0666667
NODE_32023_length_548_cov_4.670379	140	182	0	13	42	0.3095238
NODE_32023_length_548_cov_4.670379	140	182	4	29	42	0.6904762
NODE_32023_length_548_cov_4.670379	282	311	2	6	29	0.2068966
NODE_32023_length_548_cov_4.670379	282	311	4	20	29	0.6896552
NODE_32023_length_548_cov_4.670379	282	311	6	3	29	0.1034483
NODE_32023_length_548_cov_4.670379	410	455	2	1	45	0.0222222
NODE_32023_length_548_cov_4.670379	410	455	6	20	45	0.4444444
NODE_32023_length_548_cov_4.670379	410	455	8	1	45	0.0222222
NODE_32023_length_548_cov_4.670379	410	455	10	23	45	0.5111111
NODE_32029_length_548_cov_3.630290	111	177	0	66	66	1.0000000
NODE_32039_length_548_cov_3.080178	142	191	2	49	49	1.0000000
NODE_32180_length_547_cov_23.982143	243	323	19	2	80	0.0250000
NODE_32180_length_547_cov_23.982143	243	323	23	1	80	0.0125000
NODE_32180_length_547_cov_23.982143	243	323	24	2	80	0.0250000
NODE_32180_length_547_cov_23.982143	243	323	25	2	80	0.0250000
NODE_32180_length_547_cov_23.982143	243	323	26	1	80	0.0125000
NODE_32180_length_547_cov_23.982143	243	323	28	25	80	0.3125000
NODE_32180_length_547_cov_23.982143	243	323	33	1	80	0.0125000
NODE_32180_length_547_cov_23.982143	243	323	35	2	80	0.0250000
NODE_32180_length_547_cov_23.982143	243	323	36	31	80	0.3875000
NODE_32180_length_547_cov_23.982143	243	323	42	6	80	0.0750000
NODE_32180_length_547_cov_23.982143	243	323	44	7	80	0.0875000
NODE_32180_length_547_cov_23.982143	243	323	19	2	80	0.0250000
NODE_32180_length_547_cov_23.982143	243	323	23	1	80	0.0125000
NODE_32180_length_547_cov_23.982143	243	323	24	2	80	0.0250000
NODE_32180_length_547_cov_23.982143	243	323	25	2	80	0.0250000
NODE_32180_length_547_cov_23.982143	243	323	26	1	80	0.0125000
NODE_32180_length_547_cov_23.982143	243	323	28	25	80	0.3125000
NODE_32180_length_547_cov_23.982143	243	323	33	1	80	0.0125000
NODE_32180_length_547_cov_23.982143	243	323	35	2	80	0.0250000
NODE_32180_length_547_cov_23.982143	243	323	36	31	80	0.3875000
NODE_32180_length_547_cov_23.982143	243	323	42	6	80	0.0750000
NODE_32180_length_547_cov_23.982143	243	323	44	7	80	0.0875000
NODE_32180_length_547_cov_23.982143	252	323	28	24	71	0.3380282
NODE_32180_length_547_cov_23.982143	252	323	33	1	71	0.0140845
NODE_32180_length_547_cov_23.982143	252	323	35	2	71	0.0281690
NODE_32180_length_547_cov_23.982143	252	323	36	31	71	0.4366197
NODE_32180_length_547_cov_23.982143	252	323	42	6	71	0.0845070
NODE_32180_length_547_cov_23.982143	252	323	44	7	71	0.0985916
NODE_32181_length_547_cov_23.555804	42	122	0	80	80	1.0000000
NODE_32181_length_547_cov_23.555804	95	175	0	80	80	1.0000000
NODE_32183_length_547_cov_12.819196	190	270	0	6	80	0.0750000
NODE_32183_length_547_cov_12.819196	190	270	2	74	80	0.9250000
NODE_32195_length_547_cov_5.207589	290	370	0	17	80	0.2125000
NODE_32195_length_547_cov_5.207589	290	370	3	6	80	0.0750000
NODE_32195_length_547_cov_5.207589	290	370	4	10	80	0.1250000
NODE_32195_length_547_cov_5.207589	290	370	6	44	80	0.5500000
NODE_32195_length_547_cov_5.207589	290	370	10	3	80	0.0375000
NODE_32195_length_547_cov_5.207589	343	423	0	17	80	0.2125000
NODE_32195_length_547_cov_5.207589	343	423	3	6	80	0.0750000
NODE_32195_length_547_cov_5.207589	343	423	4	1	80	0.0125000
NODE_32195_length_547_cov_5.207589	343	423	10	3	80	0.0375000
NODE_32195_length_547_cov_5.207589	343	423	16	2	80	0.0250000
NODE_32195_length_547_cov_5.207589	343	423	26	1	80	0.0125000
NODE_32195_length_547_cov_5.207589	343	423	28	4	80	0.0500000
NODE_32195_length_547_cov_5.207589	343	423	30	3	80	0.0375000
NODE_32195_length_547_cov_5.207589	343	423	32	7	80	0.0875000
NODE_32195_length_547_cov_5.207589	343	423	34	6	80	0.0750000
NODE_32195_length_547_cov_5.207589	343	423	35	2	80	0.0250000
NODE_32195_length_547_cov_5.207589	343	423	37	6	80	0.0750000
NODE_32195_length_547_cov_5.207589	343	423	38	22	80	0.2750000
NODE_32197_length_547_cov_4.975446	411	488	0	41	77	0.5324675
NODE_32197_length_547_cov_4.975446	411	488	2	12	77	0.1558442
NODE_32197_length_547_cov_4.975446	411	488	4	24	77	0.3116883
NODE_32197_length_547_cov_4.975446	461	542	2	3	81	0.0370370
NODE_32197_length_547_cov_4.975446	461	542	3	14	81	0.1728395
NODE_32197_length_547_cov_4.975446	461	542	4	64	81	0.7901235
NODE_32199_length_547_cov_4.683036	451	492	0	41	41	1.0000000
NODE_32204_length_547_cov_4.138393	97	175	6	78	78	1.0000000
NODE_32204_length_547_cov_4.138393	151	228	2	4	77	0.0519481
NODE_32204_length_547_cov_4.138393	151	228	3	10	77	0.1298701
NODE_32204_length_547_cov_4.138393	151	228	4	21	77	0.2727273
NODE_32204_length_547_cov_4.138393	151	228	6	42	77	0.5454546
NODE_32206_length_547_cov_4.026786	136	216	0	16	80	0.2000000
NODE_32206_length_547_cov_4.026786	136	216	2	64	80	0.8000000
NODE_32206_length_547_cov_4.026786	189	269	0	69	80	0.8625000
NODE_32206_length_547_cov_4.026786	189	269	2	11	80	0.1375000
NODE_32215_length_547_cov_3.468750	219	299	2	76	80	0.9500000
NODE_32215_length_547_cov_3.468750	219	299	4	4	80	0.0500000
NODE_32222_length_547_cov_2.901786	304	384	0	80	80	1.0000000
NODE_32347_length_546_cov_17.733781	159	239	0	80	80	1.0000000
NODE_32347_length_546_cov_17.733781	212	293	0	81	81	1.0000000
NODE_32348_length_546_cov_16.275168	272	352	0	64	80	0.8000000
NODE_32348_length_546_cov_16.275168	272	352	2	16	80	0.2000000
NODE_32348_length_546_cov_16.275168	325	405	0	11	80	0.1375000
NODE_32348_length_546_cov_16.275168	325	405	2	69	80	0.8625000
NODE_32349_length_546_cov_8.201342	179	259	0	80	80	1.0000000
NODE_32351_length_546_cov_7.454139	241	321	0	80	80	1.0000000
NODE_32351_length_546_cov_7.454139	294	374	0	80	80	1.0000000
NODE_32380_length_546_cov_3.192394	171	251	0	80	80	1.0000000
NODE_32510_length_545_cov_31.524664	38	118	0	80	80	1.0000000
NODE_32510_length_545_cov_31.524664	91	171	0	80	80	1.0000000
NODE_32517_length_545_cov_5.524664	268	348	0	80	80	1.0000000
NODE_32525_length_545_cov_3.885650	137	217	0	10	80	0.1250000
NODE_32525_length_545_cov_3.885650	137	217	5	1	80	0.0125000
NODE_32525_length_545_cov_3.885650	137	217	6	69	80	0.8625000
NODE_32571_length_545_cov_2.013453	246	318	2	72	72	1.0000000
NODE_32599_length_545_cov_1.450673	130	179	0	26	49	0.5306122
NODE_32599_length_545_cov_1.450673	130	179	2	8	49	0.1632653
NODE_32599_length_545_cov_1.450673	130	179	4	15	49	0.3061225
NODE_32616_length_545_cov_1.179372	431	469	0	38	38	1.0000000
NODE_32673_length_544_cov_37.705618	258	338	0	80	80	1.0000000
NODE_32673_length_544_cov_37.705618	311	391	0	80	80	1.0000000
NODE_32674_length_544_cov_33.847191	189	269	0	80	80	1.0000000
NODE_32674_length_544_cov_33.847191	242	327	0	85	85	1.0000000
NODE_32675_length_544_cov_19.467416	251	331	0	80	80	1.0000000
NODE_32675_length_544_cov_19.467416	304	384	0	80	80	1.0000000
NODE_32676_length_544_cov_16.775281	163	243	0	80	80	1.0000000
NODE_32676_length_544_cov_16.775281	216	296	0	80	80	1.0000000
NODE_32677_length_544_cov_8.943820	81	161	0	80	80	1.0000000
NODE_32677_length_544_cov_8.943820	134	214	0	80	80	1.0000000
NODE_32678_length_544_cov_8.537079	283	363	0	80	80	1.0000000
NODE_32678_length_544_cov_8.537079	336	416	0	80	80	1.0000000
NODE_32680_length_544_cov_8.440449	209	289	0	80	80	1.0000000
NODE_32680_length_544_cov_8.440449	262	342	0	80	80	1.0000000
NODE_32681_length_544_cov_7.604494	332	412	0	80	80	1.0000000
NODE_32681_length_544_cov_7.604494	385	465	0	80	80	1.0000000
NODE_32684_length_544_cov_6.000000	461	513	19	11	52	0.2115385
NODE_32684_length_544_cov_6.000000	461	513	20	2	52	0.0384615
NODE_32684_length_544_cov_6.000000	461	513	21	29	52	0.5576923
NODE_32684_length_544_cov_6.000000	461	513	23	10	52	0.1923077
NODE_32830_length_543_cov_38.790541	116	196	0	80	80	1.0000000
NODE_32830_length_543_cov_38.790541	169	249	0	80	80	1.0000000
NODE_32831_length_543_cov_31.713964	193	273	0	80	80	1.0000000
NODE_32831_length_543_cov_31.713964	246	326	0	80	80	1.0000000
NODE_32832_length_543_cov_13.689189	118	198	0	14	80	0.1750000
NODE_32832_length_543_cov_13.689189	118	198	2	51	80	0.6375000
NODE_32832_length_543_cov_13.689189	118	198	6	15	80	0.1875000
NODE_32832_length_543_cov_13.689189	171	251	2	12	80	0.1500000
NODE_32832_length_543_cov_13.689189	171	251	4	52	80	0.6500000
NODE_32832_length_543_cov_13.689189	171	251	6	16	80	0.2000000
NODE_32833_length_543_cov_10.601351	271	351	0	57	80	0.7125000
NODE_32833_length_543_cov_10.601351	271	351	2	23	80	0.2875000
NODE_32833_length_543_cov_10.601351	324	404	0	4	80	0.0500000
NODE_32833_length_543_cov_10.601351	324	404	2	76	80	0.9500000
NODE_32833_length_543_cov_10.601351	400	480	0	34	80	0.4250000
NODE_32833_length_543_cov_10.601351	400	480	2	46	80	0.5750000
NODE_32833_length_543_cov_10.601351	453	533	0	80	80	1.0000000
NODE_32834_length_543_cov_9.202703	291	341	0	9	50	0.1800000
NODE_32834_length_543_cov_9.202703	291	341	1	3	50	0.0600000
NODE_32834_length_543_cov_9.202703	291	341	2	38	50	0.7600000
NODE_32834_length_543_cov_9.202703	347	384	2	37	37	1.0000000
NODE_32835_length_543_cov_7.722973	300	378	0	78	78	1.0000000
NODE_32835_length_543_cov_7.722973	351	431	0	80	80	1.0000000
NODE_32836_length_543_cov_6.815315	181	260	0	79	79	1.0000000
NODE_32845_length_543_cov_4.704955	145	225	0	80	80	1.0000000
NODE_32845_length_543_cov_4.704955	198	275	0	77	77	1.0000000
NODE_32864_length_543_cov_3.301802	247	312	0	65	65	1.0000000
NODE_32875_length_543_cov_2.635135	253	316	6	31	63	0.4920635
NODE_32875_length_543_cov_2.635135	253	316	8	12	63	0.1904762
NODE_32875_length_543_cov_2.635135	253	316	10	14	63	0.2222222
NODE_32875_length_543_cov_2.635135	253	316	12	6	63	0.0952381
NODE_32875_length_543_cov_2.635135	293	373	8	3	80	0.0375000
NODE_32875_length_543_cov_2.635135	293	373	10	14	80	0.1750000
NODE_32875_length_543_cov_2.635135	293	373	12	10	80	0.1250000
NODE_32875_length_543_cov_2.635135	293	373	14	2	80	0.0250000
NODE_32875_length_543_cov_2.635135	293	373	16	5	80	0.0625000
NODE_32875_length_543_cov_2.635135	293	373	18	2	80	0.0250000
NODE_32875_length_543_cov_2.635135	293	373	20	12	80	0.1500000
NODE_32875_length_543_cov_2.635135	293	373	22	10	80	0.1250000
NODE_32875_length_543_cov_2.635135	293	373	24	13	80	0.1625000
NODE_32875_length_543_cov_2.635135	293	373	26	9	80	0.1125000
NODE_33002_length_543_cov_0.682432	98	178	0	52	80	0.6500000
NODE_33002_length_543_cov_0.682432	98	178	2	28	80	0.3500000
NODE_33012_length_542_cov_57.370203	287	367	0	80	80	1.0000000
NODE_33012_length_542_cov_57.370203	340	378	0	38	38	1.0000000
NODE_33014_length_542_cov_11.616253	277	357	0	80	80	1.0000000
NODE_33014_length_542_cov_11.616253	330	410	0	80	80	1.0000000
NODE_33015_length_542_cov_9.988713	253	333	0	80	80	1.0000000
NODE_33015_length_542_cov_9.988713	306	386	0	70	80	0.8750000
NODE_33015_length_542_cov_9.988713	306	386	2	10	80	0.1250000
NODE_33018_length_542_cov_7.934537	215	295	2	80	80	1.0000000
NODE_33018_length_542_cov_7.934537	268	348	0	45	80	0.5625000
NODE_33018_length_542_cov_7.934537	268	348	2	35	80	0.4375000
NODE_33020_length_542_cov_7.266366	159	239	0	80	80	1.0000000
NODE_33021_length_542_cov_7.069977	230	304	0	74	74	1.0000000
NODE_33021_length_542_cov_7.069977	284	362	0	78	78	1.0000000
NODE_33025_length_542_cov_4.783296	237	267	0	30	30	1.0000000
NODE_33035_length_542_cov_3.882619	275	303	0	28	28	1.0000000
NODE_33040_length_542_cov_3.600451	82	131	0	44	49	0.8979592
NODE_33040_length_542_cov_3.600451	82	131	2	5	49	0.1020408
NODE_33188_length_541_cov_22.463801	247	327	0	80	80	1.0000000
NODE_33188_length_541_cov_22.463801	300	380	0	80	80	1.0000000
NODE_33190_length_541_cov_11.070136	60	140	0	80	80	1.0000000
NODE_33190_length_541_cov_11.070136	113	193	0	80	80	1.0000000
NODE_33204_length_541_cov_3.690045	179	250	3	24	71	0.3380282
NODE_33204_length_541_cov_3.690045	179	250	6	2	71	0.0281690
NODE_33204_length_541_cov_3.690045	179	250	10	45	71	0.6338028
NODE_33300_length_541_cov_1.187783	352	400	4	48	48	1.0000000
NODE_33359_length_540_cov_78.353741	219	299	0	80	80	1.0000000
NODE_33359_length_540_cov_78.353741	272	352	0	80	80	1.0000000
NODE_33360_length_540_cov_33.473923	59	139	0	80	80	1.0000000
NODE_33360_length_540_cov_33.473923	112	192	0	80	80	1.0000000
NODE_33361_length_540_cov_20.380952	97	177	0	80	80	1.0000000
NODE_33361_length_540_cov_20.380952	150	230	0	80	80	1.0000000
NODE_33362_length_540_cov_12.657596	248	328	0	80	80	1.0000000
NODE_33362_length_540_cov_12.657596	301	381	0	80	80	1.0000000
NODE_33363_length_540_cov_11.111111	180	260	0	80	80	1.0000000
NODE_33363_length_540_cov_11.111111	233	313	0	80	80	1.0000000
NODE_33365_length_540_cov_6.328798	260	340	2	80	80	1.0000000
NODE_33365_length_540_cov_6.328798	313	393	0	46	80	0.5750000
NODE_33365_length_540_cov_6.328798	313	393	2	34	80	0.4250000
NODE_33382_length_540_cov_3.587302	351	411	0	60	60	1.0000000
NODE_33503_length_539_cov_1023.604545	264	344	339	1	80	0.0125000
NODE_33503_length_539_cov_1023.604545	264	344	341	1	80	0.0125000
NODE_33503_length_539_cov_1023.604545	264	344	354	1	80	0.0125000
NODE_33503_length_539_cov_1023.604545	264	344	361	1	80	0.0125000
NODE_33503_length_539_cov_1023.604545	264	344	365	1	80	0.0125000
NODE_33503_length_539_cov_1023.604545	264	344	378	1	80	0.0125000
NODE_33503_length_539_cov_1023.604545	264	344	388	1	80	0.0125000
NODE_33503_length_539_cov_1023.604545	264	344	393	1	80	0.0125000
NODE_33503_length_539_cov_1023.604545	264	344	398	1	80	0.0125000
NODE_33503_length_539_cov_1023.604545	264	344	416	1	80	0.0125000
NODE_33503_length_539_cov_1023.604545	264	344	422	1	80	0.0125000
NODE_33503_length_539_cov_1023.604545	264	344	441	1	80	0.0125000
NODE_33503_length_539_cov_1023.604545	264	344	446	1	80	0.0125000
NODE_33503_length_539_cov_1023.604545	264	344	449	1	80	0.0125000
NODE_33503_length_539_cov_1023.604545	264	344	459	1	80	0.0125000
NODE_33503_length_539_cov_1023.604545	264	344	462	1	80	0.0125000
NODE_33503_length_539_cov_1023.604545	264	344	477	1	80	0.0125000
NODE_33503_length_539_cov_1023.604545	264	344	488	1	80	0.0125000
NODE_33503_length_539_cov_1023.604545	264	344	497	1	80	0.0125000
NODE_33503_length_539_cov_1023.604545	264	344	517	1	80	0.0125000
NODE_33503_length_539_cov_1023.604545	264	344	533	1	80	0.0125000
NODE_33503_length_539_cov_1023.604545	264	344	547	1	80	0.0125000
NODE_33503_length_539_cov_1023.604545	264	344	548	1	80	0.0125000
NODE_33503_length_539_cov_1023.604545	264	344	583	1	80	0.0125000
NODE_33503_length_539_cov_1023.604545	264	344	624	1	80	0.0125000
NODE_33503_length_539_cov_1023.604545	264	344	649	1	80	0.0125000
NODE_33503_length_539_cov_1023.604545	264	344	686	1	80	0.0125000
NODE_33503_length_539_cov_1023.604545	264	344	701	1	80	0.0125000
NODE_33503_length_539_cov_1023.604545	264	344	711	1	80	0.0125000
NODE_33503_length_539_cov_1023.604545	264	344	733	1	80	0.0125000
NODE_33503_length_539_cov_1023.604545	264	344	749	1	80	0.0125000
NODE_33503_length_539_cov_1023.604545	264	344	787	1	80	0.0125000
NODE_33503_length_539_cov_1023.604545	264	344	803	1	80	0.0125000
NODE_33503_length_539_cov_1023.604545	264	344	807	1	80	0.0125000
NODE_33503_length_539_cov_1023.604545	264	344	811	1	80	0.0125000
NODE_33503_length_539_cov_1023.604545	264	344	822	1	80	0.0125000
NODE_33503_length_539_cov_1023.604545	264	344	842	1	80	0.0125000
NODE_33503_length_539_cov_1023.604545	264	344	850	1	80	0.0125000
NODE_33503_length_539_cov_1023.604545	264	344	865	1	80	0.0125000
NODE_33503_length_539_cov_1023.604545	264	344	868	1	80	0.0125000
NODE_33503_length_539_cov_1023.604545	264	344	880	1	80	0.0125000
NODE_33503_length_539_cov_1023.604545	264	344	889	1	80	0.0125000
NODE_33503_length_539_cov_1023.604545	264	344	906	1	80	0.0125000
NODE_33503_length_539_cov_1023.604545	264	344	936	1	80	0.0125000
NODE_33503_length_539_cov_1023.604545	264	344	939	1	80	0.0125000
NODE_33503_length_539_cov_1023.604545	264	344	943	1	80	0.0125000
NODE_33503_length_539_cov_1023.604545	264	344	949	1	80	0.0125000
NODE_33503_length_539_cov_1023.604545	264	344	956	1	80	0.0125000
NODE_33503_length_539_cov_1023.604545	264	344	981	1	80	0.0125000
NODE_33503_length_539_cov_1023.604545	264	344	989	1	80	0.0125000
NODE_33503_length_539_cov_1023.604545	264	344	1001	1	80	0.0125000
NODE_33503_length_539_cov_1023.604545	264	344	1008	1	80	0.0125000
NODE_33503_length_539_cov_1023.604545	264	344	1030	1	80	0.0125000
NODE_33503_length_539_cov_1023.604545	264	344	1034	2	80	0.0250000
NODE_33503_length_539_cov_1023.604545	264	344	1045	1	80	0.0125000
NODE_33503_length_539_cov_1023.604545	264	344	1054	1	80	0.0125000
NODE_33503_length_539_cov_1023.604545	264	344	1057	1	80	0.0125000
NODE_33503_length_539_cov_1023.604545	264	344	1072	1	80	0.0125000
NODE_33503_length_539_cov_1023.604545	264	344	1076	1	80	0.0125000
NODE_33503_length_539_cov_1023.604545	264	344	1085	1	80	0.0125000
NODE_33503_length_539_cov_1023.604545	264	344	1098	1	80	0.0125000
NODE_33503_length_539_cov_1023.604545	264	344	1114	1	80	0.0125000
NODE_33503_length_539_cov_1023.604545	264	344	1141	1	80	0.0125000
NODE_33503_length_539_cov_1023.604545	264	344	1143	1	80	0.0125000
NODE_33503_length_539_cov_1023.604545	264	344	1150	1	80	0.0125000
NODE_33503_length_539_cov_1023.604545	264	344	1154	1	80	0.0125000
NODE_33503_length_539_cov_1023.604545	264	344	1170	1	80	0.0125000
NODE_33503_length_539_cov_1023.604545	264	344	1180	1	80	0.0125000
NODE_33503_length_539_cov_1023.604545	264	344	1192	1	80	0.0125000
NODE_33503_length_539_cov_1023.604545	264	344	1205	1	80	0.0125000
NODE_33503_length_539_cov_1023.604545	264	344	1207	1	80	0.0125000
NODE_33503_length_539_cov_1023.604545	264	344	1209	1	80	0.0125000
NODE_33503_length_539_cov_1023.604545	264	344	1213	1	80	0.0125000
NODE_33503_length_539_cov_1023.604545	264	344	1215	1	80	0.0125000
NODE_33503_length_539_cov_1023.604545	264	344	1229	1	80	0.0125000
NODE_33503_length_539_cov_1023.604545	264	344	1233	1	80	0.0125000
NODE_33503_length_539_cov_1023.604545	264	344	1241	1	80	0.0125000
NODE_33503_length_539_cov_1023.604545	264	344	1248	1	80	0.0125000
NODE_33503_length_539_cov_1023.604545	264	344	1250	1	80	0.0125000
NODE_33503_length_539_cov_1023.604545	317	397	1034	2	80	0.0250000
NODE_33503_length_539_cov_1023.604545	317	397	1045	1	80	0.0125000
NODE_33503_length_539_cov_1023.604545	317	397	1054	1	80	0.0125000
NODE_33503_length_539_cov_1023.604545	317	397	1057	1	80	0.0125000
NODE_33503_length_539_cov_1023.604545	317	397	1072	1	80	0.0125000
NODE_33503_length_539_cov_1023.604545	317	397	1076	1	80	0.0125000
NODE_33503_length_539_cov_1023.604545	317	397	1085	1	80	0.0125000
NODE_33503_length_539_cov_1023.604545	317	397	1098	1	80	0.0125000
NODE_33503_length_539_cov_1023.604545	317	397	1114	1	80	0.0125000
NODE_33503_length_539_cov_1023.604545	317	397	1141	1	80	0.0125000
NODE_33503_length_539_cov_1023.604545	317	397	1143	1	80	0.0125000
NODE_33503_length_539_cov_1023.604545	317	397	1150	1	80	0.0125000
NODE_33503_length_539_cov_1023.604545	317	397	1154	1	80	0.0125000
NODE_33503_length_539_cov_1023.604545	317	397	1170	1	80	0.0125000
NODE_33503_length_539_cov_1023.604545	317	397	1177	2	80	0.0250000
NODE_33503_length_539_cov_1023.604545	317	397	1180	1	80	0.0125000
NODE_33503_length_539_cov_1023.604545	317	397	1183	1	80	0.0125000
NODE_33503_length_539_cov_1023.604545	317	397	1186	1	80	0.0125000
NODE_33503_length_539_cov_1023.604545	317	397	1188	1	80	0.0125000
NODE_33503_length_539_cov_1023.604545	317	397	1191	2	80	0.0250000
NODE_33503_length_539_cov_1023.604545	317	397	1192	2	80	0.0250000
NODE_33503_length_539_cov_1023.604545	317	397	1193	2	80	0.0250000
NODE_33503_length_539_cov_1023.604545	317	397	1196	2	80	0.0250000
NODE_33503_length_539_cov_1023.604545	317	397	1199	1	80	0.0125000
NODE_33503_length_539_cov_1023.604545	317	397	1200	1	80	0.0125000
NODE_33503_length_539_cov_1023.604545	317	397	1201	1	80	0.0125000
NODE_33503_length_539_cov_1023.604545	317	397	1202	3	80	0.0375000
NODE_33503_length_539_cov_1023.604545	317	397	1204	3	80	0.0375000
NODE_33503_length_539_cov_1023.604545	317	397	1205	3	80	0.0375000
NODE_33503_length_539_cov_1023.604545	317	397	1206	1	80	0.0125000
NODE_33503_length_539_cov_1023.604545	317	397	1207	2	80	0.0250000
NODE_33503_length_539_cov_1023.604545	317	397	1209	2	80	0.0250000
NODE_33503_length_539_cov_1023.604545	317	397	1213	1	80	0.0125000
NODE_33503_length_539_cov_1023.604545	317	397	1215	1	80	0.0125000
NODE_33503_length_539_cov_1023.604545	317	397	1228	1	80	0.0125000
NODE_33503_length_539_cov_1023.604545	317	397	1229	1	80	0.0125000
NODE_33503_length_539_cov_1023.604545	317	397	1233	1	80	0.0125000
NODE_33503_length_539_cov_1023.604545	317	397	1234	1	80	0.0125000
NODE_33503_length_539_cov_1023.604545	317	397	1235	1	80	0.0125000
NODE_33503_length_539_cov_1023.604545	317	397	1241	1	80	0.0125000
NODE_33503_length_539_cov_1023.604545	317	397	1242	1	80	0.0125000
NODE_33503_length_539_cov_1023.604545	317	397	1245	1	80	0.0125000
NODE_33503_length_539_cov_1023.604545	317	397	1246	1	80	0.0125000
NODE_33503_length_539_cov_1023.604545	317	397	1248	1	80	0.0125000
NODE_33503_length_539_cov_1023.604545	317	397	1250	1	80	0.0125000
NODE_33503_length_539_cov_1023.604545	317	397	1254	2	80	0.0250000
NODE_33503_length_539_cov_1023.604545	317	397	1256	2	80	0.0250000
NODE_33503_length_539_cov_1023.604545	317	397	1258	1	80	0.0125000
NODE_33503_length_539_cov_1023.604545	317	397	1261	1	80	0.0125000
NODE_33503_length_539_cov_1023.604545	317	397	1264	2	80	0.0250000
NODE_33503_length_539_cov_1023.604545	317	397	1266	1	80	0.0125000
NODE_33503_length_539_cov_1023.604545	317	397	1267	1	80	0.0125000
NODE_33503_length_539_cov_1023.604545	317	397	1268	2	80	0.0250000
NODE_33503_length_539_cov_1023.604545	317	397	1270	1	80	0.0125000
NODE_33503_length_539_cov_1023.604545	317	397	1271	1	80	0.0125000
NODE_33503_length_539_cov_1023.604545	317	397	1272	1	80	0.0125000
NODE_33503_length_539_cov_1023.604545	317	397	1277	1	80	0.0125000
NODE_33503_length_539_cov_1023.604545	317	397	1279	1	80	0.0125000
NODE_33503_length_539_cov_1023.604545	317	397	1289	1	80	0.0125000
NODE_33503_length_539_cov_1023.604545	317	397	1292	1	80	0.0125000
NODE_33503_length_539_cov_1023.604545	317	397	1293	1	80	0.0125000
NODE_33503_length_539_cov_1023.604545	317	397	1295	1	80	0.0125000
NODE_33504_length_539_cov_99.579545	478	539	0	61	61	1.0000000
NODE_33505_length_539_cov_15.247727	217	297	0	80	80	1.0000000
NODE_33505_length_539_cov_15.247727	270	350	0	80	80	1.0000000
NODE_33506_length_539_cov_14.172727	278	350	0	72	72	1.0000000
NODE_33507_length_539_cov_13.154545	118	198	0	32	80	0.4000000
NODE_33507_length_539_cov_13.154545	118	198	1	1	80	0.0125000
NODE_33507_length_539_cov_13.154545	118	198	2	47	80	0.5875000
NODE_33507_length_539_cov_13.154545	171	251	0	80	80	1.0000000
NODE_33508_length_539_cov_10.811364	48	128	0	30	80	0.3750000
NODE_33508_length_539_cov_10.811364	48	128	13	1	80	0.0125000
NODE_33508_length_539_cov_10.811364	48	128	14	49	80	0.6125000
NODE_33508_length_539_cov_10.811364	101	181	0	7	80	0.0875000
NODE_33508_length_539_cov_10.811364	101	181	14	73	80	0.9125000
NODE_33509_length_539_cov_9.563636	201	277	0	16	76	0.2105263
NODE_33509_length_539_cov_9.563636	201	277	8	60	76	0.7894737
NODE_33510_length_539_cov_7.934091	311	369	2	53	58	0.9137931
NODE_33510_length_539_cov_7.934091	311	369	4	5	58	0.0862069
NODE_33510_length_539_cov_7.934091	342	422	2	63	80	0.7875000
NODE_33510_length_539_cov_7.934091	342	422	4	17	80	0.2125000
NODE_33517_length_539_cov_5.740909	251	319	0	68	68	1.0000000
NODE_33517_length_539_cov_5.740909	301	372	0	71	71	1.0000000
NODE_33533_length_539_cov_3.627273	80	157	0	77	77	1.0000000
NODE_33533_length_539_cov_3.627273	130	175	0	45	45	1.0000000
NODE_33569_length_539_cov_2.143182	325	371	0	46	46	1.0000000
NODE_33595_length_539_cov_1.618182	408	456	0	48	48	1.0000000
NODE_33623_length_539_cov_1.129545	97	134	0	37	37	1.0000000
NODE_33669_length_538_cov_23.193622	171	256	0	85	85	1.0000000
NODE_33669_length_538_cov_23.193622	225	305	0	80	80	1.0000000
NODE_33672_length_538_cov_7.378132	145	225	0	80	80	1.0000000
NODE_33672_length_538_cov_7.378132	198	278	0	80	80	1.0000000
NODE_33683_length_538_cov_4.496583	277	357	0	60	80	0.7500000
NODE_33683_length_538_cov_4.496583	277	357	2	20	80	0.2500000
NODE_33683_length_538_cov_4.496583	330	410	0	7	80	0.0875000
NODE_33683_length_538_cov_4.496583	330	410	2	73	80	0.9125000
NODE_33687_length_538_cov_3.753986	251	309	0	58	58	1.0000000
NODE_33713_length_538_cov_2.239180	256	338	0	55	82	0.6707317
NODE_33713_length_538_cov_2.239180	256	338	2	7	82	0.0853659
NODE_33713_length_538_cov_2.239180	256	338	8	17	82	0.2073171
NODE_33713_length_538_cov_2.239180	256	338	10	3	82	0.0365854
NODE_33814_length_538_cov_0.822323	397	477	6	5	80	0.0625000
NODE_33814_length_538_cov_0.822323	397	477	8	32	80	0.4000000
NODE_33814_length_538_cov_0.822323	397	477	10	28	80	0.3500000
NODE_33814_length_538_cov_0.822323	397	477	12	15	80	0.1875000
NODE_33852_length_537_cov_13.031963	258	309	0	51	51	1.0000000
NODE_33854_length_537_cov_9.552511	198	278	0	80	80	1.0000000
NODE_33854_length_537_cov_9.552511	251	332	0	81	81	1.0000000
NODE_33960_length_537_cov_1.244292	107	187	4	4	80	0.0500000
NODE_33960_length_537_cov_1.244292	107	187	6	7	80	0.0875000
NODE_33960_length_537_cov_1.244292	107	187	7	1	80	0.0125000
NODE_33960_length_537_cov_1.244292	107	187	8	5	80	0.0625000
NODE_33960_length_537_cov_1.244292	107	187	12	1	80	0.0125000
NODE_33960_length_537_cov_1.244292	107	187	14	3	80	0.0375000
NODE_33960_length_537_cov_1.244292	107	187	16	7	80	0.0875000
NODE_33960_length_537_cov_1.244292	107	187	20	1	80	0.0125000
NODE_33960_length_537_cov_1.244292	107	187	22	1	80	0.0125000
NODE_33960_length_537_cov_1.244292	107	187	32	1	80	0.0125000
NODE_33960_length_537_cov_1.244292	107	187	34	1	80	0.0125000
NODE_33960_length_537_cov_1.244292	107	187	36	3	80	0.0375000
NODE_33960_length_537_cov_1.244292	107	187	38	1	80	0.0125000
NODE_33960_length_537_cov_1.244292	107	187	40	4	80	0.0500000
NODE_33960_length_537_cov_1.244292	107	187	42	1	80	0.0125000
NODE_33960_length_537_cov_1.244292	107	187	43	1	80	0.0125000
NODE_33960_length_537_cov_1.244292	107	187	44	1	80	0.0125000
NODE_33960_length_537_cov_1.244292	107	187	46	9	80	0.1125000
NODE_33960_length_537_cov_1.244292	107	187	50	3	80	0.0375000
NODE_33960_length_537_cov_1.244292	107	187	52	6	80	0.0750000
NODE_33960_length_537_cov_1.244292	107	187	54	3	80	0.0375000
NODE_33960_length_537_cov_1.244292	107	187	56	3	80	0.0375000
NODE_33960_length_537_cov_1.244292	107	187	58	11	80	0.1375000
NODE_33960_length_537_cov_1.244292	107	187	60	2	80	0.0250000
NODE_34029_length_536_cov_87.622426	430	462	92	1	32	0.0312500
NODE_34029_length_536_cov_87.622426	430	462	94	1	32	0.0312500
NODE_34029_length_536_cov_87.622426	430	462	98	7	32	0.2187500
NODE_34029_length_536_cov_87.622426	430	462	102	1	32	0.0312500
NODE_34029_length_536_cov_87.622426	430	462	106	3	32	0.0937500
NODE_34029_length_536_cov_87.622426	430	462	109	3	32	0.0937500
NODE_34029_length_536_cov_87.622426	430	462	111	8	32	0.2500000
NODE_34029_length_536_cov_87.622426	430	462	113	3	32	0.0937500
NODE_34029_length_536_cov_87.622426	430	462	119	5	32	0.1562500
NODE_34030_length_536_cov_11.629291	119	199	0	80	80	1.0000000
NODE_34030_length_536_cov_11.629291	172	252	0	80	80	1.0000000
NODE_34032_length_536_cov_6.613272	286	372	0	86	86	1.0000000
NODE_34035_length_536_cov_5.810069	191	271	0	80	80	1.0000000
NODE_34035_length_536_cov_5.810069	244	324	0	80	80	1.0000000
NODE_34035_length_536_cov_5.810069	374	404	0	30	30	1.0000000
NODE_34039_length_536_cov_4.729977	202	245	0	43	43	1.0000000
NODE_34057_length_536_cov_3.297483	86	126	2	40	40	1.0000000
NODE_34068_length_536_cov_2.796339	223	280	0	57	57	1.0000000
NODE_34094_length_536_cov_1.956522	181	230	23	2	49	0.0408163
NODE_34094_length_536_cov_1.956522	181	230	24	3	49	0.0612245
NODE_34094_length_536_cov_1.956522	181	230	26	8	49	0.1632653
NODE_34094_length_536_cov_1.956522	181	230	28	7	49	0.1428571
NODE_34094_length_536_cov_1.956522	181	230	29	1	49	0.0204082
NODE_34094_length_536_cov_1.956522	181	230	30	2	49	0.0408163
NODE_34094_length_536_cov_1.956522	181	230	32	1	49	0.0204082
NODE_34094_length_536_cov_1.956522	181	230	34	1	49	0.0204082
NODE_34094_length_536_cov_1.956522	181	230	35	11	49	0.2244898
NODE_34094_length_536_cov_1.956522	181	230	36	1	49	0.0204082
NODE_34094_length_536_cov_1.956522	181	230	37	8	49	0.1632653
NODE_34094_length_536_cov_1.956522	181	230	39	4	49	0.0816327
NODE_34095_length_536_cov_1.951945	203	284	6	2	81	0.0246914
NODE_34095_length_536_cov_1.951945	203	284	7	3	81	0.0370370
NODE_34095_length_536_cov_1.951945	203	284	9	11	81	0.1358025
NODE_34095_length_536_cov_1.951945	203	284	11	13	81	0.1604938
NODE_34095_length_536_cov_1.951945	203	284	12	52	81	0.6419753
NODE_34095_length_536_cov_1.951945	306	368	4	59	62	0.9516129
NODE_34095_length_536_cov_1.951945	306	368	6	3	62	0.0483871
NODE_34209_length_535_cov_32.277523	158	238	0	80	80	1.0000000
NODE_34209_length_535_cov_32.277523	211	291	0	80	80	1.0000000
NODE_34215_length_535_cov_5.910550	110	162	2	52	52	1.0000000
NODE_34229_length_535_cov_3.795872	217	297	10	44	80	0.5500000
NODE_34229_length_535_cov_3.795872	217	297	12	36	80	0.4500000
NODE_34375_length_534_cov_54.331034	435	498	0	57	63	0.9047619
NODE_34375_length_534_cov_54.331034	435	498	7	1	63	0.0158730
NODE_34375_length_534_cov_54.331034	435	498	12	1	63	0.0158730
NODE_34375_length_534_cov_54.331034	435	498	89	2	63	0.0317460
NODE_34375_length_534_cov_54.331034	435	498	94	1	63	0.0158730
NODE_34375_length_534_cov_54.331034	435	498	96	1	63	0.0158730
NODE_34375_length_534_cov_54.331034	471	534	0	63	63	1.0000000
NODE_34377_length_534_cov_15.462069	460	534	0	46	74	0.6216216
NODE_34377_length_534_cov_15.462069	460	534	2	28	74	0.3783784
NODE_34377_length_534_cov_15.462069	512	534	0	22	22	1.0000000
NODE_34378_length_534_cov_10.308046	268	348	0	80	80	1.0000000
NODE_34378_length_534_cov_10.308046	321	401	0	80	80	1.0000000
NODE_34380_length_534_cov_9.041379	204	284	0	80	80	1.0000000
NODE_34380_length_534_cov_9.041379	257	332	0	75	75	1.0000000
NODE_34383_length_534_cov_6.958621	273	303	0	30	30	1.0000000
NODE_34392_length_534_cov_5.022989	291	371	2	4	80	0.0500000
NODE_34392_length_534_cov_5.022989	291	371	4	1	80	0.0125000
NODE_34392_length_534_cov_5.022989	291	371	6	8	80	0.1000000
NODE_34392_length_534_cov_5.022989	291	371	10	17	80	0.2125000
NODE_34392_length_534_cov_5.022989	291	371	12	50	80	0.6250000
NODE_34402_length_534_cov_3.873563	110	190	0	62	80	0.7750000
NODE_34402_length_534_cov_3.873563	110	190	2	18	80	0.2250000
NODE_34409_length_534_cov_3.202299	221	301	0	57	80	0.7125000
NODE_34409_length_534_cov_3.202299	221	301	2	23	80	0.2875000
NODE_34411_length_534_cov_3.158621	171	200	2	29	29	1.0000000
NODE_34418_length_534_cov_3.002299	175	219	2	1	44	0.0227273
NODE_34418_length_534_cov_3.002299	175	219	4	43	44	0.9772727
NODE_34489_length_534_cov_1.344828	475	518	0	43	43	1.0000000
NODE_34494_length_534_cov_1.291954	273	336	4	18	63	0.2857143
NODE_34494_length_534_cov_1.291954	273	336	8	45	63	0.7142857
NODE_34511_length_534_cov_1.160920	227	264	0	8	37	0.2162162
NODE_34511_length_534_cov_1.160920	227	264	4	29	37	0.7837838
NODE_34570_length_533_cov_13.956221	216	296	0	80	80	1.0000000
NODE_34570_length_533_cov_13.956221	269	349	0	80	80	1.0000000
NODE_34575_length_533_cov_8.207373	244	322	0	37	78	0.4743590
NODE_34575_length_533_cov_8.207373	244	322	4	41	78	0.5256410
NODE_34576_length_533_cov_8.023041	230	310	0	41	80	0.5125000
NODE_34576_length_533_cov_8.023041	230	310	2	39	80	0.4875000
NODE_34576_length_533_cov_8.023041	283	364	0	81	81	1.0000000
NODE_34585_length_533_cov_5.170507	308	369	0	61	61	1.0000000
NODE_34588_length_533_cov_4.988479	229	309	0	80	80	1.0000000
NODE_34588_length_533_cov_4.988479	282	362	0	80	80	1.0000000
NODE_34600_length_533_cov_3.638249	201	265	2	64	64	1.0000000
NODE_34603_length_533_cov_3.511521	138	218	5	80	80	1.0000000
NODE_34615_length_533_cov_3.073733	294	340	0	46	46	1.0000000
NODE_34617_length_533_cov_3.052995	256	304	4	48	48	1.0000000
NODE_34631_length_533_cov_2.366359	229	311	2	3	82	0.0365854
NODE_34631_length_533_cov_2.366359	229	311	3	2	82	0.0243902
NODE_34631_length_533_cov_2.366359	229	311	4	5	82	0.0609756
NODE_34631_length_533_cov_2.366359	229	311	6	10	82	0.1219512
NODE_34631_length_533_cov_2.366359	229	311	7	2	82	0.0243902
NODE_34631_length_533_cov_2.366359	229	311	10	4	82	0.0487805
NODE_34631_length_533_cov_2.366359	229	311	11	1	82	0.0121951
NODE_34631_length_533_cov_2.366359	229	311	12	55	82	0.6707317
NODE_34635_length_533_cov_2.288018	468	490	0	22	22	1.0000000
NODE_34767_length_532_cov_73.279446	0	64	0	3	64	0.0468750
NODE_34767_length_532_cov_73.279446	0	64	4	21	64	0.3281250
NODE_34767_length_532_cov_73.279446	0	64	6	26	64	0.4062500
NODE_34767_length_532_cov_73.279446	0	64	7	8	64	0.1250000
NODE_34767_length_532_cov_73.279446	0	64	8	6	64	0.0937500
NODE_34768_length_532_cov_23.055427	168	248	0	29	80	0.3625000
NODE_34768_length_532_cov_23.055427	168	248	2	51	80	0.6375000
NODE_34768_length_532_cov_23.055427	221	301	0	21	80	0.2625000
NODE_34768_length_532_cov_23.055427	221	301	2	59	80	0.7375000
NODE_34769_length_532_cov_22.778291	256	336	0	80	80	1.0000000
NODE_34769_length_532_cov_22.778291	309	389	0	80	80	1.0000000
NODE_34770_length_532_cov_13.279446	85	165	0	80	80	1.0000000
NODE_34770_length_532_cov_13.279446	138	218	0	80	80	1.0000000
NODE_34774_length_532_cov_7.591224	171	235	0	64	64	1.0000000
NODE_34774_length_532_cov_7.591224	172	235	0	63	63	1.0000000
NODE_34774_length_532_cov_7.591224	173	226	0	53	53	1.0000000
NODE_34774_length_532_cov_7.591224	173	228	0	55	55	1.0000000
NODE_34774_length_532_cov_7.591224	208	282	0	74	74	1.0000000
NODE_34774_length_532_cov_7.591224	208	282	0	74	74	1.0000000
NODE_34774_length_532_cov_7.591224	208	282	0	74	74	1.0000000
NODE_34774_length_532_cov_7.591224	208	282	0	74	74	1.0000000
NODE_34788_length_532_cov_4.524249	84	151	0	67	67	1.0000000
NODE_34788_length_532_cov_4.524249	137	218	0	81	81	1.0000000
NODE_34838_length_532_cov_1.866051	263	309	0	46	46	1.0000000
NODE_34845_length_532_cov_1.757506	126	146	0	20	20	1.0000000
NODE_34948_length_531_cov_35.539352	7	45	0	38	38	1.0000000
NODE_34948_length_531_cov_35.539352	18	98	0	43	80	0.5375000
NODE_34948_length_531_cov_35.539352	18	98	2	37	80	0.4625000
NODE_34949_length_531_cov_13.162037	129	209	0	80	80	1.0000000
NODE_34949_length_531_cov_13.162037	182	251	0	69	69	1.0000000
NODE_34953_length_531_cov_6.821759	242	322	0	80	80	1.0000000
NODE_34953_length_531_cov_6.821759	295	375	0	80	80	1.0000000
NODE_34958_length_531_cov_5.261574	261	336	4	2	75	0.0266667
NODE_34958_length_531_cov_5.261574	261	336	6	19	75	0.2533333
NODE_34958_length_531_cov_5.261574	261	336	8	54	75	0.7200000
NODE_34958_length_531_cov_5.261574	309	362	2	10	53	0.1886792
NODE_34958_length_531_cov_5.261574	309	362	4	3	53	0.0566038
NODE_34958_length_531_cov_5.261574	309	362	6	15	53	0.2830189
NODE_34958_length_531_cov_5.261574	309	362	8	25	53	0.4716981
NODE_34963_length_531_cov_4.527778	177	255	0	78	78	1.0000000
NODE_34965_length_531_cov_4.319444	283	363	0	80	80	1.0000000
NODE_34965_length_531_cov_4.319444	336	416	0	80	80	1.0000000
NODE_34979_length_531_cov_3.488426	238	318	0	80	80	1.0000000
NODE_34979_length_531_cov_3.488426	291	371	0	80	80	1.0000000
NODE_34980_length_531_cov_3.375000	153	207	0	11	54	0.2037037
NODE_34980_length_531_cov_3.375000	153	207	2	22	54	0.4074074
NODE_34980_length_531_cov_3.375000	153	207	4	4	54	0.0740741
NODE_34980_length_531_cov_3.375000	153	207	5	17	54	0.3148148
NODE_34980_length_531_cov_3.375000	180	260	2	6	80	0.0750000
NODE_34980_length_531_cov_3.375000	180	260	4	23	80	0.2875000
NODE_34980_length_531_cov_3.375000	180	260	5	39	80	0.4875000
NODE_34980_length_531_cov_3.375000	180	260	6	12	80	0.1500000
NODE_34986_length_531_cov_3.111111	243	323	0	80	80	1.0000000
NODE_34986_length_531_cov_3.111111	296	376	0	80	80	1.0000000
NODE_35008_length_531_cov_2.201389	302	373	0	2	71	0.0281690
NODE_35008_length_531_cov_2.201389	302	373	4	19	71	0.2676056
NODE_35008_length_531_cov_2.201389	302	373	6	15	71	0.2112676
NODE_35008_length_531_cov_2.201389	302	373	8	35	71	0.4929577
NODE_35008_length_531_cov_2.201389	350	426	0	1	76	0.0131579
NODE_35008_length_531_cov_2.201389	350	426	2	8	76	0.1052632
NODE_35008_length_531_cov_2.201389	350	426	4	1	76	0.0131579
NODE_35008_length_531_cov_2.201389	350	426	6	8	76	0.1052632
NODE_35008_length_531_cov_2.201389	350	426	8	58	76	0.7631579
NODE_35141_length_530_cov_30.605568	250	330	2	74	80	0.9250000
NODE_35141_length_530_cov_30.605568	250	330	6	6	80	0.0750000
NODE_35141_length_530_cov_30.605568	303	383	2	21	80	0.2625000
NODE_35141_length_530_cov_30.605568	303	383	4	30	80	0.3750000
NODE_35141_length_530_cov_30.605568	303	383	6	29	80	0.3625000
NODE_35142_length_530_cov_16.937355	404	484	2	3	80	0.0375000
NODE_35142_length_530_cov_16.937355	404	484	4	3	80	0.0375000
NODE_35142_length_530_cov_16.937355	404	484	6	1	80	0.0125000
NODE_35142_length_530_cov_16.937355	404	484	8	1	80	0.0125000
NODE_35142_length_530_cov_16.937355	404	484	16	7	80	0.0875000
NODE_35142_length_530_cov_16.937355	404	484	18	65	80	0.8125000
NODE_35142_length_530_cov_16.937355	457	530	2	18	73	0.2465753
NODE_35142_length_530_cov_16.937355	457	530	18	55	73	0.7534246
NODE_35143_length_530_cov_9.902552	273	353	0	80	80	1.0000000
NODE_35143_length_530_cov_9.902552	326	406	0	80	80	1.0000000
NODE_35144_length_530_cov_7.928074	46	126	0	80	80	1.0000000
NODE_35144_length_530_cov_7.928074	99	179	0	80	80	1.0000000
NODE_35150_length_530_cov_4.647332	188	268	0	80	80	1.0000000
NODE_35150_length_530_cov_4.647332	241	321	0	80	80	1.0000000
NODE_35154_length_530_cov_4.389791	162	242	10	3	80	0.0375000
NODE_35154_length_530_cov_4.389791	162	242	11	1	80	0.0125000
NODE_35154_length_530_cov_4.389791	162	242	12	26	80	0.3250000
NODE_35154_length_530_cov_4.389791	162	242	18	6	80	0.0750000
NODE_35154_length_530_cov_4.389791	162	242	22	12	80	0.1500000
NODE_35154_length_530_cov_4.389791	162	242	24	3	80	0.0375000
NODE_35154_length_530_cov_4.389791	162	242	25	7	80	0.0875000
NODE_35154_length_530_cov_4.389791	162	242	27	4	80	0.0500000
NODE_35154_length_530_cov_4.389791	162	242	28	6	80	0.0750000
NODE_35154_length_530_cov_4.389791	162	242	29	12	80	0.1500000
NODE_35159_length_530_cov_4.046404	76	111	0	35	35	1.0000000
NODE_35319_length_529_cov_38.983721	140	220	0	41	80	0.5125000
NODE_35319_length_529_cov_38.983721	140	220	2	39	80	0.4875000
NODE_35320_length_529_cov_18.223256	189	269	0	80	80	1.0000000
NODE_35320_length_529_cov_18.223256	242	322	0	80	80	1.0000000
NODE_35321_length_529_cov_17.009302	358	438	0	80	80	1.0000000
NODE_35321_length_529_cov_17.009302	411	491	0	80	80	1.0000000
NODE_35331_length_529_cov_6.195349	211	291	0	80	80	1.0000000
NODE_35331_length_529_cov_6.195349	264	322	0	58	58	1.0000000
NODE_35336_length_529_cov_5.176744	139	207	0	45	68	0.6617647
NODE_35336_length_529_cov_5.176744	139	207	2	23	68	0.3382353
NODE_35336_length_529_cov_5.176744	185	260	2	75	75	1.0000000
NODE_35364_length_529_cov_2.883721	223	281	0	58	58	1.0000000
NODE_35374_length_529_cov_2.660465	89	168	0	15	79	0.1898734
NODE_35374_length_529_cov_2.660465	89	168	4	64	79	0.8101266
NODE_35375_length_529_cov_2.595349	278	321	0	43	43	1.0000000
NODE_35384_length_529_cov_2.272093	247	313	0	66	66	1.0000000
NODE_35427_length_529_cov_1.597674	289	332	0	43	43	1.0000000
NODE_35521_length_528_cov_25.808858	233	313	0	16	80	0.2000000
NODE_35521_length_528_cov_25.808858	233	313	2	64	80	0.8000000
NODE_35521_length_528_cov_25.808858	286	366	0	69	80	0.8625000
NODE_35521_length_528_cov_25.808858	286	366	2	11	80	0.1375000
NODE_35522_length_528_cov_17.331002	219	299	0	80	80	1.0000000
NODE_35522_length_528_cov_17.331002	272	352	0	80	80	1.0000000
NODE_35523_length_528_cov_16.165501	262	342	0	80	80	1.0000000
NODE_35523_length_528_cov_16.165501	315	395	0	80	80	1.0000000
NODE_35529_length_528_cov_5.776224	204	284	0	17	80	0.2125000
NODE_35529_length_528_cov_5.776224	204	284	4	63	80	0.7875000
NODE_35529_length_528_cov_5.776224	257	337	0	31	80	0.3875000
NODE_35529_length_528_cov_5.776224	257	337	3	2	80	0.0250000
NODE_35529_length_528_cov_5.776224	257	337	4	47	80	0.5875000
NODE_35542_length_528_cov_4.016317	235	315	0	80	80	1.0000000
NODE_35542_length_528_cov_4.016317	288	368	0	80	80	1.0000000
NODE_35545_length_528_cov_3.799534	144	192	0	48	48	1.0000000
NODE_35561_length_528_cov_2.902098	252	305	4	24	53	0.4528302
NODE_35561_length_528_cov_2.902098	252	305	6	29	53	0.5471698
NODE_35575_length_528_cov_2.324009	137	188	5	20	51	0.3921569
NODE_35575_length_528_cov_2.324009	137	188	6	28	51	0.5490196
NODE_35575_length_528_cov_2.324009	137	188	8	3	51	0.0588235
NODE_35575_length_528_cov_2.324009	161	241	0	14	80	0.1750000
NODE_35575_length_528_cov_2.324009	161	241	4	7	80	0.0875000
NODE_35575_length_528_cov_2.324009	161	241	5	52	80	0.6500000
NODE_35575_length_528_cov_2.324009	161	241	6	7	80	0.0875000
NODE_35597_length_528_cov_1.755245	268	348	2	18	80	0.2250000
NODE_35597_length_528_cov_1.755245	268	348	4	62	80	0.7750000
NODE_35597_length_528_cov_1.755245	321	401	0	35	80	0.4375000
NODE_35597_length_528_cov_1.755245	321	401	2	25	80	0.3125000
NODE_35597_length_528_cov_1.755245	321	401	4	20	80	0.2500000
NODE_35687_length_527_cov_19.247664	306	386	0	80	80	1.0000000
NODE_35687_length_527_cov_19.247664	359	439	0	80	80	1.0000000
NODE_35688_length_527_cov_15.974299	250	349	0	99	99	1.0000000
NODE_35688_length_527_cov_15.974299	322	402	0	80	80	1.0000000
NODE_35691_length_527_cov_8.221963	235	315	0	70	80	0.8750000
NODE_35691_length_527_cov_8.221963	235	315	2	10	80	0.1250000
NODE_35691_length_527_cov_8.221963	288	368	0	17	80	0.2125000
NODE_35691_length_527_cov_8.221963	288	368	2	36	80	0.4500000
NODE_35691_length_527_cov_8.221963	288	368	4	27	80	0.3375000
NODE_35693_length_527_cov_7.200935	190	270	0	80	80	1.0000000
NODE_35693_length_527_cov_7.200935	243	346	0	103	103	1.0000000
NODE_35693_length_527_cov_7.200935	342	422	0	80	80	1.0000000
NODE_35693_length_527_cov_7.200935	395	475	0	80	80	1.0000000
NODE_35696_length_527_cov_6.862150	279	359	0	80	80	1.0000000
NODE_35697_length_527_cov_6.046729	155	235	0	80	80	1.0000000
NODE_35697_length_527_cov_6.046729	208	288	0	80	80	1.0000000
NODE_35736_length_527_cov_2.238318	226	306	0	80	80	1.0000000
NODE_35858_length_526_cov_50.866511	169	242	0	42	73	0.5753425
NODE_35858_length_526_cov_50.866511	169	242	2	31	73	0.4246575
NODE_35858_length_526_cov_50.866511	215	295	2	80	80	1.0000000
NODE_35858_length_526_cov_50.866511	291	371	0	71	80	0.8875000
NODE_35858_length_526_cov_50.866511	291	371	1	1	80	0.0125000
NODE_35858_length_526_cov_50.866511	291	371	2	8	80	0.1000000
NODE_35858_length_526_cov_50.866511	344	424	0	80	80	1.0000000
NODE_35860_length_526_cov_26.395785	315	395	6	21	80	0.2625000
NODE_35860_length_526_cov_26.395785	315	395	8	59	80	0.7375000
NODE_35860_length_526_cov_26.395785	368	448	6	74	80	0.9250000
NODE_35860_length_526_cov_26.395785	368	448	8	6	80	0.0750000
NODE_35861_length_526_cov_16.611241	305	385	0	80	80	1.0000000
NODE_35861_length_526_cov_16.611241	358	438	0	80	80	1.0000000
NODE_35866_length_526_cov_6.215457	303	351	0	48	48	1.0000000
NODE_35877_length_526_cov_3.936768	118	142	0	24	24	1.0000000
NODE_35877_length_526_cov_3.936768	118	163	0	45	45	1.0000000
NODE_35901_length_526_cov_2.466042	138	184	0	46	46	1.0000000
NODE_36055_length_525_cov_33.910798	98	178	2	32	80	0.4000000
NODE_36055_length_525_cov_33.910798	98	178	3	1	80	0.0125000
NODE_36055_length_525_cov_33.910798	98	178	4	1	80	0.0125000
NODE_36055_length_525_cov_33.910798	98	178	5	19	80	0.2375000
NODE_36055_length_525_cov_33.910798	98	178	6	27	80	0.3375000
NODE_36055_length_525_cov_33.910798	151	231	2	80	80	1.0000000
NODE_36055_length_525_cov_33.910798	159	231	2	72	72	1.0000000
NODE_36058_length_525_cov_8.788732	175	255	0	80	80	1.0000000
NODE_36058_length_525_cov_8.788732	228	308	0	80	80	1.0000000
NODE_36059_length_525_cov_7.880282	242	285	0	43	43	1.0000000
NODE_36098_length_525_cov_2.417840	229	306	4	8	77	0.1038961
NODE_36098_length_525_cov_2.417840	229	306	6	16	77	0.2077922
NODE_36098_length_525_cov_2.417840	229	306	8	53	77	0.6883117
NODE_36230_length_524_cov_21.649412	262	342	0	80	80	1.0000000
NODE_36230_length_524_cov_21.649412	315	395	0	80	80	1.0000000
NODE_36231_length_524_cov_14.131765	136	201	0	65	65	1.0000000
NODE_36232_length_524_cov_10.392941	237	317	0	55	80	0.6875000
NODE_36232_length_524_cov_10.392941	237	317	2	25	80	0.3125000
NODE_36232_length_524_cov_10.392941	290	370	0	2	80	0.0250000
NODE_36232_length_524_cov_10.392941	290	370	2	78	80	0.9750000
NODE_36262_length_524_cov_3.221176	195	272	0	77	77	1.0000000
NODE_36262_length_524_cov_3.221176	253	324	0	71	71	1.0000000
NODE_36264_length_524_cov_3.148235	317	397	0	80	80	1.0000000
NODE_36410_length_523_cov_113.438679	0	48	0	20	48	0.4166667
NODE_36410_length_523_cov_113.438679	0	48	2	4	48	0.0833333
NODE_36410_length_523_cov_113.438679	0	48	10	18	48	0.3750000
NODE_36410_length_523_cov_113.438679	0	48	12	2	48	0.0416667
NODE_36410_length_523_cov_113.438679	0	48	15	4	48	0.0833333
NODE_36410_length_523_cov_113.438679	14	69	0	6	55	0.1090909
NODE_36410_length_523_cov_113.438679	14	69	2	4	55	0.0727273
NODE_36410_length_523_cov_113.438679	14	69	10	18	55	0.3272727
NODE_36410_length_523_cov_113.438679	14	69	12	2	55	0.0363636
NODE_36410_length_523_cov_113.438679	14	69	15	10	55	0.1818182
NODE_36410_length_523_cov_113.438679	14	69	19	2	55	0.0363636
NODE_36410_length_523_cov_113.438679	14	69	25	1	55	0.0181818
NODE_36410_length_523_cov_113.438679	14	69	26	6	55	0.1090909
NODE_36410_length_523_cov_113.438679	14	69	27	4	55	0.0727273
NODE_36410_length_523_cov_113.438679	14	69	28	1	55	0.0181818
NODE_36410_length_523_cov_113.438679	14	69	30	1	55	0.0181818
NODE_36410_length_523_cov_113.438679	25	101	10	17	76	0.2236842
NODE_36410_length_523_cov_113.438679	25	101	12	2	76	0.0263158
NODE_36410_length_523_cov_113.438679	25	101	15	10	76	0.1315790
NODE_36410_length_523_cov_113.438679	25	101	19	2	76	0.0263158
NODE_36410_length_523_cov_113.438679	25	101	25	1	76	0.0131579
NODE_36410_length_523_cov_113.438679	25	101	26	6	76	0.0789474
NODE_36410_length_523_cov_113.438679	25	101	27	4	76	0.0526316
NODE_36410_length_523_cov_113.438679	25	101	28	1	76	0.0131579
NODE_36410_length_523_cov_113.438679	25	101	30	12	76	0.1578947
NODE_36410_length_523_cov_113.438679	25	101	33	2	76	0.0263158
NODE_36410_length_523_cov_113.438679	25	101	35	2	76	0.0263158
NODE_36410_length_523_cov_113.438679	25	101	37	17	76	0.2236842
NODE_36410_length_523_cov_113.438679	105	181	37	3	76	0.0394737
NODE_36410_length_523_cov_113.438679	105	181	39	2	76	0.0263158
NODE_36410_length_523_cov_113.438679	105	181	40	4	76	0.0526316
NODE_36410_length_523_cov_113.438679	105	181	41	1	76	0.0131579
NODE_36410_length_523_cov_113.438679	105	181	42	1	76	0.0131579
NODE_36410_length_523_cov_113.438679	105	181	44	4	76	0.0526316
NODE_36410_length_523_cov_113.438679	105	181	50	2	76	0.0263158
NODE_36410_length_523_cov_113.438679	105	181	64	7	76	0.0921053
NODE_36410_length_523_cov_113.438679	105	181	66	4	76	0.0526316
NODE_36410_length_523_cov_113.438679	105	181	68	2	76	0.0263158
NODE_36410_length_523_cov_113.438679	105	181	70	4	76	0.0526316
NODE_36410_length_523_cov_113.438679	105	181	76	5	76	0.0657895
NODE_36410_length_523_cov_113.438679	105	181	78	6	76	0.0789474
NODE_36410_length_523_cov_113.438679	105	181	80	1	76	0.0131579
NODE_36410_length_523_cov_113.438679	105	181	82	4	76	0.0526316
NODE_36410_length_523_cov_113.438679	105	181	84	1	76	0.0131579
NODE_36410_length_523_cov_113.438679	105	181	85	4	76	0.0526316
NODE_36410_length_523_cov_113.438679	105	181	86	3	76	0.0394737
NODE_36410_length_523_cov_113.438679	105	181	87	3	76	0.0394737
NODE_36410_length_523_cov_113.438679	105	181	89	1	76	0.0131579
NODE_36410_length_523_cov_113.438679	105	181	91	5	76	0.0657895
NODE_36410_length_523_cov_113.438679	105	181	93	3	76	0.0394737
NODE_36410_length_523_cov_113.438679	105	181	94	2	76	0.0263158
NODE_36410_length_523_cov_113.438679	105	181	95	4	76	0.0526316
NODE_36410_length_523_cov_113.438679	154	234	43	1	80	0.0125000
NODE_36410_length_523_cov_113.438679	154	234	46	1	80	0.0125000
NODE_36410_length_523_cov_113.438679	154	234	47	2	80	0.0250000
NODE_36410_length_523_cov_113.438679	154	234	50	1	80	0.0125000
NODE_36410_length_523_cov_113.438679	154	234	56	2	80	0.0250000
NODE_36410_length_523_cov_113.438679	154	234	58	1	80	0.0125000
NODE_36410_length_523_cov_113.438679	154	234	67	2	80	0.0250000
NODE_36410_length_523_cov_113.438679	154	234	73	6	80	0.0750000
NODE_36410_length_523_cov_113.438679	154	234	74	1	80	0.0125000
NODE_36410_length_523_cov_113.438679	154	234	75	2	80	0.0250000
NODE_36410_length_523_cov_113.438679	154	234	76	3	80	0.0375000
NODE_36410_length_523_cov_113.438679	154	234	77	2	80	0.0250000
NODE_36410_length_523_cov_113.438679	154	234	79	4	80	0.0500000
NODE_36410_length_523_cov_113.438679	154	234	82	1	80	0.0125000
NODE_36410_length_523_cov_113.438679	154	234	84	1	80	0.0125000
NODE_36410_length_523_cov_113.438679	154	234	85	4	80	0.0500000
NODE_36410_length_523_cov_113.438679	154	234	86	4	80	0.0500000
NODE_36410_length_523_cov_113.438679	154	234	87	14	80	0.1750000
NODE_36410_length_523_cov_113.438679	154	234	88	1	80	0.0125000
NODE_36410_length_523_cov_113.438679	154	234	89	1	80	0.0125000
NODE_36410_length_523_cov_113.438679	154	234	91	5	80	0.0625000
NODE_36410_length_523_cov_113.438679	154	234	92	7	80	0.0875000
NODE_36410_length_523_cov_113.438679	154	234	93	3	80	0.0375000
NODE_36410_length_523_cov_113.438679	154	234	94	7	80	0.0875000
NODE_36410_length_523_cov_113.438679	154	234	95	4	80	0.0500000
NODE_36410_length_523_cov_113.438679	312	355	11	1	43	0.0232558
NODE_36410_length_523_cov_113.438679	312	355	13	7	43	0.1627907
NODE_36410_length_523_cov_113.438679	312	355	16	5	43	0.1162791
NODE_36410_length_523_cov_113.438679	312	355	26	30	43	0.6976744
NODE_36412_length_523_cov_64.695755	35	115	0	80	80	1.0000000
NODE_36412_length_523_cov_64.695755	88	168	0	80	80	1.0000000
NODE_36414_length_523_cov_20.724057	235	315	0	80	80	1.0000000
NODE_36414_length_523_cov_20.724057	288	368	0	80	80	1.0000000
NODE_36415_length_523_cov_18.500000	164	244	0	80	80	1.0000000
NODE_36415_length_523_cov_18.500000	217	297	0	80	80	1.0000000
NODE_36416_length_523_cov_15.216981	62	142	0	80	80	1.0000000
NODE_36416_length_523_cov_15.216981	115	195	0	52	80	0.6500000
NODE_36416_length_523_cov_15.216981	115	195	2	28	80	0.3500000
NODE_36417_length_523_cov_10.575472	157	183	0	26	26	1.0000000
NODE_36418_length_523_cov_9.962264	212	292	0	80	80	1.0000000
NODE_36418_length_523_cov_9.962264	265	345	0	80	80	1.0000000
NODE_36427_length_523_cov_4.943396	108	188	12	4	80	0.0500000
NODE_36427_length_523_cov_4.943396	108	188	14	11	80	0.1375000
NODE_36427_length_523_cov_4.943396	108	188	15	3	80	0.0375000
NODE_36427_length_523_cov_4.943396	108	188	16	36	80	0.4500000
NODE_36427_length_523_cov_4.943396	108	188	17	3	80	0.0375000
NODE_36427_length_523_cov_4.943396	108	188	18	5	80	0.0625000
NODE_36427_length_523_cov_4.943396	108	188	19	1	80	0.0125000
NODE_36427_length_523_cov_4.943396	108	188	20	12	80	0.1500000
NODE_36427_length_523_cov_4.943396	108	188	22	5	80	0.0625000
NODE_36427_length_523_cov_4.943396	161	241	12	7	80	0.0875000
NODE_36427_length_523_cov_4.943396	161	241	13	8	80	0.1000000
NODE_36427_length_523_cov_4.943396	161	241	14	18	80	0.2250000
NODE_36427_length_523_cov_4.943396	161	241	15	1	80	0.0125000
NODE_36427_length_523_cov_4.943396	161	241	16	18	80	0.2250000
NODE_36427_length_523_cov_4.943396	161	241	18	4	80	0.0500000
NODE_36427_length_523_cov_4.943396	161	241	19	1	80	0.0125000
NODE_36427_length_523_cov_4.943396	161	241	20	18	80	0.2250000
NODE_36427_length_523_cov_4.943396	161	241	22	5	80	0.0625000
NODE_36429_length_523_cov_4.787736	110	141	20	17	31	0.5483871
NODE_36429_length_523_cov_4.787736	110	141	22	14	31	0.4516129
NODE_36429_length_523_cov_4.787736	131	194	13	1	63	0.0158730
NODE_36429_length_523_cov_4.787736	131	194	15	11	63	0.1746032
NODE_36429_length_523_cov_4.787736	131	194	16	2	63	0.0317460
NODE_36429_length_523_cov_4.787736	131	194	17	2	63	0.0317460
NODE_36429_length_523_cov_4.787736	131	194	19	5	63	0.0793651
NODE_36429_length_523_cov_4.787736	131	194	22	26	63	0.4126984
NODE_36429_length_523_cov_4.787736	131	194	26	10	63	0.1587302
NODE_36429_length_523_cov_4.787736	131	194	27	6	63	0.0952381
NODE_36439_length_523_cov_3.792453	139	219	0	80	80	1.0000000
NODE_36439_length_523_cov_3.792453	192	272	0	80	80	1.0000000
NODE_36481_length_523_cov_2.259434	337	372	0	9	35	0.2571429
NODE_36481_length_523_cov_2.259434	337	372	2	2	35	0.0571429
NODE_36481_length_523_cov_2.259434	337	372	3	24	35	0.6857143
NODE_36490_length_523_cov_2.096698	307	351	1	8	44	0.1818182
NODE_36490_length_523_cov_2.096698	307	351	5	8	44	0.1818182
NODE_36490_length_523_cov_2.096698	307	351	7	4	44	0.0909091
NODE_36490_length_523_cov_2.096698	307	351	9	10	44	0.2272727
NODE_36490_length_523_cov_2.096698	307	351	10	4	44	0.0909091
NODE_36490_length_523_cov_2.096698	307	351	11	10	44	0.2272727
NODE_36518_length_523_cov_1.700472	176	195	0	4	19	0.2105263
NODE_36518_length_523_cov_1.700472	176	195	1	15	19	0.7894737
NODE_36632_length_522_cov_33.579196	55	135	0	80	80	1.0000000
NODE_36632_length_522_cov_33.579196	108	188	0	80	80	1.0000000
NODE_36634_length_522_cov_12.851064	266	342	0	76	76	1.0000000
NODE_36634_length_522_cov_12.851064	319	395	0	76	76	1.0000000
NODE_36637_length_522_cov_7.349882	212	283	0	71	71	1.0000000
NODE_36637_length_522_cov_7.349882	400	469	0	69	69	1.0000000
NODE_36670_length_522_cov_2.933806	178	258	0	80	80	1.0000000
NODE_36670_length_522_cov_2.933806	231	311	0	80	80	1.0000000
NODE_36676_length_522_cov_2.661939	187	241	0	54	54	1.0000000
NODE_36820_length_521_cov_9.303318	106	186	0	80	80	1.0000000
NODE_36820_length_521_cov_9.303318	159	239	0	80	80	1.0000000
NODE_36832_length_521_cov_4.971564	218	298	0	80	80	1.0000000
NODE_36832_length_521_cov_4.971564	271	351	0	80	80	1.0000000
NODE_36845_length_521_cov_3.504739	113	191	0	62	78	0.7948718
NODE_36845_length_521_cov_3.504739	113	191	6	16	78	0.2051282
NODE_36845_length_521_cov_3.504739	164	205	0	41	41	1.0000000
NODE_36848_length_521_cov_3.324645	158	244	0	40	86	0.4651163
NODE_36848_length_521_cov_3.324645	158	244	6	46	86	0.5348837
NODE_36848_length_521_cov_3.324645	217	280	6	63	63	1.0000000
NODE_36916_length_521_cov_1.613744	165	227	0	62	62	1.0000000
NODE_37036_length_520_cov_50.676960	0	75	0	75	75	1.0000000
NODE_37036_length_520_cov_50.676960	48	128	0	80	80	1.0000000
NODE_37036_length_520_cov_50.676960	124	204	0	70	80	0.8750000
NODE_37036_length_520_cov_50.676960	124	204	2	10	80	0.1250000
NODE_37036_length_520_cov_50.676960	177	257	0	17	80	0.2125000
NODE_37036_length_520_cov_50.676960	177	257	2	63	80	0.7875000
NODE_37037_length_520_cov_43.294537	10	90	0	80	80	1.0000000
NODE_37037_length_520_cov_43.294537	10	90	0	80	80	1.0000000
NODE_37037_length_520_cov_43.294537	10	90	0	80	80	1.0000000
NODE_37037_length_520_cov_43.294537	10	90	0	80	80	1.0000000
NODE_37037_length_520_cov_43.294537	10	90	0	80	80	1.0000000
NODE_37037_length_520_cov_43.294537	10	90	0	80	80	1.0000000
NODE_37037_length_520_cov_43.294537	63	129	0	66	66	1.0000000
NODE_37037_length_520_cov_43.294537	63	142	0	79	79	1.0000000
NODE_37037_length_520_cov_43.294537	63	143	0	80	80	1.0000000
NODE_37037_length_520_cov_43.294537	63	133	0	70	70	1.0000000
NODE_37037_length_520_cov_43.294537	66	133	0	67	67	1.0000000
NODE_37037_length_520_cov_43.294537	68	143	0	75	75	1.0000000
NODE_37038_length_520_cov_29.427553	224	304	0	80	80	1.0000000
NODE_37038_length_520_cov_29.427553	277	357	0	80	80	1.0000000
NODE_37038_length_520_cov_29.427553	353	433	0	80	80	1.0000000
NODE_37038_length_520_cov_29.427553	406	486	0	80	80	1.0000000
NODE_37039_length_520_cov_14.365796	103	183	0	80	80	1.0000000
NODE_37039_length_520_cov_14.365796	156	237	0	81	81	1.0000000
NODE_37059_length_520_cov_4.121140	79	159	0	80	80	1.0000000
NODE_37059_length_520_cov_4.121140	132	212	0	80	80	1.0000000
NODE_37063_length_520_cov_3.900238	203	233	2	30	30	1.0000000
NODE_37235_length_519_cov_42.842857	8	88	7	1	80	0.0125000
NODE_37235_length_519_cov_42.842857	8	88	8	79	80	0.9875000
NODE_37235_length_519_cov_42.842857	61	139	2	9	78	0.1153846
NODE_37235_length_519_cov_42.842857	61	139	3	6	78	0.0769231
NODE_37235_length_519_cov_42.842857	61	139	4	8	78	0.1025641
NODE_37235_length_519_cov_42.842857	61	139	8	49	78	0.6282051
NODE_37235_length_519_cov_42.842857	61	139	9	1	78	0.0128205
NODE_37235_length_519_cov_42.842857	61	139	10	5	78	0.0641026
NODE_37236_length_519_cov_19.269048	284	363	8	79	79	1.0000000
NODE_37236_length_519_cov_19.269048	336	416	0	46	80	0.5750000
NODE_37236_length_519_cov_19.269048	336	416	8	34	80	0.4250000
NODE_37237_length_519_cov_8.500000	195	267	0	16	72	0.2222222
NODE_37237_length_519_cov_8.500000	195	267	6	56	72	0.7777778
NODE_37245_length_519_cov_5.169048	282	346	0	64	64	1.0000000
NODE_37290_length_519_cov_2.783333	174	235	0	61	61	1.0000000
NODE_37349_length_519_cov_1.538095	147	213	0	66	66	1.0000000
NODE_37447_length_518_cov_40.026253	385	465	0	41	80	0.5125000
NODE_37447_length_518_cov_40.026253	385	465	2	2	80	0.0250000
NODE_37447_length_518_cov_40.026253	385	465	6	37	80	0.4625000
NODE_37447_length_518_cov_40.026253	438	518	0	80	80	1.0000000
NODE_37449_length_518_cov_12.083532	144	224	0	80	80	1.0000000
NODE_37449_length_518_cov_12.083532	197	277	0	80	80	1.0000000
NODE_37449_length_518_cov_12.083532	407	481	0	74	74	1.0000000
NODE_37449_length_518_cov_12.083532	454	518	0	64	64	1.0000000
NODE_37450_length_518_cov_11.467780	171	200	0	29	29	1.0000000
NODE_37450_length_518_cov_11.467780	253	320	0	8	67	0.1194030
NODE_37450_length_518_cov_11.467780	253	320	2	12	67	0.1791045
NODE_37450_length_518_cov_11.467780	253	320	6	47	67	0.7014925
NODE_37450_length_518_cov_11.467780	253	282	6	29	29	1.0000000
NODE_37454_length_518_cov_7.441527	188	273	2	17	85	0.2000000
NODE_37454_length_518_cov_7.441527	188	273	4	18	85	0.2117647
NODE_37454_length_518_cov_7.441527	188	273	6	50	85	0.5882353
NODE_37461_length_518_cov_5.563246	315	366	0	28	51	0.5490196
NODE_37461_length_518_cov_5.563246	315	366	2	23	51	0.4509804
NODE_37461_length_518_cov_5.563246	339	383	0	4	44	0.0909091
NODE_37461_length_518_cov_5.563246	339	383	2	40	44	0.9090909
NODE_37465_length_518_cov_4.732697	214	276	0	62	62	1.0000000
NODE_37465_length_518_cov_4.732697	350	430	0	80	80	1.0000000
NODE_37479_length_518_cov_3.503580	291	333	0	42	42	1.0000000
NODE_37479_length_518_cov_3.503580	306	363	0	57	57	1.0000000
NODE_37483_length_518_cov_3.136038	269	338	0	69	69	1.0000000
NODE_37483_length_518_cov_3.136038	269	348	0	79	79	1.0000000
NODE_37483_length_518_cov_3.136038	269	349	0	80	80	1.0000000
NODE_37483_length_518_cov_3.136038	322	402	0	80	80	1.0000000
NODE_37483_length_518_cov_3.136038	322	364	0	42	42	1.0000000
NODE_37483_length_518_cov_3.136038	322	368	0	46	46	1.0000000
NODE_37483_length_518_cov_3.136038	331	366	0	35	35	1.0000000
NODE_37637_length_517_cov_55.267943	177	257	0	80	80	1.0000000
NODE_37637_length_517_cov_55.267943	230	310	0	80	80	1.0000000
NODE_37639_length_517_cov_30.863636	0	72	0	72	72	1.0000000
NODE_37639_length_517_cov_30.863636	0	72	0	72	72	1.0000000
NODE_37639_length_517_cov_30.863636	45	125	0	80	80	1.0000000
NODE_37639_length_517_cov_30.863636	45	99	0	54	54	1.0000000
NODE_37641_length_517_cov_12.258373	305	385	0	80	80	1.0000000
NODE_37641_length_517_cov_12.258373	358	438	0	80	80	1.0000000
NODE_37643_length_517_cov_7.131579	100	152	0	52	52	1.0000000
NODE_37662_length_517_cov_4.492823	140	220	0	80	80	1.0000000
NODE_37662_length_517_cov_4.492823	193	273	0	80	80	1.0000000
NODE_37697_length_517_cov_2.437799	331	388	4	57	57	1.0000000
NODE_37850_length_516_cov_17.570743	147	227	0	80	80	1.0000000
NODE_37850_length_516_cov_17.570743	200	280	0	80	80	1.0000000
NODE_37861_length_516_cov_5.268585	402	448	4	46	46	1.0000000
NODE_37862_length_516_cov_5.067146	114	194	0	50	80	0.6250000
NODE_37862_length_516_cov_5.067146	114	194	4	30	80	0.3750000
NODE_37862_length_516_cov_5.067146	167	247	4	80	80	1.0000000
NODE_37864_length_516_cov_4.788969	156	236	4	80	80	1.0000000
NODE_37864_length_516_cov_4.788969	209	277	0	24	68	0.3529412
NODE_37864_length_516_cov_4.788969	209	277	4	44	68	0.6470588
NODE_37881_length_516_cov_3.167866	48	93	0	4	45	0.0888889
NODE_37881_length_516_cov_3.167866	48	93	2	8	45	0.1777778
NODE_37881_length_516_cov_3.167866	48	93	6	3	45	0.0666667
NODE_37881_length_516_cov_3.167866	48	93	8	8	45	0.1777778
NODE_37881_length_516_cov_3.167866	48	93	10	7	45	0.1555556
NODE_37881_length_516_cov_3.167866	48	93	12	15	45	0.3333333
NODE_37881_length_516_cov_3.167866	103	177	0	3	74	0.0405405
NODE_37881_length_516_cov_3.167866	103	177	4	29	74	0.3918919
NODE_37881_length_516_cov_3.167866	103	177	8	4	74	0.0540541
NODE_37881_length_516_cov_3.167866	103	177	10	14	74	0.1891892
NODE_37881_length_516_cov_3.167866	103	177	12	24	74	0.3243243
NODE_38044_length_515_cov_69.442308	177	257	16	10	80	0.1250000
NODE_38044_length_515_cov_69.442308	177	257	18	6	80	0.0750000
NODE_38044_length_515_cov_69.442308	177	257	27	9	80	0.1125000
NODE_38044_length_515_cov_69.442308	177	257	29	1	80	0.0125000
NODE_38044_length_515_cov_69.442308	177	257	32	2	80	0.0250000
NODE_38044_length_515_cov_69.442308	177	257	33	40	80	0.5000000
NODE_38044_length_515_cov_69.442308	177	257	34	5	80	0.0625000
NODE_38044_length_515_cov_69.442308	177	257	37	5	80	0.0625000
NODE_38044_length_515_cov_69.442308	177	257	38	2	80	0.0250000
NODE_38044_length_515_cov_69.442308	177	257	16	10	80	0.1250000
NODE_38044_length_515_cov_69.442308	177	257	18	6	80	0.0750000
NODE_38044_length_515_cov_69.442308	177	257	27	9	80	0.1125000
NODE_38044_length_515_cov_69.442308	177	257	29	1	80	0.0125000
NODE_38044_length_515_cov_69.442308	177	257	32	2	80	0.0250000
NODE_38044_length_515_cov_69.442308	177	257	33	40	80	0.5000000
NODE_38044_length_515_cov_69.442308	177	257	34	5	80	0.0625000
NODE_38044_length_515_cov_69.442308	177	257	37	5	80	0.0625000
NODE_38044_length_515_cov_69.442308	177	257	38	2	80	0.0250000
NODE_38044_length_515_cov_69.442308	177	257	16	10	80	0.1250000
NODE_38044_length_515_cov_69.442308	177	257	18	6	80	0.0750000
NODE_38044_length_515_cov_69.442308	177	257	27	9	80	0.1125000
NODE_38044_length_515_cov_69.442308	177	257	29	1	80	0.0125000
NODE_38044_length_515_cov_69.442308	177	257	32	2	80	0.0250000
NODE_38044_length_515_cov_69.442308	177	257	33	40	80	0.5000000
NODE_38044_length_515_cov_69.442308	177	257	34	5	80	0.0625000
NODE_38044_length_515_cov_69.442308	177	257	37	5	80	0.0625000
NODE_38044_length_515_cov_69.442308	177	257	38	2	80	0.0250000
NODE_38044_length_515_cov_69.442308	230	291	29	6	61	0.0983607
NODE_38044_length_515_cov_69.442308	230	291	32	1	61	0.0163934
NODE_38044_length_515_cov_69.442308	230	291	33	14	61	0.2295082
NODE_38044_length_515_cov_69.442308	230	291	34	5	61	0.0819672
NODE_38044_length_515_cov_69.442308	230	291	37	5	61	0.0819672
NODE_38044_length_515_cov_69.442308	230	291	38	2	61	0.0327869
NODE_38044_length_515_cov_69.442308	230	291	47	5	61	0.0819672
NODE_38044_length_515_cov_69.442308	230	291	58	7	61	0.1147541
NODE_38044_length_515_cov_69.442308	230	291	59	5	61	0.0819672
NODE_38044_length_515_cov_69.442308	230	291	64	1	61	0.0163934
NODE_38044_length_515_cov_69.442308	230	291	68	10	61	0.1639344
NODE_38044_length_515_cov_69.442308	230	308	29	6	78	0.0769231
NODE_38044_length_515_cov_69.442308	230	308	32	1	78	0.0128205
NODE_38044_length_515_cov_69.442308	230	308	33	14	78	0.1794872
NODE_38044_length_515_cov_69.442308	230	308	34	5	78	0.0641026
NODE_38044_length_515_cov_69.442308	230	308	37	5	78	0.0641026
NODE_38044_length_515_cov_69.442308	230	308	38	2	78	0.0256410
NODE_38044_length_515_cov_69.442308	230	308	47	5	78	0.0641026
NODE_38044_length_515_cov_69.442308	230	308	58	7	78	0.0897436
NODE_38044_length_515_cov_69.442308	230	308	59	5	78	0.0641026
NODE_38044_length_515_cov_69.442308	230	308	64	1	78	0.0128205
NODE_38044_length_515_cov_69.442308	230	308	66	2	78	0.0256410
NODE_38044_length_515_cov_69.442308	230	308	68	25	78	0.3205128
NODE_38044_length_515_cov_69.442308	235	308	29	6	73	0.0821918
NODE_38044_length_515_cov_69.442308	235	308	32	1	73	0.0136986
NODE_38044_length_515_cov_69.442308	235	308	33	9	73	0.1232877
NODE_38044_length_515_cov_69.442308	235	308	34	5	73	0.0684932
NODE_38044_length_515_cov_69.442308	235	308	37	5	73	0.0684932
NODE_38044_length_515_cov_69.442308	235	308	38	2	73	0.0273973
NODE_38044_length_515_cov_69.442308	235	308	47	5	73	0.0684932
NODE_38044_length_515_cov_69.442308	235	308	58	7	73	0.0958904
NODE_38044_length_515_cov_69.442308	235	308	59	5	73	0.0684932
NODE_38044_length_515_cov_69.442308	235	308	64	1	73	0.0136986
NODE_38044_length_515_cov_69.442308	235	308	66	2	73	0.0273973
NODE_38044_length_515_cov_69.442308	235	308	68	25	73	0.3424658
NODE_38045_length_515_cov_13.271635	168	248	0	67	80	0.8375000
NODE_38045_length_515_cov_13.271635	168	248	1	13	80	0.1625000
NODE_38045_length_515_cov_13.271635	221	301	0	14	80	0.1750000
NODE_38045_length_515_cov_13.271635	221	301	1	21	80	0.2625000
NODE_38045_length_515_cov_13.271635	221	301	2	45	80	0.5625000
NODE_38048_length_515_cov_8.314904	213	290	2	77	77	1.0000000
NODE_38054_length_515_cov_5.487981	317	402	0	5	85	0.0588235
NODE_38054_length_515_cov_5.487981	317	402	2	7	85	0.0823529
NODE_38054_length_515_cov_5.487981	317	402	4	29	85	0.3411765
NODE_38054_length_515_cov_5.487981	317	402	8	10	85	0.1176471
NODE_38054_length_515_cov_5.487981	317	402	12	4	85	0.0470588
NODE_38054_length_515_cov_5.487981	317	402	16	9	85	0.1058824
NODE_38054_length_515_cov_5.487981	317	402	18	21	85	0.2470588
NODE_38242_length_514_cov_26.910843	170	250	0	80	80	1.0000000
NODE_38242_length_514_cov_26.910843	223	303	0	80	80	1.0000000
NODE_38243_length_514_cov_12.775904	85	149	0	64	64	1.0000000
NODE_38243_length_514_cov_12.775904	123	202	0	79	79	1.0000000
NODE_38244_length_514_cov_11.156627	124	204	0	80	80	1.0000000
NODE_38244_length_514_cov_11.156627	177	257	0	80	80	1.0000000
NODE_38253_length_514_cov_5.802410	165	217	0	52	52	1.0000000
NODE_38253_length_514_cov_5.802410	190	270	0	80	80	1.0000000
NODE_38254_length_514_cov_5.554217	192	272	0	80	80	1.0000000
NODE_38254_length_514_cov_5.554217	294	340	0	46	46	1.0000000
NODE_38257_length_514_cov_5.322892	230	260	0	14	30	0.4666667
NODE_38257_length_514_cov_5.322892	230	260	2	16	30	0.5333334
NODE_38262_length_514_cov_4.337349	220	300	0	80	80	1.0000000
NODE_38286_length_514_cov_3.012048	264	328	0	64	64	1.0000000
NODE_38432_length_513_cov_14.613527	118	198	0	80	80	1.0000000
NODE_38432_length_513_cov_14.613527	171	251	0	80	80	1.0000000
NODE_38433_length_513_cov_9.898551	253	333	0	80	80	1.0000000
NODE_38433_length_513_cov_9.898551	306	386	0	80	80	1.0000000
NODE_38434_length_513_cov_9.164251	185	265	0	80	80	1.0000000
NODE_38434_length_513_cov_9.164251	238	318	0	80	80	1.0000000
NODE_38441_length_513_cov_6.123188	284	364	0	80	80	1.0000000
NODE_38441_length_513_cov_6.123188	337	417	0	80	80	1.0000000
NODE_38460_length_513_cov_3.456522	283	350	3	6	67	0.0895522
NODE_38460_length_513_cov_3.456522	283	350	14	36	67	0.5373135
NODE_38460_length_513_cov_3.456522	283	350	15	7	67	0.1044776
NODE_38460_length_513_cov_3.456522	283	350	17	18	67	0.2686567
NODE_38460_length_513_cov_3.456522	336	398	14	20	62	0.3225806
NODE_38460_length_513_cov_3.456522	336	398	18	9	62	0.1451613
NODE_38460_length_513_cov_3.456522	336	398	20	33	62	0.5322581
NODE_38482_length_513_cov_2.309179	134	174	0	40	40	1.0000000
NODE_38482_length_513_cov_2.309179	170	223	0	53	53	1.0000000
NODE_38482_length_513_cov_2.309179	238	285	0	47	47	1.0000000
NODE_38515_length_513_cov_1.671498	427	476	0	29	49	0.5918368
NODE_38515_length_513_cov_1.671498	427	476	2	6	49	0.1224490
NODE_38515_length_513_cov_1.671498	427	476	4	14	49	0.2857143
NODE_38646_length_512_cov_45.070218	34	114	0	71	80	0.8875000
NODE_38646_length_512_cov_45.070218	34	114	4	9	80	0.1125000
NODE_38646_length_512_cov_45.070218	87	167	0	18	80	0.2250000
NODE_38646_length_512_cov_45.070218	87	167	4	16	80	0.2000000
NODE_38646_length_512_cov_45.070218	87	167	8	46	80	0.5750000
NODE_38647_length_512_cov_39.639225	323	404	0	74	81	0.9135802
NODE_38647_length_512_cov_39.639225	323	404	2	7	81	0.0864198
NODE_38647_length_512_cov_39.639225	377	457	0	20	80	0.2500000
NODE_38647_length_512_cov_39.639225	377	457	2	60	80	0.7500000
NODE_38648_length_512_cov_8.581114	192	256	4	7	64	0.1093750
NODE_38648_length_512_cov_8.581114	192	256	5	57	64	0.8906250
NODE_38661_length_512_cov_4.869249	327	407	0	80	80	1.0000000
NODE_38661_length_512_cov_4.869249	380	460	0	80	80	1.0000000
NODE_38668_length_512_cov_4.157385	161	204	0	43	43	1.0000000
NODE_38668_length_512_cov_4.157385	178	257	0	79	79	1.0000000
NODE_38677_length_512_cov_3.435835	138	218	0	80	80	1.0000000
NODE_38677_length_512_cov_3.435835	191	271	0	80	80	1.0000000
NODE_38693_length_512_cov_2.888620	320	400	0	80	80	1.0000000
NODE_38768_length_512_cov_1.341404	198	269	0	2	71	0.0281690
NODE_38768_length_512_cov_1.341404	198	269	1	3	71	0.0422535
NODE_38768_length_512_cov_1.341404	198	269	3	8	71	0.1126761
NODE_38768_length_512_cov_1.341404	198	269	5	1	71	0.0140845
NODE_38768_length_512_cov_1.341404	198	269	6	4	71	0.0563380
NODE_38768_length_512_cov_1.341404	198	269	12	18	71	0.2535211
NODE_38768_length_512_cov_1.341404	198	269	14	35	71	0.4929577
NODE_38866_length_511_cov_9.796117	251	331	0	16	80	0.2000000
NODE_38866_length_511_cov_9.796117	251	331	4	64	80	0.8000000
NODE_38866_length_511_cov_9.796117	304	370	0	10	66	0.1515152
NODE_38866_length_511_cov_9.796117	304	370	4	56	66	0.8484849
NODE_38869_length_511_cov_8.873786	239	319	0	10	80	0.1250000
NODE_38869_length_511_cov_8.873786	239	319	2	16	80	0.2000000
NODE_38869_length_511_cov_8.873786	239	319	4	44	80	0.5500000
NODE_38869_length_511_cov_8.873786	239	319	6	10	80	0.1250000
NODE_38869_length_511_cov_8.873786	292	356	2	14	64	0.2187500
NODE_38869_length_511_cov_8.873786	292	356	4	18	64	0.2812500
NODE_38869_length_511_cov_8.873786	292	356	6	27	64	0.4218750
NODE_38869_length_511_cov_8.873786	292	356	7	2	64	0.0312500
NODE_38869_length_511_cov_8.873786	292	356	8	3	64	0.0468750
NODE_38870_length_511_cov_8.434466	232	312	0	80	80	1.0000000
NODE_38870_length_511_cov_8.434466	285	366	0	81	81	1.0000000
NODE_38872_length_511_cov_7.519417	157	237	0	75	80	0.9375000
NODE_38872_length_511_cov_7.519417	157	237	2	5	80	0.0625000
NODE_38872_length_511_cov_7.519417	210	290	0	80	80	1.0000000
NODE_38877_length_511_cov_5.762136	102	179	4	5	77	0.0649351
NODE_38877_length_511_cov_5.762136	102	179	5	9	77	0.1168831
NODE_38877_length_511_cov_5.762136	102	179	6	53	77	0.6883117
NODE_38877_length_511_cov_5.762136	102	179	8	10	77	0.1298701
NODE_38877_length_511_cov_5.762136	155	230	2	3	75	0.0400000
NODE_38877_length_511_cov_5.762136	155	230	4	51	75	0.6800000
NODE_38877_length_511_cov_5.762136	155	230	6	21	75	0.2800000
NODE_38878_length_511_cov_5.655340	133	213	2	80	80	1.0000000
NODE_38878_length_511_cov_5.655340	186	266	0	32	80	0.4000000
NODE_38878_length_511_cov_5.655340	186	266	2	48	80	0.6000000
NODE_38911_length_511_cov_2.978155	219	255	0	36	36	1.0000000
NODE_39013_length_511_cov_1.225728	99	127	0	28	28	1.0000000
NODE_39092_length_511_cov_0.708738	98	146	0	48	48	1.0000000
NODE_39105_length_510_cov_18.206813	334	414	4	15	80	0.1875000
NODE_39105_length_510_cov_18.206813	334	414	8	65	80	0.8125000
NODE_39105_length_510_cov_18.206813	387	467	8	80	80	1.0000000
NODE_39110_length_510_cov_8.017032	211	291	0	80	80	1.0000000
NODE_39110_length_510_cov_8.017032	264	344	0	80	80	1.0000000
NODE_39110_length_510_cov_8.017032	391	413	0	22	22	1.0000000
NODE_39112_length_510_cov_6.476886	208	251	31	43	43	1.0000000
NODE_39115_length_510_cov_6.133820	149	200	0	51	51	1.0000000
NODE_39122_length_510_cov_4.313869	32	106	0	3	74	0.0405405
NODE_39122_length_510_cov_4.313869	32	106	4	14	74	0.1891892
NODE_39122_length_510_cov_4.313869	32	106	6	57	74	0.7702703
NODE_39131_length_510_cov_3.435523	149	213	0	64	64	1.0000000
NODE_39131_length_510_cov_3.435523	191	249	0	58	58	1.0000000
NODE_39293_length_509_cov_13.378049	160	240	0	80	80	1.0000000
NODE_39293_length_509_cov_13.378049	213	294	0	81	81	1.0000000
NODE_39302_length_509_cov_5.190244	203	283	0	9	80	0.1125000
NODE_39302_length_509_cov_5.190244	203	283	4	7	80	0.0875000
NODE_39302_length_509_cov_5.190244	203	283	8	64	80	0.8000000
NODE_39302_length_509_cov_5.190244	256	336	4	31	80	0.3875000
NODE_39302_length_509_cov_5.190244	256	336	8	49	80	0.6125000
NODE_39309_length_509_cov_4.478049	221	301	0	80	80	1.0000000
NODE_39309_length_509_cov_4.478049	274	354	0	80	80	1.0000000
NODE_39311_length_509_cov_4.451220	203	283	10	2	80	0.0250000
NODE_39311_length_509_cov_4.451220	203	283	12	65	80	0.8125000
NODE_39311_length_509_cov_4.451220	203	283	14	13	80	0.1625000
NODE_39322_length_509_cov_3.443902	133	185	0	52	52	1.0000000
NODE_39326_length_509_cov_3.207317	367	445	0	78	78	1.0000000
NODE_39337_length_509_cov_2.853659	194	274	0	80	80	1.0000000
NODE_39480_length_509_cov_0.809756	229	272	0	21	43	0.4883721
NODE_39480_length_509_cov_0.809756	229	272	2	22	43	0.5116279
NODE_39506_length_508_cov_22.009780	440	508	0	68	68	1.0000000
NODE_39512_length_508_cov_5.158924	248	284	0	36	36	1.0000000
NODE_39539_length_508_cov_2.662592	165	244	0	46	79	0.5822785
NODE_39539_length_508_cov_2.662592	165	244	2	33	79	0.4177215
NODE_39698_length_507_cov_32.286765	0	61	3	1	61	0.0163934
NODE_39698_length_507_cov_32.286765	0	61	11	2	61	0.0327869
NODE_39698_length_507_cov_32.286765	0	61	15	1	61	0.0163934
NODE_39698_length_507_cov_32.286765	0	61	16	1	61	0.0163934
NODE_39698_length_507_cov_32.286765	0	61	19	1	61	0.0163934
NODE_39698_length_507_cov_32.286765	0	61	22	1	61	0.0163934
NODE_39698_length_507_cov_32.286765	0	61	25	1	61	0.0163934
NODE_39698_length_507_cov_32.286765	0	61	31	1	61	0.0163934
NODE_39698_length_507_cov_32.286765	0	61	32	2	61	0.0327869
NODE_39698_length_507_cov_32.286765	0	61	39	2	61	0.0327869
NODE_39698_length_507_cov_32.286765	0	61	40	2	61	0.0327869
NODE_39698_length_507_cov_32.286765	0	61	42	2	61	0.0327869
NODE_39698_length_507_cov_32.286765	0	61	43	2	61	0.0327869
NODE_39698_length_507_cov_32.286765	0	61	50	3	61	0.0491803
NODE_39698_length_507_cov_32.286765	0	61	54	1	61	0.0163934
NODE_39698_length_507_cov_32.286765	0	61	58	1	61	0.0163934
NODE_39698_length_507_cov_32.286765	0	61	62	3	61	0.0491803
NODE_39698_length_507_cov_32.286765	0	61	63	1	61	0.0163934
NODE_39698_length_507_cov_32.286765	0	61	67	1	61	0.0163934
NODE_39698_length_507_cov_32.286765	0	61	70	1	61	0.0163934
NODE_39698_length_507_cov_32.286765	0	61	79	1	61	0.0163934
NODE_39698_length_507_cov_32.286765	0	61	81	1	61	0.0163934
NODE_39698_length_507_cov_32.286765	0	61	89	1	61	0.0163934
NODE_39698_length_507_cov_32.286765	0	61	93	1	61	0.0163934
NODE_39698_length_507_cov_32.286765	0	61	95	2	61	0.0327869
NODE_39698_length_507_cov_32.286765	0	61	97	6	61	0.0983607
NODE_39698_length_507_cov_32.286765	0	61	99	6	61	0.0983607
NODE_39698_length_507_cov_32.286765	0	61	101	1	61	0.0163934
NODE_39698_length_507_cov_32.286765	0	61	103	2	61	0.0327869
NODE_39698_length_507_cov_32.286765	0	61	120	1	61	0.0163934
NODE_39698_length_507_cov_32.286765	0	61	121	1	61	0.0163934
NODE_39698_length_507_cov_32.286765	0	61	125	1	61	0.0163934
NODE_39698_length_507_cov_32.286765	0	61	128	2	61	0.0327869
NODE_39698_length_507_cov_32.286765	0	61	130	3	61	0.0491803
NODE_39698_length_507_cov_32.286765	0	61	132	1	61	0.0163934
NODE_39698_length_507_cov_32.286765	0	61	134	1	61	0.0163934
NODE_39698_length_507_cov_32.286765	53	97	125	1	44	0.0227273
NODE_39698_length_507_cov_32.286765	53	97	128	2	44	0.0454545
NODE_39698_length_507_cov_32.286765	53	97	130	3	44	0.0681818
NODE_39698_length_507_cov_32.286765	53	97	132	1	44	0.0227273
NODE_39698_length_507_cov_32.286765	53	97	134	3	44	0.0681818
NODE_39698_length_507_cov_32.286765	53	97	136	4	44	0.0909091
NODE_39698_length_507_cov_32.286765	53	97	140	1	44	0.0227273
NODE_39698_length_507_cov_32.286765	53	97	143	1	44	0.0227273
NODE_39698_length_507_cov_32.286765	53	97	145	1	44	0.0227273
NODE_39698_length_507_cov_32.286765	53	97	146	3	44	0.0681818
NODE_39698_length_507_cov_32.286765	53	97	148	2	44	0.0454545
NODE_39698_length_507_cov_32.286765	53	97	154	1	44	0.0227273
NODE_39698_length_507_cov_32.286765	53	97	156	2	44	0.0454545
NODE_39698_length_507_cov_32.286765	53	97	160	3	44	0.0681818
NODE_39698_length_507_cov_32.286765	53	97	162	2	44	0.0454545
NODE_39698_length_507_cov_32.286765	53	97	166	1	44	0.0227273
NODE_39698_length_507_cov_32.286765	53	97	170	2	44	0.0454545
NODE_39698_length_507_cov_32.286765	53	97	173	3	44	0.0681818
NODE_39698_length_507_cov_32.286765	53	97	176	1	44	0.0227273
NODE_39698_length_507_cov_32.286765	53	97	185	1	44	0.0227273
NODE_39698_length_507_cov_32.286765	53	97	189	5	44	0.1136364
NODE_39698_length_507_cov_32.286765	53	97	193	1	44	0.0227273
NODE_39701_length_507_cov_7.553922	203	283	0	2	80	0.0250000
NODE_39701_length_507_cov_7.553922	203	283	4	26	80	0.3250000
NODE_39701_length_507_cov_7.553922	203	283	8	10	80	0.1250000
NODE_39701_length_507_cov_7.553922	203	283	18	6	80	0.0750000
NODE_39701_length_507_cov_7.553922	203	283	20	36	80	0.4500000
NODE_39709_length_507_cov_5.154412	296	362	0	66	66	1.0000000
NODE_39714_length_507_cov_4.710784	248	328	0	80	80	1.0000000
NODE_39714_length_507_cov_4.710784	308	379	0	71	71	1.0000000
NODE_39728_length_507_cov_3.649510	80	109	12	9	29	0.3103448
NODE_39728_length_507_cov_3.649510	80	109	14	4	29	0.1379310
NODE_39728_length_507_cov_3.649510	80	109	18	3	29	0.1034483
NODE_39728_length_507_cov_3.649510	80	109	20	6	29	0.2068966
NODE_39728_length_507_cov_3.649510	80	109	21	6	29	0.2068966
NODE_39728_length_507_cov_3.649510	80	109	23	1	29	0.0344828
NODE_39728_length_507_cov_3.649510	184	266	29	2	82	0.0243902
NODE_39728_length_507_cov_3.649510	184	266	31	10	82	0.1219512
NODE_39728_length_507_cov_3.649510	184	266	32	1	82	0.0121951
NODE_39728_length_507_cov_3.649510	184	266	33	15	82	0.1829268
NODE_39728_length_507_cov_3.649510	184	266	34	19	82	0.2317073
NODE_39728_length_507_cov_3.649510	184	266	35	5	82	0.0609756
NODE_39728_length_507_cov_3.649510	184	266	36	17	82	0.2073171
NODE_39728_length_507_cov_3.649510	184	266	38	6	82	0.0731707
NODE_39728_length_507_cov_3.649510	184	266	39	2	82	0.0243902
NODE_39728_length_507_cov_3.649510	184	266	41	5	82	0.0609756
NODE_39728_length_507_cov_3.649510	189	273	27	6	84	0.0714286
NODE_39728_length_507_cov_3.649510	189	273	29	3	84	0.0357143
NODE_39728_length_507_cov_3.649510	189	273	31	10	84	0.1190476
NODE_39728_length_507_cov_3.649510	189	273	32	1	84	0.0119048
NODE_39728_length_507_cov_3.649510	189	273	33	15	84	0.1785714
NODE_39728_length_507_cov_3.649510	189	273	34	14	84	0.1666667
NODE_39728_length_507_cov_3.649510	189	273	35	5	84	0.0595238
NODE_39728_length_507_cov_3.649510	189	273	36	17	84	0.2023810
NODE_39728_length_507_cov_3.649510	189	273	38	6	84	0.0714286
NODE_39728_length_507_cov_3.649510	189	273	39	2	84	0.0238095
NODE_39728_length_507_cov_3.649510	189	273	41	5	84	0.0595238
NODE_39728_length_507_cov_3.649510	207	266	29	2	59	0.0338983
NODE_39728_length_507_cov_3.649510	207	266	31	7	59	0.1186441
NODE_39728_length_507_cov_3.649510	207	266	33	6	59	0.1016949
NODE_39728_length_507_cov_3.649510	207	266	34	10	59	0.1694915
NODE_39728_length_507_cov_3.649510	207	266	35	5	59	0.0847458
NODE_39728_length_507_cov_3.649510	207	266	36	17	59	0.2881356
NODE_39728_length_507_cov_3.649510	207	266	38	6	59	0.1016949
NODE_39728_length_507_cov_3.649510	207	266	39	2	59	0.0338983
NODE_39728_length_507_cov_3.649510	207	266	41	4	59	0.0677966
NODE_39747_length_507_cov_2.754902	345	425	0	80	80	1.0000000
NODE_39747_length_507_cov_2.754902	428	463	0	35	35	1.0000000
NODE_39918_length_506_cov_31.987715	71	156	0	50	85	0.5882353
NODE_39918_length_506_cov_31.987715	71	156	5	35	85	0.4117647
NODE_39918_length_506_cov_31.987715	71	156	0	50	85	0.5882353
NODE_39918_length_506_cov_31.987715	71	156	5	35	85	0.4117647
NODE_39918_length_506_cov_31.987715	71	156	0	50	85	0.5882353
NODE_39918_length_506_cov_31.987715	71	156	5	35	85	0.4117647
NODE_39918_length_506_cov_31.987715	129	209	5	80	80	1.0000000
NODE_39919_length_506_cov_15.877150	210	279	0	69	69	1.0000000
NODE_39920_length_506_cov_15.461916	334	414	0	80	80	1.0000000
NODE_39920_length_506_cov_15.461916	387	467	0	80	80	1.0000000
NODE_39921_length_506_cov_9.749386	197	276	0	79	79	1.0000000
NODE_39921_length_506_cov_9.749386	249	329	0	80	80	1.0000000
NODE_39947_length_506_cov_3.122850	218	298	0	80	80	1.0000000
NODE_39947_length_506_cov_3.122850	271	351	0	80	80	1.0000000
NODE_39951_length_506_cov_2.894349	190	270	0	22	80	0.2750000
NODE_39951_length_506_cov_2.894349	190	270	2	58	80	0.7250000
NODE_40133_length_505_cov_35.541872	373	453	0	80	80	1.0000000
NODE_40135_length_505_cov_10.339901	30	110	0	80	80	1.0000000
NODE_40135_length_505_cov_10.339901	83	163	0	80	80	1.0000000
NODE_40158_length_505_cov_3.554187	225	305	0	80	80	1.0000000
NODE_40158_length_505_cov_3.554187	278	358	0	80	80	1.0000000
NODE_40160_length_505_cov_3.403941	207	287	0	80	80	1.0000000
NODE_40175_length_505_cov_2.975369	162	227	0	5	65	0.0769231
NODE_40175_length_505_cov_2.975369	162	227	3	1	65	0.0153846
NODE_40175_length_505_cov_2.975369	162	227	4	6	65	0.0923077
NODE_40175_length_505_cov_2.975369	162	227	8	53	65	0.8153846
NODE_40222_length_505_cov_1.864532	55	126	0	71	71	1.0000000
NODE_40368_length_504_cov_115.891358	122	202	222	1	80	0.0125000
NODE_40368_length_504_cov_115.891358	122	202	229	1	80	0.0125000
NODE_40368_length_504_cov_115.891358	122	202	238	1	80	0.0125000
NODE_40368_length_504_cov_115.891358	122	202	240	2	80	0.0250000
NODE_40368_length_504_cov_115.891358	122	202	246	2	80	0.0250000
NODE_40368_length_504_cov_115.891358	122	202	248	1	80	0.0125000
NODE_40368_length_504_cov_115.891358	122	202	249	1	80	0.0125000
NODE_40368_length_504_cov_115.891358	122	202	255	1	80	0.0125000
NODE_40368_length_504_cov_115.891358	122	202	260	1	80	0.0125000
NODE_40368_length_504_cov_115.891358	122	202	263	2	80	0.0250000
NODE_40368_length_504_cov_115.891358	122	202	265	1	80	0.0125000
NODE_40368_length_504_cov_115.891358	122	202	267	2	80	0.0250000
NODE_40368_length_504_cov_115.891358	122	202	271	1	80	0.0125000
NODE_40368_length_504_cov_115.891358	122	202	273	1	80	0.0125000
NODE_40368_length_504_cov_115.891358	122	202	277	4	80	0.0500000
NODE_40368_length_504_cov_115.891358	122	202	286	1	80	0.0125000
NODE_40368_length_504_cov_115.891358	122	202	290	1	80	0.0125000
NODE_40368_length_504_cov_115.891358	122	202	300	1	80	0.0125000
NODE_40368_length_504_cov_115.891358	122	202	305	2	80	0.0250000
NODE_40368_length_504_cov_115.891358	122	202	312	1	80	0.0125000
NODE_40368_length_504_cov_115.891358	122	202	316	1	80	0.0125000
NODE_40368_length_504_cov_115.891358	122	202	318	1	80	0.0125000
NODE_40368_length_504_cov_115.891358	122	202	324	2	80	0.0250000
NODE_40368_length_504_cov_115.891358	122	202	331	2	80	0.0250000
NODE_40368_length_504_cov_115.891358	122	202	332	2	80	0.0250000
NODE_40368_length_504_cov_115.891358	122	202	335	1	80	0.0125000
NODE_40368_length_504_cov_115.891358	122	202	342	1	80	0.0125000
NODE_40368_length_504_cov_115.891358	122	202	346	4	80	0.0500000
NODE_40368_length_504_cov_115.891358	122	202	347	1	80	0.0125000
NODE_40368_length_504_cov_115.891358	122	202	352	1	80	0.0125000
NODE_40368_length_504_cov_115.891358	122	202	360	1	80	0.0125000
NODE_40368_length_504_cov_115.891358	122	202	380	1	80	0.0125000
NODE_40368_length_504_cov_115.891358	122	202	386	1	80	0.0125000
NODE_40368_length_504_cov_115.891358	122	202	388	1	80	0.0125000
NODE_40368_length_504_cov_115.891358	122	202	391	1	80	0.0125000
NODE_40368_length_504_cov_115.891358	122	202	396	1	80	0.0125000
NODE_40368_length_504_cov_115.891358	122	202	399	2	80	0.0250000
NODE_40368_length_504_cov_115.891358	122	202	400	3	80	0.0375000
NODE_40368_length_504_cov_115.891358	122	202	404	2	80	0.0250000
NODE_40368_length_504_cov_115.891358	122	202	416	1	80	0.0125000
NODE_40368_length_504_cov_115.891358	122	202	418	2	80	0.0250000
NODE_40368_length_504_cov_115.891358	122	202	420	2	80	0.0250000
NODE_40368_length_504_cov_115.891358	122	202	422	1	80	0.0125000
NODE_40368_length_504_cov_115.891358	122	202	426	3	80	0.0375000
NODE_40368_length_504_cov_115.891358	122	202	427	1	80	0.0125000
NODE_40368_length_504_cov_115.891358	122	202	428	3	80	0.0375000
NODE_40368_length_504_cov_115.891358	122	202	429	1	80	0.0125000
NODE_40368_length_504_cov_115.891358	122	202	430	1	80	0.0125000
NODE_40368_length_504_cov_115.891358	122	202	431	3	80	0.0375000
NODE_40368_length_504_cov_115.891358	122	202	434	1	80	0.0125000
NODE_40368_length_504_cov_115.891358	122	202	435	1	80	0.0125000
NODE_40368_length_504_cov_115.891358	122	202	439	1	80	0.0125000
NODE_40368_length_504_cov_115.891358	122	202	440	1	80	0.0125000
NODE_40368_length_504_cov_115.891358	122	202	442	1	80	0.0125000
NODE_40368_length_504_cov_115.891358	175	255	270	1	80	0.0125000
NODE_40368_length_504_cov_115.891358	175	255	276	1	80	0.0125000
NODE_40368_length_504_cov_115.891358	175	255	278	1	80	0.0125000
NODE_40368_length_504_cov_115.891358	175	255	286	1	80	0.0125000
NODE_40368_length_504_cov_115.891358	175	255	291	1	80	0.0125000
NODE_40368_length_504_cov_115.891358	175	255	302	1	80	0.0125000
NODE_40368_length_504_cov_115.891358	175	255	304	1	80	0.0125000
NODE_40368_length_504_cov_115.891358	175	255	309	1	80	0.0125000
NODE_40368_length_504_cov_115.891358	175	255	317	2	80	0.0250000
NODE_40368_length_504_cov_115.891358	175	255	320	1	80	0.0125000
NODE_40368_length_504_cov_115.891358	175	255	323	1	80	0.0125000
NODE_40368_length_504_cov_115.891358	175	255	325	1	80	0.0125000
NODE_40368_length_504_cov_115.891358	175	255	327	1	80	0.0125000
NODE_40368_length_504_cov_115.891358	175	255	340	1	80	0.0125000
NODE_40368_length_504_cov_115.891358	175	255	353	1	80	0.0125000
NODE_40368_length_504_cov_115.891358	175	255	362	2	80	0.0250000
NODE_40368_length_504_cov_115.891358	175	255	364	1	80	0.0125000
NODE_40368_length_504_cov_115.891358	175	255	371	1	80	0.0125000
NODE_40368_length_504_cov_115.891358	175	255	389	1	80	0.0125000
NODE_40368_length_504_cov_115.891358	175	255	391	2	80	0.0250000
NODE_40368_length_504_cov_115.891358	175	255	396	3	80	0.0375000
NODE_40368_length_504_cov_115.891358	175	255	399	1	80	0.0125000
NODE_40368_length_504_cov_115.891358	175	255	400	1	80	0.0125000
NODE_40368_length_504_cov_115.891358	175	255	401	1	80	0.0125000
NODE_40368_length_504_cov_115.891358	175	255	404	4	80	0.0500000
NODE_40368_length_504_cov_115.891358	175	255	410	2	80	0.0250000
NODE_40368_length_504_cov_115.891358	175	255	413	1	80	0.0125000
NODE_40368_length_504_cov_115.891358	175	255	415	3	80	0.0375000
NODE_40368_length_504_cov_115.891358	175	255	416	2	80	0.0250000
NODE_40368_length_504_cov_115.891358	175	255	418	2	80	0.0250000
NODE_40368_length_504_cov_115.891358	175	255	420	4	80	0.0500000
NODE_40368_length_504_cov_115.891358	175	255	422	2	80	0.0250000
NODE_40368_length_504_cov_115.891358	175	255	426	3	80	0.0375000
NODE_40368_length_504_cov_115.891358	175	255	427	1	80	0.0125000
NODE_40368_length_504_cov_115.891358	175	255	428	3	80	0.0375000
NODE_40368_length_504_cov_115.891358	175	255	429	5	80	0.0625000
NODE_40368_length_504_cov_115.891358	175	255	430	3	80	0.0375000
NODE_40368_length_504_cov_115.891358	175	255	431	5	80	0.0625000
NODE_40368_length_504_cov_115.891358	175	255	432	3	80	0.0375000
NODE_40368_length_504_cov_115.891358	175	255	434	1	80	0.0125000
NODE_40368_length_504_cov_115.891358	175	255	435	2	80	0.0250000
NODE_40368_length_504_cov_115.891358	175	255	438	1	80	0.0125000
NODE_40368_length_504_cov_115.891358	175	255	439	2	80	0.0250000
NODE_40368_length_504_cov_115.891358	175	255	440	1	80	0.0125000
NODE_40368_length_504_cov_115.891358	175	255	442	1	80	0.0125000
NODE_40369_length_504_cov_33.360494	28	108	0	80	80	1.0000000
NODE_40369_length_504_cov_33.360494	81	161	0	80	80	1.0000000
NODE_40370_length_504_cov_15.669136	176	256	0	80	80	1.0000000
NODE_40370_length_504_cov_15.669136	229	309	0	80	80	1.0000000
NODE_40371_length_504_cov_13.202469	134	215	0	81	81	1.0000000
NODE_40371_length_504_cov_13.202469	188	268	0	80	80	1.0000000
NODE_40377_length_504_cov_6.770370	55	135	0	45	80	0.5625000
NODE_40377_length_504_cov_6.770370	55	135	2	35	80	0.4375000
NODE_40377_length_504_cov_6.770370	108	188	2	80	80	1.0000000
NODE_40427_length_504_cov_2.234568	359	407	0	10	48	0.2083333
NODE_40427_length_504_cov_2.234568	359	407	2	38	48	0.7916667
NODE_40428_length_504_cov_2.227160	307	370	0	63	63	1.0000000
NODE_40434_length_504_cov_2.116049	245	325	0	80	80	1.0000000
NODE_40434_length_504_cov_2.116049	298	378	0	80	80	1.0000000
NODE_40446_length_504_cov_1.925926	196	262	0	66	66	1.0000000
NODE_40601_length_503_cov_11.356436	268	348	0	80	80	1.0000000
NODE_40601_length_503_cov_11.356436	321	401	0	80	80	1.0000000
NODE_40615_length_503_cov_5.537129	314	381	2	67	67	1.0000000
NODE_40645_length_503_cov_3.012376	264	285	0	21	21	1.0000000
NODE_40652_length_503_cov_2.757426	266	334	2	14	68	0.2058824
NODE_40652_length_503_cov_2.757426	266	334	4	10	68	0.1470588
NODE_40652_length_503_cov_2.757426	266	334	6	44	68	0.6470588
NODE_40652_length_503_cov_2.757426	307	387	2	19	80	0.2375000
NODE_40652_length_503_cov_2.757426	307	387	4	15	80	0.1875000
NODE_40652_length_503_cov_2.757426	307	387	6	46	80	0.5750000
NODE_40655_length_503_cov_2.705446	158	237	0	18	79	0.2278481
NODE_40655_length_503_cov_2.705446	158	237	4	61	79	0.7721519
NODE_40655_length_503_cov_2.705446	211	291	0	72	80	0.9000000
NODE_40655_length_503_cov_2.705446	211	291	4	8	80	0.1000000
NODE_40656_length_503_cov_2.705446	251	331	0	80	80	1.0000000
NODE_40656_length_503_cov_2.705446	251	321	0	70	70	1.0000000
NODE_40656_length_503_cov_2.705446	330	384	0	18	54	0.3333333
NODE_40656_length_503_cov_2.705446	330	384	1	15	54	0.2777778
NODE_40656_length_503_cov_2.705446	330	384	2	21	54	0.3888889
NODE_40656_length_503_cov_2.705446	338	384	0	10	46	0.2173913
NODE_40656_length_503_cov_2.705446	338	384	1	15	46	0.3260870
NODE_40656_length_503_cov_2.705446	338	384	2	21	46	0.4565217
NODE_40664_length_503_cov_2.584158	95	163	0	68	68	1.0000000
NODE_40857_length_502_cov_45.292804	353	433	7	21	80	0.2625000
NODE_40857_length_502_cov_45.292804	353	433	10	44	80	0.5500000
NODE_40857_length_502_cov_45.292804	353	433	11	3	80	0.0375000
NODE_40857_length_502_cov_45.292804	353	433	12	12	80	0.1500000
NODE_40864_length_502_cov_5.980149	305	381	3	11	76	0.1447368
NODE_40864_length_502_cov_5.980149	305	381	5	25	76	0.3289474
NODE_40864_length_502_cov_5.980149	305	381	6	8	76	0.1052632
NODE_40864_length_502_cov_5.980149	305	381	8	2	76	0.0263158
NODE_40864_length_502_cov_5.980149	305	381	12	16	76	0.2105263
NODE_40864_length_502_cov_5.980149	305	381	14	10	76	0.1315790
NODE_40864_length_502_cov_5.980149	305	381	15	4	76	0.0526316
NODE_41070_length_501_cov_208.708955	288	350	91	2	62	0.0322581
NODE_41070_length_501_cov_208.708955	288	350	92	1	62	0.0161290
NODE_41070_length_501_cov_208.708955	288	350	94	1	62	0.0161290
NODE_41070_length_501_cov_208.708955	288	350	95	6	62	0.0967742
NODE_41070_length_501_cov_208.708955	288	350	109	1	62	0.0161290
NODE_41070_length_501_cov_208.708955	288	350	111	2	62	0.0322581
NODE_41070_length_501_cov_208.708955	288	350	115	1	62	0.0161290
NODE_41070_length_501_cov_208.708955	288	350	117	2	62	0.0322581
NODE_41070_length_501_cov_208.708955	288	350	121	1	62	0.0161290
NODE_41070_length_501_cov_208.708955	288	350	122	1	62	0.0161290
NODE_41070_length_501_cov_208.708955	288	350	123	4	62	0.0645161
NODE_41070_length_501_cov_208.708955	288	350	128	1	62	0.0161290
NODE_41070_length_501_cov_208.708955	288	350	129	4	62	0.0645161
NODE_41070_length_501_cov_208.708955	288	350	130	9	62	0.1451613
NODE_41070_length_501_cov_208.708955	288	350	132	1	62	0.0161290
NODE_41070_length_501_cov_208.708955	288	350	142	2	62	0.0322581
NODE_41070_length_501_cov_208.708955	288	350	144	3	62	0.0483871
NODE_41070_length_501_cov_208.708955	288	350	149	1	62	0.0161290
NODE_41070_length_501_cov_208.708955	288	350	152	1	62	0.0161290
NODE_41070_length_501_cov_208.708955	288	350	153	1	62	0.0161290
NODE_41070_length_501_cov_208.708955	288	350	158	1	62	0.0161290
NODE_41070_length_501_cov_208.708955	288	350	160	4	62	0.0645161
NODE_41070_length_501_cov_208.708955	288	350	162	3	62	0.0483871
NODE_41070_length_501_cov_208.708955	288	350	164	4	62	0.0645161
NODE_41070_length_501_cov_208.708955	288	350	167	3	62	0.0483871
NODE_41070_length_501_cov_208.708955	288	350	169	1	62	0.0161290
NODE_41070_length_501_cov_208.708955	288	350	171	1	62	0.0161290
NODE_41070_length_501_cov_208.708955	327	413	68	5	86	0.0581395
NODE_41070_length_501_cov_208.708955	327	413	72	1	86	0.0116279
NODE_41070_length_501_cov_208.708955	327	413	73	1	86	0.0116279
NODE_41070_length_501_cov_208.708955	327	413	94	1	86	0.0116279
NODE_41070_length_501_cov_208.708955	327	413	100	2	86	0.0232558
NODE_41070_length_501_cov_208.708955	327	413	119	2	86	0.0232558
NODE_41070_length_501_cov_208.708955	327	413	120	1	86	0.0116279
NODE_41070_length_501_cov_208.708955	327	413	126	1	86	0.0116279
NODE_41070_length_501_cov_208.708955	327	413	132	1	86	0.0116279
NODE_41070_length_501_cov_208.708955	327	413	138	1	86	0.0116279
NODE_41070_length_501_cov_208.708955	327	413	139	6	86	0.0697674
NODE_41070_length_501_cov_208.708955	327	413	142	5	86	0.0581395
NODE_41070_length_501_cov_208.708955	327	413	144	2	86	0.0232558
NODE_41070_length_501_cov_208.708955	327	413	146	1	86	0.0116279
NODE_41070_length_501_cov_208.708955	327	413	149	1	86	0.0116279
NODE_41070_length_501_cov_208.708955	327	413	150	3	86	0.0348837
NODE_41070_length_501_cov_208.708955	327	413	152	2	86	0.0232558
NODE_41070_length_501_cov_208.708955	327	413	153	1	86	0.0116279
NODE_41070_length_501_cov_208.708955	327	413	154	4	86	0.0465116
NODE_41070_length_501_cov_208.708955	327	413	156	3	86	0.0348837
NODE_41070_length_501_cov_208.708955	327	413	158	7	86	0.0813954
NODE_41070_length_501_cov_208.708955	327	413	160	6	86	0.0697674
NODE_41070_length_501_cov_208.708955	327	413	161	2	86	0.0232558
NODE_41070_length_501_cov_208.708955	327	413	162	10	86	0.1162791
NODE_41070_length_501_cov_208.708955	327	413	164	8	86	0.0930233
NODE_41070_length_501_cov_208.708955	327	413	165	4	86	0.0465116
NODE_41070_length_501_cov_208.708955	327	413	167	3	86	0.0348837
NODE_41070_length_501_cov_208.708955	327	413	169	1	86	0.0116279
NODE_41070_length_501_cov_208.708955	327	413	171	1	86	0.0116279
NODE_41071_length_501_cov_29.126866	23	103	0	80	80	1.0000000
NODE_41071_length_501_cov_29.126866	76	156	0	80	80	1.0000000
NODE_41072_length_501_cov_23.736318	85	165	0	80	80	1.0000000
NODE_41072_length_501_cov_23.736318	138	218	0	80	80	1.0000000
NODE_41075_length_501_cov_7.820896	270	350	0	80	80	1.0000000
NODE_41075_length_501_cov_7.820896	323	403	0	80	80	1.0000000
NODE_41080_length_501_cov_6.437811	309	389	0	80	80	1.0000000
NODE_41097_length_501_cov_3.656716	289	312	0	23	23	1.0000000
NODE_41097_length_501_cov_3.656716	355	420	0	65	65	1.0000000
NODE_41103_length_501_cov_3.477612	329	409	0	80	80	1.0000000
NODE_41109_length_501_cov_3.134328	266	345	2	45	79	0.5696203
NODE_41109_length_501_cov_3.134328	266	345	4	34	79	0.4303797
NODE_41308_length_500_cov_77.895262	456	500	0	44	44	1.0000000
NODE_41309_length_500_cov_35.805486	326	406	0	80	80	1.0000000
NODE_41309_length_500_cov_35.805486	379	459	0	80	80	1.0000000
NODE_41310_length_500_cov_13.084788	160	221	2	41	61	0.6721311
NODE_41310_length_500_cov_13.084788	160	221	3	20	61	0.3278688
NODE_41311_length_500_cov_12.650873	215	295	0	80	80	1.0000000
NODE_41311_length_500_cov_12.650873	268	348	0	80	80	1.0000000
NODE_41312_length_500_cov_12.009975	203	268	0	10	65	0.1538462
NODE_41312_length_500_cov_12.009975	203	268	2	35	65	0.5384616
NODE_41312_length_500_cov_12.009975	203	268	4	20	65	0.3076923
NODE_41312_length_500_cov_12.009975	241	321	2	7	80	0.0875000
NODE_41312_length_500_cov_12.009975	241	321	4	38	80	0.4750000
NODE_41312_length_500_cov_12.009975	241	321	5	35	80	0.4375000
NODE_41325_length_500_cov_4.653367	224	295	0	71	71	1.0000000
NODE_41415_length_500_cov_1.650873	355	435	0	80	80	1.0000000
NODE_41415_length_500_cov_1.650873	408	488	0	80	80	1.0000000
NODE_41462_length_500_cov_1.231920	169	212	0	29	43	0.6744186
NODE_41462_length_500_cov_1.231920	169	212	2	14	43	0.3255814
NODE_41542_length_499_cov_358.730000	425	492	14	2	67	0.0298507
NODE_41542_length_499_cov_358.730000	425	492	16	3	67	0.0447761
NODE_41542_length_499_cov_358.730000	425	492	17	1	67	0.0149254
NODE_41542_length_499_cov_358.730000	425	492	20	1	67	0.0149254
NODE_41542_length_499_cov_358.730000	425	492	24	1	67	0.0149254
NODE_41542_length_499_cov_358.730000	425	492	30	3	67	0.0447761
NODE_41542_length_499_cov_358.730000	425	492	32	2	67	0.0298507
NODE_41542_length_499_cov_358.730000	425	492	36	4	67	0.0597015
NODE_41542_length_499_cov_358.730000	425	492	42	3	67	0.0447761
NODE_41542_length_499_cov_358.730000	425	492	46	5	67	0.0746269
NODE_41542_length_499_cov_358.730000	425	492	50	8	67	0.1194030
NODE_41542_length_499_cov_358.730000	425	492	52	3	67	0.0447761
NODE_41542_length_499_cov_358.730000	425	492	54	1	67	0.0149254
NODE_41542_length_499_cov_358.730000	425	492	56	2	67	0.0298507
NODE_41542_length_499_cov_358.730000	425	492	60	1	67	0.0149254
NODE_41542_length_499_cov_358.730000	425	492	62	1	67	0.0149254
NODE_41542_length_499_cov_358.730000	425	492	64	4	67	0.0597015
NODE_41542_length_499_cov_358.730000	425	492	68	2	67	0.0298507
NODE_41542_length_499_cov_358.730000	425	492	69	1	67	0.0149254
NODE_41542_length_499_cov_358.730000	425	492	71	1	67	0.0149254
NODE_41542_length_499_cov_358.730000	425	492	74	1	67	0.0149254
NODE_41542_length_499_cov_358.730000	425	492	75	2	67	0.0298507
NODE_41542_length_499_cov_358.730000	425	492	77	5	67	0.0746269
NODE_41542_length_499_cov_358.730000	425	492	79	5	67	0.0746269
NODE_41542_length_499_cov_358.730000	425	492	83	3	67	0.0447761
NODE_41542_length_499_cov_358.730000	425	492	85	1	67	0.0149254
NODE_41542_length_499_cov_358.730000	425	492	87	1	67	0.0149254
NODE_41543_length_499_cov_21.135000	52	132	0	80	80	1.0000000
NODE_41543_length_499_cov_21.135000	105	185	0	80	80	1.0000000
NODE_41544_length_499_cov_11.917500	50	130	0	80	80	1.0000000
NODE_41544_length_499_cov_11.917500	103	183	0	80	80	1.0000000
NODE_41549_length_499_cov_5.007500	0	54	0	54	54	1.0000000
NODE_41563_length_499_cov_3.482500	307	336	10	16	29	0.5517241
NODE_41563_length_499_cov_3.482500	307	336	12	9	29	0.3103448
NODE_41563_length_499_cov_3.482500	307	336	14	4	29	0.1379310
NODE_41594_length_499_cov_2.420000	198	247	0	49	49	1.0000000
NODE_41662_length_499_cov_1.445000	311	372	0	61	61	1.0000000
NODE_41770_length_498_cov_31.704261	12	92	0	80	80	1.0000000
NODE_41770_length_498_cov_31.704261	65	145	0	80	80	1.0000000
NODE_41775_length_498_cov_7.002506	256	336	2	47	80	0.5875000
NODE_41775_length_498_cov_7.002506	256	336	6	1	80	0.0125000
NODE_41775_length_498_cov_7.002506	256	336	7	8	80	0.1000000
NODE_41775_length_498_cov_7.002506	256	336	8	1	80	0.0125000
NODE_41775_length_498_cov_7.002506	256	336	12	23	80	0.2875000
NODE_41780_length_498_cov_5.759398	217	247	0	30	30	1.0000000
NODE_41814_length_498_cov_3.075188	225	262	2	19	37	0.5135135
NODE_41814_length_498_cov_3.075188	225	262	4	7	37	0.1891892
NODE_41814_length_498_cov_3.075188	225	262	8	11	37	0.2972973
NODE_41814_length_498_cov_3.075188	246	324	4	5	78	0.0641026
NODE_41814_length_498_cov_3.075188	246	324	6	6	78	0.0769231
NODE_41814_length_498_cov_3.075188	246	324	7	20	78	0.2564103
NODE_41814_length_498_cov_3.075188	246	324	8	47	78	0.6025641
NODE_42016_length_497_cov_44.105528	169	249	0	80	80	1.0000000
NODE_42016_length_497_cov_44.105528	222	302	0	80	80	1.0000000
NODE_42017_length_497_cov_10.145729	85	165	0	44	80	0.5500000
NODE_42017_length_497_cov_10.145729	85	165	2	36	80	0.4500000
NODE_42017_length_497_cov_10.145729	138	226	2	88	88	1.0000000
NODE_42024_length_497_cov_6.618090	231	304	0	45	73	0.6164383
NODE_42024_length_497_cov_6.618090	231	304	5	5	73	0.0684932
NODE_42024_length_497_cov_6.618090	231	304	6	23	73	0.3150685
NODE_42024_length_497_cov_6.618090	284	364	6	80	80	1.0000000
NODE_42065_length_497_cov_2.889447	109	189	0	44	80	0.5500000
NODE_42065_length_497_cov_2.889447	109	189	2	36	80	0.4500000
NODE_42065_length_497_cov_2.889447	162	242	2	80	80	1.0000000
NODE_42071_length_497_cov_2.623116	302	368	0	12	66	0.1818182
NODE_42071_length_497_cov_2.623116	302	368	5	54	66	0.8181818
NODE_42071_length_497_cov_2.623116	355	406	0	14	51	0.2745098
NODE_42071_length_497_cov_2.623116	355	406	5	37	51	0.7254902
NODE_42100_length_497_cov_1.909548	106	186	2	1	80	0.0125000
NODE_42100_length_497_cov_1.909548	106	186	4	5	80	0.0625000
NODE_42100_length_497_cov_1.909548	106	186	5	6	80	0.0750000
NODE_42100_length_497_cov_1.909548	106	186	9	22	80	0.2750000
NODE_42100_length_497_cov_1.909548	106	186	11	7	80	0.0875000
NODE_42100_length_497_cov_1.909548	106	186	13	8	80	0.1000000
NODE_42100_length_497_cov_1.909548	106	186	14	4	80	0.0500000
NODE_42100_length_497_cov_1.909548	106	186	15	14	80	0.1750000
NODE_42100_length_497_cov_1.909548	106	186	16	13	80	0.1625000
NODE_42100_length_497_cov_1.909548	159	240	14	8	81	0.0987654
NODE_42100_length_497_cov_1.909548	159	240	15	15	81	0.1851852
NODE_42100_length_497_cov_1.909548	159	240	16	13	81	0.1604938
NODE_42100_length_497_cov_1.909548	159	240	18	11	81	0.1358025
NODE_42100_length_497_cov_1.909548	159	240	21	1	81	0.0123457
NODE_42100_length_497_cov_1.909548	159	240	29	1	81	0.0123457
NODE_42100_length_497_cov_1.909548	159	240	30	4	81	0.0493827
NODE_42100_length_497_cov_1.909548	159	240	42	3	81	0.0370370
NODE_42100_length_497_cov_1.909548	159	240	48	1	81	0.0123457
NODE_42100_length_497_cov_1.909548	159	240	50	2	81	0.0246914
NODE_42100_length_497_cov_1.909548	159	240	54	2	81	0.0246914
NODE_42100_length_497_cov_1.909548	159	240	55	3	81	0.0370370
NODE_42100_length_497_cov_1.909548	159	240	56	2	81	0.0246914
NODE_42100_length_497_cov_1.909548	159	240	58	5	81	0.0617284
NODE_42100_length_497_cov_1.909548	159	240	60	10	81	0.1234568
NODE_42100_length_497_cov_1.909548	262	324	19	3	62	0.0483871
NODE_42100_length_497_cov_1.909548	262	324	21	4	62	0.0645161
NODE_42100_length_497_cov_1.909548	262	324	29	2	62	0.0322581
NODE_42100_length_497_cov_1.909548	262	324	31	1	62	0.0161290
NODE_42100_length_497_cov_1.909548	262	324	33	3	62	0.0483871
NODE_42100_length_497_cov_1.909548	262	324	41	1	62	0.0161290
NODE_42100_length_497_cov_1.909548	262	324	49	1	62	0.0161290
NODE_42100_length_497_cov_1.909548	262	324	50	4	62	0.0645161
NODE_42100_length_497_cov_1.909548	262	324	53	35	62	0.5645161
NODE_42100_length_497_cov_1.909548	262	324	55	8	62	0.1290323
NODE_42131_length_497_cov_1.500000	259	339	0	80	80	1.0000000
NODE_42136_length_497_cov_1.404523	211	263	0	33	52	0.6346154
NODE_42136_length_497_cov_1.404523	211	263	2	19	52	0.3653846
NODE_42279_length_496_cov_5.619647	239	269	0	30	30	1.0000000
NODE_42281_length_496_cov_5.392947	103	168	2	65	65	1.0000000
NODE_42281_length_496_cov_5.392947	141	221	2	37	80	0.4625000
NODE_42281_length_496_cov_5.392947	141	221	4	40	80	0.5000000
NODE_42281_length_496_cov_5.392947	141	221	6	3	80	0.0375000
NODE_42281_length_496_cov_5.392947	217	295	0	30	78	0.3846154
NODE_42281_length_496_cov_5.392947	217	295	4	48	78	0.6153846
NODE_42281_length_496_cov_5.392947	270	295	0	25	25	1.0000000
NODE_42287_length_496_cov_4.397985	388	467	0	2	79	0.0253165
NODE_42287_length_496_cov_4.397985	388	467	2	77	79	0.9746835
NODE_42288_length_496_cov_4.193955	235	315	6	60	80	0.7500000
NODE_42288_length_496_cov_4.193955	235	315	12	20	80	0.2500000
NODE_42297_length_496_cov_3.531486	192	273	0	15	81	0.1851852
NODE_42297_length_496_cov_3.531486	192	273	2	66	81	0.8148148
NODE_42297_length_496_cov_3.531486	245	325	0	67	80	0.8375000
NODE_42297_length_496_cov_3.531486	245	325	2	13	80	0.1625000
NODE_42298_length_496_cov_3.377834	252	332	0	80	80	1.0000000
NODE_42298_length_496_cov_3.377834	305	383	0	78	78	1.0000000
NODE_42316_length_496_cov_2.659950	203	251	0	42	48	0.8750000
NODE_42316_length_496_cov_2.659950	203	251	4	6	48	0.1250000
NODE_42328_length_496_cov_2.445844	95	165	0	70	70	1.0000000
NODE_42328_length_496_cov_2.445844	148	228	0	80	80	1.0000000
NODE_42333_length_496_cov_2.214106	299	359	0	1	60	0.0166667
NODE_42333_length_496_cov_2.214106	299	359	2	59	60	0.9833333
NODE_42415_length_496_cov_1.395466	273	317	2	44	44	1.0000000
NODE_42461_length_496_cov_0.979849	214	294	0	8	80	0.1000000
NODE_42461_length_496_cov_0.979849	214	294	2	37	80	0.4625000
NODE_42461_length_496_cov_0.979849	214	294	4	35	80	0.4375000
NODE_42525_length_495_cov_34.888889	209	264	2	14	55	0.2545455
NODE_42525_length_495_cov_34.888889	209	264	6	41	55	0.7454545
NODE_42526_length_495_cov_12.800505	268	348	0	80	80	1.0000000
NODE_42526_length_495_cov_12.800505	321	401	0	80	80	1.0000000
NODE_42529_length_495_cov_7.080808	386	416	0	30	30	1.0000000
NODE_42548_length_495_cov_3.868687	218	298	0	17	80	0.2125000
NODE_42548_length_495_cov_3.868687	218	298	4	44	80	0.5500000
NODE_42548_length_495_cov_3.868687	218	298	6	19	80	0.2375000
NODE_42736_length_495_cov_0.792929	274	309	0	17	35	0.4857143
NODE_42736_length_495_cov_0.792929	274	309	2	18	35	0.5142857
NODE_42773_length_494_cov_20.096203	182	262	0	80	80	1.0000000
NODE_42773_length_494_cov_20.096203	235	315	0	80	80	1.0000000
NODE_42778_length_494_cov_7.498734	187	240	2	53	53	1.0000000
NODE_42788_length_494_cov_4.283544	255	332	0	77	77	1.0000000
NODE_42804_length_494_cov_3.496203	209	276	0	24	67	0.3582090
NODE_42804_length_494_cov_3.496203	209	276	2	43	67	0.6417910
NODE_42812_length_494_cov_3.032911	385	432	0	1	47	0.0212766
NODE_42812_length_494_cov_3.032911	385	432	2	4	47	0.0851064
NODE_42812_length_494_cov_3.032911	385	432	4	42	47	0.8936170
NODE_42816_length_494_cov_2.908861	189	269	6	9	80	0.1125000
NODE_42816_length_494_cov_2.908861	189	269	10	10	80	0.1250000
NODE_42816_length_494_cov_2.908861	189	269	12	61	80	0.7625000
NODE_42822_length_494_cov_2.777215	145	188	0	43	43	1.0000000
NODE_42834_length_494_cov_2.531646	371	430	0	59	59	1.0000000
NODE_42834_length_494_cov_2.531646	428	494	0	66	66	1.0000000
NODE_43021_length_493_cov_34.946701	140	220	0	80	80	1.0000000
NODE_43021_length_493_cov_34.946701	193	265	0	72	72	1.0000000
NODE_43022_length_493_cov_12.451777	173	253	0	80	80	1.0000000
NODE_43022_length_493_cov_12.451777	226	306	0	80	80	1.0000000
NODE_43025_length_493_cov_8.540609	116	146	0	30	30	1.0000000
NODE_43025_length_493_cov_8.540609	119	199	0	80	80	1.0000000
NODE_43031_length_493_cov_6.144670	300	380	0	61	80	0.7625000
NODE_43031_length_493_cov_6.144670	300	380	1	19	80	0.2375000
NODE_43031_length_493_cov_6.144670	353	433	0	80	80	1.0000000
NODE_43046_length_493_cov_3.840102	178	258	0	80	80	1.0000000
NODE_43046_length_493_cov_3.840102	231	311	0	80	80	1.0000000
NODE_43125_length_493_cov_1.588832	126	206	0	80	80	1.0000000
NODE_43125_length_493_cov_1.588832	179	259	0	80	80	1.0000000
NODE_43261_length_492_cov_5.488550	117	197	0	19	80	0.2375000
NODE_43261_length_492_cov_5.488550	117	197	4	61	80	0.7625000
NODE_43261_length_492_cov_5.488550	170	250	0	72	80	0.9000000
NODE_43261_length_492_cov_5.488550	170	250	4	8	80	0.1000000
NODE_43270_length_492_cov_4.445293	158	234	0	76	76	1.0000000
NODE_43270_length_492_cov_4.445293	207	285	0	78	78	1.0000000
NODE_43273_length_492_cov_4.244275	272	315	0	43	43	1.0000000
NODE_43293_length_492_cov_3.297710	113	193	0	80	80	1.0000000
NODE_43528_length_491_cov_17.196429	138	218	0	80	80	1.0000000
NODE_43528_length_491_cov_17.196429	191	271	0	80	80	1.0000000
NODE_43529_length_491_cov_17.193878	77	157	0	80	80	1.0000000
NODE_43529_length_491_cov_17.193878	130	210	0	80	80	1.0000000
NODE_43535_length_491_cov_5.505102	215	284	4	69	69	1.0000000
NODE_43535_length_491_cov_5.505102	215	295	4	80	80	1.0000000
NODE_43535_length_491_cov_5.505102	268	348	0	40	80	0.5000000
NODE_43535_length_491_cov_5.505102	268	348	2	7	80	0.0875000
NODE_43535_length_491_cov_5.505102	268	348	4	33	80	0.4125000
NODE_43536_length_491_cov_5.477041	169	222	6	53	53	1.0000000
NODE_43546_length_491_cov_4.176020	383	449	0	1	66	0.0151515
NODE_43546_length_491_cov_4.176020	383	449	14	6	66	0.0909091
NODE_43546_length_491_cov_4.176020	383	449	16	59	66	0.8939394
NODE_43546_length_491_cov_4.176020	422	476	4	16	54	0.2962963
NODE_43546_length_491_cov_4.176020	422	476	16	38	54	0.7037037
NODE_43570_length_491_cov_2.887755	348	428	0	80	80	1.0000000
NODE_43570_length_491_cov_2.887755	401	472	0	71	71	1.0000000
NODE_43575_length_491_cov_2.693878	239	316	2	77	77	1.0000000
NODE_43744_length_490_cov_10.058824	192	272	0	80	80	1.0000000
NODE_43744_length_490_cov_10.058824	245	325	0	80	80	1.0000000
NODE_43748_length_490_cov_6.652174	304	363	4	59	59	1.0000000
NODE_43816_length_490_cov_2.212276	241	300	0	59	59	1.0000000
NODE_43816_length_490_cov_2.212276	280	358	0	78	78	1.0000000
NODE_43886_length_490_cov_1.360614	97	159	4	17	62	0.2741936
NODE_43886_length_490_cov_1.360614	97	159	6	44	62	0.7096774
NODE_43886_length_490_cov_1.360614	97	159	9	1	62	0.0161290
NODE_43886_length_490_cov_1.360614	132	212	6	26	80	0.3250000
NODE_43886_length_490_cov_1.360614	132	212	9	1	80	0.0125000
NODE_43886_length_490_cov_1.360614	132	212	10	53	80	0.6625000
NODE_43993_length_489_cov_55.992308	50	130	0	80	80	1.0000000
NODE_43993_length_489_cov_55.992308	103	183	0	80	80	1.0000000
NODE_43993_length_489_cov_55.992308	179	259	0	80	80	1.0000000
NODE_43993_length_489_cov_55.992308	232	312	0	80	80	1.0000000
NODE_43994_length_489_cov_31.707692	299	384	0	26	85	0.3058824
NODE_43994_length_489_cov_31.707692	299	384	2	9	85	0.1058824
NODE_43994_length_489_cov_31.707692	299	384	6	38	85	0.4470588
NODE_43994_length_489_cov_31.707692	299	384	8	12	85	0.1411765
NODE_43994_length_489_cov_31.707692	299	384	0	26	85	0.3058824
NODE_43994_length_489_cov_31.707692	299	384	2	9	85	0.1058824
NODE_43994_length_489_cov_31.707692	299	384	6	38	85	0.4470588
NODE_43994_length_489_cov_31.707692	299	384	8	12	85	0.1411765
NODE_43996_length_489_cov_13.661538	227	307	0	80	80	1.0000000
NODE_43996_length_489_cov_13.661538	280	358	0	56	78	0.7179487
NODE_43996_length_489_cov_13.661538	280	358	2	22	78	0.2820513
NODE_43997_length_489_cov_12.017949	214	294	0	80	80	1.0000000
NODE_43997_length_489_cov_12.017949	267	347	0	80	80	1.0000000
NODE_43998_length_489_cov_10.774359	262	304	0	42	42	1.0000000
NODE_44001_length_489_cov_8.094872	141	221	0	80	80	1.0000000
NODE_44001_length_489_cov_8.094872	194	247	0	53	53	1.0000000
NODE_44007_length_489_cov_5.284615	176	256	0	80	80	1.0000000
NODE_44007_length_489_cov_5.284615	229	309	0	80	80	1.0000000
NODE_44096_length_489_cov_1.646154	234	278	0	44	44	1.0000000
NODE_44105_length_489_cov_1.574359	351	391	2	40	40	1.0000000
NODE_44105_length_489_cov_1.574359	351	383	2	32	32	1.0000000
NODE_44105_length_489_cov_1.574359	365	445	0	46	80	0.5750000
NODE_44105_length_489_cov_1.574359	365	445	2	34	80	0.4250000
NODE_44105_length_489_cov_1.574359	365	445	0	46	80	0.5750000
NODE_44105_length_489_cov_1.574359	365	445	2	34	80	0.4250000
NODE_44105_length_489_cov_1.574359	366	445	0	46	79	0.5822785
NODE_44105_length_489_cov_1.574359	366	445	2	33	79	0.4177215
NODE_44231_length_488_cov_15.406170	235	313	0	78	78	1.0000000
NODE_44231_length_488_cov_15.406170	286	367	0	81	81	1.0000000
NODE_44234_length_488_cov_8.416452	210	290	0	80	80	1.0000000
NODE_44234_length_488_cov_8.416452	263	343	0	80	80	1.0000000
NODE_44240_length_488_cov_6.084833	254	302	0	19	48	0.3958333
NODE_44240_length_488_cov_6.084833	254	302	2	29	48	0.6041667
NODE_44243_length_488_cov_5.434447	210	279	0	69	69	1.0000000
NODE_44243_length_488_cov_5.434447	265	300	0	35	35	1.0000000
NODE_44263_length_488_cov_3.431877	212	248	0	18	36	0.5000000
NODE_44263_length_488_cov_3.431877	212	248	2	18	36	0.5000000
NODE_44264_length_488_cov_3.424165	320	367	4	43	47	0.9148936
NODE_44264_length_488_cov_3.424165	320	367	9	1	47	0.0212766
NODE_44264_length_488_cov_3.424165	320	367	10	3	47	0.0638298
NODE_44264_length_488_cov_3.424165	320	378	4	43	58	0.7413793
NODE_44264_length_488_cov_3.424165	320	378	9	1	58	0.0172414
NODE_44264_length_488_cov_3.424165	320	378	10	14	58	0.2413793
NODE_44264_length_488_cov_3.424165	351	393	4	12	42	0.2857143
NODE_44264_length_488_cov_3.424165	351	393	9	1	42	0.0238095
NODE_44264_length_488_cov_3.424165	351	393	10	29	42	0.6904762
NODE_44264_length_488_cov_3.424165	360	395	4	3	35	0.0857143
NODE_44264_length_488_cov_3.424165	360	395	9	1	35	0.0285714
NODE_44264_length_488_cov_3.424165	360	395	10	31	35	0.8857143
NODE_44274_length_488_cov_2.850900	276	356	0	80	80	1.0000000
NODE_44376_length_488_cov_1.562982	31	67	0	36	36	1.0000000
NODE_44496_length_487_cov_7.028351	278	358	7	8	80	0.1000000
NODE_44496_length_487_cov_7.028351	278	358	9	7	80	0.0875000
NODE_44496_length_487_cov_7.028351	278	358	10	65	80	0.8125000
NODE_44498_length_487_cov_6.804124	242	313	6	1	71	0.0140845
NODE_44498_length_487_cov_6.804124	242	313	11	22	71	0.3098592
NODE_44498_length_487_cov_6.804124	242	313	12	48	71	0.6760563
NODE_44498_length_487_cov_6.804124	286	366	6	54	80	0.6750000
NODE_44498_length_487_cov_6.804124	286	366	11	22	80	0.2750000
NODE_44498_length_487_cov_6.804124	286	366	12	4	80	0.0500000
NODE_44500_length_487_cov_5.917526	140	220	0	80	80	1.0000000
NODE_44500_length_487_cov_5.917526	193	273	0	69	80	0.8625000
NODE_44500_length_487_cov_5.917526	193	273	2	11	80	0.1375000
NODE_44520_length_487_cov_3.296392	235	315	1	38	80	0.4750000
NODE_44520_length_487_cov_3.296392	235	315	2	6	80	0.0750000
NODE_44520_length_487_cov_3.296392	235	315	4	3	80	0.0375000
NODE_44520_length_487_cov_3.296392	235	315	6	1	80	0.0125000
NODE_44520_length_487_cov_3.296392	235	315	8	2	80	0.0250000
NODE_44520_length_487_cov_3.296392	235	315	10	1	80	0.0125000
NODE_44520_length_487_cov_3.296392	235	315	12	8	80	0.1000000
NODE_44520_length_487_cov_3.296392	235	315	14	21	80	0.2625000
NODE_44521_length_487_cov_3.237113	301	363	0	11	62	0.1774193
NODE_44521_length_487_cov_3.237113	301	363	2	51	62	0.8225806
NODE_44525_length_487_cov_3.074742	214	294	1	14	80	0.1750000
NODE_44525_length_487_cov_3.074742	214	294	2	42	80	0.5250000
NODE_44525_length_487_cov_3.074742	214	294	4	5	80	0.0625000
NODE_44525_length_487_cov_3.074742	214	294	6	4	80	0.0500000
NODE_44525_length_487_cov_3.074742	214	294	10	15	80	0.1875000
NODE_44723_length_486_cov_6.609819	206	286	0	80	80	1.0000000
NODE_44728_length_486_cov_5.428941	147	227	0	80	80	1.0000000
NODE_44754_length_486_cov_3.072351	131	211	0	80	80	1.0000000
NODE_44754_length_486_cov_3.072351	190	235	0	45	45	1.0000000
NODE_44769_length_486_cov_2.581395	156	236	0	80	80	1.0000000
NODE_44769_length_486_cov_2.581395	209	289	0	80	80	1.0000000
NODE_44781_length_486_cov_2.343669	189	230	0	41	41	1.0000000
NODE_44781_length_486_cov_2.343669	242	306	0	64	64	1.0000000
NODE_44959_length_485_cov_29.505181	270	350	0	80	80	1.0000000
NODE_44959_length_485_cov_29.505181	323	403	0	80	80	1.0000000
NODE_44959_length_485_cov_29.505181	399	479	0	80	80	1.0000000
NODE_44960_length_485_cov_10.450777	67	153	0	86	86	1.0000000
NODE_44960_length_485_cov_10.450777	133	206	0	73	73	1.0000000
NODE_44965_length_485_cov_5.922280	196	273	0	77	77	1.0000000
NODE_44965_length_485_cov_5.922280	246	326	0	80	80	1.0000000
NODE_44966_length_485_cov_5.818653	279	359	0	53	80	0.6625000
NODE_44966_length_485_cov_5.818653	279	359	2	27	80	0.3375000
NODE_44966_length_485_cov_5.818653	332	412	2	80	80	1.0000000
NODE_44968_length_485_cov_5.670984	321	396	0	33	75	0.4400000
NODE_44968_length_485_cov_5.670984	321	396	4	42	75	0.5600000
NODE_44992_length_485_cov_3.518135	162	210	0	48	48	1.0000000
NODE_45005_length_485_cov_2.790155	193	253	2	3	60	0.0500000
NODE_45005_length_485_cov_2.790155	193	253	4	57	60	0.9500000
NODE_45021_length_485_cov_2.427461	170	249	0	79	79	1.0000000
NODE_45100_length_485_cov_1.264249	232	251	0	19	19	1.0000000
NODE_45193_length_484_cov_33.384416	92	172	0	80	80	1.0000000
NODE_45193_length_484_cov_33.384416	145	225	0	80	80	1.0000000
NODE_45195_length_484_cov_9.111688	136	216	0	80	80	1.0000000
NODE_45195_length_484_cov_9.111688	189	270	0	81	81	1.0000000
NODE_45196_length_484_cov_8.353247	165	244	0	79	79	1.0000000
NODE_45196_length_484_cov_8.353247	217	297	0	80	80	1.0000000
NODE_45197_length_484_cov_8.119481	108	188	0	80	80	1.0000000
NODE_45197_length_484_cov_8.119481	161	241	0	80	80	1.0000000
NODE_45200_length_484_cov_7.703896	208	288	0	80	80	1.0000000
NODE_45200_length_484_cov_7.703896	261	341	0	80	80	1.0000000
NODE_45202_length_484_cov_7.153247	230	292	0	62	62	1.0000000
NODE_45204_length_484_cov_6.594805	221	301	0	80	80	1.0000000
NODE_45204_length_484_cov_6.594805	274	354	0	80	80	1.0000000
NODE_45218_length_484_cov_4.044156	267	347	0	28	80	0.3500000
NODE_45218_length_484_cov_4.044156	267	347	2	21	80	0.2625000
NODE_45218_length_484_cov_4.044156	267	347	4	31	80	0.3875000
NODE_45218_length_484_cov_4.044156	342	396	2	14	54	0.2592593
NODE_45218_length_484_cov_4.044156	342	396	4	40	54	0.7407407
NODE_45225_length_484_cov_3.787013	287	331	2	44	44	1.0000000
NODE_45225_length_484_cov_3.787013	307	386	0	27	79	0.3417721
NODE_45225_length_484_cov_3.787013	307	386	2	52	79	0.6582279
NODE_45225_length_484_cov_3.787013	317	386	0	27	69	0.3913043
NODE_45225_length_484_cov_3.787013	317	386	2	42	69	0.6086956
NODE_45276_length_484_cov_2.254545	79	132	0	3	53	0.0566038
NODE_45276_length_484_cov_2.254545	79	132	2	50	53	0.9433962
NODE_45352_length_484_cov_1.322078	429	477	0	48	48	1.0000000
NODE_45353_length_484_cov_1.314286	431	472	0	41	41	1.0000000
NODE_45459_length_483_cov_40.815104	396	473	6	77	77	1.0000000
NODE_45459_length_483_cov_40.815104	396	473	6	77	77	1.0000000
NODE_45473_length_483_cov_5.289062	124	185	0	48	61	0.7868853
NODE_45473_length_483_cov_5.289062	124	185	2	3	61	0.0491803
NODE_45473_length_483_cov_5.289062	124	185	4	10	61	0.1639344
NODE_45494_length_483_cov_4.114583	226	306	0	80	80	1.0000000
NODE_45494_length_483_cov_4.114583	226	305	0	79	79	1.0000000
NODE_45494_length_483_cov_4.114583	226	306	0	80	80	1.0000000
NODE_45494_length_483_cov_4.114583	226	306	0	80	80	1.0000000
NODE_45494_length_483_cov_4.114583	279	359	0	47	80	0.5875000
NODE_45494_length_483_cov_4.114583	279	359	2	33	80	0.4125000
NODE_45494_length_483_cov_4.114583	279	325	0	46	46	1.0000000
NODE_45494_length_483_cov_4.114583	297	323	0	26	26	1.0000000
NODE_45495_length_483_cov_4.046875	68	117	0	49	49	1.0000000
NODE_45495_length_483_cov_4.046875	184	250	4	65	66	0.9848485
NODE_45495_length_483_cov_4.046875	184	250	7	1	66	0.0151515
NODE_45635_length_483_cov_1.205729	249	291	0	42	42	1.0000000
NODE_45725_length_482_cov_37.900783	72	152	2	32	80	0.4000000
NODE_45725_length_482_cov_37.900783	72	152	4	48	80	0.6000000
NODE_45725_length_482_cov_37.900783	125	205	0	36	80	0.4500000
NODE_45725_length_482_cov_37.900783	125	205	2	22	80	0.2750000
NODE_45725_length_482_cov_37.900783	125	205	4	22	80	0.2750000
NODE_45728_length_482_cov_10.545692	233	297	2	64	64	1.0000000
NODE_45729_length_482_cov_9.342037	281	333	2	52	52	1.0000000
NODE_45730_length_482_cov_8.190601	247	311	18	6	64	0.0937500
NODE_45730_length_482_cov_8.190601	247	311	20	2	64	0.0312500
NODE_45730_length_482_cov_8.190601	247	311	22	2	64	0.0312500
NODE_45730_length_482_cov_8.190601	247	311	23	7	64	0.1093750
NODE_45730_length_482_cov_8.190601	247	311	27	6	64	0.0937500
NODE_45730_length_482_cov_8.190601	247	311	28	6	64	0.0937500
NODE_45730_length_482_cov_8.190601	247	311	29	35	64	0.5468750
NODE_45730_length_482_cov_8.190601	284	355	18	24	71	0.3380282
NODE_45730_length_482_cov_8.190601	284	355	19	26	71	0.3661972
NODE_45730_length_482_cov_8.190601	284	355	20	2	71	0.0281690
NODE_45730_length_482_cov_8.190601	284	355	22	2	71	0.0281690
NODE_45730_length_482_cov_8.190601	284	355	23	7	71	0.0985916
NODE_45730_length_482_cov_8.190601	284	355	27	6	71	0.0845070
NODE_45730_length_482_cov_8.190601	284	355	29	4	71	0.0563380
NODE_45734_length_482_cov_6.002611	112	192	0	80	80	1.0000000
NODE_45734_length_482_cov_6.002611	165	245	0	80	80	1.0000000
NODE_45735_length_482_cov_5.953003	315	395	0	80	80	1.0000000
NODE_45735_length_482_cov_5.953003	368	441	0	73	73	1.0000000
NODE_45748_length_482_cov_4.530026	20	85	0	65	65	1.0000000
NODE_45759_length_482_cov_3.791123	278	358	0	80	80	1.0000000
NODE_45759_length_482_cov_3.791123	331	411	0	80	80	1.0000000
NODE_45842_length_482_cov_1.647520	382	446	2	64	64	1.0000000
NODE_45842_length_482_cov_1.647520	435	482	0	6	47	0.1276596
NODE_45842_length_482_cov_1.647520	435	482	2	41	47	0.8723404
NODE_45994_length_481_cov_50.623037	154	234	0	32	80	0.4000000
NODE_45994_length_481_cov_50.623037	154	234	2	48	80	0.6000000
NODE_45994_length_481_cov_50.623037	207	287	0	13	80	0.1625000
NODE_45994_length_481_cov_50.623037	207	287	2	67	80	0.8375000
NODE_45995_length_481_cov_30.939791	149	198	0	49	49	1.0000000
NODE_45995_length_481_cov_30.939791	171	235	0	64	64	1.0000000
NODE_45995_length_481_cov_30.939791	171	235	0	64	64	1.0000000
NODE_45996_length_481_cov_30.183246	0	41	0	37	41	0.9024390
NODE_45996_length_481_cov_30.183246	0	41	2	4	41	0.0975610
NODE_45996_length_481_cov_30.183246	0	39	0	37	39	0.9487180
NODE_45996_length_481_cov_30.183246	0	39	2	2	39	0.0512821
NODE_45996_length_481_cov_30.183246	0	44	0	37	44	0.8409091
NODE_45996_length_481_cov_30.183246	0	44	2	7	44	0.1590909
NODE_45996_length_481_cov_30.183246	0	44	0	37	44	0.8409091
NODE_45996_length_481_cov_30.183246	0	44	2	7	44	0.1590909
NODE_45996_length_481_cov_30.183246	0	44	0	37	44	0.8409091
NODE_45996_length_481_cov_30.183246	0	44	2	7	44	0.1590909
NODE_45996_length_481_cov_30.183246	0	44	0	37	44	0.8409091
NODE_45996_length_481_cov_30.183246	0	44	2	7	44	0.1590909
NODE_45996_length_481_cov_30.183246	17	97	0	20	80	0.2500000
NODE_45996_length_481_cov_30.183246	17	97	2	60	80	0.7500000
NODE_45996_length_481_cov_30.183246	17	97	0	20	80	0.2500000
NODE_45996_length_481_cov_30.183246	17	97	2	60	80	0.7500000
NODE_45996_length_481_cov_30.183246	17	97	0	20	80	0.2500000
NODE_45996_length_481_cov_30.183246	17	97	2	60	80	0.7500000
NODE_45996_length_481_cov_30.183246	17	97	0	20	80	0.2500000
NODE_45996_length_481_cov_30.183246	17	97	2	60	80	0.7500000
NODE_45996_length_481_cov_30.183246	17	97	0	20	80	0.2500000
NODE_45996_length_481_cov_30.183246	17	97	2	60	80	0.7500000
NODE_45996_length_481_cov_30.183246	17	97	0	20	80	0.2500000
NODE_45996_length_481_cov_30.183246	17	97	2	60	80	0.7500000
NODE_45997_length_481_cov_12.709424	250	330	1	80	80	1.0000000
NODE_45997_length_481_cov_12.709424	303	383	0	6	80	0.0750000
NODE_45997_length_481_cov_12.709424	303	383	1	74	80	0.9250000
NODE_46037_length_481_cov_3.002618	197	277	0	80	80	1.0000000
NODE_46064_length_481_cov_2.261780	271	351	6	13	80	0.1625000
NODE_46064_length_481_cov_2.261780	271	351	7	8	80	0.1000000
NODE_46064_length_481_cov_2.261780	271	351	8	42	80	0.5250000
NODE_46064_length_481_cov_2.261780	271	351	10	5	80	0.0625000
NODE_46064_length_481_cov_2.261780	271	351	12	12	80	0.1500000
NODE_46256_length_480_cov_22.346457	318	398	0	23	80	0.2875000
NODE_46256_length_480_cov_22.346457	318	398	2	57	80	0.7125000
NODE_46256_length_480_cov_22.346457	371	451	0	21	80	0.2625000
NODE_46256_length_480_cov_22.346457	371	451	2	59	80	0.7375000
NODE_46257_length_480_cov_16.488189	252	332	0	23	80	0.2875000
NODE_46257_length_480_cov_16.488189	252	332	2	57	80	0.7125000
NODE_46257_length_480_cov_16.488189	305	385	0	72	80	0.9000000
NODE_46257_length_480_cov_16.488189	305	385	2	8	80	0.1000000
NODE_46258_length_480_cov_12.874016	164	234	0	70	70	1.0000000
NODE_46258_length_480_cov_12.874016	207	273	0	66	66	1.0000000
NODE_46260_length_480_cov_11.879265	170	250	0	80	80	1.0000000
NODE_46260_length_480_cov_11.879265	223	303	0	80	80	1.0000000
NODE_46261_length_480_cov_8.774278	114	143	2	29	29	1.0000000
NODE_46261_length_480_cov_8.774278	165	245	2	21	80	0.2625000
NODE_46261_length_480_cov_8.774278	165	245	8	54	80	0.6750000
NODE_46261_length_480_cov_8.774278	165	245	10	5	80	0.0625000
NODE_46261_length_480_cov_8.774278	218	298	2	15	80	0.1875000
NODE_46261_length_480_cov_8.774278	218	298	8	50	80	0.6250000
NODE_46261_length_480_cov_8.774278	218	298	10	15	80	0.1875000
NODE_46261_length_480_cov_8.774278	385	428	1	43	43	1.0000000
NODE_46271_length_480_cov_5.671916	231	302	0	53	71	0.7464789
NODE_46271_length_480_cov_5.671916	231	302	1	18	71	0.2535211
NODE_46283_length_480_cov_4.354331	126	187	0	61	61	1.0000000
NODE_46283_length_480_cov_4.354331	218	298	0	80	80	1.0000000
NODE_46445_length_480_cov_1.152231	142	216	0	71	74	0.9594595
NODE_46445_length_480_cov_1.152231	142	216	5	1	74	0.0135135
NODE_46445_length_480_cov_1.152231	142	216	6	2	74	0.0270270
NODE_46470_length_480_cov_0.973753	31	71	0	40	40	1.0000000
NODE_46533_length_479_cov_28.205263	308	388	0	80	80	1.0000000
NODE_46533_length_479_cov_28.205263	361	441	0	80	80	1.0000000
NODE_46534_length_479_cov_23.944737	189	269	0	20	80	0.2500000
NODE_46534_length_479_cov_23.944737	189	269	2	60	80	0.7500000
NODE_46534_length_479_cov_23.944737	242	322	0	49	80	0.6125000
NODE_46534_length_479_cov_23.944737	242	322	2	31	80	0.3875000
NODE_46554_length_479_cov_4.942105	283	363	2	40	80	0.5000000
NODE_46554_length_479_cov_4.942105	283	363	4	31	80	0.3875000
NODE_46554_length_479_cov_4.942105	283	363	6	9	80	0.1125000
NODE_46554_length_479_cov_4.942105	336	416	0	35	80	0.4375000
NODE_46554_length_479_cov_4.942105	336	416	2	45	80	0.5625000
NODE_46574_length_479_cov_3.494737	217	279	4	50	62	0.8064516
NODE_46574_length_479_cov_3.494737	217	279	6	7	62	0.1129032
NODE_46574_length_479_cov_3.494737	217	279	8	5	62	0.0806452
NODE_46574_length_479_cov_3.494737	272	332	0	5	60	0.0833333
NODE_46574_length_479_cov_3.494737	272	332	4	55	60	0.9166667
NODE_46611_length_479_cov_2.281579	219	265	4	20	46	0.4347826
NODE_46611_length_479_cov_2.281579	219	265	6	26	46	0.5652174
NODE_46638_length_479_cov_1.839474	376	431	4	14	55	0.2545455
NODE_46638_length_479_cov_1.839474	376	431	8	11	55	0.2000000
NODE_46638_length_479_cov_1.839474	376	431	10	1	55	0.0181818
NODE_46638_length_479_cov_1.839474	376	431	12	24	55	0.4363636
NODE_46638_length_479_cov_1.839474	376	431	14	5	55	0.0909091
NODE_46654_length_479_cov_1.710526	203	265	0	62	62	1.0000000
NODE_46654_length_479_cov_1.710526	248	318	0	70	70	1.0000000
NODE_46828_length_478_cov_336.139842	153	233	59	1	80	0.0125000
NODE_46828_length_478_cov_336.139842	153	233	65	2	80	0.0250000
NODE_46828_length_478_cov_336.139842	153	233	66	1	80	0.0125000
NODE_46828_length_478_cov_336.139842	153	233	69	4	80	0.0500000
NODE_46828_length_478_cov_336.139842	153	233	73	2	80	0.0250000
NODE_46828_length_478_cov_336.139842	153	233	77	1	80	0.0125000
NODE_46828_length_478_cov_336.139842	153	233	78	1	80	0.0125000
NODE_46828_length_478_cov_336.139842	153	233	84	1	80	0.0125000
NODE_46828_length_478_cov_336.139842	153	233	88	1	80	0.0125000
NODE_46828_length_478_cov_336.139842	153	233	90	1	80	0.0125000
NODE_46828_length_478_cov_336.139842	153	233	94	4	80	0.0500000
NODE_46828_length_478_cov_336.139842	153	233	96	4	80	0.0500000
NODE_46828_length_478_cov_336.139842	153	233	98	1	80	0.0125000
NODE_46828_length_478_cov_336.139842	153	233	106	7	80	0.0875000
NODE_46828_length_478_cov_336.139842	153	233	107	1	80	0.0125000
NODE_46828_length_478_cov_336.139842	153	233	108	2	80	0.0250000
NODE_46828_length_478_cov_336.139842	153	233	114	6	80	0.0750000
NODE_46828_length_478_cov_336.139842	153	233	116	4	80	0.0500000
NODE_46828_length_478_cov_336.139842	153	233	122	3	80	0.0375000
NODE_46828_length_478_cov_336.139842	153	233	124	7	80	0.0875000
NODE_46828_length_478_cov_336.139842	153	233	126	2	80	0.0250000
NODE_46828_length_478_cov_336.139842	153	233	128	4	80	0.0500000
NODE_46828_length_478_cov_336.139842	153	233	136	1	80	0.0125000
NODE_46828_length_478_cov_336.139842	153	233	139	1	80	0.0125000
NODE_46828_length_478_cov_336.139842	153	233	140	1	80	0.0125000
NODE_46828_length_478_cov_336.139842	153	233	142	3	80	0.0375000
NODE_46828_length_478_cov_336.139842	153	233	144	6	80	0.0750000
NODE_46828_length_478_cov_336.139842	153	233	145	1	80	0.0125000
NODE_46828_length_478_cov_336.139842	153	233	146	2	80	0.0250000
NODE_46828_length_478_cov_336.139842	153	233	148	2	80	0.0250000
NODE_46828_length_478_cov_336.139842	153	233	153	1	80	0.0125000
NODE_46828_length_478_cov_336.139842	153	233	154	1	80	0.0125000
NODE_46828_length_478_cov_336.139842	153	233	158	1	80	0.0125000
NODE_46828_length_478_cov_336.139842	206	286	122	1	80	0.0125000
NODE_46828_length_478_cov_336.139842	206	286	124	1	80	0.0125000
NODE_46828_length_478_cov_336.139842	206	286	126	1	80	0.0125000
NODE_46828_length_478_cov_336.139842	206	286	128	4	80	0.0500000
NODE_46828_length_478_cov_336.139842	206	286	136	1	80	0.0125000
NODE_46828_length_478_cov_336.139842	206	286	139	1	80	0.0125000
NODE_46828_length_478_cov_336.139842	206	286	140	1	80	0.0125000
NODE_46828_length_478_cov_336.139842	206	286	142	5	80	0.0625000
NODE_46828_length_478_cov_336.139842	206	286	144	6	80	0.0750000
NODE_46828_length_478_cov_336.139842	206	286	145	4	80	0.0500000
NODE_46828_length_478_cov_336.139842	206	286	146	2	80	0.0250000
NODE_46828_length_478_cov_336.139842	206	286	148	14	80	0.1750000
NODE_46828_length_478_cov_336.139842	206	286	149	6	80	0.0750000
NODE_46828_length_478_cov_336.139842	206	286	150	8	80	0.1000000
NODE_46828_length_478_cov_336.139842	206	286	151	1	80	0.0125000
NODE_46828_length_478_cov_336.139842	206	286	152	12	80	0.1500000
NODE_46828_length_478_cov_336.139842	206	286	153	2	80	0.0250000
NODE_46828_length_478_cov_336.139842	206	286	154	7	80	0.0875000
NODE_46828_length_478_cov_336.139842	206	286	155	1	80	0.0125000
NODE_46828_length_478_cov_336.139842	206	286	158	2	80	0.0250000
NODE_46846_length_478_cov_4.448549	150	230	0	80	80	1.0000000
NODE_46846_length_478_cov_4.448549	203	284	0	81	81	1.0000000
NODE_46874_length_478_cov_2.627968	228	278	0	50	50	1.0000000
NODE_47128_length_477_cov_36.230159	225	305	1	31	80	0.3875000
NODE_47128_length_477_cov_36.230159	225	305	2	49	80	0.6125000
NODE_47128_length_477_cov_36.230159	278	358	1	29	80	0.3625000
NODE_47128_length_477_cov_36.230159	278	358	2	51	80	0.6375000
NODE_47129_length_477_cov_33.111111	307	387	0	39	80	0.4875000
NODE_47129_length_477_cov_33.111111	307	387	4	41	80	0.5125000
NODE_47129_length_477_cov_33.111111	360	440	0	80	80	1.0000000
NODE_47133_length_477_cov_11.235450	119	199	0	80	80	1.0000000
NODE_47133_length_477_cov_11.235450	172	247	0	75	75	1.0000000
NODE_47135_length_477_cov_9.359788	221	301	0	80	80	1.0000000
NODE_47135_length_477_cov_9.359788	274	354	0	80	80	1.0000000
NODE_47139_length_477_cov_7.436508	230	304	0	33	74	0.4459459
NODE_47139_length_477_cov_7.436508	230	304	5	20	74	0.2702703
NODE_47139_length_477_cov_7.436508	230	304	6	11	74	0.1486486
NODE_47139_length_477_cov_7.436508	230	304	7	10	74	0.1351351
NODE_47140_length_477_cov_7.433862	43	123	0	80	80	1.0000000
NODE_47140_length_477_cov_7.433862	96	176	0	80	80	1.0000000
NODE_47143_length_477_cov_6.846561	163	243	0	80	80	1.0000000
NODE_47143_length_477_cov_6.846561	216	296	0	80	80	1.0000000
NODE_47147_length_477_cov_5.677249	150	228	0	78	78	1.0000000
NODE_47148_length_477_cov_5.084656	227	288	0	8	61	0.1311475
NODE_47148_length_477_cov_5.084656	227	288	2	53	61	0.8688524
NODE_47253_length_477_cov_1.629630	115	171	0	3	56	0.0535714
NODE_47253_length_477_cov_1.629630	115	171	2	4	56	0.0714286
NODE_47253_length_477_cov_1.629630	115	171	4	2	56	0.0357143
NODE_47253_length_477_cov_1.629630	115	171	6	1	56	0.0178571
NODE_47253_length_477_cov_1.629630	115	171	9	5	56	0.0892857
NODE_47253_length_477_cov_1.629630	115	171	11	41	56	0.7321429
NODE_47253_length_477_cov_1.629630	167	224	7	33	57	0.5789474
NODE_47253_length_477_cov_1.629630	167	224	9	3	57	0.0526316
NODE_47253_length_477_cov_1.629630	167	224	11	21	57	0.3684210
NODE_47375_length_477_cov_0.859788	445	477	0	32	32	1.0000000
NODE_47427_length_476_cov_7.533156	221	301	0	80	80	1.0000000
NODE_47427_length_476_cov_7.533156	274	354	0	80	80	1.0000000
NODE_47529_length_476_cov_1.618037	385	444	0	59	59	1.0000000
NODE_47601_length_476_cov_1.129973	15	34	0	19	19	1.0000000
NODE_47620_length_476_cov_1.037135	180	243	0	63	63	1.0000000
NODE_47620_length_476_cov_1.037135	237	296	0	59	59	1.0000000
NODE_47693_length_475_cov_34.460106	270	350	0	80	80	1.0000000
NODE_47693_length_475_cov_34.460106	323	403	0	80	80	1.0000000
NODE_47694_length_475_cov_30.087766	273	353	6	80	80	1.0000000
NODE_47694_length_475_cov_30.087766	326	406	0	9	80	0.1125000
NODE_47694_length_475_cov_30.087766	326	406	6	71	80	0.8875000
NODE_47695_length_475_cov_10.247340	42	122	0	80	80	1.0000000
NODE_47701_length_475_cov_8.393617	9	89	0	80	80	1.0000000
NODE_47701_length_475_cov_8.393617	62	142	0	80	80	1.0000000
NODE_47828_length_475_cov_1.531915	272	352	0	38	80	0.4750000
NODE_47828_length_475_cov_1.531915	272	352	4	42	80	0.5250000
NODE_47839_length_475_cov_1.457447	50	93	0	43	43	1.0000000
NODE_47979_length_474_cov_49.453333	392	472	25	1	80	0.0125000
NODE_47979_length_474_cov_49.453333	392	472	26	1	80	0.0125000
NODE_47979_length_474_cov_49.453333	392	472	29	2	80	0.0250000
NODE_47979_length_474_cov_49.453333	392	472	30	1	80	0.0125000
NODE_47979_length_474_cov_49.453333	392	472	34	2	80	0.0250000
NODE_47979_length_474_cov_49.453333	392	472	40	2	80	0.0250000
NODE_47979_length_474_cov_49.453333	392	472	48	1	80	0.0125000
NODE_47979_length_474_cov_49.453333	392	472	50	3	80	0.0375000
NODE_47979_length_474_cov_49.453333	392	472	54	1	80	0.0125000
NODE_47979_length_474_cov_49.453333	392	472	57	1	80	0.0125000
NODE_47979_length_474_cov_49.453333	392	472	59	1	80	0.0125000
NODE_47979_length_474_cov_49.453333	392	472	65	1	80	0.0125000
NODE_47979_length_474_cov_49.453333	392	472	70	2	80	0.0250000
NODE_47979_length_474_cov_49.453333	392	472	72	1	80	0.0125000
NODE_47979_length_474_cov_49.453333	392	472	77	3	80	0.0375000
NODE_47979_length_474_cov_49.453333	392	472	81	1	80	0.0125000
NODE_47979_length_474_cov_49.453333	392	472	83	1	80	0.0125000
NODE_47979_length_474_cov_49.453333	392	472	85	1	80	0.0125000
NODE_47979_length_474_cov_49.453333	392	472	97	1	80	0.0125000
NODE_47979_length_474_cov_49.453333	392	472	99	1	80	0.0125000
NODE_47979_length_474_cov_49.453333	392	472	105	1	80	0.0125000
NODE_47979_length_474_cov_49.453333	392	472	109	1	80	0.0125000
NODE_47979_length_474_cov_49.453333	392	472	112	4	80	0.0500000
NODE_47979_length_474_cov_49.453333	392	472	123	6	80	0.0750000
NODE_47979_length_474_cov_49.453333	392	472	130	1	80	0.0125000
NODE_47979_length_474_cov_49.453333	392	472	137	1	80	0.0125000
NODE_47979_length_474_cov_49.453333	392	472	138	1	80	0.0125000
NODE_47979_length_474_cov_49.453333	392	472	140	5	80	0.0625000
NODE_47979_length_474_cov_49.453333	392	472	144	3	80	0.0375000
NODE_47979_length_474_cov_49.453333	392	472	149	1	80	0.0125000
NODE_47979_length_474_cov_49.453333	392	472	155	1	80	0.0125000
NODE_47979_length_474_cov_49.453333	392	472	160	2	80	0.0250000
NODE_47979_length_474_cov_49.453333	392	472	163	1	80	0.0125000
NODE_47979_length_474_cov_49.453333	392	472	166	1	80	0.0125000
NODE_47979_length_474_cov_49.453333	392	472	167	1	80	0.0125000
NODE_47979_length_474_cov_49.453333	392	472	173	2	80	0.0250000
NODE_47979_length_474_cov_49.453333	392	472	180	1	80	0.0125000
NODE_47979_length_474_cov_49.453333	392	472	184	2	80	0.0250000
NODE_47979_length_474_cov_49.453333	392	472	188	1	80	0.0125000
NODE_47979_length_474_cov_49.453333	392	472	195	2	80	0.0250000
NODE_47979_length_474_cov_49.453333	392	472	199	1	80	0.0125000
NODE_47979_length_474_cov_49.453333	392	472	202	2	80	0.0250000
NODE_47979_length_474_cov_49.453333	392	472	211	1	80	0.0125000
NODE_47979_length_474_cov_49.453333	392	472	223	1	80	0.0125000
NODE_47979_length_474_cov_49.453333	392	472	225	1	80	0.0125000
NODE_47979_length_474_cov_49.453333	392	472	229	2	80	0.0250000
NODE_47979_length_474_cov_49.453333	392	472	236	1	80	0.0125000
NODE_47979_length_474_cov_49.453333	392	472	238	1	80	0.0125000
NODE_47979_length_474_cov_49.453333	392	472	240	1	80	0.0125000
NODE_47979_length_474_cov_49.453333	392	472	242	1	80	0.0125000
NODE_47979_length_474_cov_49.453333	392	472	245	2	80	0.0250000
NODE_47979_length_474_cov_49.453333	445	474	16	1	29	0.0344828
NODE_47979_length_474_cov_49.453333	445	474	21	1	29	0.0344828
NODE_47979_length_474_cov_49.453333	445	474	25	1	29	0.0344828
NODE_47979_length_474_cov_49.453333	445	474	26	1	29	0.0344828
NODE_47979_length_474_cov_49.453333	445	474	29	2	29	0.0689655
NODE_47979_length_474_cov_49.453333	445	474	30	1	29	0.0344828
NODE_47979_length_474_cov_49.453333	445	474	34	2	29	0.0689655
NODE_47979_length_474_cov_49.453333	445	474	40	2	29	0.0689655
NODE_47979_length_474_cov_49.453333	445	474	48	1	29	0.0344828
NODE_47979_length_474_cov_49.453333	445	474	50	3	29	0.1034483
NODE_47979_length_474_cov_49.453333	445	474	54	1	29	0.0344828
NODE_47979_length_474_cov_49.453333	445	474	57	1	29	0.0344828
NODE_47979_length_474_cov_49.453333	445	474	59	1	29	0.0344828
NODE_47979_length_474_cov_49.453333	445	474	65	1	29	0.0344828
NODE_47979_length_474_cov_49.453333	445	474	70	2	29	0.0689655
NODE_47979_length_474_cov_49.453333	445	474	72	1	29	0.0344828
NODE_47979_length_474_cov_49.453333	445	474	77	3	29	0.1034483
NODE_47979_length_474_cov_49.453333	445	474	81	1	29	0.0344828
NODE_47979_length_474_cov_49.453333	445	474	83	1	29	0.0344828
NODE_47979_length_474_cov_49.453333	445	474	85	1	29	0.0344828
NODE_47979_length_474_cov_49.453333	445	474	97	1	29	0.0344828
NODE_47981_length_474_cov_24.930667	287	367	0	80	80	1.0000000
NODE_47981_length_474_cov_24.930667	340	420	0	80	80	1.0000000
NODE_47982_length_474_cov_15.952000	258	338	0	80	80	1.0000000
NODE_47982_length_474_cov_15.952000	311	391	0	80	80	1.0000000
NODE_48003_length_474_cov_3.986667	172	252	1	9	80	0.1125000
NODE_48003_length_474_cov_3.986667	172	252	2	2	80	0.0250000
NODE_48003_length_474_cov_3.986667	172	252	6	9	80	0.1125000
NODE_48003_length_474_cov_3.986667	172	252	8	7	80	0.0875000
NODE_48003_length_474_cov_3.986667	172	252	12	24	80	0.3000000
NODE_48003_length_474_cov_3.986667	172	252	14	29	80	0.3625000
NODE_48015_length_474_cov_3.496000	163	243	0	2	80	0.0250000
NODE_48015_length_474_cov_3.496000	163	243	2	7	80	0.0875000
NODE_48015_length_474_cov_3.496000	163	243	4	13	80	0.1625000
NODE_48015_length_474_cov_3.496000	163	243	6	11	80	0.1375000
NODE_48015_length_474_cov_3.496000	163	243	8	47	80	0.5875000
NODE_48038_length_474_cov_2.784000	259	300	4	41	41	1.0000000
NODE_48116_length_474_cov_1.538667	41	62	0	21	21	1.0000000
NODE_48181_length_474_cov_1.085333	0	50	0	50	50	1.0000000
NODE_48184_length_474_cov_1.056000	95	133	0	38	38	1.0000000
NODE_48266_length_473_cov_82.374332	123	203	26	22	80	0.2750000
NODE_48266_length_473_cov_82.374332	123	203	27	1	80	0.0125000
NODE_48266_length_473_cov_82.374332	123	203	28	1	80	0.0125000
NODE_48266_length_473_cov_82.374332	123	203	29	1	80	0.0125000
NODE_48266_length_473_cov_82.374332	123	203	42	1	80	0.0125000
NODE_48266_length_473_cov_82.374332	123	203	44	54	80	0.6750000
NODE_48266_length_473_cov_82.374332	176	256	0	43	80	0.5375000
NODE_48266_length_473_cov_82.374332	176	256	2	7	80	0.0875000
NODE_48266_length_473_cov_82.374332	176	256	26	25	80	0.3125000
NODE_48266_length_473_cov_82.374332	176	256	27	1	80	0.0125000
NODE_48266_length_473_cov_82.374332	176	256	28	1	80	0.0125000
NODE_48266_length_473_cov_82.374332	176	256	29	1	80	0.0125000
NODE_48266_length_473_cov_82.374332	176	256	42	1	80	0.0125000
NODE_48266_length_473_cov_82.374332	176	256	44	1	80	0.0125000
NODE_48267_length_473_cov_54.882353	199	279	0	80	80	1.0000000
NODE_48267_length_473_cov_54.882353	252	332	0	80	80	1.0000000
NODE_48268_length_473_cov_48.997326	119	194	43	2	75	0.0266667
NODE_48268_length_473_cov_48.997326	119	194	46	3	75	0.0400000
NODE_48268_length_473_cov_48.997326	119	194	47	6	75	0.0800000
NODE_48268_length_473_cov_48.997326	119	194	48	1	75	0.0133333
NODE_48268_length_473_cov_48.997326	119	194	49	37	75	0.4933333
NODE_48268_length_473_cov_48.997326	119	194	51	15	75	0.2000000
NODE_48268_length_473_cov_48.997326	119	194	53	5	75	0.0666667
NODE_48268_length_473_cov_48.997326	119	194	54	6	75	0.0800000
NODE_48268_length_473_cov_48.997326	119	194	43	2	75	0.0266667
NODE_48268_length_473_cov_48.997326	119	194	46	3	75	0.0400000
NODE_48268_length_473_cov_48.997326	119	194	47	6	75	0.0800000
NODE_48268_length_473_cov_48.997326	119	194	48	1	75	0.0133333
NODE_48268_length_473_cov_48.997326	119	194	49	37	75	0.4933333
NODE_48268_length_473_cov_48.997326	119	194	51	15	75	0.2000000
NODE_48268_length_473_cov_48.997326	119	194	53	5	75	0.0666667
NODE_48268_length_473_cov_48.997326	119	194	54	6	75	0.0800000
NODE_48268_length_473_cov_48.997326	167	247	15	29	80	0.3625000
NODE_48268_length_473_cov_48.997326	167	247	43	2	80	0.0250000
NODE_48268_length_473_cov_48.997326	167	247	46	4	80	0.0500000
NODE_48268_length_473_cov_48.997326	167	247	47	26	80	0.3250000
NODE_48268_length_473_cov_48.997326	167	247	49	12	80	0.1500000
NODE_48268_length_473_cov_48.997326	167	247	53	1	80	0.0125000
NODE_48268_length_473_cov_48.997326	167	247	54	6	80	0.0750000
NODE_48269_length_473_cov_30.679144	174	254	0	36	80	0.4500000
NODE_48269_length_473_cov_30.679144	174	254	2	24	80	0.3000000
NODE_48269_length_473_cov_30.679144	174	254	4	3	80	0.0375000
NODE_48269_length_473_cov_30.679144	174	254	6	17	80	0.2125000
NODE_48269_length_473_cov_30.679144	226	307	0	81	81	1.0000000
NODE_48269_length_473_cov_30.679144	227	307	0	80	80	1.0000000
NODE_48270_length_473_cov_24.967914	295	370	5	75	75	1.0000000
NODE_48270_length_473_cov_24.967914	343	423	0	53	80	0.6625000
NODE_48270_length_473_cov_24.967914	343	423	5	27	80	0.3375000
NODE_48271_length_473_cov_18.540107	168	248	0	80	80	1.0000000
NODE_48271_length_473_cov_18.540107	221	301	0	53	80	0.6625000
NODE_48271_length_473_cov_18.540107	221	301	2	27	80	0.3375000
NODE_48272_length_473_cov_15.871658	143	223	0	80	80	1.0000000
NODE_48272_length_473_cov_15.871658	196	276	0	80	80	1.0000000
NODE_48291_length_473_cov_4.363636	160	240	0	80	80	1.0000000
NODE_48291_length_473_cov_4.363636	213	293	0	80	80	1.0000000
NODE_48320_length_473_cov_2.959893	199	267	0	68	68	1.0000000
NODE_48325_length_473_cov_2.804813	207	269	0	62	62	1.0000000
NODE_48350_length_473_cov_2.251337	48	128	2	12	80	0.1500000
NODE_48350_length_473_cov_2.251337	48	128	4	68	80	0.8500000
NODE_48350_length_473_cov_2.251337	101	181	2	41	80	0.5125000
NODE_48350_length_473_cov_2.251337	101	181	3	3	80	0.0375000
NODE_48350_length_473_cov_2.251337	101	181	4	36	80	0.4500000
NODE_48568_length_472_cov_50.077748	1	81	1	16	80	0.2000000
NODE_48568_length_472_cov_50.077748	1	81	2	2	80	0.0250000
NODE_48568_length_472_cov_50.077748	1	81	3	4	80	0.0500000
NODE_48568_length_472_cov_50.077748	1	81	8	1	80	0.0125000
NODE_48568_length_472_cov_50.077748	1	81	12	1	80	0.0125000
NODE_48568_length_472_cov_50.077748	1	81	13	16	80	0.2000000
NODE_48568_length_472_cov_50.077748	1	81	14	6	80	0.0750000
NODE_48568_length_472_cov_50.077748	1	81	15	4	80	0.0500000
NODE_48568_length_472_cov_50.077748	1	81	16	7	80	0.0875000
NODE_48568_length_472_cov_50.077748	1	81	18	10	80	0.1250000
NODE_48568_length_472_cov_50.077748	1	81	20	13	80	0.1625000
NODE_48568_length_472_cov_50.077748	1	81	1	16	80	0.2000000
NODE_48568_length_472_cov_50.077748	1	81	2	2	80	0.0250000
NODE_48568_length_472_cov_50.077748	1	81	3	4	80	0.0500000
NODE_48568_length_472_cov_50.077748	1	81	8	1	80	0.0125000
NODE_48568_length_472_cov_50.077748	1	81	12	1	80	0.0125000
NODE_48568_length_472_cov_50.077748	1	81	13	16	80	0.2000000
NODE_48568_length_472_cov_50.077748	1	81	14	6	80	0.0750000
NODE_48568_length_472_cov_50.077748	1	81	15	4	80	0.0500000
NODE_48568_length_472_cov_50.077748	1	81	16	7	80	0.0875000
NODE_48568_length_472_cov_50.077748	1	81	18	10	80	0.1250000
NODE_48568_length_472_cov_50.077748	1	81	20	13	80	0.1625000
NODE_48568_length_472_cov_50.077748	1	81	1	16	80	0.2000000
NODE_48568_length_472_cov_50.077748	1	81	2	2	80	0.0250000
NODE_48568_length_472_cov_50.077748	1	81	3	4	80	0.0500000
NODE_48568_length_472_cov_50.077748	1	81	8	1	80	0.0125000
NODE_48568_length_472_cov_50.077748	1	81	12	1	80	0.0125000
NODE_48568_length_472_cov_50.077748	1	81	13	16	80	0.2000000
NODE_48568_length_472_cov_50.077748	1	81	14	6	80	0.0750000
NODE_48568_length_472_cov_50.077748	1	81	15	4	80	0.0500000
NODE_48568_length_472_cov_50.077748	1	81	16	7	80	0.0875000
NODE_48568_length_472_cov_50.077748	1	81	18	10	80	0.1250000
NODE_48568_length_472_cov_50.077748	1	81	20	13	80	0.1625000
NODE_48568_length_472_cov_50.077748	1	81	1	16	80	0.2000000
NODE_48568_length_472_cov_50.077748	1	81	2	2	80	0.0250000
NODE_48568_length_472_cov_50.077748	1	81	3	4	80	0.0500000
NODE_48568_length_472_cov_50.077748	1	81	8	1	80	0.0125000
NODE_48568_length_472_cov_50.077748	1	81	12	1	80	0.0125000
NODE_48568_length_472_cov_50.077748	1	81	13	16	80	0.2000000
NODE_48568_length_472_cov_50.077748	1	81	14	6	80	0.0750000
NODE_48568_length_472_cov_50.077748	1	81	15	4	80	0.0500000
NODE_48568_length_472_cov_50.077748	1	81	16	7	80	0.0875000
NODE_48568_length_472_cov_50.077748	1	81	18	10	80	0.1250000
NODE_48568_length_472_cov_50.077748	1	81	20	13	80	0.1625000
NODE_48568_length_472_cov_50.077748	1	81	1	16	80	0.2000000
NODE_48568_length_472_cov_50.077748	1	81	2	2	80	0.0250000
NODE_48568_length_472_cov_50.077748	1	81	3	4	80	0.0500000
NODE_48568_length_472_cov_50.077748	1	81	8	1	80	0.0125000
NODE_48568_length_472_cov_50.077748	1	81	12	1	80	0.0125000
NODE_48568_length_472_cov_50.077748	1	81	13	16	80	0.2000000
NODE_48568_length_472_cov_50.077748	1	81	14	6	80	0.0750000
NODE_48568_length_472_cov_50.077748	1	81	15	4	80	0.0500000
NODE_48568_length_472_cov_50.077748	1	81	16	7	80	0.0875000
NODE_48568_length_472_cov_50.077748	1	81	18	10	80	0.1250000
NODE_48568_length_472_cov_50.077748	1	81	20	13	80	0.1625000
NODE_48568_length_472_cov_50.077748	10	81	1	7	71	0.0985916
NODE_48568_length_472_cov_50.077748	10	81	2	2	71	0.0281690
NODE_48568_length_472_cov_50.077748	10	81	3	4	71	0.0563380
NODE_48568_length_472_cov_50.077748	10	81	8	1	71	0.0140845
NODE_48568_length_472_cov_50.077748	10	81	12	1	71	0.0140845
NODE_48568_length_472_cov_50.077748	10	81	13	16	71	0.2253521
NODE_48568_length_472_cov_50.077748	10	81	14	6	71	0.0845070
NODE_48568_length_472_cov_50.077748	10	81	15	4	71	0.0563380
NODE_48568_length_472_cov_50.077748	10	81	16	7	71	0.0985916
NODE_48568_length_472_cov_50.077748	10	81	18	10	71	0.1408451
NODE_48568_length_472_cov_50.077748	10	81	20	13	71	0.1830986
NODE_48568_length_472_cov_50.077748	54	131	16	4	77	0.0519481
NODE_48568_length_472_cov_50.077748	54	131	18	24	77	0.3116883
NODE_48568_length_472_cov_50.077748	54	131	20	49	77	0.6363636
NODE_48568_length_472_cov_50.077748	54	131	16	4	77	0.0519481
NODE_48568_length_472_cov_50.077748	54	131	18	24	77	0.3116883
NODE_48568_length_472_cov_50.077748	54	131	20	49	77	0.6363636
NODE_48568_length_472_cov_50.077748	54	131	16	4	77	0.0519481
NODE_48568_length_472_cov_50.077748	54	131	18	24	77	0.3116883
NODE_48568_length_472_cov_50.077748	54	131	20	49	77	0.6363636
NODE_48568_length_472_cov_50.077748	130	204	6	13	74	0.1756757
NODE_48568_length_472_cov_50.077748	130	204	7	1	74	0.0135135
NODE_48568_length_472_cov_50.077748	130	204	9	16	74	0.2162162
NODE_48568_length_472_cov_50.077748	130	204	14	1	74	0.0135135
NODE_48568_length_472_cov_50.077748	130	204	18	2	74	0.0270270
NODE_48568_length_472_cov_50.077748	130	204	19	7	74	0.0945946
NODE_48568_length_472_cov_50.077748	130	204	20	12	74	0.1621622
NODE_48568_length_472_cov_50.077748	130	204	21	18	74	0.2432432
NODE_48568_length_472_cov_50.077748	130	204	22	4	74	0.0540541
NODE_48569_length_472_cov_10.469169	294	374	0	80	80	1.0000000
NODE_48569_length_472_cov_10.469169	347	427	0	80	80	1.0000000
NODE_48570_length_472_cov_10.195710	143	223	0	80	80	1.0000000
NODE_48570_length_472_cov_10.195710	196	276	0	80	80	1.0000000
NODE_48593_length_472_cov_4.375335	165	245	0	80	80	1.0000000
NODE_48593_length_472_cov_4.375335	218	251	0	33	33	1.0000000
NODE_48614_length_472_cov_3.495979	305	349	0	44	44	1.0000000
NODE_48620_length_472_cov_3.093834	220	295	0	75	75	1.0000000
NODE_48638_length_472_cov_2.592493	431	471	0	40	40	1.0000000
NODE_48745_length_472_cov_1.294906	43	98	0	55	55	1.0000000
NODE_48745_length_472_cov_1.294906	71	151	0	80	80	1.0000000
NODE_48768_length_472_cov_1.211796	106	126	0	20	20	1.0000000
NODE_48873_length_471_cov_39.319892	119	193	0	71	74	0.9594595
NODE_48873_length_471_cov_39.319892	119	193	2	2	74	0.0270270
NODE_48873_length_471_cov_39.319892	119	193	31	1	74	0.0135135
NODE_48874_length_471_cov_24.279570	185	265	0	80	80	1.0000000
NODE_48874_length_471_cov_24.279570	238	318	0	80	80	1.0000000
NODE_48875_length_471_cov_19.669355	83	163	0	80	80	1.0000000
NODE_48875_length_471_cov_19.669355	136	216	0	80	80	1.0000000
NODE_48876_length_471_cov_14.387097	198	278	0	80	80	1.0000000
NODE_48876_length_471_cov_14.387097	251	331	0	80	80	1.0000000
NODE_48881_length_471_cov_6.948925	186	213	0	27	27	1.0000000
NODE_48881_length_471_cov_6.948925	204	284	0	53	80	0.6625000
NODE_48881_length_471_cov_6.948925	204	284	2	27	80	0.3375000
NODE_48881_length_471_cov_6.948925	244	275	0	13	31	0.4193548
NODE_48881_length_471_cov_6.948925	244	275	2	18	31	0.5806451
NODE_48881_length_471_cov_6.948925	257	337	2	80	80	1.0000000
NODE_48881_length_471_cov_6.948925	268	337	2	69	69	1.0000000
NODE_48902_length_471_cov_3.803763	83	162	0	69	79	0.8734177
NODE_48902_length_471_cov_3.803763	83	162	2	10	79	0.1265823
NODE_48902_length_471_cov_3.803763	135	215	0	17	80	0.2125000
NODE_48902_length_471_cov_3.803763	135	215	2	63	80	0.7875000
NODE_48924_length_471_cov_2.954301	284	315	0	31	31	1.0000000
NODE_48957_length_471_cov_2.287634	133	200	8	14	67	0.2089552
NODE_48957_length_471_cov_2.287634	133	200	10	14	67	0.2089552
NODE_48957_length_471_cov_2.287634	133	200	15	9	67	0.1343284
NODE_48957_length_471_cov_2.287634	133	200	17	10	67	0.1492537
NODE_48957_length_471_cov_2.287634	133	200	19	20	67	0.2985075
NODE_49186_length_470_cov_57.078167	184	264	0	80	80	1.0000000
NODE_49186_length_470_cov_57.078167	237	317	0	80	80	1.0000000
NODE_49186_length_470_cov_57.078167	313	393	0	29	80	0.3625000
NODE_49186_length_470_cov_57.078167	313	393	10	51	80	0.6375000
NODE_49186_length_470_cov_57.078167	366	446	10	80	80	1.0000000
NODE_49187_length_470_cov_34.035040	228	308	0	80	80	1.0000000
NODE_49187_length_470_cov_34.035040	281	361	0	80	80	1.0000000
NODE_49187_length_470_cov_34.035040	357	437	0	80	80	1.0000000
NODE_49187_length_470_cov_34.035040	410	470	0	60	60	1.0000000
NODE_49188_length_470_cov_15.539084	142	222	0	80	80	1.0000000
NODE_49188_length_470_cov_15.539084	195	275	0	80	80	1.0000000
NODE_49193_length_470_cov_6.070081	272	330	39	2	58	0.0344828
NODE_49193_length_470_cov_6.070081	272	330	43	3	58	0.0517241
NODE_49193_length_470_cov_6.070081	272	330	45	4	58	0.0689655
NODE_49193_length_470_cov_6.070081	272	330	46	1	58	0.0172414
NODE_49193_length_470_cov_6.070081	272	330	48	20	58	0.3448276
NODE_49193_length_470_cov_6.070081	272	330	50	2	58	0.0344828
NODE_49193_length_470_cov_6.070081	272	330	52	4	58	0.0689655
NODE_49193_length_470_cov_6.070081	272	330	53	13	58	0.2241379
NODE_49193_length_470_cov_6.070081	272	330	55	6	58	0.1034483
NODE_49193_length_470_cov_6.070081	272	330	59	3	58	0.0517241
NODE_49193_length_470_cov_6.070081	325	383	1	6	58	0.1034483
NODE_49193_length_470_cov_6.070081	325	383	11	1	58	0.0172414
NODE_49193_length_470_cov_6.070081	325	383	13	1	58	0.0172414
NODE_49193_length_470_cov_6.070081	325	383	19	1	58	0.0172414
NODE_49193_length_470_cov_6.070081	325	383	20	13	58	0.2241379
NODE_49193_length_470_cov_6.070081	325	383	21	1	58	0.0172414
NODE_49193_length_470_cov_6.070081	325	383	22	8	58	0.1379310
NODE_49193_length_470_cov_6.070081	325	383	26	1	58	0.0172414
NODE_49193_length_470_cov_6.070081	325	383	28	5	58	0.0862069
NODE_49193_length_470_cov_6.070081	325	383	29	3	58	0.0517241
NODE_49193_length_470_cov_6.070081	325	383	33	2	58	0.0344828
NODE_49193_length_470_cov_6.070081	325	383	36	4	58	0.0689655
NODE_49193_length_470_cov_6.070081	325	383	37	1	58	0.0172414
NODE_49193_length_470_cov_6.070081	325	383	38	6	58	0.1034483
NODE_49193_length_470_cov_6.070081	325	383	39	2	58	0.0344828
NODE_49193_length_470_cov_6.070081	325	383	43	3	58	0.0517241
NODE_49215_length_470_cov_3.735849	194	251	0	57	57	1.0000000
NODE_49260_length_470_cov_2.363881	403	422	4	11	19	0.5789474
NODE_49260_length_470_cov_2.363881	403	422	6	8	19	0.4210526
NODE_49260_length_470_cov_2.363881	403	422	4	11	19	0.5789474
NODE_49260_length_470_cov_2.363881	403	422	6	8	19	0.4210526
NODE_49389_length_470_cov_1.142857	414	470	0	56	56	1.0000000
NODE_49502_length_469_cov_221.024324	150	228	218	1	78	0.0128205
NODE_49502_length_469_cov_221.024324	150	228	222	1	78	0.0128205
NODE_49502_length_469_cov_221.024324	150	228	242	2	78	0.0256410
NODE_49502_length_469_cov_221.024324	150	228	248	1	78	0.0128205
NODE_49502_length_469_cov_221.024324	150	228	250	1	78	0.0128205
NODE_49502_length_469_cov_221.024324	150	228	252	1	78	0.0128205
NODE_49502_length_469_cov_221.024324	150	228	260	1	78	0.0128205
NODE_49502_length_469_cov_221.024324	150	228	263	2	78	0.0256410
NODE_49502_length_469_cov_221.024324	150	228	265	1	78	0.0128205
NODE_49502_length_469_cov_221.024324	150	228	269	1	78	0.0128205
NODE_49502_length_469_cov_221.024324	150	228	270	1	78	0.0128205
NODE_49502_length_469_cov_221.024324	150	228	284	1	78	0.0128205
NODE_49502_length_469_cov_221.024324	150	228	288	1	78	0.0128205
NODE_49502_length_469_cov_221.024324	150	228	289	5	78	0.0641026
NODE_49502_length_469_cov_221.024324	150	228	290	6	78	0.0769231
NODE_49502_length_469_cov_221.024324	150	228	291	2	78	0.0256410
NODE_49502_length_469_cov_221.024324	150	228	292	1	78	0.0128205
NODE_49502_length_469_cov_221.024324	150	228	294	4	78	0.0512821
NODE_49502_length_469_cov_221.024324	150	228	295	1	78	0.0128205
NODE_49502_length_469_cov_221.024324	150	228	296	1	78	0.0128205
NODE_49502_length_469_cov_221.024324	150	228	298	7	78	0.0897436
NODE_49502_length_469_cov_221.024324	150	228	300	1	78	0.0128205
NODE_49502_length_469_cov_221.024324	150	228	303	2	78	0.0256410
NODE_49502_length_469_cov_221.024324	150	228	304	1	78	0.0128205
NODE_49502_length_469_cov_221.024324	150	228	308	1	78	0.0128205
NODE_49502_length_469_cov_221.024324	150	228	310	1	78	0.0128205
NODE_49502_length_469_cov_221.024324	150	228	311	4	78	0.0512821
NODE_49502_length_469_cov_221.024324	150	228	312	6	78	0.0769231
NODE_49502_length_469_cov_221.024324	150	228	313	1	78	0.0128205
NODE_49502_length_469_cov_221.024324	150	228	314	2	78	0.0256410
NODE_49502_length_469_cov_221.024324	150	228	315	2	78	0.0256410
NODE_49502_length_469_cov_221.024324	150	228	316	4	78	0.0512821
NODE_49502_length_469_cov_221.024324	150	228	317	2	78	0.0256410
NODE_49502_length_469_cov_221.024324	150	228	318	3	78	0.0384615
NODE_49502_length_469_cov_221.024324	150	228	319	1	78	0.0128205
NODE_49502_length_469_cov_221.024324	150	228	320	1	78	0.0128205
NODE_49502_length_469_cov_221.024324	150	228	321	3	78	0.0384615
NODE_49502_length_469_cov_221.024324	150	228	322	1	78	0.0128205
NODE_49502_length_469_cov_221.024324	150	228	218	1	78	0.0128205
NODE_49502_length_469_cov_221.024324	150	228	222	1	78	0.0128205
NODE_49502_length_469_cov_221.024324	150	228	242	2	78	0.0256410
NODE_49502_length_469_cov_221.024324	150	228	248	1	78	0.0128205
NODE_49502_length_469_cov_221.024324	150	228	250	1	78	0.0128205
NODE_49502_length_469_cov_221.024324	150	228	252	1	78	0.0128205
NODE_49502_length_469_cov_221.024324	150	228	260	1	78	0.0128205
NODE_49502_length_469_cov_221.024324	150	228	263	2	78	0.0256410
NODE_49502_length_469_cov_221.024324	150	228	265	1	78	0.0128205
NODE_49502_length_469_cov_221.024324	150	228	269	1	78	0.0128205
NODE_49502_length_469_cov_221.024324	150	228	270	1	78	0.0128205
NODE_49502_length_469_cov_221.024324	150	228	284	1	78	0.0128205
NODE_49502_length_469_cov_221.024324	150	228	288	1	78	0.0128205
NODE_49502_length_469_cov_221.024324	150	228	289	5	78	0.0641026
NODE_49502_length_469_cov_221.024324	150	228	290	6	78	0.0769231
NODE_49502_length_469_cov_221.024324	150	228	291	2	78	0.0256410
NODE_49502_length_469_cov_221.024324	150	228	292	1	78	0.0128205
NODE_49502_length_469_cov_221.024324	150	228	294	4	78	0.0512821
NODE_49502_length_469_cov_221.024324	150	228	295	1	78	0.0128205
NODE_49502_length_469_cov_221.024324	150	228	296	1	78	0.0128205
NODE_49502_length_469_cov_221.024324	150	228	298	7	78	0.0897436
NODE_49502_length_469_cov_221.024324	150	228	300	1	78	0.0128205
NODE_49502_length_469_cov_221.024324	150	228	303	2	78	0.0256410
NODE_49502_length_469_cov_221.024324	150	228	304	1	78	0.0128205
NODE_49502_length_469_cov_221.024324	150	228	308	1	78	0.0128205
NODE_49502_length_469_cov_221.024324	150	228	310	1	78	0.0128205
NODE_49502_length_469_cov_221.024324	150	228	311	4	78	0.0512821
NODE_49502_length_469_cov_221.024324	150	228	312	6	78	0.0769231
NODE_49502_length_469_cov_221.024324	150	228	313	1	78	0.0128205
NODE_49502_length_469_cov_221.024324	150	228	314	2	78	0.0256410
NODE_49502_length_469_cov_221.024324	150	228	315	2	78	0.0256410
NODE_49502_length_469_cov_221.024324	150	228	316	4	78	0.0512821
NODE_49502_length_469_cov_221.024324	150	228	317	2	78	0.0256410
NODE_49502_length_469_cov_221.024324	150	228	318	3	78	0.0384615
NODE_49502_length_469_cov_221.024324	150	228	319	1	78	0.0128205
NODE_49502_length_469_cov_221.024324	150	228	320	1	78	0.0128205
NODE_49502_length_469_cov_221.024324	150	228	321	3	78	0.0384615
NODE_49502_length_469_cov_221.024324	150	228	322	1	78	0.0128205
NODE_49502_length_469_cov_221.024324	150	219	263	1	69	0.0144928
NODE_49502_length_469_cov_221.024324	150	219	265	1	69	0.0144928
NODE_49502_length_469_cov_221.024324	150	219	269	1	69	0.0144928
NODE_49502_length_469_cov_221.024324	150	219	270	1	69	0.0144928
NODE_49502_length_469_cov_221.024324	150	219	284	1	69	0.0144928
NODE_49502_length_469_cov_221.024324	150	219	288	1	69	0.0144928
NODE_49502_length_469_cov_221.024324	150	219	289	5	69	0.0724638
NODE_49502_length_469_cov_221.024324	150	219	290	6	69	0.0869565
NODE_49502_length_469_cov_221.024324	150	219	291	2	69	0.0289855
NODE_49502_length_469_cov_221.024324	150	219	292	1	69	0.0144928
NODE_49502_length_469_cov_221.024324	150	219	294	4	69	0.0579710
NODE_49502_length_469_cov_221.024324	150	219	295	1	69	0.0144928
NODE_49502_length_469_cov_221.024324	150	219	296	1	69	0.0144928
NODE_49502_length_469_cov_221.024324	150	219	298	7	69	0.1014493
NODE_49502_length_469_cov_221.024324	150	219	300	1	69	0.0144928
NODE_49502_length_469_cov_221.024324	150	219	303	2	69	0.0289855
NODE_49502_length_469_cov_221.024324	150	219	304	1	69	0.0144928
NODE_49502_length_469_cov_221.024324	150	219	308	1	69	0.0144928
NODE_49502_length_469_cov_221.024324	150	219	310	1	69	0.0144928
NODE_49502_length_469_cov_221.024324	150	219	311	4	69	0.0579710
NODE_49502_length_469_cov_221.024324	150	219	312	6	69	0.0869565
NODE_49502_length_469_cov_221.024324	150	219	313	1	69	0.0144928
NODE_49502_length_469_cov_221.024324	150	219	314	2	69	0.0289855
NODE_49502_length_469_cov_221.024324	150	219	315	2	69	0.0289855
NODE_49502_length_469_cov_221.024324	150	219	316	4	69	0.0579710
NODE_49502_length_469_cov_221.024324	150	219	317	2	69	0.0289855
NODE_49502_length_469_cov_221.024324	150	219	318	3	69	0.0434783
NODE_49502_length_469_cov_221.024324	150	219	319	1	69	0.0144928
NODE_49502_length_469_cov_221.024324	150	219	320	1	69	0.0144928
NODE_49502_length_469_cov_221.024324	150	219	321	3	69	0.0434783
NODE_49502_length_469_cov_221.024324	150	219	322	1	69	0.0144928
NODE_49557_length_469_cov_2.686486	263	343	0	80	80	1.0000000
NODE_49561_length_469_cov_2.521622	237	289	0	52	52	1.0000000
NODE_49579_length_469_cov_2.224324	279	331	0	16	52	0.3076923
NODE_49579_length_469_cov_2.224324	279	331	1	36	52	0.6923077
NODE_49796_length_468_cov_8.043360	190	250	6	60	60	1.0000000
NODE_49796_length_468_cov_8.043360	223	303	0	46	80	0.5750000
NODE_49796_length_468_cov_8.043360	223	303	5	2	80	0.0250000
NODE_49796_length_468_cov_8.043360	223	303	6	32	80	0.4000000
NODE_49800_length_468_cov_6.046070	152	232	0	80	80	1.0000000
NODE_49800_length_468_cov_6.046070	205	285	0	80	80	1.0000000
NODE_49801_length_468_cov_5.997290	81	161	0	80	80	1.0000000
NODE_49801_length_468_cov_5.997290	134	214	0	80	80	1.0000000
NODE_49801_length_468_cov_5.997290	210	270	0	60	60	1.0000000
NODE_49803_length_468_cov_5.872629	133	201	8	6	68	0.0882353
NODE_49803_length_468_cov_5.872629	133	201	10	14	68	0.2058824
NODE_49803_length_468_cov_5.872629	133	201	14	2	68	0.0294118
NODE_49803_length_468_cov_5.872629	133	201	16	1	68	0.0147059
NODE_49803_length_468_cov_5.872629	133	201	18	6	68	0.0882353
NODE_49803_length_468_cov_5.872629	133	201	20	39	68	0.5735294
NODE_49807_length_468_cov_5.384824	305	356	0	51	51	1.0000000
NODE_49894_length_468_cov_2.067751	45	96	0	51	51	1.0000000
NODE_49913_length_468_cov_1.891599	4	63	0	59	59	1.0000000
NODE_49928_length_468_cov_1.758808	140	218	0	78	78	1.0000000
NODE_49928_length_468_cov_1.758808	191	257	0	66	66	1.0000000
NODE_49974_length_468_cov_1.390244	291	310	0	19	19	1.0000000
NODE_49974_length_468_cov_1.390244	369	405	0	36	36	1.0000000
NODE_50133_length_467_cov_14.100543	176	256	1	73	80	0.9125000
NODE_50133_length_467_cov_14.100543	176	256	2	7	80	0.0875000
NODE_50134_length_467_cov_11.902174	193	236	0	43	43	1.0000000
NODE_50135_length_467_cov_10.875000	226	306	0	80	80	1.0000000
NODE_50135_length_467_cov_10.875000	279	359	0	80	80	1.0000000
NODE_50144_length_467_cov_6.625000	206	275	0	16	69	0.2318841
NODE_50144_length_467_cov_6.625000	206	275	2	12	69	0.1739130
NODE_50144_length_467_cov_6.625000	206	275	4	35	69	0.5072464
NODE_50144_length_467_cov_6.625000	206	275	6	6	69	0.0869565
NODE_50144_length_467_cov_6.625000	257	328	2	9	71	0.1267606
NODE_50144_length_467_cov_6.625000	257	328	4	32	71	0.4507042
NODE_50144_length_467_cov_6.625000	257	328	6	30	71	0.4225352
NODE_50197_length_467_cov_2.709239	247	327	0	65	80	0.8125000
NODE_50197_length_467_cov_2.709239	247	327	4	15	80	0.1875000
NODE_50215_length_467_cov_2.296196	284	329	0	45	45	1.0000000
NODE_50238_length_467_cov_2.027174	218	269	0	51	51	1.0000000
NODE_50252_length_467_cov_1.836957	55	118	0	63	63	1.0000000
NODE_50267_length_467_cov_1.603261	92	141	0	24	49	0.4897959
NODE_50267_length_467_cov_1.603261	92	141	2	25	49	0.5102041
NODE_50283_length_467_cov_1.426630	135	183	0	48	48	1.0000000
NODE_50447_length_466_cov_42.839237	0	47	0	47	47	1.0000000
NODE_50447_length_466_cov_42.839237	20	100	0	80	80	1.0000000
NODE_50447_length_466_cov_42.839237	96	176	0	80	80	1.0000000
NODE_50447_length_466_cov_42.839237	149	229	0	80	80	1.0000000
NODE_50448_length_466_cov_36.901907	85	165	0	10	80	0.1250000
NODE_50448_length_466_cov_36.901907	85	165	2	70	80	0.8750000
NODE_50448_length_466_cov_36.901907	138	218	0	11	80	0.1375000
NODE_50448_length_466_cov_36.901907	138	218	2	69	80	0.8625000
NODE_50448_length_466_cov_36.901907	214	294	0	60	80	0.7500000
NODE_50448_length_466_cov_36.901907	214	294	2	20	80	0.2500000
NODE_50448_length_466_cov_36.901907	267	347	0	7	80	0.0875000
NODE_50448_length_466_cov_36.901907	267	347	2	20	80	0.2500000
NODE_50448_length_466_cov_36.901907	267	347	4	53	80	0.6625000
NODE_50457_length_466_cov_5.122616	275	316	0	41	41	1.0000000
NODE_50457_length_466_cov_5.122616	276	316	0	40	40	1.0000000
NODE_50457_length_466_cov_5.122616	289	338	0	49	49	1.0000000
NODE_50515_length_466_cov_2.602180	9	90	2	3	81	0.0370370
NODE_50515_length_466_cov_2.602180	9	90	4	78	81	0.9629630
NODE_50515_length_466_cov_2.602180	312	341	2	28	29	0.9655172
NODE_50515_length_466_cov_2.602180	312	341	4	1	29	0.0344828
NODE_50549_length_466_cov_2.108992	130	182	0	52	52	1.0000000
NODE_50562_length_466_cov_1.980926	183	265	0	82	82	1.0000000
NODE_50787_length_465_cov_13.019126	170	250	0	80	80	1.0000000
NODE_50787_length_465_cov_13.019126	223	301	0	54	78	0.6923077
NODE_50787_length_465_cov_13.019126	223	301	1	12	78	0.1538462
NODE_50787_length_465_cov_13.019126	223	301	2	12	78	0.1538462
NODE_50799_length_465_cov_5.363388	316	393	0	77	77	1.0000000
NODE_50800_length_465_cov_4.898907	376	406	0	30	30	1.0000000
NODE_50869_length_465_cov_2.366120	147	227	0	80	80	1.0000000
NODE_50869_length_465_cov_2.366120	200	271	0	71	71	1.0000000
NODE_50911_length_465_cov_1.737705	338	383	6	4	45	0.0888889
NODE_50911_length_465_cov_1.737705	338	383	8	1	45	0.0222222
NODE_50911_length_465_cov_1.737705	338	383	10	33	45	0.7333333
NODE_50911_length_465_cov_1.737705	338	383	12	7	45	0.1555556
NODE_51100_length_464_cov_8.473973	209	289	0	80	80	1.0000000
NODE_51100_length_464_cov_8.473973	262	342	0	80	80	1.0000000
NODE_51148_length_464_cov_2.528767	136	199	0	63	63	1.0000000
NODE_51167_length_464_cov_2.134247	130	203	0	17	73	0.2328767
NODE_51167_length_464_cov_2.134247	130	203	2	51	73	0.6986302
NODE_51167_length_464_cov_2.134247	130	203	5	5	73	0.0684932
NODE_51186_length_464_cov_1.901370	58	138	0	1	80	0.0125000
NODE_51186_length_464_cov_1.901370	58	138	1	22	80	0.2750000
NODE_51186_length_464_cov_1.901370	58	138	2	57	80	0.7125000
NODE_51203_length_464_cov_1.706849	186	265	0	79	79	1.0000000
NODE_51377_length_463_cov_64.420330	375	455	0	80	80	1.0000000
NODE_51377_length_463_cov_64.420330	375	455	0	80	80	1.0000000
NODE_51377_length_463_cov_64.420330	375	455	0	80	80	1.0000000
NODE_51377_length_463_cov_64.420330	375	455	0	80	80	1.0000000
NODE_51377_length_463_cov_64.420330	375	455	0	80	80	1.0000000
NODE_51378_length_463_cov_49.673077	0	71	2	18	71	0.2535211
NODE_51378_length_463_cov_49.673077	0	71	4	22	71	0.3098592
NODE_51378_length_463_cov_49.673077	0	71	8	24	71	0.3380282
NODE_51378_length_463_cov_49.673077	0	71	10	7	71	0.0985916
NODE_51378_length_463_cov_49.673077	44	121	8	20	77	0.2597403
NODE_51378_length_463_cov_49.673077	44	121	10	53	77	0.6883117
NODE_51378_length_463_cov_49.673077	44	121	12	3	77	0.0389610
NODE_51378_length_463_cov_49.673077	44	121	14	1	77	0.0129870
NODE_51379_length_463_cov_41.005495	8	88	0	80	80	1.0000000
NODE_51379_length_463_cov_41.005495	61	141	0	80	80	1.0000000
NODE_51380_length_463_cov_30.626374	318	398	0	80	80	1.0000000
NODE_51380_length_463_cov_30.626374	371	451	0	80	80	1.0000000
NODE_51381_length_463_cov_27.475275	211	291	0	80	80	1.0000000
NODE_51381_length_463_cov_27.475275	264	344	0	80	80	1.0000000
NODE_51383_length_463_cov_11.211538	304	377	0	73	73	1.0000000
NODE_51383_length_463_cov_11.211538	350	430	0	80	80	1.0000000
NODE_51391_length_463_cov_5.711538	181	261	0	80	80	1.0000000
NODE_51391_length_463_cov_5.711538	234	314	0	80	80	1.0000000
NODE_51399_length_463_cov_4.398352	119	169	0	50	50	1.0000000
NODE_51402_length_463_cov_4.186813	175	233	4	58	58	1.0000000
NODE_51402_length_463_cov_4.186813	206	251	0	1	45	0.0222222
NODE_51402_length_463_cov_4.186813	206	251	4	44	45	0.9777778
NODE_51408_length_463_cov_3.846154	235	268	0	14	33	0.4242424
NODE_51408_length_463_cov_3.846154	235	268	2	19	33	0.5757576
NODE_51421_length_463_cov_3.063187	193	248	0	55	55	1.0000000
NODE_51421_length_463_cov_3.063187	222	301	0	79	79	1.0000000
NODE_51680_length_462_cov_21.876033	93	173	0	41	80	0.5125000
NODE_51680_length_462_cov_21.876033	93	173	2	39	80	0.4875000
NODE_51680_length_462_cov_21.876033	146	226	0	12	80	0.1500000
NODE_51680_length_462_cov_21.876033	146	226	2	68	80	0.8500000
NODE_51687_length_462_cov_5.033058	93	154	0	61	61	1.0000000
NODE_51687_length_462_cov_5.033058	159	209	2	50	50	1.0000000
NODE_51699_length_462_cov_4.101928	168	246	0	78	78	1.0000000
NODE_51699_length_462_cov_4.101928	184	208	0	24	24	1.0000000
NODE_51699_length_462_cov_4.101928	219	299	0	80	80	1.0000000
NODE_51708_length_462_cov_3.630854	149	194	0	24	45	0.5333334
NODE_51708_length_462_cov_3.630854	149	194	4	21	45	0.4666667
NODE_51720_length_462_cov_3.079890	103	147	0	22	44	0.5000000
NODE_51720_length_462_cov_3.079890	103	147	2	22	44	0.5000000
NODE_51735_length_462_cov_2.677686	78	118	0	13	40	0.3250000
NODE_51735_length_462_cov_2.677686	78	118	2	27	40	0.6750000
NODE_51763_length_462_cov_2.209366	18	58	0	40	40	1.0000000
NODE_51817_length_462_cov_1.570248	68	113	0	45	45	1.0000000
NODE_51995_length_461_cov_35.116022	0	79	0	79	79	1.0000000
NODE_51995_length_461_cov_35.116022	52	132	0	80	80	1.0000000
NODE_51996_length_461_cov_11.124309	77	157	0	80	80	1.0000000
NODE_51996_length_461_cov_11.124309	130	210	0	80	80	1.0000000
NODE_52010_length_461_cov_5.361878	246	322	0	76	76	1.0000000
NODE_52018_length_461_cov_4.472376	268	333	0	65	65	1.0000000
NODE_52021_length_461_cov_4.168508	159	234	0	75	75	1.0000000
NODE_52047_length_461_cov_2.892265	233	312	0	79	79	1.0000000
NODE_52073_length_461_cov_2.392265	186	223	0	37	37	1.0000000
NODE_52154_length_461_cov_1.389503	283	349	2	66	66	1.0000000
NODE_52292_length_460_cov_172.986150	0	68	14	3	68	0.0441176
NODE_52292_length_460_cov_172.986150	0	68	16	1	68	0.0147059
NODE_52292_length_460_cov_172.986150	0	68	18	1	68	0.0147059
NODE_52292_length_460_cov_172.986150	0	68	24	1	68	0.0147059
NODE_52292_length_460_cov_172.986150	0	68	30	1	68	0.0147059
NODE_52292_length_460_cov_172.986150	0	68	32	1	68	0.0147059
NODE_52292_length_460_cov_172.986150	0	68	39	1	68	0.0147059
NODE_52292_length_460_cov_172.986150	0	68	54	1	68	0.0147059
NODE_52292_length_460_cov_172.986150	0	68	58	1	68	0.0147059
NODE_52292_length_460_cov_172.986150	0	68	59	1	68	0.0147059
NODE_52292_length_460_cov_172.986150	0	68	72	1	68	0.0147059
NODE_52292_length_460_cov_172.986150	0	68	85	1	68	0.0147059
NODE_52292_length_460_cov_172.986150	0	68	88	1	68	0.0147059
NODE_52292_length_460_cov_172.986150	0	68	96	1	68	0.0147059
NODE_52292_length_460_cov_172.986150	0	68	109	1	68	0.0147059
NODE_52292_length_460_cov_172.986150	0	68	125	1	68	0.0147059
NODE_52292_length_460_cov_172.986150	0	68	131	1	68	0.0147059
NODE_52292_length_460_cov_172.986150	0	68	158	1	68	0.0147059
NODE_52292_length_460_cov_172.986150	0	68	170	2	68	0.0294118
NODE_52292_length_460_cov_172.986150	0	68	175	1	68	0.0147059
NODE_52292_length_460_cov_172.986150	0	68	177	1	68	0.0147059
NODE_52292_length_460_cov_172.986150	0	68	187	1	68	0.0147059
NODE_52292_length_460_cov_172.986150	0	68	196	1	68	0.0147059
NODE_52292_length_460_cov_172.986150	0	68	200	1	68	0.0147059
NODE_52292_length_460_cov_172.986150	0	68	204	3	68	0.0441176
NODE_52292_length_460_cov_172.986150	0	68	210	1	68	0.0147059
NODE_52292_length_460_cov_172.986150	0	68	211	3	68	0.0441176
NODE_52292_length_460_cov_172.986150	0	68	213	1	68	0.0147059
NODE_52292_length_460_cov_172.986150	0	68	223	1	68	0.0147059
NODE_52292_length_460_cov_172.986150	0	68	224	1	68	0.0147059
NODE_52292_length_460_cov_172.986150	0	68	231	2	68	0.0294118
NODE_52292_length_460_cov_172.986150	0	68	237	1	68	0.0147059
NODE_52292_length_460_cov_172.986150	0	68	241	1	68	0.0147059
NODE_52292_length_460_cov_172.986150	0	68	243	1	68	0.0147059
NODE_52292_length_460_cov_172.986150	0	68	245	3	68	0.0441176
NODE_52292_length_460_cov_172.986150	0	68	251	1	68	0.0147059
NODE_52292_length_460_cov_172.986150	0	68	252	1	68	0.0147059
NODE_52292_length_460_cov_172.986150	0	68	256	1	68	0.0147059
NODE_52292_length_460_cov_172.986150	0	68	264	2	68	0.0294118
NODE_52292_length_460_cov_172.986150	0	68	273	1	68	0.0147059
NODE_52292_length_460_cov_172.986150	0	68	278	1	68	0.0147059
NODE_52292_length_460_cov_172.986150	0	68	290	1	68	0.0147059
NODE_52292_length_460_cov_172.986150	0	68	298	1	68	0.0147059
NODE_52292_length_460_cov_172.986150	0	68	308	1	68	0.0147059
NODE_52292_length_460_cov_172.986150	0	68	317	1	68	0.0147059
NODE_52292_length_460_cov_172.986150	0	68	318	1	68	0.0147059
NODE_52292_length_460_cov_172.986150	0	68	320	3	68	0.0441176
NODE_52292_length_460_cov_172.986150	0	68	321	1	68	0.0147059
NODE_52292_length_460_cov_172.986150	0	68	327	2	68	0.0294118
NODE_52292_length_460_cov_172.986150	0	68	328	3	68	0.0441176
NODE_52292_length_460_cov_172.986150	0	68	333	1	68	0.0147059
NODE_52292_length_460_cov_172.986150	0	68	334	1	68	0.0147059
NODE_52292_length_460_cov_172.986150	41	121	243	1	80	0.0125000
NODE_52292_length_460_cov_172.986150	41	121	245	3	80	0.0375000
NODE_52292_length_460_cov_172.986150	41	121	251	1	80	0.0125000
NODE_52292_length_460_cov_172.986150	41	121	252	1	80	0.0125000
NODE_52292_length_460_cov_172.986150	41	121	256	1	80	0.0125000
NODE_52292_length_460_cov_172.986150	41	121	264	2	80	0.0250000
NODE_52292_length_460_cov_172.986150	41	121	273	1	80	0.0125000
NODE_52292_length_460_cov_172.986150	41	121	278	1	80	0.0125000
NODE_52292_length_460_cov_172.986150	41	121	290	1	80	0.0125000
NODE_52292_length_460_cov_172.986150	41	121	298	1	80	0.0125000
NODE_52292_length_460_cov_172.986150	41	121	308	1	80	0.0125000
NODE_52292_length_460_cov_172.986150	41	121	317	1	80	0.0125000
NODE_52292_length_460_cov_172.986150	41	121	318	1	80	0.0125000
NODE_52292_length_460_cov_172.986150	41	121	320	3	80	0.0375000
NODE_52292_length_460_cov_172.986150	41	121	321	1	80	0.0125000
NODE_52292_length_460_cov_172.986150	41	121	327	2	80	0.0250000
NODE_52292_length_460_cov_172.986150	41	121	328	3	80	0.0375000
NODE_52292_length_460_cov_172.986150	41	121	333	1	80	0.0125000
NODE_52292_length_460_cov_172.986150	41	121	334	2	80	0.0250000
NODE_52292_length_460_cov_172.986150	41	121	339	1	80	0.0125000
NODE_52292_length_460_cov_172.986150	41	121	342	2	80	0.0250000
NODE_52292_length_460_cov_172.986150	41	121	343	1	80	0.0125000
NODE_52292_length_460_cov_172.986150	41	121	346	1	80	0.0125000
NODE_52292_length_460_cov_172.986150	41	121	350	1	80	0.0125000
NODE_52292_length_460_cov_172.986150	41	121	354	3	80	0.0375000
NODE_52292_length_460_cov_172.986150	41	121	356	3	80	0.0375000
NODE_52292_length_460_cov_172.986150	41	121	362	1	80	0.0125000
NODE_52292_length_460_cov_172.986150	41	121	369	6	80	0.0750000
NODE_52292_length_460_cov_172.986150	41	121	373	3	80	0.0375000
NODE_52292_length_460_cov_172.986150	41	121	379	1	80	0.0125000
NODE_52292_length_460_cov_172.986150	41	121	380	1	80	0.0125000
NODE_52292_length_460_cov_172.986150	41	121	384	1	80	0.0125000
NODE_52292_length_460_cov_172.986150	41	121	386	2	80	0.0250000
NODE_52292_length_460_cov_172.986150	41	121	392	2	80	0.0250000
NODE_52292_length_460_cov_172.986150	41	121	393	1	80	0.0125000
NODE_52292_length_460_cov_172.986150	41	121	395	3	80	0.0375000
NODE_52292_length_460_cov_172.986150	41	121	397	2	80	0.0250000
NODE_52292_length_460_cov_172.986150	41	121	399	3	80	0.0375000
NODE_52292_length_460_cov_172.986150	41	121	401	1	80	0.0125000
NODE_52292_length_460_cov_172.986150	41	121	405	1	80	0.0125000
NODE_52292_length_460_cov_172.986150	41	121	407	2	80	0.0250000
NODE_52292_length_460_cov_172.986150	41	121	409	1	80	0.0125000
NODE_52292_length_460_cov_172.986150	41	121	414	3	80	0.0375000
NODE_52292_length_460_cov_172.986150	41	121	415	2	80	0.0250000
NODE_52292_length_460_cov_172.986150	41	121	421	1	80	0.0125000
NODE_52292_length_460_cov_172.986150	41	121	423	1	80	0.0125000
NODE_52292_length_460_cov_172.986150	41	121	429	1	80	0.0125000
NODE_52292_length_460_cov_172.986150	41	121	432	1	80	0.0125000
NODE_52293_length_460_cov_62.512465	9	48	2	20	39	0.5128205
NODE_52293_length_460_cov_62.512465	9	48	3	19	39	0.4871795
NODE_52294_length_460_cov_33.146814	0	47	0	47	47	1.0000000
NODE_52294_length_460_cov_33.146814	43	115	0	72	72	1.0000000
NODE_52294_length_460_cov_33.146814	96	165	0	69	69	1.0000000
NODE_52295_length_460_cov_26.049861	0	63	4	21	63	0.3333333
NODE_52295_length_460_cov_26.049861	0	63	6	1	63	0.0158730
NODE_52295_length_460_cov_26.049861	0	63	10	3	63	0.0476190
NODE_52295_length_460_cov_26.049861	0	63	12	9	63	0.1428571
NODE_52295_length_460_cov_26.049861	0	63	16	5	63	0.0793651
NODE_52295_length_460_cov_26.049861	0	63	18	8	63	0.1269841
NODE_52295_length_460_cov_26.049861	0	63	22	1	63	0.0158730
NODE_52295_length_460_cov_26.049861	0	63	24	12	63	0.1904762
NODE_52295_length_460_cov_26.049861	0	63	26	3	63	0.0476190
NODE_52296_length_460_cov_25.709141	246	326	0	80	80	1.0000000
NODE_52296_length_460_cov_25.709141	299	379	0	80	80	1.0000000
NODE_52297_length_460_cov_11.063712	273	353	0	80	80	1.0000000
NODE_52297_length_460_cov_11.063712	326	406	0	80	80	1.0000000
NODE_52303_length_460_cov_7.285319	172	250	0	78	78	1.0000000
NODE_52312_length_460_cov_5.163435	120	200	0	80	80	1.0000000
NODE_52312_length_460_cov_5.163435	173	253	0	80	80	1.0000000
NODE_52333_length_460_cov_3.457064	150	230	0	80	80	1.0000000
NODE_52333_length_460_cov_3.457064	203	246	0	43	43	1.0000000
NODE_52339_length_460_cov_3.027701	167	230	2	7	63	0.1111111
NODE_52339_length_460_cov_3.027701	167	230	4	30	63	0.4761905
NODE_52339_length_460_cov_3.027701	167	230	6	26	63	0.4126984
NODE_52347_length_460_cov_2.819945	195	266	1	2	71	0.0281690
NODE_52347_length_460_cov_2.819945	195	266	2	35	71	0.4929577
NODE_52347_length_460_cov_2.819945	195	266	3	31	71	0.4366197
NODE_52347_length_460_cov_2.819945	195	266	6	3	71	0.0422535
NODE_52358_length_460_cov_2.626039	223	277	1	54	54	1.0000000
NODE_52612_length_459_cov_34.927778	165	239	0	74	74	1.0000000
NODE_52612_length_459_cov_34.927778	212	292	0	80	80	1.0000000
NODE_52617_length_459_cov_7.261111	143	189	0	46	46	1.0000000
NODE_52617_length_459_cov_7.261111	162	242	0	80	80	1.0000000
NODE_52635_length_459_cov_4.127778	153	233	0	80	80	1.0000000
NODE_52685_length_459_cov_2.158333	219	285	0	66	66	1.0000000
NODE_52685_length_459_cov_2.158333	283	342	0	59	59	1.0000000
NODE_52704_length_459_cov_1.722222	280	353	0	73	73	1.0000000
NODE_52920_length_458_cov_71.047354	0	51	0	51	51	1.0000000
NODE_52920_length_458_cov_71.047354	24	104	0	80	80	1.0000000
NODE_52920_length_458_cov_71.047354	100	180	0	67	80	0.8375000
NODE_52920_length_458_cov_71.047354	100	180	2	13	80	0.1625000
NODE_52920_length_458_cov_71.047354	153	233	0	14	80	0.1750000
NODE_52920_length_458_cov_71.047354	153	233	2	66	80	0.8250000
NODE_52921_length_458_cov_47.966574	151	231	0	80	80	1.0000000
NODE_52921_length_458_cov_47.966574	204	284	0	80	80	1.0000000
NODE_52921_length_458_cov_47.966574	280	360	0	80	80	1.0000000
NODE_52921_length_458_cov_47.966574	333	413	0	80	80	1.0000000
NODE_52924_length_458_cov_9.935933	267	347	0	80	80	1.0000000
NODE_52924_length_458_cov_9.935933	320	400	0	80	80	1.0000000
NODE_52929_length_458_cov_7.598886	87	167	2	53	80	0.6625000
NODE_52929_length_458_cov_7.598886	87	167	4	27	80	0.3375000
NODE_52967_length_458_cov_3.061281	62	91	0	29	29	1.0000000
NODE_52967_length_458_cov_3.061281	185	224	0	30	39	0.7692308
NODE_52967_length_458_cov_3.061281	185	224	2	8	39	0.2051282
NODE_52967_length_458_cov_3.061281	185	224	4	1	39	0.0256410
NODE_52992_length_458_cov_2.454039	210	251	0	41	41	1.0000000
NODE_53107_length_458_cov_1.139276	242	289	2	44	47	0.9361702
NODE_53107_length_458_cov_1.139276	242	289	4	3	47	0.0638298
NODE_53107_length_458_cov_1.139276	262	328	2	50	66	0.7575758
NODE_53107_length_458_cov_1.139276	262	328	4	16	66	0.2424242
NODE_53205_length_457_cov_20.754190	123	203	0	80	80	1.0000000
NODE_53205_length_457_cov_20.754190	176	256	0	80	80	1.0000000
NODE_53207_length_457_cov_13.918994	218	298	0	80	80	1.0000000
NODE_53207_length_457_cov_13.918994	218	298	0	80	80	1.0000000
NODE_53207_length_457_cov_13.918994	218	298	0	80	80	1.0000000
NODE_53207_length_457_cov_13.918994	218	298	0	80	80	1.0000000
NODE_53207_length_457_cov_13.918994	271	320	0	46	49	0.9387755
NODE_53207_length_457_cov_13.918994	271	320	2	2	49	0.0408163
NODE_53207_length_457_cov_13.918994	271	320	4	1	49	0.0204082
NODE_53207_length_457_cov_13.918994	271	320	0	46	49	0.9387755
NODE_53207_length_457_cov_13.918994	271	320	2	2	49	0.0408163
NODE_53207_length_457_cov_13.918994	271	320	4	1	49	0.0204082
NODE_53207_length_457_cov_13.918994	271	320	0	46	49	0.9387755
NODE_53207_length_457_cov_13.918994	271	320	2	2	49	0.0408163
NODE_53207_length_457_cov_13.918994	271	320	4	1	49	0.0204082
NODE_53216_length_457_cov_6.050279	264	326	1	28	62	0.4516129
NODE_53216_length_457_cov_6.050279	264	326	2	23	62	0.3709677
NODE_53216_length_457_cov_6.050279	264	326	3	11	62	0.1774193
NODE_53220_length_457_cov_5.078212	71	149	0	78	78	1.0000000
NODE_53220_length_457_cov_5.078212	122	202	0	80	80	1.0000000
NODE_53225_length_457_cov_4.530726	193	273	0	28	80	0.3500000
NODE_53225_length_457_cov_4.530726	193	273	2	52	80	0.6500000
NODE_53225_length_457_cov_4.530726	246	315	0	5	69	0.0724638
NODE_53225_length_457_cov_4.530726	246	315	2	64	69	0.9275362
NODE_53230_length_457_cov_3.986034	192	272	0	80	80	1.0000000
NODE_53267_length_457_cov_2.636872	117	197	0	65	80	0.8125000
NODE_53267_length_457_cov_2.636872	117	197	2	15	80	0.1875000
NODE_53462_length_457_cov_0.916201	108	188	0	80	80	1.0000000
NODE_53462_length_457_cov_0.916201	108	188	0	80	80	1.0000000
NODE_53462_length_457_cov_0.916201	161	241	0	80	80	1.0000000
NODE_53462_length_457_cov_0.916201	161	241	0	80	80	1.0000000
NODE_53512_length_456_cov_34.731092	0	63	0	63	63	1.0000000
NODE_53512_length_456_cov_34.731092	36	116	0	80	80	1.0000000
NODE_53512_length_456_cov_34.731092	112	194	0	82	82	1.0000000
NODE_53532_length_456_cov_4.582633	269	349	0	80	80	1.0000000
NODE_53533_length_456_cov_4.554622	124	206	0	82	82	1.0000000
NODE_53533_length_456_cov_4.554622	179	263	0	84	84	1.0000000
NODE_53546_length_456_cov_3.669468	123	186	0	63	63	1.0000000
NODE_53566_length_456_cov_2.921569	302	362	0	60	60	1.0000000
NODE_53859_length_455_cov_113.589888	137	220	9	42	83	0.5060241
NODE_53859_length_455_cov_113.589888	137	220	15	1	83	0.0120482
NODE_53859_length_455_cov_113.589888	137	220	16	4	83	0.0481928
NODE_53859_length_455_cov_113.589888	137	220	17	6	83	0.0722892
NODE_53859_length_455_cov_113.589888	137	220	18	30	83	0.3614458
NODE_53859_length_455_cov_113.589888	198	268	9	66	70	0.9428571
NODE_53859_length_455_cov_113.589888	198	268	15	1	70	0.0142857
NODE_53859_length_455_cov_113.589888	198	268	16	3	70	0.0428571
NODE_53859_length_455_cov_113.589888	269	348	0	37	79	0.4683544
NODE_53859_length_455_cov_113.589888	269	348	9	42	79	0.5316456
NODE_53859_length_455_cov_113.589888	321	401	0	80	80	1.0000000
NODE_53860_length_455_cov_52.941011	260	340	0	80	80	1.0000000
NODE_53860_length_455_cov_52.941011	313	393	0	80	80	1.0000000
NODE_53863_length_455_cov_8.584270	250	302	0	52	52	1.0000000
NODE_53863_length_455_cov_8.584270	275	355	0	80	80	1.0000000
NODE_53864_length_455_cov_8.084270	146	226	0	23	80	0.2875000
NODE_53864_length_455_cov_8.084270	146	226	2	4	80	0.0500000
NODE_53864_length_455_cov_8.084270	146	226	6	26	80	0.3250000
NODE_53864_length_455_cov_8.084270	146	226	8	27	80	0.3375000
NODE_53864_length_455_cov_8.084270	199	279	0	76	80	0.9500000
NODE_53864_length_455_cov_8.084270	199	279	2	4	80	0.0500000
NODE_53870_length_455_cov_6.022472	122	203	0	81	81	1.0000000
NODE_53872_length_455_cov_5.140449	181	232	0	21	51	0.4117647
NODE_53872_length_455_cov_5.140449	181	232	2	30	51	0.5882353
NODE_54512_length_453_cov_29.528249	44	124	0	80	80	1.0000000
NODE_54512_length_453_cov_29.528249	97	177	0	80	80	1.0000000
NODE_54512_length_453_cov_29.528249	173	253	0	80	80	1.0000000
NODE_54512_length_453_cov_29.528249	226	301	0	46	75	0.6133333
NODE_54512_length_453_cov_29.528249	226	301	2	29	75	0.3866667
NODE_54513_length_453_cov_11.146893	95	140	0	45	45	1.0000000
NODE_54513_length_453_cov_11.146893	146	220	0	74	74	1.0000000
NODE_54517_length_453_cov_7.709040	194	252	2	23	58	0.3965517
NODE_54517_length_453_cov_7.709040	194	252	3	15	58	0.2586207
NODE_54517_length_453_cov_7.709040	194	252	4	20	58	0.3448276
NODE_54518_length_453_cov_7.440678	250	319	0	69	69	1.0000000
NODE_54533_length_453_cov_4.282486	190	270	0	80	80	1.0000000
NODE_54533_length_453_cov_4.282486	243	283	0	40	40	1.0000000
NODE_54566_length_453_cov_2.836158	186	266	0	80	80	1.0000000
NODE_54566_length_453_cov_2.836158	239	319	0	80	80	1.0000000
NODE_54592_length_453_cov_2.048023	139	174	2	2	35	0.0571429
NODE_54592_length_453_cov_2.048023	139	174	4	33	35	0.9428571
NODE_54600_length_453_cov_2.002825	78	98	0	20	20	1.0000000
NODE_54767_length_453_cov_0.774011	174	195	0	21	21	1.0000000
NODE_54822_length_452_cov_36.028329	0	72	0	72	72	1.0000000
NODE_54822_length_452_cov_36.028329	0	72	0	72	72	1.0000000
NODE_54822_length_452_cov_36.028329	45	99	0	54	54	1.0000000
NODE_54822_length_452_cov_36.028329	45	125	0	80	80	1.0000000
NODE_54823_length_452_cov_17.424929	29	109	0	80	80	1.0000000
NODE_54823_length_452_cov_17.424929	82	162	0	80	80	1.0000000
NODE_54844_length_452_cov_4.317280	141	200	0	26	59	0.4406780
NODE_54844_length_452_cov_4.317280	141	200	2	33	59	0.5593221
NODE_54886_length_452_cov_2.634561	262	338	0	76	76	1.0000000
NODE_55146_length_451_cov_37.090909	230	310	0	80	80	1.0000000
NODE_55146_length_451_cov_37.090909	283	363	0	80	80	1.0000000
NODE_55147_length_451_cov_16.517045	205	286	0	40	81	0.4938272
NODE_55147_length_451_cov_16.517045	205	286	2	41	81	0.5061728
NODE_55147_length_451_cov_16.517045	259	339	0	80	80	1.0000000
NODE_55148_length_451_cov_13.153409	182	262	0	80	80	1.0000000
NODE_55148_length_451_cov_13.153409	235	315	0	80	80	1.0000000
NODE_55149_length_451_cov_11.926136	141	221	2	51	80	0.6375000
NODE_55149_length_451_cov_11.926136	141	221	6	2	80	0.0250000
NODE_55149_length_451_cov_11.926136	141	221	7	27	80	0.3375000
NODE_55149_length_451_cov_11.926136	331	411	2	7	80	0.0875000
NODE_55149_length_451_cov_11.926136	331	411	4	14	80	0.1750000
NODE_55149_length_451_cov_11.926136	331	411	6	48	80	0.6000000
NODE_55149_length_451_cov_11.926136	331	411	9	11	80	0.1375000
NODE_55154_length_451_cov_7.102273	81	143	0	62	62	1.0000000
NODE_55161_length_451_cov_5.610795	1	31	0	30	30	1.0000000
NODE_55161_length_451_cov_5.610795	60	90	0	30	30	1.0000000
NODE_55166_length_451_cov_5.065341	219	285	0	62	66	0.9393939
NODE_55166_length_451_cov_5.065341	219	285	2	4	66	0.0606061
NODE_55166_length_451_cov_5.065341	272	322	0	50	50	1.0000000
NODE_55184_length_451_cov_3.696023	253	332	8	16	79	0.2025317
NODE_55184_length_451_cov_3.696023	253	332	14	18	79	0.2278481
NODE_55184_length_451_cov_3.696023	253	332	18	13	79	0.1645570
NODE_55184_length_451_cov_3.696023	253	332	23	2	79	0.0253165
NODE_55184_length_451_cov_3.696023	253	332	24	30	79	0.3797468
NODE_55188_length_451_cov_3.406250	176	247	2	10	71	0.1408451
NODE_55188_length_451_cov_3.406250	176	247	4	11	71	0.1549296
NODE_55188_length_451_cov_3.406250	176	247	8	23	71	0.3239437
NODE_55188_length_451_cov_3.406250	176	247	10	27	71	0.3802817
NODE_55188_length_451_cov_3.406250	220	300	6	9	80	0.1125000
NODE_55188_length_451_cov_3.406250	220	300	8	1	80	0.0125000
NODE_55188_length_451_cov_3.406250	220	300	10	70	80	0.8750000
NODE_55198_length_451_cov_3.025568	72	148	10	5	76	0.0657895
NODE_55198_length_451_cov_3.025568	72	148	14	71	76	0.9342105
NODE_55213_length_451_cov_2.607955	84	143	0	59	59	1.0000000
NODE_55213_length_451_cov_2.607955	257	326	0	69	69	1.0000000
NODE_55234_length_451_cov_2.125000	156	224	2	68	68	1.0000000
NODE_55436_length_450_cov_105.723647	317	386	0	69	69	1.0000000
NODE_55438_length_450_cov_27.982906	98	120	0	22	22	1.0000000
NODE_55438_length_450_cov_27.982906	225	305	0	80	80	1.0000000
NODE_55438_length_450_cov_27.982906	278	358	0	80	80	1.0000000
NODE_55459_length_450_cov_3.991453	220	290	0	70	70	1.0000000
NODE_55459_length_450_cov_3.991453	223	290	0	67	67	1.0000000
NODE_55459_length_450_cov_3.991453	268	348	0	80	80	1.0000000
NODE_55459_length_450_cov_3.991453	268	348	0	80	80	1.0000000
NODE_55459_length_450_cov_3.991453	278	348	0	70	70	1.0000000
NODE_55459_length_450_cov_3.991453	344	363	0	19	19	1.0000000
NODE_55466_length_450_cov_3.717949	107	177	0	70	70	1.0000000
NODE_55483_length_450_cov_3.162393	99	157	0	58	58	1.0000000
NODE_55550_length_450_cov_1.857550	114	172	2	2	58	0.0344828
NODE_55550_length_450_cov_1.857550	114	172	3	43	58	0.7413793
NODE_55550_length_450_cov_1.857550	114	172	5	3	58	0.0517241
NODE_55550_length_450_cov_1.857550	114	172	7	2	58	0.0344828
NODE_55550_length_450_cov_1.857550	114	172	9	8	58	0.1379310
NODE_55560_length_450_cov_1.749288	321	376	0	55	55	1.0000000
NODE_55565_length_450_cov_1.723647	101	161	20	16	60	0.2666667
NODE_55565_length_450_cov_1.723647	101	161	22	18	60	0.3000000
NODE_55565_length_450_cov_1.723647	101	161	24	26	60	0.4333333
NODE_55685_length_450_cov_1.017094	116	196	0	62	80	0.7750000
NODE_55685_length_450_cov_1.017094	116	196	2	18	80	0.2250000
NODE_55761_length_449_cov_46.882857	237	317	0	80	80	1.0000000
NODE_55761_length_449_cov_46.882857	290	370	0	80	80	1.0000000
NODE_55762_length_449_cov_36.031429	238	318	0	80	80	1.0000000
NODE_55762_length_449_cov_36.031429	291	371	0	80	80	1.0000000
NODE_55783_length_449_cov_4.594286	137	184	2	17	47	0.3617021
NODE_55783_length_449_cov_4.594286	137	184	3	1	47	0.0212766
NODE_55783_length_449_cov_4.594286	137	184	4	16	47	0.3404255
NODE_55783_length_449_cov_4.594286	137	184	5	13	47	0.2765957
NODE_55794_length_449_cov_3.797143	204	284	4	7	80	0.0875000
NODE_55794_length_449_cov_3.797143	204	284	6	9	80	0.1125000
NODE_55794_length_449_cov_3.797143	204	284	8	31	80	0.3875000
NODE_55794_length_449_cov_3.797143	204	284	10	33	80	0.4125000
NODE_55844_length_449_cov_2.445714	346	376	0	30	30	1.0000000
NODE_56144_length_448_cov_44.664756	126	206	0	80	80	1.0000000
NODE_56144_length_448_cov_44.664756	179	259	0	80	80	1.0000000
NODE_56145_length_448_cov_36.148997	195	275	0	80	80	1.0000000
NODE_56145_length_448_cov_36.148997	248	328	0	80	80	1.0000000
NODE_56145_length_448_cov_36.148997	324	404	0	11	80	0.1375000
NODE_56145_length_448_cov_36.148997	324	404	6	69	80	0.8625000
NODE_56145_length_448_cov_36.148997	377	448	0	37	71	0.5211267
NODE_56145_length_448_cov_36.148997	377	448	6	34	71	0.4788733
NODE_56146_length_448_cov_31.816619	43	123	0	80	80	1.0000000
NODE_56151_length_448_cov_6.779370	197	277	0	80	80	1.0000000
NODE_56151_length_448_cov_6.779370	250	313	0	31	63	0.4920635
NODE_56151_length_448_cov_6.779370	250	313	2	32	63	0.5079365
NODE_56180_length_448_cov_3.664756	148	189	0	41	41	1.0000000
NODE_56189_length_448_cov_3.108883	242	324	0	29	82	0.3536585
NODE_56189_length_448_cov_3.108883	242	324	3	21	82	0.2560976
NODE_56189_length_448_cov_3.108883	242	324	4	32	82	0.3902439
NODE_56233_length_448_cov_2.263610	292	360	0	2	68	0.0294118
NODE_56233_length_448_cov_2.263610	292	360	1	66	68	0.9705882
NODE_56518_length_447_cov_10.505747	205	234	0	29	29	1.0000000
NODE_56518_length_447_cov_10.505747	267	326	0	59	59	1.0000000
NODE_56518_length_447_cov_10.505747	299	379	0	80	80	1.0000000
NODE_56527_length_447_cov_5.767241	176	256	0	33	80	0.4125000
NODE_56527_length_447_cov_5.767241	176	256	1	1	80	0.0125000
NODE_56527_length_447_cov_5.767241	176	256	3	22	80	0.2750000
NODE_56527_length_447_cov_5.767241	176	256	5	24	80	0.3000000
NODE_56527_length_447_cov_5.767241	229	309	0	51	80	0.6375000
NODE_56527_length_447_cov_5.767241	229	309	4	29	80	0.3625000
NODE_56539_length_447_cov_4.583333	265	289	0	14	24	0.5833333
NODE_56539_length_447_cov_4.583333	265	289	2	10	24	0.4166667
NODE_56545_length_447_cov_4.037356	58	138	0	80	80	1.0000000
NODE_56545_length_447_cov_4.037356	111	191	0	80	80	1.0000000
NODE_56890_length_446_cov_42.527378	239	310	5	13	71	0.1830986
NODE_56890_length_446_cov_42.527378	239	310	7	16	71	0.2253521
NODE_56890_length_446_cov_42.527378	239	310	13	1	71	0.0140845
NODE_56890_length_446_cov_42.527378	239	310	14	7	71	0.0985916
NODE_56890_length_446_cov_42.527378	239	310	17	1	71	0.0140845
NODE_56890_length_446_cov_42.527378	239	310	18	2	71	0.0281690
NODE_56890_length_446_cov_42.527378	239	310	19	2	71	0.0281690
NODE_56890_length_446_cov_42.527378	239	310	25	12	71	0.1690141
NODE_56890_length_446_cov_42.527378	239	310	27	17	71	0.2394366
NODE_56890_length_446_cov_42.527378	359	433	0	4	74	0.0540541
NODE_56890_length_446_cov_42.527378	359	433	7	11	74	0.1486486
NODE_56890_length_446_cov_42.527378	359	433	11	1	74	0.0135135
NODE_56890_length_446_cov_42.527378	359	433	13	6	74	0.0810811
NODE_56890_length_446_cov_42.527378	359	433	15	23	74	0.3108108
NODE_56890_length_446_cov_42.527378	359	433	20	2	74	0.0270270
NODE_56890_length_446_cov_42.527378	359	433	22	4	74	0.0540541
NODE_56890_length_446_cov_42.527378	359	433	24	11	74	0.1486486
NODE_56890_length_446_cov_42.527378	359	433	25	7	74	0.0945946
NODE_56890_length_446_cov_42.527378	359	433	27	5	74	0.0675676
NODE_56891_length_446_cov_12.749280	92	172	0	80	80	1.0000000
NODE_56891_length_446_cov_12.749280	145	225	0	80	80	1.0000000
NODE_56896_length_446_cov_6.902017	175	217	0	42	42	1.0000000
NODE_56902_length_446_cov_5.930836	165	245	0	80	80	1.0000000
NODE_56902_length_446_cov_5.930836	165	245	0	80	80	1.0000000
NODE_56902_length_446_cov_5.930836	165	235	0	70	70	1.0000000
NODE_56902_length_446_cov_5.930836	218	298	0	80	80	1.0000000
NODE_56902_length_446_cov_5.930836	218	297	0	79	79	1.0000000
NODE_56919_length_446_cov_3.896254	215	274	6	3	59	0.0508475
NODE_56919_length_446_cov_3.896254	215	274	8	2	59	0.0338983
NODE_56919_length_446_cov_3.896254	215	274	9	10	59	0.1694915
NODE_56919_length_446_cov_3.896254	215	274	10	44	59	0.7457627
NODE_56934_length_446_cov_3.282421	130	168	0	7	38	0.1842105
NODE_56934_length_446_cov_3.282421	130	168	6	31	38	0.8157895
NODE_56952_length_446_cov_2.775216	337	417	2	6	80	0.0750000
NODE_56952_length_446_cov_2.775216	337	417	4	74	80	0.9250000
NODE_56995_length_446_cov_2.161383	17	97	0	80	80	1.0000000
NODE_57022_length_446_cov_1.907781	196	225	2	6	29	0.2068966
NODE_57022_length_446_cov_1.907781	196	225	4	23	29	0.7931035
NODE_57277_length_445_cov_75.572254	108	188	0	80	80	1.0000000
NODE_57277_length_445_cov_75.572254	161	241	0	80	80	1.0000000
NODE_57277_length_445_cov_75.572254	237	317	0	80	80	1.0000000
NODE_57277_length_445_cov_75.572254	290	370	0	80	80	1.0000000
NODE_57278_length_445_cov_33.973988	83	163	0	80	80	1.0000000
NODE_57278_length_445_cov_33.973988	136	216	0	80	80	1.0000000
NODE_57280_length_445_cov_9.323699	78	148	0	69	70	0.9857143
NODE_57280_length_445_cov_9.323699	78	148	2	1	70	0.0142857
NODE_57280_length_445_cov_9.323699	121	201	0	26	80	0.3250000
NODE_57280_length_445_cov_9.323699	121	201	2	54	80	0.6750000
NODE_57284_length_445_cov_6.439306	210	282	0	19	72	0.2638889
NODE_57284_length_445_cov_6.439306	210	282	2	53	72	0.7361111
NODE_57286_length_445_cov_5.479769	115	184	0	69	69	1.0000000
NODE_57286_length_445_cov_5.479769	157	237	0	80	80	1.0000000
NODE_57286_length_445_cov_5.479769	233	309	0	76	76	1.0000000
NODE_57286_length_445_cov_5.479769	286	309	0	23	23	1.0000000
NODE_57345_length_445_cov_2.843931	124	199	0	75	75	1.0000000
NODE_57352_length_445_cov_2.682081	202	248	0	46	46	1.0000000
NODE_57400_length_445_cov_1.884393	252	332	2	80	80	1.0000000
NODE_57409_length_445_cov_1.783237	132	203	0	71	71	1.0000000
NODE_57409_length_445_cov_1.783237	256	331	0	75	75	1.0000000
NODE_57409_length_445_cov_1.783237	256	278	0	22	22	1.0000000
NODE_57644_length_444_cov_34.075362	243	323	0	80	80	1.0000000
NODE_57644_length_444_cov_34.075362	296	376	0	80	80	1.0000000
NODE_57645_length_444_cov_22.524638	98	178	0	80	80	1.0000000
NODE_57645_length_444_cov_22.524638	151	231	0	80	80	1.0000000
NODE_57646_length_444_cov_16.544928	263	343	0	80	80	1.0000000
NODE_57646_length_444_cov_16.544928	316	396	0	80	80	1.0000000
NODE_57647_length_444_cov_12.684058	293	373	0	7	80	0.0875000
NODE_57647_length_444_cov_12.684058	293	373	4	73	80	0.9125000
NODE_57647_length_444_cov_12.684058	346	426	0	60	80	0.7500000
NODE_57647_length_444_cov_12.684058	346	426	4	20	80	0.2500000
NODE_57649_length_444_cov_9.284058	176	256	0	80	80	1.0000000
NODE_57649_length_444_cov_9.284058	229	309	0	80	80	1.0000000
NODE_57666_length_444_cov_5.159420	170	241	0	71	71	1.0000000
NODE_57668_length_444_cov_5.060870	201	245	0	44	44	1.0000000
NODE_57668_length_444_cov_5.060870	218	298	0	80	80	1.0000000
NODE_57717_length_444_cov_2.744928	73	136	0	1	63	0.0158730
NODE_57717_length_444_cov_2.744928	73	136	6	62	63	0.9841270
NODE_57770_length_444_cov_2.028986	46	113	33	1	67	0.0149254
NODE_57770_length_444_cov_2.028986	46	113	37	5	67	0.0746269
NODE_57770_length_444_cov_2.028986	46	113	39	2	67	0.0298507
NODE_57770_length_444_cov_2.028986	46	113	45	2	67	0.0298507
NODE_57770_length_444_cov_2.028986	46	113	50	2	67	0.0298507
NODE_57770_length_444_cov_2.028986	46	113	51	2	67	0.0298507
NODE_57770_length_444_cov_2.028986	46	113	53	7	67	0.1044776
NODE_57770_length_444_cov_2.028986	46	113	59	1	67	0.0149254
NODE_57770_length_444_cov_2.028986	46	113	60	1	67	0.0149254
NODE_57770_length_444_cov_2.028986	46	113	62	2	67	0.0298507
NODE_57770_length_444_cov_2.028986	46	113	64	1	67	0.0149254
NODE_57770_length_444_cov_2.028986	46	113	66	2	67	0.0298507
NODE_57770_length_444_cov_2.028986	46	113	70	1	67	0.0149254
NODE_57770_length_444_cov_2.028986	46	113	76	2	67	0.0298507
NODE_57770_length_444_cov_2.028986	46	113	77	3	67	0.0447761
NODE_57770_length_444_cov_2.028986	46	113	79	1	67	0.0149254
NODE_57770_length_444_cov_2.028986	46	113	81	2	67	0.0298507
NODE_57770_length_444_cov_2.028986	46	113	83	2	67	0.0298507
NODE_57770_length_444_cov_2.028986	46	113	89	1	67	0.0149254
NODE_57770_length_444_cov_2.028986	46	113	91	1	67	0.0149254
NODE_57770_length_444_cov_2.028986	46	113	93	1	67	0.0149254
NODE_57770_length_444_cov_2.028986	46	113	95	2	67	0.0298507
NODE_57770_length_444_cov_2.028986	46	113	102	1	67	0.0149254
NODE_57770_length_444_cov_2.028986	46	113	106	1	67	0.0149254
NODE_57770_length_444_cov_2.028986	46	113	107	1	67	0.0149254
NODE_57770_length_444_cov_2.028986	46	113	114	5	67	0.0746269
NODE_57770_length_444_cov_2.028986	46	113	116	4	67	0.0597015
NODE_57770_length_444_cov_2.028986	46	113	120	5	67	0.0746269
NODE_57770_length_444_cov_2.028986	46	113	121	4	67	0.0597015
NODE_57770_length_444_cov_2.028986	46	113	122	1	67	0.0149254
NODE_57770_length_444_cov_2.028986	46	113	125	1	67	0.0149254
NODE_57770_length_444_cov_2.028986	86	166	91	1	80	0.0125000
NODE_57770_length_444_cov_2.028986	86	166	93	1	80	0.0125000
NODE_57770_length_444_cov_2.028986	86	166	95	2	80	0.0250000
NODE_57770_length_444_cov_2.028986	86	166	102	2	80	0.0250000
NODE_57770_length_444_cov_2.028986	86	166	106	2	80	0.0250000
NODE_57770_length_444_cov_2.028986	86	166	107	1	80	0.0125000
NODE_57770_length_444_cov_2.028986	86	166	108	1	80	0.0125000
NODE_57770_length_444_cov_2.028986	86	166	114	7	80	0.0875000
NODE_57770_length_444_cov_2.028986	86	166	115	3	80	0.0375000
NODE_57770_length_444_cov_2.028986	86	166	116	8	80	0.1000000
NODE_57770_length_444_cov_2.028986	86	166	118	1	80	0.0125000
NODE_57770_length_444_cov_2.028986	86	166	120	6	80	0.0750000
NODE_57770_length_444_cov_2.028986	86	166	121	4	80	0.0500000
NODE_57770_length_444_cov_2.028986	86	166	122	5	80	0.0625000
NODE_57770_length_444_cov_2.028986	86	166	124	8	80	0.1000000
NODE_57770_length_444_cov_2.028986	86	166	125	1	80	0.0125000
NODE_57770_length_444_cov_2.028986	86	166	126	6	80	0.0750000
NODE_57770_length_444_cov_2.028986	86	166	128	3	80	0.0375000
NODE_57770_length_444_cov_2.028986	86	166	130	1	80	0.0125000
NODE_57770_length_444_cov_2.028986	86	166	132	16	80	0.2000000
NODE_57770_length_444_cov_2.028986	86	166	134	1	80	0.0125000
NODE_57873_length_444_cov_1.234783	335	407	0	72	72	1.0000000
NODE_57892_length_444_cov_1.173913	7	87	0	80	80	1.0000000
NODE_58026_length_443_cov_71.284884	209	289	0	80	80	1.0000000
NODE_58026_length_443_cov_71.284884	262	342	0	80	80	1.0000000
NODE_58026_length_443_cov_71.284884	338	418	0	80	80	1.0000000
NODE_58026_length_443_cov_71.284884	391	443	0	52	52	1.0000000
NODE_58027_length_443_cov_68.973837	314	394	0	5	80	0.0625000
NODE_58027_length_443_cov_68.973837	314	394	2	17	80	0.2125000
NODE_58027_length_443_cov_68.973837	314	394	4	58	80	0.7250000
NODE_58027_length_443_cov_68.973837	367	443	0	33	76	0.4342105
NODE_58027_length_443_cov_68.973837	367	443	2	11	76	0.1447368
NODE_58027_length_443_cov_68.973837	367	443	4	32	76	0.4210526
NODE_58028_length_443_cov_61.116279	34	114	0	12	80	0.1500000
NODE_58028_length_443_cov_61.116279	34	114	22	68	80	0.8500000
NODE_58028_length_443_cov_61.116279	87	167	22	80	80	1.0000000
NODE_58041_length_443_cov_4.895349	127	207	0	80	80	1.0000000
NODE_58086_length_443_cov_2.581395	121	195	0	74	74	1.0000000
NODE_58088_length_443_cov_2.508721	297	347	0	50	50	1.0000000
NODE_58088_length_443_cov_2.508721	320	395	0	75	75	1.0000000
NODE_58091_length_443_cov_2.456395	114	192	0	78	78	1.0000000
NODE_58091_length_443_cov_2.456395	118	141	0	23	23	1.0000000
NODE_58237_length_443_cov_1.151163	144	224	0	5	80	0.0625000
NODE_58237_length_443_cov_1.151163	144	224	2	75	80	0.9375000
NODE_58321_length_443_cov_0.715116	52	104	0	14	52	0.2692308
NODE_58321_length_443_cov_0.715116	52	104	2	7	52	0.1346154
NODE_58321_length_443_cov_0.715116	52	104	4	31	52	0.5961539
NODE_58321_length_443_cov_0.715116	105	146	2	6	41	0.1463415
NODE_58321_length_443_cov_0.715116	105	146	4	35	41	0.8536586
NODE_58346_length_442_cov_42.956268	290	375	0	18	85	0.2117647
NODE_58346_length_442_cov_42.956268	290	375	2	4	85	0.0470588
NODE_58346_length_442_cov_42.956268	290	375	4	5	85	0.0588235
NODE_58346_length_442_cov_42.956268	290	375	14	11	85	0.1294118
NODE_58346_length_442_cov_42.956268	290	375	16	1	85	0.0117647
NODE_58346_length_442_cov_42.956268	290	375	18	6	85	0.0705882
NODE_58346_length_442_cov_42.956268	290	375	20	2	85	0.0235294
NODE_58346_length_442_cov_42.956268	290	375	21	1	85	0.0117647
NODE_58346_length_442_cov_42.956268	290	375	22	37	85	0.4352941
NODE_58346_length_442_cov_42.956268	290	375	0	18	85	0.2117647
NODE_58346_length_442_cov_42.956268	290	375	2	4	85	0.0470588
NODE_58346_length_442_cov_42.956268	290	375	4	5	85	0.0588235
NODE_58346_length_442_cov_42.956268	290	375	14	11	85	0.1294118
NODE_58346_length_442_cov_42.956268	290	375	16	1	85	0.0117647
NODE_58346_length_442_cov_42.956268	290	375	18	6	85	0.0705882
NODE_58346_length_442_cov_42.956268	290	375	20	2	85	0.0235294
NODE_58346_length_442_cov_42.956268	290	375	21	1	85	0.0117647
NODE_58346_length_442_cov_42.956268	290	375	22	37	85	0.4352941
NODE_58347_length_442_cov_24.093294	225	305	0	69	80	0.8625000
NODE_58347_length_442_cov_24.093294	225	305	6	11	80	0.1375000
NODE_58347_length_442_cov_24.093294	278	358	0	16	80	0.2000000
NODE_58347_length_442_cov_24.093294	278	358	6	64	80	0.8000000
NODE_58348_length_442_cov_8.956268	173	192	0	19	19	1.0000000
NODE_58361_length_442_cov_5.052478	213	293	0	80	80	1.0000000
NODE_58361_length_442_cov_5.052478	266	346	0	80	80	1.0000000
NODE_58376_length_442_cov_3.871720	297	372	0	5	75	0.0666667
NODE_58376_length_442_cov_3.871720	297	372	2	19	75	0.2533333
NODE_58376_length_442_cov_3.871720	297	372	4	51	75	0.6800000
NODE_58376_length_442_cov_3.871720	360	413	0	43	53	0.8113208
NODE_58376_length_442_cov_3.871720	360	413	2	5	53	0.0943396
NODE_58376_length_442_cov_3.871720	360	413	4	5	53	0.0943396
NODE_58378_length_442_cov_3.804665	211	244	0	32	33	0.9696970
NODE_58378_length_442_cov_3.804665	211	244	6	1	33	0.0303030
NODE_58405_length_442_cov_3.206997	149	217	8	68	68	1.0000000
NODE_58438_length_442_cov_2.434402	203	274	21	5	71	0.0704225
NODE_58438_length_442_cov_2.434402	203	274	22	1	71	0.0140845
NODE_58438_length_442_cov_2.434402	203	274	23	3	71	0.0422535
NODE_58438_length_442_cov_2.434402	203	274	24	1	71	0.0140845
NODE_58438_length_442_cov_2.434402	203	274	25	2	71	0.0281690
NODE_58438_length_442_cov_2.434402	203	274	29	36	71	0.5070422
NODE_58438_length_442_cov_2.434402	203	274	30	21	71	0.2957746
NODE_58438_length_442_cov_2.434402	203	274	32	2	71	0.0281690
NODE_58438_length_442_cov_2.434402	247	327	26	9	80	0.1125000
NODE_58438_length_442_cov_2.434402	247	327	28	6	80	0.0750000
NODE_58438_length_442_cov_2.434402	247	327	29	4	80	0.0500000
NODE_58438_length_442_cov_2.434402	247	327	30	26	80	0.3250000
NODE_58438_length_442_cov_2.434402	247	327	32	2	80	0.0250000
NODE_58438_length_442_cov_2.434402	247	327	33	1	80	0.0125000
NODE_58438_length_442_cov_2.434402	247	327	34	16	80	0.2000000
NODE_58438_length_442_cov_2.434402	247	327	35	16	80	0.2000000
NODE_58503_length_442_cov_1.746356	95	161	0	10	66	0.1515152
NODE_58503_length_442_cov_1.746356	95	161	4	56	66	0.8484849
NODE_58503_length_442_cov_1.746356	95	122	4	27	27	1.0000000
NODE_58759_length_441_cov_21.877193	28	108	0	80	80	1.0000000
NODE_58759_length_441_cov_21.877193	81	161	0	80	80	1.0000000
NODE_58760_length_441_cov_13.546784	152	232	0	80	80	1.0000000
NODE_58760_length_441_cov_13.546784	205	285	0	80	80	1.0000000
NODE_58771_length_441_cov_5.710526	200	280	0	80	80	1.0000000
NODE_58771_length_441_cov_5.710526	253	333	0	80	80	1.0000000
NODE_58817_length_441_cov_3.096491	240	324	0	84	84	1.0000000
NODE_58820_length_441_cov_3.023392	105	163	0	29	58	0.5000000
NODE_58820_length_441_cov_3.023392	105	163	2	8	58	0.1379310
NODE_58820_length_441_cov_3.023392	105	163	4	19	58	0.3275862
NODE_58820_length_441_cov_3.023392	105	163	6	2	58	0.0344828
NODE_58852_length_441_cov_2.438596	19	99	0	80	80	1.0000000
NODE_58852_length_441_cov_2.438596	72	126	0	54	54	1.0000000
NODE_58970_length_441_cov_1.435673	105	156	2	10	51	0.1960784
NODE_58970_length_441_cov_1.435673	105	156	4	41	51	0.8039216
NODE_59142_length_440_cov_43.131965	122	202	0	18	80	0.2250000
NODE_59142_length_440_cov_43.131965	122	202	8	62	80	0.7750000
NODE_59142_length_440_cov_43.131965	175	255	0	19	80	0.2375000
NODE_59142_length_440_cov_43.131965	175	255	8	61	80	0.7625000
NODE_59142_length_440_cov_43.131965	251	331	0	80	80	1.0000000
NODE_59142_length_440_cov_43.131965	304	384	0	80	80	1.0000000
NODE_59143_length_440_cov_42.929619	116	196	0	80	80	1.0000000
NODE_59143_length_440_cov_42.929619	169	249	0	80	80	1.0000000
NODE_59147_length_440_cov_8.164223	45	125	0	32	80	0.4000000
NODE_59147_length_440_cov_8.164223	45	125	3	1	80	0.0125000
NODE_59147_length_440_cov_8.164223	45	125	4	47	80	0.5875000
NODE_59147_length_440_cov_8.164223	98	178	0	10	80	0.1250000
NODE_59147_length_440_cov_8.164223	98	178	4	70	80	0.8750000
NODE_59157_length_440_cov_5.193548	146	210	6	21	64	0.3281250
NODE_59157_length_440_cov_5.193548	146	210	8	43	64	0.6718750
NODE_59157_length_440_cov_5.193548	146	210	6	21	64	0.3281250
NODE_59157_length_440_cov_5.193548	146	210	8	43	64	0.6718750
NODE_59157_length_440_cov_5.193548	146	210	6	21	64	0.3281250
NODE_59157_length_440_cov_5.193548	146	210	8	43	64	0.6718750
NODE_59164_length_440_cov_4.595308	153	233	0	80	80	1.0000000
NODE_59164_length_440_cov_4.595308	153	180	0	27	27	1.0000000
NODE_59188_length_440_cov_3.431085	84	150	0	66	66	1.0000000
NODE_59191_length_440_cov_3.331378	139	195	8	26	56	0.4642857
NODE_59191_length_440_cov_3.331378	139	195	10	30	56	0.5357143
NODE_59517_length_439_cov_76.552941	0	68	0	68	68	1.0000000
NODE_59517_length_439_cov_76.552941	0	68	0	68	68	1.0000000
NODE_59517_length_439_cov_76.552941	0	68	0	68	68	1.0000000
NODE_59517_length_439_cov_76.552941	1	68	0	67	67	1.0000000
NODE_59517_length_439_cov_76.552941	64	144	0	51	80	0.6375000
NODE_59517_length_439_cov_76.552941	64	144	2	29	80	0.3625000
NODE_59517_length_439_cov_76.552941	64	144	0	51	80	0.6375000
NODE_59517_length_439_cov_76.552941	64	144	2	29	80	0.3625000
NODE_59517_length_439_cov_76.552941	117	197	0	30	80	0.3750000
NODE_59517_length_439_cov_76.552941	117	197	2	50	80	0.6250000
NODE_59517_length_439_cov_76.552941	117	195	0	28	78	0.3589744
NODE_59517_length_439_cov_76.552941	117	195	2	50	78	0.6410257
NODE_59533_length_439_cov_4.408824	174	238	0	64	64	1.0000000
NODE_59536_length_439_cov_4.255882	258	318	0	60	60	1.0000000
NODE_59560_length_439_cov_3.011765	57	128	6	11	71	0.1549296
NODE_59560_length_439_cov_3.011765	57	128	8	47	71	0.6619718
NODE_59560_length_439_cov_3.011765	57	128	13	1	71	0.0140845
NODE_59560_length_439_cov_3.011765	57	128	14	12	71	0.1690141
NODE_59560_length_439_cov_3.011765	101	140	8	14	39	0.3589744
NODE_59560_length_439_cov_3.011765	101	140	13	1	39	0.0256410
NODE_59560_length_439_cov_3.011765	101	140	14	24	39	0.6153846
NODE_59592_length_439_cov_2.252941	227	269	0	9	42	0.2142857
NODE_59592_length_439_cov_2.252941	227	269	2	27	42	0.6428571
NODE_59592_length_439_cov_2.252941	227	269	3	6	42	0.1428571
NODE_59599_length_439_cov_2.135294	116	179	0	63	63	1.0000000
NODE_59617_length_439_cov_1.929412	388	439	0	51	51	1.0000000
NODE_59897_length_438_cov_29.952802	196	276	0	80	80	1.0000000
NODE_59897_length_438_cov_29.952802	249	329	0	80	80	1.0000000
NODE_59898_length_438_cov_16.330383	225	305	0	80	80	1.0000000
NODE_59898_length_438_cov_16.330383	278	358	0	80	80	1.0000000
NODE_59899_length_438_cov_15.436578	74	154	0	80	80	1.0000000
NODE_59899_length_438_cov_15.436578	127	207	0	80	80	1.0000000
NODE_59901_length_438_cov_9.306785	256	309	0	12	53	0.2264151
NODE_59901_length_438_cov_9.306785	256	309	4	41	53	0.7735849
NODE_59901_length_438_cov_9.306785	282	327	4	45	45	1.0000000
NODE_59916_length_438_cov_4.808260	46	133	0	45	87	0.5172414
NODE_59916_length_438_cov_4.808260	46	133	4	42	87	0.4827586
NODE_59916_length_438_cov_4.808260	106	186	4	31	80	0.3875000
NODE_59916_length_438_cov_4.808260	106	186	5	2	80	0.0250000
NODE_59916_length_438_cov_4.808260	106	186	7	47	80	0.5875000
NODE_59920_length_438_cov_4.622419	135	184	0	49	49	1.0000000
NODE_59936_length_438_cov_3.651917	86	166	0	80	80	1.0000000
NODE_59936_length_438_cov_3.651917	139	219	0	80	80	1.0000000
NODE_59952_length_438_cov_3.109145	215	273	0	1	58	0.0172414
NODE_59952_length_438_cov_3.109145	215	273	2	57	58	0.9827586
NODE_59957_length_438_cov_3.005900	175	258	0	70	83	0.8433735
NODE_59957_length_438_cov_3.005900	175	258	4	13	83	0.1566265
NODE_60317_length_437_cov_57.260355	272	352	0	80	80	1.0000000
NODE_60317_length_437_cov_57.260355	325	405	0	80	80	1.0000000
NODE_60318_length_437_cov_40.964497	0	73	0	73	73	1.0000000
NODE_60318_length_437_cov_40.964497	46	126	0	80	80	1.0000000
NODE_60319_length_437_cov_30.843195	140	220	0	80	80	1.0000000
NODE_60319_length_437_cov_30.843195	193	273	0	80	80	1.0000000
NODE_60320_length_437_cov_14.736686	164	244	0	80	80	1.0000000
NODE_60320_length_437_cov_14.736686	217	297	0	80	80	1.0000000
NODE_60331_length_437_cov_6.032544	249	320	0	71	71	1.0000000
NODE_60332_length_437_cov_6.020710	272	352	0	80	80	1.0000000
NODE_60332_length_437_cov_6.020710	325	405	0	80	80	1.0000000
NODE_60336_length_437_cov_5.526627	129	209	0	76	80	0.9500000
NODE_60336_length_437_cov_5.526627	129	209	2	4	80	0.0500000
NODE_60336_length_437_cov_5.526627	182	262	0	23	80	0.2875000
NODE_60336_length_437_cov_5.526627	182	262	2	32	80	0.4000000
NODE_60336_length_437_cov_5.526627	182	262	4	25	80	0.3125000
NODE_60348_length_437_cov_4.505917	247	327	0	80	80	1.0000000
NODE_60361_length_437_cov_3.470414	204	259	0	55	55	1.0000000
NODE_60369_length_437_cov_3.301775	95	149	0	54	54	1.0000000
NODE_60381_length_437_cov_2.911243	91	171	0	1	80	0.0125000
NODE_60381_length_437_cov_2.911243	91	171	1	2	80	0.0250000
NODE_60381_length_437_cov_2.911243	91	171	3	1	80	0.0125000
NODE_60381_length_437_cov_2.911243	91	171	5	11	80	0.1375000
NODE_60381_length_437_cov_2.911243	91	171	6	4	80	0.0500000
NODE_60381_length_437_cov_2.911243	91	171	7	12	80	0.1500000
NODE_60381_length_437_cov_2.911243	91	171	9	15	80	0.1875000
NODE_60381_length_437_cov_2.911243	91	171	11	8	80	0.1000000
NODE_60381_length_437_cov_2.911243	91	171	13	14	80	0.1750000
NODE_60381_length_437_cov_2.911243	91	171	15	12	80	0.1500000
NODE_60400_length_437_cov_2.650888	190	239	0	20	49	0.4081633
NODE_60400_length_437_cov_2.650888	190	239	2	29	49	0.5918368
NODE_60400_length_437_cov_2.650888	212	292	2	80	80	1.0000000
NODE_60411_length_437_cov_2.514793	292	333	1	7	41	0.1707317
NODE_60411_length_437_cov_2.514793	292	333	2	34	41	0.8292683
NODE_60509_length_437_cov_1.473373	252	324	0	72	72	1.0000000
NODE_60709_length_436_cov_125.940653	204	284	9	17	80	0.2125000
NODE_60709_length_436_cov_125.940653	204	284	11	44	80	0.5500000
NODE_60709_length_436_cov_125.940653	204	284	12	1	80	0.0125000
NODE_60709_length_436_cov_125.940653	204	284	13	11	80	0.1375000
NODE_60709_length_436_cov_125.940653	204	284	15	1	80	0.0125000
NODE_60709_length_436_cov_125.940653	204	284	17	6	80	0.0750000
NODE_60709_length_436_cov_125.940653	255	301	11	22	46	0.4782609
NODE_60709_length_436_cov_125.940653	255	301	12	1	46	0.0217391
NODE_60709_length_436_cov_125.940653	255	301	13	23	46	0.5000000
NODE_60709_length_436_cov_125.940653	257	337	2	1	80	0.0125000
NODE_60709_length_436_cov_125.940653	257	337	4	9	80	0.1125000
NODE_60709_length_436_cov_125.940653	257	337	6	5	80	0.0625000
NODE_60709_length_436_cov_125.940653	257	337	8	14	80	0.1750000
NODE_60709_length_436_cov_125.940653	257	337	9	3	80	0.0375000
NODE_60709_length_436_cov_125.940653	257	337	11	20	80	0.2500000
NODE_60709_length_436_cov_125.940653	257	337	12	1	80	0.0125000
NODE_60709_length_436_cov_125.940653	257	337	13	27	80	0.3375000
NODE_60709_length_436_cov_125.940653	333	413	2	77	80	0.9625000
NODE_60709_length_436_cov_125.940653	333	413	4	3	80	0.0375000
NODE_60709_length_436_cov_125.940653	386	436	0	8	50	0.1600000
NODE_60709_length_436_cov_125.940653	386	436	1	1	50	0.0200000
NODE_60709_length_436_cov_125.940653	386	436	2	41	50	0.8200000
NODE_60712_length_436_cov_45.459941	166	246	0	80	80	1.0000000
NODE_60712_length_436_cov_45.459941	219	299	0	80	80	1.0000000
NODE_60712_length_436_cov_45.459941	295	375	0	80	80	1.0000000
NODE_60712_length_436_cov_45.459941	348	428	0	80	80	1.0000000
NODE_60713_length_436_cov_10.560831	74	154	0	80	80	1.0000000
NODE_60713_length_436_cov_10.560831	127	207	0	80	80	1.0000000
NODE_60716_length_436_cov_8.317507	51	127	0	76	76	1.0000000
NODE_60716_length_436_cov_8.317507	104	182	0	78	78	1.0000000
NODE_60760_length_436_cov_3.109792	153	205	0	52	52	1.0000000
NODE_60786_length_436_cov_2.551929	182	258	5	7	76	0.0921053
NODE_60786_length_436_cov_2.551929	182	258	8	52	76	0.6842105
NODE_60786_length_436_cov_2.551929	182	258	10	17	76	0.2236842
NODE_60786_length_436_cov_2.551929	235	315	4	15	80	0.1875000
NODE_60786_length_436_cov_2.551929	235	315	6	5	80	0.0625000
NODE_60786_length_436_cov_2.551929	235	315	8	6	80	0.0750000
NODE_60786_length_436_cov_2.551929	235	315	10	54	80	0.6750000
NODE_60934_length_436_cov_1.207715	105	181	0	43	76	0.5657895
NODE_60934_length_436_cov_1.207715	105	181	2	33	76	0.4342105
NODE_61088_length_435_cov_17.401786	55	135	0	31	80	0.3875000
NODE_61088_length_435_cov_17.401786	55	135	2	49	80	0.6125000
NODE_61088_length_435_cov_17.401786	108	188	2	80	80	1.0000000
NODE_61094_length_435_cov_6.910714	113	193	12	34	80	0.4250000
NODE_61094_length_435_cov_6.910714	113	193	14	46	80	0.5750000
NODE_61094_length_435_cov_6.910714	147	194	12	2	47	0.0425532
NODE_61094_length_435_cov_6.910714	147	194	14	45	47	0.9574468
NODE_61094_length_435_cov_6.910714	149	184	14	35	35	1.0000000
NODE_61094_length_435_cov_6.910714	151	193	14	42	42	1.0000000
NODE_61094_length_435_cov_6.910714	166	251	0	3	85	0.0352941
NODE_61094_length_435_cov_6.910714	166	251	6	35	85	0.4117647
NODE_61094_length_435_cov_6.910714	166	251	8	10	85	0.1176471
NODE_61094_length_435_cov_6.910714	166	251	10	9	85	0.1058824
NODE_61094_length_435_cov_6.910714	166	251	14	28	85	0.3294118
NODE_61094_length_435_cov_6.910714	167	251	0	3	84	0.0357143
NODE_61094_length_435_cov_6.910714	167	251	6	35	84	0.4166667
NODE_61094_length_435_cov_6.910714	167	251	8	10	84	0.1190476
NODE_61094_length_435_cov_6.910714	167	251	10	9	84	0.1071429
NODE_61094_length_435_cov_6.910714	167	251	14	27	84	0.3214286
NODE_61102_length_435_cov_5.630952	159	217	0	58	58	1.0000000
NODE_61102_length_435_cov_5.630952	190	270	0	80	80	1.0000000
NODE_61112_length_435_cov_4.601190	271	309	0	34	38	0.8947368
NODE_61112_length_435_cov_4.601190	271	309	2	4	38	0.1052632
NODE_61112_length_435_cov_4.601190	282	344	0	23	62	0.3709677
NODE_61112_length_435_cov_4.601190	282	344	2	33	62	0.5322581
NODE_61112_length_435_cov_4.601190	282	344	4	6	62	0.0967742
NODE_61122_length_435_cov_3.770833	209	240	0	31	31	1.0000000
NODE_61137_length_435_cov_2.836310	113	194	4	1	81	0.0123457
NODE_61137_length_435_cov_2.836310	113	194	6	3	81	0.0370370
NODE_61137_length_435_cov_2.836310	113	194	7	20	81	0.2469136
NODE_61137_length_435_cov_2.836310	113	194	8	20	81	0.2469136
NODE_61137_length_435_cov_2.836310	113	194	9	1	81	0.0123457
NODE_61137_length_435_cov_2.836310	113	194	10	36	81	0.4444444
NODE_61357_length_435_cov_0.988095	286	322	0	36	36	1.0000000
NODE_61451_length_434_cov_136.483582	0	58	21	1	58	0.0172414
NODE_61451_length_434_cov_136.483582	0	58	24	1	58	0.0172414
NODE_61451_length_434_cov_136.483582	0	58	31	1	58	0.0172414
NODE_61451_length_434_cov_136.483582	0	58	40	2	58	0.0344828
NODE_61451_length_434_cov_136.483582	0	58	43	1	58	0.0172414
NODE_61451_length_434_cov_136.483582	0	58	49	1	58	0.0172414
NODE_61451_length_434_cov_136.483582	0	58	51	1	58	0.0172414
NODE_61451_length_434_cov_136.483582	0	58	60	1	58	0.0172414
NODE_61451_length_434_cov_136.483582	0	58	64	1	58	0.0172414
NODE_61451_length_434_cov_136.483582	0	58	68	1	58	0.0172414
NODE_61451_length_434_cov_136.483582	0	58	79	1	58	0.0172414
NODE_61451_length_434_cov_136.483582	0	58	81	1	58	0.0172414
NODE_61451_length_434_cov_136.483582	0	58	85	1	58	0.0172414
NODE_61451_length_434_cov_136.483582	0	58	86	1	58	0.0172414
NODE_61451_length_434_cov_136.483582	0	58	89	1	58	0.0172414
NODE_61451_length_434_cov_136.483582	0	58	95	1	58	0.0172414
NODE_61451_length_434_cov_136.483582	0	58	102	1	58	0.0172414
NODE_61451_length_434_cov_136.483582	0	58	105	2	58	0.0344828
NODE_61451_length_434_cov_136.483582	0	58	108	1	58	0.0172414
NODE_61451_length_434_cov_136.483582	0	58	114	1	58	0.0172414
NODE_61451_length_434_cov_136.483582	0	58	116	1	58	0.0172414
NODE_61451_length_434_cov_136.483582	0	58	122	1	58	0.0172414
NODE_61451_length_434_cov_136.483582	0	58	126	3	58	0.0517241
NODE_61451_length_434_cov_136.483582	0	58	130	1	58	0.0172414
NODE_61451_length_434_cov_136.483582	0	58	137	1	58	0.0172414
NODE_61451_length_434_cov_136.483582	0	58	147	3	58	0.0517241
NODE_61451_length_434_cov_136.483582	0	58	149	1	58	0.0172414
NODE_61451_length_434_cov_136.483582	0	58	151	2	58	0.0344828
NODE_61451_length_434_cov_136.483582	0	58	153	5	58	0.0862069
NODE_61451_length_434_cov_136.483582	0	58	155	2	58	0.0344828
NODE_61451_length_434_cov_136.483582	0	58	158	1	58	0.0172414
NODE_61451_length_434_cov_136.483582	0	58	160	2	58	0.0344828
NODE_61451_length_434_cov_136.483582	0	58	163	1	58	0.0172414
NODE_61451_length_434_cov_136.483582	0	58	164	6	58	0.1034483
NODE_61451_length_434_cov_136.483582	0	58	165	1	58	0.0172414
NODE_61451_length_434_cov_136.483582	0	58	171	1	58	0.0172414
NODE_61451_length_434_cov_136.483582	0	58	172	3	58	0.0517241
NODE_61451_length_434_cov_136.483582	0	58	173	1	58	0.0172414
NODE_61451_length_434_cov_136.483582	31	111	147	1	80	0.0125000
NODE_61451_length_434_cov_136.483582	31	111	149	1	80	0.0125000
NODE_61451_length_434_cov_136.483582	31	111	151	2	80	0.0250000
NODE_61451_length_434_cov_136.483582	31	111	153	5	80	0.0625000
NODE_61451_length_434_cov_136.483582	31	111	155	2	80	0.0250000
NODE_61451_length_434_cov_136.483582	31	111	158	1	80	0.0125000
NODE_61451_length_434_cov_136.483582	31	111	160	2	80	0.0250000
NODE_61451_length_434_cov_136.483582	31	111	163	1	80	0.0125000
NODE_61451_length_434_cov_136.483582	31	111	164	6	80	0.0750000
NODE_61451_length_434_cov_136.483582	31	111	165	1	80	0.0125000
NODE_61451_length_434_cov_136.483582	31	111	171	1	80	0.0125000
NODE_61451_length_434_cov_136.483582	31	111	172	3	80	0.0375000
NODE_61451_length_434_cov_136.483582	31	111	173	2	80	0.0250000
NODE_61451_length_434_cov_136.483582	31	111	180	2	80	0.0250000
NODE_61451_length_434_cov_136.483582	31	111	182	4	80	0.0500000
NODE_61451_length_434_cov_136.483582	31	111	184	1	80	0.0125000
NODE_61451_length_434_cov_136.483582	31	111	188	11	80	0.1375000
NODE_61451_length_434_cov_136.483582	31	111	193	14	80	0.1750000
NODE_61451_length_434_cov_136.483582	31	111	194	1	80	0.0125000
NODE_61451_length_434_cov_136.483582	31	111	195	2	80	0.0250000
NODE_61451_length_434_cov_136.483582	31	111	196	1	80	0.0125000
NODE_61451_length_434_cov_136.483582	31	111	198	1	80	0.0125000
NODE_61451_length_434_cov_136.483582	31	111	199	2	80	0.0250000
NODE_61451_length_434_cov_136.483582	31	111	201	1	80	0.0125000
NODE_61451_length_434_cov_136.483582	31	111	203	3	80	0.0375000
NODE_61451_length_434_cov_136.483582	31	111	204	4	80	0.0500000
NODE_61451_length_434_cov_136.483582	31	111	205	4	80	0.0500000
NODE_61451_length_434_cov_136.483582	31	111	206	1	80	0.0125000
NODE_61452_length_434_cov_43.214925	291	366	6	10	75	0.1333333
NODE_61452_length_434_cov_43.214925	291	366	8	19	75	0.2533333
NODE_61452_length_434_cov_43.214925	291	366	10	9	75	0.1200000
NODE_61452_length_434_cov_43.214925	291	366	11	2	75	0.0266667
NODE_61452_length_434_cov_43.214925	291	366	12	35	75	0.4666667
NODE_61452_length_434_cov_43.214925	344	424	0	19	80	0.2375000
NODE_61452_length_434_cov_43.214925	344	424	3	1	80	0.0125000
NODE_61452_length_434_cov_43.214925	344	424	4	20	80	0.2500000
NODE_61452_length_434_cov_43.214925	344	424	6	28	80	0.3500000
NODE_61452_length_434_cov_43.214925	344	424	8	7	80	0.0875000
NODE_61452_length_434_cov_43.214925	344	424	10	5	80	0.0625000
NODE_61452_length_434_cov_43.214925	344	424	0	19	80	0.2375000
NODE_61452_length_434_cov_43.214925	344	424	3	1	80	0.0125000
NODE_61452_length_434_cov_43.214925	344	424	4	20	80	0.2500000
NODE_61452_length_434_cov_43.214925	344	424	6	28	80	0.3500000
NODE_61452_length_434_cov_43.214925	344	424	8	7	80	0.0875000
NODE_61452_length_434_cov_43.214925	344	424	10	5	80	0.0625000
NODE_61453_length_434_cov_22.373134	80	160	0	40	80	0.5000000
NODE_61453_length_434_cov_22.373134	80	160	6	40	80	0.5000000
NODE_61453_length_434_cov_22.373134	133	213	0	80	80	1.0000000
NODE_61455_length_434_cov_11.549254	74	145	0	71	71	1.0000000
NODE_61455_length_434_cov_11.549254	118	198	0	80	80	1.0000000
NODE_61477_length_434_cov_4.125373	191	233	0	3	42	0.0714286
NODE_61477_length_434_cov_4.125373	191	233	2	39	42	0.9285714
NODE_61477_length_434_cov_4.125373	200	235	0	5	35	0.1428571
NODE_61477_length_434_cov_4.125373	200	235	2	30	35	0.8571429
NODE_61497_length_434_cov_3.104478	191	263	0	17	72	0.2361111
NODE_61497_length_434_cov_3.104478	191	263	2	55	72	0.7638889
NODE_61528_length_434_cov_2.197015	129	168	0	39	39	1.0000000
NODE_61563_length_434_cov_1.883582	88	133	0	11	45	0.2444444
NODE_61563_length_434_cov_1.883582	88	133	2	34	45	0.7555556
NODE_61563_length_434_cov_1.883582	141	182	2	41	41	1.0000000
NODE_61603_length_434_cov_1.626866	163	243	8	3	80	0.0375000
NODE_61603_length_434_cov_1.626866	163	243	10	57	80	0.7125000
NODE_61603_length_434_cov_1.626866	163	243	12	20	80	0.2500000
NODE_61676_length_434_cov_1.220896	118	198	204	3	80	0.0375000
NODE_61676_length_434_cov_1.220896	118	198	208	1	80	0.0125000
NODE_61676_length_434_cov_1.220896	118	198	209	2	80	0.0250000
NODE_61676_length_434_cov_1.220896	118	198	212	1	80	0.0125000
NODE_61676_length_434_cov_1.220896	118	198	214	1	80	0.0125000
NODE_61676_length_434_cov_1.220896	118	198	219	1	80	0.0125000
NODE_61676_length_434_cov_1.220896	118	198	220	1	80	0.0125000
NODE_61676_length_434_cov_1.220896	118	198	228	1	80	0.0125000
NODE_61676_length_434_cov_1.220896	118	198	230	2	80	0.0250000
NODE_61676_length_434_cov_1.220896	118	198	232	1	80	0.0125000
NODE_61676_length_434_cov_1.220896	118	198	234	1	80	0.0125000
NODE_61676_length_434_cov_1.220896	118	198	239	1	80	0.0125000
NODE_61676_length_434_cov_1.220896	118	198	243	1	80	0.0125000
NODE_61676_length_434_cov_1.220896	118	198	247	1	80	0.0125000
NODE_61676_length_434_cov_1.220896	118	198	249	1	80	0.0125000
NODE_61676_length_434_cov_1.220896	118	198	250	2	80	0.0250000
NODE_61676_length_434_cov_1.220896	118	198	254	1	80	0.0125000
NODE_61676_length_434_cov_1.220896	118	198	256	2	80	0.0250000
NODE_61676_length_434_cov_1.220896	118	198	262	1	80	0.0125000
NODE_61676_length_434_cov_1.220896	118	198	264	1	80	0.0125000
NODE_61676_length_434_cov_1.220896	118	198	266	1	80	0.0125000
NODE_61676_length_434_cov_1.220896	118	198	271	1	80	0.0125000
NODE_61676_length_434_cov_1.220896	118	198	272	1	80	0.0125000
NODE_61676_length_434_cov_1.220896	118	198	280	1	80	0.0125000
NODE_61676_length_434_cov_1.220896	118	198	283	1	80	0.0125000
NODE_61676_length_434_cov_1.220896	118	198	291	1	80	0.0125000
NODE_61676_length_434_cov_1.220896	118	198	293	1	80	0.0125000
NODE_61676_length_434_cov_1.220896	118	198	295	1	80	0.0125000
NODE_61676_length_434_cov_1.220896	118	198	297	1	80	0.0125000
NODE_61676_length_434_cov_1.220896	118	198	298	5	80	0.0625000
NODE_61676_length_434_cov_1.220896	118	198	299	12	80	0.1500000
NODE_61676_length_434_cov_1.220896	118	198	301	9	80	0.1125000
NODE_61676_length_434_cov_1.220896	118	198	302	2	80	0.0250000
NODE_61676_length_434_cov_1.220896	118	198	303	6	80	0.0750000
NODE_61676_length_434_cov_1.220896	118	198	305	2	80	0.0250000
NODE_61676_length_434_cov_1.220896	118	198	306	3	80	0.0375000
NODE_61676_length_434_cov_1.220896	118	198	307	2	80	0.0250000
NODE_61676_length_434_cov_1.220896	118	198	308	1	80	0.0125000
NODE_61676_length_434_cov_1.220896	118	198	309	3	80	0.0375000
NODE_61727_length_434_cov_1.002985	245	286	4	26	41	0.6341463
NODE_61727_length_434_cov_1.002985	245	286	6	8	41	0.1951219
NODE_61727_length_434_cov_1.002985	245	286	10	7	41	0.1707317
NODE_61727_length_434_cov_1.002985	258	339	4	14	81	0.1728395
NODE_61727_length_434_cov_1.002985	258	339	6	19	81	0.2345679
NODE_61727_length_434_cov_1.002985	258	339	8	10	81	0.1234568
NODE_61727_length_434_cov_1.002985	258	339	10	38	81	0.4691358
NODE_61826_length_433_cov_51.392216	2	82	0	80	80	1.0000000
NODE_61826_length_433_cov_51.392216	55	135	0	80	80	1.0000000
NODE_61826_length_433_cov_51.392216	131	213	0	82	82	1.0000000
NODE_61826_length_433_cov_51.392216	189	266	0	77	77	1.0000000
NODE_61827_length_433_cov_46.344311	248	328	0	80	80	1.0000000
NODE_61827_length_433_cov_46.344311	301	381	0	80	80	1.0000000
NODE_61828_length_433_cov_41.808383	92	172	0	26	80	0.3250000
NODE_61828_length_433_cov_41.808383	92	172	2	54	80	0.6750000
NODE_61828_length_433_cov_41.808383	145	225	2	80	80	1.0000000
NODE_61835_length_433_cov_6.227545	157	237	0	80	80	1.0000000
NODE_61836_length_433_cov_6.080838	164	244	0	80	80	1.0000000
NODE_61838_length_433_cov_5.547904	10	80	2	4	70	0.0571429
NODE_61838_length_433_cov_5.547904	10	80	4	8	70	0.1142857
NODE_61838_length_433_cov_5.547904	10	80	6	7	70	0.1000000
NODE_61838_length_433_cov_5.547904	10	80	8	33	70	0.4714286
NODE_61838_length_433_cov_5.547904	10	80	10	18	70	0.2571429
NODE_61838_length_433_cov_5.547904	51	133	4	1	82	0.0121951
NODE_61838_length_433_cov_5.547904	51	133	6	23	82	0.2804878
NODE_61838_length_433_cov_5.547904	51	133	8	15	82	0.1829268
NODE_61838_length_433_cov_5.547904	51	133	10	43	82	0.5243902
NODE_61839_length_433_cov_5.476048	81	141	0	60	60	1.0000000
NODE_61855_length_433_cov_3.907186	77	107	0	30	30	1.0000000
NODE_61862_length_433_cov_3.595808	231	316	0	4	85	0.0470588
NODE_61862_length_433_cov_3.595808	231	316	2	3	85	0.0352941
NODE_61862_length_433_cov_3.595808	231	316	4	49	85	0.5764706
NODE_61862_length_433_cov_3.595808	231	316	6	6	85	0.0705882
NODE_61862_length_433_cov_3.595808	231	316	8	23	85	0.2705882
NODE_61864_length_433_cov_3.526946	107	178	6	71	71	1.0000000
NODE_61931_length_433_cov_2.137725	123	203	0	80	80	1.0000000
NODE_62258_length_432_cov_17.540541	150	230	0	80	80	1.0000000
NODE_62258_length_432_cov_17.540541	203	288	0	85	85	1.0000000
NODE_62264_length_432_cov_6.555556	52	82	0	30	30	1.0000000
NODE_62268_length_432_cov_5.720721	77	157	0	80	80	1.0000000
NODE_62268_length_432_cov_5.720721	130	202	0	72	72	1.0000000
NODE_62269_length_432_cov_5.387387	65	95	0	30	30	1.0000000
NODE_62270_length_432_cov_5.345345	271	324	0	53	53	1.0000000
NODE_62293_length_432_cov_3.678679	78	121	0	43	43	1.0000000
NODE_62304_length_432_cov_3.246246	87	128	6	22	41	0.5365854
NODE_62304_length_432_cov_3.246246	87	128	8	2	41	0.0487805
NODE_62304_length_432_cov_3.246246	87	128	10	17	41	0.4146341
NODE_62304_length_432_cov_3.246246	101	167	6	8	66	0.1212121
NODE_62304_length_432_cov_3.246246	101	167	8	2	66	0.0303030
NODE_62304_length_432_cov_3.246246	101	167	10	25	66	0.3787879
NODE_62304_length_432_cov_3.246246	101	167	14	3	66	0.0454545
NODE_62304_length_432_cov_3.246246	101	167	16	28	66	0.4242424
NODE_62396_length_432_cov_1.762763	4	71	0	67	67	1.0000000
NODE_62544_length_432_cov_1.027027	44	68	0	24	24	1.0000000
NODE_62650_length_431_cov_35.355422	202	284	0	82	82	1.0000000
NODE_62650_length_431_cov_35.355422	257	333	0	76	76	1.0000000
NODE_62652_length_431_cov_11.207831	185	265	0	80	80	1.0000000
NODE_62652_length_431_cov_11.207831	238	318	0	80	80	1.0000000
NODE_62657_length_431_cov_7.018072	110	190	0	52	80	0.6500000
NODE_62657_length_431_cov_7.018072	110	190	2	28	80	0.3500000
NODE_62657_length_431_cov_7.018072	163	243	0	80	80	1.0000000
NODE_62661_length_431_cov_6.292169	123	203	0	80	80	1.0000000
NODE_62668_length_431_cov_5.608434	170	241	0	71	71	1.0000000
NODE_62681_length_431_cov_4.250000	146	216	4	13	70	0.1857143
NODE_62681_length_431_cov_4.250000	146	216	8	57	70	0.8142857
NODE_62684_length_431_cov_3.993976	210	290	0	80	80	1.0000000
NODE_62794_length_431_cov_1.695783	76	156	9	21	80	0.2625000
NODE_62794_length_431_cov_1.695783	76	156	11	5	80	0.0625000
NODE_62794_length_431_cov_1.695783	76	156	13	6	80	0.0750000
NODE_62794_length_431_cov_1.695783	76	156	15	11	80	0.1375000
NODE_62794_length_431_cov_1.695783	76	156	16	7	80	0.0875000
NODE_62794_length_431_cov_1.695783	76	156	17	18	80	0.2250000
NODE_62794_length_431_cov_1.695783	76	156	18	7	80	0.0875000
NODE_62794_length_431_cov_1.695783	76	156	19	2	80	0.0250000
NODE_62794_length_431_cov_1.695783	76	156	20	1	80	0.0125000
NODE_62794_length_431_cov_1.695783	76	156	21	2	80	0.0250000
NODE_62794_length_431_cov_1.695783	129	199	16	7	70	0.1000000
NODE_62794_length_431_cov_1.695783	129	199	17	8	70	0.1142857
NODE_62794_length_431_cov_1.695783	129	199	18	7	70	0.1000000
NODE_62794_length_431_cov_1.695783	129	199	19	2	70	0.0285714
NODE_62794_length_431_cov_1.695783	129	199	20	1	70	0.0142857
NODE_62794_length_431_cov_1.695783	129	199	21	7	70	0.1000000
NODE_62794_length_431_cov_1.695783	129	199	22	2	70	0.0285714
NODE_62794_length_431_cov_1.695783	129	199	23	26	70	0.3714286
NODE_62794_length_431_cov_1.695783	129	199	24	2	70	0.0285714
NODE_62794_length_431_cov_1.695783	129	199	25	4	70	0.0571429
NODE_62794_length_431_cov_1.695783	129	199	26	4	70	0.0571429
NODE_63043_length_430_cov_49.791541	319	399	74	2	80	0.0250000
NODE_63043_length_430_cov_49.791541	319	399	75	4	80	0.0500000
NODE_63043_length_430_cov_49.791541	319	399	77	3	80	0.0375000
NODE_63043_length_430_cov_49.791541	319	399	78	4	80	0.0500000
NODE_63043_length_430_cov_49.791541	319	399	84	1	80	0.0125000
NODE_63043_length_430_cov_49.791541	319	399	88	1	80	0.0125000
NODE_63043_length_430_cov_49.791541	319	399	94	1	80	0.0125000
NODE_63043_length_430_cov_49.791541	319	399	96	3	80	0.0375000
NODE_63043_length_430_cov_49.791541	319	399	100	7	80	0.0875000
NODE_63043_length_430_cov_49.791541	319	399	102	1	80	0.0125000
NODE_63043_length_430_cov_49.791541	319	399	104	1	80	0.0125000
NODE_63043_length_430_cov_49.791541	319	399	105	2	80	0.0250000
NODE_63043_length_430_cov_49.791541	319	399	106	3	80	0.0375000
NODE_63043_length_430_cov_49.791541	319	399	108	6	80	0.0750000
NODE_63043_length_430_cov_49.791541	319	399	110	2	80	0.0250000
NODE_63043_length_430_cov_49.791541	319	399	112	2	80	0.0250000
NODE_63043_length_430_cov_49.791541	319	399	113	1	80	0.0125000
NODE_63043_length_430_cov_49.791541	319	399	117	1	80	0.0125000
NODE_63043_length_430_cov_49.791541	319	399	118	4	80	0.0500000
NODE_63043_length_430_cov_49.791541	319	399	121	1	80	0.0125000
NODE_63043_length_430_cov_49.791541	319	399	128	4	80	0.0500000
NODE_63043_length_430_cov_49.791541	319	399	132	1	80	0.0125000
NODE_63043_length_430_cov_49.791541	319	399	134	1	80	0.0125000
NODE_63043_length_430_cov_49.791541	319	399	138	2	80	0.0250000
NODE_63043_length_430_cov_49.791541	319	399	140	1	80	0.0125000
NODE_63043_length_430_cov_49.791541	319	399	142	1	80	0.0125000
NODE_63043_length_430_cov_49.791541	319	399	143	2	80	0.0250000
NODE_63043_length_430_cov_49.791541	319	399	145	2	80	0.0250000
NODE_63043_length_430_cov_49.791541	319	399	147	4	80	0.0500000
NODE_63043_length_430_cov_49.791541	319	399	152	1	80	0.0125000
NODE_63043_length_430_cov_49.791541	319	399	154	1	80	0.0125000
NODE_63043_length_430_cov_49.791541	319	399	155	3	80	0.0375000
NODE_63043_length_430_cov_49.791541	319	399	156	1	80	0.0125000
NODE_63043_length_430_cov_49.791541	319	399	157	5	80	0.0625000
NODE_63043_length_430_cov_49.791541	319	399	158	1	80	0.0125000
NODE_63043_length_430_cov_49.791541	372	430	12	2	58	0.0344828
NODE_63043_length_430_cov_49.791541	372	430	23	1	58	0.0172414
NODE_63043_length_430_cov_49.791541	372	430	25	2	58	0.0344828
NODE_63043_length_430_cov_49.791541	372	430	29	1	58	0.0172414
NODE_63043_length_430_cov_49.791541	372	430	33	2	58	0.0344828
NODE_63043_length_430_cov_49.791541	372	430	45	2	58	0.0344828
NODE_63043_length_430_cov_49.791541	372	430	46	1	58	0.0172414
NODE_63043_length_430_cov_49.791541	372	430	50	1	58	0.0172414
NODE_63043_length_430_cov_49.791541	372	430	52	1	58	0.0172414
NODE_63043_length_430_cov_49.791541	372	430	54	1	58	0.0172414
NODE_63043_length_430_cov_49.791541	372	430	56	2	58	0.0344828
NODE_63043_length_430_cov_49.791541	372	430	57	2	58	0.0344828
NODE_63043_length_430_cov_49.791541	372	430	59	3	58	0.0517241
NODE_63043_length_430_cov_49.791541	372	430	60	2	58	0.0344828
NODE_63043_length_430_cov_49.791541	372	430	70	5	58	0.0862069
NODE_63043_length_430_cov_49.791541	372	430	72	3	58	0.0517241
NODE_63043_length_430_cov_49.791541	372	430	74	2	58	0.0344828
NODE_63043_length_430_cov_49.791541	372	430	75	4	58	0.0689655
NODE_63043_length_430_cov_49.791541	372	430	77	3	58	0.0517241
NODE_63043_length_430_cov_49.791541	372	430	78	4	58	0.0689655
NODE_63043_length_430_cov_49.791541	372	430	84	1	58	0.0172414
NODE_63043_length_430_cov_49.791541	372	430	88	1	58	0.0172414
NODE_63043_length_430_cov_49.791541	372	430	94	1	58	0.0172414
NODE_63043_length_430_cov_49.791541	372	430	96	3	58	0.0517241
NODE_63043_length_430_cov_49.791541	372	430	100	7	58	0.1206897
NODE_63043_length_430_cov_49.791541	372	430	102	1	58	0.0172414
NODE_63044_length_430_cov_44.365559	109	189	0	80	80	1.0000000
NODE_63044_length_430_cov_44.365559	162	242	0	80	80	1.0000000
NODE_63045_length_430_cov_16.746224	92	172	0	80	80	1.0000000
NODE_63045_length_430_cov_16.746224	145	225	0	80	80	1.0000000
NODE_63048_length_430_cov_7.737160	180	263	0	83	83	1.0000000
NODE_63050_length_430_cov_6.163142	135	197	0	62	62	1.0000000
NODE_63051_length_430_cov_5.873112	7	90	0	83	83	1.0000000
NODE_63051_length_430_cov_5.873112	60	126	0	36	66	0.5454546
NODE_63051_length_430_cov_5.873112	60	126	2	15	66	0.2272727
NODE_63051_length_430_cov_5.873112	60	126	5	15	66	0.2272727
NODE_63066_length_430_cov_4.323263	18	90	0	72	72	1.0000000
NODE_63161_length_430_cov_1.945619	153	233	0	80	80	1.0000000
NODE_63401_length_430_cov_0.664653	391	430	0	39	39	1.0000000
NODE_63437_length_429_cov_10.424242	78	158	0	80	80	1.0000000
NODE_63437_length_429_cov_10.424242	207	287	0	80	80	1.0000000
NODE_63437_length_429_cov_10.424242	260	340	0	80	80	1.0000000
NODE_63439_length_429_cov_8.957576	213	293	0	80	80	1.0000000
NODE_63439_length_429_cov_8.957576	266	346	0	80	80	1.0000000
NODE_63441_length_429_cov_6.772727	337	366	0	29	29	1.0000000
NODE_63485_length_429_cov_3.003030	173	251	4	14	78	0.1794872
NODE_63485_length_429_cov_3.003030	173	251	6	64	78	0.8205128
NODE_63516_length_429_cov_2.433333	220	300	2	3	80	0.0375000
NODE_63516_length_429_cov_2.433333	220	300	4	62	80	0.7750000
NODE_63516_length_429_cov_2.433333	220	300	6	15	80	0.1875000
NODE_63519_length_429_cov_2.360606	24	85	0	61	61	1.0000000
NODE_63527_length_429_cov_2.224242	115	195	0	13	80	0.1625000
NODE_63527_length_429_cov_2.224242	115	195	2	67	80	0.8375000
NODE_63547_length_429_cov_2.051515	114	143	2	29	29	1.0000000
NODE_63547_length_429_cov_2.051515	286	348	0	62	62	1.0000000
NODE_63864_length_428_cov_40.449848	217	297	0	80	80	1.0000000
NODE_63864_length_428_cov_40.449848	270	350	0	80	80	1.0000000
NODE_63864_length_428_cov_40.449848	346	426	0	80	80	1.0000000
NODE_63865_length_428_cov_31.066869	249	325	0	25	76	0.3289474
NODE_63865_length_428_cov_31.066869	249	325	2	34	76	0.4473684
NODE_63865_length_428_cov_31.066869	249	325	4	17	76	0.2236842
NODE_63865_length_428_cov_31.066869	297	378	2	11	81	0.1358025
NODE_63865_length_428_cov_31.066869	297	378	4	70	81	0.8641976
NODE_63866_length_428_cov_11.799392	62	142	0	80	80	1.0000000
NODE_63866_length_428_cov_11.799392	115	195	0	80	80	1.0000000
NODE_63867_length_428_cov_10.595745	227	307	0	80	80	1.0000000
NODE_63870_length_428_cov_6.784195	344	374	0	30	30	1.0000000
NODE_63871_length_428_cov_6.768997	131	194	4	63	63	1.0000000
NODE_63895_length_428_cov_4.206687	224	304	0	29	80	0.3625000
NODE_63895_length_428_cov_4.206687	224	304	2	51	80	0.6375000
NODE_63905_length_428_cov_3.525836	168	236	0	68	68	1.0000000
NODE_63905_length_428_cov_3.525836	209	244	0	35	35	1.0000000
NODE_63959_length_428_cov_2.322188	1	42	0	41	41	1.0000000
NODE_63977_length_428_cov_2.124620	228	308	0	80	80	1.0000000
NODE_64011_length_428_cov_1.848024	178	260	0	82	82	1.0000000
NODE_64027_length_428_cov_1.772036	187	255	0	68	68	1.0000000
NODE_64245_length_428_cov_0.790274	275	308	0	33	33	1.0000000
NODE_64245_length_428_cov_0.790274	276	302	0	26	26	1.0000000
NODE_64310_length_427_cov_29.628049	312	392	0	80	80	1.0000000
NODE_64310_length_427_cov_29.628049	365	427	0	62	62	1.0000000
NODE_64310_length_427_cov_29.628049	365	427	0	62	62	1.0000000
NODE_64312_length_427_cov_9.371951	184	239	0	4	55	0.0727273
NODE_64312_length_427_cov_9.371951	184	239	2	51	55	0.9272727
NODE_64313_length_427_cov_9.359756	11	82	0	71	71	1.0000000
NODE_64313_length_427_cov_9.359756	70	149	0	79	79	1.0000000
NODE_64313_length_427_cov_9.359756	145	225	0	80	80	1.0000000
NODE_64313_length_427_cov_9.359756	198	278	0	80	80	1.0000000
NODE_64321_length_427_cov_5.929878	405	424	0	19	19	1.0000000
NODE_64324_length_427_cov_5.088415	257	332	0	75	75	1.0000000
NODE_64345_length_427_cov_3.884146	212	260	2	19	48	0.3958333
NODE_64345_length_427_cov_3.884146	212	260	3	10	48	0.2083333
NODE_64345_length_427_cov_3.884146	212	260	4	19	48	0.3958333
NODE_64383_length_427_cov_2.765244	312	363	0	51	51	1.0000000
NODE_64409_length_427_cov_2.362805	142	177	0	35	35	1.0000000
NODE_64537_length_427_cov_1.359756	56	139	2	83	83	1.0000000
NODE_64728_length_426_cov_21.837920	178	258	0	80	80	1.0000000
NODE_64729_length_426_cov_16.850153	76	156	2	32	80	0.4000000
NODE_64729_length_426_cov_16.850153	76	156	3	48	80	0.6000000
NODE_64729_length_426_cov_16.850153	129	209	1	15	80	0.1875000
NODE_64729_length_426_cov_16.850153	129	209	2	18	80	0.2250000
NODE_64729_length_426_cov_16.850153	129	209	3	47	80	0.5875000
NODE_64731_length_426_cov_9.033639	152	232	0	80	80	1.0000000
NODE_64731_length_426_cov_9.033639	205	285	0	80	80	1.0000000
NODE_64734_length_426_cov_8.314985	133	213	0	80	80	1.0000000
NODE_64734_length_426_cov_8.314985	186	266	0	80	80	1.0000000
NODE_64735_length_426_cov_8.278287	132	212	0	80	80	1.0000000
NODE_64735_length_426_cov_8.278287	185	265	0	80	80	1.0000000
NODE_64752_length_426_cov_4.926606	116	196	0	80	80	1.0000000
NODE_64754_length_426_cov_4.743119	119	199	0	1	80	0.0125000
NODE_64754_length_426_cov_4.743119	119	199	2	79	80	0.9875000
NODE_64754_length_426_cov_4.743119	172	252	0	35	80	0.4375000
NODE_64754_length_426_cov_4.743119	172	252	2	45	80	0.5625000
NODE_64833_length_426_cov_2.278287	92	132	2	25	40	0.6250000
NODE_64833_length_426_cov_2.278287	92	132	4	15	40	0.3750000
NODE_64833_length_426_cov_2.278287	139	205	2	38	66	0.5757576
NODE_64833_length_426_cov_2.278287	139	205	4	28	66	0.4242424
NODE_64865_length_426_cov_1.896024	80	154	0	74	74	1.0000000
NODE_64948_length_426_cov_1.397554	240	290	0	50	50	1.0000000
NODE_65135_length_426_cov_0.602446	127	158	0	31	31	1.0000000
NODE_65152_length_425_cov_63.938650	0	61	0	61	61	1.0000000
NODE_65152_length_425_cov_63.938650	34	114	0	80	80	1.0000000
NODE_65164_length_425_cov_4.877301	171	229	12	58	58	1.0000000
NODE_65165_length_425_cov_4.822086	295	377	0	19	82	0.2317073
NODE_65165_length_425_cov_4.822086	295	377	2	19	82	0.2317073
NODE_65165_length_425_cov_4.822086	295	377	4	4	82	0.0487805
NODE_65165_length_425_cov_4.822086	295	377	10	40	82	0.4878049
NODE_65218_length_425_cov_2.809816	38	118	0	80	80	1.0000000
NODE_65278_length_425_cov_1.935583	93	138	0	15	45	0.3333333
NODE_65278_length_425_cov_1.935583	93	138	2	30	45	0.6666667
NODE_65278_length_425_cov_1.935583	170	225	4	17	55	0.3090909
NODE_65278_length_425_cov_1.935583	170	225	5	4	55	0.0727273
NODE_65278_length_425_cov_1.935583	170	225	6	34	55	0.6181818
NODE_65278_length_425_cov_1.935583	312	355	8	17	43	0.3953488
NODE_65278_length_425_cov_1.935583	312	355	9	2	43	0.0465116
NODE_65278_length_425_cov_1.935583	312	355	10	24	43	0.5581396
NODE_65565_length_425_cov_0.628834	104	131	2	27	27	1.0000000
NODE_65602_length_424_cov_5.295385	224	270	0	46	46	1.0000000
NODE_65634_length_424_cov_3.255385	266	329	4	63	63	1.0000000
NODE_65669_length_424_cov_2.578462	403	422	0	19	19	1.0000000
NODE_65670_length_424_cov_2.578462	122	144	0	22	22	1.0000000
NODE_66111_length_423_cov_2.728395	150	229	0	29	79	0.3670886
NODE_66111_length_423_cov_2.728395	150	229	2	50	79	0.6329114
NODE_66181_length_423_cov_1.879630	94	142	0	48	48	1.0000000
NODE_66222_length_423_cov_1.580247	128	208	0	80	80	1.0000000
NODE_66258_length_423_cov_1.410494	206	286	0	9	80	0.1125000
NODE_66258_length_423_cov_1.410494	206	286	4	71	80	0.8875000
NODE_66459_length_422_cov_12.021672	201	236	0	35	35	1.0000000
NODE_66459_length_422_cov_12.021672	247	289	0	42	42	1.0000000
NODE_66460_length_422_cov_10.712074	62	140	0	78	78	1.0000000
NODE_66460_length_422_cov_10.712074	115	195	0	80	80	1.0000000
NODE_66468_length_422_cov_6.281734	37	117	0	37	80	0.4625000
NODE_66468_length_422_cov_6.281734	37	117	2	43	80	0.5375000
NODE_66468_length_422_cov_6.281734	90	170	0	9	80	0.1125000
NODE_66468_length_422_cov_6.281734	90	170	2	71	80	0.8875000
NODE_66474_length_422_cov_5.266254	176	256	0	80	80	1.0000000
NODE_66485_length_422_cov_4.148607	159	224	0	65	65	1.0000000
NODE_66485_length_422_cov_4.148607	197	277	0	80	80	1.0000000
NODE_66488_length_422_cov_4.003096	146	226	0	80	80	1.0000000
NODE_66488_length_422_cov_4.003096	199	279	0	42	80	0.5250000
NODE_66488_length_422_cov_4.003096	199	279	4	31	80	0.3875000
NODE_66488_length_422_cov_4.003096	199	279	8	7	80	0.0875000
NODE_66512_length_422_cov_3.130031	93	173	0	80	80	1.0000000
NODE_66512_length_422_cov_3.130031	146	226	0	80	80	1.0000000
NODE_66515_length_422_cov_3.077399	291	359	11	1	68	0.0147059
NODE_66515_length_422_cov_3.077399	291	359	13	3	68	0.0441176
NODE_66515_length_422_cov_3.077399	291	359	17	3	68	0.0441176
NODE_66515_length_422_cov_3.077399	291	359	24	1	68	0.0147059
NODE_66515_length_422_cov_3.077399	291	359	26	1	68	0.0147059
NODE_66515_length_422_cov_3.077399	291	359	30	2	68	0.0294118
NODE_66515_length_422_cov_3.077399	291	359	32	8	68	0.1176471
NODE_66515_length_422_cov_3.077399	291	359	34	1	68	0.0147059
NODE_66515_length_422_cov_3.077399	291	359	38	5	68	0.0735294
NODE_66515_length_422_cov_3.077399	291	359	40	5	68	0.0735294
NODE_66515_length_422_cov_3.077399	291	359	44	8	68	0.1176471
NODE_66515_length_422_cov_3.077399	291	359	46	30	68	0.4411765
NODE_66550_length_422_cov_2.191950	5	24	0	19	19	1.0000000
NODE_66560_length_422_cov_2.108359	97	177	0	37	80	0.4625000
NODE_66560_length_422_cov_2.108359	97	177	1	1	80	0.0125000
NODE_66560_length_422_cov_2.108359	97	177	2	16	80	0.2000000
NODE_66560_length_422_cov_2.108359	97	177	4	11	80	0.1375000
NODE_66560_length_422_cov_2.108359	97	177	12	2	80	0.0250000
NODE_66560_length_422_cov_2.108359	97	177	14	3	80	0.0375000
NODE_66560_length_422_cov_2.108359	97	177	18	8	80	0.1000000
NODE_66560_length_422_cov_2.108359	97	177	20	1	80	0.0125000
NODE_66560_length_422_cov_2.108359	97	177	22	1	80	0.0125000
NODE_66560_length_422_cov_2.108359	150	189	0	10	39	0.2564103
NODE_66560_length_422_cov_2.108359	150	189	1	1	39	0.0256410
NODE_66560_length_422_cov_2.108359	150	189	2	28	39	0.7179487
NODE_66560_length_422_cov_2.108359	249	289	10	5	40	0.1250000
NODE_66560_length_422_cov_2.108359	249	289	12	11	40	0.2750000
NODE_66560_length_422_cov_2.108359	249	289	14	4	40	0.1000000
NODE_66560_length_422_cov_2.108359	249	289	16	5	40	0.1250000
NODE_66560_length_422_cov_2.108359	249	289	18	10	40	0.2500000
NODE_66560_length_422_cov_2.108359	249	289	20	5	40	0.1250000
NODE_66806_length_422_cov_0.845201	2	76	0	74	74	1.0000000
NODE_66869_length_421_cov_10.664596	178	256	0	78	78	1.0000000
NODE_66869_length_421_cov_10.664596	229	309	0	80	80	1.0000000
NODE_66874_length_421_cov_7.552795	325	407	0	82	82	1.0000000
NODE_66874_length_421_cov_7.552795	380	421	0	41	41	1.0000000
NODE_66875_length_421_cov_7.431677	96	118	0	22	22	1.0000000
NODE_66883_length_421_cov_5.279503	245	310	0	8	65	0.1230769
NODE_66883_length_421_cov_5.279503	245	310	2	57	65	0.8769231
NODE_66884_length_421_cov_5.158385	68	145	0	77	77	1.0000000
NODE_66897_length_421_cov_4.114907	221	287	0	66	66	1.0000000
NODE_66898_length_421_cov_4.102484	202	277	0	75	75	1.0000000
NODE_66899_length_421_cov_4.040373	192	272	0	80	80	1.0000000
NODE_66899_length_421_cov_4.040373	245	314	0	50	69	0.7246377
NODE_66899_length_421_cov_4.040373	245	314	2	19	69	0.2753623
NODE_66923_length_421_cov_3.319876	0	57	0	57	57	1.0000000
NODE_66955_length_421_cov_2.708075	95	118	2	23	23	1.0000000
NODE_66955_length_421_cov_2.708075	109	189	0	27	80	0.3375000
NODE_66955_length_421_cov_2.708075	109	189	2	53	80	0.6625000
NODE_66955_length_421_cov_2.708075	248	300	0	52	52	1.0000000
NODE_67073_length_421_cov_1.559006	240	309	3	42	69	0.6086956
NODE_67073_length_421_cov_1.559006	240	309	7	3	69	0.0434783
NODE_67073_length_421_cov_1.559006	240	309	8	1	69	0.0144928
NODE_67073_length_421_cov_1.559006	240	309	10	23	69	0.3333333
NODE_67073_length_421_cov_1.559006	240	310	3	43	70	0.6142857
NODE_67073_length_421_cov_1.559006	240	310	7	3	70	0.0428571
NODE_67073_length_421_cov_1.559006	240	310	8	1	70	0.0142857
NODE_67073_length_421_cov_1.559006	240	310	10	23	70	0.3285714
NODE_67077_length_421_cov_1.537267	305	383	0	78	78	1.0000000
NODE_67098_length_421_cov_1.413043	254	303	0	49	49	1.0000000
NODE_67283_length_421_cov_0.633540	132	156	0	24	24	1.0000000
NODE_67317_length_420_cov_80.766355	90	170	0	80	80	1.0000000
NODE_67317_length_420_cov_80.766355	143	223	0	80	80	1.0000000
NODE_67319_length_420_cov_51.473520	171	250	0	79	79	1.0000000
NODE_67319_length_420_cov_51.473520	223	307	0	84	84	1.0000000
NODE_67319_length_420_cov_51.473520	303	383	0	80	80	1.0000000
NODE_67319_length_420_cov_51.473520	356	420	0	64	64	1.0000000
NODE_67330_length_420_cov_5.071651	230	310	0	8	80	0.1000000
NODE_67330_length_420_cov_5.071651	230	310	2	8	80	0.1000000
NODE_67330_length_420_cov_5.071651	230	310	4	7	80	0.0875000
NODE_67330_length_420_cov_5.071651	230	310	8	11	80	0.1375000
NODE_67330_length_420_cov_5.071651	230	310	12	1	80	0.0125000
NODE_67330_length_420_cov_5.071651	230	310	14	45	80	0.5625000
NODE_67334_length_420_cov_4.775701	177	221	0	44	44	1.0000000
NODE_67345_length_420_cov_4.037383	161	240	0	13	79	0.1645570
NODE_67345_length_420_cov_4.037383	161	240	1	7	79	0.0886076
NODE_67345_length_420_cov_4.037383	161	240	2	59	79	0.7468355
NODE_67358_length_420_cov_3.657321	291	373	0	82	82	1.0000000
NODE_67398_length_420_cov_2.542056	96	176	0	80	80	1.0000000
NODE_67398_length_420_cov_2.542056	148	202	0	54	54	1.0000000
NODE_67398_length_420_cov_2.542056	149	195	0	46	46	1.0000000
NODE_67414_length_420_cov_2.323988	89	108	0	19	19	1.0000000
NODE_67506_length_420_cov_1.641745	277	312	0	35	35	1.0000000
NODE_67547_length_420_cov_1.429907	15	68	0	1	53	0.0188679
NODE_67547_length_420_cov_1.429907	15	68	2	23	53	0.4339623
NODE_67547_length_420_cov_1.429907	15	68	4	8	53	0.1509434
NODE_67547_length_420_cov_1.429907	15	68	6	21	53	0.3962264
NODE_67547_length_420_cov_1.429907	69	111	6	33	42	0.7857143
NODE_67547_length_420_cov_1.429907	69	111	12	9	42	0.2142857
NODE_67770_length_419_cov_491.015625	0	67	0	7	67	0.1044776
NODE_67770_length_419_cov_491.015625	0	67	7	1	67	0.0149254
NODE_67770_length_419_cov_491.015625	0	67	8	2	67	0.0298507
NODE_67770_length_419_cov_491.015625	0	67	9	4	67	0.0597015
NODE_67770_length_419_cov_491.015625	0	67	17	1	67	0.0149254
NODE_67770_length_419_cov_491.015625	0	67	19	14	67	0.2089552
NODE_67770_length_419_cov_491.015625	0	67	20	3	67	0.0447761
NODE_67770_length_419_cov_491.015625	0	67	21	35	67	0.5223880
NODE_67770_length_419_cov_491.015625	0	67	0	7	67	0.1044776
NODE_67770_length_419_cov_491.015625	0	67	7	1	67	0.0149254
NODE_67770_length_419_cov_491.015625	0	67	8	2	67	0.0298507
NODE_67770_length_419_cov_491.015625	0	67	9	4	67	0.0597015
NODE_67770_length_419_cov_491.015625	0	67	17	1	67	0.0149254
NODE_67770_length_419_cov_491.015625	0	67	19	14	67	0.2089552
NODE_67770_length_419_cov_491.015625	0	67	20	3	67	0.0447761
NODE_67770_length_419_cov_491.015625	0	67	21	35	67	0.5223880
NODE_67770_length_419_cov_491.015625	0	67	0	7	67	0.1044776
NODE_67770_length_419_cov_491.015625	0	67	7	1	67	0.0149254
NODE_67770_length_419_cov_491.015625	0	67	8	2	67	0.0298507
NODE_67770_length_419_cov_491.015625	0	67	9	4	67	0.0597015
NODE_67770_length_419_cov_491.015625	0	67	17	1	67	0.0149254
NODE_67770_length_419_cov_491.015625	0	67	19	14	67	0.2089552
NODE_67770_length_419_cov_491.015625	0	67	20	3	67	0.0447761
NODE_67770_length_419_cov_491.015625	0	67	21	35	67	0.5223880
NODE_67770_length_419_cov_491.015625	0	67	0	7	67	0.1044776
NODE_67770_length_419_cov_491.015625	0	67	7	1	67	0.0149254
NODE_67770_length_419_cov_491.015625	0	67	8	2	67	0.0298507
NODE_67770_length_419_cov_491.015625	0	67	9	4	67	0.0597015
NODE_67770_length_419_cov_491.015625	0	67	17	1	67	0.0149254
NODE_67770_length_419_cov_491.015625	0	67	19	14	67	0.2089552
NODE_67770_length_419_cov_491.015625	0	67	20	3	67	0.0447761
NODE_67770_length_419_cov_491.015625	0	67	21	35	67	0.5223880
NODE_67770_length_419_cov_491.015625	63	143	21	10	80	0.1250000
NODE_67770_length_419_cov_491.015625	63	143	22	7	80	0.0875000
NODE_67770_length_419_cov_491.015625	63	143	38	15	80	0.1875000
NODE_67770_length_419_cov_491.015625	63	143	40	31	80	0.3875000
NODE_67770_length_419_cov_491.015625	63	143	42	3	80	0.0375000
NODE_67770_length_419_cov_491.015625	63	143	44	10	80	0.1250000
NODE_67770_length_419_cov_491.015625	63	143	48	4	80	0.0500000
NODE_67770_length_419_cov_491.015625	63	143	21	10	80	0.1250000
NODE_67770_length_419_cov_491.015625	63	143	22	7	80	0.0875000
NODE_67770_length_419_cov_491.015625	63	143	38	15	80	0.1875000
NODE_67770_length_419_cov_491.015625	63	143	40	31	80	0.3875000
NODE_67770_length_419_cov_491.015625	63	143	42	3	80	0.0375000
NODE_67770_length_419_cov_491.015625	63	143	44	10	80	0.1250000
NODE_67770_length_419_cov_491.015625	63	143	48	4	80	0.0500000
NODE_67770_length_419_cov_491.015625	63	143	21	10	80	0.1250000
NODE_67770_length_419_cov_491.015625	63	143	22	7	80	0.0875000
NODE_67770_length_419_cov_491.015625	63	143	38	15	80	0.1875000
NODE_67770_length_419_cov_491.015625	63	143	40	31	80	0.3875000
NODE_67770_length_419_cov_491.015625	63	143	42	3	80	0.0375000
NODE_67770_length_419_cov_491.015625	63	143	44	10	80	0.1250000
NODE_67770_length_419_cov_491.015625	63	143	48	4	80	0.0500000
NODE_67770_length_419_cov_491.015625	116	196	18	2	80	0.0250000
NODE_67770_length_419_cov_491.015625	116	196	19	7	80	0.0875000
NODE_67770_length_419_cov_491.015625	116	196	21	8	80	0.1000000
NODE_67770_length_419_cov_491.015625	116	196	36	15	80	0.1875000
NODE_67770_length_419_cov_491.015625	116	196	38	1	80	0.0125000
NODE_67770_length_419_cov_491.015625	116	196	40	9	80	0.1125000
NODE_67770_length_419_cov_491.015625	116	196	42	4	80	0.0500000
NODE_67770_length_419_cov_491.015625	116	196	43	2	80	0.0250000
NODE_67770_length_419_cov_491.015625	116	196	44	14	80	0.1750000
NODE_67770_length_419_cov_491.015625	116	196	48	12	80	0.1500000
NODE_67770_length_419_cov_491.015625	116	196	50	4	80	0.0500000
NODE_67770_length_419_cov_491.015625	116	196	51	2	80	0.0250000
NODE_67770_length_419_cov_491.015625	116	196	18	2	80	0.0250000
NODE_67770_length_419_cov_491.015625	116	196	19	7	80	0.0875000
NODE_67770_length_419_cov_491.015625	116	196	21	8	80	0.1000000
NODE_67770_length_419_cov_491.015625	116	196	36	15	80	0.1875000
NODE_67770_length_419_cov_491.015625	116	196	38	1	80	0.0125000
NODE_67770_length_419_cov_491.015625	116	196	40	9	80	0.1125000
NODE_67770_length_419_cov_491.015625	116	196	42	4	80	0.0500000
NODE_67770_length_419_cov_491.015625	116	196	43	2	80	0.0250000
NODE_67770_length_419_cov_491.015625	116	196	44	14	80	0.1750000
NODE_67770_length_419_cov_491.015625	116	196	48	12	80	0.1500000
NODE_67770_length_419_cov_491.015625	116	196	50	4	80	0.0500000
NODE_67770_length_419_cov_491.015625	116	196	51	2	80	0.0250000
NODE_67770_length_419_cov_491.015625	116	196	18	2	80	0.0250000
NODE_67770_length_419_cov_491.015625	116	196	19	7	80	0.0875000
NODE_67770_length_419_cov_491.015625	116	196	21	8	80	0.1000000
NODE_67770_length_419_cov_491.015625	116	196	36	15	80	0.1875000
NODE_67770_length_419_cov_491.015625	116	196	38	1	80	0.0125000
NODE_67770_length_419_cov_491.015625	116	196	40	9	80	0.1125000
NODE_67770_length_419_cov_491.015625	116	196	42	4	80	0.0500000
NODE_67770_length_419_cov_491.015625	116	196	43	2	80	0.0250000
NODE_67770_length_419_cov_491.015625	116	196	44	14	80	0.1750000
NODE_67770_length_419_cov_491.015625	116	196	48	12	80	0.1500000
NODE_67770_length_419_cov_491.015625	116	196	50	4	80	0.0500000
NODE_67770_length_419_cov_491.015625	116	196	51	2	80	0.0250000
NODE_67770_length_419_cov_491.015625	116	196	18	2	80	0.0250000
NODE_67770_length_419_cov_491.015625	116	196	19	7	80	0.0875000
NODE_67770_length_419_cov_491.015625	116	196	21	8	80	0.1000000
NODE_67770_length_419_cov_491.015625	116	196	36	15	80	0.1875000
NODE_67770_length_419_cov_491.015625	116	196	38	1	80	0.0125000
NODE_67770_length_419_cov_491.015625	116	196	40	9	80	0.1125000
NODE_67770_length_419_cov_491.015625	116	196	42	4	80	0.0500000
NODE_67770_length_419_cov_491.015625	116	196	43	2	80	0.0250000
NODE_67770_length_419_cov_491.015625	116	196	44	14	80	0.1750000
NODE_67770_length_419_cov_491.015625	116	196	48	12	80	0.1500000
NODE_67770_length_419_cov_491.015625	116	196	50	4	80	0.0500000
NODE_67770_length_419_cov_491.015625	116	196	51	2	80	0.0250000
NODE_67770_length_419_cov_491.015625	116	196	18	2	80	0.0250000
NODE_67770_length_419_cov_491.015625	116	196	19	7	80	0.0875000
NODE_67770_length_419_cov_491.015625	116	196	21	8	80	0.1000000
NODE_67770_length_419_cov_491.015625	116	196	36	15	80	0.1875000
NODE_67770_length_419_cov_491.015625	116	196	38	1	80	0.0125000
NODE_67770_length_419_cov_491.015625	116	196	40	9	80	0.1125000
NODE_67770_length_419_cov_491.015625	116	196	42	4	80	0.0500000
NODE_67770_length_419_cov_491.015625	116	196	43	2	80	0.0250000
NODE_67770_length_419_cov_491.015625	116	196	44	14	80	0.1750000
NODE_67770_length_419_cov_491.015625	116	196	48	12	80	0.1500000
NODE_67770_length_419_cov_491.015625	116	196	50	4	80	0.0500000
NODE_67770_length_419_cov_491.015625	116	196	51	2	80	0.0250000
NODE_67772_length_419_cov_31.725000	12	92	0	80	80	1.0000000
NODE_67772_length_419_cov_31.725000	65	145	0	80	80	1.0000000
NODE_67789_length_419_cov_4.862500	47	103	0	56	56	1.0000000
NODE_67789_length_419_cov_4.862500	258	327	2	1	69	0.0144928
NODE_67789_length_419_cov_4.862500	258	327	4	68	69	0.9855072
NODE_67789_length_419_cov_4.862500	284	328	2	2	44	0.0454545
NODE_67789_length_419_cov_4.862500	284	328	4	42	44	0.9545454
NODE_67803_length_419_cov_4.193750	215	262	0	13	47	0.2765957
NODE_67803_length_419_cov_4.193750	215	262	6	34	47	0.7234042
NODE_67803_length_419_cov_4.193750	235	275	6	40	40	1.0000000
NODE_67817_length_419_cov_3.696875	165	215	0	50	50	1.0000000
NODE_67854_length_419_cov_2.628125	234	314	0	80	80	1.0000000
NODE_67856_length_419_cov_2.603125	154	196	0	42	42	1.0000000
NODE_67878_length_419_cov_2.350000	156	220	2	5	64	0.0781250
NODE_67878_length_419_cov_2.350000	156	220	4	3	64	0.0468750
NODE_67878_length_419_cov_2.350000	156	220	6	6	64	0.0937500
NODE_67878_length_419_cov_2.350000	156	220	8	1	64	0.0156250
NODE_67878_length_419_cov_2.350000	156	220	9	3	64	0.0468750
NODE_67878_length_419_cov_2.350000	156	220	11	3	64	0.0468750
NODE_67878_length_419_cov_2.350000	156	220	14	1	64	0.0156250
NODE_67878_length_419_cov_2.350000	156	220	15	9	64	0.1406250
NODE_67878_length_419_cov_2.350000	156	220	20	1	64	0.0156250
NODE_67878_length_419_cov_2.350000	156	220	22	16	64	0.2500000
NODE_67878_length_419_cov_2.350000	156	220	24	16	64	0.2500000
NODE_67961_length_419_cov_1.593750	339	358	0	19	19	1.0000000
NODE_68250_length_418_cov_63.059561	105	186	0	81	81	1.0000000
NODE_68250_length_418_cov_63.059561	159	239	0	80	80	1.0000000
NODE_68251_length_418_cov_49.796238	325	405	0	2	80	0.0250000
NODE_68251_length_418_cov_49.796238	325	405	8	5	80	0.0625000
NODE_68251_length_418_cov_49.796238	325	405	10	1	80	0.0125000
NODE_68251_length_418_cov_49.796238	325	405	13	4	80	0.0500000
NODE_68251_length_418_cov_49.796238	325	405	17	4	80	0.0500000
NODE_68251_length_418_cov_49.796238	325	405	18	2	80	0.0250000
NODE_68251_length_418_cov_49.796238	325	405	20	9	80	0.1125000
NODE_68251_length_418_cov_49.796238	325	405	24	12	80	0.1500000
NODE_68251_length_418_cov_49.796238	325	405	26	11	80	0.1375000
NODE_68251_length_418_cov_49.796238	325	405	28	1	80	0.0125000
NODE_68251_length_418_cov_49.796238	325	405	30	29	80	0.3625000
NODE_68251_length_418_cov_49.796238	378	415	0	12	37	0.3243243
NODE_68251_length_418_cov_49.796238	378	415	8	5	37	0.1351351
NODE_68251_length_418_cov_49.796238	378	415	10	1	37	0.0270270
NODE_68251_length_418_cov_49.796238	378	415	13	4	37	0.1081081
NODE_68251_length_418_cov_49.796238	378	415	17	4	37	0.1081081
NODE_68251_length_418_cov_49.796238	378	415	18	2	37	0.0540541
NODE_68251_length_418_cov_49.796238	378	415	20	9	37	0.2432432
NODE_68252_length_418_cov_42.764890	119	196	0	77	77	1.0000000
NODE_68252_length_418_cov_42.764890	172	250	0	78	78	1.0000000
NODE_68253_length_418_cov_23.830721	73	153	2	11	80	0.1375000
NODE_68253_length_418_cov_23.830721	73	153	6	69	80	0.8625000
NODE_68253_length_418_cov_23.830721	126	200	0	31	74	0.4189189
NODE_68253_length_418_cov_23.830721	126	200	2	27	74	0.3648649
NODE_68253_length_418_cov_23.830721	126	200	6	16	74	0.2162162
NODE_68255_length_418_cov_7.216301	211	291	0	17	80	0.2125000
NODE_68255_length_418_cov_7.216301	211	291	11	38	80	0.4750000
NODE_68255_length_418_cov_7.216301	211	291	15	25	80	0.3125000
NODE_68265_length_418_cov_5.382445	134	215	0	81	81	1.0000000
NODE_68265_length_418_cov_5.382445	187	268	0	81	81	1.0000000
NODE_68275_length_418_cov_4.463950	191	272	0	9	81	0.1111111
NODE_68275_length_418_cov_4.463950	191	272	4	30	81	0.3703704
NODE_68275_length_418_cov_4.463950	191	272	7	11	81	0.1358025
NODE_68275_length_418_cov_4.463950	191	272	8	25	81	0.3086420
NODE_68275_length_418_cov_4.463950	191	272	9	1	81	0.0123457
NODE_68275_length_418_cov_4.463950	191	272	10	5	81	0.0617284
NODE_68280_length_418_cov_4.216301	148	230	0	1	82	0.0121951
NODE_68280_length_418_cov_4.216301	148	230	2	81	82	0.9878049
NODE_68281_length_418_cov_4.065831	211	280	2	48	69	0.6956522
NODE_68281_length_418_cov_4.065831	211	280	4	19	69	0.2753623
NODE_68281_length_418_cov_4.065831	211	280	6	2	69	0.0289855
NODE_68284_length_418_cov_3.909091	95	175	3	12	80	0.1500000
NODE_68284_length_418_cov_3.909091	95	175	5	9	80	0.1125000
NODE_68284_length_418_cov_3.909091	95	175	7	2	80	0.0250000
NODE_68284_length_418_cov_3.909091	95	175	8	7	80	0.0875000
NODE_68284_length_418_cov_3.909091	95	175	10	8	80	0.1000000
NODE_68284_length_418_cov_3.909091	95	175	12	4	80	0.0500000
NODE_68284_length_418_cov_3.909091	95	175	14	3	80	0.0375000
NODE_68284_length_418_cov_3.909091	95	175	16	2	80	0.0250000
NODE_68284_length_418_cov_3.909091	95	175	17	3	80	0.0375000
NODE_68284_length_418_cov_3.909091	95	175	19	4	80	0.0500000
NODE_68284_length_418_cov_3.909091	95	175	20	4	80	0.0500000
NODE_68284_length_418_cov_3.909091	95	175	22	13	80	0.1625000
NODE_68284_length_418_cov_3.909091	95	175	24	9	80	0.1125000
NODE_68284_length_418_cov_3.909091	148	224	3	12	76	0.1578947
NODE_68284_length_418_cov_3.909091	148	224	4	4	76	0.0526316
NODE_68284_length_418_cov_3.909091	148	224	5	35	76	0.4605263
NODE_68284_length_418_cov_3.909091	148	224	6	4	76	0.0526316
NODE_68284_length_418_cov_3.909091	148	224	7	5	76	0.0657895
NODE_68284_length_418_cov_3.909091	148	224	8	4	76	0.0526316
NODE_68284_length_418_cov_3.909091	148	224	10	2	76	0.0263158
NODE_68284_length_418_cov_3.909091	148	224	12	5	76	0.0657895
NODE_68284_length_418_cov_3.909091	148	224	14	5	76	0.0657895
NODE_68288_length_418_cov_3.749216	181	247	0	66	66	1.0000000
NODE_68289_length_418_cov_3.711599	249	313	0	64	64	1.0000000
NODE_68307_length_418_cov_3.012539	101	181	0	48	80	0.6000000
NODE_68307_length_418_cov_3.012539	101	181	2	32	80	0.4000000
NODE_68354_length_418_cov_2.376176	95	115	0	20	20	1.0000000
NODE_68436_length_418_cov_1.623824	47	128	0	81	81	1.0000000
NODE_68436_length_418_cov_1.623824	239	268	6	29	29	1.0000000
NODE_68682_length_418_cov_0.626959	255	299	0	44	44	1.0000000
NODE_68708_length_417_cov_45.267296	212	292	0	80	80	1.0000000
NODE_68708_length_417_cov_45.267296	265	345	0	80	80	1.0000000
NODE_68708_length_417_cov_45.267296	341	417	0	76	76	1.0000000
NODE_68709_length_417_cov_36.006289	159	239	2	80	80	1.0000000
NODE_68711_length_417_cov_12.886792	193	273	0	80	80	1.0000000
NODE_68711_length_417_cov_12.886792	246	326	0	41	80	0.5125000
NODE_68711_length_417_cov_12.886792	246	326	2	39	80	0.4875000
NODE_68717_length_417_cov_7.056604	210	271	0	60	61	0.9836066
NODE_68717_length_417_cov_7.056604	210	271	1	1	61	0.0163934
NODE_68717_length_417_cov_7.056604	263	315	0	52	52	1.0000000
NODE_68718_length_417_cov_6.669811	194	264	4	36	70	0.5142857
NODE_68718_length_417_cov_6.669811	194	264	8	34	70	0.4857143
NODE_68779_length_417_cov_2.795597	20	91	0	71	71	1.0000000
NODE_69163_length_416_cov_115.782334	174	259	6	15	85	0.1764706
NODE_69163_length_416_cov_115.782334	174	259	14	9	85	0.1058824
NODE_69163_length_416_cov_115.782334	174	259	16	18	85	0.2117647
NODE_69163_length_416_cov_115.782334	174	259	18	14	85	0.1647059
NODE_69163_length_416_cov_115.782334	174	259	20	29	85	0.3411765
NODE_69164_length_416_cov_70.678233	180	244	23	10	64	0.1562500
NODE_69164_length_416_cov_70.678233	180	244	25	11	64	0.1718750
NODE_69164_length_416_cov_70.678233	180	244	27	1	64	0.0156250
NODE_69164_length_416_cov_70.678233	180	244	29	2	64	0.0312500
NODE_69164_length_416_cov_70.678233	180	244	31	7	64	0.1093750
NODE_69164_length_416_cov_70.678233	180	244	37	1	64	0.0156250
NODE_69164_length_416_cov_70.678233	180	244	40	10	64	0.1562500
NODE_69164_length_416_cov_70.678233	180	244	44	13	64	0.2031250
NODE_69164_length_416_cov_70.678233	180	244	45	1	64	0.0156250
NODE_69164_length_416_cov_70.678233	180	244	46	8	64	0.1250000
NODE_69166_length_416_cov_39.933754	288	368	0	80	80	1.0000000
NODE_69166_length_416_cov_39.933754	341	416	0	75	75	1.0000000
NODE_69167_length_416_cov_37.334385	158	238	0	80	80	1.0000000
NODE_69167_length_416_cov_37.334385	211	291	0	80	80	1.0000000
NODE_69167_length_416_cov_37.334385	287	367	0	80	80	1.0000000
NODE_69167_length_416_cov_37.334385	340	416	0	76	76	1.0000000
NODE_69179_length_416_cov_5.242902	89	169	0	80	80	1.0000000
NODE_69179_length_416_cov_5.242902	142	222	0	80	80	1.0000000
NODE_69184_length_416_cov_4.892744	79	145	0	66	66	1.0000000
NODE_69184_length_416_cov_4.892744	194	272	0	78	78	1.0000000
NODE_69184_length_416_cov_4.892744	247	272	0	25	25	1.0000000
NODE_69204_length_416_cov_3.886435	79	136	0	9	57	0.1578947
NODE_69204_length_416_cov_3.886435	79	136	2	48	57	0.8421053
NODE_69279_length_416_cov_2.230284	10	90	2	27	80	0.3375000
NODE_69279_length_416_cov_2.230284	10	90	4	53	80	0.6625000
NODE_69399_length_416_cov_1.520505	198	244	0	3	46	0.0652174
NODE_69399_length_416_cov_1.520505	198	244	6	25	46	0.5434783
NODE_69399_length_416_cov_1.520505	198	244	8	18	46	0.3913043
NODE_69399_length_416_cov_1.520505	261	328	10	20	67	0.2985075
NODE_69399_length_416_cov_1.520505	261	328	12	8	67	0.1194030
NODE_69399_length_416_cov_1.520505	261	328	14	6	67	0.0895522
NODE_69399_length_416_cov_1.520505	261	328	16	1	67	0.0149254
NODE_69399_length_416_cov_1.520505	261	328	18	14	67	0.2089552
NODE_69399_length_416_cov_1.520505	261	328	20	18	67	0.2686567
NODE_69673_length_415_cov_35.924051	260	339	0	79	79	1.0000000
NODE_69673_length_415_cov_35.924051	316	392	0	76	76	1.0000000
NODE_69679_length_415_cov_6.376582	117	197	0	80	80	1.0000000
NODE_69679_length_415_cov_6.376582	254	334	0	80	80	1.0000000
NODE_69774_length_415_cov_2.224684	144	224	0	35	80	0.4375000
NODE_69774_length_415_cov_2.224684	144	224	2	6	80	0.0750000
NODE_69774_length_415_cov_2.224684	144	224	4	39	80	0.4875000
NODE_69795_length_415_cov_2.069620	207	273	0	66	66	1.0000000
NODE_69817_length_415_cov_1.832278	225	283	0	6	58	0.1034483
NODE_69817_length_415_cov_1.832278	225	283	5	7	58	0.1206897
NODE_69817_length_415_cov_1.832278	225	283	8	4	58	0.0689655
NODE_69817_length_415_cov_1.832278	225	283	9	1	58	0.0172414
NODE_69817_length_415_cov_1.832278	225	283	11	3	58	0.0517241
NODE_69817_length_415_cov_1.832278	225	283	15	3	58	0.0517241
NODE_69817_length_415_cov_1.832278	225	283	16	8	58	0.1379310
NODE_69817_length_415_cov_1.832278	225	283	17	4	58	0.0689655
NODE_69817_length_415_cov_1.832278	225	283	19	2	58	0.0344828
NODE_69817_length_415_cov_1.832278	225	283	20	2	58	0.0344828
NODE_69817_length_415_cov_1.832278	225	283	22	5	58	0.0862069
NODE_69817_length_415_cov_1.832278	225	283	24	13	58	0.2241379
NODE_69845_length_415_cov_1.610759	90	170	34	3	80	0.0375000
NODE_69845_length_415_cov_1.610759	90	170	35	2	80	0.0250000
NODE_69845_length_415_cov_1.610759	90	170	37	1	80	0.0125000
NODE_69845_length_415_cov_1.610759	90	170	38	2	80	0.0250000
NODE_69845_length_415_cov_1.610759	90	170	40	6	80	0.0750000
NODE_69845_length_415_cov_1.610759	90	170	42	1	80	0.0125000
NODE_69845_length_415_cov_1.610759	90	170	44	3	80	0.0375000
NODE_69845_length_415_cov_1.610759	90	170	46	2	80	0.0250000
NODE_69845_length_415_cov_1.610759	90	170	48	1	80	0.0125000
NODE_69845_length_415_cov_1.610759	90	170	50	2	80	0.0250000
NODE_69845_length_415_cov_1.610759	90	170	54	2	80	0.0250000
NODE_69845_length_415_cov_1.610759	90	170	60	15	80	0.1875000
NODE_69845_length_415_cov_1.610759	90	170	63	8	80	0.1000000
NODE_69845_length_415_cov_1.610759	90	170	65	8	80	0.1000000
NODE_69845_length_415_cov_1.610759	90	170	66	7	80	0.0875000
NODE_69845_length_415_cov_1.610759	90	170	67	17	80	0.2125000
NODE_69845_length_415_cov_1.610759	335	376	2	41	41	1.0000000
NODE_70175_length_414_cov_46.263492	0	49	0	49	49	1.0000000
NODE_70175_length_414_cov_46.263492	22	102	0	80	80	1.0000000
NODE_70183_length_414_cov_7.460317	167	247	0	80	80	1.0000000
NODE_70183_length_414_cov_7.460317	220	300	0	80	80	1.0000000
NODE_70192_length_414_cov_5.676190	54	134	0	80	80	1.0000000
NODE_70192_length_414_cov_5.676190	107	187	0	80	80	1.0000000
NODE_70222_length_414_cov_4.130159	257	303	4	46	46	1.0000000
NODE_70222_length_414_cov_4.130159	276	356	0	4	80	0.0500000
NODE_70222_length_414_cov_4.130159	276	356	2	15	80	0.1875000
NODE_70222_length_414_cov_4.130159	276	356	4	61	80	0.7625000
NODE_70254_length_414_cov_2.996825	75	135	18	60	60	1.0000000
NODE_70271_length_414_cov_2.631746	68	145	0	77	77	1.0000000
NODE_70284_length_414_cov_2.473016	164	197	0	33	33	1.0000000
NODE_70284_length_414_cov_2.473016	170	255	0	85	85	1.0000000
NODE_70305_length_414_cov_2.222222	185	260	0	16	75	0.2133333
NODE_70305_length_414_cov_2.222222	185	260	2	6	75	0.0800000
NODE_70305_length_414_cov_2.222222	185	260	4	53	75	0.7066666
NODE_70305_length_414_cov_2.222222	233	304	4	71	71	1.0000000
NODE_70307_length_414_cov_2.206349	88	163	0	75	75	1.0000000
NODE_70326_length_414_cov_2.047619	298	349	0	51	51	1.0000000
NODE_70486_length_414_cov_1.177778	106	190	0	6	84	0.0714286
NODE_70486_length_414_cov_1.177778	106	190	2	78	84	0.9285714
NODE_70494_length_414_cov_1.155556	0	23	0	23	23	1.0000000
NODE_70690_length_413_cov_41.471338	35	115	0	80	80	1.0000000
NODE_70690_length_413_cov_41.471338	35	115	0	80	80	1.0000000
NODE_70690_length_413_cov_41.471338	88	168	0	80	80	1.0000000
NODE_70690_length_413_cov_41.471338	88	168	0	80	80	1.0000000
NODE_70691_length_413_cov_16.687898	222	302	0	80	80	1.0000000
NODE_70691_length_413_cov_16.687898	275	355	0	80	80	1.0000000
NODE_70699_length_413_cov_7.057325	170	250	0	4	80	0.0500000
NODE_70699_length_413_cov_7.057325	170	250	2	42	80	0.5250000
NODE_70699_length_413_cov_7.057325	170	250	6	34	80	0.4250000
NODE_70699_length_413_cov_7.057325	223	300	4	25	77	0.3246753
NODE_70699_length_413_cov_7.057325	223	300	6	52	77	0.6753247
NODE_70703_length_413_cov_5.665605	125	182	0	22	57	0.3859649
NODE_70703_length_413_cov_5.665605	125	182	2	35	57	0.6140351
NODE_70712_length_413_cov_4.754777	140	184	0	44	44	1.0000000
NODE_70743_length_413_cov_3.506369	113	193	8	80	80	1.0000000
NODE_70749_length_413_cov_3.235669	251	331	0	80	80	1.0000000
NODE_70749_length_413_cov_3.235669	304	356	0	52	52	1.0000000
NODE_70792_length_413_cov_2.484076	209	257	0	33	48	0.6875000
NODE_70792_length_413_cov_2.484076	209	257	10	15	48	0.3125000
NODE_70835_length_413_cov_1.949045	224	296	0	72	72	1.0000000
NODE_71196_length_412_cov_9.996805	172	244	0	72	72	1.0000000
NODE_71218_length_412_cov_4.686901	112	167	0	55	55	1.0000000
NODE_71253_length_412_cov_3.204473	44	124	0	44	80	0.5500000
NODE_71253_length_412_cov_3.204473	44	124	2	36	80	0.4500000
NODE_71276_length_412_cov_2.824281	225	305	2	80	80	1.0000000
NODE_71371_length_412_cov_1.782748	262	342	0	75	80	0.9375000
NODE_71371_length_412_cov_1.782748	262	342	2	5	80	0.0625000
NODE_71398_length_412_cov_1.603834	143	182	2	7	39	0.1794872
NODE_71398_length_412_cov_1.603834	143	182	4	5	39	0.1282051
NODE_71398_length_412_cov_1.603834	143	182	6	1	39	0.0256410
NODE_71398_length_412_cov_1.603834	143	182	8	3	39	0.0769231
NODE_71398_length_412_cov_1.603834	143	182	12	3	39	0.0769231
NODE_71398_length_412_cov_1.603834	143	182	14	2	39	0.0512821
NODE_71398_length_412_cov_1.603834	143	182	16	3	39	0.0769231
NODE_71398_length_412_cov_1.603834	143	182	19	2	39	0.0512821
NODE_71398_length_412_cov_1.603834	143	182	21	3	39	0.0769231
NODE_71398_length_412_cov_1.603834	143	182	22	8	39	0.2051282
NODE_71398_length_412_cov_1.603834	143	182	24	2	39	0.0512821
NODE_71665_length_411_cov_44.701923	4	72	0	68	68	1.0000000
NODE_71665_length_411_cov_44.701923	35	116	0	81	81	1.0000000
NODE_71665_length_411_cov_44.701923	161	242	0	81	81	1.0000000
NODE_71665_length_411_cov_44.701923	293	374	0	13	81	0.1604938
NODE_71665_length_411_cov_44.701923	293	374	2	68	81	0.8395061
NODE_71665_length_411_cov_44.701923	337	411	0	30	74	0.4054054
NODE_71665_length_411_cov_44.701923	337	411	2	44	74	0.5945946
NODE_71666_length_411_cov_43.144231	102	183	0	64	81	0.7901235
NODE_71666_length_411_cov_43.144231	102	183	2	17	81	0.2098765
NODE_71666_length_411_cov_43.144231	156	236	0	10	80	0.1250000
NODE_71666_length_411_cov_43.144231	156	236	2	70	80	0.8750000
NODE_71666_length_411_cov_43.144231	232	312	0	67	80	0.8375000
NODE_71666_length_411_cov_43.144231	232	312	2	13	80	0.1625000
NODE_71666_length_411_cov_43.144231	285	365	0	80	80	1.0000000
NODE_71672_length_411_cov_8.471154	133	213	0	80	80	1.0000000
NODE_71672_length_411_cov_8.471154	186	266	0	80	80	1.0000000
NODE_71673_length_411_cov_8.407051	133	220	6	87	87	1.0000000
NODE_71675_length_411_cov_6.455128	249	316	0	67	67	1.0000000
NODE_71675_length_411_cov_6.455128	292	344	0	52	52	1.0000000
NODE_71687_length_411_cov_4.782051	98	178	0	80	80	1.0000000
NODE_71687_length_411_cov_4.782051	151	228	0	77	77	1.0000000
NODE_71705_length_411_cov_3.698718	282	347	0	65	65	1.0000000
NODE_71713_length_411_cov_3.378205	88	148	0	7	60	0.1166667
NODE_71713_length_411_cov_3.378205	88	148	4	53	60	0.8833333
NODE_71714_length_411_cov_3.371795	145	225	0	80	80	1.0000000
NODE_71714_length_411_cov_3.371795	198	274	0	71	76	0.9342105
NODE_71714_length_411_cov_3.371795	198	274	2	5	76	0.0657895
NODE_72163_length_410_cov_49.331190	320	400	6	15	80	0.1875000
NODE_72163_length_410_cov_49.331190	320	400	13	10	80	0.1250000
NODE_72163_length_410_cov_49.331190	320	400	15	4	80	0.0500000
NODE_72163_length_410_cov_49.331190	320	400	16	24	80	0.3000000
NODE_72163_length_410_cov_49.331190	320	400	17	8	80	0.1000000
NODE_72163_length_410_cov_49.331190	320	400	19	3	80	0.0375000
NODE_72163_length_410_cov_49.331190	320	400	23	14	80	0.1750000
NODE_72163_length_410_cov_49.331190	320	400	24	2	80	0.0250000
NODE_72163_length_410_cov_49.331190	320	400	6	15	80	0.1875000
NODE_72163_length_410_cov_49.331190	320	400	13	10	80	0.1250000
NODE_72163_length_410_cov_49.331190	320	400	15	4	80	0.0500000
NODE_72163_length_410_cov_49.331190	320	400	16	24	80	0.3000000
NODE_72163_length_410_cov_49.331190	320	400	17	8	80	0.1000000
NODE_72163_length_410_cov_49.331190	320	400	19	3	80	0.0375000
NODE_72163_length_410_cov_49.331190	320	400	23	14	80	0.1750000
NODE_72163_length_410_cov_49.331190	320	400	24	2	80	0.0250000
NODE_72163_length_410_cov_49.331190	320	400	6	15	80	0.1875000
NODE_72163_length_410_cov_49.331190	320	400	13	10	80	0.1250000
NODE_72163_length_410_cov_49.331190	320	400	15	4	80	0.0500000
NODE_72163_length_410_cov_49.331190	320	400	16	24	80	0.3000000
NODE_72163_length_410_cov_49.331190	320	400	17	8	80	0.1000000
NODE_72163_length_410_cov_49.331190	320	400	19	3	80	0.0375000
NODE_72163_length_410_cov_49.331190	320	400	23	14	80	0.1750000
NODE_72163_length_410_cov_49.331190	320	400	24	2	80	0.0250000
NODE_72163_length_410_cov_49.331190	320	400	6	15	80	0.1875000
NODE_72163_length_410_cov_49.331190	320	400	13	10	80	0.1250000
NODE_72163_length_410_cov_49.331190	320	400	15	4	80	0.0500000
NODE_72163_length_410_cov_49.331190	320	400	16	24	80	0.3000000
NODE_72163_length_410_cov_49.331190	320	400	17	8	80	0.1000000
NODE_72163_length_410_cov_49.331190	320	400	19	3	80	0.0375000
NODE_72163_length_410_cov_49.331190	320	400	23	14	80	0.1750000
NODE_72163_length_410_cov_49.331190	320	400	24	2	80	0.0250000
NODE_72163_length_410_cov_49.331190	320	400	6	15	80	0.1875000
NODE_72163_length_410_cov_49.331190	320	400	13	10	80	0.1250000
NODE_72163_length_410_cov_49.331190	320	400	15	4	80	0.0500000
NODE_72163_length_410_cov_49.331190	320	400	16	24	80	0.3000000
NODE_72163_length_410_cov_49.331190	320	400	17	8	80	0.1000000
NODE_72163_length_410_cov_49.331190	320	400	19	3	80	0.0375000
NODE_72163_length_410_cov_49.331190	320	400	23	14	80	0.1750000
NODE_72163_length_410_cov_49.331190	320	400	24	2	80	0.0250000
NODE_72163_length_410_cov_49.331190	329	400	6	15	71	0.2112676
NODE_72163_length_410_cov_49.331190	329	400	13	10	71	0.1408451
NODE_72163_length_410_cov_49.331190	329	400	15	4	71	0.0563380
NODE_72163_length_410_cov_49.331190	329	400	16	24	71	0.3380282
NODE_72163_length_410_cov_49.331190	329	400	17	8	71	0.1126761
NODE_72163_length_410_cov_49.331190	329	400	19	3	71	0.0422535
NODE_72163_length_410_cov_49.331190	329	400	23	7	71	0.0985916
NODE_72169_length_410_cov_6.797428	179	259	0	80	80	1.0000000
NODE_72169_length_410_cov_6.797428	232	312	0	80	80	1.0000000
NODE_72184_length_410_cov_5.102894	153	222	0	5	69	0.0724638
NODE_72184_length_410_cov_5.102894	153	222	2	64	69	0.9275362
NODE_72186_length_410_cov_4.884244	101	179	0	29	78	0.3717949
NODE_72186_length_410_cov_4.884244	101	179	2	49	78	0.6282051
NODE_72187_length_410_cov_4.787781	287	344	0	7	57	0.1228070
NODE_72187_length_410_cov_4.787781	287	344	2	50	57	0.8771930
NODE_72187_length_410_cov_4.787781	340	397	0	36	57	0.6315789
NODE_72187_length_410_cov_4.787781	340	397	2	21	57	0.3684210
NODE_72194_length_410_cov_4.591640	245	303	14	1	58	0.0172414
NODE_72194_length_410_cov_4.591640	245	303	20	10	58	0.1724138
NODE_72194_length_410_cov_4.591640	245	303	22	2	58	0.0344828
NODE_72194_length_410_cov_4.591640	245	303	26	1	58	0.0172414
NODE_72194_length_410_cov_4.591640	245	303	28	16	58	0.2758621
NODE_72194_length_410_cov_4.591640	245	303	32	1	58	0.0172414
NODE_72194_length_410_cov_4.591640	245	303	34	1	58	0.0172414
NODE_72194_length_410_cov_4.591640	245	303	38	5	58	0.0862069
NODE_72194_length_410_cov_4.591640	245	303	40	7	58	0.1206897
NODE_72194_length_410_cov_4.591640	245	303	44	14	58	0.2413793
NODE_72194_length_410_cov_4.591640	298	356	26	3	58	0.0517241
NODE_72194_length_410_cov_4.591640	298	356	28	12	58	0.2068966
NODE_72194_length_410_cov_4.591640	298	356	29	5	58	0.0862069
NODE_72194_length_410_cov_4.591640	298	356	30	3	58	0.0517241
NODE_72194_length_410_cov_4.591640	298	356	36	1	58	0.0172414
NODE_72194_length_410_cov_4.591640	298	356	38	2	58	0.0344828
NODE_72194_length_410_cov_4.591640	298	356	40	2	58	0.0344828
NODE_72194_length_410_cov_4.591640	298	356	42	6	58	0.1034483
NODE_72194_length_410_cov_4.591640	298	356	44	24	58	0.4137931
NODE_72230_length_410_cov_3.215434	32	112	0	80	80	1.0000000
NODE_72230_length_410_cov_3.215434	85	165	0	80	80	1.0000000
NODE_72327_length_410_cov_1.913183	227	285	0	58	58	1.0000000
NODE_72526_length_410_cov_1.038585	272	316	4	25	44	0.5681818
NODE_72526_length_410_cov_1.038585	272	316	12	11	44	0.2500000
NODE_72526_length_410_cov_1.038585	272	316	14	8	44	0.1818182
NODE_72688_length_409_cov_11.506452	56	136	0	80	80	1.0000000
NODE_72688_length_409_cov_11.506452	109	189	0	80	80	1.0000000
NODE_72689_length_409_cov_10.329032	131	186	0	55	55	1.0000000
NODE_72690_length_409_cov_9.625806	62	142	0	80	80	1.0000000
NODE_72690_length_409_cov_9.625806	115	195	0	80	80	1.0000000
NODE_72697_length_409_cov_6.867742	41	71	0	30	30	1.0000000
NODE_72730_length_409_cov_3.822581	103	158	0	55	55	1.0000000
NODE_72730_length_409_cov_3.822581	151	232	0	81	81	1.0000000
NODE_72754_length_409_cov_2.987097	240	287	0	47	47	1.0000000
NODE_72951_length_409_cov_1.319355	49	131	3	67	82	0.8170732
NODE_72951_length_409_cov_1.319355	49	131	4	15	82	0.1829268
NODE_72951_length_409_cov_1.319355	104	161	0	1	57	0.0175439
NODE_72951_length_409_cov_1.319355	104	161	2	8	57	0.1403509
NODE_72951_length_409_cov_1.319355	104	161	3	12	57	0.2105263
NODE_72951_length_409_cov_1.319355	104	161	4	36	57	0.6315789
NODE_73196_length_408_cov_8.585761	57	137	0	10	80	0.1250000
NODE_73196_length_408_cov_8.585761	57	137	4	70	80	0.8750000
NODE_73196_length_408_cov_8.585761	110	190	0	6	80	0.0750000
NODE_73196_length_408_cov_8.585761	110	190	4	74	80	0.9250000
NODE_73198_length_408_cov_6.948220	71	151	2	80	80	1.0000000
NODE_73198_length_408_cov_6.948220	124	204	0	44	80	0.5500000
NODE_73198_length_408_cov_6.948220	124	204	2	36	80	0.4500000
NODE_73219_length_408_cov_3.957929	83	132	6	49	49	1.0000000
NODE_73226_length_408_cov_3.511327	40	97	0	57	57	1.0000000
NODE_73226_length_408_cov_3.511327	357	398	0	41	41	1.0000000
NODE_73262_length_408_cov_2.724919	128	180	4	52	52	1.0000000
NODE_73269_length_408_cov_2.563107	164	241	0	77	77	1.0000000
NODE_73271_length_408_cov_2.456311	314	379	0	65	65	1.0000000
NODE_73271_length_408_cov_2.456311	352	408	0	56	56	1.0000000
NODE_73690_length_407_cov_6.191558	144	208	0	17	64	0.2656250
NODE_73690_length_407_cov_6.191558	144	208	2	47	64	0.7343750
NODE_73698_length_407_cov_4.961039	212	291	4	29	79	0.3670886
NODE_73698_length_407_cov_4.961039	212	291	6	50	79	0.6329114
NODE_73719_length_407_cov_3.681818	314	375	0	61	61	1.0000000
NODE_73732_length_407_cov_3.344156	199	247	5	48	48	1.0000000
NODE_73736_length_407_cov_3.250000	142	223	0	3	81	0.0370370
NODE_73736_length_407_cov_3.250000	142	223	6	17	81	0.2098765
NODE_73736_length_407_cov_3.250000	142	223	8	2	81	0.0246914
NODE_73736_length_407_cov_3.250000	142	223	10	59	81	0.7283950
NODE_73762_length_407_cov_2.594156	194	257	0	37	63	0.5873016
NODE_73762_length_407_cov_2.594156	194	257	2	26	63	0.4126984
NODE_73769_length_407_cov_2.538961	34	114	4	31	80	0.3875000
NODE_73769_length_407_cov_2.538961	34	114	6	49	80	0.6125000
NODE_73853_length_407_cov_1.737013	208	264	0	8	56	0.1428571
NODE_73853_length_407_cov_1.737013	208	264	4	48	56	0.8571429
NODE_74200_length_406_cov_176.856678	200	271	93	1	71	0.0140845
NODE_74200_length_406_cov_176.856678	200	271	95	1	71	0.0140845
NODE_74200_length_406_cov_176.856678	200	271	101	1	71	0.0140845
NODE_74200_length_406_cov_176.856678	200	271	103	3	71	0.0422535
NODE_74200_length_406_cov_176.856678	200	271	104	1	71	0.0140845
NODE_74200_length_406_cov_176.856678	200	271	105	5	71	0.0704225
NODE_74200_length_406_cov_176.856678	200	271	107	3	71	0.0422535
NODE_74200_length_406_cov_176.856678	200	271	109	1	71	0.0140845
NODE_74200_length_406_cov_176.856678	200	271	110	1	71	0.0140845
NODE_74200_length_406_cov_176.856678	200	271	111	2	71	0.0281690
NODE_74200_length_406_cov_176.856678	200	271	112	1	71	0.0140845
NODE_74200_length_406_cov_176.856678	200	271	113	1	71	0.0140845
NODE_74200_length_406_cov_176.856678	200	271	118	1	71	0.0140845
NODE_74200_length_406_cov_176.856678	200	271	119	1	71	0.0140845
NODE_74200_length_406_cov_176.856678	200	271	125	1	71	0.0140845
NODE_74200_length_406_cov_176.856678	200	271	129	2	71	0.0281690
NODE_74200_length_406_cov_176.856678	200	271	131	2	71	0.0281690
NODE_74200_length_406_cov_176.856678	200	271	140	1	71	0.0140845
NODE_74200_length_406_cov_176.856678	200	271	142	1	71	0.0140845
NODE_74200_length_406_cov_176.856678	200	271	148	2	71	0.0281690
NODE_74200_length_406_cov_176.856678	200	271	150	5	71	0.0704225
NODE_74200_length_406_cov_176.856678	200	271	151	6	71	0.0845070
NODE_74200_length_406_cov_176.856678	200	271	152	2	71	0.0281690
NODE_74200_length_406_cov_176.856678	200	271	154	1	71	0.0140845
NODE_74200_length_406_cov_176.856678	200	271	156	6	71	0.0845070
NODE_74200_length_406_cov_176.856678	200	271	157	1	71	0.0140845
NODE_74200_length_406_cov_176.856678	200	271	158	1	71	0.0140845
NODE_74200_length_406_cov_176.856678	200	271	159	2	71	0.0281690
NODE_74200_length_406_cov_176.856678	200	271	160	3	71	0.0422535
NODE_74200_length_406_cov_176.856678	200	271	161	3	71	0.0422535
NODE_74200_length_406_cov_176.856678	200	271	163	2	71	0.0281690
NODE_74200_length_406_cov_176.856678	200	271	164	4	71	0.0563380
NODE_74200_length_406_cov_176.856678	200	271	165	3	71	0.0422535
NODE_74200_length_406_cov_176.856678	244	321	122	3	77	0.0389610
NODE_74200_length_406_cov_176.856678	244	321	124	2	77	0.0259740
NODE_74200_length_406_cov_176.856678	244	321	127	6	77	0.0779221
NODE_74200_length_406_cov_176.856678	244	321	128	1	77	0.0129870
NODE_74200_length_406_cov_176.856678	244	321	131	1	77	0.0129870
NODE_74200_length_406_cov_176.856678	244	321	132	1	77	0.0129870
NODE_74200_length_406_cov_176.856678	244	321	133	3	77	0.0389610
NODE_74200_length_406_cov_176.856678	244	321	135	5	77	0.0649351
NODE_74200_length_406_cov_176.856678	244	321	138	1	77	0.0129870
NODE_74200_length_406_cov_176.856678	244	321	140	1	77	0.0129870
NODE_74200_length_406_cov_176.856678	244	321	142	2	77	0.0259740
NODE_74200_length_406_cov_176.856678	244	321	145	3	77	0.0389610
NODE_74200_length_406_cov_176.856678	244	321	148	4	77	0.0519481
NODE_74200_length_406_cov_176.856678	244	321	150	3	77	0.0389610
NODE_74200_length_406_cov_176.856678	244	321	151	6	77	0.0779221
NODE_74200_length_406_cov_176.856678	244	321	152	1	77	0.0129870
NODE_74200_length_406_cov_176.856678	244	321	154	3	77	0.0389610
NODE_74200_length_406_cov_176.856678	244	321	156	6	77	0.0779221
NODE_74200_length_406_cov_176.856678	244	321	157	1	77	0.0129870
NODE_74200_length_406_cov_176.856678	244	321	158	4	77	0.0519481
NODE_74200_length_406_cov_176.856678	244	321	159	3	77	0.0389610
NODE_74200_length_406_cov_176.856678	244	321	160	2	77	0.0259740
NODE_74200_length_406_cov_176.856678	244	321	161	5	77	0.0649351
NODE_74200_length_406_cov_176.856678	244	321	162	2	77	0.0259740
NODE_74200_length_406_cov_176.856678	244	321	163	2	77	0.0259740
NODE_74200_length_406_cov_176.856678	244	321	164	5	77	0.0649351
NODE_74200_length_406_cov_176.856678	244	321	165	1	77	0.0129870
NODE_74203_length_406_cov_37.723127	15	95	0	78	80	0.9750000
NODE_74203_length_406_cov_37.723127	15	95	4	1	80	0.0125000
NODE_74203_length_406_cov_37.723127	15	95	16	1	80	0.0125000
NODE_74219_length_406_cov_4.960912	268	327	2	59	59	1.0000000
NODE_74253_length_406_cov_3.087948	261	302	0	41	41	1.0000000
NODE_74284_length_406_cov_2.475570	220	270	6	18	50	0.3600000
NODE_74284_length_406_cov_2.475570	220	270	8	32	50	0.6400000
NODE_74332_length_406_cov_1.986971	238	276	0	2	38	0.0526316
NODE_74332_length_406_cov_1.986971	238	276	2	36	38	0.9473684
NODE_74368_length_406_cov_1.778502	159	195	2	1	36	0.0277778
NODE_74368_length_406_cov_1.778502	159	195	4	5	36	0.1388889
NODE_74368_length_406_cov_1.778502	159	195	6	17	36	0.4722222
NODE_74368_length_406_cov_1.778502	159	195	10	13	36	0.3611111
NODE_74368_length_406_cov_1.778502	234	294	14	1	60	0.0166667
NODE_74368_length_406_cov_1.778502	234	294	16	6	60	0.1000000
NODE_74368_length_406_cov_1.778502	234	294	18	11	60	0.1833333
NODE_74368_length_406_cov_1.778502	234	294	20	2	60	0.0333333
NODE_74368_length_406_cov_1.778502	234	294	22	38	60	0.6333333
NODE_74368_length_406_cov_1.778502	234	294	24	2	60	0.0333333
NODE_74368_length_406_cov_1.778502	267	347	2	11	80	0.1375000
NODE_74368_length_406_cov_1.778502	267	347	4	4	80	0.0500000
NODE_74368_length_406_cov_1.778502	267	347	6	8	80	0.1000000
NODE_74368_length_406_cov_1.778502	267	347	8	1	80	0.0125000
NODE_74368_length_406_cov_1.778502	267	347	10	3	80	0.0375000
NODE_74368_length_406_cov_1.778502	267	347	14	1	80	0.0125000
NODE_74368_length_406_cov_1.778502	267	347	16	2	80	0.0250000
NODE_74368_length_406_cov_1.778502	267	347	18	3	80	0.0375000
NODE_74368_length_406_cov_1.778502	267	347	22	45	80	0.5625000
NODE_74368_length_406_cov_1.778502	267	347	24	2	80	0.0250000
NODE_74427_length_406_cov_1.495114	173	212	0	39	39	1.0000000
NODE_74476_length_406_cov_1.325733	367	398	0	31	31	1.0000000
NODE_74588_length_406_cov_0.934853	1	32	0	31	31	1.0000000
NODE_74588_length_406_cov_0.934853	5	85	0	80	80	1.0000000
NODE_74696_length_405_cov_5.107843	332	380	0	25	48	0.5208333
NODE_74696_length_405_cov_5.107843	332	380	6	23	48	0.4791667
NODE_74697_length_405_cov_4.915033	15	46	0	31	31	1.0000000
NODE_74727_length_405_cov_3.346405	195	240	0	7	45	0.1555556
NODE_74727_length_405_cov_3.346405	195	240	2	38	45	0.8444445
NODE_74727_length_405_cov_3.346405	274	329	0	55	55	1.0000000
NODE_74737_length_405_cov_3.124183	210	260	0	38	50	0.7600000
NODE_74737_length_405_cov_3.124183	210	260	7	12	50	0.2400000
NODE_74737_length_405_cov_3.124183	240	286	0	8	46	0.1739130
NODE_74737_length_405_cov_3.124183	240	286	7	17	46	0.3695652
NODE_74737_length_405_cov_3.124183	240	286	13	2	46	0.0434783
NODE_74737_length_405_cov_3.124183	240	286	14	15	46	0.3260870
NODE_74737_length_405_cov_3.124183	240	286	16	4	46	0.0869565
NODE_74737_length_405_cov_3.124183	260	339	7	5	79	0.0632911
NODE_74737_length_405_cov_3.124183	260	339	13	2	79	0.0253165
NODE_74737_length_405_cov_3.124183	260	339	14	35	79	0.4430380
NODE_74737_length_405_cov_3.124183	260	339	15	12	79	0.1518987
NODE_74737_length_405_cov_3.124183	260	339	16	25	79	0.3164557
NODE_74737_length_405_cov_3.124183	272	339	14	30	67	0.4477612
NODE_74737_length_405_cov_3.124183	272	339	15	12	67	0.1791045
NODE_74737_length_405_cov_3.124183	272	339	16	25	67	0.3731343
NODE_74780_length_405_cov_2.503268	352	399	0	47	47	1.0000000
NODE_74787_length_405_cov_2.460784	0	73	0	14	73	0.1917808
NODE_74787_length_405_cov_2.460784	0	73	2	59	73	0.8082192
NODE_75145_length_405_cov_0.666667	207	268	0	61	61	1.0000000
NODE_75196_length_404_cov_40.937705	40	120	0	38	80	0.4750000
NODE_75196_length_404_cov_40.937705	40	120	2	42	80	0.5250000
NODE_75196_length_404_cov_40.937705	93	173	0	22	80	0.2750000
NODE_75196_length_404_cov_40.937705	93	173	2	58	80	0.7250000
NODE_75197_length_404_cov_32.940984	46	126	0	80	80	1.0000000
NODE_75197_length_404_cov_32.940984	99	179	0	80	80	1.0000000
NODE_75197_length_404_cov_32.940984	175	255	0	80	80	1.0000000
NODE_75197_length_404_cov_32.940984	228	308	0	80	80	1.0000000
NODE_75198_length_404_cov_11.731148	130	210	0	80	80	1.0000000
NODE_75198_length_404_cov_11.731148	183	263	0	80	80	1.0000000
NODE_75200_length_404_cov_9.170492	201	257	0	56	56	1.0000000
NODE_75236_length_404_cov_3.613115	323	385	0	53	62	0.8548387
NODE_75236_length_404_cov_3.613115	323	385	2	9	62	0.1451613
NODE_75259_length_404_cov_2.914754	181	261	0	80	80	1.0000000
NODE_75345_length_404_cov_2.085246	245	325	0	80	80	1.0000000
NODE_75357_length_404_cov_1.993443	95	148	0	53	53	1.0000000
NODE_75399_length_404_cov_1.672131	32	106	0	74	74	1.0000000
NODE_75440_length_404_cov_1.498361	94	174	2	77	80	0.9625000
NODE_75440_length_404_cov_1.498361	94	174	4	3	80	0.0375000
NODE_75446_length_404_cov_1.485246	234	282	6	2	48	0.0416667
NODE_75446_length_404_cov_1.485246	234	282	8	16	48	0.3333333
NODE_75446_length_404_cov_1.485246	234	282	10	30	48	0.6250000
NODE_75545_length_404_cov_1.121311	114	194	4	9	80	0.1125000
NODE_75545_length_404_cov_1.121311	114	194	6	10	80	0.1250000
NODE_75545_length_404_cov_1.121311	114	194	8	41	80	0.5125000
NODE_75545_length_404_cov_1.121311	114	194	10	3	80	0.0375000
NODE_75545_length_404_cov_1.121311	114	194	12	17	80	0.2125000
NODE_75750_length_403_cov_7.325658	80	146	0	8	66	0.1212121
NODE_75750_length_403_cov_7.325658	80	146	1	57	66	0.8636364
NODE_75750_length_403_cov_7.325658	80	146	2	1	66	0.0151515
NODE_75750_length_403_cov_7.325658	165	234	2	69	69	1.0000000
NODE_75750_length_403_cov_7.325658	215	255	1	20	40	0.5000000
NODE_75750_length_403_cov_7.325658	215	255	2	20	40	0.5000000
NODE_75751_length_403_cov_7.217105	207	284	0	77	77	1.0000000
NODE_75751_length_403_cov_7.217105	257	334	0	77	77	1.0000000
NODE_75752_length_403_cov_6.776316	192	250	0	58	58	1.0000000
NODE_75788_length_403_cov_3.710526	327	373	0	46	46	1.0000000
NODE_75788_length_403_cov_3.710526	346	403	0	57	57	1.0000000
NODE_75793_length_403_cov_3.611842	283	363	6	26	80	0.3250000
NODE_75793_length_403_cov_3.611842	283	363	12	1	80	0.0125000
NODE_75793_length_403_cov_3.611842	283	363	14	1	80	0.0125000
NODE_75793_length_403_cov_3.611842	283	363	16	18	80	0.2250000
NODE_75793_length_403_cov_3.611842	283	363	18	24	80	0.3000000
NODE_75793_length_403_cov_3.611842	283	363	22	3	80	0.0375000
NODE_75793_length_403_cov_3.611842	283	363	24	7	80	0.0875000
NODE_75824_length_403_cov_2.822368	201	282	4	13	81	0.1604938
NODE_75824_length_403_cov_2.822368	201	282	5	21	81	0.2592593
NODE_75824_length_403_cov_2.822368	201	282	6	47	81	0.5802469
NODE_75871_length_403_cov_2.082237	102	145	0	43	43	1.0000000
NODE_75908_length_403_cov_1.871711	130	166	0	14	36	0.3888889
NODE_75908_length_403_cov_1.871711	130	166	2	22	36	0.6111111
NODE_75993_length_403_cov_1.398026	79	116	0	37	37	1.0000000
NODE_76029_length_403_cov_1.269737	82	111	0	29	29	1.0000000
NODE_76239_length_402_cov_6.293729	217	297	0	80	80	1.0000000
NODE_76239_length_402_cov_6.293729	270	350	0	80	80	1.0000000
NODE_76246_length_402_cov_5.227723	176	236	4	22	60	0.3666667
NODE_76246_length_402_cov_5.227723	176	236	6	38	60	0.6333333
NODE_76261_length_402_cov_4.356436	44	123	0	79	79	1.0000000
NODE_76261_length_402_cov_4.356436	119	199	0	35	80	0.4375000
NODE_76261_length_402_cov_4.356436	119	199	3	18	80	0.2250000
NODE_76261_length_402_cov_4.356436	119	199	4	27	80	0.3375000
NODE_76261_length_402_cov_4.356436	172	252	3	23	80	0.2875000
NODE_76261_length_402_cov_4.356436	172	252	4	10	80	0.1250000
NODE_76261_length_402_cov_4.356436	172	252	5	9	80	0.1125000
NODE_76261_length_402_cov_4.356436	172	252	7	2	80	0.0250000
NODE_76261_length_402_cov_4.356436	172	252	15	31	80	0.3875000
NODE_76261_length_402_cov_4.356436	172	252	17	5	80	0.0625000
NODE_76276_length_402_cov_3.564356	197	257	0	32	60	0.5333334
NODE_76276_length_402_cov_3.564356	197	257	4	28	60	0.4666667
NODE_76276_length_402_cov_3.564356	230	310	4	80	80	1.0000000
NODE_76328_length_402_cov_2.633663	335	402	0	33	67	0.4925373
NODE_76328_length_402_cov_2.633663	335	402	2	34	67	0.5074627
NODE_76336_length_402_cov_2.514851	82	162	0	14	80	0.1750000
NODE_76336_length_402_cov_2.514851	82	162	2	3	80	0.0375000
NODE_76336_length_402_cov_2.514851	82	162	4	10	80	0.1250000
NODE_76336_length_402_cov_2.514851	82	162	6	10	80	0.1250000
NODE_76336_length_402_cov_2.514851	82	162	8	43	80	0.5375000
NODE_76336_length_402_cov_2.514851	135	200	0	52	65	0.8000000
NODE_76336_length_402_cov_2.514851	135	200	2	3	65	0.0461538
NODE_76336_length_402_cov_2.514851	135	200	4	10	65	0.1538462
NODE_76380_length_402_cov_2.102310	114	165	2	37	51	0.7254902
NODE_76380_length_402_cov_2.102310	114	165	4	14	51	0.2745098
NODE_76380_length_402_cov_2.102310	138	195	2	43	57	0.7543859
NODE_76380_length_402_cov_2.102310	138	195	4	14	57	0.2456140
NODE_76560_length_402_cov_1.214521	0	33	0	33	33	1.0000000
NODE_76646_length_402_cov_1.000000	119	188	0	69	69	1.0000000
NODE_76752_length_402_cov_0.663366	0	46	0	46	46	1.0000000
NODE_76780_length_401_cov_43.675497	285	343	0	58	58	1.0000000
NODE_76801_length_401_cov_4.377483	309	389	0	80	80	1.0000000
NODE_76804_length_401_cov_4.241722	125	180	0	55	55	1.0000000
NODE_76808_length_401_cov_4.132450	195	275	0	40	80	0.5000000
NODE_76808_length_401_cov_4.132450	195	275	2	40	80	0.5000000
NODE_76811_length_401_cov_3.973510	138	181	11	3	43	0.0697674
NODE_76811_length_401_cov_3.973510	138	181	12	3	43	0.0697674
NODE_76811_length_401_cov_3.973510	138	181	13	37	43	0.8604651
NODE_76828_length_401_cov_3.370861	141	221	0	80	80	1.0000000
NODE_76828_length_401_cov_3.370861	194	273	0	79	79	1.0000000
NODE_76830_length_401_cov_3.317881	67	147	0	28	80	0.3500000
NODE_76830_length_401_cov_3.317881	67	147	2	16	80	0.2000000
NODE_76830_length_401_cov_3.317881	67	147	4	36	80	0.4500000
NODE_76918_length_401_cov_1.937086	160	239	12	11	79	0.1392405
NODE_76918_length_401_cov_1.937086	160	239	14	26	79	0.3291139
NODE_76918_length_401_cov_1.937086	160	239	16	1	79	0.0126582
NODE_76918_length_401_cov_1.937086	160	239	19	30	79	0.3797468
NODE_76918_length_401_cov_1.937086	160	239	20	7	79	0.0886076
NODE_76918_length_401_cov_1.937086	160	239	22	2	79	0.0253165
NODE_76918_length_401_cov_1.937086	160	239	24	2	79	0.0253165
NODE_76978_length_401_cov_1.615894	205	269	14	2	64	0.0312500
NODE_76978_length_401_cov_1.615894	205	269	16	3	64	0.0468750
NODE_76978_length_401_cov_1.615894	205	269	22	8	64	0.1250000
NODE_76978_length_401_cov_1.615894	205	269	24	2	64	0.0312500
NODE_76978_length_401_cov_1.615894	205	269	25	1	64	0.0156250
NODE_76978_length_401_cov_1.615894	205	269	29	1	64	0.0156250
NODE_76978_length_401_cov_1.615894	205	269	35	1	64	0.0156250
NODE_76978_length_401_cov_1.615894	205	269	37	1	64	0.0156250
NODE_76978_length_401_cov_1.615894	205	269	39	1	64	0.0156250
NODE_76978_length_401_cov_1.615894	205	269	48	1	64	0.0156250
NODE_76978_length_401_cov_1.615894	205	269	54	1	64	0.0156250
NODE_76978_length_401_cov_1.615894	205	269	60	2	64	0.0312500
NODE_76978_length_401_cov_1.615894	205	269	63	1	64	0.0156250
NODE_76978_length_401_cov_1.615894	205	269	67	1	64	0.0156250
NODE_76978_length_401_cov_1.615894	205	269	73	2	64	0.0312500
NODE_76978_length_401_cov_1.615894	205	269	75	2	64	0.0312500
NODE_76978_length_401_cov_1.615894	205	269	83	1	64	0.0156250
NODE_76978_length_401_cov_1.615894	205	269	91	2	64	0.0312500
NODE_76978_length_401_cov_1.615894	205	269	93	2	64	0.0312500
NODE_76978_length_401_cov_1.615894	205	269	100	1	64	0.0156250
NODE_76978_length_401_cov_1.615894	205	269	104	1	64	0.0156250
NODE_76978_length_401_cov_1.615894	205	269	106	5	64	0.0781250
NODE_76978_length_401_cov_1.615894	205	269	108	1	64	0.0156250
NODE_76978_length_401_cov_1.615894	205	269	110	3	64	0.0468750
NODE_76978_length_401_cov_1.615894	205	269	112	4	64	0.0625000
NODE_76978_length_401_cov_1.615894	205	269	114	2	64	0.0312500
NODE_76978_length_401_cov_1.615894	205	269	118	2	64	0.0312500
NODE_76978_length_401_cov_1.615894	205	269	120	2	64	0.0312500
NODE_76978_length_401_cov_1.615894	205	269	122	2	64	0.0312500
NODE_76978_length_401_cov_1.615894	205	269	130	6	64	0.0937500
NODE_77017_length_401_cov_1.407285	23	92	0	35	69	0.5072464
NODE_77017_length_401_cov_1.407285	23	92	2	34	69	0.4927536
NODE_77017_length_401_cov_1.407285	76	122	2	42	46	0.9130435
NODE_77017_length_401_cov_1.407285	76	122	6	4	46	0.0869565
NODE_77236_length_401_cov_0.675497	292	372	0	80	80	1.0000000
NODE_77236_length_401_cov_0.675497	345	401	0	56	56	1.0000000
NODE_77284_length_400_cov_40.584718	205	281	0	76	76	1.0000000
NODE_77284_length_400_cov_40.584718	254	334	0	80	80	1.0000000
NODE_77289_length_400_cov_8.631229	307	372	0	45	65	0.6923077
NODE_77289_length_400_cov_8.631229	307	372	2	20	65	0.3076923
NODE_77292_length_400_cov_6.850498	281	329	0	35	48	0.7291667
NODE_77292_length_400_cov_6.850498	281	329	2	2	48	0.0416667
NODE_77292_length_400_cov_6.850498	281	329	15	1	48	0.0208333
NODE_77292_length_400_cov_6.850498	281	329	16	8	48	0.1666667
NODE_77292_length_400_cov_6.850498	281	329	17	2	48	0.0416667
NODE_77322_length_400_cov_4.000000	82	140	3	58	58	1.0000000
NODE_77358_length_400_cov_3.029900	204	284	0	80	80	1.0000000
NODE_77358_length_400_cov_3.029900	205	231	0	26	26	1.0000000
NODE_77362_length_400_cov_3.009967	146	220	7	14	74	0.1891892
NODE_77362_length_400_cov_3.009967	146	220	8	8	74	0.1081081
NODE_77362_length_400_cov_3.009967	146	220	9	14	74	0.1891892
NODE_77362_length_400_cov_3.009967	146	220	10	26	74	0.3513514
NODE_77362_length_400_cov_3.009967	146	220	11	9	74	0.1216216
NODE_77362_length_400_cov_3.009967	146	220	12	3	74	0.0405405
NODE_77362_length_400_cov_3.009967	195	261	7	6	66	0.0909091
NODE_77362_length_400_cov_3.009967	195	261	9	25	66	0.3787879
NODE_77362_length_400_cov_3.009967	195	261	10	15	66	0.2272727
NODE_77362_length_400_cov_3.009967	195	261	11	2	66	0.0303030
NODE_77362_length_400_cov_3.009967	195	261	12	7	66	0.1060606
NODE_77362_length_400_cov_3.009967	195	261	14	11	66	0.1666667
NODE_77363_length_400_cov_2.990033	253	332	30	5	79	0.0632911
NODE_77363_length_400_cov_2.990033	253	332	32	14	79	0.1772152
NODE_77363_length_400_cov_2.990033	253	332	34	30	79	0.3797468
NODE_77363_length_400_cov_2.990033	253	332	36	18	79	0.2278481
NODE_77363_length_400_cov_2.990033	253	332	40	12	79	0.1518987
NODE_77363_length_400_cov_2.990033	306	385	20	14	79	0.1772152
NODE_77363_length_400_cov_2.990033	306	385	21	4	79	0.0506329
NODE_77363_length_400_cov_2.990033	306	385	24	4	79	0.0506329
NODE_77363_length_400_cov_2.990033	306	385	25	11	79	0.1392405
NODE_77363_length_400_cov_2.990033	306	385	31	12	79	0.1518987
NODE_77363_length_400_cov_2.990033	306	385	34	14	79	0.1772152
NODE_77363_length_400_cov_2.990033	306	385	36	8	79	0.1012658
NODE_77363_length_400_cov_2.990033	306	385	40	12	79	0.1518987
NODE_77368_length_400_cov_2.860465	365	400	0	35	35	1.0000000
NODE_77371_length_400_cov_2.797342	324	372	4	48	48	1.0000000
NODE_77380_length_400_cov_2.581395	192	254	0	31	62	0.5000000
NODE_77380_length_400_cov_2.581395	192	254	2	31	62	0.5000000
NODE_77460_length_400_cov_1.940199	225	268	0	43	43	1.0000000
NODE_77460_length_400_cov_1.940199	293	374	6	9	81	0.1111111
NODE_77460_length_400_cov_1.940199	293	374	8	72	81	0.8888889
NODE_77821_length_399_cov_71.493333	215	295	0	80	80	1.0000000
NODE_77821_length_399_cov_71.493333	268	348	0	80	80	1.0000000
NODE_77823_length_399_cov_7.510000	229	309	0	80	80	1.0000000
NODE_77823_length_399_cov_7.510000	282	362	0	80	80	1.0000000
NODE_77825_length_399_cov_7.310000	125	187	0	62	62	1.0000000
NODE_77854_length_399_cov_4.293333	86	164	0	3	78	0.0384615
NODE_77854_length_399_cov_4.293333	86	164	2	75	78	0.9615384
NODE_77877_length_399_cov_3.406667	51	124	0	73	73	1.0000000
NODE_77933_length_399_cov_2.286667	310	390	0	80	80	1.0000000
NODE_77966_length_399_cov_1.916667	76	136	2	60	60	1.0000000
NODE_77966_length_399_cov_1.916667	123	189	2	66	66	1.0000000
NODE_78276_length_399_cov_0.710000	313	392	0	70	79	0.8860760
NODE_78276_length_399_cov_0.710000	313	392	2	9	79	0.1139240
NODE_78354_length_398_cov_9.688963	1	81	0	80	80	1.0000000
NODE_78354_length_398_cov_9.688963	247	327	0	80	80	1.0000000
NODE_78354_length_398_cov_9.688963	300	380	0	80	80	1.0000000
NODE_78360_length_398_cov_6.488294	130	210	2	80	80	1.0000000
NODE_78364_length_398_cov_5.765886	253	333	2	60	80	0.7500000
NODE_78364_length_398_cov_5.765886	253	333	4	20	80	0.2500000
NODE_78372_length_398_cov_5.244147	248	312	0	35	64	0.5468750
NODE_78372_length_398_cov_5.244147	248	312	2	29	64	0.4531250
NODE_78376_length_398_cov_5.006689	116	196	0	80	80	1.0000000
NODE_78376_length_398_cov_5.006689	169	251	0	82	82	1.0000000
NODE_78383_length_398_cov_4.284281	63	117	0	54	54	1.0000000
NODE_78383_length_398_cov_4.284281	135	160	0	25	25	1.0000000
NODE_78420_length_398_cov_2.993311	229	309	2	38	80	0.4750000
NODE_78420_length_398_cov_2.993311	229	309	4	42	80	0.5250000
NODE_78429_length_398_cov_2.822742	236	271	0	35	35	1.0000000
NODE_78891_length_397_cov_52.855705	124	204	0	80	80	1.0000000
NODE_78891_length_397_cov_52.855705	177	257	0	80	80	1.0000000
NODE_78894_length_397_cov_35.036913	173	253	0	36	80	0.4500000
NODE_78894_length_397_cov_35.036913	173	253	2	44	80	0.5500000
NODE_78895_length_397_cov_13.667785	94	174	0	80	80	1.0000000
NODE_78895_length_397_cov_13.667785	147	227	0	80	80	1.0000000
NODE_78897_length_397_cov_7.496644	192	272	0	80	80	1.0000000
NODE_78897_length_397_cov_7.496644	245	325	0	80	80	1.0000000
NODE_78898_length_397_cov_6.828859	127	173	0	46	46	1.0000000
NODE_78913_length_397_cov_4.902685	293	364	0	71	71	1.0000000
NODE_78933_length_397_cov_3.765101	164	244	0	80	80	1.0000000
NODE_78951_length_397_cov_3.325503	107	187	0	8	80	0.1000000
NODE_78951_length_397_cov_3.325503	107	187	4	55	80	0.6875000
NODE_78951_length_397_cov_3.325503	107	187	6	4	80	0.0500000
NODE_78951_length_397_cov_3.325503	107	187	12	13	80	0.1625000
NODE_78951_length_397_cov_3.325503	163	236	4	7	73	0.0958904
NODE_78951_length_397_cov_3.325503	163	236	6	4	73	0.0547945
NODE_78951_length_397_cov_3.325503	163	236	8	23	73	0.3150685
NODE_78951_length_397_cov_3.325503	163	236	12	39	73	0.5342466
NODE_78999_length_397_cov_2.530201	269	312	0	21	43	0.4883721
NODE_78999_length_397_cov_2.530201	269	312	2	22	43	0.5116279
NODE_79047_length_397_cov_1.959732	154	193	0	39	39	1.0000000
NODE_79072_length_397_cov_1.791946	218	283	0	24	65	0.3692308
NODE_79072_length_397_cov_1.791946	218	283	2	1	65	0.0153846
NODE_79072_length_397_cov_1.791946	218	283	4	8	65	0.1230769
NODE_79072_length_397_cov_1.791946	218	283	6	7	65	0.1076923
NODE_79072_length_397_cov_1.791946	218	283	7	3	65	0.0461538
NODE_79072_length_397_cov_1.791946	218	283	8	2	65	0.0307692
NODE_79072_length_397_cov_1.791946	218	283	10	20	65	0.3076923
NODE_79127_length_397_cov_1.560403	183	240	0	57	57	1.0000000
NODE_79456_length_396_cov_11.632997	162	242	0	80	80	1.0000000
NODE_79456_length_396_cov_11.632997	215	295	0	80	80	1.0000000
NODE_79460_length_396_cov_7.053872	71	101	0	30	30	1.0000000
NODE_79464_length_396_cov_6.097643	229	309	0	80	80	1.0000000
NODE_79464_length_396_cov_6.097643	282	362	0	80	80	1.0000000
NODE_79471_length_396_cov_5.484848	125	205	0	14	80	0.1750000
NODE_79471_length_396_cov_5.484848	125	205	12	66	80	0.8250000
NODE_79471_length_396_cov_5.484848	178	259	0	19	81	0.2345679
NODE_79471_length_396_cov_5.484848	178	259	10	1	81	0.0123457
NODE_79471_length_396_cov_5.484848	178	259	11	1	81	0.0123457
NODE_79471_length_396_cov_5.484848	178	259	12	60	81	0.7407407
NODE_79473_length_396_cov_5.434343	224	275	0	51	51	1.0000000
NODE_79473_length_396_cov_5.434343	272	331	0	59	59	1.0000000
NODE_79483_length_396_cov_4.414141	189	264	0	19	75	0.2533333
NODE_79483_length_396_cov_4.414141	189	264	2	56	75	0.7466667
NODE_79483_length_396_cov_4.414141	241	317	0	72	76	0.9473684
NODE_79483_length_396_cov_4.414141	241	317	2	4	76	0.0526316
NODE_79493_length_396_cov_4.010101	163	205	0	42	42	1.0000000
NODE_79522_length_396_cov_3.080808	95	161	0	66	66	1.0000000
NODE_79524_length_396_cov_3.067340	252	316	0	64	64	1.0000000
NODE_79535_length_396_cov_2.892256	136	217	0	37	81	0.4567901
NODE_79535_length_396_cov_2.892256	136	217	2	44	81	0.5432099
NODE_79557_length_396_cov_2.710438	88	168	1	16	80	0.2000000
NODE_79557_length_396_cov_2.710438	88	168	3	8	80	0.1000000
NODE_79557_length_396_cov_2.710438	88	168	5	3	80	0.0375000
NODE_79557_length_396_cov_2.710438	88	168	6	2	80	0.0250000
NODE_79557_length_396_cov_2.710438	88	168	8	5	80	0.0625000
NODE_79557_length_396_cov_2.710438	88	168	10	1	80	0.0125000
NODE_79557_length_396_cov_2.710438	88	168	18	3	80	0.0375000
NODE_79557_length_396_cov_2.710438	88	168	20	6	80	0.0750000
NODE_79557_length_396_cov_2.710438	88	168	22	2	80	0.0250000
NODE_79557_length_396_cov_2.710438	88	168	24	34	80	0.4250000
NODE_79561_length_396_cov_2.680135	297	335	0	38	38	1.0000000
NODE_79562_length_396_cov_2.659933	68	148	0	80	80	1.0000000
NODE_79562_length_396_cov_2.659933	121	168	0	47	47	1.0000000
NODE_79616_length_396_cov_2.060606	308	388	0	80	80	1.0000000
NODE_79643_length_396_cov_1.939394	63	142	0	15	79	0.1898734
NODE_79643_length_396_cov_1.939394	63	142	4	64	79	0.8101266
NODE_79643_length_396_cov_1.939394	115	164	4	49	49	1.0000000
NODE_79683_length_396_cov_1.811448	82	162	0	13	80	0.1625000
NODE_79683_length_396_cov_1.811448	82	162	2	67	80	0.8375000
NODE_79692_length_396_cov_1.734007	88	119	0	31	31	1.0000000
NODE_79930_length_396_cov_0.905724	101	151	11	22	50	0.4400000
NODE_79930_length_396_cov_0.905724	101	151	13	1	50	0.0200000
NODE_79930_length_396_cov_0.905724	101	151	16	4	50	0.0800000
NODE_79930_length_396_cov_0.905724	101	151	18	23	50	0.4600000
NODE_80057_length_395_cov_449.327703	0	79	50	1	79	0.0126582
NODE_80057_length_395_cov_449.327703	0	79	56	1	79	0.0126582
NODE_80057_length_395_cov_449.327703	0	79	64	1	79	0.0126582
NODE_80057_length_395_cov_449.327703	0	79	67	1	79	0.0126582
NODE_80057_length_395_cov_449.327703	0	79	70	1	79	0.0126582
NODE_80057_length_395_cov_449.327703	0	79	95	1	79	0.0126582
NODE_80057_length_395_cov_449.327703	0	79	102	1	79	0.0126582
NODE_80057_length_395_cov_449.327703	0	79	104	1	79	0.0126582
NODE_80057_length_395_cov_449.327703	0	79	105	1	79	0.0126582
NODE_80057_length_395_cov_449.327703	0	79	107	1	79	0.0126582
NODE_80057_length_395_cov_449.327703	0	79	109	1	79	0.0126582
NODE_80057_length_395_cov_449.327703	0	79	111	2	79	0.0253165
NODE_80057_length_395_cov_449.327703	0	79	115	1	79	0.0126582
NODE_80057_length_395_cov_449.327703	0	79	119	1	79	0.0126582
NODE_80057_length_395_cov_449.327703	0	79	121	1	79	0.0126582
NODE_80057_length_395_cov_449.327703	0	79	135	3	79	0.0379747
NODE_80057_length_395_cov_449.327703	0	79	140	1	79	0.0126582
NODE_80057_length_395_cov_449.327703	0	79	144	1	79	0.0126582
NODE_80057_length_395_cov_449.327703	0	79	165	1	79	0.0126582
NODE_80057_length_395_cov_449.327703	0	79	172	1	79	0.0126582
NODE_80057_length_395_cov_449.327703	0	79	176	1	79	0.0126582
NODE_80057_length_395_cov_449.327703	0	79	178	1	79	0.0126582
NODE_80057_length_395_cov_449.327703	0	79	188	2	79	0.0253165
NODE_80057_length_395_cov_449.327703	0	79	197	1	79	0.0126582
NODE_80057_length_395_cov_449.327703	0	79	198	1	79	0.0126582
NODE_80057_length_395_cov_449.327703	0	79	202	1	79	0.0126582
NODE_80057_length_395_cov_449.327703	0	79	210	1	79	0.0126582
NODE_80057_length_395_cov_449.327703	0	79	213	1	79	0.0126582
NODE_80057_length_395_cov_449.327703	0	79	214	1	79	0.0126582
NODE_80057_length_395_cov_449.327703	0	79	225	1	79	0.0126582
NODE_80057_length_395_cov_449.327703	0	79	226	1	79	0.0126582
NODE_80057_length_395_cov_449.327703	0	79	228	2	79	0.0253165
NODE_80057_length_395_cov_449.327703	0	79	237	1	79	0.0126582
NODE_80057_length_395_cov_449.327703	0	79	241	1	79	0.0126582
NODE_80057_length_395_cov_449.327703	0	79	248	1	79	0.0126582
NODE_80057_length_395_cov_449.327703	0	79	252	1	79	0.0126582
NODE_80057_length_395_cov_449.327703	0	79	257	2	79	0.0253165
NODE_80057_length_395_cov_449.327703	0	79	279	1	79	0.0126582
NODE_80057_length_395_cov_449.327703	0	79	283	1	79	0.0126582
NODE_80057_length_395_cov_449.327703	0	79	287	1	79	0.0126582
NODE_80057_length_395_cov_449.327703	0	79	295	1	79	0.0126582
NODE_80057_length_395_cov_449.327703	0	79	299	1	79	0.0126582
NODE_80057_length_395_cov_449.327703	0	79	303	2	79	0.0253165
NODE_80057_length_395_cov_449.327703	0	79	305	3	79	0.0379747
NODE_80057_length_395_cov_449.327703	0	79	313	2	79	0.0253165
NODE_80057_length_395_cov_449.327703	0	79	314	1	79	0.0126582
NODE_80057_length_395_cov_449.327703	0	79	316	1	79	0.0126582
NODE_80057_length_395_cov_449.327703	0	79	321	1	79	0.0126582
NODE_80057_length_395_cov_449.327703	0	79	324	2	79	0.0253165
NODE_80057_length_395_cov_449.327703	0	79	326	1	79	0.0126582
NODE_80057_length_395_cov_449.327703	0	79	331	2	79	0.0253165
NODE_80057_length_395_cov_449.327703	0	79	338	1	79	0.0126582
NODE_80057_length_395_cov_449.327703	0	79	339	1	79	0.0126582
NODE_80057_length_395_cov_449.327703	0	79	344	1	79	0.0126582
NODE_80057_length_395_cov_449.327703	0	79	348	5	79	0.0632911
NODE_80057_length_395_cov_449.327703	0	79	350	1	79	0.0126582
NODE_80057_length_395_cov_449.327703	0	79	354	1	79	0.0126582
NODE_80057_length_395_cov_449.327703	0	79	369	1	79	0.0126582
NODE_80057_length_395_cov_449.327703	0	79	377	1	79	0.0126582
NODE_80057_length_395_cov_449.327703	0	79	386	1	79	0.0126582
NODE_80057_length_395_cov_449.327703	0	79	389	3	79	0.0379747
NODE_80058_length_395_cov_13.695946	113	193	0	80	80	1.0000000
NODE_80058_length_395_cov_13.695946	166	246	0	80	80	1.0000000
NODE_80086_length_395_cov_4.179054	152	232	0	8	80	0.1000000
NODE_80086_length_395_cov_4.179054	152	232	2	17	80	0.2125000
NODE_80086_length_395_cov_4.179054	152	232	3	7	80	0.0875000
NODE_80086_length_395_cov_4.179054	152	232	4	48	80	0.6000000
NODE_80116_length_395_cov_2.962838	118	198	0	18	80	0.2250000
NODE_80116_length_395_cov_2.962838	118	198	2	62	80	0.7750000
NODE_80116_length_395_cov_2.962838	171	237	0	57	66	0.8636364
NODE_80116_length_395_cov_2.962838	171	237	2	9	66	0.1363636
NODE_80121_length_395_cov_2.878378	261	301	2	40	40	1.0000000
NODE_80139_length_395_cov_2.587838	111	188	0	75	77	0.9740260
NODE_80139_length_395_cov_2.587838	111	188	2	2	77	0.0259740
NODE_80139_length_395_cov_2.587838	232	301	0	54	69	0.7826087
NODE_80139_length_395_cov_2.587838	232	301	2	15	69	0.2173913
NODE_80139_length_395_cov_2.587838	258	302	0	44	44	1.0000000
NODE_80141_length_395_cov_2.560811	123	187	0	64	64	1.0000000
NODE_80146_length_395_cov_2.527027	194	274	0	80	80	1.0000000
NODE_80146_length_395_cov_2.527027	247	327	0	80	80	1.0000000
NODE_80439_length_395_cov_1.033784	103	151	0	48	48	1.0000000
NODE_80448_length_395_cov_1.010135	85	105	0	20	20	1.0000000
NODE_80639_length_394_cov_9.464407	211	291	0	34	80	0.4250000
NODE_80639_length_394_cov_9.464407	211	291	4	46	80	0.5750000
NODE_80639_length_394_cov_9.464407	264	344	4	80	80	1.0000000
NODE_80643_length_394_cov_7.437288	221	301	22	80	80	1.0000000
NODE_80643_length_394_cov_7.437288	274	331	22	57	57	1.0000000
NODE_80647_length_394_cov_6.444068	187	267	0	80	80	1.0000000
NODE_80647_length_394_cov_6.444068	240	320	0	80	80	1.0000000
NODE_80709_length_394_cov_2.932203	119	140	0	21	21	1.0000000
NODE_80710_length_394_cov_2.894915	79	135	0	56	56	1.0000000
NODE_80710_length_394_cov_2.894915	166	202	0	36	36	1.0000000
NODE_81216_length_393_cov_4.261905	201	267	0	66	66	1.0000000
NODE_81216_length_393_cov_4.261905	240	282	0	42	42	1.0000000
NODE_81240_length_393_cov_3.503401	121	201	0	80	80	1.0000000
NODE_81240_length_393_cov_3.503401	174	246	0	72	72	1.0000000
NODE_81277_length_393_cov_2.704082	198	271	0	73	73	1.0000000
NODE_81289_length_393_cov_2.493197	136	216	0	80	80	1.0000000
NODE_81289_length_393_cov_2.493197	189	269	0	80	80	1.0000000
NODE_81296_length_393_cov_2.360544	195	252	2	57	57	1.0000000
NODE_81416_length_393_cov_1.608844	207	270	0	63	63	1.0000000
NODE_81778_length_392_cov_7.873720	161	241	0	80	80	1.0000000
NODE_81778_length_392_cov_7.873720	214	294	0	80	80	1.0000000
NODE_81790_length_392_cov_5.262799	218	248	0	30	30	1.0000000
NODE_81805_length_392_cov_3.655290	109	157	0	48	48	1.0000000
NODE_81805_length_392_cov_3.655290	306	386	0	80	80	1.0000000
NODE_81823_length_392_cov_3.197952	102	171	0	11	69	0.1594203
NODE_81823_length_392_cov_3.197952	102	171	2	7	69	0.1014493
NODE_81823_length_392_cov_3.197952	102	171	4	51	69	0.7391304
NODE_81823_length_392_cov_3.197952	233	314	0	50	81	0.6172839
NODE_81823_length_392_cov_3.197952	233	314	2	31	81	0.3827161
NODE_81857_length_392_cov_2.511945	67	133	62	1	66	0.0151515
NODE_81857_length_392_cov_2.511945	67	133	63	1	66	0.0151515
NODE_81857_length_392_cov_2.511945	67	133	65	1	66	0.0151515
NODE_81857_length_392_cov_2.511945	67	133	66	1	66	0.0151515
NODE_81857_length_392_cov_2.511945	67	133	68	1	66	0.0151515
NODE_81857_length_392_cov_2.511945	67	133	69	1	66	0.0151515
NODE_81857_length_392_cov_2.511945	67	133	77	1	66	0.0151515
NODE_81857_length_392_cov_2.511945	67	133	79	5	66	0.0757576
NODE_81857_length_392_cov_2.511945	67	133	81	1	66	0.0151515
NODE_81857_length_392_cov_2.511945	67	133	86	1	66	0.0151515
NODE_81857_length_392_cov_2.511945	67	133	88	1	66	0.0151515
NODE_81857_length_392_cov_2.511945	67	133	89	3	66	0.0454545
NODE_81857_length_392_cov_2.511945	67	133	91	1	66	0.0151515
NODE_81857_length_392_cov_2.511945	67	133	95	2	66	0.0303030
NODE_81857_length_392_cov_2.511945	67	133	97	3	66	0.0454545
NODE_81857_length_392_cov_2.511945	67	133	101	1	66	0.0151515
NODE_81857_length_392_cov_2.511945	67	133	102	1	66	0.0151515
NODE_81857_length_392_cov_2.511945	67	133	103	2	66	0.0303030
NODE_81857_length_392_cov_2.511945	67	133	104	1	66	0.0151515
NODE_81857_length_392_cov_2.511945	67	133	106	1	66	0.0151515
NODE_81857_length_392_cov_2.511945	67	133	107	2	66	0.0303030
NODE_81857_length_392_cov_2.511945	67	133	108	4	66	0.0606061
NODE_81857_length_392_cov_2.511945	67	133	109	3	66	0.0454545
NODE_81857_length_392_cov_2.511945	67	133	115	3	66	0.0454545
NODE_81857_length_392_cov_2.511945	67	133	117	4	66	0.0606061
NODE_81857_length_392_cov_2.511945	67	133	119	1	66	0.0151515
NODE_81857_length_392_cov_2.511945	67	133	120	2	66	0.0303030
NODE_81857_length_392_cov_2.511945	67	133	125	1	66	0.0151515
NODE_81857_length_392_cov_2.511945	67	133	127	4	66	0.0606061
NODE_81857_length_392_cov_2.511945	67	133	131	2	66	0.0303030
NODE_81857_length_392_cov_2.511945	67	133	133	2	66	0.0303030
NODE_81857_length_392_cov_2.511945	67	133	134	2	66	0.0303030
NODE_81857_length_392_cov_2.511945	67	133	136	2	66	0.0303030
NODE_81857_length_392_cov_2.511945	67	133	137	2	66	0.0303030
NODE_81857_length_392_cov_2.511945	67	133	143	2	66	0.0303030
NODE_81857_length_392_cov_2.511945	120	206	101	1	86	0.0116279
NODE_81857_length_392_cov_2.511945	120	206	104	10	86	0.1162791
NODE_81857_length_392_cov_2.511945	120	206	105	2	86	0.0232558
NODE_81857_length_392_cov_2.511945	120	206	106	3	86	0.0348837
NODE_81857_length_392_cov_2.511945	120	206	107	5	86	0.0581395
NODE_81857_length_392_cov_2.511945	120	206	109	1	86	0.0116279
NODE_81857_length_392_cov_2.511945	120	206	111	2	86	0.0232558
NODE_81857_length_392_cov_2.511945	120	206	115	1	86	0.0116279
NODE_81857_length_392_cov_2.511945	120	206	121	4	86	0.0465116
NODE_81857_length_392_cov_2.511945	120	206	124	1	86	0.0116279
NODE_81857_length_392_cov_2.511945	120	206	127	1	86	0.0116279
NODE_81857_length_392_cov_2.511945	120	206	130	3	86	0.0348837
NODE_81857_length_392_cov_2.511945	120	206	131	2	86	0.0232558
NODE_81857_length_392_cov_2.511945	120	206	132	2	86	0.0232558
NODE_81857_length_392_cov_2.511945	120	206	133	2	86	0.0232558
NODE_81857_length_392_cov_2.511945	120	206	134	2	86	0.0232558
NODE_81857_length_392_cov_2.511945	120	206	136	3	86	0.0348837
NODE_81857_length_392_cov_2.511945	120	206	137	4	86	0.0465116
NODE_81857_length_392_cov_2.511945	120	206	139	1	86	0.0116279
NODE_81857_length_392_cov_2.511945	120	206	140	2	86	0.0232558
NODE_81857_length_392_cov_2.511945	120	206	143	2	86	0.0232558
NODE_81857_length_392_cov_2.511945	120	206	144	1	86	0.0116279
NODE_81857_length_392_cov_2.511945	120	206	146	2	86	0.0232558
NODE_81857_length_392_cov_2.511945	120	206	148	4	86	0.0465116
NODE_81857_length_392_cov_2.511945	120	206	150	5	86	0.0581395
NODE_81857_length_392_cov_2.511945	120	206	152	2	86	0.0232558
NODE_81857_length_392_cov_2.511945	120	206	154	11	86	0.1279070
NODE_81857_length_392_cov_2.511945	120	206	155	5	86	0.0581395
NODE_81857_length_392_cov_2.511945	120	206	156	1	86	0.0116279
NODE_81857_length_392_cov_2.511945	120	206	162	1	86	0.0116279
NODE_81914_length_392_cov_2.075085	268	349	8	39	81	0.4814815
NODE_81914_length_392_cov_2.075085	268	349	10	42	81	0.5185185
NODE_81914_length_392_cov_2.075085	322	387	2	3	65	0.0461538
NODE_81914_length_392_cov_2.075085	322	387	4	25	65	0.3846154
NODE_81914_length_392_cov_2.075085	322	387	8	11	65	0.1692308
NODE_81914_length_392_cov_2.075085	322	387	10	26	65	0.4000000
NODE_81928_length_392_cov_1.955631	11	56	0	45	45	1.0000000
NODE_81929_length_392_cov_1.952218	40	59	0	19	19	1.0000000
NODE_81940_length_392_cov_1.911263	238	315	0	77	77	1.0000000
NODE_81994_length_392_cov_1.631399	114	139	17	1	25	0.0400000
NODE_81994_length_392_cov_1.631399	114	139	22	1	25	0.0400000
NODE_81994_length_392_cov_1.631399	114	139	24	2	25	0.0800000
NODE_81994_length_392_cov_1.631399	114	139	26	2	25	0.0800000
NODE_81994_length_392_cov_1.631399	114	139	28	2	25	0.0800000
NODE_81994_length_392_cov_1.631399	114	139	30	3	25	0.1200000
NODE_81994_length_392_cov_1.631399	114	139	32	2	25	0.0800000
NODE_81994_length_392_cov_1.631399	114	139	34	1	25	0.0400000
NODE_81994_length_392_cov_1.631399	114	139	36	9	25	0.3600000
NODE_81994_length_392_cov_1.631399	114	139	38	2	25	0.0800000
NODE_82008_length_392_cov_1.559727	83	163	0	10	80	0.1250000
NODE_82008_length_392_cov_1.559727	83	163	2	3	80	0.0375000
NODE_82008_length_392_cov_1.559727	83	163	4	67	80	0.8375000
NODE_82015_length_392_cov_1.552901	32	52	0	20	20	1.0000000
NODE_82390_length_391_cov_69.510274	9	89	53	1	80	0.0125000
NODE_82390_length_391_cov_69.510274	9	89	55	1	80	0.0125000
NODE_82390_length_391_cov_69.510274	9	89	61	1	80	0.0125000
NODE_82390_length_391_cov_69.510274	9	89	63	1	80	0.0125000
NODE_82390_length_391_cov_69.510274	9	89	78	2	80	0.0250000
NODE_82390_length_391_cov_69.510274	9	89	86	1	80	0.0125000
NODE_82390_length_391_cov_69.510274	9	89	90	3	80	0.0375000
NODE_82390_length_391_cov_69.510274	9	89	94	1	80	0.0125000
NODE_82390_length_391_cov_69.510274	9	89	102	2	80	0.0250000
NODE_82390_length_391_cov_69.510274	9	89	104	1	80	0.0125000
NODE_82390_length_391_cov_69.510274	9	89	112	3	80	0.0375000
NODE_82390_length_391_cov_69.510274	9	89	121	2	80	0.0250000
NODE_82390_length_391_cov_69.510274	9	89	124	1	80	0.0125000
NODE_82390_length_391_cov_69.510274	9	89	126	2	80	0.0250000
NODE_82390_length_391_cov_69.510274	9	89	128	1	80	0.0125000
NODE_82390_length_391_cov_69.510274	9	89	131	1	80	0.0125000
NODE_82390_length_391_cov_69.510274	9	89	133	2	80	0.0250000
NODE_82390_length_391_cov_69.510274	9	89	139	2	80	0.0250000
NODE_82390_length_391_cov_69.510274	9	89	145	2	80	0.0250000
NODE_82390_length_391_cov_69.510274	9	89	150	1	80	0.0125000
NODE_82390_length_391_cov_69.510274	9	89	153	1	80	0.0125000
NODE_82390_length_391_cov_69.510274	9	89	155	1	80	0.0125000
NODE_82390_length_391_cov_69.510274	9	89	157	1	80	0.0125000
NODE_82390_length_391_cov_69.510274	9	89	159	1	80	0.0125000
NODE_82390_length_391_cov_69.510274	9	89	160	1	80	0.0125000
NODE_82390_length_391_cov_69.510274	9	89	164	2	80	0.0250000
NODE_82390_length_391_cov_69.510274	9	89	168	1	80	0.0125000
NODE_82390_length_391_cov_69.510274	9	89	169	1	80	0.0125000
NODE_82390_length_391_cov_69.510274	9	89	174	1	80	0.0125000
NODE_82390_length_391_cov_69.510274	9	89	175	1	80	0.0125000
NODE_82390_length_391_cov_69.510274	9	89	180	2	80	0.0250000
NODE_82390_length_391_cov_69.510274	9	89	184	1	80	0.0125000
NODE_82390_length_391_cov_69.510274	9	89	185	1	80	0.0125000
NODE_82390_length_391_cov_69.510274	9	89	189	2	80	0.0250000
NODE_82390_length_391_cov_69.510274	9	89	192	1	80	0.0125000
NODE_82390_length_391_cov_69.510274	9	89	196	3	80	0.0375000
NODE_82390_length_391_cov_69.510274	9	89	198	2	80	0.0250000
NODE_82390_length_391_cov_69.510274	9	89	204	1	80	0.0125000
NODE_82390_length_391_cov_69.510274	9	89	206	1	80	0.0125000
NODE_82390_length_391_cov_69.510274	9	89	208	1	80	0.0125000
NODE_82390_length_391_cov_69.510274	9	89	212	1	80	0.0125000
NODE_82390_length_391_cov_69.510274	9	89	216	1	80	0.0125000
NODE_82390_length_391_cov_69.510274	9	89	219	1	80	0.0125000
NODE_82390_length_391_cov_69.510274	9	89	225	1	80	0.0125000
NODE_82390_length_391_cov_69.510274	9	89	229	3	80	0.0375000
NODE_82390_length_391_cov_69.510274	9	89	232	2	80	0.0250000
NODE_82390_length_391_cov_69.510274	9	89	233	1	80	0.0125000
NODE_82390_length_391_cov_69.510274	9	89	235	1	80	0.0125000
NODE_82390_length_391_cov_69.510274	9	89	237	2	80	0.0250000
NODE_82390_length_391_cov_69.510274	9	89	239	1	80	0.0125000
NODE_82390_length_391_cov_69.510274	9	89	245	2	80	0.0250000
NODE_82390_length_391_cov_69.510274	9	89	247	2	80	0.0250000
NODE_82390_length_391_cov_69.510274	9	89	249	1	80	0.0125000
NODE_82390_length_391_cov_69.510274	9	89	259	2	80	0.0250000
NODE_82390_length_391_cov_69.510274	9	89	261	2	80	0.0250000
NODE_82391_length_391_cov_39.414384	0	66	0	3	66	0.0454545
NODE_82391_length_391_cov_39.414384	0	66	2	9	66	0.1363636
NODE_82391_length_391_cov_39.414384	0	66	4	1	66	0.0151515
NODE_82391_length_391_cov_39.414384	0	66	10	26	66	0.3939394
NODE_82391_length_391_cov_39.414384	0	66	12	27	66	0.4090909
NODE_82391_length_391_cov_39.414384	0	71	0	3	71	0.0422535
NODE_82391_length_391_cov_39.414384	0	71	2	9	71	0.1267606
NODE_82391_length_391_cov_39.414384	0	71	4	1	71	0.0140845
NODE_82391_length_391_cov_39.414384	0	71	10	26	71	0.3661972
NODE_82391_length_391_cov_39.414384	0	71	12	32	71	0.4507042
NODE_82391_length_391_cov_39.414384	44	124	2	4	80	0.0500000
NODE_82391_length_391_cov_39.414384	44	124	4	11	80	0.1375000
NODE_82391_length_391_cov_39.414384	44	124	6	2	80	0.0250000
NODE_82391_length_391_cov_39.414384	44	124	12	63	80	0.7875000
NODE_82394_length_391_cov_10.352740	156	235	0	79	79	1.0000000
NODE_82415_length_391_cov_5.030822	85	166	12	4	81	0.0493827
NODE_82415_length_391_cov_5.030822	85	166	14	8	81	0.0987654
NODE_82415_length_391_cov_5.030822	85	166	16	3	81	0.0370370
NODE_82415_length_391_cov_5.030822	85	166	18	8	81	0.0987654
NODE_82415_length_391_cov_5.030822	85	166	20	58	81	0.7160494
NODE_82498_length_391_cov_2.660959	267	343	2	64	76	0.8421053
NODE_82498_length_391_cov_2.660959	267	343	4	12	76	0.1578947
NODE_82552_length_391_cov_2.089041	176	256	0	80	80	1.0000000
NODE_82552_length_391_cov_2.089041	229	280	0	51	51	1.0000000
NODE_82574_length_391_cov_1.907534	200	257	0	57	57	1.0000000
NODE_82597_length_391_cov_1.773973	160	190	2	30	30	1.0000000
NODE_82632_length_391_cov_1.647260	298	378	2	2	80	0.0250000
NODE_82632_length_391_cov_1.647260	298	378	4	14	80	0.1750000
NODE_82632_length_391_cov_1.647260	298	378	8	17	80	0.2125000
NODE_82632_length_391_cov_1.647260	298	378	10	33	80	0.4125000
NODE_82632_length_391_cov_1.647260	298	378	12	14	80	0.1750000
NODE_82662_length_391_cov_1.561644	241	261	0	20	20	1.0000000
NODE_83015_length_390_cov_29.030928	86	166	0	80	80	1.0000000
NODE_83015_length_390_cov_29.030928	139	219	0	80	80	1.0000000
NODE_83016_length_390_cov_22.319588	118	198	0	80	80	1.0000000
NODE_83016_length_390_cov_22.319588	171	251	0	80	80	1.0000000
NODE_83044_length_390_cov_4.481100	208	277	0	69	69	1.0000000
NODE_83044_length_390_cov_4.481100	286	327	0	3	41	0.0731707
NODE_83044_length_390_cov_4.481100	286	327	2	38	41	0.9268293
NODE_83045_length_390_cov_4.481100	93	171	0	78	78	1.0000000
NODE_83045_length_390_cov_4.481100	144	210	0	66	66	1.0000000
NODE_83060_length_390_cov_3.814433	66	99	0	33	33	1.0000000
NODE_83061_length_390_cov_3.783505	188	268	0	80	80	1.0000000
NODE_83061_length_390_cov_3.783505	241	321	0	80	80	1.0000000
NODE_83066_length_390_cov_3.560137	304	367	4	7	63	0.1111111
NODE_83066_length_390_cov_3.560137	304	367	6	56	63	0.8888889
NODE_83066_length_390_cov_3.560137	340	381	0	3	41	0.0731707
NODE_83066_length_390_cov_3.560137	340	381	4	18	41	0.4390244
NODE_83066_length_390_cov_3.560137	340	381	6	20	41	0.4878049
NODE_83169_length_390_cov_2.127148	242	322	0	4	80	0.0500000
NODE_83169_length_390_cov_2.127148	242	322	2	22	80	0.2750000
NODE_83169_length_390_cov_2.127148	242	322	4	54	80	0.6750000
NODE_83171_length_390_cov_2.123711	133	177	0	6	44	0.1363636
NODE_83171_length_390_cov_2.123711	133	177	1	6	44	0.1363636
NODE_83171_length_390_cov_2.123711	133	177	5	26	44	0.5909091
NODE_83171_length_390_cov_2.123711	133	177	7	6	44	0.1363636
NODE_83171_length_390_cov_2.123711	157	237	5	14	80	0.1750000
NODE_83171_length_390_cov_2.123711	157	237	7	15	80	0.1875000
NODE_83171_length_390_cov_2.123711	157	237	9	5	80	0.0625000
NODE_83171_length_390_cov_2.123711	157	237	10	46	80	0.5750000
NODE_83288_length_390_cov_1.536082	223	276	0	53	53	1.0000000
NODE_83338_length_390_cov_1.398625	49	110	23	1	61	0.0163934
NODE_83338_length_390_cov_1.398625	49	110	27	1	61	0.0163934
NODE_83338_length_390_cov_1.398625	49	110	30	1	61	0.0163934
NODE_83338_length_390_cov_1.398625	49	110	35	2	61	0.0327869
NODE_83338_length_390_cov_1.398625	49	110	37	2	61	0.0327869
NODE_83338_length_390_cov_1.398625	49	110	39	2	61	0.0327869
NODE_83338_length_390_cov_1.398625	49	110	41	4	61	0.0655738
NODE_83338_length_390_cov_1.398625	49	110	45	6	61	0.0983607
NODE_83338_length_390_cov_1.398625	49	110	47	1	61	0.0163934
NODE_83338_length_390_cov_1.398625	49	110	49	2	61	0.0327869
NODE_83338_length_390_cov_1.398625	49	110	51	11	61	0.1803279
NODE_83338_length_390_cov_1.398625	49	110	53	1	61	0.0163934
NODE_83338_length_390_cov_1.398625	49	110	55	10	61	0.1639344
NODE_83338_length_390_cov_1.398625	49	110	57	4	61	0.0655738
NODE_83338_length_390_cov_1.398625	49	110	59	13	61	0.2131148
NODE_83463_length_390_cov_1.034364	78	158	0	80	80	1.0000000
NODE_83633_length_389_cov_63.710345	32	112	0	80	80	1.0000000
NODE_83633_length_389_cov_63.710345	85	165	0	80	80	1.0000000
NODE_83633_length_389_cov_63.710345	161	241	0	80	80	1.0000000
NODE_83633_length_389_cov_63.710345	214	294	0	80	80	1.0000000
NODE_83650_length_389_cov_5.382759	154	234	0	31	80	0.3875000
NODE_83650_length_389_cov_5.382759	154	234	2	49	80	0.6125000
NODE_83662_length_389_cov_4.468966	199	269	0	70	70	1.0000000
NODE_83663_length_389_cov_4.424138	68	148	72	5	80	0.0625000
NODE_83663_length_389_cov_4.424138	68	148	75	1	80	0.0125000
NODE_83663_length_389_cov_4.424138	68	148	76	1	80	0.0125000
NODE_83663_length_389_cov_4.424138	68	148	80	8	80	0.1000000
NODE_83663_length_389_cov_4.424138	68	148	81	1	80	0.0125000
NODE_83663_length_389_cov_4.424138	68	148	82	8	80	0.1000000
NODE_83663_length_389_cov_4.424138	68	148	84	13	80	0.1625000
NODE_83663_length_389_cov_4.424138	68	148	86	2	80	0.0250000
NODE_83663_length_389_cov_4.424138	68	148	88	4	80	0.0500000
NODE_83663_length_389_cov_4.424138	68	148	90	6	80	0.0750000
NODE_83663_length_389_cov_4.424138	68	148	92	14	80	0.1750000
NODE_83663_length_389_cov_4.424138	68	148	94	17	80	0.2125000
NODE_83685_length_389_cov_3.782759	194	225	0	31	31	1.0000000
NODE_83689_length_389_cov_3.555172	107	153	2	46	46	1.0000000
NODE_83695_length_389_cov_3.251724	120	163	0	42	43	0.9767442
NODE_83695_length_389_cov_3.251724	120	163	2	1	43	0.0232558
NODE_83695_length_389_cov_3.251724	136	206	0	70	70	1.0000000
NODE_83816_length_389_cov_1.951724	68	148	0	47	80	0.5875000
NODE_83816_length_389_cov_1.951724	68	148	2	33	80	0.4125000
NODE_83819_length_389_cov_1.937931	53	82	0	29	29	1.0000000
NODE_83819_length_389_cov_1.937931	153	233	6	1	80	0.0125000
NODE_83819_length_389_cov_1.937931	153	233	8	29	80	0.3625000
NODE_83819_length_389_cov_1.937931	153	233	14	50	80	0.6250000
NODE_83829_length_389_cov_1.920690	296	365	2	69	69	1.0000000
NODE_84182_length_389_cov_0.720690	294	374	0	31	80	0.3875000
NODE_84182_length_389_cov_0.720690	294	374	4	49	80	0.6125000
NODE_84267_length_388_cov_9.179931	47	127	0	80	80	1.0000000
NODE_84267_length_388_cov_9.179931	100	180	0	80	80	1.0000000
NODE_84270_length_388_cov_7.249135	171	251	0	80	80	1.0000000
NODE_84270_length_388_cov_7.249135	224	304	0	80	80	1.0000000
NODE_84305_length_388_cov_3.913495	151	231	4	63	80	0.7875000
NODE_84305_length_388_cov_3.913495	151	231	7	1	80	0.0125000
NODE_84305_length_388_cov_3.913495	151	231	8	16	80	0.2000000
NODE_84308_length_388_cov_3.809689	233	277	0	44	44	1.0000000
NODE_84332_length_388_cov_3.103806	101	166	0	65	65	1.0000000
NODE_84332_length_388_cov_3.103806	147	227	0	80	80	1.0000000
NODE_84334_length_388_cov_3.041522	48	128	0	80	80	1.0000000
NODE_84410_length_388_cov_2.114187	82	141	0	59	59	1.0000000
NODE_84410_length_388_cov_2.114187	135	194	0	59	59	1.0000000
NODE_84423_length_388_cov_2.017301	99	151	0	52	52	1.0000000
NODE_84427_length_388_cov_1.989619	0	76	0	76	76	1.0000000
NODE_84427_length_388_cov_1.989619	49	114	0	65	65	1.0000000
NODE_84587_length_388_cov_1.352941	172	247	0	18	75	0.2400000
NODE_84587_length_388_cov_1.352941	172	247	1	57	75	0.7600000
NODE_84631_length_388_cov_1.228374	308	339	0	31	31	1.0000000
NODE_84885_length_387_cov_33.052083	194	274	0	80	80	1.0000000
NODE_84885_length_387_cov_33.052083	247	327	0	80	80	1.0000000
NODE_84890_length_387_cov_6.871528	26	106	0	80	80	1.0000000
NODE_84890_length_387_cov_6.871528	79	159	0	80	80	1.0000000
NODE_84902_length_387_cov_5.420139	286	341	2	55	55	1.0000000
NODE_84946_length_387_cov_3.364583	287	367	0	80	80	1.0000000
NODE_85007_length_387_cov_2.260417	140	210	0	54	70	0.7714286
NODE_85007_length_387_cov_2.260417	140	210	2	16	70	0.2285714
NODE_85019_length_387_cov_2.128472	220	286	0	66	66	1.0000000
NODE_85019_length_387_cov_2.128472	273	329	0	56	56	1.0000000
NODE_85032_length_387_cov_2.090278	318	352	0	34	34	1.0000000
NODE_85037_length_387_cov_2.055556	23	45	0	22	22	1.0000000
NODE_85047_length_387_cov_1.979167	259	316	0	9	57	0.1578947
NODE_85047_length_387_cov_1.979167	259	316	2	48	57	0.8421053
NODE_85047_length_387_cov_1.979167	312	369	2	57	57	1.0000000
NODE_85091_length_387_cov_1.770833	315	361	0	18	46	0.3913043
NODE_85091_length_387_cov_1.770833	315	361	3	1	46	0.0217391
NODE_85091_length_387_cov_1.770833	315	361	6	3	46	0.0652174
NODE_85091_length_387_cov_1.770833	315	361	10	3	46	0.0652174
NODE_85091_length_387_cov_1.770833	315	361	11	4	46	0.0869565
NODE_85091_length_387_cov_1.770833	315	361	12	17	46	0.3695652
NODE_85528_length_386_cov_9.979094	38	118	0	80	80	1.0000000
NODE_85528_length_386_cov_9.979094	91	174	0	83	83	1.0000000
NODE_85546_length_386_cov_4.428571	197	249	6	52	52	1.0000000
NODE_85570_length_386_cov_3.355401	151	231	0	80	80	1.0000000
NODE_85570_length_386_cov_3.355401	204	265	0	61	61	1.0000000
NODE_85602_length_386_cov_2.686411	293	325	0	32	32	1.0000000
NODE_85602_length_386_cov_2.686411	349	379	0	30	30	1.0000000
NODE_85629_length_386_cov_2.442509	55	135	0	80	80	1.0000000
NODE_85629_length_386_cov_2.442509	108	164	0	56	56	1.0000000
NODE_85793_length_386_cov_1.494774	79	121	5	42	42	1.0000000
NODE_85793_length_386_cov_1.494774	93	156	4	7	63	0.1111111
NODE_85793_length_386_cov_1.494774	93	156	5	33	63	0.5238096
NODE_85793_length_386_cov_1.494774	93	156	8	23	63	0.3650794
NODE_85816_length_386_cov_1.421603	160	236	0	26	76	0.3421053
NODE_85816_length_386_cov_1.421603	160	236	2	6	76	0.0789474
NODE_85816_length_386_cov_1.421603	160	236	5	44	76	0.5789474
NODE_85845_length_386_cov_1.372822	62	142	0	54	80	0.6750000
NODE_85845_length_386_cov_1.372822	62	142	2	26	80	0.3250000
NODE_85845_length_386_cov_1.372822	115	195	0	1	80	0.0125000
NODE_85845_length_386_cov_1.372822	115	195	2	44	80	0.5500000
NODE_85845_length_386_cov_1.372822	115	195	4	35	80	0.4375000
NODE_85858_length_386_cov_1.317073	124	161	10	13	37	0.3513514
NODE_85858_length_386_cov_1.317073	124	161	12	1	37	0.0270270
NODE_85858_length_386_cov_1.317073	124	161	14	23	37	0.6216216
NODE_85902_length_386_cov_1.170732	260	308	5	1	48	0.0208333
NODE_85902_length_386_cov_1.170732	260	308	8	47	48	0.9791667
NODE_86143_length_385_cov_167.877622	103	164	192	1	61	0.0163934
NODE_86143_length_385_cov_167.877622	103	164	196	2	61	0.0327869
NODE_86143_length_385_cov_167.877622	103	164	197	1	61	0.0163934
NODE_86143_length_385_cov_167.877622	103	164	198	2	61	0.0327869
NODE_86143_length_385_cov_167.877622	103	164	199	4	61	0.0655738
NODE_86143_length_385_cov_167.877622	103	164	200	3	61	0.0491803
NODE_86143_length_385_cov_167.877622	103	164	201	1	61	0.0163934
NODE_86143_length_385_cov_167.877622	103	164	202	3	61	0.0491803
NODE_86143_length_385_cov_167.877622	103	164	208	1	61	0.0163934
NODE_86143_length_385_cov_167.877622	103	164	210	1	61	0.0163934
NODE_86143_length_385_cov_167.877622	103	164	212	1	61	0.0163934
NODE_86143_length_385_cov_167.877622	103	164	221	1	61	0.0163934
NODE_86143_length_385_cov_167.877622	103	164	227	1	61	0.0163934
NODE_86143_length_385_cov_167.877622	103	164	231	1	61	0.0163934
NODE_86143_length_385_cov_167.877622	103	164	232	1	61	0.0163934
NODE_86143_length_385_cov_167.877622	103	164	233	3	61	0.0491803
NODE_86143_length_385_cov_167.877622	103	164	239	2	61	0.0327869
NODE_86143_length_385_cov_167.877622	103	164	240	1	61	0.0163934
NODE_86143_length_385_cov_167.877622	103	164	241	2	61	0.0327869
NODE_86143_length_385_cov_167.877622	103	164	243	1	61	0.0163934
NODE_86143_length_385_cov_167.877622	103	164	244	5	61	0.0819672
NODE_86143_length_385_cov_167.877622	103	164	245	1	61	0.0163934
NODE_86143_length_385_cov_167.877622	103	164	246	1	61	0.0163934
NODE_86143_length_385_cov_167.877622	103	164	247	1	61	0.0163934
NODE_86143_length_385_cov_167.877622	103	164	248	1	61	0.0163934
NODE_86143_length_385_cov_167.877622	103	164	249	5	61	0.0819672
NODE_86143_length_385_cov_167.877622	103	164	250	2	61	0.0327869
NODE_86143_length_385_cov_167.877622	103	164	251	3	61	0.0491803
NODE_86143_length_385_cov_167.877622	103	164	253	6	61	0.0983607
NODE_86143_length_385_cov_167.877622	103	164	254	1	61	0.0163934
NODE_86143_length_385_cov_167.877622	103	164	255	2	61	0.0327869
NODE_86144_length_385_cov_38.695804	164	244	0	80	80	1.0000000
NODE_86144_length_385_cov_38.695804	217	297	0	80	80	1.0000000
NODE_86169_length_385_cov_4.335664	173	250	0	47	77	0.6103896
NODE_86169_length_385_cov_4.335664	173	250	1	16	77	0.2077922
NODE_86169_length_385_cov_4.335664	173	250	2	14	77	0.1818182
NODE_86185_length_385_cov_3.793706	215	297	0	20	82	0.2439024
NODE_86185_length_385_cov_3.793706	215	297	2	17	82	0.2073171
NODE_86185_length_385_cov_3.793706	215	297	4	45	82	0.5487805
NODE_86230_length_385_cov_2.786713	99	179	2	32	80	0.4000000
NODE_86230_length_385_cov_2.786713	99	179	4	4	80	0.0500000
NODE_86230_length_385_cov_2.786713	99	179	6	44	80	0.5500000
NODE_86230_length_385_cov_2.786713	152	232	0	33	80	0.4125000
NODE_86230_length_385_cov_2.786713	152	232	2	47	80	0.5875000
NODE_86230_length_385_cov_2.786713	281	362	0	81	81	1.0000000
NODE_86448_length_385_cov_1.381119	71	145	0	27	74	0.3648649
NODE_86448_length_385_cov_1.381119	71	145	1	5	74	0.0675676
NODE_86448_length_385_cov_1.381119	71	145	2	12	74	0.1621622
NODE_86448_length_385_cov_1.381119	71	145	6	8	74	0.1081081
NODE_86448_length_385_cov_1.381119	71	145	10	4	74	0.0540541
NODE_86448_length_385_cov_1.381119	71	145	11	3	74	0.0405405
NODE_86448_length_385_cov_1.381119	71	145	13	5	74	0.0675676
NODE_86448_length_385_cov_1.381119	71	145	21	7	74	0.0945946
NODE_86448_length_385_cov_1.381119	71	145	23	3	74	0.0405405
NODE_86448_length_385_cov_1.381119	118	198	6	5	80	0.0625000
NODE_86448_length_385_cov_1.381119	118	198	10	4	80	0.0500000
NODE_86448_length_385_cov_1.381119	118	198	11	3	80	0.0375000
NODE_86448_length_385_cov_1.381119	118	198	13	5	80	0.0625000
NODE_86448_length_385_cov_1.381119	118	198	21	7	80	0.0875000
NODE_86448_length_385_cov_1.381119	118	198	23	16	80	0.2000000
NODE_86448_length_385_cov_1.381119	118	198	24	6	80	0.0750000
NODE_86448_length_385_cov_1.381119	118	198	25	4	80	0.0500000
NODE_86448_length_385_cov_1.381119	118	198	26	5	80	0.0625000
NODE_86448_length_385_cov_1.381119	118	198	28	7	80	0.0875000
NODE_86448_length_385_cov_1.381119	118	198	29	1	80	0.0125000
NODE_86448_length_385_cov_1.381119	118	198	30	6	80	0.0750000
NODE_86448_length_385_cov_1.381119	118	198	34	11	80	0.1375000
NODE_86798_length_384_cov_3.996491	135	217	0	82	82	1.0000000
NODE_86809_length_384_cov_3.729825	181	228	0	25	47	0.5319149
NODE_86809_length_384_cov_3.729825	181	228	2	22	47	0.4680851
NODE_86812_length_384_cov_3.715789	145	221	0	70	76	0.9210526
NODE_86812_length_384_cov_3.715789	145	221	2	6	76	0.0789474
NODE_86841_length_384_cov_2.996491	147	227	2	30	80	0.3750000
NODE_86841_length_384_cov_2.996491	147	227	4	8	80	0.1000000
NODE_86841_length_384_cov_2.996491	147	227	8	9	80	0.1125000
NODE_86841_length_384_cov_2.996491	147	227	10	4	80	0.0500000
NODE_86841_length_384_cov_2.996491	147	227	12	17	80	0.2125000
NODE_86841_length_384_cov_2.996491	147	227	14	12	80	0.1500000
NODE_86847_length_384_cov_2.835088	65	145	2	66	80	0.8250000
NODE_86847_length_384_cov_2.835088	65	145	4	14	80	0.1750000
NODE_86866_length_384_cov_2.575439	151	224	8	2	73	0.0273973
NODE_86866_length_384_cov_2.575439	151	224	10	8	73	0.1095890
NODE_86866_length_384_cov_2.575439	151	224	12	6	73	0.0821918
NODE_86866_length_384_cov_2.575439	151	224	14	57	73	0.7808219
NODE_86866_length_384_cov_2.575439	197	281	0	17	84	0.2023810
NODE_86866_length_384_cov_2.575439	197	281	2	3	84	0.0357143
NODE_86866_length_384_cov_2.575439	197	281	6	35	84	0.4166667
NODE_86866_length_384_cov_2.575439	197	281	8	4	84	0.0476190
NODE_86866_length_384_cov_2.575439	197	281	10	8	84	0.0952381
NODE_86866_length_384_cov_2.575439	197	281	12	5	84	0.0595238
NODE_86866_length_384_cov_2.575439	197	281	14	12	84	0.1428571
NODE_86907_length_384_cov_2.231579	78	153	0	75	75	1.0000000
NODE_86942_length_384_cov_1.940351	73	153	0	6	80	0.0750000
NODE_86942_length_384_cov_1.940351	73	153	2	74	80	0.9250000
NODE_87431_length_383_cov_4.869718	117	197	0	80	80	1.0000000
NODE_87431_length_383_cov_4.869718	170	250	0	80	80	1.0000000
NODE_87432_length_383_cov_4.841549	121	180	0	1	59	0.0169492
NODE_87432_length_383_cov_4.841549	121	180	2	58	59	0.9830508
NODE_87438_length_383_cov_4.559859	33	109	0	76	76	1.0000000
NODE_87487_length_383_cov_2.940141	185	265	2	21	80	0.2625000
NODE_87487_length_383_cov_2.940141	185	265	4	31	80	0.3875000
NODE_87487_length_383_cov_2.940141	185	265	7	28	80	0.3500000
NODE_87495_length_383_cov_2.760563	123	203	120	2	80	0.0250000
NODE_87495_length_383_cov_2.760563	123	203	122	5	80	0.0625000
NODE_87495_length_383_cov_2.760563	123	203	128	2	80	0.0250000
NODE_87495_length_383_cov_2.760563	123	203	130	1	80	0.0125000
NODE_87495_length_383_cov_2.760563	123	203	132	5	80	0.0625000
NODE_87495_length_383_cov_2.760563	123	203	134	1	80	0.0125000
NODE_87495_length_383_cov_2.760563	123	203	137	1	80	0.0125000
NODE_87495_length_383_cov_2.760563	123	203	160	1	80	0.0125000
NODE_87495_length_383_cov_2.760563	123	203	162	1	80	0.0125000
NODE_87495_length_383_cov_2.760563	123	203	166	2	80	0.0250000
NODE_87495_length_383_cov_2.760563	123	203	170	2	80	0.0250000
NODE_87495_length_383_cov_2.760563	123	203	172	1	80	0.0125000
NODE_87495_length_383_cov_2.760563	123	203	173	1	80	0.0125000
NODE_87495_length_383_cov_2.760563	123	203	175	1	80	0.0125000
NODE_87495_length_383_cov_2.760563	123	203	183	1	80	0.0125000
NODE_87495_length_383_cov_2.760563	123	203	185	2	80	0.0250000
NODE_87495_length_383_cov_2.760563	123	203	187	1	80	0.0125000
NODE_87495_length_383_cov_2.760563	123	203	195	2	80	0.0250000
NODE_87495_length_383_cov_2.760563	123	203	197	1	80	0.0125000
NODE_87495_length_383_cov_2.760563	123	203	199	2	80	0.0250000
NODE_87495_length_383_cov_2.760563	123	203	201	1	80	0.0125000
NODE_87495_length_383_cov_2.760563	123	203	202	3	80	0.0375000
NODE_87495_length_383_cov_2.760563	123	203	203	1	80	0.0125000
NODE_87495_length_383_cov_2.760563	123	203	204	1	80	0.0125000
NODE_87495_length_383_cov_2.760563	123	203	205	4	80	0.0500000
NODE_87495_length_383_cov_2.760563	123	203	207	7	80	0.0875000
NODE_87495_length_383_cov_2.760563	123	203	208	2	80	0.0250000
NODE_87495_length_383_cov_2.760563	123	203	209	5	80	0.0625000
NODE_87495_length_383_cov_2.760563	123	203	210	2	80	0.0250000
NODE_87495_length_383_cov_2.760563	123	203	211	5	80	0.0625000
NODE_87495_length_383_cov_2.760563	123	203	212	3	80	0.0375000
NODE_87495_length_383_cov_2.760563	123	203	213	7	80	0.0875000
NODE_87495_length_383_cov_2.760563	123	203	215	4	80	0.0500000
NODE_87495_length_383_cov_2.760563	169	249	34	4	80	0.0500000
NODE_87495_length_383_cov_2.760563	169	249	40	1	80	0.0125000
NODE_87495_length_383_cov_2.760563	169	249	42	1	80	0.0125000
NODE_87495_length_383_cov_2.760563	169	249	44	2	80	0.0250000
NODE_87495_length_383_cov_2.760563	169	249	47	1	80	0.0125000
NODE_87495_length_383_cov_2.760563	169	249	49	6	80	0.0750000
NODE_87495_length_383_cov_2.760563	169	249	55	3	80	0.0375000
NODE_87495_length_383_cov_2.760563	169	249	56	1	80	0.0125000
NODE_87495_length_383_cov_2.760563	169	249	61	2	80	0.0250000
NODE_87495_length_383_cov_2.760563	169	249	62	1	80	0.0125000
NODE_87495_length_383_cov_2.760563	169	249	63	3	80	0.0375000
NODE_87495_length_383_cov_2.760563	169	249	69	4	80	0.0500000
NODE_87495_length_383_cov_2.760563	169	249	71	1	80	0.0125000
NODE_87495_length_383_cov_2.760563	169	249	73	1	80	0.0125000
NODE_87495_length_383_cov_2.760563	169	249	81	2	80	0.0250000
NODE_87495_length_383_cov_2.760563	169	249	89	4	80	0.0500000
NODE_87495_length_383_cov_2.760563	169	249	95	1	80	0.0125000
NODE_87495_length_383_cov_2.760563	169	249	96	5	80	0.0625000
NODE_87495_length_383_cov_2.760563	169	249	100	1	80	0.0125000
NODE_87495_length_383_cov_2.760563	169	249	110	1	80	0.0125000
NODE_87495_length_383_cov_2.760563	169	249	118	1	80	0.0125000
NODE_87495_length_383_cov_2.760563	169	249	120	2	80	0.0250000
NODE_87495_length_383_cov_2.760563	169	249	122	5	80	0.0625000
NODE_87495_length_383_cov_2.760563	169	249	128	2	80	0.0250000
NODE_87495_length_383_cov_2.760563	169	249	130	1	80	0.0125000
NODE_87495_length_383_cov_2.760563	169	249	132	5	80	0.0625000
NODE_87495_length_383_cov_2.760563	169	249	134	1	80	0.0125000
NODE_87495_length_383_cov_2.760563	169	249	137	1	80	0.0125000
NODE_87495_length_383_cov_2.760563	169	249	160	1	80	0.0125000
NODE_87495_length_383_cov_2.760563	169	249	162	1	80	0.0125000
NODE_87495_length_383_cov_2.760563	169	249	166	2	80	0.0250000
NODE_87495_length_383_cov_2.760563	169	249	170	2	80	0.0250000
NODE_87495_length_383_cov_2.760563	169	249	172	1	80	0.0125000
NODE_87495_length_383_cov_2.760563	169	249	173	1	80	0.0125000
NODE_87495_length_383_cov_2.760563	169	249	175	1	80	0.0125000
NODE_87495_length_383_cov_2.760563	169	249	183	1	80	0.0125000
NODE_87495_length_383_cov_2.760563	169	249	185	2	80	0.0250000
NODE_87495_length_383_cov_2.760563	169	249	187	1	80	0.0125000
NODE_87495_length_383_cov_2.760563	169	249	195	2	80	0.0250000
NODE_87495_length_383_cov_2.760563	169	249	197	1	80	0.0125000
NODE_87495_length_383_cov_2.760563	169	249	199	1	80	0.0125000
NODE_87495_length_383_cov_2.760563	222	302	0	17	80	0.2125000
NODE_87495_length_383_cov_2.760563	222	302	2	3	80	0.0375000
NODE_87495_length_383_cov_2.760563	222	302	4	6	80	0.0750000
NODE_87495_length_383_cov_2.760563	222	302	6	5	80	0.0625000
NODE_87495_length_383_cov_2.760563	222	302	8	1	80	0.0125000
NODE_87495_length_383_cov_2.760563	222	302	10	1	80	0.0125000
NODE_87495_length_383_cov_2.760563	222	302	12	1	80	0.0125000
NODE_87495_length_383_cov_2.760563	222	302	14	6	80	0.0750000
NODE_87495_length_383_cov_2.760563	222	302	24	2	80	0.0250000
NODE_87495_length_383_cov_2.760563	222	302	28	5	80	0.0625000
NODE_87495_length_383_cov_2.760563	222	302	30	1	80	0.0125000
NODE_87495_length_383_cov_2.760563	222	302	32	5	80	0.0625000
NODE_87495_length_383_cov_2.760563	222	302	34	4	80	0.0500000
NODE_87495_length_383_cov_2.760563	222	302	40	1	80	0.0125000
NODE_87495_length_383_cov_2.760563	222	302	42	1	80	0.0125000
NODE_87495_length_383_cov_2.760563	222	302	44	2	80	0.0250000
NODE_87495_length_383_cov_2.760563	222	302	47	1	80	0.0125000
NODE_87495_length_383_cov_2.760563	222	302	49	6	80	0.0750000
NODE_87495_length_383_cov_2.760563	222	302	55	3	80	0.0375000
NODE_87495_length_383_cov_2.760563	222	302	56	1	80	0.0125000
NODE_87495_length_383_cov_2.760563	222	302	61	2	80	0.0250000
NODE_87495_length_383_cov_2.760563	222	302	62	1	80	0.0125000
NODE_87495_length_383_cov_2.760563	222	302	63	3	80	0.0375000
NODE_87495_length_383_cov_2.760563	222	302	69	2	80	0.0250000
NODE_87566_length_383_cov_2.123239	29	94	4	36	65	0.5538462
NODE_87566_length_383_cov_2.123239	29	94	6	29	65	0.4461538
NODE_87566_length_383_cov_2.123239	93	173	2	79	80	0.9875000
NODE_87566_length_383_cov_2.123239	93	173	6	1	80	0.0125000
NODE_87566_length_383_cov_2.123239	146	193	0	20	47	0.4255319
NODE_87566_length_383_cov_2.123239	146	193	2	27	47	0.5744681
NODE_87634_length_383_cov_1.728873	196	257	10	6	61	0.0983607
NODE_87634_length_383_cov_1.728873	196	257	11	1	61	0.0163934
NODE_87634_length_383_cov_1.728873	196	257	13	1	61	0.0163934
NODE_87634_length_383_cov_1.728873	196	257	14	6	61	0.0983607
NODE_87634_length_383_cov_1.728873	196	257	16	12	61	0.1967213
NODE_87634_length_383_cov_1.728873	196	257	18	17	61	0.2786885
NODE_87634_length_383_cov_1.728873	196	257	20	18	61	0.2950820
NODE_87634_length_383_cov_1.728873	239	310	12	17	71	0.2394366
NODE_87634_length_383_cov_1.728873	239	310	16	6	71	0.0845070
NODE_87634_length_383_cov_1.728873	239	310	17	16	71	0.2253521
NODE_87634_length_383_cov_1.728873	239	310	18	10	71	0.1408451
NODE_87634_length_383_cov_1.728873	239	310	20	22	71	0.3098592
NODE_88039_length_382_cov_43.724382	245	325	0	80	80	1.0000000
NODE_88039_length_382_cov_43.724382	298	378	0	80	80	1.0000000
NODE_88040_length_382_cov_35.908127	163	243	0	80	80	1.0000000
NODE_88040_length_382_cov_35.908127	216	296	0	80	80	1.0000000
NODE_88040_length_382_cov_35.908127	292	372	0	80	80	1.0000000
NODE_88041_length_382_cov_26.240283	57	137	0	80	80	1.0000000
NODE_88041_length_382_cov_26.240283	110	190	0	80	80	1.0000000
NODE_88054_length_382_cov_5.583039	63	143	0	80	80	1.0000000
NODE_88054_length_382_cov_5.583039	116	196	0	80	80	1.0000000
NODE_88063_length_382_cov_4.837456	19	78	0	42	59	0.7118644
NODE_88063_length_382_cov_4.837456	19	78	2	17	59	0.2881356
NODE_88067_length_382_cov_4.618375	0	55	0	10	55	0.1818182
NODE_88067_length_382_cov_4.618375	0	55	2	19	55	0.3454545
NODE_88067_length_382_cov_4.618375	0	55	3	2	55	0.0363636
NODE_88067_length_382_cov_4.618375	0	55	4	24	55	0.4363636
NODE_88067_length_382_cov_4.618375	104	184	4	11	80	0.1375000
NODE_88067_length_382_cov_4.618375	104	184	5	9	80	0.1125000
NODE_88067_length_382_cov_4.618375	104	184	6	8	80	0.1000000
NODE_88067_length_382_cov_4.618375	104	184	8	39	80	0.4875000
NODE_88067_length_382_cov_4.618375	104	184	10	8	80	0.1000000
NODE_88067_length_382_cov_4.618375	104	184	12	5	80	0.0625000
NODE_88067_length_382_cov_4.618375	157	237	8	26	80	0.3250000
NODE_88067_length_382_cov_4.618375	157	237	9	7	80	0.0875000
NODE_88067_length_382_cov_4.618375	157	237	11	5	80	0.0625000
NODE_88067_length_382_cov_4.618375	157	237	12	22	80	0.2750000
NODE_88067_length_382_cov_4.618375	157	237	13	6	80	0.0750000
NODE_88067_length_382_cov_4.618375	157	237	14	14	80	0.1750000
NODE_88075_length_382_cov_4.268551	71	152	0	81	81	1.0000000
NODE_88075_length_382_cov_4.268551	124	205	0	81	81	1.0000000
NODE_88080_length_382_cov_4.091873	30	92	0	62	62	1.0000000
NODE_88121_length_382_cov_3.031802	173	253	0	29	80	0.3625000
NODE_88121_length_382_cov_3.031802	173	253	2	51	80	0.6375000
NODE_88121_length_382_cov_3.031802	226	295	2	69	69	1.0000000
NODE_88135_length_382_cov_2.798587	231	293	0	62	62	1.0000000
NODE_88136_length_382_cov_2.791519	195	244	0	15	49	0.3061225
NODE_88136_length_382_cov_2.791519	195	244	2	34	49	0.6938776
NODE_88136_length_382_cov_2.791519	217	297	2	80	80	1.0000000
NODE_88164_length_382_cov_2.611307	301	368	0	67	67	1.0000000
NODE_88276_length_382_cov_1.802120	0	60	0	60	60	1.0000000
NODE_88660_length_382_cov_0.738516	48	95	8	30	47	0.6382979
NODE_88660_length_382_cov_0.738516	48	95	10	17	47	0.3617021
NODE_88660_length_382_cov_0.738516	68	148	8	10	80	0.1250000
NODE_88660_length_382_cov_0.738516	68	148	10	17	80	0.2125000
NODE_88660_length_382_cov_0.738516	68	148	14	53	80	0.6625000
NODE_88758_length_381_cov_12.010638	195	274	0	79	79	1.0000000
NODE_88865_length_381_cov_2.606383	68	98	0	30	30	1.0000000
NODE_88867_length_381_cov_2.570922	115	175	0	60	60	1.0000000
NODE_88872_length_381_cov_2.514184	225	307	0	9	82	0.1097561
NODE_88872_length_381_cov_2.514184	225	307	2	73	82	0.8902439
NODE_88900_length_381_cov_2.198582	193	276	3	24	83	0.2891566
NODE_88900_length_381_cov_2.198582	193	276	4	59	83	0.7108434
NODE_88935_length_381_cov_1.989362	279	325	0	46	46	1.0000000
NODE_89009_length_381_cov_1.663121	51	128	0	66	77	0.8571429
NODE_89009_length_381_cov_1.663121	51	128	4	11	77	0.1428571
NODE_89009_length_381_cov_1.663121	101	181	0	16	80	0.2000000
NODE_89009_length_381_cov_1.663121	101	181	4	64	80	0.8000000
NODE_89090_length_381_cov_1.400709	254	334	3	51	80	0.6375000
NODE_89090_length_381_cov_1.400709	254	334	4	29	80	0.3625000
NODE_89090_length_381_cov_1.400709	254	334	3	51	80	0.6375000
NODE_89090_length_381_cov_1.400709	254	334	4	29	80	0.3625000
NODE_89090_length_381_cov_1.400709	309	373	0	35	64	0.5468750
NODE_89090_length_381_cov_1.400709	309	373	4	29	64	0.4531250
NODE_89482_length_380_cov_57.604982	196	276	0	80	80	1.0000000
NODE_89482_length_380_cov_57.604982	249	329	0	80	80	1.0000000
NODE_89482_length_380_cov_57.604982	325	359	0	34	34	1.0000000
NODE_89483_length_380_cov_11.185053	79	161	0	80	82	0.9756098
NODE_89483_length_380_cov_11.185053	79	161	2	2	82	0.0243902
NODE_89483_length_380_cov_11.185053	134	214	0	80	80	1.0000000
NODE_89491_length_380_cov_5.811388	100	156	0	2	56	0.0357143
NODE_89491_length_380_cov_5.811388	100	156	2	54	56	0.9642857
NODE_89491_length_380_cov_5.811388	177	213	0	32	36	0.8888889
NODE_89491_length_380_cov_5.811388	177	213	2	4	36	0.1111111
NODE_89495_length_380_cov_5.377224	242	271	63	2	29	0.0689655
NODE_89495_length_380_cov_5.377224	242	271	65	13	29	0.4482759
NODE_89495_length_380_cov_5.377224	242	271	67	8	29	0.2758621
NODE_89495_length_380_cov_5.377224	242	271	69	2	29	0.0689655
NODE_89495_length_380_cov_5.377224	242	271	71	4	29	0.1379310
NODE_89508_length_380_cov_4.185053	158	230	0	72	72	1.0000000
NODE_89508_length_380_cov_4.185053	159	229	0	70	70	1.0000000
NODE_89508_length_380_cov_4.185053	203	283	0	80	80	1.0000000
NODE_89508_length_380_cov_4.185053	203	283	0	80	80	1.0000000
NODE_89527_length_380_cov_3.423488	164	233	16	1	69	0.0144928
NODE_89527_length_380_cov_3.423488	164	233	17	6	69	0.0869565
NODE_89527_length_380_cov_3.423488	164	233	18	47	69	0.6811594
NODE_89527_length_380_cov_3.423488	164	233	19	4	69	0.0579710
NODE_89527_length_380_cov_3.423488	164	233	20	11	69	0.1594203
NODE_89540_length_380_cov_3.153025	188	260	0	15	72	0.2083333
NODE_89540_length_380_cov_3.153025	188	260	2	13	72	0.1805556
NODE_89540_length_380_cov_3.153025	188	260	4	44	72	0.6111111
NODE_89568_length_380_cov_2.718861	51	131	0	80	80	1.0000000
NODE_89568_length_380_cov_2.718861	104	184	0	80	80	1.0000000
NODE_89658_length_380_cov_1.943060	22	56	6	34	34	1.0000000
NODE_89750_length_380_cov_1.601423	292	332	62	2	40	0.0500000
NODE_89750_length_380_cov_1.601423	292	332	64	1	40	0.0250000
NODE_89750_length_380_cov_1.601423	292	332	67	1	40	0.0250000
NODE_89750_length_380_cov_1.601423	292	332	68	6	40	0.1500000
NODE_89750_length_380_cov_1.601423	292	332	70	2	40	0.0500000
NODE_89750_length_380_cov_1.601423	292	332	72	1	40	0.0250000
NODE_89750_length_380_cov_1.601423	292	332	80	4	40	0.1000000
NODE_89750_length_380_cov_1.601423	292	332	83	5	40	0.1250000
NODE_89750_length_380_cov_1.601423	292	332	84	1	40	0.0250000
NODE_89750_length_380_cov_1.601423	292	332	85	2	40	0.0500000
NODE_89750_length_380_cov_1.601423	292	332	86	1	40	0.0250000
NODE_89750_length_380_cov_1.601423	292	332	89	2	40	0.0500000
NODE_89750_length_380_cov_1.601423	292	332	91	3	40	0.0750000
NODE_89750_length_380_cov_1.601423	292	332	92	1	40	0.0250000
NODE_89750_length_380_cov_1.601423	292	332	94	1	40	0.0250000
NODE_89750_length_380_cov_1.601423	292	332	96	1	40	0.0250000
NODE_89750_length_380_cov_1.601423	292	332	97	1	40	0.0250000
NODE_89750_length_380_cov_1.601423	292	332	98	1	40	0.0250000
NODE_89750_length_380_cov_1.601423	292	332	99	2	40	0.0500000
NODE_89750_length_380_cov_1.601423	292	332	107	2	40	0.0500000
NODE_89911_length_380_cov_1.088968	312	353	0	30	41	0.7317073
NODE_89911_length_380_cov_1.088968	312	353	1	11	41	0.2682927
NODE_89911_length_380_cov_1.088968	326	380	0	54	54	1.0000000
NODE_90152_length_379_cov_42.339286	10	90	0	80	80	1.0000000
NODE_90152_length_379_cov_42.339286	86	166	0	80	80	1.0000000
NODE_90152_length_379_cov_42.339286	139	219	0	80	80	1.0000000
NODE_90153_length_379_cov_32.075000	0	62	0	62	62	1.0000000
NODE_90165_length_379_cov_5.607143	279	338	0	59	59	1.0000000
NODE_90180_length_379_cov_4.432143	219	243	0	24	24	1.0000000
NODE_90193_length_379_cov_3.778571	271	300	0	29	29	1.0000000
NODE_90198_length_379_cov_3.585714	128	152	0	24	24	1.0000000
NODE_90198_length_379_cov_3.585714	169	249	0	80	80	1.0000000
NODE_90203_length_379_cov_3.375000	19	43	0	24	24	1.0000000
NODE_90247_length_379_cov_2.692857	121	201	0	80	80	1.0000000
NODE_90247_length_379_cov_2.692857	174	221	0	47	47	1.0000000
NODE_90789_length_378_cov_53.039427	147	227	0	80	80	1.0000000
NODE_90789_length_378_cov_53.039427	200	280	0	80	80	1.0000000
NODE_90789_length_378_cov_53.039427	276	356	0	80	80	1.0000000
NODE_90789_length_378_cov_53.039427	329	378	0	49	49	1.0000000
NODE_90794_length_378_cov_6.569892	223	304	2	26	81	0.3209876
NODE_90794_length_378_cov_6.569892	223	304	4	54	81	0.6666667
NODE_90794_length_378_cov_6.569892	223	304	5	1	81	0.0123457
NODE_90795_length_378_cov_6.444444	217	297	0	80	80	1.0000000
NODE_90795_length_378_cov_6.444444	270	350	0	80	80	1.0000000
NODE_90808_length_378_cov_4.899642	135	191	23	9	56	0.1607143
NODE_90808_length_378_cov_4.899642	135	191	27	5	56	0.0892857
NODE_90808_length_378_cov_4.899642	135	191	29	42	56	0.7500000
NODE_90855_length_378_cov_3.236559	143	212	6	69	69	1.0000000
NODE_90859_length_378_cov_3.132616	238	280	0	42	42	1.0000000
NODE_90898_length_378_cov_2.534050	203	243	0	40	40	1.0000000
NODE_90898_length_378_cov_2.534050	271	347	0	76	76	1.0000000
NODE_90898_length_378_cov_2.534050	331	360	0	29	29	1.0000000
NODE_90948_length_378_cov_2.093190	179	250	0	3	71	0.0422535
NODE_90948_length_378_cov_2.093190	179	250	2	68	71	0.9577465
NODE_90948_length_378_cov_2.093190	183	219	2	36	36	1.0000000
NODE_91002_length_378_cov_1.813620	36	89	0	53	53	1.0000000
NODE_91475_length_377_cov_71.723022	19	99	0	80	80	1.0000000
NODE_91475_length_377_cov_71.723022	72	152	0	78	80	0.9750000
NODE_91475_length_377_cov_71.723022	72	152	2	2	80	0.0250000
NODE_91475_length_377_cov_71.723022	148	228	0	2	80	0.0250000
NODE_91475_length_377_cov_71.723022	148	228	2	52	80	0.6500000
NODE_91475_length_377_cov_71.723022	148	228	4	22	80	0.2750000
NODE_91475_length_377_cov_71.723022	148	228	6	4	80	0.0500000
NODE_91475_length_377_cov_71.723022	201	281	2	1	80	0.0125000
NODE_91475_length_377_cov_71.723022	201	281	4	22	80	0.2750000
NODE_91475_length_377_cov_71.723022	201	281	6	30	80	0.3750000
NODE_91475_length_377_cov_71.723022	201	281	8	27	80	0.3375000
NODE_91477_length_377_cov_41.787770	210	290	0	80	80	1.0000000
NODE_91477_length_377_cov_41.787770	263	343	0	80	80	1.0000000
NODE_91478_length_377_cov_9.982014	32	83	0	51	51	1.0000000
NODE_91486_length_377_cov_6.244604	101	177	0	47	76	0.6184211
NODE_91486_length_377_cov_6.244604	101	177	2	29	76	0.3815790
NODE_91494_length_377_cov_5.183453	169	224	0	55	55	1.0000000
NODE_91499_length_377_cov_4.586331	186	266	0	80	80	1.0000000
NODE_91499_length_377_cov_4.586331	239	319	0	80	80	1.0000000
NODE_91500_length_377_cov_4.431655	139	216	0	77	77	1.0000000
NODE_91502_length_377_cov_4.330935	134	214	0	80	80	1.0000000
NODE_91502_length_377_cov_4.330935	187	267	0	80	80	1.0000000
NODE_91506_length_377_cov_4.032374	124	181	2	57	57	1.0000000
NODE_91506_length_377_cov_4.032374	154	201	0	13	47	0.2765957
NODE_91506_length_377_cov_4.032374	154	201	2	34	47	0.7234042
NODE_91526_length_377_cov_3.615108	82	140	0	58	58	1.0000000
NODE_91526_length_377_cov_3.615108	82	140	0	58	58	1.0000000
NODE_91526_length_377_cov_3.615108	113	193	0	80	80	1.0000000
NODE_91526_length_377_cov_3.615108	113	193	0	80	80	1.0000000
NODE_91526_length_377_cov_3.615108	189	258	0	69	69	1.0000000
NODE_91526_length_377_cov_3.615108	243	313	0	70	70	1.0000000
NODE_91553_length_377_cov_2.913669	38	61	0	23	23	1.0000000
NODE_91553_length_377_cov_2.913669	167	228	0	61	61	1.0000000
NODE_91619_length_377_cov_2.104317	137	188	0	51	51	1.0000000
NODE_91619_length_377_cov_2.104317	168	211	0	33	43	0.7674419
NODE_91619_length_377_cov_2.104317	168	211	2	10	43	0.2325581
NODE_91619_length_377_cov_2.104317	190	241	0	11	51	0.2156863
NODE_91619_length_377_cov_2.104317	190	241	2	40	51	0.7843137
NODE_91727_length_377_cov_1.622302	123	181	4	58	58	1.0000000
NODE_91727_length_377_cov_1.622302	176	234	0	3	58	0.0517241
NODE_91727_length_377_cov_1.622302	176	234	2	25	58	0.4310345
NODE_91727_length_377_cov_1.622302	176	234	4	30	58	0.5172414
NODE_91749_length_377_cov_1.539568	230	310	0	80	80	1.0000000
NODE_91749_length_377_cov_1.539568	230	310	0	80	80	1.0000000
NODE_91749_length_377_cov_1.539568	306	377	0	71	71	1.0000000
NODE_91749_length_377_cov_1.539568	327	351	0	24	24	1.0000000
NODE_91765_length_377_cov_1.471223	118	198	18	24	80	0.3000000
NODE_91765_length_377_cov_1.471223	118	198	20	17	80	0.2125000
NODE_91765_length_377_cov_1.471223	118	198	22	21	80	0.2625000
NODE_91765_length_377_cov_1.471223	118	198	24	11	80	0.1375000
NODE_91765_length_377_cov_1.471223	118	198	26	7	80	0.0875000
NODE_91790_length_377_cov_1.456835	177	257	0	80	80	1.0000000
NODE_91790_length_377_cov_1.456835	230	310	0	80	80	1.0000000
NODE_91817_length_377_cov_1.330935	0	44	0	8	44	0.1818182
NODE_91817_length_377_cov_1.330935	0	44	2	36	44	0.8181818
NODE_91817_length_377_cov_1.330935	45	117	0	22	72	0.3055556
NODE_91817_length_377_cov_1.330935	45	117	2	50	72	0.6944444
NODE_92046_length_377_cov_0.762590	299	330	0	31	31	1.0000000
NODE_92166_length_376_cov_6.938628	0	63	16	8	63	0.1269841
NODE_92166_length_376_cov_6.938628	0	63	18	5	63	0.0793651
NODE_92166_length_376_cov_6.938628	0	63	22	5	63	0.0793651
NODE_92166_length_376_cov_6.938628	0	63	24	2	63	0.0317460
NODE_92166_length_376_cov_6.938628	0	63	26	2	63	0.0317460
NODE_92166_length_376_cov_6.938628	0	63	28	6	63	0.0952381
NODE_92166_length_376_cov_6.938628	0	63	30	6	63	0.0952381
NODE_92166_length_376_cov_6.938628	0	63	34	6	63	0.0952381
NODE_92166_length_376_cov_6.938628	0	63	36	5	63	0.0793651
NODE_92166_length_376_cov_6.938628	0	63	38	7	63	0.1111111
NODE_92166_length_376_cov_6.938628	0	63	40	1	63	0.0158730
NODE_92166_length_376_cov_6.938628	0	63	42	4	63	0.0634921
NODE_92166_length_376_cov_6.938628	0	63	49	6	63	0.0952381
NODE_92166_length_376_cov_6.938628	269	340	12	3	71	0.0422535
NODE_92166_length_376_cov_6.938628	269	340	14	2	71	0.0281690
NODE_92166_length_376_cov_6.938628	269	340	16	10	71	0.1408451
NODE_92166_length_376_cov_6.938628	269	340	20	7	71	0.0985916
NODE_92166_length_376_cov_6.938628	269	340	24	21	71	0.2957746
NODE_92166_length_376_cov_6.938628	269	340	26	14	71	0.1971831
NODE_92166_length_376_cov_6.938628	269	340	28	14	71	0.1971831
NODE_92168_length_376_cov_6.415162	177	257	0	80	80	1.0000000
NODE_92168_length_376_cov_6.415162	230	310	0	80	80	1.0000000
NODE_92173_length_376_cov_5.722022	100	171	4	5	71	0.0704225
NODE_92173_length_376_cov_5.722022	100	171	6	66	71	0.9295775
NODE_92173_length_376_cov_5.722022	155	192	6	37	37	1.0000000
NODE_92191_length_376_cov_4.148014	300	330	0	30	30	1.0000000
NODE_92196_length_376_cov_3.859206	168	236	0	68	68	1.0000000
NODE_92219_length_376_cov_3.140794	122	188	0	66	66	1.0000000
NODE_92442_length_376_cov_1.516245	57	106	0	49	49	1.0000000
NODE_92879_length_375_cov_4.217391	321	350	0	6	29	0.2068966
NODE_92879_length_375_cov_4.217391	321	350	2	9	29	0.3103448
NODE_92879_length_375_cov_4.217391	321	350	4	7	29	0.2413793
NODE_92879_length_375_cov_4.217391	321	350	6	7	29	0.2413793
NODE_92897_length_375_cov_3.699275	287	367	0	80	80	1.0000000
NODE_92911_length_375_cov_3.376812	70	136	0	63	66	0.9545454
NODE_92911_length_375_cov_3.376812	70	136	4	3	66	0.0454545
NODE_93031_length_375_cov_2.032609	162	224	0	5	62	0.0806452
NODE_93031_length_375_cov_2.032609	162	224	1	2	62	0.0322581
NODE_93031_length_375_cov_2.032609	162	224	4	1	62	0.0161290
NODE_93031_length_375_cov_2.032609	162	224	5	3	62	0.0483871
NODE_93031_length_375_cov_2.032609	162	224	6	19	62	0.3064516
NODE_93031_length_375_cov_2.032609	162	224	8	6	62	0.0967742
NODE_93031_length_375_cov_2.032609	162	224	11	5	62	0.0806452
NODE_93031_length_375_cov_2.032609	162	224	13	7	62	0.1129032
NODE_93031_length_375_cov_2.032609	162	224	15	1	62	0.0161290
NODE_93031_length_375_cov_2.032609	162	224	16	13	62	0.2096774
NODE_93031_length_375_cov_2.032609	215	272	16	12	57	0.2105263
NODE_93031_length_375_cov_2.032609	215	272	17	30	57	0.5263158
NODE_93031_length_375_cov_2.032609	215	272	18	15	57	0.2631579
NODE_93050_length_375_cov_1.967391	131	190	0	59	59	1.0000000
NODE_93050_length_375_cov_1.967391	184	235	0	51	51	1.0000000
NODE_93081_length_375_cov_1.840580	195	276	2	58	81	0.7160494
NODE_93081_length_375_cov_1.840580	195	276	4	23	81	0.2839506
NODE_93386_length_375_cov_1.000000	320	375	0	55	55	1.0000000
NODE_93609_length_374_cov_4.563636	93	160	4	15	67	0.2238806
NODE_93609_length_374_cov_4.563636	93	160	6	26	67	0.3880597
NODE_93609_length_374_cov_4.563636	93	160	16	26	67	0.3880597
NODE_93609_length_374_cov_4.563636	146	213	14	2	67	0.0298507
NODE_93609_length_374_cov_4.563636	146	213	16	14	67	0.2089552
NODE_93609_length_374_cov_4.563636	146	213	18	14	67	0.2089552
NODE_93609_length_374_cov_4.563636	146	213	22	19	67	0.2835821
NODE_93609_length_374_cov_4.563636	146	213	24	18	67	0.2686567
NODE_93612_length_374_cov_4.523636	23	101	0	78	78	1.0000000
NODE_93612_length_374_cov_4.523636	81	154	0	73	73	1.0000000
NODE_93628_length_374_cov_3.810909	130	189	2	3	59	0.0508475
NODE_93628_length_374_cov_3.810909	130	189	4	17	59	0.2881356
NODE_93628_length_374_cov_3.810909	130	189	8	3	59	0.0508475
NODE_93628_length_374_cov_3.810909	130	189	12	4	59	0.0677966
NODE_93628_length_374_cov_3.810909	130	189	14	8	59	0.1355932
NODE_93628_length_374_cov_3.810909	130	189	16	24	59	0.4067796
NODE_93628_length_374_cov_3.810909	162	242	12	10	80	0.1250000
NODE_93628_length_374_cov_3.810909	162	242	14	10	80	0.1250000
NODE_93628_length_374_cov_3.810909	162	242	16	60	80	0.7500000
NODE_93630_length_374_cov_3.789091	236	271	1	8	35	0.2285714
NODE_93630_length_374_cov_3.789091	236	271	2	1	35	0.0285714
NODE_93630_length_374_cov_3.789091	236	271	4	26	35	0.7428572
NODE_93630_length_374_cov_3.789091	238	280	0	5	42	0.1190476
NODE_93630_length_374_cov_3.789091	238	280	1	12	42	0.2857143
NODE_93630_length_374_cov_3.789091	238	280	2	1	42	0.0238095
NODE_93630_length_374_cov_3.789091	238	280	4	24	42	0.5714286
NODE_93637_length_374_cov_3.458182	190	248	0	58	58	1.0000000
NODE_93688_length_374_cov_2.600000	142	217	0	2	75	0.0266667
NODE_93688_length_374_cov_2.600000	142	217	1	20	75	0.2666667
NODE_93688_length_374_cov_2.600000	142	217	2	2	75	0.0266667
NODE_93688_length_374_cov_2.600000	142	217	4	5	75	0.0666667
NODE_93688_length_374_cov_2.600000	142	217	6	32	75	0.4266667
NODE_93688_length_374_cov_2.600000	142	217	8	14	75	0.1866667
NODE_93688_length_374_cov_2.600000	190	270	6	13	80	0.1625000
NODE_93688_length_374_cov_2.600000	190	270	8	29	80	0.3625000
NODE_93688_length_374_cov_2.600000	190	270	10	3	80	0.0375000
NODE_93688_length_374_cov_2.600000	190	270	12	18	80	0.2250000
NODE_93688_length_374_cov_2.600000	190	270	14	17	80	0.2125000
NODE_93718_length_374_cov_2.330909	40	120	0	14	80	0.1750000
NODE_93718_length_374_cov_2.330909	40	120	1	2	80	0.0250000
NODE_93718_length_374_cov_2.330909	40	120	2	64	80	0.8000000
NODE_93769_length_374_cov_2.010909	40	105	0	44	65	0.6769231
NODE_93769_length_374_cov_2.010909	40	105	1	21	65	0.3230769
NODE_93821_length_374_cov_1.796364	254	288	0	1	34	0.0294118
NODE_93821_length_374_cov_1.796364	254	288	2	33	34	0.9705882
NODE_93852_length_374_cov_1.661818	95	157	0	62	62	1.0000000
NODE_93859_length_374_cov_1.621818	202	254	0	52	52	1.0000000
NODE_93936_length_374_cov_1.360000	211	291	6	57	80	0.7125000
NODE_93936_length_374_cov_1.360000	211	291	8	4	80	0.0500000
NODE_93936_length_374_cov_1.360000	211	291	10	4	80	0.0500000
NODE_93936_length_374_cov_1.360000	211	291	12	1	80	0.0125000
NODE_93936_length_374_cov_1.360000	211	291	14	4	80	0.0500000
NODE_93936_length_374_cov_1.360000	211	291	16	3	80	0.0375000
NODE_93936_length_374_cov_1.360000	211	291	18	7	80	0.0875000
NODE_93981_length_374_cov_1.236364	263	336	0	73	73	1.0000000
NODE_94321_length_373_cov_31.302920	0	53	0	6	53	0.1132075
NODE_94321_length_373_cov_31.302920	0	53	58	1	53	0.0188679
NODE_94321_length_373_cov_31.302920	0	53	62	1	53	0.0188679
NODE_94321_length_373_cov_31.302920	0	53	65	1	53	0.0188679
NODE_94321_length_373_cov_31.302920	0	53	69	7	53	0.1320755
NODE_94321_length_373_cov_31.302920	0	53	71	3	53	0.0566038
NODE_94321_length_373_cov_31.302920	0	53	81	11	53	0.2075472
NODE_94321_length_373_cov_31.302920	0	53	82	3	53	0.0566038
NODE_94321_length_373_cov_31.302920	0	53	85	3	53	0.0566038
NODE_94321_length_373_cov_31.302920	0	53	91	7	53	0.1320755
NODE_94321_length_373_cov_31.302920	0	53	94	10	53	0.1886792
NODE_94321_length_373_cov_31.302920	0	53	0	6	53	0.1132075
NODE_94321_length_373_cov_31.302920	0	53	58	1	53	0.0188679
NODE_94321_length_373_cov_31.302920	0	53	62	1	53	0.0188679
NODE_94321_length_373_cov_31.302920	0	53	65	1	53	0.0188679
NODE_94321_length_373_cov_31.302920	0	53	69	7	53	0.1320755
NODE_94321_length_373_cov_31.302920	0	53	71	3	53	0.0566038
NODE_94321_length_373_cov_31.302920	0	53	81	11	53	0.2075472
NODE_94321_length_373_cov_31.302920	0	53	82	3	53	0.0566038
NODE_94321_length_373_cov_31.302920	0	53	85	3	53	0.0566038
NODE_94321_length_373_cov_31.302920	0	53	91	7	53	0.1320755
NODE_94321_length_373_cov_31.302920	0	53	94	10	53	0.1886792
NODE_94321_length_373_cov_31.302920	0	53	0	6	53	0.1132075
NODE_94321_length_373_cov_31.302920	0	53	58	1	53	0.0188679
NODE_94321_length_373_cov_31.302920	0	53	62	1	53	0.0188679
NODE_94321_length_373_cov_31.302920	0	53	65	1	53	0.0188679
NODE_94321_length_373_cov_31.302920	0	53	69	7	53	0.1320755
NODE_94321_length_373_cov_31.302920	0	53	71	3	53	0.0566038
NODE_94321_length_373_cov_31.302920	0	53	81	11	53	0.2075472
NODE_94321_length_373_cov_31.302920	0	53	82	3	53	0.0566038
NODE_94321_length_373_cov_31.302920	0	53	85	3	53	0.0566038
NODE_94321_length_373_cov_31.302920	0	53	91	7	53	0.1320755
NODE_94321_length_373_cov_31.302920	0	53	94	10	53	0.1886792
NODE_94321_length_373_cov_31.302920	26	106	81	4	80	0.0500000
NODE_94321_length_373_cov_31.302920	26	106	82	3	80	0.0375000
NODE_94321_length_373_cov_31.302920	26	106	85	3	80	0.0375000
NODE_94321_length_373_cov_31.302920	26	106	89	4	80	0.0500000
NODE_94321_length_373_cov_31.302920	26	106	91	7	80	0.0875000
NODE_94321_length_373_cov_31.302920	26	106	94	18	80	0.2250000
NODE_94321_length_373_cov_31.302920	26	106	95	4	80	0.0500000
NODE_94321_length_373_cov_31.302920	26	106	96	5	80	0.0625000
NODE_94321_length_373_cov_31.302920	26	106	97	32	80	0.4000000
NODE_94340_length_373_cov_4.671533	76	142	4	66	66	1.0000000
NODE_94340_length_373_cov_4.671533	115	195	0	17	80	0.2125000
NODE_94340_length_373_cov_4.671533	115	195	4	63	80	0.7875000
NODE_94340_length_373_cov_4.671533	115	195	0	17	80	0.2125000
NODE_94340_length_373_cov_4.671533	115	195	4	63	80	0.7875000
NODE_94340_length_373_cov_4.671533	288	368	0	80	80	1.0000000
NODE_94352_length_373_cov_4.080292	109	189	0	61	80	0.7625000
NODE_94352_length_373_cov_4.080292	109	189	2	19	80	0.2375000
NODE_94352_length_373_cov_4.080292	162	220	0	8	58	0.1379310
NODE_94352_length_373_cov_4.080292	162	220	2	23	58	0.3965517
NODE_94352_length_373_cov_4.080292	162	220	4	27	58	0.4655173
NODE_94380_length_373_cov_3.167883	131	210	0	79	79	1.0000000
NODE_94414_length_373_cov_2.751825	80	151	0	71	71	1.0000000
NODE_94414_length_373_cov_2.751825	124	162	0	34	38	0.8947368
NODE_94414_length_373_cov_2.751825	124	162	3	4	38	0.1052632
NODE_94493_length_373_cov_2.036496	248	326	0	50	78	0.6410257
NODE_94493_length_373_cov_2.036496	248	326	1	8	78	0.1025641
NODE_94493_length_373_cov_2.036496	248	326	3	1	78	0.0128205
NODE_94493_length_373_cov_2.036496	248	326	6	6	78	0.0769231
NODE_94493_length_373_cov_2.036496	248	326	7	13	78	0.1666667
NODE_94493_length_373_cov_2.036496	299	359	0	25	60	0.4166667
NODE_94493_length_373_cov_2.036496	299	359	1	35	60	0.5833333
NODE_94500_length_373_cov_2.003650	150	194	0	44	44	1.0000000
NODE_94937_length_373_cov_0.759124	62	114	0	52	52	1.0000000
NODE_95051_length_372_cov_30.135531	111	191	0	80	80	1.0000000
NODE_95051_length_372_cov_30.135531	159	222	0	63	63	1.0000000
NODE_95051_length_372_cov_30.135531	164	239	0	75	75	1.0000000
NODE_95051_length_372_cov_30.135531	182	253	0	71	71	1.0000000
NODE_95051_length_372_cov_30.135531	195	275	0	80	80	1.0000000
NODE_95051_length_372_cov_30.135531	213	276	0	63	63	1.0000000
NODE_95053_length_372_cov_9.091575	150	230	0	80	80	1.0000000
NODE_95053_length_372_cov_9.091575	203	283	0	80	80	1.0000000
NODE_95063_length_372_cov_5.706960	168	208	0	40	40	1.0000000
NODE_95067_length_372_cov_5.124542	146	211	0	5	65	0.0769231
NODE_95067_length_372_cov_5.124542	146	211	1	7	65	0.1076923
NODE_95067_length_372_cov_5.124542	146	211	2	53	65	0.8153846
NODE_95067_length_372_cov_5.124542	189	264	2	75	75	1.0000000
NODE_95090_length_372_cov_3.761905	177	221	0	44	44	1.0000000
NODE_95109_length_372_cov_3.186813	137	218	2	81	81	1.0000000
NODE_95159_length_372_cov_2.582418	167	239	19	10	72	0.1388889
NODE_95159_length_372_cov_2.582418	167	239	21	2	72	0.0277778
NODE_95159_length_372_cov_2.582418	167	239	24	10	72	0.1388889
NODE_95159_length_372_cov_2.582418	167	239	26	17	72	0.2361111
NODE_95159_length_372_cov_2.582418	167	239	28	1	72	0.0138889
NODE_95159_length_372_cov_2.582418	167	239	30	6	72	0.0833333
NODE_95159_length_372_cov_2.582418	167	239	32	26	72	0.3611111
NODE_95159_length_372_cov_2.582418	212	292	7	2	80	0.0250000
NODE_95159_length_372_cov_2.582418	212	292	14	1	80	0.0125000
NODE_95159_length_372_cov_2.582418	212	292	15	3	80	0.0375000
NODE_95159_length_372_cov_2.582418	212	292	17	9	80	0.1125000
NODE_95159_length_372_cov_2.582418	212	292	20	1	80	0.0125000
NODE_95159_length_372_cov_2.582418	212	292	22	10	80	0.1250000
NODE_95159_length_372_cov_2.582418	212	292	24	9	80	0.1125000
NODE_95159_length_372_cov_2.582418	212	292	26	6	80	0.0750000
NODE_95159_length_372_cov_2.582418	212	292	28	1	80	0.0125000
NODE_95159_length_372_cov_2.582418	212	292	30	5	80	0.0625000
NODE_95159_length_372_cov_2.582418	212	292	32	33	80	0.4125000
NODE_95183_length_372_cov_2.347985	97	141	0	44	44	1.0000000
NODE_95183_length_372_cov_2.347985	98	133	0	35	35	1.0000000
NODE_95183_length_372_cov_2.347985	178	243	0	65	65	1.0000000
NODE_95303_length_372_cov_1.699634	195	276	10	2	81	0.0246914
NODE_95303_length_372_cov_1.699634	195	276	12	1	81	0.0123457
NODE_95303_length_372_cov_1.699634	195	276	13	20	81	0.2469136
NODE_95303_length_372_cov_1.699634	195	276	14	6	81	0.0740741
NODE_95303_length_372_cov_1.699634	195	276	15	52	81	0.6419753
NODE_95453_length_372_cov_1.223443	264	334	0	70	70	1.0000000
NODE_95784_length_371_cov_52.040441	104	184	0	80	80	1.0000000
NODE_95784_length_371_cov_52.040441	157	237	0	51	80	0.6375000
NODE_95784_length_371_cov_52.040441	157	237	2	9	80	0.1125000
NODE_95784_length_371_cov_52.040441	157	237	4	20	80	0.2500000
NODE_95784_length_371_cov_52.040441	180	232	0	28	52	0.5384616
NODE_95784_length_371_cov_52.040441	180	232	2	9	52	0.1730769
NODE_95784_length_371_cov_52.040441	180	232	4	15	52	0.2884615
NODE_95785_length_371_cov_24.878676	91	171	0	80	80	1.0000000
NODE_95785_length_371_cov_24.878676	144	224	0	80	80	1.0000000
NODE_95797_length_371_cov_5.738971	170	245	0	11	75	0.1466667
NODE_95797_length_371_cov_5.738971	170	245	2	58	75	0.7733333
NODE_95797_length_371_cov_5.738971	170	245	4	6	75	0.0800000
NODE_95797_length_371_cov_5.738971	218	298	2	21	80	0.2625000
NODE_95797_length_371_cov_5.738971	218	298	4	36	80	0.4500000
NODE_95797_length_371_cov_5.738971	218	298	6	23	80	0.2875000
NODE_95807_length_371_cov_4.452206	65	145	0	80	80	1.0000000
NODE_95807_length_371_cov_4.452206	118	198	0	80	80	1.0000000
NODE_95863_length_371_cov_2.841912	288	350	0	60	62	0.9677419
NODE_95863_length_371_cov_2.841912	288	350	8	2	62	0.0322581
NODE_96013_length_371_cov_1.790441	188	235	0	47	47	1.0000000
NODE_96105_length_371_cov_1.422794	199	287	0	88	88	1.0000000
NODE_96500_length_370_cov_50.380074	144	224	0	80	80	1.0000000
NODE_96500_length_370_cov_50.380074	197	277	0	80	80	1.0000000
NODE_96504_length_370_cov_7.553506	105	162	5	5	57	0.0877193
NODE_96504_length_370_cov_7.553506	105	162	6	41	57	0.7192982
NODE_96504_length_370_cov_7.553506	105	162	7	11	57	0.1929825
NODE_96510_length_370_cov_5.811808	153	221	0	68	68	1.0000000
NODE_96510_length_370_cov_5.811808	206	286	0	80	80	1.0000000
NODE_96522_length_370_cov_4.915129	157	207	0	50	50	1.0000000
NODE_96528_length_370_cov_4.535055	141	221	0	80	80	1.0000000
NODE_96528_length_370_cov_4.535055	194	274	0	80	80	1.0000000
NODE_96532_length_370_cov_4.199262	230	275	0	7	45	0.1555556
NODE_96532_length_370_cov_4.199262	230	275	2	38	45	0.8444445
NODE_96533_length_370_cov_4.151292	142	209	0	11	67	0.1641791
NODE_96533_length_370_cov_4.151292	142	209	5	35	67	0.5223880
NODE_96533_length_370_cov_4.151292	142	209	7	21	67	0.3134328
NODE_96542_length_370_cov_3.719557	214	251	10	14	37	0.3783784
NODE_96542_length_370_cov_3.719557	214	251	12	6	37	0.1621622
NODE_96542_length_370_cov_3.719557	214	251	14	17	37	0.4594595
NODE_96581_length_370_cov_2.822878	126	173	6	47	47	1.0000000
NODE_96668_length_370_cov_2.081181	0	52	0	1	52	0.0192308
NODE_96668_length_370_cov_2.081181	0	52	2	4	52	0.0769231
NODE_96668_length_370_cov_2.081181	0	52	6	5	52	0.0961538
NODE_96668_length_370_cov_2.081181	0	52	8	11	52	0.2115385
NODE_96668_length_370_cov_2.081181	0	52	10	5	52	0.0961538
NODE_96668_length_370_cov_2.081181	0	52	12	9	52	0.1730769
NODE_96668_length_370_cov_2.081181	0	52	14	17	52	0.3269231
NODE_97207_length_369_cov_36.811111	273	358	0	17	85	0.2000000
NODE_97207_length_369_cov_36.811111	273	358	1	4	85	0.0470588
NODE_97207_length_369_cov_36.811111	273	358	7	14	85	0.1647059
NODE_97207_length_369_cov_36.811111	273	358	8	50	85	0.5882353
NODE_97207_length_369_cov_36.811111	273	358	0	17	85	0.2000000
NODE_97207_length_369_cov_36.811111	273	358	1	4	85	0.0470588
NODE_97207_length_369_cov_36.811111	273	358	7	14	85	0.1647059
NODE_97207_length_369_cov_36.811111	273	358	8	50	85	0.5882353
NODE_97207_length_369_cov_36.811111	273	358	0	17	85	0.2000000
NODE_97207_length_369_cov_36.811111	273	358	1	4	85	0.0470588
NODE_97207_length_369_cov_36.811111	273	358	7	14	85	0.1647059
NODE_97207_length_369_cov_36.811111	273	358	8	50	85	0.5882353
NODE_97211_length_369_cov_8.751852	107	187	4	58	80	0.7250000
NODE_97211_length_369_cov_8.751852	107	187	5	13	80	0.1625000
NODE_97211_length_369_cov_8.751852	107	187	6	9	80	0.1125000
NODE_97226_length_369_cov_6.677778	189	269	0	80	80	1.0000000
NODE_97226_length_369_cov_6.677778	242	323	0	81	81	1.0000000
NODE_97236_length_369_cov_5.337037	199	264	0	65	65	1.0000000
NODE_97249_length_369_cov_4.459259	89	157	0	68	68	1.0000000
NODE_97249_length_369_cov_4.459259	130	210	0	80	80	1.0000000
NODE_97255_length_369_cov_4.111111	216	279	0	63	63	1.0000000
NODE_97265_length_369_cov_3.837037	205	238	0	33	33	1.0000000
NODE_97265_length_369_cov_3.837037	211	291	0	80	80	1.0000000
NODE_97265_length_369_cov_3.837037	287	316	0	29	29	1.0000000
NODE_97346_length_369_cov_2.355556	62	142	6	38	80	0.4750000
NODE_97346_length_369_cov_2.355556	62	142	8	42	80	0.5250000
NODE_97346_length_369_cov_2.355556	114	195	2	4	81	0.0493827
NODE_97346_length_369_cov_2.355556	114	195	5	9	81	0.1111111
NODE_97346_length_369_cov_2.355556	114	195	8	68	81	0.8395061
NODE_97440_length_369_cov_1.803704	170	235	0	65	65	1.0000000
NODE_97936_length_368_cov_42.208178	231	311	0	80	80	1.0000000
NODE_97936_length_368_cov_42.208178	284	364	0	80	80	1.0000000
NODE_97939_length_368_cov_11.988848	47	127	0	80	80	1.0000000
NODE_97939_length_368_cov_11.988848	100	180	0	80	80	1.0000000
NODE_97945_length_368_cov_6.267658	133	213	0	80	80	1.0000000
NODE_97945_length_368_cov_6.267658	186	266	0	80	80	1.0000000
NODE_97997_length_368_cov_3.486989	127	207	0	80	80	1.0000000
NODE_98008_length_368_cov_3.282528	182	255	8	6	73	0.0821918
NODE_98008_length_368_cov_3.282528	182	255	10	2	73	0.0273973
NODE_98008_length_368_cov_3.282528	182	255	12	17	73	0.2328767
NODE_98008_length_368_cov_3.282528	182	255	14	48	73	0.6575342
NODE_98058_length_368_cov_2.605948	192	246	0	54	54	1.0000000
NODE_98123_length_368_cov_2.182156	85	145	0	60	60	1.0000000
NODE_98129_length_368_cov_2.137546	66	107	2	2	41	0.0487805
NODE_98129_length_368_cov_2.137546	66	107	6	17	41	0.4146341
NODE_98129_length_368_cov_2.137546	66	107	8	22	41	0.5365854
NODE_98157_length_368_cov_1.944238	192	272	4	64	80	0.8000000
NODE_98157_length_368_cov_1.944238	192	272	6	5	80	0.0625000
NODE_98157_length_368_cov_1.944238	192	272	8	11	80	0.1375000
NODE_98723_length_367_cov_7.156716	174	254	0	80	80	1.0000000
NODE_98723_length_367_cov_7.156716	227	307	0	80	80	1.0000000
NODE_98734_length_367_cov_5.313433	148	206	0	7	58	0.1206897
NODE_98734_length_367_cov_5.313433	148	206	2	9	58	0.1551724
NODE_98734_length_367_cov_5.313433	148	206	10	6	58	0.1034483
NODE_98734_length_367_cov_5.313433	148	206	20	36	58	0.6206896
NODE_98737_length_367_cov_5.138060	58	138	0	80	80	1.0000000
NODE_98737_length_367_cov_5.138060	111	191	0	80	80	1.0000000
NODE_98796_length_367_cov_3.059701	110	154	2	44	44	1.0000000
NODE_98796_length_367_cov_3.059701	111	146	2	35	35	1.0000000
NODE_98843_length_367_cov_2.384328	246	326	0	80	80	1.0000000
NODE_98843_length_367_cov_2.384328	299	367	0	68	68	1.0000000
NODE_98849_length_367_cov_2.332090	127	207	0	80	80	1.0000000
NODE_98909_length_367_cov_1.944030	91	156	0	31	65	0.4769231
NODE_98909_length_367_cov_1.944030	91	156	4	34	65	0.5230770
NODE_98980_length_367_cov_1.679104	173	252	6	19	79	0.2405063
NODE_98980_length_367_cov_1.679104	173	252	8	17	79	0.2151899
NODE_98980_length_367_cov_1.679104	173	252	9	1	79	0.0126582
NODE_98980_length_367_cov_1.679104	173	252	10	33	79	0.4177215
NODE_98980_length_367_cov_1.679104	173	252	12	9	79	0.1139240
NODE_99005_length_367_cov_1.552239	148	200	0	52	52	1.0000000
NODE_99138_length_367_cov_1.201493	79	159	0	80	80	1.0000000
NODE_99138_length_367_cov_1.201493	136	179	0	43	43	1.0000000
NODE_99318_length_367_cov_0.761194	288	357	0	69	69	1.0000000
NODE_99451_length_366_cov_5.239700	193	253	2	60	60	1.0000000
NODE_99472_length_366_cov_4.168539	302	355	0	53	53	1.0000000
NODE_99478_length_366_cov_3.913858	183	229	6	46	46	1.0000000
NODE_99478_length_366_cov_3.913858	203	282	0	13	79	0.1645570
NODE_99478_length_366_cov_3.913858	203	282	5	1	79	0.0126582
NODE_99478_length_366_cov_3.913858	203	282	6	65	79	0.8227848
NODE_99496_length_366_cov_3.168539	88	160	10	58	72	0.8055556
NODE_99496_length_366_cov_3.168539	88	160	12	3	72	0.0416667
NODE_99496_length_366_cov_3.168539	88	160	16	11	72	0.1527778
NODE_99496_length_366_cov_3.168539	133	193	6	17	60	0.2833333
NODE_99496_length_366_cov_3.168539	133	193	10	13	60	0.2166667
NODE_99496_length_366_cov_3.168539	133	193	12	3	60	0.0500000
NODE_99496_length_366_cov_3.168539	133	193	16	27	60	0.4500000
NODE_100137_length_365_cov_140.101504	40	107	48	10	67	0.1492537
NODE_100137_length_365_cov_140.101504	40	107	50	1	67	0.0149254
NODE_100137_length_365_cov_140.101504	40	107	52	2	67	0.0298507
NODE_100137_length_365_cov_140.101504	40	107	58	2	67	0.0298507
NODE_100137_length_365_cov_140.101504	40	107	60	1	67	0.0149254
NODE_100137_length_365_cov_140.101504	40	107	64	3	67	0.0447761
NODE_100137_length_365_cov_140.101504	40	107	66	1	67	0.0149254
NODE_100137_length_365_cov_140.101504	40	107	70	3	67	0.0447761
NODE_100137_length_365_cov_140.101504	40	107	72	5	67	0.0746269
NODE_100137_length_365_cov_140.101504	40	107	76	1	67	0.0149254
NODE_100137_length_365_cov_140.101504	40	107	80	2	67	0.0298507
NODE_100137_length_365_cov_140.101504	40	107	82	9	67	0.1343284
NODE_100137_length_365_cov_140.101504	40	107	84	2	67	0.0298507
NODE_100137_length_365_cov_140.101504	40	107	86	5	67	0.0746269
NODE_100137_length_365_cov_140.101504	40	107	88	1	67	0.0149254
NODE_100137_length_365_cov_140.101504	40	107	90	1	67	0.0149254
NODE_100137_length_365_cov_140.101504	40	107	92	1	67	0.0149254
NODE_100137_length_365_cov_140.101504	40	107	94	2	67	0.0298507
NODE_100137_length_365_cov_140.101504	40	107	96	8	67	0.1194030
NODE_100137_length_365_cov_140.101504	40	107	99	1	67	0.0149254
NODE_100137_length_365_cov_140.101504	40	107	100	6	67	0.0895522
NODE_100138_length_365_cov_45.815789	0	38	0	38	38	1.0000000
NODE_100138_length_365_cov_45.815789	11	91	0	80	80	1.0000000
NODE_100140_length_365_cov_8.169173	191	244	4	12	53	0.2264151
NODE_100140_length_365_cov_8.169173	191	244	10	2	53	0.0377358
NODE_100140_length_365_cov_8.169173	191	244	12	39	53	0.7358491
NODE_100140_length_365_cov_8.169173	217	297	8	13	80	0.1625000
NODE_100140_length_365_cov_8.169173	217	297	10	32	80	0.4000000
NODE_100140_length_365_cov_8.169173	217	297	12	35	80	0.4375000
NODE_100145_length_365_cov_5.954887	136	216	0	80	80	1.0000000
NODE_100145_length_365_cov_5.954887	189	269	0	80	80	1.0000000
NODE_100147_length_365_cov_5.721805	37	78	2	41	41	1.0000000
NODE_100168_length_365_cov_4.195489	269	329	0	60	60	1.0000000
NODE_100172_length_365_cov_4.071429	106	186	0	80	80	1.0000000
NODE_100172_length_365_cov_4.071429	159	239	0	80	80	1.0000000
NODE_100180_length_365_cov_3.879699	131	187	10	1	56	0.0178571
NODE_100180_length_365_cov_3.879699	131	187	14	13	56	0.2321429
NODE_100180_length_365_cov_3.879699	131	187	20	42	56	0.7500000
NODE_100206_length_365_cov_3.270677	211	280	0	69	69	1.0000000
NODE_100253_length_365_cov_2.601504	189	265	2	47	76	0.6184211
NODE_100253_length_365_cov_2.601504	189	265	4	1	76	0.0131579
NODE_100253_length_365_cov_2.601504	189	265	6	28	76	0.3684210
NODE_100293_length_365_cov_2.289474	169	249	0	80	80	1.0000000
NODE_100407_length_365_cov_1.635338	156	235	0	13	79	0.1645570
NODE_100407_length_365_cov_1.635338	156	235	2	9	79	0.1139240
NODE_100407_length_365_cov_1.635338	156	235	4	4	79	0.0506329
NODE_100407_length_365_cov_1.635338	156	235	6	1	79	0.0126582
NODE_100407_length_365_cov_1.635338	156	235	8	1	79	0.0126582
NODE_100407_length_365_cov_1.635338	156	235	12	1	79	0.0126582
NODE_100407_length_365_cov_1.635338	156	235	14	1	79	0.0126582
NODE_100407_length_365_cov_1.635338	156	235	16	12	79	0.1518987
NODE_100407_length_365_cov_1.635338	156	235	18	4	79	0.0506329
NODE_100407_length_365_cov_1.635338	156	235	20	2	79	0.0253165
NODE_100407_length_365_cov_1.635338	156	235	24	8	79	0.1012658
NODE_100407_length_365_cov_1.635338	156	235	26	5	79	0.0632911
NODE_100407_length_365_cov_1.635338	156	235	28	4	79	0.0506329
NODE_100407_length_365_cov_1.635338	156	235	30	14	79	0.1772152
NODE_100485_length_365_cov_1.421053	228	309	0	81	81	1.0000000
NODE_100570_length_365_cov_1.169173	57	137	0	80	80	1.0000000
NODE_100570_length_365_cov_1.169173	65	145	0	80	80	1.0000000
NODE_100570_length_365_cov_1.169173	194	274	0	10	80	0.1250000
NODE_100570_length_365_cov_1.169173	194	274	2	24	80	0.3000000
NODE_100570_length_365_cov_1.169173	194	274	5	2	80	0.0250000
NODE_100570_length_365_cov_1.169173	194	274	6	13	80	0.1625000
NODE_100570_length_365_cov_1.169173	194	274	8	20	80	0.2500000
NODE_100570_length_365_cov_1.169173	194	274	10	11	80	0.1375000
NODE_100893_length_364_cov_24.600000	101	181	0	80	80	1.0000000
NODE_100893_length_364_cov_24.600000	154	234	0	80	80	1.0000000
NODE_100896_length_364_cov_7.377358	0	50	0	50	50	1.0000000
NODE_100933_length_364_cov_3.988679	122	168	0	46	46	1.0000000
NODE_100935_length_364_cov_3.913208	151	208	0	5	57	0.0877193
NODE_100935_length_364_cov_3.913208	151	208	1	2	57	0.0350877
NODE_100935_length_364_cov_3.913208	151	208	2	24	57	0.4210526
NODE_100935_length_364_cov_3.913208	151	208	4	26	57	0.4561403
NODE_100959_length_364_cov_3.305660	296	358	0	62	62	1.0000000
NODE_100966_length_364_cov_3.181132	78	138	0	60	60	1.0000000
NODE_100975_length_364_cov_3.041509	264	321	0	57	57	1.0000000
NODE_100975_length_364_cov_3.041509	294	359	0	65	65	1.0000000
NODE_100978_length_364_cov_3.015094	238	274	0	36	36	1.0000000
NODE_101087_length_364_cov_1.977358	126	201	8	29	75	0.3866667
NODE_101087_length_364_cov_1.977358	126	201	10	8	75	0.1066667
NODE_101087_length_364_cov_1.977358	126	201	12	4	75	0.0533333
NODE_101087_length_364_cov_1.977358	126	201	14	34	75	0.4533333
NODE_101141_length_364_cov_1.811321	209	256	0	47	47	1.0000000
NODE_101148_length_364_cov_1.781132	130	203	0	1	73	0.0136986
NODE_101148_length_364_cov_1.781132	130	203	6	1	73	0.0136986
NODE_101148_length_364_cov_1.781132	130	203	10	2	73	0.0273973
NODE_101148_length_364_cov_1.781132	130	203	13	4	73	0.0547945
NODE_101148_length_364_cov_1.781132	130	203	16	22	73	0.3013699
NODE_101148_length_364_cov_1.781132	130	203	18	13	73	0.1780822
NODE_101148_length_364_cov_1.781132	130	203	20	30	73	0.4109589
NODE_101148_length_364_cov_1.781132	183	203	0	1	20	0.0500000
NODE_101148_length_364_cov_1.781132	183	203	6	1	20	0.0500000
NODE_101148_length_364_cov_1.781132	183	203	10	2	20	0.1000000
NODE_101148_length_364_cov_1.781132	183	203	13	4	20	0.2000000
NODE_101148_length_364_cov_1.781132	183	203	16	12	20	0.6000000
NODE_101720_length_363_cov_7.791667	121	200	0	44	79	0.5569620
NODE_101720_length_363_cov_7.791667	121	200	2	35	79	0.4430380
NODE_101725_length_363_cov_6.484848	33	90	6	12	57	0.2105263
NODE_101725_length_363_cov_6.484848	33	90	8	45	57	0.7894737
NODE_101725_length_363_cov_6.484848	93	146	0	12	53	0.2264151
NODE_101725_length_363_cov_6.484848	93	146	2	12	53	0.2264151
NODE_101725_length_363_cov_6.484848	93	146	8	29	53	0.5471698
NODE_101734_length_363_cov_4.825758	154	215	0	3	61	0.0491803
NODE_101734_length_363_cov_4.825758	154	215	2	1	61	0.0163934
NODE_101734_length_363_cov_4.825758	154	215	4	57	61	0.9344262
NODE_101760_length_363_cov_3.950758	112	183	0	47	71	0.6619718
NODE_101760_length_363_cov_3.950758	112	183	2	24	71	0.3380282
NODE_101760_length_363_cov_3.950758	156	236	0	80	80	1.0000000
NODE_101769_length_363_cov_3.617424	16	79	0	63	63	1.0000000
NODE_101774_length_363_cov_3.409091	241	267	0	26	26	1.0000000
NODE_101791_length_363_cov_3.087121	228	308	0	38	80	0.4750000
NODE_101791_length_363_cov_3.087121	228	308	2	42	80	0.5250000
NODE_101809_length_363_cov_2.795455	240	320	4	3	80	0.0375000
NODE_101809_length_363_cov_2.795455	240	320	6	8	80	0.1000000
NODE_101809_length_363_cov_2.795455	240	320	8	2	80	0.0250000
NODE_101809_length_363_cov_2.795455	240	320	9	1	80	0.0125000
NODE_101809_length_363_cov_2.795455	240	320	10	1	80	0.0125000
NODE_101809_length_363_cov_2.795455	240	320	11	7	80	0.0875000
NODE_101809_length_363_cov_2.795455	240	320	12	11	80	0.1375000
NODE_101809_length_363_cov_2.795455	240	320	13	1	80	0.0125000
NODE_101809_length_363_cov_2.795455	240	320	14	4	80	0.0500000
NODE_101809_length_363_cov_2.795455	240	320	16	11	80	0.1375000
NODE_101809_length_363_cov_2.795455	240	320	18	22	80	0.2750000
NODE_101809_length_363_cov_2.795455	240	320	19	7	80	0.0875000
NODE_101809_length_363_cov_2.795455	240	320	20	2	80	0.0250000
NODE_101822_length_363_cov_2.481061	86	166	0	16	80	0.2000000
NODE_101822_length_363_cov_2.481061	86	166	2	2	80	0.0250000
NODE_101822_length_363_cov_2.481061	86	166	4	62	80	0.7750000
NODE_101822_length_363_cov_2.481061	139	219	0	11	80	0.1375000
NODE_101822_length_363_cov_2.481061	139	219	2	16	80	0.2000000
NODE_101822_length_363_cov_2.481061	139	219	4	53	80	0.6625000
NODE_101879_length_363_cov_2.034091	46	126	0	80	80	1.0000000
NODE_101879_length_363_cov_2.034091	99	153	0	54	54	1.0000000
NODE_101992_length_363_cov_1.541667	235	315	0	12	80	0.1500000
NODE_101992_length_363_cov_1.541667	235	315	4	68	80	0.8500000
NODE_102022_length_363_cov_1.477273	141	202	0	12	61	0.1967213
NODE_102022_length_363_cov_1.477273	141	202	4	20	61	0.3278688
NODE_102022_length_363_cov_1.477273	141	202	8	2	61	0.0327869
NODE_102022_length_363_cov_1.477273	141	202	10	12	61	0.1967213
NODE_102022_length_363_cov_1.477273	141	202	14	15	61	0.2459016
NODE_102022_length_363_cov_1.477273	153	210	4	20	57	0.3508772
NODE_102022_length_363_cov_1.477273	153	210	8	2	57	0.0350877
NODE_102022_length_363_cov_1.477273	153	210	10	12	57	0.2105263
NODE_102022_length_363_cov_1.477273	153	210	14	23	57	0.4035088
NODE_102187_length_363_cov_1.113636	245	316	0	21	71	0.2957746
NODE_102187_length_363_cov_1.113636	245	316	2	50	71	0.7042254
NODE_102464_length_362_cov_54.927757	52	116	0	64	64	1.0000000
NODE_102465_length_362_cov_29.273764	86	166	0	12	80	0.1500000
NODE_102465_length_362_cov_29.273764	86	166	1	25	80	0.3125000
NODE_102465_length_362_cov_29.273764	86	166	2	43	80	0.5375000
NODE_102465_length_362_cov_29.273764	139	219	0	65	80	0.8125000
NODE_102465_length_362_cov_29.273764	139	219	1	15	80	0.1875000
NODE_102467_length_362_cov_14.847909	130	210	0	14	80	0.1750000
NODE_102467_length_362_cov_14.847909	130	210	2	66	80	0.8250000
NODE_102467_length_362_cov_14.847909	183	263	0	35	80	0.4375000
NODE_102467_length_362_cov_14.847909	183	263	2	45	80	0.5625000
NODE_102633_length_362_cov_2.159696	133	216	0	51	83	0.6144578
NODE_102633_length_362_cov_2.159696	133	216	2	32	83	0.3855422
NODE_103259_length_361_cov_4.641221	249	312	0	26	63	0.4126984
NODE_103259_length_361_cov_4.641221	249	312	2	37	63	0.5873016
NODE_103280_length_361_cov_3.717557	185	265	0	80	80	1.0000000
NODE_103280_length_361_cov_3.717557	238	265	0	27	27	1.0000000
NODE_103314_length_361_cov_2.988550	121	201	10	8	80	0.1000000
NODE_103314_length_361_cov_2.988550	121	201	11	28	80	0.3500000
NODE_103314_length_361_cov_2.988550	121	201	12	44	80	0.5500000
NODE_103314_length_361_cov_2.988550	174	216	9	4	42	0.0952381
NODE_103314_length_361_cov_2.988550	174	216	11	38	42	0.9047619
NODE_103338_length_361_cov_2.641221	4	33	0	29	29	1.0000000
NODE_103338_length_361_cov_2.641221	101	182	0	81	81	1.0000000
NODE_103391_length_361_cov_2.137405	138	194	0	56	56	1.0000000
NODE_103396_length_361_cov_2.106870	192	256	0	64	64	1.0000000
NODE_103418_length_361_cov_1.969466	137	198	6	53	61	0.8688524
NODE_103418_length_361_cov_1.969466	137	198	7	4	61	0.0655738
NODE_103418_length_361_cov_1.969466	137	198	8	4	61	0.0655738
NODE_103632_length_361_cov_1.343511	171	250	0	79	79	1.0000000
NODE_103802_length_361_cov_1.000000	60	123	0	63	63	1.0000000
NODE_104057_length_360_cov_8.191571	171	242	0	24	71	0.3380282
NODE_104057_length_360_cov_8.191571	171	242	3	2	71	0.0281690
NODE_104057_length_360_cov_8.191571	171	242	7	13	71	0.1830986
NODE_104057_length_360_cov_8.191571	171	242	8	32	71	0.4507042
NODE_104057_length_360_cov_8.191571	176	242	0	19	66	0.2878788
NODE_104057_length_360_cov_8.191571	176	242	3	2	66	0.0303030
NODE_104057_length_360_cov_8.191571	176	242	7	13	66	0.1969697
NODE_104057_length_360_cov_8.191571	176	242	8	32	66	0.4848485
NODE_104057_length_360_cov_8.191571	215	279	4	7	64	0.1093750
NODE_104057_length_360_cov_8.191571	215	279	8	57	64	0.8906250
NODE_104057_length_360_cov_8.191571	215	279	4	7	64	0.1093750
NODE_104057_length_360_cov_8.191571	215	279	8	57	64	0.8906250
NODE_104079_length_360_cov_5.003831	86	166	0	80	80	1.0000000
NODE_104091_length_360_cov_4.111111	158	238	63	2	80	0.0250000
NODE_104091_length_360_cov_4.111111	158	238	64	5	80	0.0625000
NODE_104091_length_360_cov_4.111111	158	238	68	3	80	0.0375000
NODE_104091_length_360_cov_4.111111	158	238	70	2	80	0.0250000
NODE_104091_length_360_cov_4.111111	158	238	71	8	80	0.1000000
NODE_104091_length_360_cov_4.111111	158	238	72	5	80	0.0625000
NODE_104091_length_360_cov_4.111111	158	238	73	3	80	0.0375000
NODE_104091_length_360_cov_4.111111	158	238	74	9	80	0.1125000
NODE_104091_length_360_cov_4.111111	158	238	76	2	80	0.0250000
NODE_104091_length_360_cov_4.111111	158	238	78	1	80	0.0125000
NODE_104091_length_360_cov_4.111111	158	238	80	2	80	0.0250000
NODE_104091_length_360_cov_4.111111	158	238	82	8	80	0.1000000
NODE_104091_length_360_cov_4.111111	158	238	84	16	80	0.2000000
NODE_104091_length_360_cov_4.111111	158	238	86	14	80	0.1750000
NODE_104102_length_360_cov_3.613027	123	203	0	80	80	1.0000000
NODE_104102_length_360_cov_3.613027	176	256	0	80	80	1.0000000
NODE_104129_length_360_cov_3.080460	48	70	0	22	22	1.0000000
NODE_104162_length_360_cov_2.689655	118	198	0	14	80	0.1750000
NODE_104162_length_360_cov_2.689655	118	198	2	6	80	0.0750000
NODE_104162_length_360_cov_2.689655	118	198	4	38	80	0.4750000
NODE_104162_length_360_cov_2.689655	118	198	6	22	80	0.2750000
NODE_104261_length_360_cov_1.977011	235	286	2	2	51	0.0392157
NODE_104261_length_360_cov_1.977011	235	286	4	16	51	0.3137255
NODE_104261_length_360_cov_1.977011	235	286	6	33	51	0.6470588
NODE_104572_length_360_cov_1.149425	273	353	0	80	80	1.0000000
NODE_104669_length_360_cov_0.965517	119	175	2	3	56	0.0535714
NODE_104669_length_360_cov_0.965517	119	175	4	53	56	0.9464286
NODE_104671_length_360_cov_0.957854	140	186	0	3	46	0.0652174
NODE_104671_length_360_cov_0.957854	140	186	2	43	46	0.9347826
NODE_104858_length_359_cov_45.519231	140	220	0	7	80	0.0875000
NODE_104858_length_359_cov_45.519231	140	220	2	73	80	0.9125000
NODE_104858_length_359_cov_45.519231	193	273	0	31	80	0.3875000
NODE_104858_length_359_cov_45.519231	193	273	2	49	80	0.6125000
NODE_104932_length_359_cov_3.296154	67	147	6	8	80	0.1000000
NODE_104932_length_359_cov_3.296154	67	147	8	49	80	0.6125000
NODE_104932_length_359_cov_3.296154	67	147	10	15	80	0.1875000
NODE_104932_length_359_cov_3.296154	67	147	12	8	80	0.1000000
NODE_104932_length_359_cov_3.296154	120	177	8	16	57	0.2807018
NODE_104932_length_359_cov_3.296154	120	177	10	3	57	0.0526316
NODE_104932_length_359_cov_3.296154	120	177	12	29	57	0.5087720
NODE_104932_length_359_cov_3.296154	120	177	13	1	57	0.0175439
NODE_104932_length_359_cov_3.296154	120	177	14	8	57	0.1403509
NODE_104932_length_359_cov_3.296154	201	256	2	2	55	0.0363636
NODE_104932_length_359_cov_3.296154	201	256	4	11	55	0.2000000
NODE_104932_length_359_cov_3.296154	201	256	6	18	55	0.3272727
NODE_104932_length_359_cov_3.296154	201	256	8	8	55	0.1454545
NODE_104932_length_359_cov_3.296154	201	256	10	1	55	0.0181818
NODE_104932_length_359_cov_3.296154	201	256	12	15	55	0.2727273
NODE_104936_length_359_cov_3.276923	5	95	0	90	90	1.0000000
NODE_104954_length_359_cov_3.007692	156	212	0	14	56	0.2500000
NODE_104954_length_359_cov_3.007692	156	212	4	42	56	0.7500000
NODE_104998_length_359_cov_2.523077	148	228	0	13	80	0.1625000
NODE_104998_length_359_cov_2.523077	148	228	4	2	80	0.0250000
NODE_104998_length_359_cov_2.523077	148	228	5	1	80	0.0125000
NODE_104998_length_359_cov_2.523077	148	228	6	64	80	0.8000000
NODE_104998_length_359_cov_2.523077	201	278	6	77	77	1.0000000
NODE_105002_length_359_cov_2.419231	106	186	0	80	80	1.0000000
NODE_105002_length_359_cov_2.419231	159	211	0	50	52	0.9615384
NODE_105002_length_359_cov_2.419231	159	211	10	2	52	0.0384615
NODE_105006_length_359_cov_2.353846	172	243	0	71	71	1.0000000
NODE_105006_length_359_cov_2.353846	216	296	0	80	80	1.0000000
NODE_105026_length_359_cov_2.257692	211	270	2	7	59	0.1186441
NODE_105026_length_359_cov_2.257692	211	270	4	52	59	0.8813559
NODE_105063_length_359_cov_2.003846	8	88	0	80	80	1.0000000
NODE_105063_length_359_cov_2.003846	61	139	0	78	78	1.0000000
NODE_105106_length_359_cov_1.815385	126	207	0	81	81	1.0000000
NODE_105106_length_359_cov_1.815385	180	227	0	47	47	1.0000000
NODE_105142_length_359_cov_1.692308	88	116	0	28	28	1.0000000
NODE_105373_length_359_cov_1.096154	64	89	0	8	25	0.3200000
NODE_105373_length_359_cov_1.096154	64	89	1	14	25	0.5600000
NODE_105373_length_359_cov_1.096154	64	89	2	3	25	0.1200000
NODE_105599_length_359_cov_0.711538	222	248	0	26	26	1.0000000
NODE_105600_length_359_cov_0.707692	10	90	0	52	80	0.6500000
NODE_105600_length_359_cov_0.707692	10	90	4	28	80	0.3500000
NODE_105600_length_359_cov_0.707692	10	90	0	52	80	0.6500000
NODE_105600_length_359_cov_0.707692	10	90	4	28	80	0.3500000
NODE_105600_length_359_cov_0.707692	63	143	4	80	80	1.0000000
NODE_105678_length_358_cov_19.760618	213	293	0	1	80	0.0125000
NODE_105678_length_358_cov_19.760618	213	293	4	79	80	0.9875000
NODE_105678_length_358_cov_19.760618	266	346	0	54	80	0.6750000
NODE_105678_length_358_cov_19.760618	266	346	4	26	80	0.3250000
NODE_105679_length_358_cov_18.455598	303	358	0	55	55	1.0000000
NODE_105680_length_358_cov_17.023166	0	63	10	17	63	0.2698413
NODE_105680_length_358_cov_17.023166	0	63	11	12	63	0.1904762
NODE_105680_length_358_cov_17.023166	0	63	13	1	63	0.0158730
NODE_105680_length_358_cov_17.023166	0	63	14	10	63	0.1587302
NODE_105680_length_358_cov_17.023166	0	63	16	2	63	0.0317460
NODE_105680_length_358_cov_17.023166	0	63	17	6	63	0.0952381
NODE_105680_length_358_cov_17.023166	0	63	18	2	63	0.0317460
NODE_105680_length_358_cov_17.023166	0	63	19	5	63	0.0793651
NODE_105680_length_358_cov_17.023166	0	63	31	8	63	0.1269841
NODE_105680_length_358_cov_17.023166	0	63	10	17	63	0.2698413
NODE_105680_length_358_cov_17.023166	0	63	11	12	63	0.1904762
NODE_105680_length_358_cov_17.023166	0	63	13	1	63	0.0158730
NODE_105680_length_358_cov_17.023166	0	63	14	10	63	0.1587302
NODE_105680_length_358_cov_17.023166	0	63	16	2	63	0.0317460
NODE_105680_length_358_cov_17.023166	0	63	17	6	63	0.0952381
NODE_105680_length_358_cov_17.023166	0	63	18	2	63	0.0317460
NODE_105680_length_358_cov_17.023166	0	63	19	5	63	0.0793651
NODE_105680_length_358_cov_17.023166	0	63	31	8	63	0.1269841
NODE_105680_length_358_cov_17.023166	0	63	10	17	63	0.2698413
NODE_105680_length_358_cov_17.023166	0	63	11	12	63	0.1904762
NODE_105680_length_358_cov_17.023166	0	63	13	1	63	0.0158730
NODE_105680_length_358_cov_17.023166	0	63	14	10	63	0.1587302
NODE_105680_length_358_cov_17.023166	0	63	16	2	63	0.0317460
NODE_105680_length_358_cov_17.023166	0	63	17	6	63	0.0952381
NODE_105680_length_358_cov_17.023166	0	63	18	2	63	0.0317460
NODE_105680_length_358_cov_17.023166	0	63	19	5	63	0.0793651
NODE_105680_length_358_cov_17.023166	0	63	31	8	63	0.1269841
NODE_105680_length_358_cov_17.023166	36	116	14	4	80	0.0500000
NODE_105680_length_358_cov_17.023166	36	116	16	2	80	0.0250000
NODE_105680_length_358_cov_17.023166	36	116	17	6	80	0.0750000
NODE_105680_length_358_cov_17.023166	36	116	18	2	80	0.0250000
NODE_105680_length_358_cov_17.023166	36	116	19	5	80	0.0625000
NODE_105680_length_358_cov_17.023166	36	116	31	10	80	0.1250000
NODE_105680_length_358_cov_17.023166	36	116	32	1	80	0.0125000
NODE_105680_length_358_cov_17.023166	36	116	33	3	80	0.0375000
NODE_105680_length_358_cov_17.023166	36	116	40	22	80	0.2750000
NODE_105680_length_358_cov_17.023166	36	116	42	3	80	0.0375000
NODE_105680_length_358_cov_17.023166	36	116	44	22	80	0.2750000
NODE_105680_length_358_cov_17.023166	53	115	19	2	62	0.0322581
NODE_105680_length_358_cov_17.023166	53	115	31	9	62	0.1451613
NODE_105680_length_358_cov_17.023166	53	115	32	1	62	0.0161290
NODE_105680_length_358_cov_17.023166	53	115	33	3	62	0.0483871
NODE_105680_length_358_cov_17.023166	53	115	40	22	62	0.3548387
NODE_105680_length_358_cov_17.023166	53	115	42	3	62	0.0483871
NODE_105680_length_358_cov_17.023166	53	115	44	22	62	0.3548387
NODE_105686_length_358_cov_6.509653	109	155	4	46	46	1.0000000
NODE_105710_length_358_cov_4.239382	114	143	4	6	29	0.2068966
NODE_105710_length_358_cov_4.239382	114	143	6	16	29	0.5517241
NODE_105710_length_358_cov_4.239382	114	143	8	7	29	0.2413793
NODE_105710_length_358_cov_4.239382	180	245	12	17	65	0.2615385
NODE_105710_length_358_cov_4.239382	180	245	14	48	65	0.7384616
NODE_105710_length_358_cov_4.239382	218	298	0	15	80	0.1875000
NODE_105710_length_358_cov_4.239382	218	298	4	16	80	0.2000000
NODE_105710_length_358_cov_4.239382	218	298	6	13	80	0.1625000
NODE_105710_length_358_cov_4.239382	218	298	10	7	80	0.0875000
NODE_105710_length_358_cov_4.239382	218	298	12	19	80	0.2375000
NODE_105710_length_358_cov_4.239382	218	298	14	10	80	0.1250000
NODE_105846_length_358_cov_2.162162	229	305	0	34	76	0.4473684
NODE_105846_length_358_cov_2.162162	229	305	2	16	76	0.2105263
NODE_105846_length_358_cov_2.162162	229	305	4	26	76	0.3421053
NODE_105902_length_358_cov_1.926641	290	358	0	4	68	0.0588235
NODE_105902_length_358_cov_1.926641	290	358	2	64	68	0.9411765
NODE_105910_length_358_cov_1.884170	250	317	0	67	67	1.0000000
NODE_105923_length_358_cov_1.841699	189	269	8	2	80	0.0250000
NODE_105923_length_358_cov_1.841699	189	269	9	1	80	0.0125000
NODE_105923_length_358_cov_1.841699	189	269	10	1	80	0.0125000
NODE_105923_length_358_cov_1.841699	189	269	12	3	80	0.0375000
NODE_105923_length_358_cov_1.841699	189	269	14	2	80	0.0250000
NODE_105923_length_358_cov_1.841699	189	269	18	2	80	0.0250000
NODE_105923_length_358_cov_1.841699	189	269	20	1	80	0.0125000
NODE_105923_length_358_cov_1.841699	189	269	22	3	80	0.0375000
NODE_105923_length_358_cov_1.841699	189	269	28	1	80	0.0125000
NODE_105923_length_358_cov_1.841699	189	269	29	2	80	0.0250000
NODE_105923_length_358_cov_1.841699	189	269	31	14	80	0.1750000
NODE_105923_length_358_cov_1.841699	189	269	33	6	80	0.0750000
NODE_105923_length_358_cov_1.841699	189	269	35	5	80	0.0625000
NODE_105923_length_358_cov_1.841699	189	269	36	2	80	0.0250000
NODE_105923_length_358_cov_1.841699	189	269	38	17	80	0.2125000
NODE_105923_length_358_cov_1.841699	189	269	39	4	80	0.0500000
NODE_105923_length_358_cov_1.841699	189	269	41	12	80	0.1500000
NODE_105923_length_358_cov_1.841699	189	269	42	2	80	0.0250000
NODE_106096_length_358_cov_1.235521	99	179	4	2	80	0.0250000
NODE_106096_length_358_cov_1.235521	99	179	6	7	80	0.0875000
NODE_106096_length_358_cov_1.235521	99	179	8	13	80	0.1625000
NODE_106096_length_358_cov_1.235521	99	179	10	4	80	0.0500000
NODE_106096_length_358_cov_1.235521	99	179	12	23	80	0.2875000
NODE_106096_length_358_cov_1.235521	99	179	14	31	80	0.3875000
NODE_106096_length_358_cov_1.235521	152	222	0	25	70	0.3571429
NODE_106096_length_358_cov_1.235521	152	222	1	2	70	0.0285714
NODE_106096_length_358_cov_1.235521	152	222	2	10	70	0.1428571
NODE_106096_length_358_cov_1.235521	152	222	4	8	70	0.1142857
NODE_106096_length_358_cov_1.235521	152	222	6	7	70	0.1000000
NODE_106096_length_358_cov_1.235521	152	222	8	13	70	0.1857143
NODE_106096_length_358_cov_1.235521	152	222	10	4	70	0.0571429
NODE_106096_length_358_cov_1.235521	152	222	12	1	70	0.0142857
NODE_106189_length_358_cov_1.096525	148	228	0	80	80	1.0000000
NODE_106233_length_358_cov_0.984556	193	265	0	72	72	1.0000000
NODE_106489_length_357_cov_381.833333	244	324	44	10	80	0.1250000
NODE_106489_length_357_cov_381.833333	244	324	51	1	80	0.0125000
NODE_106489_length_357_cov_381.833333	244	324	56	6	80	0.0750000
NODE_106489_length_357_cov_381.833333	244	324	60	2	80	0.0250000
NODE_106489_length_357_cov_381.833333	244	324	72	2	80	0.0250000
NODE_106489_length_357_cov_381.833333	244	324	74	3	80	0.0375000
NODE_106489_length_357_cov_381.833333	244	324	75	1	80	0.0125000
NODE_106489_length_357_cov_381.833333	244	324	76	55	80	0.6875000
NODE_106493_length_357_cov_7.643411	45	125	0	80	80	1.0000000
NODE_106493_length_357_cov_7.643411	98	178	0	80	80	1.0000000
NODE_106495_length_357_cov_7.027132	157	237	0	80	80	1.0000000
NODE_106495_length_357_cov_7.027132	210	252	0	42	42	1.0000000
NODE_106496_length_357_cov_6.732558	183	263	8	23	80	0.2875000
NODE_106496_length_357_cov_6.732558	183	263	10	37	80	0.4625000
NODE_106496_length_357_cov_6.732558	183	263	12	13	80	0.1625000
NODE_106496_length_357_cov_6.732558	183	263	14	7	80	0.0875000
NODE_106529_length_357_cov_4.081395	145	225	0	80	80	1.0000000
NODE_106529_length_357_cov_4.081395	198	271	0	73	73	1.0000000
NODE_106542_length_357_cov_3.724806	192	265	0	73	73	1.0000000
NODE_106558_length_357_cov_3.341085	205	285	0	80	80	1.0000000
NODE_106558_length_357_cov_3.341085	258	338	0	80	80	1.0000000
NODE_106625_length_357_cov_2.414729	245	302	6	57	57	1.0000000
NODE_106625_length_357_cov_2.414729	275	355	0	19	80	0.2375000
NODE_106625_length_357_cov_2.414729	275	355	2	1	80	0.0125000
NODE_106625_length_357_cov_2.414729	275	355	4	20	80	0.2500000
NODE_106625_length_357_cov_2.414729	275	355	5	1	80	0.0125000
NODE_106625_length_357_cov_2.414729	275	355	6	39	80	0.4875000
NODE_106661_length_357_cov_2.174419	250	330	0	80	80	1.0000000
NODE_106666_length_357_cov_2.166667	103	133	0	30	30	1.0000000
NODE_106666_length_357_cov_2.166667	112	133	0	21	21	1.0000000
NODE_106702_length_357_cov_1.961240	150	169	0	19	19	1.0000000
NODE_106708_length_357_cov_1.918605	173	253	22	1	80	0.0125000
NODE_106708_length_357_cov_1.918605	173	253	30	1	80	0.0125000
NODE_106708_length_357_cov_1.918605	173	253	33	2	80	0.0250000
NODE_106708_length_357_cov_1.918605	173	253	37	4	80	0.0500000
NODE_106708_length_357_cov_1.918605	173	253	39	40	80	0.5000000
NODE_106708_length_357_cov_1.918605	173	253	43	3	80	0.0375000
NODE_106708_length_357_cov_1.918605	173	253	46	1	80	0.0125000
NODE_106708_length_357_cov_1.918605	173	253	47	7	80	0.0875000
NODE_106708_length_357_cov_1.918605	173	253	48	10	80	0.1250000
NODE_106708_length_357_cov_1.918605	173	253	50	11	80	0.1375000
NODE_106737_length_357_cov_1.782946	73	142	0	69	69	1.0000000
NODE_106737_length_357_cov_1.782946	115	195	0	80	80	1.0000000
NODE_107002_length_357_cov_1.127907	98	129	8	31	31	1.0000000
NODE_107306_length_356_cov_5.299611	140	200	14	6	60	0.1000000
NODE_107306_length_356_cov_5.299611	140	200	16	54	60	0.9000000
NODE_107347_length_356_cov_3.400778	255	317	4	10	62	0.1612903
NODE_107347_length_356_cov_3.400778	255	317	6	52	62	0.8387097
NODE_107347_length_356_cov_3.400778	308	353	0	1	45	0.0222222
NODE_107347_length_356_cov_3.400778	308	353	4	44	45	0.9777778
NODE_107402_length_356_cov_2.657588	256	298	83	5	42	0.1190476
NODE_107402_length_356_cov_2.657588	256	298	84	5	42	0.1190476
NODE_107402_length_356_cov_2.657588	256	298	86	10	42	0.2380952
NODE_107402_length_356_cov_2.657588	256	298	88	1	42	0.0238095
NODE_107402_length_356_cov_2.657588	256	298	90	7	42	0.1666667
NODE_107402_length_356_cov_2.657588	256	298	92	10	42	0.2380952
NODE_107402_length_356_cov_2.657588	256	298	94	1	42	0.0238095
NODE_107402_length_356_cov_2.657588	256	298	96	3	42	0.0714286
NODE_107402_length_356_cov_2.657588	265	338	25	1	73	0.0136986
NODE_107402_length_356_cov_2.657588	265	338	28	1	73	0.0136986
NODE_107402_length_356_cov_2.657588	265	338	30	2	73	0.0273973
NODE_107402_length_356_cov_2.657588	265	338	32	2	73	0.0273973
NODE_107402_length_356_cov_2.657588	265	338	36	1	73	0.0136986
NODE_107402_length_356_cov_2.657588	265	338	39	3	73	0.0410959
NODE_107402_length_356_cov_2.657588	265	338	41	1	73	0.0136986
NODE_107402_length_356_cov_2.657588	265	338	43	2	73	0.0273973
NODE_107402_length_356_cov_2.657588	265	338	44	1	73	0.0136986
NODE_107402_length_356_cov_2.657588	265	338	56	3	73	0.0410959
NODE_107402_length_356_cov_2.657588	265	338	61	8	73	0.1095890
NODE_107402_length_356_cov_2.657588	265	338	63	8	73	0.1095890
NODE_107402_length_356_cov_2.657588	265	338	73	1	73	0.0136986
NODE_107402_length_356_cov_2.657588	265	338	75	1	73	0.0136986
NODE_107402_length_356_cov_2.657588	265	338	81	1	73	0.0136986
NODE_107402_length_356_cov_2.657588	265	338	82	3	73	0.0410959
NODE_107402_length_356_cov_2.657588	265	338	83	6	73	0.0821918
NODE_107402_length_356_cov_2.657588	265	338	84	5	73	0.0684932
NODE_107402_length_356_cov_2.657588	265	338	86	10	73	0.1369863
NODE_107402_length_356_cov_2.657588	265	338	88	1	73	0.0136986
NODE_107402_length_356_cov_2.657588	265	338	90	7	73	0.0958904
NODE_107402_length_356_cov_2.657588	265	338	92	5	73	0.0684932
NODE_107402_length_356_cov_2.657588	299	351	8	4	52	0.0769231
NODE_107402_length_356_cov_2.657588	299	351	12	2	52	0.0384615
NODE_107402_length_356_cov_2.657588	299	351	18	1	52	0.0192308
NODE_107402_length_356_cov_2.657588	299	351	21	1	52	0.0192308
NODE_107402_length_356_cov_2.657588	299	351	24	2	52	0.0384615
NODE_107402_length_356_cov_2.657588	299	351	25	4	52	0.0769231
NODE_107402_length_356_cov_2.657588	299	351	28	1	52	0.0192308
NODE_107402_length_356_cov_2.657588	299	351	30	2	52	0.0384615
NODE_107402_length_356_cov_2.657588	299	351	32	2	52	0.0384615
NODE_107402_length_356_cov_2.657588	299	351	36	1	52	0.0192308
NODE_107402_length_356_cov_2.657588	299	351	39	3	52	0.0576923
NODE_107402_length_356_cov_2.657588	299	351	41	1	52	0.0192308
NODE_107402_length_356_cov_2.657588	299	351	43	2	52	0.0384615
NODE_107402_length_356_cov_2.657588	299	351	44	1	52	0.0192308
NODE_107402_length_356_cov_2.657588	299	351	56	3	52	0.0576923
NODE_107402_length_356_cov_2.657588	299	351	61	8	52	0.1538462
NODE_107402_length_356_cov_2.657588	299	351	63	8	52	0.1538462
NODE_107402_length_356_cov_2.657588	299	351	73	1	52	0.0192308
NODE_107402_length_356_cov_2.657588	299	351	75	1	52	0.0192308
NODE_107402_length_356_cov_2.657588	299	351	81	1	52	0.0192308
NODE_107402_length_356_cov_2.657588	299	351	82	3	52	0.0576923
NODE_107452_length_356_cov_2.237354	90	135	2	2	45	0.0444444
NODE_107452_length_356_cov_2.237354	90	135	4	1	45	0.0222222
NODE_107452_length_356_cov_2.237354	90	135	6	4	45	0.0888889
NODE_107452_length_356_cov_2.237354	90	135	9	1	45	0.0222222
NODE_107452_length_356_cov_2.237354	90	135	10	37	45	0.8222222
NODE_107475_length_356_cov_1.996109	127	194	0	67	67	1.0000000
NODE_107521_length_356_cov_1.813230	296	341	2	19	45	0.4222222
NODE_107521_length_356_cov_1.813230	296	341	4	26	45	0.5777778
NODE_107606_length_356_cov_1.560311	192	272	0	80	80	1.0000000
NODE_107606_length_356_cov_1.560311	245	319	0	74	74	1.0000000
NODE_108122_length_355_cov_6.796875	127	173	0	46	46	1.0000000
NODE_108210_length_355_cov_2.734375	111	162	0	51	51	1.0000000
NODE_108210_length_355_cov_2.734375	142	222	0	80	80	1.0000000
NODE_108215_length_355_cov_2.707031	277	314	0	37	37	1.0000000
NODE_108215_length_355_cov_2.707031	287	353	0	66	66	1.0000000
NODE_108239_length_355_cov_2.500000	38	82	2	44	44	1.0000000
NODE_108278_length_355_cov_2.207031	258	308	0	50	50	1.0000000
NODE_108284_length_355_cov_2.179688	153	233	15	20	80	0.2500000
NODE_108284_length_355_cov_2.179688	153	233	16	8	80	0.1000000
NODE_108284_length_355_cov_2.179688	153	233	18	5	80	0.0625000
NODE_108284_length_355_cov_2.179688	153	233	22	47	80	0.5875000
NODE_108284_length_355_cov_2.179688	206	286	4	6	80	0.0750000
NODE_108284_length_355_cov_2.179688	206	286	6	15	80	0.1875000
NODE_108284_length_355_cov_2.179688	206	286	8	11	80	0.1375000
NODE_108284_length_355_cov_2.179688	206	286	12	7	80	0.0875000
NODE_108284_length_355_cov_2.179688	206	286	16	7	80	0.0875000
NODE_108284_length_355_cov_2.179688	206	286	18	3	80	0.0375000
NODE_108284_length_355_cov_2.179688	206	286	22	31	80	0.3875000
NODE_108291_length_355_cov_2.132812	261	334	0	73	73	1.0000000
NODE_108291_length_355_cov_2.132812	301	342	0	41	41	1.0000000
NODE_108315_length_355_cov_2.007812	281	347	0	66	66	1.0000000
NODE_108395_length_355_cov_1.765625	186	247	3	7	61	0.1147541
NODE_108395_length_355_cov_1.765625	186	247	4	54	61	0.8852459
NODE_108395_length_355_cov_1.765625	220	300	2	7	80	0.0875000
NODE_108395_length_355_cov_1.765625	220	300	3	21	80	0.2625000
NODE_108395_length_355_cov_1.765625	220	300	4	52	80	0.6500000
NODE_109015_length_354_cov_6.843137	53	132	0	79	79	1.0000000
NODE_109015_length_354_cov_6.843137	53	132	0	79	79	1.0000000
NODE_109015_length_354_cov_6.843137	105	185	0	80	80	1.0000000
NODE_109015_length_354_cov_6.843137	105	185	0	80	80	1.0000000
NODE_109033_length_354_cov_4.823529	208	255	0	47	47	1.0000000
NODE_109054_length_354_cov_3.956863	145	208	0	63	63	1.0000000
NODE_109054_length_354_cov_3.956863	181	261	0	80	80	1.0000000
NODE_109057_length_354_cov_3.878431	198	244	0	46	46	1.0000000
NODE_109089_length_354_cov_3.207843	130	199	0	47	69	0.6811594
NODE_109089_length_354_cov_3.207843	130	199	2	22	69	0.3188406
NODE_109126_length_354_cov_2.725490	179	259	0	15	80	0.1875000
NODE_109126_length_354_cov_2.725490	179	259	3	2	80	0.0250000
NODE_109126_length_354_cov_2.725490	179	259	4	24	80	0.3000000
NODE_109126_length_354_cov_2.725490	179	259	10	7	80	0.0875000
NODE_109126_length_354_cov_2.725490	179	259	14	32	80	0.4000000
NODE_109126_length_354_cov_2.725490	235	312	14	77	77	1.0000000
NODE_109128_length_354_cov_2.713725	16	76	0	60	60	1.0000000
NODE_109128_length_354_cov_2.713725	90	149	0	59	59	1.0000000
NODE_109140_length_354_cov_2.580392	176	234	0	19	58	0.3275862
NODE_109140_length_354_cov_2.580392	176	234	2	1	58	0.0172414
NODE_109140_length_354_cov_2.580392	176	234	4	38	58	0.6551724
NODE_109140_length_354_cov_2.580392	207	251	4	44	44	1.0000000
NODE_109237_length_354_cov_1.996078	79	145	0	66	66	1.0000000
NODE_109237_length_354_cov_1.996078	118	200	0	82	82	1.0000000
NODE_109244_length_354_cov_1.988235	7	77	0	9	70	0.1285714
NODE_109244_length_354_cov_1.988235	7	77	1	3	70	0.0428571
NODE_109244_length_354_cov_1.988235	7	77	2	8	70	0.1142857
NODE_109244_length_354_cov_1.988235	7	77	6	50	70	0.7142857
NODE_109244_length_354_cov_1.988235	64	130	6	66	66	1.0000000
NODE_109321_length_354_cov_1.682353	99	171	0	9	72	0.1250000
NODE_109321_length_354_cov_1.682353	99	171	2	63	72	0.8750000
NODE_109321_length_354_cov_1.682353	144	224	0	7	80	0.0875000
NODE_109321_length_354_cov_1.682353	144	224	2	73	80	0.9125000
NODE_109852_length_353_cov_11.169291	14	90	0	76	76	1.0000000
NODE_109852_length_353_cov_11.169291	67	143	0	76	76	1.0000000
NODE_109911_length_353_cov_3.874016	220	256	0	36	36	1.0000000
NODE_109911_length_353_cov_3.874016	265	334	0	69	69	1.0000000
NODE_109928_length_353_cov_3.488189	200	282	2	29	82	0.3536585
NODE_109928_length_353_cov_3.488189	200	282	4	29	82	0.3536585
NODE_109928_length_353_cov_3.488189	200	282	6	24	82	0.2926829
NODE_109976_length_353_cov_2.826772	8	88	0	34	80	0.4250000
NODE_109976_length_353_cov_2.826772	8	88	2	46	80	0.5750000
NODE_109976_length_353_cov_2.826772	61	120	2	59	59	1.0000000
NODE_110022_length_353_cov_2.417323	260	336	0	76	76	1.0000000
NODE_110610_length_353_cov_0.744094	299	318	0	19	19	1.0000000
NODE_110708_length_352_cov_34.691700	110	203	0	90	93	0.9677419
NODE_110708_length_352_cov_34.691700	110	203	2	1	93	0.0107527
NODE_110708_length_352_cov_34.691700	110	203	14	1	93	0.0107527
NODE_110708_length_352_cov_34.691700	110	203	28	1	93	0.0107527
NODE_110710_length_352_cov_17.944664	20	100	0	80	80	1.0000000
NODE_110710_length_352_cov_17.944664	73	153	0	80	80	1.0000000
NODE_110710_length_352_cov_17.944664	273	352	0	79	79	1.0000000
NODE_110735_length_352_cov_4.707510	157	237	4	9	80	0.1125000
NODE_110735_length_352_cov_4.707510	157	237	6	54	80	0.6750000
NODE_110735_length_352_cov_4.707510	157	237	8	17	80	0.2125000
NODE_110749_length_352_cov_4.221344	144	205	0	61	61	1.0000000
NODE_110749_length_352_cov_4.221344	178	259	0	81	81	1.0000000
NODE_110754_length_352_cov_4.011858	98	143	0	45	45	1.0000000
NODE_110754_length_352_cov_4.011858	151	228	0	20	77	0.2597403
NODE_110754_length_352_cov_4.011858	151	228	2	57	77	0.7402598
NODE_110798_length_352_cov_2.849802	74	154	0	80	80	1.0000000
NODE_110798_length_352_cov_2.849802	127	198	0	71	71	1.0000000
NODE_110820_length_352_cov_2.683794	0	77	4	77	77	1.0000000
NODE_110820_length_352_cov_2.683794	50	130	2	8	80	0.1000000
NODE_110820_length_352_cov_2.683794	50	130	4	72	80	0.9000000
NODE_110832_length_352_cov_2.608696	90	136	0	46	46	1.0000000
NODE_110832_length_352_cov_2.608696	144	189	0	45	45	1.0000000
NODE_110838_length_352_cov_2.577075	111	191	2	80	80	1.0000000
NODE_110876_length_352_cov_2.264822	171	251	0	80	80	1.0000000
NODE_110938_length_352_cov_2.007905	277	326	0	49	49	1.0000000
NODE_111439_length_352_cov_0.806324	165	238	26	1	73	0.0136986
NODE_111439_length_352_cov_0.806324	165	238	27	2	73	0.0273973
NODE_111439_length_352_cov_0.806324	165	238	34	1	73	0.0136986
NODE_111439_length_352_cov_0.806324	165	238	35	1	73	0.0136986
NODE_111439_length_352_cov_0.806324	165	238	38	5	73	0.0684932
NODE_111439_length_352_cov_0.806324	165	238	39	1	73	0.0136986
NODE_111439_length_352_cov_0.806324	165	238	41	4	73	0.0547945
NODE_111439_length_352_cov_0.806324	165	238	43	1	73	0.0136986
NODE_111439_length_352_cov_0.806324	165	238	47	1	73	0.0136986
NODE_111439_length_352_cov_0.806324	165	238	49	1	73	0.0136986
NODE_111439_length_352_cov_0.806324	165	238	51	1	73	0.0136986
NODE_111439_length_352_cov_0.806324	165	238	53	2	73	0.0273973
NODE_111439_length_352_cov_0.806324	165	238	55	1	73	0.0136986
NODE_111439_length_352_cov_0.806324	165	238	57	2	73	0.0273973
NODE_111439_length_352_cov_0.806324	165	238	60	1	73	0.0136986
NODE_111439_length_352_cov_0.806324	165	238	61	1	73	0.0136986
NODE_111439_length_352_cov_0.806324	165	238	62	2	73	0.0273973
NODE_111439_length_352_cov_0.806324	165	238	64	1	73	0.0136986
NODE_111439_length_352_cov_0.806324	165	238	68	1	73	0.0136986
NODE_111439_length_352_cov_0.806324	165	238	69	1	73	0.0136986
NODE_111439_length_352_cov_0.806324	165	238	72	4	73	0.0547945
NODE_111439_length_352_cov_0.806324	165	238	73	15	73	0.2054795
NODE_111439_length_352_cov_0.806324	165	238	74	6	73	0.0821918
NODE_111439_length_352_cov_0.806324	165	238	77	1	73	0.0136986
NODE_111439_length_352_cov_0.806324	165	238	78	1	73	0.0136986
NODE_111439_length_352_cov_0.806324	165	238	79	3	73	0.0410959
NODE_111439_length_352_cov_0.806324	165	238	81	3	73	0.0410959
NODE_111439_length_352_cov_0.806324	165	238	85	1	73	0.0136986
NODE_111439_length_352_cov_0.806324	165	238	86	6	73	0.0821918
NODE_111439_length_352_cov_0.806324	165	238	88	2	73	0.0273973
NODE_111593_length_351_cov_5.003968	115	195	0	80	80	1.0000000
NODE_111662_length_351_cov_2.900794	289	320	0	31	31	1.0000000
NODE_111738_length_351_cov_2.376984	79	159	0	12	80	0.1500000
NODE_111738_length_351_cov_2.376984	79	159	2	32	80	0.4000000
NODE_111738_length_351_cov_2.376984	79	159	5	1	80	0.0125000
NODE_111738_length_351_cov_2.376984	79	159	8	6	80	0.0750000
NODE_111738_length_351_cov_2.376984	79	159	10	1	80	0.0125000
NODE_111738_length_351_cov_2.376984	79	159	12	28	80	0.3500000
NODE_111759_length_351_cov_2.226190	116	170	27	1	54	0.0185185
NODE_111759_length_351_cov_2.226190	116	170	29	8	54	0.1481481
NODE_111759_length_351_cov_2.226190	116	170	31	45	54	0.8333333
NODE_111769_length_351_cov_2.186508	198	277	0	20	79	0.2531646
NODE_111769_length_351_cov_2.186508	198	277	2	28	79	0.3544304
NODE_111769_length_351_cov_2.186508	198	277	4	2	79	0.0253165
NODE_111769_length_351_cov_2.186508	198	277	6	29	79	0.3670886
NODE_111861_length_351_cov_1.809524	276	309	0	27	33	0.8181818
NODE_111861_length_351_cov_1.809524	276	309	4	6	33	0.1818182
NODE_111969_length_351_cov_1.515873	228	299	0	71	71	1.0000000
NODE_112493_length_350_cov_232.529880	25	92	30	2	67	0.0298507
NODE_112493_length_350_cov_232.529880	25	92	34	5	67	0.0746269
NODE_112493_length_350_cov_232.529880	25	92	38	3	67	0.0447761
NODE_112493_length_350_cov_232.529880	25	92	39	2	67	0.0298507
NODE_112493_length_350_cov_232.529880	25	92	43	1	67	0.0149254
NODE_112493_length_350_cov_232.529880	25	92	50	1	67	0.0149254
NODE_112493_length_350_cov_232.529880	25	92	51	1	67	0.0149254
NODE_112493_length_350_cov_232.529880	25	92	53	1	67	0.0149254
NODE_112493_length_350_cov_232.529880	25	92	55	3	67	0.0447761
NODE_112493_length_350_cov_232.529880	25	92	59	1	67	0.0149254
NODE_112493_length_350_cov_232.529880	25	92	63	3	67	0.0447761
NODE_112493_length_350_cov_232.529880	25	92	67	3	67	0.0447761
NODE_112493_length_350_cov_232.529880	25	92	71	2	67	0.0298507
NODE_112493_length_350_cov_232.529880	25	92	72	1	67	0.0149254
NODE_112493_length_350_cov_232.529880	25	92	76	3	67	0.0447761
NODE_112493_length_350_cov_232.529880	25	92	79	2	67	0.0298507
NODE_112493_length_350_cov_232.529880	25	92	83	4	67	0.0597015
NODE_112493_length_350_cov_232.529880	25	92	84	3	67	0.0447761
NODE_112493_length_350_cov_232.529880	25	92	86	5	67	0.0746269
NODE_112493_length_350_cov_232.529880	25	92	87	2	67	0.0298507
NODE_112493_length_350_cov_232.529880	25	92	89	16	67	0.2388060
NODE_112493_length_350_cov_232.529880	25	92	93	3	67	0.0447761
NODE_112494_length_350_cov_40.677291	181	246	138	3	65	0.0461538
NODE_112494_length_350_cov_40.677291	181	246	139	2	65	0.0307692
NODE_112494_length_350_cov_40.677291	181	246	141	3	65	0.0461538
NODE_112494_length_350_cov_40.677291	181	246	142	5	65	0.0769231
NODE_112494_length_350_cov_40.677291	181	246	143	2	65	0.0307692
NODE_112494_length_350_cov_40.677291	181	246	144	5	65	0.0769231
NODE_112494_length_350_cov_40.677291	181	246	145	2	65	0.0307692
NODE_112494_length_350_cov_40.677291	181	246	146	5	65	0.0769231
NODE_112494_length_350_cov_40.677291	181	246	147	4	65	0.0615385
NODE_112494_length_350_cov_40.677291	181	246	148	3	65	0.0461538
NODE_112494_length_350_cov_40.677291	181	246	149	1	65	0.0153846
NODE_112494_length_350_cov_40.677291	181	246	150	4	65	0.0615385
NODE_112494_length_350_cov_40.677291	181	246	151	1	65	0.0153846
NODE_112494_length_350_cov_40.677291	181	246	152	3	65	0.0461538
NODE_112494_length_350_cov_40.677291	181	246	153	2	65	0.0307692
NODE_112494_length_350_cov_40.677291	181	246	154	13	65	0.2000000
NODE_112494_length_350_cov_40.677291	181	246	156	6	65	0.0923077
NODE_112494_length_350_cov_40.677291	181	246	157	1	65	0.0153846
NODE_112535_length_350_cov_4.179283	114	194	1	19	80	0.2375000
NODE_112535_length_350_cov_4.179283	114	194	2	6	80	0.0750000
NODE_112535_length_350_cov_4.179283	114	194	3	1	80	0.0125000
NODE_112535_length_350_cov_4.179283	114	194	4	54	80	0.6750000
NODE_112535_length_350_cov_4.179283	167	244	4	44	77	0.5714286
NODE_112535_length_350_cov_4.179283	167	244	6	33	77	0.4285714
NODE_112554_length_350_cov_3.573705	128	202	0	32	74	0.4324324
NODE_112554_length_350_cov_3.573705	128	202	2	1	74	0.0135135
NODE_112554_length_350_cov_3.573705	128	202	8	3	74	0.0405405
NODE_112554_length_350_cov_3.573705	128	202	10	1	74	0.0135135
NODE_112554_length_350_cov_3.573705	128	202	14	2	74	0.0270270
NODE_112554_length_350_cov_3.573705	128	202	16	12	74	0.1621622
NODE_112554_length_350_cov_3.573705	128	202	20	23	74	0.3108108
NODE_112554_length_350_cov_3.573705	178	241	0	25	63	0.3968254
NODE_112554_length_350_cov_3.573705	178	241	2	38	63	0.6031746
NODE_112627_length_350_cov_2.478088	266	297	0	31	31	1.0000000
NODE_112647_length_350_cov_2.346614	97	148	96	2	51	0.0392157
NODE_112647_length_350_cov_2.346614	97	148	97	2	51	0.0392157
NODE_112647_length_350_cov_2.346614	97	148	99	2	51	0.0392157
NODE_112647_length_350_cov_2.346614	97	148	100	3	51	0.0588235
NODE_112647_length_350_cov_2.346614	97	148	101	1	51	0.0196078
NODE_112647_length_350_cov_2.346614	97	148	103	5	51	0.0980392
NODE_112647_length_350_cov_2.346614	97	148	104	3	51	0.0588235
NODE_112647_length_350_cov_2.346614	97	148	105	1	51	0.0196078
NODE_112647_length_350_cov_2.346614	97	148	106	2	51	0.0392157
NODE_112647_length_350_cov_2.346614	97	148	107	1	51	0.0196078
NODE_112647_length_350_cov_2.346614	97	148	110	1	51	0.0196078
NODE_112647_length_350_cov_2.346614	97	148	111	1	51	0.0196078
NODE_112647_length_350_cov_2.346614	97	148	112	3	51	0.0588235
NODE_112647_length_350_cov_2.346614	97	148	113	3	51	0.0588235
NODE_112647_length_350_cov_2.346614	97	148	114	2	51	0.0392157
NODE_112647_length_350_cov_2.346614	97	148	115	2	51	0.0392157
NODE_112647_length_350_cov_2.346614	97	148	117	2	51	0.0392157
NODE_112647_length_350_cov_2.346614	97	148	118	3	51	0.0588235
NODE_112647_length_350_cov_2.346614	97	148	120	4	51	0.0784314
NODE_112647_length_350_cov_2.346614	97	148	121	3	51	0.0588235
NODE_112647_length_350_cov_2.346614	97	148	123	2	51	0.0392157
NODE_112647_length_350_cov_2.346614	97	148	124	3	51	0.0588235
NODE_112714_length_350_cov_2.031873	181	238	35	2	57	0.0350877
NODE_112714_length_350_cov_2.031873	181	238	37	6	57	0.1052632
NODE_112714_length_350_cov_2.031873	181	238	39	1	57	0.0175439
NODE_112714_length_350_cov_2.031873	181	238	41	6	57	0.1052632
NODE_112714_length_350_cov_2.031873	181	238	45	2	57	0.0350877
NODE_112714_length_350_cov_2.031873	181	238	46	4	57	0.0701754
NODE_112714_length_350_cov_2.031873	181	238	48	14	57	0.2456140
NODE_112714_length_350_cov_2.031873	181	238	50	22	57	0.3859649
NODE_112997_length_350_cov_1.223108	202	275	0	37	73	0.5068493
NODE_112997_length_350_cov_1.223108	202	275	5	7	73	0.0958904
NODE_112997_length_350_cov_1.223108	202	275	7	1	73	0.0136986
NODE_112997_length_350_cov_1.223108	202	275	9	1	73	0.0136986
NODE_112997_length_350_cov_1.223108	202	275	11	1	73	0.0136986
NODE_112997_length_350_cov_1.223108	202	275	13	5	73	0.0684932
NODE_112997_length_350_cov_1.223108	202	275	15	7	73	0.0958904
NODE_112997_length_350_cov_1.223108	202	275	19	2	73	0.0273973
NODE_112997_length_350_cov_1.223108	202	275	21	1	73	0.0136986
NODE_112997_length_350_cov_1.223108	202	275	23	4	73	0.0547945
NODE_112997_length_350_cov_1.223108	202	275	24	6	73	0.0821918
NODE_112997_length_350_cov_1.223108	202	275	25	1	73	0.0136986
NODE_113450_length_349_cov_4.268000	83	163	0	3	80	0.0375000
NODE_113450_length_349_cov_4.268000	83	163	2	77	80	0.9625000
NODE_113450_length_349_cov_4.268000	83	163	0	3	80	0.0375000
NODE_113450_length_349_cov_4.268000	83	163	2	77	80	0.9625000
NODE_113450_length_349_cov_4.268000	136	216	0	29	80	0.3625000
NODE_113450_length_349_cov_4.268000	136	216	2	51	80	0.6375000
NODE_113450_length_349_cov_4.268000	145	180	2	35	35	1.0000000
NODE_113473_length_349_cov_3.648000	219	300	0	30	81	0.3703704
NODE_113473_length_349_cov_3.648000	219	300	2	8	81	0.0987654
NODE_113473_length_349_cov_3.648000	219	300	4	38	81	0.4691358
NODE_113473_length_349_cov_3.648000	219	300	6	5	81	0.0617284
NODE_113480_length_349_cov_3.484000	196	276	0	6	80	0.0750000
NODE_113480_length_349_cov_3.484000	196	276	2	2	80	0.0250000
NODE_113480_length_349_cov_3.484000	196	276	4	13	80	0.1625000
NODE_113480_length_349_cov_3.484000	196	276	5	36	80	0.4500000
NODE_113480_length_349_cov_3.484000	196	276	6	23	80	0.2875000
NODE_113486_length_349_cov_3.364000	219	284	0	65	65	1.0000000
NODE_113511_length_349_cov_2.916000	94	189	8	52	95	0.5473684
NODE_113511_length_349_cov_2.916000	94	189	10	43	95	0.4526316
NODE_113571_length_349_cov_2.420000	35	54	0	19	19	1.0000000
NODE_113647_length_349_cov_1.964000	32	63	0	31	31	1.0000000
NODE_113654_length_349_cov_1.928000	9	77	0	68	68	1.0000000
NODE_113654_length_349_cov_1.928000	62	115	0	53	53	1.0000000
NODE_113710_length_349_cov_1.684000	225	265	10	2	40	0.0500000
NODE_113710_length_349_cov_1.684000	225	265	12	13	40	0.3250000
NODE_113710_length_349_cov_1.684000	225	265	16	10	40	0.2500000
NODE_113710_length_349_cov_1.684000	225	265	18	3	40	0.0750000
NODE_113710_length_349_cov_1.684000	225	265	20	1	40	0.0250000
NODE_113710_length_349_cov_1.684000	225	265	22	3	40	0.0750000
NODE_113710_length_349_cov_1.684000	225	265	24	3	40	0.0750000
NODE_113710_length_349_cov_1.684000	225	265	28	2	40	0.0500000
NODE_113710_length_349_cov_1.684000	225	265	29	1	40	0.0250000
NODE_113710_length_349_cov_1.684000	225	265	33	2	40	0.0500000
NODE_113825_length_349_cov_1.392000	32	95	0	63	63	1.0000000
NODE_113961_length_349_cov_1.056000	316	339	0	23	23	1.0000000
NODE_114002_length_349_cov_1.020000	177	257	0	80	80	1.0000000
NODE_114263_length_348_cov_34.867470	156	236	0	80	80	1.0000000
NODE_114263_length_348_cov_34.867470	209	289	0	80	80	1.0000000
NODE_114296_length_348_cov_4.180723	106	186	0	80	80	1.0000000
NODE_114296_length_348_cov_4.180723	159	239	0	80	80	1.0000000
NODE_114330_length_348_cov_3.277108	83	137	0	54	54	1.0000000
NODE_114330_length_348_cov_3.277108	145	197	0	52	52	1.0000000
NODE_114424_length_348_cov_2.305221	204	273	0	26	69	0.3768116
NODE_114424_length_348_cov_2.305221	204	273	2	43	69	0.6231884
NODE_114448_length_348_cov_2.216867	103	152	1	49	49	1.0000000
NODE_114505_length_348_cov_1.995984	170	239	0	69	69	1.0000000
NODE_114591_length_348_cov_1.638554	309	346	0	37	37	1.0000000
NODE_114643_length_348_cov_1.485944	9	60	0	51	51	1.0000000
NODE_115147_length_347_cov_15.100806	57	137	0	32	80	0.4000000
NODE_115147_length_347_cov_15.100806	57	137	2	48	80	0.6000000
NODE_115147_length_347_cov_15.100806	110	152	2	42	42	1.0000000
NODE_115147_length_347_cov_15.100806	182	209	0	27	27	1.0000000
NODE_115147_length_347_cov_15.100806	290	317	0	27	27	1.0000000
NODE_115161_length_347_cov_5.967742	110	173	0	15	63	0.2380952
NODE_115161_length_347_cov_5.967742	110	173	2	48	63	0.7619048
NODE_115195_length_347_cov_4.028226	260	329	0	69	69	1.0000000
NODE_115321_length_347_cov_2.463710	99	141	0	42	42	1.0000000
NODE_115321_length_347_cov_2.463710	108	143	0	35	35	1.0000000
NODE_115331_length_347_cov_2.391129	35	70	0	35	35	1.0000000
NODE_115331_length_347_cov_2.391129	37	79	0	42	42	1.0000000
NODE_115331_length_347_cov_2.391129	77	105	0	28	28	1.0000000
NODE_115397_length_347_cov_2.048387	15	34	0	19	19	1.0000000
NODE_115417_length_347_cov_1.967742	205	268	0	63	63	1.0000000
NODE_115450_length_347_cov_1.818548	109	156	0	14	47	0.2978723
NODE_115450_length_347_cov_1.818548	109	156	2	33	47	0.7021276
NODE_115771_length_347_cov_1.028226	230	255	0	25	25	1.0000000
NODE_116114_length_346_cov_74.433198	10	90	0	39	80	0.4875000
NODE_116114_length_346_cov_74.433198	10	90	2	41	80	0.5125000
NODE_116114_length_346_cov_74.433198	19	90	0	30	71	0.4225352
NODE_116114_length_346_cov_74.433198	19	90	2	41	71	0.5774648
NODE_116114_length_346_cov_74.433198	192	272	0	80	80	1.0000000
NODE_116115_length_346_cov_67.834008	133	213	0	80	80	1.0000000
NODE_116115_length_346_cov_67.834008	186	266	0	80	80	1.0000000
NODE_116117_length_346_cov_10.299595	190	270	0	80	80	1.0000000
NODE_116117_length_346_cov_10.299595	243	323	0	80	80	1.0000000
NODE_116119_length_346_cov_9.566802	159	239	0	80	80	1.0000000
NODE_116119_length_346_cov_9.566802	212	292	0	80	80	1.0000000
NODE_116134_length_346_cov_5.506073	157	238	2	32	81	0.3950617
NODE_116134_length_346_cov_5.506073	157	238	4	3	81	0.0370370
NODE_116134_length_346_cov_5.506073	157	238	6	18	81	0.2222222
NODE_116134_length_346_cov_5.506073	157	238	8	28	81	0.3456790
NODE_116155_length_346_cov_4.368421	205	264	0	59	59	1.0000000
NODE_116159_length_346_cov_4.032389	121	141	0	20	20	1.0000000
NODE_116184_length_346_cov_3.400810	194	253	0	59	59	1.0000000
NODE_116212_length_346_cov_3.008097	183	263	0	80	80	1.0000000
NODE_116257_length_346_cov_2.538462	47	102	0	55	55	1.0000000
NODE_116257_length_346_cov_2.538462	118	173	0	55	55	1.0000000
NODE_116439_length_346_cov_1.700405	71	107	0	36	36	1.0000000
NODE_117035_length_345_cov_47.699187	0	66	0	66	66	1.0000000
NODE_117035_length_345_cov_47.699187	39	119	0	41	80	0.5125000
NODE_117035_length_345_cov_47.699187	39	119	4	39	80	0.4875000
NODE_117035_length_345_cov_47.699187	115	182	4	67	67	1.0000000
NODE_117035_length_345_cov_47.699187	246	311	4	65	65	1.0000000
NODE_117036_length_345_cov_13.439024	28	108	0	80	80	1.0000000
NODE_117036_length_345_cov_13.439024	81	161	0	80	80	1.0000000
NODE_117037_length_345_cov_9.906504	224	283	0	59	59	1.0000000
NODE_117051_length_345_cov_5.475610	52	132	6	25	80	0.3125000
NODE_117051_length_345_cov_5.475610	52	132	10	7	80	0.0875000
NODE_117051_length_345_cov_5.475610	52	132	18	14	80	0.1750000
NODE_117051_length_345_cov_5.475610	52	132	20	19	80	0.2375000
NODE_117051_length_345_cov_5.475610	52	132	22	15	80	0.1875000
NODE_117051_length_345_cov_5.475610	105	185	6	68	80	0.8500000
NODE_117051_length_345_cov_5.475610	105	185	10	12	80	0.1500000
NODE_117055_length_345_cov_5.321138	104	152	0	48	48	1.0000000
NODE_117065_length_345_cov_4.524390	205	269	0	64	64	1.0000000
NODE_117075_length_345_cov_4.109756	95	157	0	62	62	1.0000000
NODE_117075_length_345_cov_4.109756	162	204	0	42	42	1.0000000
NODE_117076_length_345_cov_4.073171	251	326	0	75	75	1.0000000
NODE_117084_length_345_cov_3.776423	199	273	0	58	74	0.7837838
NODE_117084_length_345_cov_3.776423	199	273	4	16	74	0.2162162
NODE_117084_length_345_cov_3.776423	246	326	0	80	80	1.0000000
NODE_117148_length_345_cov_2.821138	61	141	2	64	80	0.8000000
NODE_117148_length_345_cov_2.821138	61	141	4	16	80	0.2000000
NODE_117205_length_345_cov_2.333333	47	90	6	1	43	0.0232558
NODE_117205_length_345_cov_2.333333	47	90	8	2	43	0.0465116
NODE_117205_length_345_cov_2.333333	47	90	11	1	43	0.0232558
NODE_117205_length_345_cov_2.333333	47	90	12	7	43	0.1627907
NODE_117205_length_345_cov_2.333333	47	90	14	15	43	0.3488372
NODE_117205_length_345_cov_2.333333	47	90	16	17	43	0.3953488
NODE_117205_length_345_cov_2.333333	63	147	12	16	84	0.1904762
NODE_117205_length_345_cov_2.333333	63	147	14	11	84	0.1309524
NODE_117205_length_345_cov_2.333333	63	147	16	40	84	0.4761905
NODE_117205_length_345_cov_2.333333	63	147	18	17	84	0.2023810
NODE_117219_length_345_cov_2.239837	0	81	0	1	81	0.0123457
NODE_117219_length_345_cov_2.239837	0	81	2	5	81	0.0617284
NODE_117219_length_345_cov_2.239837	0	81	4	4	81	0.0493827
NODE_117219_length_345_cov_2.239837	0	81	6	10	81	0.1234568
NODE_117219_length_345_cov_2.239837	0	81	8	5	81	0.0617284
NODE_117219_length_345_cov_2.239837	0	81	10	6	81	0.0740741
NODE_117219_length_345_cov_2.239837	0	81	11	31	81	0.3827161
NODE_117219_length_345_cov_2.239837	0	81	13	4	81	0.0493827
NODE_117219_length_345_cov_2.239837	0	81	15	8	81	0.0987654
NODE_117219_length_345_cov_2.239837	0	81	16	7	81	0.0864198
NODE_117669_length_345_cov_1.040650	6	73	1	16	67	0.2388060
NODE_117669_length_345_cov_1.040650	6	73	2	2	67	0.0298507
NODE_117669_length_345_cov_1.040650	6	73	4	31	67	0.4626866
NODE_117669_length_345_cov_1.040650	6	73	8	18	67	0.2686567
NODE_117989_length_344_cov_54.020408	6	55	0	36	49	0.7346939
NODE_117989_length_344_cov_54.020408	6	55	2	13	49	0.2653061
NODE_117989_length_344_cov_54.020408	28	105	0	14	77	0.1818182
NODE_117989_length_344_cov_54.020408	28	105	2	63	77	0.8181818
NODE_117989_length_344_cov_54.020408	28	105	0	14	77	0.1818182
NODE_117989_length_344_cov_54.020408	28	105	2	63	77	0.8181818
NODE_117989_length_344_cov_54.020408	112	178	2	10	66	0.1515152
NODE_117989_length_344_cov_54.020408	112	178	5	24	66	0.3636364
NODE_117989_length_344_cov_54.020408	112	178	7	2	66	0.0303030
NODE_117989_length_344_cov_54.020408	112	178	8	24	66	0.3636364
NODE_117989_length_344_cov_54.020408	112	178	10	6	66	0.0909091
NODE_118009_length_344_cov_5.016327	72	125	22	4	53	0.0754717
NODE_118009_length_344_cov_5.016327	72	125	23	1	53	0.0188679
NODE_118009_length_344_cov_5.016327	72	125	24	8	53	0.1509434
NODE_118009_length_344_cov_5.016327	72	125	26	2	53	0.0377358
NODE_118009_length_344_cov_5.016327	72	125	31	5	53	0.0943396
NODE_118009_length_344_cov_5.016327	72	125	33	4	53	0.0754717
NODE_118009_length_344_cov_5.016327	72	125	34	11	53	0.2075472
NODE_118009_length_344_cov_5.016327	72	125	35	1	53	0.0188679
NODE_118009_length_344_cov_5.016327	72	125	36	17	53	0.3207547
NODE_118009_length_344_cov_5.016327	136	203	12	11	67	0.1641791
NODE_118009_length_344_cov_5.016327	136	203	16	11	67	0.1641791
NODE_118009_length_344_cov_5.016327	136	203	20	9	67	0.1343284
NODE_118009_length_344_cov_5.016327	136	203	22	4	67	0.0597015
NODE_118009_length_344_cov_5.016327	136	203	24	1	67	0.0149254
NODE_118009_length_344_cov_5.016327	136	203	26	4	67	0.0597015
NODE_118009_length_344_cov_5.016327	136	203	28	2	67	0.0298507
NODE_118009_length_344_cov_5.016327	136	203	34	25	67	0.3731343
NODE_118017_length_344_cov_4.579592	172	254	0	82	82	1.0000000
NODE_118045_length_344_cov_3.840816	197	240	0	43	43	1.0000000
NODE_118074_length_344_cov_3.293878	149	189	0	2	40	0.0500000
NODE_118074_length_344_cov_3.293878	149	189	2	38	40	0.9500000
NODE_118074_length_344_cov_3.293878	162	229	0	42	67	0.6268657
NODE_118074_length_344_cov_3.293878	162	229	2	25	67	0.3731343
NODE_118111_length_344_cov_2.751020	24	87	0	47	63	0.7460318
NODE_118111_length_344_cov_2.751020	24	87	2	16	63	0.2539683
NODE_118179_length_344_cov_2.126531	274	305	2	31	31	1.0000000
NODE_118243_length_344_cov_1.914286	114	194	0	80	80	1.0000000
NODE_118243_length_344_cov_1.914286	167	247	0	80	80	1.0000000
NODE_118297_length_344_cov_1.685714	180	220	0	30	40	0.7500000
NODE_118297_length_344_cov_1.685714	180	220	2	10	40	0.2500000
NODE_118393_length_344_cov_1.457143	160	240	8	2	80	0.0250000
NODE_118393_length_344_cov_1.457143	160	240	12	3	80	0.0375000
NODE_118393_length_344_cov_1.457143	160	240	14	20	80	0.2500000
NODE_118393_length_344_cov_1.457143	160	240	16	55	80	0.6875000
NODE_118393_length_344_cov_1.457143	213	273	2	7	60	0.1166667
NODE_118393_length_344_cov_1.457143	213	273	4	7	60	0.1166667
NODE_118393_length_344_cov_1.457143	213	273	6	19	60	0.3166667
NODE_118393_length_344_cov_1.457143	213	273	8	2	60	0.0333333
NODE_118393_length_344_cov_1.457143	213	273	12	3	60	0.0500000
NODE_118393_length_344_cov_1.457143	213	273	14	6	60	0.1000000
NODE_118393_length_344_cov_1.457143	213	273	16	16	60	0.2666667
NODE_118743_length_344_cov_0.800000	123	163	0	25	40	0.6250000
NODE_118743_length_344_cov_0.800000	123	163	2	15	40	0.3750000
NODE_118899_length_343_cov_3.770492	2	60	0	58	58	1.0000000
NODE_118905_length_343_cov_3.598361	97	170	0	25	73	0.3424658
NODE_118905_length_343_cov_3.598361	97	170	2	48	73	0.6575342
NODE_118905_length_343_cov_3.598361	150	223	0	25	73	0.3424658
NODE_118905_length_343_cov_3.598361	150	223	2	48	73	0.6575342
NODE_118911_length_343_cov_3.401639	48	128	14	1	80	0.0125000
NODE_118911_length_343_cov_3.401639	48	128	16	4	80	0.0500000
NODE_118911_length_343_cov_3.401639	48	128	18	1	80	0.0125000
NODE_118911_length_343_cov_3.401639	48	128	19	2	80	0.0250000
NODE_118911_length_343_cov_3.401639	48	128	21	6	80	0.0750000
NODE_118911_length_343_cov_3.401639	48	128	22	2	80	0.0250000
NODE_118911_length_343_cov_3.401639	48	128	23	3	80	0.0375000
NODE_118911_length_343_cov_3.401639	48	128	24	1	80	0.0125000
NODE_118911_length_343_cov_3.401639	48	128	29	1	80	0.0125000
NODE_118911_length_343_cov_3.401639	48	128	34	6	80	0.0750000
NODE_118911_length_343_cov_3.401639	48	128	36	6	80	0.0750000
NODE_118911_length_343_cov_3.401639	48	128	40	12	80	0.1500000
NODE_118911_length_343_cov_3.401639	48	128	44	1	80	0.0125000
NODE_118911_length_343_cov_3.401639	48	128	45	1	80	0.0125000
NODE_118911_length_343_cov_3.401639	48	128	46	20	80	0.2500000
NODE_118911_length_343_cov_3.401639	48	128	48	8	80	0.1000000
NODE_118911_length_343_cov_3.401639	48	128	50	5	80	0.0625000
NODE_118941_length_343_cov_3.049180	12	62	0	50	50	1.0000000
NODE_118941_length_343_cov_3.049180	82	111	2	29	29	1.0000000
NODE_118941_length_343_cov_3.049180	133	205	0	12	72	0.1666667
NODE_118941_length_343_cov_3.049180	133	205	2	60	72	0.8333333
NODE_118957_length_343_cov_2.770492	236	316	16	4	80	0.0500000
NODE_118957_length_343_cov_2.770492	236	316	18	6	80	0.0750000
NODE_118957_length_343_cov_2.770492	236	316	20	8	80	0.1000000
NODE_118957_length_343_cov_2.770492	236	316	23	1	80	0.0125000
NODE_118957_length_343_cov_2.770492	236	316	24	1	80	0.0125000
NODE_118957_length_343_cov_2.770492	236	316	25	2	80	0.0250000
NODE_118957_length_343_cov_2.770492	236	316	27	6	80	0.0750000
NODE_118957_length_343_cov_2.770492	236	316	29	3	80	0.0375000
NODE_118957_length_343_cov_2.770492	236	316	33	2	80	0.0250000
NODE_118957_length_343_cov_2.770492	236	316	37	2	80	0.0250000
NODE_118957_length_343_cov_2.770492	236	316	40	3	80	0.0375000
NODE_118957_length_343_cov_2.770492	236	316	42	3	80	0.0375000
NODE_118957_length_343_cov_2.770492	236	316	48	5	80	0.0625000
NODE_118957_length_343_cov_2.770492	236	316	51	5	80	0.0625000
NODE_118957_length_343_cov_2.770492	236	316	54	3	80	0.0375000
NODE_118957_length_343_cov_2.770492	236	316	57	3	80	0.0375000
NODE_118957_length_343_cov_2.770492	236	316	59	1	80	0.0125000
NODE_118957_length_343_cov_2.770492	236	316	61	4	80	0.0500000
NODE_118957_length_343_cov_2.770492	236	316	63	4	80	0.0500000
NODE_118957_length_343_cov_2.770492	236	316	67	7	80	0.0875000
NODE_118957_length_343_cov_2.770492	236	316	69	1	80	0.0125000
NODE_118957_length_343_cov_2.770492	236	316	70	1	80	0.0125000
NODE_118957_length_343_cov_2.770492	236	316	73	5	80	0.0625000
NODE_118978_length_343_cov_2.590164	167	225	0	35	58	0.6034483
NODE_118978_length_343_cov_2.590164	167	225	1	12	58	0.2068966
NODE_118978_length_343_cov_2.590164	167	225	3	10	58	0.1724138
NODE_118978_length_343_cov_2.590164	167	225	5	1	58	0.0172414
NODE_118998_length_343_cov_2.430328	208	274	0	66	66	1.0000000
NODE_119040_length_343_cov_2.209016	32	111	0	79	79	1.0000000
NODE_119067_length_343_cov_2.081967	95	177	0	75	82	0.9146342
NODE_119067_length_343_cov_2.081967	95	177	1	7	82	0.0853659
NODE_119067_length_343_cov_2.081967	150	199	0	20	49	0.4081633
NODE_119067_length_343_cov_2.081967	150	199	1	29	49	0.5918368
NODE_119202_length_343_cov_1.635246	0	52	0	52	52	1.0000000
NODE_119439_length_343_cov_1.143443	60	120	0	60	60	1.0000000
NODE_119834_length_342_cov_3.872428	136	216	4	57	80	0.7125000
NODE_119834_length_342_cov_3.872428	136	216	8	23	80	0.2875000
NODE_119834_length_342_cov_3.872428	189	259	4	70	70	1.0000000
NODE_119840_length_342_cov_3.769547	146	212	0	66	66	1.0000000
NODE_119841_length_342_cov_3.740741	113	146	2	33	33	1.0000000
NODE_119846_length_342_cov_3.674897	20	100	0	20	80	0.2500000
NODE_119846_length_342_cov_3.674897	20	100	3	2	80	0.0250000
NODE_119846_length_342_cov_3.674897	20	100	4	58	80	0.7250000
NODE_119846_length_342_cov_3.674897	73	153	0	73	80	0.9125000
NODE_119846_length_342_cov_3.674897	73	153	3	2	80	0.0250000
NODE_119846_length_342_cov_3.674897	73	153	4	5	80	0.0625000
NODE_119847_length_342_cov_3.588477	117	197	0	80	80	1.0000000
NODE_119849_length_342_cov_3.530864	72	151	0	79	79	1.0000000
NODE_119852_length_342_cov_3.423868	172	252	0	80	80	1.0000000
NODE_119852_length_342_cov_3.423868	225	283	0	58	58	1.0000000
NODE_119922_length_342_cov_2.432099	16	81	0	65	65	1.0000000
NODE_119993_length_342_cov_2.049383	249	317	0	68	68	1.0000000
NODE_120047_length_342_cov_1.864198	138	190	10	12	52	0.2307692
NODE_120047_length_342_cov_1.864198	138	190	12	3	52	0.0576923
NODE_120047_length_342_cov_1.864198	138	190	14	5	52	0.0961538
NODE_120047_length_342_cov_1.864198	138	190	16	4	52	0.0769231
NODE_120047_length_342_cov_1.864198	138	190	20	28	52	0.5384616
NODE_120047_length_342_cov_1.864198	183	243	14	33	60	0.5500000
NODE_120047_length_342_cov_1.864198	183	243	18	2	60	0.0333333
NODE_120047_length_342_cov_1.864198	183	243	20	25	60	0.4166667
NODE_120073_length_342_cov_1.720165	91	147	8	16	56	0.2857143
NODE_120073_length_342_cov_1.720165	91	147	10	6	56	0.1071429
NODE_120073_length_342_cov_1.720165	91	147	11	3	56	0.0535714
NODE_120073_length_342_cov_1.720165	91	147	12	31	56	0.5535714
NODE_120284_length_342_cov_1.271605	201	240	0	39	39	1.0000000
NODE_120755_length_341_cov_15.896694	50	130	0	80	80	1.0000000
NODE_120755_length_341_cov_15.896694	103	183	0	80	80	1.0000000
NODE_120757_length_341_cov_9.756198	117	196	0	30	79	0.3797468
NODE_120757_length_341_cov_9.756198	117	196	2	5	79	0.0632911
NODE_120757_length_341_cov_9.756198	117	196	4	6	79	0.0759494
NODE_120757_length_341_cov_9.756198	117	196	6	38	79	0.4810127
NODE_120770_length_341_cov_5.404959	141	220	0	27	79	0.3417721
NODE_120770_length_341_cov_5.404959	141	220	1	11	79	0.1392405
NODE_120770_length_341_cov_5.404959	141	220	2	2	79	0.0253165
NODE_120770_length_341_cov_5.404959	141	220	5	4	79	0.0506329
NODE_120770_length_341_cov_5.404959	141	220	9	6	79	0.0759494
NODE_120770_length_341_cov_5.404959	141	220	10	5	79	0.0632911
NODE_120770_length_341_cov_5.404959	141	220	12	12	79	0.1518987
NODE_120770_length_341_cov_5.404959	141	220	14	10	79	0.1265823
NODE_120770_length_341_cov_5.404959	141	220	18	2	79	0.0253165
NODE_120780_length_341_cov_4.669421	301	320	0	19	19	1.0000000
NODE_120783_length_341_cov_4.438017	57	132	4	1	75	0.0133333
NODE_120783_length_341_cov_4.438017	57	132	6	7	75	0.0933333
NODE_120783_length_341_cov_4.438017	57	132	8	67	75	0.8933333
NODE_120783_length_341_cov_4.438017	110	185	0	2	75	0.0266667
NODE_120783_length_341_cov_4.438017	110	185	2	21	75	0.2800000
NODE_120783_length_341_cov_4.438017	110	185	4	4	75	0.0533333
NODE_120783_length_341_cov_4.438017	110	185	5	4	75	0.0533333
NODE_120783_length_341_cov_4.438017	110	185	6	29	75	0.3866667
NODE_120783_length_341_cov_4.438017	110	185	8	15	75	0.2000000
NODE_120785_length_341_cov_4.400826	164	244	0	48	80	0.6000000
NODE_120785_length_341_cov_4.400826	164	244	2	32	80	0.4000000
NODE_120785_length_341_cov_4.400826	224	297	0	73	73	1.0000000
NODE_120797_length_341_cov_3.896694	58	122	4	2	64	0.0312500
NODE_120797_length_341_cov_3.896694	58	122	8	18	64	0.2812500
NODE_120797_length_341_cov_3.896694	58	122	10	2	64	0.0312500
NODE_120797_length_341_cov_3.896694	58	122	12	11	64	0.1718750
NODE_120797_length_341_cov_3.896694	58	122	13	5	64	0.0781250
NODE_120797_length_341_cov_3.896694	58	122	15	14	64	0.2187500
NODE_120797_length_341_cov_3.896694	58	122	17	3	64	0.0468750
NODE_120797_length_341_cov_3.896694	58	122	21	9	64	0.1406250
NODE_120805_length_341_cov_3.727273	191	273	0	49	82	0.5975610
NODE_120805_length_341_cov_3.727273	191	273	2	10	82	0.1219512
NODE_120805_length_341_cov_3.727273	191	273	4	13	82	0.1585366
NODE_120805_length_341_cov_3.727273	191	273	6	10	82	0.1219512
NODE_120805_length_341_cov_3.727273	253	326	0	73	73	1.0000000
NODE_120839_length_341_cov_3.000000	91	161	2	70	70	1.0000000
NODE_120839_length_341_cov_3.000000	146	215	0	38	69	0.5507246
NODE_120839_length_341_cov_3.000000	146	215	2	31	69	0.4492754
NODE_120840_length_341_cov_3.000000	127	207	2	5	80	0.0625000
NODE_120840_length_341_cov_3.000000	127	207	3	20	80	0.2500000
NODE_120840_length_341_cov_3.000000	127	207	4	55	80	0.6875000
NODE_120892_length_341_cov_2.533058	92	172	8	80	80	1.0000000
NODE_120901_length_341_cov_2.495868	8	89	0	11	81	0.1358025
NODE_120901_length_341_cov_2.495868	8	89	2	70	81	0.8641976
NODE_120946_length_341_cov_2.235537	10	90	0	80	80	1.0000000
NODE_120972_length_341_cov_2.103306	46	125	0	48	79	0.6075949
NODE_120972_length_341_cov_2.103306	46	125	7	1	79	0.0126582
NODE_120972_length_341_cov_2.103306	46	125	8	29	79	0.3670886
NODE_120972_length_341_cov_2.103306	46	125	10	1	79	0.0126582
NODE_120994_length_341_cov_2.066116	147	184	6	19	37	0.5135135
NODE_120994_length_341_cov_2.066116	147	184	8	18	37	0.4864865
NODE_121052_length_341_cov_1.772727	179	250	0	44	71	0.6197183
NODE_121052_length_341_cov_1.772727	179	250	3	27	71	0.3802817
NODE_121064_length_341_cov_1.727273	105	185	0	80	80	1.0000000
NODE_121160_length_341_cov_1.475207	120	185	0	2	65	0.0307692
NODE_121160_length_341_cov_1.475207	120	185	2	63	65	0.9692308
NODE_121160_length_341_cov_1.475207	158	238	0	55	80	0.6875000
NODE_121160_length_341_cov_1.475207	158	238	2	25	80	0.3125000
NODE_121173_length_341_cov_1.471074	186	266	0	80	80	1.0000000
NODE_121173_length_341_cov_1.471074	239	319	0	80	80	1.0000000
NODE_121211_length_341_cov_1.342975	284	322	0	38	38	1.0000000
NODE_121431_length_341_cov_0.991736	36	89	0	53	53	1.0000000
NODE_121693_length_340_cov_541.348548	86	144	467	1	58	0.0172414
NODE_121693_length_340_cov_541.348548	86	144	472	1	58	0.0172414
NODE_121693_length_340_cov_541.348548	86	144	485	1	58	0.0172414
NODE_121693_length_340_cov_541.348548	86	144	487	1	58	0.0172414
NODE_121693_length_340_cov_541.348548	86	144	517	1	58	0.0172414
NODE_121693_length_340_cov_541.348548	86	144	520	1	58	0.0172414
NODE_121693_length_340_cov_541.348548	86	144	537	1	58	0.0172414
NODE_121693_length_340_cov_541.348548	86	144	538	1	58	0.0172414
NODE_121693_length_340_cov_541.348548	86	144	549	1	58	0.0172414
NODE_121693_length_340_cov_541.348548	86	144	577	1	58	0.0172414
NODE_121693_length_340_cov_541.348548	86	144	589	1	58	0.0172414
NODE_121693_length_340_cov_541.348548	86	144	603	1	58	0.0172414
NODE_121693_length_340_cov_541.348548	86	144	613	1	58	0.0172414
NODE_121693_length_340_cov_541.348548	86	144	623	1	58	0.0172414
NODE_121693_length_340_cov_541.348548	86	144	651	1	58	0.0172414
NODE_121693_length_340_cov_541.348548	86	144	671	1	58	0.0172414
NODE_121693_length_340_cov_541.348548	86	144	702	1	58	0.0172414
NODE_121693_length_340_cov_541.348548	86	144	704	1	58	0.0172414
NODE_121693_length_340_cov_541.348548	86	144	717	1	58	0.0172414
NODE_121693_length_340_cov_541.348548	86	144	726	1	58	0.0172414
NODE_121693_length_340_cov_541.348548	86	144	737	1	58	0.0172414
NODE_121693_length_340_cov_541.348548	86	144	758	1	58	0.0172414
NODE_121693_length_340_cov_541.348548	86	144	761	1	58	0.0172414
NODE_121693_length_340_cov_541.348548	86	144	770	1	58	0.0172414
NODE_121693_length_340_cov_541.348548	86	144	776	1	58	0.0172414
NODE_121693_length_340_cov_541.348548	86	144	783	1	58	0.0172414
NODE_121693_length_340_cov_541.348548	86	144	807	1	58	0.0172414
NODE_121693_length_340_cov_541.348548	86	144	817	1	58	0.0172414
NODE_121693_length_340_cov_541.348548	86	144	821	1	58	0.0172414
NODE_121693_length_340_cov_541.348548	86	144	825	1	58	0.0172414
NODE_121693_length_340_cov_541.348548	86	144	836	1	58	0.0172414
NODE_121693_length_340_cov_541.348548	86	144	851	1	58	0.0172414
NODE_121693_length_340_cov_541.348548	86	144	857	1	58	0.0172414
NODE_121693_length_340_cov_541.348548	86	144	866	1	58	0.0172414
NODE_121693_length_340_cov_541.348548	86	144	879	1	58	0.0172414
NODE_121693_length_340_cov_541.348548	86	144	886	1	58	0.0172414
NODE_121693_length_340_cov_541.348548	86	144	890	1	58	0.0172414
NODE_121693_length_340_cov_541.348548	86	144	893	1	58	0.0172414
NODE_121693_length_340_cov_541.348548	86	144	904	1	58	0.0172414
NODE_121693_length_340_cov_541.348548	86	144	918	1	58	0.0172414
NODE_121693_length_340_cov_541.348548	86	144	926	1	58	0.0172414
NODE_121693_length_340_cov_541.348548	86	144	934	1	58	0.0172414
NODE_121693_length_340_cov_541.348548	86	144	942	1	58	0.0172414
NODE_121693_length_340_cov_541.348548	86	144	956	2	58	0.0344828
NODE_121693_length_340_cov_541.348548	86	144	974	1	58	0.0172414
NODE_121693_length_340_cov_541.348548	86	144	976	1	58	0.0172414
NODE_121693_length_340_cov_541.348548	86	144	981	1	58	0.0172414
NODE_121693_length_340_cov_541.348548	86	144	985	1	58	0.0172414
NODE_121693_length_340_cov_541.348548	86	144	991	1	58	0.0172414
NODE_121693_length_340_cov_541.348548	86	144	1013	1	58	0.0172414
NODE_121693_length_340_cov_541.348548	86	144	1030	1	58	0.0172414
NODE_121693_length_340_cov_541.348548	86	144	1051	1	58	0.0172414
NODE_121693_length_340_cov_541.348548	86	144	1060	1	58	0.0172414
NODE_121693_length_340_cov_541.348548	86	144	1076	1	58	0.0172414
NODE_121693_length_340_cov_541.348548	86	144	1081	1	58	0.0172414
NODE_121693_length_340_cov_541.348548	86	144	1082	1	58	0.0172414
NODE_121693_length_340_cov_541.348548	86	144	1093	1	58	0.0172414
NODE_121693_length_340_cov_541.348548	86	154	467	1	68	0.0147059
NODE_121693_length_340_cov_541.348548	86	154	472	1	68	0.0147059
NODE_121693_length_340_cov_541.348548	86	154	485	1	68	0.0147059
NODE_121693_length_340_cov_541.348548	86	154	487	1	68	0.0147059
NODE_121693_length_340_cov_541.348548	86	154	517	1	68	0.0147059
NODE_121693_length_340_cov_541.348548	86	154	520	1	68	0.0147059
NODE_121693_length_340_cov_541.348548	86	154	537	1	68	0.0147059
NODE_121693_length_340_cov_541.348548	86	154	538	1	68	0.0147059
NODE_121693_length_340_cov_541.348548	86	154	549	1	68	0.0147059
NODE_121693_length_340_cov_541.348548	86	154	577	1	68	0.0147059
NODE_121693_length_340_cov_541.348548	86	154	589	1	68	0.0147059
NODE_121693_length_340_cov_541.348548	86	154	603	1	68	0.0147059
NODE_121693_length_340_cov_541.348548	86	154	613	1	68	0.0147059
NODE_121693_length_340_cov_541.348548	86	154	623	1	68	0.0147059
NODE_121693_length_340_cov_541.348548	86	154	651	1	68	0.0147059
NODE_121693_length_340_cov_541.348548	86	154	671	1	68	0.0147059
NODE_121693_length_340_cov_541.348548	86	154	702	1	68	0.0147059
NODE_121693_length_340_cov_541.348548	86	154	704	1	68	0.0147059
NODE_121693_length_340_cov_541.348548	86	154	717	1	68	0.0147059
NODE_121693_length_340_cov_541.348548	86	154	726	1	68	0.0147059
NODE_121693_length_340_cov_541.348548	86	154	737	1	68	0.0147059
NODE_121693_length_340_cov_541.348548	86	154	758	1	68	0.0147059
NODE_121693_length_340_cov_541.348548	86	154	761	1	68	0.0147059
NODE_121693_length_340_cov_541.348548	86	154	770	1	68	0.0147059
NODE_121693_length_340_cov_541.348548	86	154	776	1	68	0.0147059
NODE_121693_length_340_cov_541.348548	86	154	783	1	68	0.0147059
NODE_121693_length_340_cov_541.348548	86	154	807	1	68	0.0147059
NODE_121693_length_340_cov_541.348548	86	154	817	1	68	0.0147059
NODE_121693_length_340_cov_541.348548	86	154	821	1	68	0.0147059
NODE_121693_length_340_cov_541.348548	86	154	825	1	68	0.0147059
NODE_121693_length_340_cov_541.348548	86	154	836	1	68	0.0147059
NODE_121693_length_340_cov_541.348548	86	154	851	1	68	0.0147059
NODE_121693_length_340_cov_541.348548	86	154	857	1	68	0.0147059
NODE_121693_length_340_cov_541.348548	86	154	866	1	68	0.0147059
NODE_121693_length_340_cov_541.348548	86	154	879	1	68	0.0147059
NODE_121693_length_340_cov_541.348548	86	154	886	1	68	0.0147059
NODE_121693_length_340_cov_541.348548	86	154	890	1	68	0.0147059
NODE_121693_length_340_cov_541.348548	86	154	893	1	68	0.0147059
NODE_121693_length_340_cov_541.348548	86	154	904	1	68	0.0147059
NODE_121693_length_340_cov_541.348548	86	154	918	1	68	0.0147059
NODE_121693_length_340_cov_541.348548	86	154	926	1	68	0.0147059
NODE_121693_length_340_cov_541.348548	86	154	934	1	68	0.0147059
NODE_121693_length_340_cov_541.348548	86	154	942	1	68	0.0147059
NODE_121693_length_340_cov_541.348548	86	154	956	2	68	0.0294118
NODE_121693_length_340_cov_541.348548	86	154	974	1	68	0.0147059
NODE_121693_length_340_cov_541.348548	86	154	976	1	68	0.0147059
NODE_121693_length_340_cov_541.348548	86	154	981	1	68	0.0147059
NODE_121693_length_340_cov_541.348548	86	154	985	1	68	0.0147059
NODE_121693_length_340_cov_541.348548	86	154	991	1	68	0.0147059
NODE_121693_length_340_cov_541.348548	86	154	1013	1	68	0.0147059
NODE_121693_length_340_cov_541.348548	86	154	1030	1	68	0.0147059
NODE_121693_length_340_cov_541.348548	86	154	1051	1	68	0.0147059
NODE_121693_length_340_cov_541.348548	86	154	1060	1	68	0.0147059
NODE_121693_length_340_cov_541.348548	86	154	1076	1	68	0.0147059
NODE_121693_length_340_cov_541.348548	86	154	1081	1	68	0.0147059
NODE_121693_length_340_cov_541.348548	86	154	1082	1	68	0.0147059
NODE_121693_length_340_cov_541.348548	86	154	1093	1	68	0.0147059
NODE_121693_length_340_cov_541.348548	86	154	1096	1	68	0.0147059
NODE_121693_length_340_cov_541.348548	86	154	1101	1	68	0.0147059
NODE_121693_length_340_cov_541.348548	86	154	1121	2	68	0.0294118
NODE_121693_length_340_cov_541.348548	86	154	1124	1	68	0.0147059
NODE_121693_length_340_cov_541.348548	86	154	1127	1	68	0.0147059
NODE_121693_length_340_cov_541.348548	86	154	1128	1	68	0.0147059
NODE_121693_length_340_cov_541.348548	86	154	1136	1	68	0.0147059
NODE_121693_length_340_cov_541.348548	86	154	1153	1	68	0.0147059
NODE_121693_length_340_cov_541.348548	86	154	1154	1	68	0.0147059
NODE_121693_length_340_cov_541.348548	86	107	467	1	21	0.0476190
NODE_121693_length_340_cov_541.348548	86	107	472	1	21	0.0476190
NODE_121693_length_340_cov_541.348548	86	107	485	1	21	0.0476190
NODE_121693_length_340_cov_541.348548	86	107	487	1	21	0.0476190
NODE_121693_length_340_cov_541.348548	86	107	517	1	21	0.0476190
NODE_121693_length_340_cov_541.348548	86	107	520	1	21	0.0476190
NODE_121693_length_340_cov_541.348548	86	107	537	1	21	0.0476190
NODE_121693_length_340_cov_541.348548	86	107	538	1	21	0.0476190
NODE_121693_length_340_cov_541.348548	86	107	549	1	21	0.0476190
NODE_121693_length_340_cov_541.348548	86	107	577	1	21	0.0476190
NODE_121693_length_340_cov_541.348548	86	107	589	1	21	0.0476190
NODE_121693_length_340_cov_541.348548	86	107	603	1	21	0.0476190
NODE_121693_length_340_cov_541.348548	86	107	613	1	21	0.0476190
NODE_121693_length_340_cov_541.348548	86	107	623	1	21	0.0476190
NODE_121693_length_340_cov_541.348548	86	107	651	1	21	0.0476190
NODE_121693_length_340_cov_541.348548	86	107	671	1	21	0.0476190
NODE_121693_length_340_cov_541.348548	86	107	702	1	21	0.0476190
NODE_121693_length_340_cov_541.348548	86	107	704	1	21	0.0476190
NODE_121693_length_340_cov_541.348548	86	107	717	1	21	0.0476190
NODE_121693_length_340_cov_541.348548	86	107	726	1	21	0.0476190
NODE_121693_length_340_cov_541.348548	86	107	737	1	21	0.0476190
NODE_121694_length_340_cov_50.755187	196	266	4	12	70	0.1714286
NODE_121694_length_340_cov_50.755187	196	266	6	3	70	0.0428571
NODE_121694_length_340_cov_50.755187	196	266	8	44	70	0.6285715
NODE_121694_length_340_cov_50.755187	196	266	9	1	70	0.0142857
NODE_121694_length_340_cov_50.755187	196	266	10	10	70	0.1428571
NODE_121696_length_340_cov_8.917012	240	270	0	30	30	1.0000000
NODE_121696_length_340_cov_8.917012	243	315	0	72	72	1.0000000
NODE_121702_length_340_cov_6.439834	175	255	0	49	80	0.6125000
NODE_121702_length_340_cov_6.439834	175	255	2	31	80	0.3875000
NODE_121702_length_340_cov_6.439834	228	310	0	4	82	0.0487805
NODE_121702_length_340_cov_6.439834	228	310	2	78	82	0.9512195
NODE_121708_length_340_cov_5.883817	72	121	0	1	49	0.0204082
NODE_121708_length_340_cov_5.883817	72	121	2	4	49	0.0816327
NODE_121708_length_340_cov_5.883817	72	121	7	1	49	0.0204082
NODE_121708_length_340_cov_5.883817	72	121	9	18	49	0.3673469
NODE_121708_length_340_cov_5.883817	72	121	11	25	49	0.5102041
NODE_121708_length_340_cov_5.883817	82	113	9	16	31	0.5161290
NODE_121708_length_340_cov_5.883817	82	113	11	15	31	0.4838710
NODE_121714_length_340_cov_5.228216	116	186	2	70	70	1.0000000
NODE_121714_length_340_cov_5.228216	159	201	2	42	42	1.0000000
NODE_121730_length_340_cov_4.497925	136	184	0	48	48	1.0000000
NODE_121752_length_340_cov_3.759336	88	169	8	81	81	1.0000000
NODE_121849_length_340_cov_2.506224	68	114	0	46	46	1.0000000
NODE_121951_length_340_cov_1.995851	29	101	0	13	72	0.1805556
NODE_121951_length_340_cov_1.995851	29	101	4	17	72	0.2361111
NODE_121951_length_340_cov_1.995851	29	101	8	17	72	0.2361111
NODE_121951_length_340_cov_1.995851	29	101	10	25	72	0.3472222
NODE_121951_length_340_cov_1.995851	96	143	10	7	47	0.1489362
NODE_121951_length_340_cov_1.995851	96	143	12	14	47	0.2978723
NODE_121951_length_340_cov_1.995851	96	143	14	9	47	0.1914894
NODE_121951_length_340_cov_1.995851	96	143	16	7	47	0.1489362
NODE_121951_length_340_cov_1.995851	96	143	18	10	47	0.2127660
NODE_122154_length_340_cov_1.427386	244	274	0	30	30	1.0000000
NODE_122218_length_340_cov_1.282158	71	135	0	24	64	0.3750000
NODE_122218_length_340_cov_1.282158	71	135	6	40	64	0.6250000
NODE_122218_length_340_cov_1.282158	128	188	6	60	60	1.0000000
NODE_122218_length_340_cov_1.282158	142	189	6	47	47	1.0000000
NODE_122220_length_340_cov_1.278008	51	102	2	14	51	0.2745098
NODE_122220_length_340_cov_1.278008	51	102	4	37	51	0.7254902
NODE_122321_length_340_cov_1.199170	98	160	0	3	62	0.0483871
NODE_122321_length_340_cov_1.199170	98	160	4	59	62	0.9516129
NODE_122381_length_340_cov_1.070539	32	65	0	33	33	1.0000000
NODE_122429_length_340_cov_1.020747	209	228	0	19	19	1.0000000
NODE_122686_length_339_cov_87.841667	149	227	92	1	78	0.0128205
NODE_122686_length_339_cov_87.841667	149	227	99	2	78	0.0256410
NODE_122686_length_339_cov_87.841667	149	227	101	1	78	0.0128205
NODE_122686_length_339_cov_87.841667	149	227	105	1	78	0.0128205
NODE_122686_length_339_cov_87.841667	149	227	107	2	78	0.0256410
NODE_122686_length_339_cov_87.841667	149	227	115	1	78	0.0128205
NODE_122686_length_339_cov_87.841667	149	227	118	2	78	0.0256410
NODE_122686_length_339_cov_87.841667	149	227	120	2	78	0.0256410
NODE_122686_length_339_cov_87.841667	149	227	125	1	78	0.0128205
NODE_122686_length_339_cov_87.841667	149	227	127	1	78	0.0128205
NODE_122686_length_339_cov_87.841667	149	227	128	2	78	0.0256410
NODE_122686_length_339_cov_87.841667	149	227	130	1	78	0.0128205
NODE_122686_length_339_cov_87.841667	149	227	135	1	78	0.0128205
NODE_122686_length_339_cov_87.841667	149	227	137	2	78	0.0256410
NODE_122686_length_339_cov_87.841667	149	227	138	1	78	0.0128205
NODE_122686_length_339_cov_87.841667	149	227	143	2	78	0.0256410
NODE_122686_length_339_cov_87.841667	149	227	144	5	78	0.0641026
NODE_122686_length_339_cov_87.841667	149	227	145	1	78	0.0128205
NODE_122686_length_339_cov_87.841667	149	227	153	1	78	0.0128205
NODE_122686_length_339_cov_87.841667	149	227	155	1	78	0.0128205
NODE_122686_length_339_cov_87.841667	149	227	156	4	78	0.0512821
NODE_122686_length_339_cov_87.841667	149	227	157	1	78	0.0128205
NODE_122686_length_339_cov_87.841667	149	227	158	2	78	0.0256410
NODE_122686_length_339_cov_87.841667	149	227	159	3	78	0.0384615
NODE_122686_length_339_cov_87.841667	149	227	160	2	78	0.0256410
NODE_122686_length_339_cov_87.841667	149	227	162	1	78	0.0128205
NODE_122686_length_339_cov_87.841667	149	227	163	1	78	0.0128205
NODE_122686_length_339_cov_87.841667	149	227	164	3	78	0.0384615
NODE_122686_length_339_cov_87.841667	149	227	165	1	78	0.0128205
NODE_122686_length_339_cov_87.841667	149	227	166	1	78	0.0128205
NODE_122686_length_339_cov_87.841667	149	227	169	1	78	0.0128205
NODE_122686_length_339_cov_87.841667	149	227	173	2	78	0.0256410
NODE_122686_length_339_cov_87.841667	149	227	176	2	78	0.0256410
NODE_122686_length_339_cov_87.841667	149	227	179	1	78	0.0128205
NODE_122686_length_339_cov_87.841667	149	227	180	1	78	0.0128205
NODE_122686_length_339_cov_87.841667	149	227	181	1	78	0.0128205
NODE_122686_length_339_cov_87.841667	149	227	184	2	78	0.0256410
NODE_122686_length_339_cov_87.841667	149	227	185	1	78	0.0128205
NODE_122686_length_339_cov_87.841667	149	227	186	2	78	0.0256410
NODE_122686_length_339_cov_87.841667	149	227	187	2	78	0.0256410
NODE_122686_length_339_cov_87.841667	149	227	189	9	78	0.1153846
NODE_122686_length_339_cov_87.841667	149	227	190	1	78	0.0128205
NODE_122686_length_339_cov_87.841667	149	227	191	2	78	0.0256410
NODE_122686_length_339_cov_87.841667	149	227	193	1	78	0.0128205
NODE_122687_length_339_cov_14.304167	69	138	35	11	69	0.1594203
NODE_122687_length_339_cov_14.304167	69	138	36	2	69	0.0289855
NODE_122687_length_339_cov_14.304167	69	138	37	56	69	0.8115942
NODE_122687_length_339_cov_14.304167	69	138	35	11	69	0.1594203
NODE_122687_length_339_cov_14.304167	69	138	36	2	69	0.0289855
NODE_122687_length_339_cov_14.304167	69	138	37	56	69	0.8115942
NODE_122687_length_339_cov_14.304167	69	138	35	11	69	0.1594203
NODE_122687_length_339_cov_14.304167	69	138	36	2	69	0.0289855
NODE_122687_length_339_cov_14.304167	69	138	37	56	69	0.8115942
NODE_122687_length_339_cov_14.304167	88	138	35	11	50	0.2200000
NODE_122687_length_339_cov_14.304167	88	138	36	2	50	0.0400000
NODE_122687_length_339_cov_14.304167	88	138	37	37	50	0.7400000
NODE_122687_length_339_cov_14.304167	111	160	31	4	49	0.0816327
NODE_122687_length_339_cov_14.304167	111	160	32	3	49	0.0612245
NODE_122687_length_339_cov_14.304167	111	160	34	1	49	0.0204082
NODE_122687_length_339_cov_14.304167	111	160	35	20	49	0.4081633
NODE_122687_length_339_cov_14.304167	111	160	36	7	49	0.1428571
NODE_122687_length_339_cov_14.304167	111	160	37	14	49	0.2857143
NODE_122727_length_339_cov_4.320833	187	267	0	80	80	1.0000000
NODE_122804_length_339_cov_2.754167	45	125	2	13	80	0.1625000
NODE_122804_length_339_cov_2.754167	45	125	4	3	80	0.0375000
NODE_122804_length_339_cov_2.754167	45	125	6	64	80	0.8000000
NODE_122971_length_339_cov_1.841667	265	312	0	47	47	1.0000000
NODE_123041_length_339_cov_1.662500	10	57	0	1	47	0.0212766
NODE_123041_length_339_cov_1.662500	10	57	2	46	47	0.9787234
NODE_123182_length_339_cov_1.275000	247	312	0	65	65	1.0000000
NODE_123285_length_339_cov_1.070833	147	169	0	22	22	1.0000000
NODE_123633_length_338_cov_57.163180	59	120	0	61	61	1.0000000
NODE_123633_length_338_cov_57.163180	102	176	0	74	74	1.0000000
NODE_123674_length_338_cov_4.263598	113	165	2	52	52	1.0000000
NODE_123679_length_338_cov_4.079498	96	151	2	55	55	1.0000000
NODE_123689_length_338_cov_3.841004	122	149	0	27	27	1.0000000
NODE_123793_length_338_cov_2.393305	216	288	0	72	72	1.0000000
NODE_123795_length_338_cov_2.380753	29	93	0	64	64	1.0000000
NODE_123919_length_338_cov_1.878661	146	232	12	11	86	0.1279070
NODE_123919_length_338_cov_1.878661	146	232	14	39	86	0.4534884
NODE_123919_length_338_cov_1.878661	146	232	16	23	86	0.2674419
NODE_123919_length_338_cov_1.878661	146	232	18	7	86	0.0813954
NODE_123919_length_338_cov_1.878661	146	232	20	6	86	0.0697674
NODE_123944_length_338_cov_1.740586	79	159	0	80	80	1.0000000
NODE_123946_length_338_cov_1.732218	216	257	0	41	41	1.0000000
NODE_124046_length_338_cov_1.493724	14	90	0	76	76	1.0000000
NODE_124247_length_338_cov_1.100418	265	333	0	68	68	1.0000000
NODE_124456_length_338_cov_0.849372	281	338	0	57	57	1.0000000
NODE_124533_length_338_cov_0.711297	188	263	0	75	75	1.0000000
NODE_124625_length_337_cov_468.180672	107	187	19	8	80	0.1000000
NODE_124625_length_337_cov_468.180672	107	187	21	7	80	0.0875000
NODE_124625_length_337_cov_468.180672	107	187	22	6	80	0.0750000
NODE_124625_length_337_cov_468.180672	107	187	23	25	80	0.3125000
NODE_124625_length_337_cov_468.180672	107	187	24	23	80	0.2875000
NODE_124625_length_337_cov_468.180672	107	187	26	5	80	0.0625000
NODE_124625_length_337_cov_468.180672	107	187	27	2	80	0.0250000
NODE_124625_length_337_cov_468.180672	107	187	28	2	80	0.0250000
NODE_124625_length_337_cov_468.180672	107	187	30	2	80	0.0250000
NODE_124625_length_337_cov_468.180672	160	230	2	6	70	0.0857143
NODE_124625_length_337_cov_468.180672	160	230	3	2	70	0.0285714
NODE_124625_length_337_cov_468.180672	160	230	5	8	70	0.1142857
NODE_124625_length_337_cov_468.180672	160	230	7	3	70	0.0428571
NODE_124625_length_337_cov_468.180672	160	230	9	7	70	0.1000000
NODE_124625_length_337_cov_468.180672	160	230	17	3	70	0.0428571
NODE_124625_length_337_cov_468.180672	160	230	18	2	70	0.0285714
NODE_124625_length_337_cov_468.180672	160	230	19	20	70	0.2857143
NODE_124625_length_337_cov_468.180672	160	230	21	7	70	0.1000000
NODE_124625_length_337_cov_468.180672	160	230	23	12	70	0.1714286
NODE_124625_length_337_cov_468.180672	226	306	0	2	80	0.0250000
NODE_124625_length_337_cov_468.180672	226	306	2	78	80	0.9750000
NODE_124625_length_337_cov_468.180672	279	337	0	33	58	0.5689655
NODE_124625_length_337_cov_468.180672	279	337	2	25	58	0.4310345
NODE_124626_length_337_cov_91.344538	1	50	2	1	49	0.0204082
NODE_124626_length_337_cov_91.344538	1	50	8	16	49	0.3265306
NODE_124626_length_337_cov_91.344538	1	50	10	6	49	0.1224490
NODE_124626_length_337_cov_91.344538	1	50	14	5	49	0.1020408
NODE_124626_length_337_cov_91.344538	1	50	16	15	49	0.3061225
NODE_124626_length_337_cov_91.344538	1	50	22	1	49	0.0204082
NODE_124626_length_337_cov_91.344538	1	50	26	4	49	0.0816327
NODE_124626_length_337_cov_91.344538	1	50	36	1	49	0.0204082
NODE_124626_length_337_cov_91.344538	23	103	10	1	80	0.0125000
NODE_124626_length_337_cov_91.344538	23	103	14	5	80	0.0625000
NODE_124626_length_337_cov_91.344538	23	103	16	15	80	0.1875000
NODE_124626_length_337_cov_91.344538	23	103	22	1	80	0.0125000
NODE_124626_length_337_cov_91.344538	23	103	26	4	80	0.0500000
NODE_124626_length_337_cov_91.344538	23	103	36	2	80	0.0250000
NODE_124626_length_337_cov_91.344538	23	103	38	2	80	0.0250000
NODE_124626_length_337_cov_91.344538	23	103	40	7	80	0.0875000
NODE_124626_length_337_cov_91.344538	23	103	44	2	80	0.0250000
NODE_124626_length_337_cov_91.344538	23	103	46	8	80	0.1000000
NODE_124626_length_337_cov_91.344538	23	103	48	3	80	0.0375000
NODE_124626_length_337_cov_91.344538	23	103	50	1	80	0.0125000
NODE_124626_length_337_cov_91.344538	23	103	52	1	80	0.0125000
NODE_124626_length_337_cov_91.344538	23	103	54	3	80	0.0375000
NODE_124626_length_337_cov_91.344538	23	103	56	6	80	0.0750000
NODE_124626_length_337_cov_91.344538	23	103	58	19	80	0.2375000
NODE_124627_length_337_cov_73.352941	71	151	0	80	80	1.0000000
NODE_124627_length_337_cov_73.352941	124	204	0	80	80	1.0000000
NODE_124629_length_337_cov_46.978992	220	305	4	4	85	0.0470588
NODE_124629_length_337_cov_46.978992	220	305	12	1	85	0.0117647
NODE_124629_length_337_cov_46.978992	220	305	14	80	85	0.9411765
NODE_124629_length_337_cov_46.978992	220	305	4	4	85	0.0470588
NODE_124629_length_337_cov_46.978992	220	305	12	1	85	0.0117647
NODE_124629_length_337_cov_46.978992	220	305	14	80	85	0.9411765
NODE_124629_length_337_cov_46.978992	220	305	4	4	85	0.0470588
NODE_124629_length_337_cov_46.978992	220	305	12	1	85	0.0117647
NODE_124629_length_337_cov_46.978992	220	305	14	80	85	0.9411765
NODE_124629_length_337_cov_46.978992	278	327	0	15	49	0.3061225
NODE_124629_length_337_cov_46.978992	278	327	9	1	49	0.0204082
NODE_124629_length_337_cov_46.978992	278	327	14	33	49	0.6734694
NODE_124629_length_337_cov_46.978992	278	337	0	25	59	0.4237288
NODE_124629_length_337_cov_46.978992	278	337	9	1	59	0.0169492
NODE_124629_length_337_cov_46.978992	278	337	14	33	59	0.5593221
NODE_124629_length_337_cov_46.978992	283	337	0	25	54	0.4629630
NODE_124629_length_337_cov_46.978992	283	337	9	1	54	0.0185185
NODE_124629_length_337_cov_46.978992	283	337	14	28	54	0.5185185
NODE_124640_length_337_cov_6.214286	52	95	0	43	43	1.0000000
NODE_124669_length_337_cov_4.298319	5	58	0	53	53	1.0000000
NODE_124703_length_337_cov_3.478992	179	259	42	7	80	0.0875000
NODE_124703_length_337_cov_3.478992	179	259	47	2	80	0.0250000
NODE_124703_length_337_cov_3.478992	179	259	49	1	80	0.0125000
NODE_124703_length_337_cov_3.478992	179	259	50	2	80	0.0250000
NODE_124703_length_337_cov_3.478992	179	259	52	7	80	0.0875000
NODE_124703_length_337_cov_3.478992	179	259	53	4	80	0.0500000
NODE_124703_length_337_cov_3.478992	179	259	54	11	80	0.1375000
NODE_124703_length_337_cov_3.478992	179	259	55	4	80	0.0500000
NODE_124703_length_337_cov_3.478992	179	259	56	1	80	0.0125000
NODE_124703_length_337_cov_3.478992	179	259	57	5	80	0.0625000
NODE_124703_length_337_cov_3.478992	179	259	61	3	80	0.0375000
NODE_124703_length_337_cov_3.478992	179	259	62	4	80	0.0500000
NODE_124703_length_337_cov_3.478992	179	259	64	3	80	0.0375000
NODE_124703_length_337_cov_3.478992	179	259	65	1	80	0.0125000
NODE_124703_length_337_cov_3.478992	179	259	66	3	80	0.0375000
NODE_124703_length_337_cov_3.478992	179	259	67	9	80	0.1125000
NODE_124703_length_337_cov_3.478992	179	259	68	2	80	0.0250000
NODE_124703_length_337_cov_3.478992	179	259	69	11	80	0.1375000
NODE_124703_length_337_cov_3.478992	232	307	8	1	75	0.0133333
NODE_124703_length_337_cov_3.478992	232	307	16	6	75	0.0800000
NODE_124703_length_337_cov_3.478992	232	307	20	11	75	0.1466667
NODE_124703_length_337_cov_3.478992	232	307	22	1	75	0.0133333
NODE_124703_length_337_cov_3.478992	232	307	24	5	75	0.0666667
NODE_124703_length_337_cov_3.478992	232	307	26	13	75	0.1733333
NODE_124703_length_337_cov_3.478992	232	307	40	7	75	0.0933333
NODE_124703_length_337_cov_3.478992	232	307	42	11	75	0.1466667
NODE_124703_length_337_cov_3.478992	232	307	47	2	75	0.0266667
NODE_124703_length_337_cov_3.478992	232	307	49	1	75	0.0133333
NODE_124703_length_337_cov_3.478992	232	307	50	2	75	0.0266667
NODE_124703_length_337_cov_3.478992	232	307	52	7	75	0.0933333
NODE_124703_length_337_cov_3.478992	232	307	53	3	75	0.0400000
NODE_124703_length_337_cov_3.478992	232	307	54	5	75	0.0666667
NODE_124759_length_337_cov_2.647059	80	146	0	15	66	0.2272727
NODE_124759_length_337_cov_2.647059	80	146	2	51	66	0.7727273
NODE_124858_length_337_cov_2.121849	23	103	0	4	80	0.0500000
NODE_124858_length_337_cov_2.121849	23	103	4	3	80	0.0375000
NODE_124858_length_337_cov_2.121849	23	103	6	73	80	0.9125000
NODE_124858_length_337_cov_2.121849	76	141	6	65	65	1.0000000
NODE_125001_length_337_cov_1.689076	138	218	0	16	80	0.2000000
NODE_125001_length_337_cov_1.689076	138	218	2	64	80	0.8000000
NODE_125024_length_337_cov_1.592437	109	151	0	42	42	1.0000000
NODE_125024_length_337_cov_1.592437	126	204	0	78	78	1.0000000
NODE_125074_length_337_cov_1.466387	266	332	0	66	66	1.0000000
NODE_125271_length_337_cov_1.071429	279	319	0	40	40	1.0000000
NODE_125332_length_337_cov_0.978992	227	272	0	45	45	1.0000000
NODE_125633_length_336_cov_7.843882	151	231	0	80	80	1.0000000
NODE_125645_length_336_cov_5.578059	159	220	0	61	61	1.0000000
NODE_125645_length_336_cov_5.578059	212	273	0	61	61	1.0000000
NODE_125663_length_336_cov_4.481013	129	207	0	78	78	1.0000000
NODE_125752_length_336_cov_2.755274	83	112	8	27	29	0.9310345
NODE_125752_length_336_cov_2.755274	83	112	9	2	29	0.0689655
NODE_125752_length_336_cov_2.755274	187	268	2	52	81	0.6419753
NODE_125752_length_336_cov_2.755274	187	268	3	3	81	0.0370370
NODE_125752_length_336_cov_2.755274	187	268	4	26	81	0.3209876
NODE_125806_length_336_cov_2.358650	60	133	0	73	73	1.0000000
NODE_125811_length_336_cov_2.337553	93	173	0	80	80	1.0000000
NODE_125965_length_336_cov_1.729958	78	141	2	63	63	1.0000000
NODE_125965_length_336_cov_1.729958	131	194	0	50	63	0.7936508
NODE_125965_length_336_cov_1.729958	131	194	2	13	63	0.2063492
NODE_126134_length_336_cov_1.333333	34	114	0	80	80	1.0000000
NODE_126134_length_336_cov_1.333333	87	124	0	37	37	1.0000000
NODE_126134_length_336_cov_1.333333	182	213	10	5	31	0.1612903
NODE_126134_length_336_cov_1.333333	182	213	12	26	31	0.8387097
NODE_126216_length_336_cov_1.244726	222	276	0	54	54	1.0000000
NODE_126216_length_336_cov_1.244726	288	312	0	24	24	1.0000000
NODE_126260_length_336_cov_1.143460	129	154	0	25	25	1.0000000
NODE_126545_length_336_cov_0.670886	259	288	0	29	29	1.0000000
NODE_126606_length_335_cov_16.114407	162	242	0	80	80	1.0000000
NODE_126606_length_335_cov_16.114407	215	295	0	80	80	1.0000000
NODE_126609_length_335_cov_9.258475	177	250	0	73	73	1.0000000
NODE_126614_length_335_cov_7.207627	29	109	0	80	80	1.0000000
NODE_126614_length_335_cov_7.207627	82	162	0	80	80	1.0000000
NODE_126636_length_335_cov_5.046610	182	263	2	19	81	0.2345679
NODE_126636_length_335_cov_5.046610	182	263	4	62	81	0.7654321
NODE_126639_length_335_cov_4.995763	144	215	0	71	71	1.0000000
NODE_126665_length_335_cov_3.923729	163	231	0	68	68	1.0000000
NODE_126787_length_335_cov_2.411017	230	294	0	2	64	0.0312500
NODE_126787_length_335_cov_2.411017	230	294	2	62	64	0.9687500
NODE_126791_length_335_cov_2.402542	164	240	6	13	76	0.1710526
NODE_126791_length_335_cov_2.402542	164	240	8	24	76	0.3157895
NODE_126791_length_335_cov_2.402542	164	240	12	1	76	0.0131579
NODE_126791_length_335_cov_2.402542	164	240	14	3	76	0.0394737
NODE_126791_length_335_cov_2.402542	164	240	18	24	76	0.3157895
NODE_126791_length_335_cov_2.402542	164	240	20	3	76	0.0394737
NODE_126791_length_335_cov_2.402542	164	240	22	3	76	0.0394737
NODE_126791_length_335_cov_2.402542	164	240	23	1	76	0.0131579
NODE_126791_length_335_cov_2.402542	164	240	24	4	76	0.0526316
NODE_126792_length_335_cov_2.398305	116	179	2	26	63	0.4126984
NODE_126792_length_335_cov_2.398305	116	179	3	26	63	0.4126984
NODE_126792_length_335_cov_2.398305	116	179	4	11	63	0.1746032
NODE_126826_length_335_cov_2.161017	82	141	0	59	59	1.0000000
NODE_126835_length_335_cov_2.152542	61	134	0	73	73	1.0000000
NODE_126835_length_335_cov_2.152542	114	134	0	20	20	1.0000000
NODE_126920_length_335_cov_1.766949	257	330	2	73	73	1.0000000
NODE_126920_length_335_cov_1.766949	297	335	0	1	38	0.0263158
NODE_126920_length_335_cov_1.766949	297	335	2	37	38	0.9736842
NODE_127022_length_335_cov_1.529661	255	320	0	65	65	1.0000000
NODE_127023_length_335_cov_1.525424	222	266	0	13	44	0.2954545
NODE_127023_length_335_cov_1.525424	222	266	2	31	44	0.7045454
NODE_127062_length_335_cov_1.457627	38	87	0	49	49	1.0000000
NODE_127130_length_335_cov_1.296610	291	311	0	20	20	1.0000000
NODE_127130_length_335_cov_1.296610	291	311	0	20	20	1.0000000
NODE_127143_length_335_cov_1.292373	202	232	0	10	30	0.3333333
NODE_127143_length_335_cov_1.292373	202	232	2	20	30	0.6666667
NODE_127200_length_335_cov_1.194915	75	156	16	1	81	0.0123457
NODE_127200_length_335_cov_1.194915	75	156	17	19	81	0.2345679
NODE_127200_length_335_cov_1.194915	75	156	18	16	81	0.1975309
NODE_127200_length_335_cov_1.194915	75	156	19	6	81	0.0740741
NODE_127200_length_335_cov_1.194915	75	156	20	26	81	0.3209876
NODE_127200_length_335_cov_1.194915	75	156	21	11	81	0.1358025
NODE_127200_length_335_cov_1.194915	75	156	22	2	81	0.0246914
NODE_127200_length_335_cov_1.194915	129	195	16	1	66	0.0151515
NODE_127200_length_335_cov_1.194915	129	195	17	2	66	0.0303030
NODE_127200_length_335_cov_1.194915	129	195	18	2	66	0.0303030
NODE_127200_length_335_cov_1.194915	129	195	19	6	66	0.0909091
NODE_127200_length_335_cov_1.194915	129	195	20	5	66	0.0757576
NODE_127200_length_335_cov_1.194915	129	195	21	11	66	0.1666667
NODE_127200_length_335_cov_1.194915	129	195	22	2	66	0.0303030
NODE_127200_length_335_cov_1.194915	129	195	26	2	66	0.0303030
NODE_127200_length_335_cov_1.194915	129	195	27	2	66	0.0303030
NODE_127200_length_335_cov_1.194915	129	195	28	7	66	0.1060606
NODE_127200_length_335_cov_1.194915	129	195	29	4	66	0.0606061
NODE_127200_length_335_cov_1.194915	129	195	30	9	66	0.1363636
NODE_127200_length_335_cov_1.194915	129	195	31	8	66	0.1212121
NODE_127200_length_335_cov_1.194915	129	195	32	5	66	0.0757576
NODE_127310_length_335_cov_0.983051	96	117	0	21	21	1.0000000
NODE_127585_length_334_cov_275.425532	135	215	82	7	80	0.0875000
NODE_127585_length_334_cov_275.425532	135	215	84	1	80	0.0125000
NODE_127585_length_334_cov_275.425532	135	215	90	1	80	0.0125000
NODE_127585_length_334_cov_275.425532	135	215	93	3	80	0.0375000
NODE_127585_length_334_cov_275.425532	135	215	94	2	80	0.0250000
NODE_127585_length_334_cov_275.425532	135	215	100	1	80	0.0125000
NODE_127585_length_334_cov_275.425532	135	215	104	6	80	0.0750000
NODE_127585_length_334_cov_275.425532	135	215	109	4	80	0.0500000
NODE_127585_length_334_cov_275.425532	135	215	111	7	80	0.0875000
NODE_127585_length_334_cov_275.425532	135	215	113	3	80	0.0375000
NODE_127585_length_334_cov_275.425532	135	215	116	2	80	0.0250000
NODE_127585_length_334_cov_275.425532	135	215	118	1	80	0.0125000
NODE_127585_length_334_cov_275.425532	135	215	121	1	80	0.0125000
NODE_127585_length_334_cov_275.425532	135	215	125	5	80	0.0625000
NODE_127585_length_334_cov_275.425532	135	215	127	1	80	0.0125000
NODE_127585_length_334_cov_275.425532	135	215	129	2	80	0.0250000
NODE_127585_length_334_cov_275.425532	135	215	131	3	80	0.0375000
NODE_127585_length_334_cov_275.425532	135	215	134	11	80	0.1375000
NODE_127585_length_334_cov_275.425532	135	215	136	3	80	0.0375000
NODE_127585_length_334_cov_275.425532	135	215	137	7	80	0.0875000
NODE_127585_length_334_cov_275.425532	135	215	138	9	80	0.1125000
NODE_127585_length_334_cov_275.425532	188	269	27	10	81	0.1234568
NODE_127585_length_334_cov_275.425532	188	269	28	11	81	0.1358025
NODE_127585_length_334_cov_275.425532	188	269	29	4	81	0.0493827
NODE_127585_length_334_cov_275.425532	188	269	37	1	81	0.0123457
NODE_127585_length_334_cov_275.425532	188	269	38	2	81	0.0246914
NODE_127585_length_334_cov_275.425532	188	269	41	1	81	0.0123457
NODE_127585_length_334_cov_275.425532	188	269	42	6	81	0.0740741
NODE_127585_length_334_cov_275.425532	188	269	43	7	81	0.0864198
NODE_127585_length_334_cov_275.425532	188	269	45	1	81	0.0123457
NODE_127585_length_334_cov_275.425532	188	269	49	1	81	0.0123457
NODE_127585_length_334_cov_275.425532	188	269	50	2	81	0.0246914
NODE_127585_length_334_cov_275.425532	188	269	51	1	81	0.0123457
NODE_127585_length_334_cov_275.425532	188	269	66	2	81	0.0246914
NODE_127585_length_334_cov_275.425532	188	269	78	1	81	0.0123457
NODE_127585_length_334_cov_275.425532	188	269	80	3	81	0.0370370
NODE_127585_length_334_cov_275.425532	188	269	82	8	81	0.0987654
NODE_127585_length_334_cov_275.425532	188	269	84	1	81	0.0123457
NODE_127585_length_334_cov_275.425532	188	269	90	1	81	0.0123457
NODE_127585_length_334_cov_275.425532	188	269	93	3	81	0.0370370
NODE_127585_length_334_cov_275.425532	188	269	94	2	81	0.0246914
NODE_127585_length_334_cov_275.425532	188	269	100	1	81	0.0123457
NODE_127585_length_334_cov_275.425532	188	269	104	6	81	0.0740741
NODE_127585_length_334_cov_275.425532	188	269	109	4	81	0.0493827
NODE_127585_length_334_cov_275.425532	188	269	111	2	81	0.0246914
NODE_127586_length_334_cov_14.753191	135	215	0	80	80	1.0000000
NODE_127586_length_334_cov_14.753191	188	268	0	80	80	1.0000000
NODE_127610_length_334_cov_4.829787	92	174	0	82	82	1.0000000
NODE_127610_length_334_cov_4.829787	151	237	0	86	86	1.0000000
NODE_127612_length_334_cov_4.817021	179	231	0	52	52	1.0000000
NODE_127626_length_334_cov_4.438298	121	201	2	5	80	0.0625000
NODE_127626_length_334_cov_4.438298	121	201	4	27	80	0.3375000
NODE_127626_length_334_cov_4.438298	121	201	5	3	80	0.0375000
NODE_127626_length_334_cov_4.438298	121	201	6	22	80	0.2750000
NODE_127626_length_334_cov_4.438298	121	201	8	15	80	0.1875000
NODE_127626_length_334_cov_4.438298	121	201	10	6	80	0.0750000
NODE_127626_length_334_cov_4.438298	121	201	12	2	80	0.0250000
NODE_127672_length_334_cov_3.604255	248	314	0	66	66	1.0000000
NODE_127672_length_334_cov_3.604255	287	334	0	47	47	1.0000000
NODE_127844_length_334_cov_2.165957	0	48	0	48	48	1.0000000
NODE_128026_length_334_cov_1.595745	253	328	0	37	75	0.4933333
NODE_128026_length_334_cov_1.595745	253	328	2	25	75	0.3333333
NODE_128026_length_334_cov_1.595745	253	328	4	13	75	0.1733333
NODE_128258_length_334_cov_1.157447	146	177	0	31	31	1.0000000
NODE_128665_length_333_cov_5.423077	172	242	0	70	70	1.0000000
NODE_128673_length_333_cov_4.867521	122	172	2	50	50	1.0000000
NODE_128673_length_333_cov_4.867521	175	255	2	55	80	0.6875000
NODE_128673_length_333_cov_4.867521	175	255	4	25	80	0.3125000
NODE_128673_length_333_cov_4.867521	194	219	2	25	25	1.0000000
NODE_128717_length_333_cov_3.717949	49	129	0	49	80	0.6125000
NODE_128717_length_333_cov_3.717949	49	129	1	3	80	0.0375000
NODE_128717_length_333_cov_3.717949	49	129	3	4	80	0.0500000
NODE_128717_length_333_cov_3.717949	49	129	4	24	80	0.3000000
NODE_128717_length_333_cov_3.717949	102	182	3	3	80	0.0375000
NODE_128717_length_333_cov_3.717949	102	182	4	28	80	0.3500000
NODE_128717_length_333_cov_3.717949	102	182	6	49	80	0.6125000
NODE_128767_length_333_cov_2.897436	59	139	8	9	80	0.1125000
NODE_128767_length_333_cov_2.897436	59	139	10	10	80	0.1250000
NODE_128767_length_333_cov_2.897436	59	139	12	21	80	0.2625000
NODE_128767_length_333_cov_2.897436	59	139	14	40	80	0.5000000
NODE_128850_length_333_cov_2.307692	68	148	0	5	80	0.0625000
NODE_128850_length_333_cov_2.307692	68	148	2	75	80	0.9375000
NODE_128933_length_333_cov_1.940171	135	215	0	1	80	0.0125000
NODE_128933_length_333_cov_1.940171	135	215	2	79	80	0.9875000
NODE_129252_length_333_cov_1.200855	0	80	0	9	80	0.1125000
NODE_129252_length_333_cov_1.200855	0	80	2	71	80	0.8875000
NODE_129263_length_333_cov_1.170940	146	193	0	1	47	0.0212766
NODE_129263_length_333_cov_1.170940	146	193	2	46	47	0.9787234
NODE_129263_length_333_cov_1.170940	203	243	0	7	40	0.1750000
NODE_129263_length_333_cov_1.170940	203	243	2	33	40	0.8250000
NODE_129303_length_333_cov_1.089744	241	306	0	65	65	1.0000000
NODE_129310_length_333_cov_1.089744	206	226	0	20	20	1.0000000
NODE_129665_length_332_cov_5.386266	101	167	0	66	66	1.0000000
NODE_129680_length_332_cov_4.768240	221	250	2	14	29	0.4827586
NODE_129680_length_332_cov_4.768240	221	250	4	15	29	0.5172414
NODE_129695_length_332_cov_4.343348	130	179	0	49	49	1.0000000
NODE_129698_length_332_cov_4.201717	191	237	2	45	46	0.9782609
NODE_129698_length_332_cov_4.201717	191	237	4	1	46	0.0217391
NODE_129698_length_332_cov_4.201717	211	290	0	48	79	0.6075949
NODE_129698_length_332_cov_4.201717	211	290	2	31	79	0.3924051
NODE_129879_length_332_cov_2.274678	187	227	12	12	40	0.3000000
NODE_129879_length_332_cov_2.274678	187	227	14	1	40	0.0250000
NODE_129879_length_332_cov_2.274678	187	227	18	1	40	0.0250000
NODE_129879_length_332_cov_2.274678	187	227	20	1	40	0.0250000
NODE_129879_length_332_cov_2.274678	187	227	22	1	40	0.0250000
NODE_129879_length_332_cov_2.274678	187	227	24	1	40	0.0250000
NODE_129879_length_332_cov_2.274678	187	227	26	1	40	0.0250000
NODE_129879_length_332_cov_2.274678	187	227	30	2	40	0.0500000
NODE_129879_length_332_cov_2.274678	187	227	31	1	40	0.0250000
NODE_129879_length_332_cov_2.274678	187	227	34	4	40	0.1000000
NODE_129879_length_332_cov_2.274678	187	227	40	1	40	0.0250000
NODE_129879_length_332_cov_2.274678	187	227	42	2	40	0.0500000
NODE_129879_length_332_cov_2.274678	187	227	44	3	40	0.0750000
NODE_129879_length_332_cov_2.274678	187	227	48	1	40	0.0250000
NODE_129879_length_332_cov_2.274678	187	227	50	2	40	0.0500000
NODE_129879_length_332_cov_2.274678	187	227	52	2	40	0.0500000
NODE_129879_length_332_cov_2.274678	187	227	58	4	40	0.1000000
NODE_129901_length_332_cov_2.184549	194	258	0	64	64	1.0000000
NODE_130053_length_332_cov_1.682403	241	316	0	75	75	1.0000000
NODE_130055_length_332_cov_1.673820	157	220	0	63	63	1.0000000
NODE_130183_length_332_cov_1.364807	132	212	2	80	80	1.0000000
NODE_130187_length_332_cov_1.356223	276	332	0	2	56	0.0357143
NODE_130187_length_332_cov_1.356223	276	332	4	1	56	0.0178571
NODE_130187_length_332_cov_1.356223	276	332	6	4	56	0.0714286
NODE_130187_length_332_cov_1.356223	276	332	15	6	56	0.1071429
NODE_130187_length_332_cov_1.356223	276	332	16	43	56	0.7678571
NODE_130312_length_332_cov_1.210300	120	176	0	45	56	0.8035714
NODE_130312_length_332_cov_1.210300	120	176	2	11	56	0.1964286
NODE_130757_length_331_cov_5.254310	141	221	0	80	80	1.0000000
NODE_130757_length_331_cov_5.254310	194	274	0	80	80	1.0000000
NODE_130781_length_331_cov_4.323276	26	108	0	9	82	0.1097561
NODE_130781_length_331_cov_4.323276	26	108	3	7	82	0.0853659
NODE_130781_length_331_cov_4.323276	26	108	5	4	82	0.0487805
NODE_130781_length_331_cov_4.323276	26	108	6	1	82	0.0121951
NODE_130781_length_331_cov_4.323276	26	108	8	20	82	0.2439024
NODE_130781_length_331_cov_4.323276	26	108	9	21	82	0.2560976
NODE_130781_length_331_cov_4.323276	26	108	11	7	82	0.0853659
NODE_130781_length_331_cov_4.323276	26	108	13	6	82	0.0731707
NODE_130781_length_331_cov_4.323276	26	108	14	7	82	0.0853659
NODE_130902_length_331_cov_2.603448	128	181	0	53	53	1.0000000
NODE_131036_length_331_cov_1.965517	183	216	0	6	33	0.1818182
NODE_131036_length_331_cov_1.965517	183	216	4	27	33	0.8181818
NODE_131054_length_331_cov_1.896552	266	331	0	22	65	0.3384615
NODE_131054_length_331_cov_1.896552	266	331	4	26	65	0.4000000
NODE_131054_length_331_cov_1.896552	266	331	6	17	65	0.2615385
NODE_131817_length_330_cov_14.731602	209	280	0	71	71	1.0000000
NODE_131840_length_330_cov_4.935065	16	97	4	10	81	0.1234568
NODE_131840_length_330_cov_4.935065	16	97	6	7	81	0.0864198
NODE_131840_length_330_cov_4.935065	16	97	18	64	81	0.7901235
NODE_131840_length_330_cov_4.935065	81	149	12	24	68	0.3529412
NODE_131840_length_330_cov_4.935065	81	149	16	18	68	0.2647059
NODE_131840_length_330_cov_4.935065	81	149	18	26	68	0.3823529
NODE_131841_length_330_cov_4.891775	177	255	0	34	78	0.4358974
NODE_131841_length_330_cov_4.891775	177	255	2	44	78	0.5641026
NODE_131845_length_330_cov_4.740260	134	209	0	75	75	1.0000000
NODE_131892_length_330_cov_3.467532	161	225	2	39	64	0.6093750
NODE_131892_length_330_cov_3.467532	161	225	6	25	64	0.3906250
NODE_131969_length_330_cov_2.601732	8	88	0	80	80	1.0000000
NODE_132188_length_330_cov_1.623377	154	200	0	46	46	1.0000000
NODE_132238_length_330_cov_1.541126	98	156	0	58	58	1.0000000
NODE_132268_length_330_cov_1.467532	234	287	0	53	53	1.0000000
NODE_132268_length_330_cov_1.467532	242	283	0	41	41	1.0000000
NODE_132306_length_330_cov_1.346320	230	296	0	66	66	1.0000000
NODE_132306_length_330_cov_1.346320	230	257	0	27	27	1.0000000
NODE_132410_length_330_cov_1.220779	249	272	0	23	23	1.0000000
NODE_132478_length_330_cov_1.103896	189	227	0	38	38	1.0000000
NODE_132542_length_330_cov_1.038961	219	297	23	10	78	0.1282051
NODE_132542_length_330_cov_1.038961	219	297	24	10	78	0.1282051
NODE_132542_length_330_cov_1.038961	219	297	27	1	78	0.0128205
NODE_132542_length_330_cov_1.038961	219	297	28	3	78	0.0384615
NODE_132542_length_330_cov_1.038961	219	297	36	2	78	0.0256410
NODE_132542_length_330_cov_1.038961	219	297	39	4	78	0.0512821
NODE_132542_length_330_cov_1.038961	219	297	47	1	78	0.0128205
NODE_132542_length_330_cov_1.038961	219	297	50	17	78	0.2179487
NODE_132542_length_330_cov_1.038961	219	297	51	5	78	0.0641026
NODE_132542_length_330_cov_1.038961	219	297	56	1	78	0.0128205
NODE_132542_length_330_cov_1.038961	219	297	65	1	78	0.0128205
NODE_132542_length_330_cov_1.038961	219	297	66	3	78	0.0384615
NODE_132542_length_330_cov_1.038961	219	297	68	4	78	0.0512821
NODE_132542_length_330_cov_1.038961	219	297	81	1	78	0.0128205
NODE_132542_length_330_cov_1.038961	219	297	85	1	78	0.0128205
NODE_132542_length_330_cov_1.038961	219	297	86	3	78	0.0384615
NODE_132542_length_330_cov_1.038961	219	297	87	1	78	0.0128205
NODE_132542_length_330_cov_1.038961	219	297	88	4	78	0.0512821
NODE_132542_length_330_cov_1.038961	219	297	99	3	78	0.0384615
NODE_132542_length_330_cov_1.038961	219	297	100	1	78	0.0128205
NODE_132542_length_330_cov_1.038961	219	297	101	2	78	0.0256410
NODE_132688_length_330_cov_0.883117	284	330	0	46	46	1.0000000
NODE_132873_length_329_cov_110.178261	138	167	37	1	29	0.0344828
NODE_132873_length_329_cov_110.178261	138	167	39	11	29	0.3793103
NODE_132873_length_329_cov_110.178261	138	167	40	4	29	0.1379310
NODE_132873_length_329_cov_110.178261	138	167	42	12	29	0.4137931
NODE_132873_length_329_cov_110.178261	138	167	44	1	29	0.0344828
NODE_132873_length_329_cov_110.178261	189	269	22	6	80	0.0750000
NODE_132873_length_329_cov_110.178261	189	269	24	4	80	0.0500000
NODE_132873_length_329_cov_110.178261	189	269	26	1	80	0.0125000
NODE_132873_length_329_cov_110.178261	189	269	33	1	80	0.0125000
NODE_132873_length_329_cov_110.178261	189	269	34	2	80	0.0250000
NODE_132873_length_329_cov_110.178261	189	269	36	3	80	0.0375000
NODE_132873_length_329_cov_110.178261	189	269	40	6	80	0.0750000
NODE_132873_length_329_cov_110.178261	189	269	42	1	80	0.0125000
NODE_132873_length_329_cov_110.178261	189	269	44	10	80	0.1250000
NODE_132873_length_329_cov_110.178261	189	269	46	9	80	0.1125000
NODE_132873_length_329_cov_110.178261	189	269	48	6	80	0.0750000
NODE_132873_length_329_cov_110.178261	189	269	50	2	80	0.0250000
NODE_132873_length_329_cov_110.178261	189	269	52	1	80	0.0125000
NODE_132873_length_329_cov_110.178261	189	269	54	4	80	0.0500000
NODE_132873_length_329_cov_110.178261	189	269	56	5	80	0.0625000
NODE_132873_length_329_cov_110.178261	189	269	57	3	80	0.0375000
NODE_132873_length_329_cov_110.178261	189	269	58	1	80	0.0125000
NODE_132873_length_329_cov_110.178261	189	269	60	15	80	0.1875000
NODE_132873_length_329_cov_110.178261	242	322	2	2	80	0.0250000
NODE_132873_length_329_cov_110.178261	242	322	4	1	80	0.0125000
NODE_132873_length_329_cov_110.178261	242	322	6	2	80	0.0250000
NODE_132873_length_329_cov_110.178261	242	322	7	10	80	0.1250000
NODE_132873_length_329_cov_110.178261	242	322	11	7	80	0.0875000
NODE_132873_length_329_cov_110.178261	242	322	12	3	80	0.0375000
NODE_132873_length_329_cov_110.178261	242	322	16	1	80	0.0125000
NODE_132873_length_329_cov_110.178261	242	322	18	5	80	0.0625000
NODE_132873_length_329_cov_110.178261	242	322	20	20	80	0.2500000
NODE_132873_length_329_cov_110.178261	242	322	22	8	80	0.1000000
NODE_132873_length_329_cov_110.178261	242	322	24	4	80	0.0500000
NODE_132873_length_329_cov_110.178261	242	322	26	1	80	0.0125000
NODE_132873_length_329_cov_110.178261	242	322	33	1	80	0.0125000
NODE_132873_length_329_cov_110.178261	242	322	34	2	80	0.0250000
NODE_132873_length_329_cov_110.178261	242	322	36	3	80	0.0375000
NODE_132873_length_329_cov_110.178261	242	322	40	6	80	0.0750000
NODE_132873_length_329_cov_110.178261	242	322	42	1	80	0.0125000
NODE_132873_length_329_cov_110.178261	242	322	44	3	80	0.0375000
NODE_132879_length_329_cov_8.882609	61	141	0	80	80	1.0000000
NODE_132879_length_329_cov_8.882609	114	194	0	80	80	1.0000000
NODE_132885_length_329_cov_6.586957	166	207	0	41	41	1.0000000
NODE_132908_length_329_cov_4.617391	175	229	2	47	54	0.8703704
NODE_132908_length_329_cov_4.617391	175	229	4	7	54	0.1296296
NODE_132970_length_329_cov_3.160870	59	139	0	33	80	0.4125000
NODE_132970_length_329_cov_3.160870	59	139	4	47	80	0.5875000
NODE_133003_length_329_cov_2.821739	164	209	0	45	45	1.0000000
NODE_133003_length_329_cov_2.821739	184	262	0	78	78	1.0000000
NODE_133033_length_329_cov_2.560870	139	201	0	62	62	1.0000000
NODE_133036_length_329_cov_2.543478	145	206	8	5	61	0.0819672
NODE_133036_length_329_cov_2.543478	145	206	10	8	61	0.1311475
NODE_133036_length_329_cov_2.543478	145	206	12	48	61	0.7868853
NODE_133123_length_329_cov_2.143478	39	119	6	5	80	0.0625000
NODE_133123_length_329_cov_2.143478	39	119	7	13	80	0.1625000
NODE_133123_length_329_cov_2.143478	39	119	8	6	80	0.0750000
NODE_133123_length_329_cov_2.143478	39	119	9	3	80	0.0375000
NODE_133123_length_329_cov_2.143478	39	119	10	1	80	0.0125000
NODE_133123_length_329_cov_2.143478	39	119	11	14	80	0.1750000
NODE_133123_length_329_cov_2.143478	39	119	12	38	80	0.4750000
NODE_133123_length_329_cov_2.143478	92	158	6	1	66	0.0151515
NODE_133123_length_329_cov_2.143478	92	158	8	6	66	0.0909091
NODE_133123_length_329_cov_2.143478	92	158	10	12	66	0.1818182
NODE_133123_length_329_cov_2.143478	92	158	12	47	66	0.7121212
NODE_133184_length_329_cov_1.865217	182	252	0	1	70	0.0142857
NODE_133184_length_329_cov_1.865217	182	252	2	20	70	0.2857143
NODE_133184_length_329_cov_1.865217	182	252	3	5	70	0.0714286
NODE_133184_length_329_cov_1.865217	182	252	4	11	70	0.1571429
NODE_133184_length_329_cov_1.865217	182	252	6	7	70	0.1000000
NODE_133184_length_329_cov_1.865217	182	252	8	1	70	0.0142857
NODE_133184_length_329_cov_1.865217	182	252	10	25	70	0.3571429
NODE_133200_length_329_cov_1.791304	50	84	0	34	34	1.0000000
NODE_133200_length_329_cov_1.791304	92	149	0	57	57	1.0000000
NODE_133200_length_329_cov_1.791304	145	203	0	58	58	1.0000000
NODE_133332_length_329_cov_1.508696	261	323	0	62	62	1.0000000
NODE_133348_length_329_cov_1.469565	168	237	0	29	69	0.4202898
NODE_133348_length_329_cov_1.469565	168	237	2	40	69	0.5797101
NODE_133376_length_329_cov_1.391304	275	307	13	1	32	0.0312500
NODE_133376_length_329_cov_1.391304	275	307	15	4	32	0.1250000
NODE_133376_length_329_cov_1.391304	275	307	16	2	32	0.0625000
NODE_133376_length_329_cov_1.391304	275	307	17	25	32	0.7812500
NODE_133547_length_329_cov_1.165217	199	242	0	43	43	1.0000000
NODE_133768_length_329_cov_0.878261	221	296	4	26	75	0.3466667
NODE_133768_length_329_cov_0.878261	221	296	6	36	75	0.4800000
NODE_133768_length_329_cov_0.878261	221	296	8	13	75	0.1733333
NODE_133970_length_328_cov_4.484716	95	175	0	80	80	1.0000000
NODE_133989_length_328_cov_4.087336	79	159	0	78	80	0.9750000
NODE_133989_length_328_cov_4.087336	79	159	2	2	80	0.0250000
NODE_133989_length_328_cov_4.087336	132	207	0	25	75	0.3333333
NODE_133989_length_328_cov_4.087336	132	207	2	44	75	0.5866666
NODE_133989_length_328_cov_4.087336	132	207	8	6	75	0.0800000
NODE_133993_length_328_cov_3.895197	110	190	2	21	80	0.2625000
NODE_133993_length_328_cov_3.895197	110	190	4	59	80	0.7375000
NODE_134019_length_328_cov_3.393013	30	78	0	48	48	1.0000000
NODE_134144_length_328_cov_2.161572	103	134	8	3	31	0.0967742
NODE_134144_length_328_cov_2.161572	103	134	12	17	31	0.5483871
NODE_134144_length_328_cov_2.161572	103	134	14	11	31	0.3548387
NODE_134247_length_328_cov_1.781659	16	44	0	28	28	1.0000000
NODE_134335_length_328_cov_1.567686	0	76	0	1	76	0.0131579
NODE_134335_length_328_cov_1.567686	0	76	8	2	76	0.0263158
NODE_134335_length_328_cov_1.567686	0	76	9	9	76	0.1184211
NODE_134335_length_328_cov_1.567686	0	76	10	64	76	0.8421053
NODE_134335_length_328_cov_1.567686	49	94	10	45	45	1.0000000
NODE_134452_length_328_cov_1.336245	0	73	0	73	73	1.0000000
NODE_134508_length_328_cov_1.266376	78	158	2	13	80	0.1625000
NODE_134508_length_328_cov_1.266376	78	158	3	21	80	0.2625000
NODE_134508_length_328_cov_1.266376	78	158	4	46	80	0.5750000
NODE_135002_length_327_cov_4.934211	170	250	0	8	80	0.1000000
NODE_135002_length_327_cov_4.934211	170	250	1	1	80	0.0125000
NODE_135002_length_327_cov_4.934211	170	250	2	71	80	0.8875000
NODE_135009_length_327_cov_4.701754	225	305	0	71	80	0.8875000
NODE_135009_length_327_cov_4.701754	225	305	2	9	80	0.1125000
NODE_135018_length_327_cov_4.241228	97	173	6	3	76	0.0394737
NODE_135018_length_327_cov_4.241228	97	173	9	18	76	0.2368421
NODE_135018_length_327_cov_4.241228	97	173	12	55	76	0.7236842
NODE_135037_length_327_cov_3.719298	70	150	0	80	80	1.0000000
NODE_135063_length_327_cov_3.350877	156	227	0	10	71	0.1408451
NODE_135063_length_327_cov_3.350877	156	227	2	13	71	0.1830986
NODE_135063_length_327_cov_3.350877	156	227	4	48	71	0.6760563
NODE_135328_length_327_cov_1.780702	191	271	6	6	80	0.0750000
NODE_135328_length_327_cov_1.780702	191	271	9	1	80	0.0125000
NODE_135328_length_327_cov_1.780702	191	271	10	7	80	0.0875000
NODE_135328_length_327_cov_1.780702	191	271	14	3	80	0.0375000
NODE_135328_length_327_cov_1.780702	191	271	18	6	80	0.0750000
NODE_135328_length_327_cov_1.780702	191	271	20	2	80	0.0250000
NODE_135328_length_327_cov_1.780702	191	271	22	2	80	0.0250000
NODE_135328_length_327_cov_1.780702	191	271	24	53	80	0.6625000
NODE_136081_length_326_cov_3.964758	178	228	0	50	50	1.0000000
NODE_136100_length_326_cov_3.502203	211	253	0	2	42	0.0476190
NODE_136100_length_326_cov_3.502203	211	253	2	8	42	0.1904762
NODE_136100_length_326_cov_3.502203	211	253	4	32	42	0.7619048
NODE_136100_length_326_cov_3.502203	220	255	0	4	35	0.1142857
NODE_136100_length_326_cov_3.502203	220	255	2	8	35	0.2285714
NODE_136100_length_326_cov_3.502203	220	255	4	23	35	0.6571429
NODE_136116_length_326_cov_3.202643	149	203	8	1	54	0.0185185
NODE_136116_length_326_cov_3.202643	149	203	10	2	54	0.0370370
NODE_136116_length_326_cov_3.202643	149	203	12	1	54	0.0185185
NODE_136116_length_326_cov_3.202643	149	203	14	1	54	0.0185185
NODE_136116_length_326_cov_3.202643	149	203	16	7	54	0.1296296
NODE_136116_length_326_cov_3.202643	149	203	18	42	54	0.7777778
NODE_136130_length_326_cov_3.057269	107	126	0	19	19	1.0000000
NODE_136176_length_326_cov_2.594714	125	196	0	71	71	1.0000000
NODE_136283_length_326_cov_2.123348	184	244	0	22	60	0.3666667
NODE_136283_length_326_cov_2.123348	184	244	2	38	60	0.6333333
NODE_136496_length_326_cov_1.515419	86	166	0	80	80	1.0000000
NODE_137182_length_325_cov_4.893805	142	222	35	2	80	0.0250000
NODE_137182_length_325_cov_4.893805	142	222	36	1	80	0.0125000
NODE_137182_length_325_cov_4.893805	142	222	38	28	80	0.3500000
NODE_137182_length_325_cov_4.893805	142	222	40	38	80	0.4750000
NODE_137182_length_325_cov_4.893805	142	222	41	4	80	0.0500000
NODE_137182_length_325_cov_4.893805	142	222	42	7	80	0.0875000
NODE_137182_length_325_cov_4.893805	195	275	9	2	80	0.0250000
NODE_137182_length_325_cov_4.893805	195	275	10	1	80	0.0125000
NODE_137182_length_325_cov_4.893805	195	275	11	6	80	0.0750000
NODE_137182_length_325_cov_4.893805	195	275	13	18	80	0.2250000
NODE_137182_length_325_cov_4.893805	195	275	16	2	80	0.0250000
NODE_137182_length_325_cov_4.893805	195	275	18	8	80	0.1000000
NODE_137182_length_325_cov_4.893805	195	275	20	4	80	0.0500000
NODE_137182_length_325_cov_4.893805	195	275	24	1	80	0.0125000
NODE_137182_length_325_cov_4.893805	195	275	26	2	80	0.0250000
NODE_137182_length_325_cov_4.893805	195	275	33	1	80	0.0125000
NODE_137182_length_325_cov_4.893805	195	275	34	7	80	0.0875000
NODE_137182_length_325_cov_4.893805	195	275	35	3	80	0.0375000
NODE_137182_length_325_cov_4.893805	195	275	36	1	80	0.0125000
NODE_137182_length_325_cov_4.893805	195	275	38	13	80	0.1625000
NODE_137182_length_325_cov_4.893805	195	275	40	11	80	0.1375000
NODE_137199_length_325_cov_4.000000	134	198	0	64	64	1.0000000
NODE_137221_length_325_cov_3.513274	191	266	8	20	75	0.2666667
NODE_137221_length_325_cov_3.513274	191	266	10	12	75	0.1600000
NODE_137221_length_325_cov_3.513274	191	266	14	24	75	0.3200000
NODE_137221_length_325_cov_3.513274	191	266	16	19	75	0.2533333
NODE_137221_length_325_cov_3.513274	240	319	2	8	79	0.1012658
NODE_137221_length_325_cov_3.513274	240	319	4	5	79	0.0632911
NODE_137221_length_325_cov_3.513274	240	319	7	1	79	0.0126582
NODE_137221_length_325_cov_3.513274	240	319	8	17	79	0.2151899
NODE_137221_length_325_cov_3.513274	240	319	10	2	79	0.0253165
NODE_137221_length_325_cov_3.513274	240	319	12	1	79	0.0126582
NODE_137221_length_325_cov_3.513274	240	319	14	9	79	0.1139240
NODE_137221_length_325_cov_3.513274	240	319	16	36	79	0.4556962
NODE_137223_length_325_cov_3.469027	216	278	4	6	62	0.0967742
NODE_137223_length_325_cov_3.469027	216	278	6	20	62	0.3225806
NODE_137223_length_325_cov_3.469027	216	278	8	36	62	0.5806451
NODE_137224_length_325_cov_3.429204	178	224	4	46	46	1.0000000
NODE_137243_length_325_cov_3.168142	188	274	0	15	86	0.1744186
NODE_137243_length_325_cov_3.168142	188	274	6	71	86	0.8255814
NODE_137268_length_325_cov_2.880531	72	152	0	8	80	0.1000000
NODE_137268_length_325_cov_2.880531	72	152	2	5	80	0.0625000
NODE_137268_length_325_cov_2.880531	72	152	4	9	80	0.1125000
NODE_137268_length_325_cov_2.880531	72	152	6	58	80	0.7250000
NODE_137268_length_325_cov_2.880531	125	205	2	3	80	0.0375000
NODE_137268_length_325_cov_2.880531	125	205	4	37	80	0.4625000
NODE_137268_length_325_cov_2.880531	125	205	5	1	80	0.0125000
NODE_137268_length_325_cov_2.880531	125	205	6	39	80	0.4875000
NODE_137291_length_325_cov_2.707965	203	261	0	58	58	1.0000000
NODE_137296_length_325_cov_2.703540	68	148	2	35	80	0.4375000
NODE_137296_length_325_cov_2.703540	68	148	3	4	80	0.0500000
NODE_137296_length_325_cov_2.703540	68	148	4	41	80	0.5125000
NODE_137330_length_325_cov_2.500000	0	42	0	42	42	1.0000000
NODE_137407_length_325_cov_2.048673	122	202	10	10	80	0.1250000
NODE_137407_length_325_cov_2.048673	122	202	11	2	80	0.0250000
NODE_137407_length_325_cov_2.048673	122	202	12	30	80	0.3750000
NODE_137407_length_325_cov_2.048673	122	202	14	14	80	0.1750000
NODE_137407_length_325_cov_2.048673	122	202	16	9	80	0.1125000
NODE_137407_length_325_cov_2.048673	122	202	18	15	80	0.1875000
NODE_137409_length_325_cov_2.035398	83	154	5	30	71	0.4225352
NODE_137409_length_325_cov_2.035398	83	154	6	1	71	0.0140845
NODE_137409_length_325_cov_2.035398	83	154	7	1	71	0.0140845
NODE_137409_length_325_cov_2.035398	83	154	10	39	71	0.5492958
NODE_137642_length_325_cov_1.464602	153	224	0	71	71	1.0000000
NODE_137939_length_325_cov_1.017699	103	134	4	31	31	1.0000000
NODE_138113_length_325_cov_0.827434	258	308	0	50	50	1.0000000
NODE_138309_length_324_cov_4.737778	113	160	0	47	47	1.0000000
NODE_138309_length_324_cov_4.737778	142	213	0	71	71	1.0000000
NODE_138358_length_324_cov_3.626667	218	273	0	55	55	1.0000000
NODE_138396_length_324_cov_3.124444	101	181	0	80	80	1.0000000
NODE_138396_length_324_cov_3.124444	256	285	0	29	29	1.0000000
NODE_138416_length_324_cov_2.924444	114	198	0	84	84	1.0000000
NODE_138416_length_324_cov_2.924444	178	237	0	20	59	0.3389831
NODE_138416_length_324_cov_2.924444	178	237	2	39	59	0.6610169
NODE_138418_length_324_cov_2.915556	141	221	0	80	80	1.0000000
NODE_138434_length_324_cov_2.715556	4	51	2	47	47	1.0000000
NODE_138434_length_324_cov_2.715556	24	104	0	9	80	0.1125000
NODE_138434_length_324_cov_2.715556	24	104	2	71	80	0.8875000
NODE_138463_length_324_cov_2.506667	270	306	0	36	36	1.0000000
NODE_138483_length_324_cov_2.448889	187	238	1	15	51	0.2941177
NODE_138483_length_324_cov_2.448889	187	238	3	7	51	0.1372549
NODE_138483_length_324_cov_2.448889	187	238	5	29	51	0.5686275
NODE_138527_length_324_cov_2.248889	30	96	0	1	66	0.0151515
NODE_138527_length_324_cov_2.248889	30	96	2	65	66	0.9848485
NODE_138778_length_324_cov_1.502222	10	90	0	55	80	0.6875000
NODE_138778_length_324_cov_1.502222	10	90	1	1	80	0.0125000
NODE_138778_length_324_cov_1.502222	10	90	2	24	80	0.3000000
NODE_138792_length_324_cov_1.457778	0	45	0	45	45	1.0000000
NODE_138792_length_324_cov_1.457778	18	75	0	50	57	0.8771930
NODE_138792_length_324_cov_1.457778	18	75	2	2	57	0.0350877
NODE_138792_length_324_cov_1.457778	18	75	4	4	57	0.0701754
NODE_138792_length_324_cov_1.457778	18	75	10	1	57	0.0175439
NODE_138808_length_324_cov_1.382222	263	304	0	41	41	1.0000000
NODE_139129_length_324_cov_1.017778	0	59	0	59	59	1.0000000
NODE_139497_length_323_cov_6.669643	215	286	2	19	71	0.2676056
NODE_139497_length_323_cov_6.669643	215	286	6	52	71	0.7323943
NODE_139497_length_323_cov_6.669643	268	315	0	29	47	0.6170213
NODE_139497_length_323_cov_6.669643	268	315	2	18	47	0.3829787
NODE_139511_length_323_cov_5.089286	224	290	0	66	66	1.0000000
NODE_139511_length_323_cov_5.089286	263	319	0	56	56	1.0000000
NODE_139572_length_323_cov_3.276786	189	269	0	27	80	0.3375000
NODE_139572_length_323_cov_3.276786	189	269	1	41	80	0.5125000
NODE_139572_length_323_cov_3.276786	189	269	2	1	80	0.0125000
NODE_139572_length_323_cov_3.276786	189	269	3	1	80	0.0125000
NODE_139572_length_323_cov_3.276786	189	269	4	3	80	0.0375000
NODE_139572_length_323_cov_3.276786	189	269	5	6	80	0.0750000
NODE_139572_length_323_cov_3.276786	189	269	6	1	80	0.0125000
NODE_139575_length_323_cov_3.263393	101	181	0	6	80	0.0750000
NODE_139575_length_323_cov_3.263393	101	181	2	14	80	0.1750000
NODE_139575_length_323_cov_3.263393	101	181	4	60	80	0.7500000
NODE_139591_length_323_cov_3.089286	128	208	1	2	80	0.0250000
NODE_139591_length_323_cov_3.089286	128	208	2	21	80	0.2625000
NODE_139591_length_323_cov_3.089286	128	208	4	57	80	0.7125000
NODE_139591_length_323_cov_3.089286	166	208	1	2	42	0.0476190
NODE_139591_length_323_cov_3.089286	166	208	2	21	42	0.5000000
NODE_139591_length_323_cov_3.089286	166	208	4	19	42	0.4523810
NODE_139591_length_323_cov_3.089286	181	261	0	47	80	0.5875000
NODE_139591_length_323_cov_3.089286	181	261	1	8	80	0.1000000
NODE_139591_length_323_cov_3.089286	181	261	2	21	80	0.2625000
NODE_139591_length_323_cov_3.089286	181	261	4	4	80	0.0500000
NODE_139591_length_323_cov_3.089286	181	261	0	47	80	0.5875000
NODE_139591_length_323_cov_3.089286	181	261	1	8	80	0.1000000
NODE_139591_length_323_cov_3.089286	181	261	2	21	80	0.2625000
NODE_139591_length_323_cov_3.089286	181	261	4	4	80	0.0500000
NODE_139629_length_323_cov_2.683036	144	215	2	3	71	0.0422535
NODE_139629_length_323_cov_2.683036	144	215	4	5	71	0.0704225
NODE_139629_length_323_cov_2.683036	144	215	6	63	71	0.8873239
NODE_139746_length_323_cov_2.089286	64	144	0	1	80	0.0125000
NODE_139746_length_323_cov_2.089286	64	144	7	2	80	0.0250000
NODE_139746_length_323_cov_2.089286	64	144	8	77	80	0.9625000
NODE_139797_length_323_cov_1.888393	148	207	2	9	59	0.1525424
NODE_139797_length_323_cov_1.888393	148	207	5	2	59	0.0338983
NODE_139797_length_323_cov_1.888393	148	207	8	2	59	0.0338983
NODE_139797_length_323_cov_1.888393	148	207	10	2	59	0.0338983
NODE_139797_length_323_cov_1.888393	148	207	12	44	59	0.7457627
NODE_139901_length_323_cov_1.705357	195	262	0	67	67	1.0000000
NODE_139901_length_323_cov_1.705357	235	315	0	80	80	1.0000000
NODE_140651_length_322_cov_5.475336	56	136	0	80	80	1.0000000
NODE_140651_length_322_cov_5.475336	113	189	0	76	76	1.0000000
NODE_140692_length_322_cov_3.753363	63	133	0	70	70	1.0000000
NODE_140692_length_322_cov_3.753363	116	190	0	74	74	1.0000000
NODE_140693_length_322_cov_3.735426	60	86	0	26	26	1.0000000
NODE_140693_length_322_cov_3.735426	99	139	0	40	40	1.0000000
NODE_140701_length_322_cov_3.605381	73	116	17	17	43	0.3953488
NODE_140701_length_322_cov_3.605381	73	116	18	10	43	0.2325581
NODE_140701_length_322_cov_3.605381	73	116	24	4	43	0.0930233
NODE_140701_length_322_cov_3.605381	73	116	26	4	43	0.0930233
NODE_140701_length_322_cov_3.605381	73	116	28	8	43	0.1860465
NODE_140702_length_322_cov_3.600897	75	145	0	70	70	1.0000000
NODE_140820_length_322_cov_2.304933	182	213	0	31	31	1.0000000
NODE_141738_length_321_cov_8.527027	176	240	2	26	64	0.4062500
NODE_141738_length_321_cov_8.527027	176	240	6	38	64	0.5937500
NODE_141786_length_321_cov_4.094595	196	266	0	70	70	1.0000000
NODE_141811_length_321_cov_3.563063	59	131	2	72	72	1.0000000
NODE_141811_length_321_cov_3.563063	112	183	0	47	71	0.6619718
NODE_141811_length_321_cov_3.563063	112	183	2	24	71	0.3380282
NODE_141813_length_321_cov_3.540541	112	141	0	8	29	0.2758621
NODE_141813_length_321_cov_3.540541	112	141	2	2	29	0.0689655
NODE_141813_length_321_cov_3.540541	112	141	4	5	29	0.1724138
NODE_141813_length_321_cov_3.540541	112	141	8	14	29	0.4827586
NODE_141833_length_321_cov_3.049550	65	115	14	5	50	0.1000000
NODE_141833_length_321_cov_3.049550	65	115	16	35	50	0.7000000
NODE_141833_length_321_cov_3.049550	65	115	18	10	50	0.2000000
NODE_141833_length_321_cov_3.049550	95	138	16	39	43	0.9069768
NODE_141833_length_321_cov_3.049550	95	138	18	4	43	0.0930233
NODE_141833_length_321_cov_3.049550	118	168	2	6	50	0.1200000
NODE_141833_length_321_cov_3.049550	118	168	4	1	50	0.0200000
NODE_141833_length_321_cov_3.049550	118	168	8	9	50	0.1800000
NODE_141833_length_321_cov_3.049550	118	168	12	14	50	0.2800000
NODE_141833_length_321_cov_3.049550	118	168	16	20	50	0.4000000
NODE_141837_length_321_cov_2.995495	146	220	0	31	74	0.4189189
NODE_141837_length_321_cov_2.995495	146	220	2	43	74	0.5810811
NODE_141842_length_321_cov_2.981982	251	304	0	7	53	0.1320755
NODE_141842_length_321_cov_2.981982	251	304	1	21	53	0.3962264
NODE_141842_length_321_cov_2.981982	251	304	2	25	53	0.4716981
NODE_141876_length_321_cov_2.734234	239	306	0	67	67	1.0000000
NODE_141910_length_321_cov_2.427928	221	265	0	44	44	1.0000000
NODE_141922_length_321_cov_2.315315	22	65	0	43	43	1.0000000
NODE_141951_length_321_cov_2.270270	43	105	9	10	62	0.1612903
NODE_141951_length_321_cov_2.270270	43	105	12	23	62	0.3709677
NODE_141951_length_321_cov_2.270270	43	105	14	29	62	0.4677419
NODE_141951_length_321_cov_2.270270	120	203	5	36	83	0.4337350
NODE_141951_length_321_cov_2.270270	120	203	8	18	83	0.2168675
NODE_141951_length_321_cov_2.270270	120	203	10	7	83	0.0843373
NODE_141951_length_321_cov_2.270270	120	203	12	9	83	0.1084337
NODE_141951_length_321_cov_2.270270	120	203	14	7	83	0.0843373
NODE_141951_length_321_cov_2.270270	120	203	16	6	83	0.0722892
NODE_141951_length_321_cov_2.270270	127	208	2	4	81	0.0493827
NODE_141951_length_321_cov_2.270270	127	208	5	37	81	0.4567901
NODE_141951_length_321_cov_2.270270	127	208	8	18	81	0.2222222
NODE_141951_length_321_cov_2.270270	127	208	10	7	81	0.0864198
NODE_141951_length_321_cov_2.270270	127	208	12	9	81	0.1111111
NODE_141951_length_321_cov_2.270270	127	208	14	6	81	0.0740741
NODE_142200_length_321_cov_1.576577	241	321	0	80	80	1.0000000
NODE_142363_length_321_cov_1.319820	253	304	0	51	51	1.0000000
NODE_142484_length_321_cov_1.130631	0	43	0	43	43	1.0000000
NODE_142700_length_321_cov_0.869369	248	294	0	46	46	1.0000000
NODE_142885_length_320_cov_200.484163	264	320	6	1	56	0.0178571
NODE_142885_length_320_cov_200.484163	264	320	10	4	56	0.0714286
NODE_142885_length_320_cov_200.484163	264	320	11	1	56	0.0178571
NODE_142885_length_320_cov_200.484163	264	320	13	2	56	0.0357143
NODE_142885_length_320_cov_200.484163	264	320	21	5	56	0.0892857
NODE_142885_length_320_cov_200.484163	264	320	23	1	56	0.0178571
NODE_142885_length_320_cov_200.484163	264	320	26	1	56	0.0178571
NODE_142885_length_320_cov_200.484163	264	320	28	2	56	0.0357143
NODE_142885_length_320_cov_200.484163	264	320	30	1	56	0.0178571
NODE_142885_length_320_cov_200.484163	264	320	32	3	56	0.0535714
NODE_142885_length_320_cov_200.484163	264	320	34	2	56	0.0357143
NODE_142885_length_320_cov_200.484163	264	320	37	3	56	0.0535714
NODE_142885_length_320_cov_200.484163	264	320	38	5	56	0.0892857
NODE_142885_length_320_cov_200.484163	264	320	40	2	56	0.0357143
NODE_142885_length_320_cov_200.484163	264	320	44	1	56	0.0178571
NODE_142885_length_320_cov_200.484163	264	320	46	4	56	0.0714286
NODE_142885_length_320_cov_200.484163	264	320	47	10	56	0.1785714
NODE_142885_length_320_cov_200.484163	264	320	49	4	56	0.0714286
NODE_142885_length_320_cov_200.484163	264	320	52	1	56	0.0178571
NODE_142885_length_320_cov_200.484163	264	320	53	3	56	0.0535714
NODE_142886_length_320_cov_73.357466	51	97	0	46	46	1.0000000
NODE_142886_length_320_cov_73.357466	108	154	0	46	46	1.0000000
NODE_142886_length_320_cov_73.357466	165	245	0	80	80	1.0000000
NODE_142886_length_320_cov_73.357466	218	296	0	78	78	1.0000000
NODE_142887_length_320_cov_35.787330	212	292	28	3	80	0.0375000
NODE_142887_length_320_cov_35.787330	212	292	32	11	80	0.1375000
NODE_142887_length_320_cov_35.787330	212	292	33	2	80	0.0250000
NODE_142887_length_320_cov_35.787330	212	292	34	11	80	0.1375000
NODE_142887_length_320_cov_35.787330	212	292	36	53	80	0.6625000
NODE_142887_length_320_cov_35.787330	212	292	28	3	80	0.0375000
NODE_142887_length_320_cov_35.787330	212	292	32	11	80	0.1375000
NODE_142887_length_320_cov_35.787330	212	292	33	2	80	0.0250000
NODE_142887_length_320_cov_35.787330	212	292	34	11	80	0.1375000
NODE_142887_length_320_cov_35.787330	212	292	36	53	80	0.6625000
NODE_142887_length_320_cov_35.787330	212	292	28	3	80	0.0375000
NODE_142887_length_320_cov_35.787330	212	292	32	11	80	0.1375000
NODE_142887_length_320_cov_35.787330	212	292	33	2	80	0.0250000
NODE_142887_length_320_cov_35.787330	212	292	34	11	80	0.1375000
NODE_142887_length_320_cov_35.787330	212	292	36	53	80	0.6625000
NODE_142887_length_320_cov_35.787330	212	292	28	3	80	0.0375000
NODE_142887_length_320_cov_35.787330	212	292	32	11	80	0.1375000
NODE_142887_length_320_cov_35.787330	212	292	33	2	80	0.0250000
NODE_142887_length_320_cov_35.787330	212	292	34	11	80	0.1375000
NODE_142887_length_320_cov_35.787330	212	292	36	53	80	0.6625000
NODE_142887_length_320_cov_35.787330	212	292	28	3	80	0.0375000
NODE_142887_length_320_cov_35.787330	212	292	32	11	80	0.1375000
NODE_142887_length_320_cov_35.787330	212	292	33	2	80	0.0250000
NODE_142887_length_320_cov_35.787330	212	292	34	11	80	0.1375000
NODE_142887_length_320_cov_35.787330	212	292	36	53	80	0.6625000
NODE_142887_length_320_cov_35.787330	265	314	19	1	49	0.0204082
NODE_142887_length_320_cov_35.787330	265	314	32	32	49	0.6530612
NODE_142887_length_320_cov_35.787330	265	314	33	2	49	0.0408163
NODE_142887_length_320_cov_35.787330	265	314	34	11	49	0.2244898
NODE_142887_length_320_cov_35.787330	265	314	36	3	49	0.0612245
NODE_142887_length_320_cov_35.787330	265	320	4	6	55	0.1090909
NODE_142887_length_320_cov_35.787330	265	320	19	1	55	0.0181818
NODE_142887_length_320_cov_35.787330	265	320	32	32	55	0.5818182
NODE_142887_length_320_cov_35.787330	265	320	33	2	55	0.0363636
NODE_142887_length_320_cov_35.787330	265	320	34	11	55	0.2000000
NODE_142887_length_320_cov_35.787330	265	320	36	3	55	0.0545455
NODE_142887_length_320_cov_35.787330	265	320	4	6	55	0.1090909
NODE_142887_length_320_cov_35.787330	265	320	19	1	55	0.0181818
NODE_142887_length_320_cov_35.787330	265	320	32	32	55	0.5818182
NODE_142887_length_320_cov_35.787330	265	320	33	2	55	0.0363636
NODE_142887_length_320_cov_35.787330	265	320	34	11	55	0.2000000
NODE_142887_length_320_cov_35.787330	265	320	36	3	55	0.0545455
NODE_142887_length_320_cov_35.787330	268	320	4	6	52	0.1153846
NODE_142887_length_320_cov_35.787330	268	320	19	1	52	0.0192308
NODE_142887_length_320_cov_35.787330	268	320	32	32	52	0.6153846
NODE_142887_length_320_cov_35.787330	268	320	33	2	52	0.0384615
NODE_142887_length_320_cov_35.787330	268	320	34	11	52	0.2115385
NODE_142887_length_320_cov_35.787330	270	320	4	6	50	0.1200000
NODE_142887_length_320_cov_35.787330	270	320	19	1	50	0.0200000
NODE_142887_length_320_cov_35.787330	270	320	32	32	50	0.6400000
NODE_142887_length_320_cov_35.787330	270	320	33	2	50	0.0400000
NODE_142887_length_320_cov_35.787330	270	320	34	9	50	0.1800000
NODE_142900_length_320_cov_5.841629	115	172	0	7	57	0.1228070
NODE_142900_length_320_cov_5.841629	115	172	2	50	57	0.8771930
NODE_142900_length_320_cov_5.841629	168	225	2	57	57	1.0000000
NODE_142934_length_320_cov_4.153846	134	200	0	66	66	1.0000000
NODE_142958_length_320_cov_3.733032	5	40	0	35	35	1.0000000
NODE_142985_length_320_cov_3.402715	142	222	0	18	80	0.2250000
NODE_142985_length_320_cov_3.402715	142	222	4	62	80	0.7750000
NODE_143076_length_320_cov_2.475113	120	187	0	12	67	0.1791045
NODE_143076_length_320_cov_2.475113	120	187	1	1	67	0.0149254
NODE_143076_length_320_cov_2.475113	120	187	2	18	67	0.2686567
NODE_143076_length_320_cov_2.475113	120	187	6	10	67	0.1492537
NODE_143076_length_320_cov_2.475113	120	187	14	16	67	0.2388060
NODE_143076_length_320_cov_2.475113	120	187	16	3	67	0.0447761
NODE_143076_length_320_cov_2.475113	120	187	18	4	67	0.0597015
NODE_143076_length_320_cov_2.475113	120	187	20	1	67	0.0149254
NODE_143076_length_320_cov_2.475113	120	187	24	2	67	0.0298507
NODE_143142_length_320_cov_2.171946	16	96	0	3	80	0.0375000
NODE_143142_length_320_cov_2.171946	16	96	2	4	80	0.0500000
NODE_143142_length_320_cov_2.171946	16	96	3	4	80	0.0500000
NODE_143142_length_320_cov_2.171946	16	96	5	17	80	0.2125000
NODE_143142_length_320_cov_2.171946	16	96	7	44	80	0.5500000
NODE_143142_length_320_cov_2.171946	16	96	10	1	80	0.0125000
NODE_143142_length_320_cov_2.171946	16	96	11	4	80	0.0500000
NODE_143142_length_320_cov_2.171946	16	96	13	3	80	0.0375000
NODE_143142_length_320_cov_2.171946	69	149	7	19	80	0.2375000
NODE_143142_length_320_cov_2.171946	69	149	10	1	80	0.0125000
NODE_143142_length_320_cov_2.171946	69	149	11	4	80	0.0500000
NODE_143142_length_320_cov_2.171946	69	149	13	56	80	0.7000000
NODE_143207_length_320_cov_1.900452	37	117	11	3	80	0.0375000
NODE_143207_length_320_cov_1.900452	37	117	12	6	80	0.0750000
NODE_143207_length_320_cov_1.900452	37	117	13	5	80	0.0625000
NODE_143207_length_320_cov_1.900452	37	117	15	1	80	0.0125000
NODE_143207_length_320_cov_1.900452	37	117	17	7	80	0.0875000
NODE_143207_length_320_cov_1.900452	37	117	18	58	80	0.7250000
NODE_143207_length_320_cov_1.900452	90	164	0	21	74	0.2837838
NODE_143207_length_320_cov_1.900452	90	164	2	10	74	0.1351351
NODE_143207_length_320_cov_1.900452	90	164	4	9	74	0.1216216
NODE_143207_length_320_cov_1.900452	90	164	18	34	74	0.4594595
NODE_143230_length_320_cov_1.846154	188	220	0	32	32	1.0000000
NODE_143309_length_320_cov_1.665158	144	198	2	6	54	0.1111111
NODE_143309_length_320_cov_1.665158	144	198	4	48	54	0.8888889
NODE_143309_length_320_cov_1.665158	198	251	2	15	53	0.2830189
NODE_143309_length_320_cov_1.665158	198	251	4	38	53	0.7169811
NODE_143351_length_320_cov_1.601810	157	181	6	24	24	1.0000000
NODE_143351_length_320_cov_1.601810	231	290	0	59	59	1.0000000
NODE_143366_length_320_cov_1.556561	0	39	0	8	39	0.2051282
NODE_143366_length_320_cov_1.556561	0	39	4	31	39	0.7948718
NODE_143442_length_320_cov_1.384615	18	98	2	56	80	0.7000000
NODE_143442_length_320_cov_1.384615	18	98	4	4	80	0.0500000
NODE_143442_length_320_cov_1.384615	18	98	7	11	80	0.1375000
NODE_143442_length_320_cov_1.384615	18	98	9	9	80	0.1125000
NODE_143442_length_320_cov_1.384615	71	145	2	3	74	0.0405405
NODE_143442_length_320_cov_1.384615	71	145	4	4	74	0.0540541
NODE_143442_length_320_cov_1.384615	71	145	7	11	74	0.1486486
NODE_143442_length_320_cov_1.384615	71	145	9	44	74	0.5945946
NODE_143442_length_320_cov_1.384615	71	145	10	1	74	0.0135135
NODE_143442_length_320_cov_1.384615	71	145	15	2	74	0.0270270
NODE_143442_length_320_cov_1.384615	71	145	17	9	74	0.1216216
NODE_143521_length_320_cov_1.312217	117	170	0	25	53	0.4716981
NODE_143521_length_320_cov_1.312217	117	170	2	28	53	0.5283019
NODE_143670_length_320_cov_1.117647	58	109	0	4	51	0.0784314
NODE_143670_length_320_cov_1.117647	58	109	2	47	51	0.9215686
NODE_144091_length_319_cov_5.940909	122	202	0	35	80	0.4375000
NODE_144091_length_319_cov_5.940909	122	202	2	10	80	0.1250000
NODE_144091_length_319_cov_5.940909	122	202	3	4	80	0.0500000
NODE_144091_length_319_cov_5.940909	122	202	4	31	80	0.3875000
NODE_144107_length_319_cov_4.700000	16	47	0	31	31	1.0000000
NODE_144137_length_319_cov_4.068182	5	36	0	31	31	1.0000000
NODE_144162_length_319_cov_3.568182	149	229	12	1	80	0.0125000
NODE_144162_length_319_cov_3.568182	149	229	13	7	80	0.0875000
NODE_144162_length_319_cov_3.568182	149	229	15	12	80	0.1500000
NODE_144162_length_319_cov_3.568182	149	229	16	3	80	0.0375000
NODE_144162_length_319_cov_3.568182	149	229	17	6	80	0.0750000
NODE_144162_length_319_cov_3.568182	149	229	18	51	80	0.6375000
NODE_144206_length_319_cov_3.036364	112	174	2	4	62	0.0645161
NODE_144206_length_319_cov_3.036364	112	174	4	13	62	0.2096774
NODE_144206_length_319_cov_3.036364	112	174	6	45	62	0.7258065
NODE_144226_length_319_cov_2.800000	25	106	4	3	81	0.0370370
NODE_144226_length_319_cov_2.800000	25	106	6	3	81	0.0370370
NODE_144226_length_319_cov_2.800000	25	106	19	1	81	0.0123457
NODE_144226_length_319_cov_2.800000	25	106	33	1	81	0.0123457
NODE_144226_length_319_cov_2.800000	25	106	39	1	81	0.0123457
NODE_144226_length_319_cov_2.800000	25	106	48	1	81	0.0123457
NODE_144226_length_319_cov_2.800000	25	106	52	4	81	0.0493827
NODE_144226_length_319_cov_2.800000	25	106	59	2	81	0.0246914
NODE_144226_length_319_cov_2.800000	25	106	60	4	81	0.0493827
NODE_144226_length_319_cov_2.800000	25	106	61	2	81	0.0246914
NODE_144226_length_319_cov_2.800000	25	106	63	3	81	0.0370370
NODE_144226_length_319_cov_2.800000	25	106	89	1	81	0.0123457
NODE_144226_length_319_cov_2.800000	25	106	99	1	81	0.0123457
NODE_144226_length_319_cov_2.800000	25	106	100	1	81	0.0123457
NODE_144226_length_319_cov_2.800000	25	106	101	1	81	0.0123457
NODE_144226_length_319_cov_2.800000	25	106	109	1	81	0.0123457
NODE_144226_length_319_cov_2.800000	25	106	111	1	81	0.0123457
NODE_144226_length_319_cov_2.800000	25	106	115	4	81	0.0493827
NODE_144226_length_319_cov_2.800000	25	106	121	2	81	0.0246914
NODE_144226_length_319_cov_2.800000	25	106	122	2	81	0.0246914
NODE_144226_length_319_cov_2.800000	25	106	124	1	81	0.0123457
NODE_144226_length_319_cov_2.800000	25	106	126	4	81	0.0493827
NODE_144226_length_319_cov_2.800000	25	106	129	1	81	0.0123457
NODE_144226_length_319_cov_2.800000	25	106	130	3	81	0.0370370
NODE_144226_length_319_cov_2.800000	25	106	132	1	81	0.0123457
NODE_144226_length_319_cov_2.800000	25	106	136	1	81	0.0123457
NODE_144226_length_319_cov_2.800000	25	106	138	5	81	0.0617284
NODE_144226_length_319_cov_2.800000	25	106	143	3	81	0.0370370
NODE_144226_length_319_cov_2.800000	25	106	157	2	81	0.0246914
NODE_144226_length_319_cov_2.800000	25	106	171	2	81	0.0246914
NODE_144226_length_319_cov_2.800000	25	106	189	3	81	0.0370370
NODE_144226_length_319_cov_2.800000	25	106	191	1	81	0.0123457
NODE_144226_length_319_cov_2.800000	25	106	201	1	81	0.0123457
NODE_144226_length_319_cov_2.800000	25	106	204	2	81	0.0246914
NODE_144226_length_319_cov_2.800000	25	106	214	8	81	0.0987654
NODE_144226_length_319_cov_2.800000	25	106	215	1	81	0.0123457
NODE_144226_length_319_cov_2.800000	25	106	216	3	81	0.0370370
NODE_144226_length_319_cov_2.800000	79	158	138	1	79	0.0126582
NODE_144226_length_319_cov_2.800000	79	158	143	3	79	0.0379747
NODE_144226_length_319_cov_2.800000	79	158	157	2	79	0.0253165
NODE_144226_length_319_cov_2.800000	79	158	171	2	79	0.0253165
NODE_144226_length_319_cov_2.800000	79	158	189	3	79	0.0379747
NODE_144226_length_319_cov_2.800000	79	158	190	2	79	0.0253165
NODE_144226_length_319_cov_2.800000	79	158	191	1	79	0.0126582
NODE_144226_length_319_cov_2.800000	79	158	193	3	79	0.0379747
NODE_144226_length_319_cov_2.800000	79	158	195	8	79	0.1012658
NODE_144226_length_319_cov_2.800000	79	158	197	1	79	0.0126582
NODE_144226_length_319_cov_2.800000	79	158	199	1	79	0.0126582
NODE_144226_length_319_cov_2.800000	79	158	201	1	79	0.0126582
NODE_144226_length_319_cov_2.800000	79	158	202	1	79	0.0126582
NODE_144226_length_319_cov_2.800000	79	158	204	2	79	0.0253165
NODE_144226_length_319_cov_2.800000	79	158	208	9	79	0.1139240
NODE_144226_length_319_cov_2.800000	79	158	212	5	79	0.0632911
NODE_144226_length_319_cov_2.800000	79	158	214	19	79	0.2405063
NODE_144226_length_319_cov_2.800000	79	158	215	12	79	0.1518987
NODE_144226_length_319_cov_2.800000	79	158	216	3	79	0.0379747
NODE_144237_length_319_cov_2.740909	67	147	0	60	80	0.7500000
NODE_144237_length_319_cov_2.740909	67	147	1	20	80	0.2500000
NODE_144252_length_319_cov_2.586364	247	319	0	72	72	1.0000000
NODE_144272_length_319_cov_2.463636	90	153	0	63	63	1.0000000
NODE_144272_length_319_cov_2.463636	163	216	0	53	53	1.0000000
NODE_144316_length_319_cov_2.259091	146	212	0	66	66	1.0000000
NODE_144340_length_319_cov_2.163636	213	275	0	62	62	1.0000000
NODE_144390_length_319_cov_1.968182	120	200	0	80	80	1.0000000
NODE_144616_length_319_cov_1.431818	111	157	4	16	46	0.3478261
NODE_144616_length_319_cov_1.431818	111	157	6	30	46	0.6521739
NODE_144629_length_319_cov_1.395455	129	179	0	50	50	1.0000000
NODE_144788_length_319_cov_1.190909	119	182	0	49	63	0.7777778
NODE_144788_length_319_cov_1.190909	119	182	2	4	63	0.0634921
NODE_144788_length_319_cov_1.190909	119	182	4	10	63	0.1587302
NODE_144788_length_319_cov_1.190909	197	232	0	35	35	1.0000000
NODE_145289_length_318_cov_232.639269	169	198	240	2	29	0.0689655
NODE_145289_length_318_cov_232.639269	169	198	242	1	29	0.0344828
NODE_145289_length_318_cov_232.639269	169	198	244	1	29	0.0344828
NODE_145289_length_318_cov_232.639269	169	198	246	2	29	0.0689655
NODE_145289_length_318_cov_232.639269	169	198	248	1	29	0.0344828
NODE_145289_length_318_cov_232.639269	169	198	250	3	29	0.1034483
NODE_145289_length_318_cov_232.639269	169	198	253	2	29	0.0689655
NODE_145289_length_318_cov_232.639269	169	198	254	1	29	0.0344828
NODE_145289_length_318_cov_232.639269	169	198	257	2	29	0.0689655
NODE_145289_length_318_cov_232.639269	169	198	259	1	29	0.0344828
NODE_145289_length_318_cov_232.639269	169	198	261	4	29	0.1379310
NODE_145289_length_318_cov_232.639269	169	198	263	1	29	0.0344828
NODE_145289_length_318_cov_232.639269	169	198	264	4	29	0.1379310
NODE_145289_length_318_cov_232.639269	169	198	265	4	29	0.1379310
NODE_145289_length_318_cov_232.639269	171	246	199	2	75	0.0266667
NODE_145289_length_318_cov_232.639269	171	246	204	2	75	0.0266667
NODE_145289_length_318_cov_232.639269	171	246	214	1	75	0.0133333
NODE_145289_length_318_cov_232.639269	171	246	220	3	75	0.0400000
NODE_145289_length_318_cov_232.639269	171	246	221	2	75	0.0266667
NODE_145289_length_318_cov_232.639269	171	246	224	1	75	0.0133333
NODE_145289_length_318_cov_232.639269	171	246	230	1	75	0.0133333
NODE_145289_length_318_cov_232.639269	171	246	232	1	75	0.0133333
NODE_145289_length_318_cov_232.639269	171	246	235	1	75	0.0133333
NODE_145289_length_318_cov_232.639269	171	246	236	1	75	0.0133333
NODE_145289_length_318_cov_232.639269	171	246	239	2	75	0.0266667
NODE_145289_length_318_cov_232.639269	171	246	242	1	75	0.0133333
NODE_145289_length_318_cov_232.639269	171	246	243	1	75	0.0133333
NODE_145289_length_318_cov_232.639269	171	246	244	1	75	0.0133333
NODE_145289_length_318_cov_232.639269	171	246	246	3	75	0.0400000
NODE_145289_length_318_cov_232.639269	171	246	248	1	75	0.0133333
NODE_145289_length_318_cov_232.639269	171	246	250	3	75	0.0400000
NODE_145289_length_318_cov_232.639269	171	246	253	3	75	0.0400000
NODE_145289_length_318_cov_232.639269	171	246	254	1	75	0.0133333
NODE_145289_length_318_cov_232.639269	171	246	257	2	75	0.0266667
NODE_145289_length_318_cov_232.639269	171	246	259	3	75	0.0400000
NODE_145289_length_318_cov_232.639269	171	246	261	4	75	0.0533333
NODE_145289_length_318_cov_232.639269	171	246	263	2	75	0.0266667
NODE_145289_length_318_cov_232.639269	171	246	264	11	75	0.1466667
NODE_145289_length_318_cov_232.639269	171	246	265	8	75	0.1066667
NODE_145289_length_318_cov_232.639269	171	246	266	5	75	0.0666667
NODE_145289_length_318_cov_232.639269	171	246	267	1	75	0.0133333
NODE_145289_length_318_cov_232.639269	171	246	269	1	75	0.0133333
NODE_145289_length_318_cov_232.639269	171	246	270	4	75	0.0533333
NODE_145289_length_318_cov_232.639269	171	246	272	3	75	0.0400000
NODE_145333_length_318_cov_4.237443	222	294	2	19	72	0.2638889
NODE_145333_length_318_cov_4.237443	222	294	6	53	72	0.7361111
NODE_145348_length_318_cov_3.721461	98	148	0	50	50	1.0000000
NODE_145362_length_318_cov_3.515982	60	129	0	69	69	1.0000000
NODE_145362_length_318_cov_3.515982	60	140	0	80	80	1.0000000
NODE_145362_length_318_cov_3.515982	60	140	0	80	80	1.0000000
NODE_145362_length_318_cov_3.515982	113	153	0	40	40	1.0000000
NODE_145362_length_318_cov_3.515982	122	153	0	31	31	1.0000000
NODE_145465_length_318_cov_2.557078	205	247	2	5	42	0.1190476
NODE_145465_length_318_cov_2.557078	205	247	4	37	42	0.8809524
NODE_145551_length_318_cov_2.109589	70	150	0	68	80	0.8500000
NODE_145551_length_318_cov_2.109589	70	150	4	7	80	0.0875000
NODE_145551_length_318_cov_2.109589	70	150	5	3	80	0.0375000
NODE_145551_length_318_cov_2.109589	70	150	6	2	80	0.0250000
NODE_145619_length_318_cov_1.945205	229	286	0	57	57	1.0000000
NODE_145709_length_318_cov_1.739726	242	308	0	66	66	1.0000000
NODE_145725_length_318_cov_1.684932	49	80	0	31	31	1.0000000
NODE_145787_length_318_cov_1.561644	99	158	0	23	59	0.3898305
NODE_145787_length_318_cov_1.561644	99	158	2	11	59	0.1864407
NODE_145787_length_318_cov_1.561644	99	158	3	24	59	0.4067796
NODE_145787_length_318_cov_1.561644	99	158	5	1	59	0.0169492
NODE_145807_length_318_cov_1.493151	151	195	0	29	44	0.6590909
NODE_145807_length_318_cov_1.493151	151	195	4	15	44	0.3409091
NODE_145807_length_318_cov_1.493151	199	258	4	59	59	1.0000000
NODE_145968_length_318_cov_1.301370	91	141	0	50	50	1.0000000
NODE_146017_length_318_cov_1.173516	83	150	2	67	67	1.0000000
NODE_146065_length_318_cov_1.127854	24	51	0	27	27	1.0000000
NODE_146065_length_318_cov_1.127854	24	60	0	36	36	1.0000000
NODE_146467_length_317_cov_55.467890	172	243	37	2	71	0.0281690
NODE_146467_length_317_cov_55.467890	172	243	43	2	71	0.0281690
NODE_146467_length_317_cov_55.467890	172	243	44	1	71	0.0140845
NODE_146467_length_317_cov_55.467890	172	243	45	12	71	0.1690141
NODE_146467_length_317_cov_55.467890	172	243	47	1	71	0.0140845
NODE_146467_length_317_cov_55.467890	172	243	51	13	71	0.1830986
NODE_146467_length_317_cov_55.467890	172	243	52	1	71	0.0140845
NODE_146467_length_317_cov_55.467890	172	243	57	1	71	0.0140845
NODE_146467_length_317_cov_55.467890	172	243	60	1	71	0.0140845
NODE_146467_length_317_cov_55.467890	172	243	63	1	71	0.0140845
NODE_146467_length_317_cov_55.467890	172	243	64	3	71	0.0422535
NODE_146467_length_317_cov_55.467890	172	243	67	1	71	0.0140845
NODE_146467_length_317_cov_55.467890	172	243	71	29	71	0.4084507
NODE_146467_length_317_cov_55.467890	172	243	73	3	71	0.0422535
NODE_146487_length_317_cov_5.252294	247	307	0	60	60	1.0000000
NODE_146503_length_317_cov_4.467890	105	185	0	21	80	0.2625000
NODE_146503_length_317_cov_4.467890	105	185	2	59	80	0.7375000
NODE_146503_length_317_cov_4.467890	113	193	0	13	80	0.1625000
NODE_146503_length_317_cov_4.467890	113	193	2	67	80	0.8375000
NODE_146554_length_317_cov_3.298165	146	206	7	2	60	0.0333333
NODE_146554_length_317_cov_3.298165	146	206	8	5	60	0.0833333
NODE_146554_length_317_cov_3.298165	146	206	9	25	60	0.4166667
NODE_146554_length_317_cov_3.298165	146	206	14	18	60	0.3000000
NODE_146554_length_317_cov_3.298165	146	206	15	10	60	0.1666667
NODE_146562_length_317_cov_3.266055	111	191	0	35	80	0.4375000
NODE_146562_length_317_cov_3.266055	111	191	2	45	80	0.5625000
NODE_146562_length_317_cov_3.266055	164	244	0	80	80	1.0000000
NODE_146585_length_317_cov_3.036697	3	79	0	76	76	1.0000000
NODE_146601_length_317_cov_2.825688	14	94	0	58	80	0.7250000
NODE_146601_length_317_cov_2.825688	14	94	2	22	80	0.2750000
NODE_146601_length_317_cov_2.825688	67	147	0	5	80	0.0625000
NODE_146601_length_317_cov_2.825688	67	147	2	25	80	0.3125000
NODE_146601_length_317_cov_2.825688	67	147	4	50	80	0.6250000
NODE_146602_length_317_cov_2.821101	142	208	0	10	66	0.1515152
NODE_146602_length_317_cov_2.821101	142	208	2	56	66	0.8484849
NODE_146604_length_317_cov_2.816514	121	201	0	80	80	1.0000000
NODE_146612_length_317_cov_2.779817	67	138	4	71	71	1.0000000
NODE_147046_length_317_cov_1.353211	166	239	2	9	73	0.1232877
NODE_147046_length_317_cov_1.353211	166	239	4	19	73	0.2602740
NODE_147046_length_317_cov_1.353211	166	239	6	45	73	0.6164383
NODE_147046_length_317_cov_1.353211	212	292	0	19	80	0.2375000
NODE_147046_length_317_cov_1.353211	212	292	2	5	80	0.0625000
NODE_147046_length_317_cov_1.353211	212	292	6	56	80	0.7000000
NODE_147172_length_317_cov_1.160550	58	117	2	45	59	0.7627119
NODE_147172_length_317_cov_1.160550	58	117	4	7	59	0.1186441
NODE_147172_length_317_cov_1.160550	58	117	6	7	59	0.1186441
NODE_147172_length_317_cov_1.160550	90	170	2	13	80	0.1625000
NODE_147172_length_317_cov_1.160550	90	170	4	13	80	0.1625000
NODE_147172_length_317_cov_1.160550	90	170	6	51	80	0.6375000
NODE_147172_length_317_cov_1.160550	90	170	8	3	80	0.0375000
NODE_147187_length_317_cov_1.137615	245	313	0	68	68	1.0000000
NODE_147259_length_317_cov_0.967890	170	211	0	3	41	0.0731707
NODE_147259_length_317_cov_0.967890	170	211	4	38	41	0.9268293
NODE_147373_length_317_cov_0.926606	194	232	2	38	38	1.0000000
NODE_147383_length_317_cov_0.912844	186	244	0	58	58	1.0000000
NODE_147595_length_316_cov_31.502304	96	174	0	20	78	0.2564103
NODE_147595_length_316_cov_31.502304	96	174	2	20	78	0.2564103
NODE_147595_length_316_cov_31.502304	96	174	6	1	78	0.0128205
NODE_147595_length_316_cov_31.502304	96	174	7	4	78	0.0512821
NODE_147595_length_316_cov_31.502304	96	174	11	10	78	0.1282051
NODE_147595_length_316_cov_31.502304	96	174	13	12	78	0.1538462
NODE_147595_length_316_cov_31.502304	96	174	18	11	78	0.1410256
NODE_147595_length_316_cov_31.502304	96	121	0	20	25	0.8000000
NODE_147595_length_316_cov_31.502304	96	121	2	5	25	0.2000000
NODE_147609_length_316_cov_6.179724	225	278	0	53	53	1.0000000
NODE_147623_length_316_cov_5.539171	91	171	4	30	80	0.3750000
NODE_147623_length_316_cov_5.539171	91	171	8	50	80	0.6250000
NODE_147668_length_316_cov_3.732719	128	208	0	80	80	1.0000000
NODE_147668_length_316_cov_3.732719	181	257	0	76	76	1.0000000
NODE_147680_length_316_cov_3.589862	185	247	0	62	62	1.0000000
NODE_147684_length_316_cov_3.520737	101	143	0	42	42	1.0000000
NODE_147702_length_316_cov_3.221198	108	184	0	17	76	0.2236842
NODE_147702_length_316_cov_3.221198	108	184	8	59	76	0.7763158
NODE_147734_length_316_cov_2.824885	274	311	0	37	37	1.0000000
NODE_147736_length_316_cov_2.820276	200	280	0	80	80	1.0000000
NODE_147757_length_316_cov_2.672811	23	80	0	57	57	1.0000000
NODE_147796_length_316_cov_2.456221	104	144	2	40	40	1.0000000
NODE_147985_length_316_cov_1.751152	73	122	0	49	49	1.0000000
NODE_148030_length_316_cov_1.640553	218	300	0	41	82	0.5000000
NODE_148030_length_316_cov_1.640553	218	300	1	41	82	0.5000000
NODE_148042_length_316_cov_1.631336	180	233	0	53	53	1.0000000
NODE_148042_length_316_cov_1.631336	180	215	0	35	35	1.0000000
NODE_148080_length_316_cov_1.520737	194	275	0	81	81	1.0000000
NODE_148080_length_316_cov_1.520737	248	302	0	54	54	1.0000000
NODE_148086_length_316_cov_1.493088	64	144	0	80	80	1.0000000
NODE_148193_length_316_cov_1.377880	22	64	0	42	42	1.0000000
NODE_148204_length_316_cov_1.350230	74	117	0	43	43	1.0000000
NODE_148204_length_316_cov_1.350230	90	140	0	50	50	1.0000000
NODE_148533_length_316_cov_0.940092	104	180	0	28	76	0.3684210
NODE_148533_length_316_cov_0.940092	104	180	2	48	76	0.6315789
NODE_148533_length_316_cov_0.940092	155	234	0	4	79	0.0506329
NODE_148533_length_316_cov_0.940092	155	234	2	75	79	0.9493671
NODE_148693_length_316_cov_0.695853	232	267	0	35	35	1.0000000
NODE_148778_length_315_cov_6.967593	127	191	0	5	64	0.0781250
NODE_148778_length_315_cov_6.967593	127	191	4	59	64	0.9218750
NODE_148786_length_315_cov_6.300926	67	147	0	80	80	1.0000000
NODE_148786_length_315_cov_6.300926	120	200	0	80	80	1.0000000
NODE_148812_length_315_cov_4.449074	125	205	2	10	80	0.1250000
NODE_148812_length_315_cov_4.449074	125	205	4	23	80	0.2875000
NODE_148812_length_315_cov_4.449074	125	205	8	47	80	0.5875000
NODE_148812_length_315_cov_4.449074	178	225	0	4	47	0.0851064
NODE_148812_length_315_cov_4.449074	178	225	2	26	47	0.5531915
NODE_148812_length_315_cov_4.449074	178	225	4	17	47	0.3617021
NODE_148834_length_315_cov_4.009259	0	61	0	61	61	1.0000000
NODE_148834_length_315_cov_4.009259	42	61	0	19	19	1.0000000
NODE_148872_length_315_cov_3.421296	37	120	0	5	83	0.0602410
NODE_148872_length_315_cov_3.421296	37	120	2	2	83	0.0240964
NODE_148872_length_315_cov_3.421296	37	120	3	1	83	0.0120482
NODE_148872_length_315_cov_3.421296	37	120	4	13	83	0.1566265
NODE_148872_length_315_cov_3.421296	37	120	6	62	83	0.7469879
NODE_148915_length_315_cov_2.847222	0	74	0	74	74	1.0000000
NODE_148915_length_315_cov_2.847222	47	127	0	80	80	1.0000000
NODE_148921_length_315_cov_2.833333	186	253	0	2	67	0.0298507
NODE_148921_length_315_cov_2.833333	186	253	2	65	67	0.9701493
NODE_148921_length_315_cov_2.833333	186	253	0	2	67	0.0298507
NODE_148921_length_315_cov_2.833333	186	253	2	65	67	0.9701493
NODE_148991_length_315_cov_2.416667	44	117	12	4	73	0.0547945
NODE_148991_length_315_cov_2.416667	44	117	18	4	73	0.0547945
NODE_148991_length_315_cov_2.416667	44	117	19	1	73	0.0136986
NODE_148991_length_315_cov_2.416667	44	117	20	1	73	0.0136986
NODE_148991_length_315_cov_2.416667	44	117	26	5	73	0.0684932
NODE_148991_length_315_cov_2.416667	44	117	31	1	73	0.0136986
NODE_148991_length_315_cov_2.416667	44	117	35	1	73	0.0136986
NODE_148991_length_315_cov_2.416667	44	117	36	1	73	0.0136986
NODE_148991_length_315_cov_2.416667	44	117	40	1	73	0.0136986
NODE_148991_length_315_cov_2.416667	44	117	44	1	73	0.0136986
NODE_148991_length_315_cov_2.416667	44	117	46	1	73	0.0136986
NODE_148991_length_315_cov_2.416667	44	117	50	1	73	0.0136986
NODE_148991_length_315_cov_2.416667	44	117	66	1	73	0.0136986
NODE_148991_length_315_cov_2.416667	44	117	74	2	73	0.0273973
NODE_148991_length_315_cov_2.416667	44	117	75	1	73	0.0136986
NODE_148991_length_315_cov_2.416667	44	117	77	3	73	0.0410959
NODE_148991_length_315_cov_2.416667	44	117	79	2	73	0.0273973
NODE_148991_length_315_cov_2.416667	44	117	81	1	73	0.0136986
NODE_148991_length_315_cov_2.416667	44	117	87	3	73	0.0410959
NODE_148991_length_315_cov_2.416667	44	117	88	3	73	0.0410959
NODE_148991_length_315_cov_2.416667	44	117	95	1	73	0.0136986
NODE_148991_length_315_cov_2.416667	44	117	101	5	73	0.0684932
NODE_148991_length_315_cov_2.416667	44	117	105	1	73	0.0136986
NODE_148991_length_315_cov_2.416667	44	117	106	2	73	0.0273973
NODE_148991_length_315_cov_2.416667	44	117	121	1	73	0.0136986
NODE_148991_length_315_cov_2.416667	44	117	123	3	73	0.0410959
NODE_148991_length_315_cov_2.416667	44	117	125	1	73	0.0136986
NODE_148991_length_315_cov_2.416667	44	117	129	1	73	0.0136986
NODE_148991_length_315_cov_2.416667	44	117	131	2	73	0.0273973
NODE_148991_length_315_cov_2.416667	44	117	135	1	73	0.0136986
NODE_148991_length_315_cov_2.416667	44	117	136	1	73	0.0136986
NODE_148991_length_315_cov_2.416667	44	117	148	1	73	0.0136986
NODE_148991_length_315_cov_2.416667	44	117	150	13	73	0.1780822
NODE_148991_length_315_cov_2.416667	44	117	153	2	73	0.0273973
NODE_149074_length_315_cov_2.115741	128	193	0	40	65	0.6153846
NODE_149074_length_315_cov_2.115741	128	193	2	25	65	0.3846154
NODE_149095_length_315_cov_2.004630	270	315	0	45	45	1.0000000
NODE_149201_length_315_cov_1.731481	125	202	7	14	77	0.1818182
NODE_149201_length_315_cov_1.731481	125	202	8	26	77	0.3376623
NODE_149201_length_315_cov_1.731481	125	202	9	16	77	0.2077922
NODE_149201_length_315_cov_1.731481	125	202	10	1	77	0.0129870
NODE_149201_length_315_cov_1.731481	125	202	11	19	77	0.2467532
NODE_149201_length_315_cov_1.731481	125	202	12	1	77	0.0129870
NODE_149391_length_315_cov_1.384259	183	233	0	50	50	1.0000000
NODE_149935_length_315_cov_0.430556	125	145	0	20	20	1.0000000
NODE_149943_length_314_cov_108.139535	151	213	82	1	62	0.0161290
NODE_149943_length_314_cov_108.139535	151	213	83	1	62	0.0161290
NODE_149943_length_314_cov_108.139535	151	213	92	3	62	0.0483871
NODE_149943_length_314_cov_108.139535	151	213	93	12	62	0.1935484
NODE_149943_length_314_cov_108.139535	151	213	95	4	62	0.0645161
NODE_149943_length_314_cov_108.139535	151	213	96	2	62	0.0322581
NODE_149943_length_314_cov_108.139535	151	213	97	1	62	0.0161290
NODE_149943_length_314_cov_108.139535	151	213	99	6	62	0.0967742
NODE_149943_length_314_cov_108.139535	151	213	100	6	62	0.0967742
NODE_149943_length_314_cov_108.139535	151	213	101	4	62	0.0645161
NODE_149943_length_314_cov_108.139535	151	213	102	6	62	0.0967742
NODE_149943_length_314_cov_108.139535	151	213	104	3	62	0.0483871
NODE_149943_length_314_cov_108.139535	151	213	105	4	62	0.0645161
NODE_149943_length_314_cov_108.139535	151	213	106	2	62	0.0322581
NODE_149943_length_314_cov_108.139535	151	213	107	2	62	0.0322581
NODE_149943_length_314_cov_108.139535	151	213	108	3	62	0.0483871
NODE_149943_length_314_cov_108.139535	151	213	109	2	62	0.0322581
NODE_149943_length_314_cov_108.139535	160	213	82	1	53	0.0188679
NODE_149943_length_314_cov_108.139535	160	213	83	1	53	0.0188679
NODE_149943_length_314_cov_108.139535	160	213	93	11	53	0.2075472
NODE_149943_length_314_cov_108.139535	160	213	96	2	53	0.0377358
NODE_149943_length_314_cov_108.139535	160	213	99	6	53	0.1132075
NODE_149943_length_314_cov_108.139535	160	213	100	6	53	0.1132075
NODE_149943_length_314_cov_108.139535	160	213	101	4	53	0.0754717
NODE_149943_length_314_cov_108.139535	160	213	102	6	53	0.1132075
NODE_149943_length_314_cov_108.139535	160	213	104	3	53	0.0566038
NODE_149943_length_314_cov_108.139535	160	213	105	4	53	0.0754717
NODE_149943_length_314_cov_108.139535	160	213	106	2	53	0.0377358
NODE_149943_length_314_cov_108.139535	160	213	107	2	53	0.0377358
NODE_149943_length_314_cov_108.139535	160	213	108	3	53	0.0566038
NODE_149943_length_314_cov_108.139535	160	213	109	2	53	0.0377358
NODE_149944_length_314_cov_48.134884	245	314	0	69	69	1.0000000
NODE_149946_length_314_cov_9.097674	149	206	0	57	57	1.0000000
NODE_149967_length_314_cov_4.897674	109	189	2	17	80	0.2125000
NODE_149967_length_314_cov_4.897674	109	189	4	26	80	0.3250000
NODE_149967_length_314_cov_4.897674	109	189	6	37	80	0.4625000
NODE_150004_length_314_cov_3.823256	119	199	0	80	80	1.0000000
NODE_150020_length_314_cov_3.558140	32	92	0	1	60	0.0166667
NODE_150020_length_314_cov_3.558140	32	92	4	59	60	0.9833333
NODE_150035_length_314_cov_3.316279	84	126	6	1	42	0.0238095
NODE_150035_length_314_cov_3.316279	84	126	8	9	42	0.2142857
NODE_150035_length_314_cov_3.316279	84	126	10	12	42	0.2857143
NODE_150035_length_314_cov_3.316279	84	126	12	20	42	0.4761905
NODE_150035_length_314_cov_3.316279	127	180	1	9	53	0.1698113
NODE_150035_length_314_cov_3.316279	127	180	2	13	53	0.2452830
NODE_150035_length_314_cov_3.316279	127	180	3	10	53	0.1886792
NODE_150035_length_314_cov_3.316279	127	180	4	2	53	0.0377358
NODE_150035_length_314_cov_3.316279	127	180	6	19	53	0.3584906
NODE_150035_length_314_cov_3.316279	128	148	4	2	20	0.1000000
NODE_150035_length_314_cov_3.316279	128	148	6	18	20	0.9000000
NODE_150066_length_314_cov_3.032558	252	308	0	56	56	1.0000000
NODE_150141_length_314_cov_2.520930	0	61	0	61	61	1.0000000
NODE_150141_length_314_cov_2.520930	34	93	0	59	59	1.0000000
NODE_150153_length_314_cov_2.441860	48	84	0	36	36	1.0000000
NODE_150159_length_314_cov_2.395349	62	112	5	13	50	0.2600000
NODE_150159_length_314_cov_2.395349	62	112	6	37	50	0.7400000
NODE_150200_length_314_cov_2.265116	7	53	0	29	46	0.6304348
NODE_150200_length_314_cov_2.265116	7	53	4	17	46	0.3695652
NODE_150220_length_314_cov_2.144186	224	264	0	40	40	1.0000000
NODE_150257_length_314_cov_2.004651	68	148	0	80	80	1.0000000
NODE_150257_length_314_cov_2.004651	121	201	0	80	80	1.0000000
NODE_150385_length_314_cov_1.665116	204	242	0	38	38	1.0000000
NODE_150385_length_314_cov_1.665116	215	295	0	80	80	1.0000000
NODE_150647_length_314_cov_1.223256	7	87	0	35	80	0.4375000
NODE_150647_length_314_cov_1.223256	7	87	2	45	80	0.5625000
NODE_150709_length_314_cov_1.167442	1	69	0	61	68	0.8970588
NODE_150709_length_314_cov_1.167442	1	69	2	7	68	0.1029412
NODE_151193_length_313_cov_156.051402	177	254	21	4	77	0.0519481
NODE_151193_length_313_cov_156.051402	177	254	33	9	77	0.1168831
NODE_151193_length_313_cov_156.051402	177	254	34	15	77	0.1948052
NODE_151193_length_313_cov_156.051402	177	254	38	1	77	0.0129870
NODE_151193_length_313_cov_156.051402	177	254	40	2	77	0.0259740
NODE_151193_length_313_cov_156.051402	177	254	44	1	77	0.0129870
NODE_151193_length_313_cov_156.051402	177	254	46	45	77	0.5844156
NODE_151193_length_313_cov_156.051402	177	254	21	4	77	0.0519481
NODE_151193_length_313_cov_156.051402	177	254	33	9	77	0.1168831
NODE_151193_length_313_cov_156.051402	177	254	34	15	77	0.1948052
NODE_151193_length_313_cov_156.051402	177	254	38	1	77	0.0129870
NODE_151193_length_313_cov_156.051402	177	254	40	2	77	0.0259740
NODE_151193_length_313_cov_156.051402	177	254	44	1	77	0.0129870
NODE_151193_length_313_cov_156.051402	177	254	46	45	77	0.5844156
NODE_151214_length_313_cov_5.359813	135	196	0	61	61	1.0000000
NODE_151214_length_313_cov_5.359813	169	241	0	72	72	1.0000000
NODE_151230_length_313_cov_4.794393	126	206	0	12	80	0.1500000
NODE_151230_length_313_cov_4.794393	126	206	2	1	80	0.0125000
NODE_151230_length_313_cov_4.794393	126	206	4	67	80	0.8375000
NODE_151230_length_313_cov_4.794393	179	259	0	24	80	0.3000000
NODE_151230_length_313_cov_4.794393	179	259	2	8	80	0.1000000
NODE_151230_length_313_cov_4.794393	179	259	4	48	80	0.6000000
NODE_151232_length_313_cov_4.761682	104	162	0	58	58	1.0000000
NODE_151232_length_313_cov_4.761682	135	215	0	59	80	0.7375000
NODE_151232_length_313_cov_4.761682	135	215	2	21	80	0.2625000
NODE_151277_length_313_cov_3.560748	106	186	14	16	80	0.2000000
NODE_151277_length_313_cov_3.560748	106	186	16	64	80	0.8000000
NODE_151331_length_313_cov_2.953271	92	153	2	60	61	0.9836066
NODE_151331_length_313_cov_2.953271	92	153	4	1	61	0.0163934
NODE_151364_length_313_cov_2.640187	110	182	0	72	72	1.0000000
NODE_151364_length_313_cov_2.640187	113	184	0	71	71	1.0000000
NODE_151409_length_313_cov_2.383178	58	137	0	79	79	1.0000000
NODE_151409_length_313_cov_2.383178	110	190	0	72	80	0.9000000
NODE_151409_length_313_cov_2.383178	110	190	2	6	80	0.0750000
NODE_151409_length_313_cov_2.383178	110	190	7	2	80	0.0250000
NODE_151474_length_313_cov_2.107477	153	221	4	45	68	0.6617647
NODE_151474_length_313_cov_2.107477	153	221	6	23	68	0.3382353
NODE_151510_length_313_cov_1.934579	107	187	0	27	80	0.3375000
NODE_151510_length_313_cov_1.934579	107	187	5	2	80	0.0250000
NODE_151510_length_313_cov_1.934579	107	187	11	1	80	0.0125000
NODE_151510_length_313_cov_1.934579	107	187	12	1	80	0.0125000
NODE_151510_length_313_cov_1.934579	107	187	22	2	80	0.0250000
NODE_151510_length_313_cov_1.934579	107	187	23	3	80	0.0375000
NODE_151510_length_313_cov_1.934579	107	187	29	1	80	0.0125000
NODE_151510_length_313_cov_1.934579	107	187	33	2	80	0.0250000
NODE_151510_length_313_cov_1.934579	107	187	36	3	80	0.0375000
NODE_151510_length_313_cov_1.934579	107	187	37	1	80	0.0125000
NODE_151510_length_313_cov_1.934579	107	187	38	1	80	0.0125000
NODE_151510_length_313_cov_1.934579	107	187	40	2	80	0.0250000
NODE_151510_length_313_cov_1.934579	107	187	42	1	80	0.0125000
NODE_151510_length_313_cov_1.934579	107	187	48	3	80	0.0375000
NODE_151510_length_313_cov_1.934579	107	187	49	1	80	0.0125000
NODE_151510_length_313_cov_1.934579	107	187	50	1	80	0.0125000
NODE_151510_length_313_cov_1.934579	107	187	58	1	80	0.0125000
NODE_151510_length_313_cov_1.934579	107	187	68	1	80	0.0125000
NODE_151510_length_313_cov_1.934579	107	187	71	1	80	0.0125000
NODE_151510_length_313_cov_1.934579	107	187	72	2	80	0.0250000
NODE_151510_length_313_cov_1.934579	107	187	73	1	80	0.0125000
NODE_151510_length_313_cov_1.934579	107	187	76	1	80	0.0125000
NODE_151510_length_313_cov_1.934579	107	187	78	3	80	0.0375000
NODE_151510_length_313_cov_1.934579	107	187	86	2	80	0.0250000
NODE_151510_length_313_cov_1.934579	107	187	93	1	80	0.0125000
NODE_151510_length_313_cov_1.934579	107	187	100	1	80	0.0125000
NODE_151510_length_313_cov_1.934579	107	187	102	1	80	0.0125000
NODE_151510_length_313_cov_1.934579	107	187	104	2	80	0.0250000
NODE_151510_length_313_cov_1.934579	107	187	106	3	80	0.0375000
NODE_151510_length_313_cov_1.934579	107	187	107	8	80	0.1000000
NODE_151510_length_313_cov_1.934579	160	240	68	1	80	0.0125000
NODE_151510_length_313_cov_1.934579	160	240	71	1	80	0.0125000
NODE_151510_length_313_cov_1.934579	160	240	72	2	80	0.0250000
NODE_151510_length_313_cov_1.934579	160	240	73	1	80	0.0125000
NODE_151510_length_313_cov_1.934579	160	240	76	1	80	0.0125000
NODE_151510_length_313_cov_1.934579	160	240	78	3	80	0.0375000
NODE_151510_length_313_cov_1.934579	160	240	86	2	80	0.0250000
NODE_151510_length_313_cov_1.934579	160	240	93	1	80	0.0125000
NODE_151510_length_313_cov_1.934579	160	240	100	1	80	0.0125000
NODE_151510_length_313_cov_1.934579	160	240	101	4	80	0.0500000
NODE_151510_length_313_cov_1.934579	160	240	102	1	80	0.0125000
NODE_151510_length_313_cov_1.934579	160	240	103	8	80	0.1000000
NODE_151510_length_313_cov_1.934579	160	240	104	2	80	0.0250000
NODE_151510_length_313_cov_1.934579	160	240	106	3	80	0.0375000
NODE_151510_length_313_cov_1.934579	160	240	107	9	80	0.1125000
NODE_151510_length_313_cov_1.934579	160	240	109	22	80	0.2750000
NODE_151510_length_313_cov_1.934579	160	240	111	16	80	0.2000000
NODE_151510_length_313_cov_1.934579	160	240	113	2	80	0.0250000
NODE_151576_length_313_cov_1.780374	236	296	1	60	60	1.0000000
NODE_151623_length_313_cov_1.663551	58	135	0	77	77	1.0000000
NODE_151703_length_313_cov_1.439252	0	64	0	64	64	1.0000000
NODE_151703_length_313_cov_1.439252	37	82	0	45	45	1.0000000
NODE_151753_length_313_cov_1.429907	74	111	0	6	37	0.1621622
NODE_151753_length_313_cov_1.429907	74	111	2	31	37	0.8378378
NODE_151753_length_313_cov_1.429907	109	172	0	1	63	0.0158730
NODE_151753_length_313_cov_1.429907	109	172	2	8	63	0.1269841
NODE_151753_length_313_cov_1.429907	109	172	7	1	63	0.0158730
NODE_151753_length_313_cov_1.429907	109	172	8	53	63	0.8412699
NODE_151953_length_313_cov_1.172897	106	161	0	14	55	0.2545455
NODE_151953_length_313_cov_1.172897	106	161	3	13	55	0.2363636
NODE_151953_length_313_cov_1.172897	106	161	5	23	55	0.4181818
NODE_151953_length_313_cov_1.172897	106	161	7	5	55	0.0909091
NODE_151953_length_313_cov_1.172897	149	214	5	7	65	0.1076923
NODE_151953_length_313_cov_1.172897	149	214	7	17	65	0.2615385
NODE_151953_length_313_cov_1.172897	149	214	11	14	65	0.2153846
NODE_151953_length_313_cov_1.172897	149	214	13	2	65	0.0307692
NODE_151953_length_313_cov_1.172897	149	214	16	4	65	0.0615385
NODE_151953_length_313_cov_1.172897	149	214	18	15	65	0.2307692
NODE_151953_length_313_cov_1.172897	149	214	20	3	65	0.0461538
NODE_151953_length_313_cov_1.172897	149	214	22	3	65	0.0461538
NODE_152525_length_312_cov_3.723005	178	238	10	19	60	0.3166667
NODE_152525_length_312_cov_3.723005	178	238	12	41	60	0.6833333
NODE_152525_length_312_cov_3.723005	231	291	0	13	60	0.2166667
NODE_152525_length_312_cov_3.723005	231	291	2	2	60	0.0333333
NODE_152525_length_312_cov_3.723005	231	291	4	24	60	0.4000000
NODE_152525_length_312_cov_3.723005	231	291	6	1	60	0.0166667
NODE_152525_length_312_cov_3.723005	231	291	8	5	60	0.0833333
NODE_152525_length_312_cov_3.723005	231	291	10	15	60	0.2500000
NODE_152609_length_312_cov_2.723005	34	96	0	62	62	1.0000000
NODE_152609_length_312_cov_2.723005	87	149	0	62	62	1.0000000
NODE_152680_length_312_cov_2.333333	6	70	0	64	64	1.0000000
NODE_152680_length_312_cov_2.333333	43	123	0	80	80	1.0000000
NODE_152686_length_312_cov_2.267606	176	208	7	12	32	0.3750000
NODE_152686_length_312_cov_2.267606	176	208	10	20	32	0.6250000
NODE_152697_length_312_cov_2.234742	108	169	0	61	61	1.0000000
NODE_152751_length_312_cov_2.014085	141	205	4	8	64	0.1250000
NODE_152751_length_312_cov_2.014085	141	205	5	2	64	0.0312500
NODE_152751_length_312_cov_2.014085	141	205	6	54	64	0.8437500
NODE_152751_length_312_cov_2.014085	178	258	5	28	80	0.3500000
NODE_152751_length_312_cov_2.014085	178	258	6	52	80	0.6500000
NODE_152827_length_312_cov_1.835681	176	221	0	45	45	1.0000000
NODE_152827_length_312_cov_1.835681	194	269	0	75	75	1.0000000
NODE_153222_length_312_cov_1.173709	87	133	3	2	46	0.0434783
NODE_153222_length_312_cov_1.173709	87	133	4	1	46	0.0217391
NODE_153222_length_312_cov_1.173709	87	133	6	12	46	0.2608696
NODE_153222_length_312_cov_1.173709	87	133	8	2	46	0.0434783
NODE_153222_length_312_cov_1.173709	87	133	9	8	46	0.1739130
NODE_153222_length_312_cov_1.173709	87	133	10	8	46	0.1739130
NODE_153222_length_312_cov_1.173709	87	133	13	1	46	0.0217391
NODE_153222_length_312_cov_1.173709	87	133	19	1	46	0.0217391
NODE_153222_length_312_cov_1.173709	87	133	20	1	46	0.0217391
NODE_153222_length_312_cov_1.173709	87	133	21	8	46	0.1739130
NODE_153222_length_312_cov_1.173709	87	133	22	2	46	0.0434783
NODE_153222_length_312_cov_1.173709	150	217	37	9	67	0.1343284
NODE_153222_length_312_cov_1.173709	150	217	39	1	67	0.0149254
NODE_153222_length_312_cov_1.173709	150	217	41	3	67	0.0447761
NODE_153222_length_312_cov_1.173709	150	217	42	1	67	0.0149254
NODE_153222_length_312_cov_1.173709	150	217	48	21	67	0.3134328
NODE_153222_length_312_cov_1.173709	150	217	50	6	67	0.0895522
NODE_153222_length_312_cov_1.173709	150	217	52	2	67	0.0298507
NODE_153222_length_312_cov_1.173709	150	217	54	13	67	0.1940299
NODE_153222_length_312_cov_1.173709	150	217	56	7	67	0.1044776
NODE_153222_length_312_cov_1.173709	150	217	58	1	67	0.0149254
NODE_153222_length_312_cov_1.173709	150	217	60	3	67	0.0447761
NODE_153532_length_312_cov_0.788732	49	110	0	61	61	1.0000000
NODE_153532_length_312_cov_0.788732	102	163	0	61	61	1.0000000
NODE_153708_length_311_cov_5.179245	155	235	0	80	80	1.0000000
NODE_153721_length_311_cov_4.589623	133	200	0	67	67	1.0000000
NODE_153730_length_311_cov_4.358491	199	263	0	64	64	1.0000000
NODE_153743_length_311_cov_3.929245	91	127	0	11	36	0.3055556
NODE_153743_length_311_cov_3.929245	91	127	2	25	36	0.6944444
NODE_153755_length_311_cov_3.825472	224	304	0	17	80	0.2125000
NODE_153755_length_311_cov_3.825472	224	304	2	63	80	0.7875000
NODE_153773_length_311_cov_3.466981	106	186	0	80	80	1.0000000
NODE_153796_length_311_cov_3.188679	39	96	0	57	57	1.0000000
NODE_153846_length_311_cov_2.702830	144	193	6	47	49	0.9591837
NODE_153846_length_311_cov_2.702830	144	193	9	1	49	0.0204082
NODE_153846_length_311_cov_2.702830	144	193	10	1	49	0.0204082
NODE_153850_length_311_cov_2.665094	43	113	0	47	70	0.6714286
NODE_153850_length_311_cov_2.665094	43	113	4	23	70	0.3285714
NODE_153859_length_311_cov_2.617925	206	284	0	78	78	1.0000000
NODE_153859_length_311_cov_2.617925	257	301	0	44	44	1.0000000
NODE_153913_length_311_cov_2.349057	177	204	0	27	27	1.0000000
NODE_153919_length_311_cov_2.325472	74	138	2	64	64	1.0000000
NODE_153947_length_311_cov_2.188679	21	92	0	71	71	1.0000000
NODE_154014_length_311_cov_1.924528	46	65	0	19	19	1.0000000
NODE_154056_length_311_cov_1.891509	122	180	0	38	58	0.6551724
NODE_154056_length_311_cov_1.891509	122	180	2	9	58	0.1551724
NODE_154056_length_311_cov_1.891509	122	180	4	11	58	0.1896552
NODE_154188_length_311_cov_1.594340	0	35	0	35	35	1.0000000
NODE_154190_length_311_cov_1.589623	96	151	0	8	55	0.1454545
NODE_154190_length_311_cov_1.589623	96	151	4	4	55	0.0727273
NODE_154190_length_311_cov_1.589623	96	151	8	10	55	0.1818182
NODE_154190_length_311_cov_1.589623	96	151	11	3	55	0.0545455
NODE_154190_length_311_cov_1.589623	96	151	13	1	55	0.0181818
NODE_154190_length_311_cov_1.589623	96	151	16	29	55	0.5272727
NODE_154194_length_311_cov_1.570755	125	145	0	20	20	1.0000000
NODE_154957_length_311_cov_0.613208	136	216	0	80	80	1.0000000
NODE_154957_length_311_cov_0.613208	189	264	0	75	75	1.0000000
NODE_154996_length_310_cov_96.995261	211	249	69	15	38	0.3947369
NODE_154996_length_310_cov_96.995261	211	249	73	3	38	0.0789474
NODE_154996_length_310_cov_96.995261	211	249	75	5	38	0.1315790
NODE_154996_length_310_cov_96.995261	211	249	77	7	38	0.1842105
NODE_154996_length_310_cov_96.995261	211	249	79	1	38	0.0263158
NODE_154996_length_310_cov_96.995261	211	249	81	7	38	0.1842105
NODE_155001_length_310_cov_7.767773	80	151	0	71	71	1.0000000
NODE_155001_length_310_cov_7.767773	134	189	0	55	55	1.0000000
NODE_155017_length_310_cov_5.914692	84	134	0	47	50	0.9400000
NODE_155017_length_310_cov_5.914692	84	134	2	2	50	0.0400000
NODE_155017_length_310_cov_5.914692	84	134	4	1	50	0.0200000
NODE_155017_length_310_cov_5.914692	113	134	0	21	21	1.0000000
NODE_155017_length_310_cov_5.914692	113	188	0	75	75	1.0000000
NODE_155066_length_310_cov_3.777251	146	226	4	80	80	1.0000000
NODE_155115_length_310_cov_3.180095	137	211	0	22	74	0.2972973
NODE_155115_length_310_cov_3.180095	137	211	1	1	74	0.0135135
NODE_155115_length_310_cov_3.180095	137	211	2	12	74	0.1621622
NODE_155115_length_310_cov_3.180095	137	211	5	2	74	0.0270270
NODE_155115_length_310_cov_3.180095	137	211	9	1	74	0.0135135
NODE_155115_length_310_cov_3.180095	137	211	11	7	74	0.0945946
NODE_155115_length_310_cov_3.180095	137	211	12	2	74	0.0270270
NODE_155115_length_310_cov_3.180095	137	211	14	1	74	0.0135135
NODE_155115_length_310_cov_3.180095	137	211	16	12	74	0.1621622
NODE_155115_length_310_cov_3.180095	137	211	20	8	74	0.1081081
NODE_155115_length_310_cov_3.180095	137	211	23	3	74	0.0405405
NODE_155115_length_310_cov_3.180095	137	211	25	3	74	0.0405405
NODE_155179_length_310_cov_2.630332	122	174	0	52	52	1.0000000
NODE_155179_length_310_cov_2.630332	175	222	0	47	47	1.0000000
NODE_155180_length_310_cov_2.625592	258	301	0	43	43	1.0000000
NODE_155195_length_310_cov_2.563981	149	196	3	15	47	0.3191489
NODE_155195_length_310_cov_2.563981	149	196	5	6	47	0.1276596
NODE_155195_length_310_cov_2.563981	149	196	7	24	47	0.5106383
NODE_155195_length_310_cov_2.563981	149	196	11	1	47	0.0212766
NODE_155195_length_310_cov_2.563981	149	196	13	1	47	0.0212766
NODE_155195_length_310_cov_2.563981	169	249	0	53	80	0.6625000
NODE_155195_length_310_cov_2.563981	169	249	3	15	80	0.1875000
NODE_155195_length_310_cov_2.563981	169	249	5	6	80	0.0750000
NODE_155195_length_310_cov_2.563981	169	249	7	6	80	0.0750000
NODE_155261_length_310_cov_2.298578	213	259	2	46	46	1.0000000
NODE_155334_length_310_cov_2.009479	223	303	0	78	80	0.9750000
NODE_155334_length_310_cov_2.009479	223	303	6	2	80	0.0250000
NODE_155439_length_310_cov_1.729858	53	91	0	38	38	1.0000000
NODE_155768_length_310_cov_1.222749	181	244	0	44	63	0.6984127
NODE_155768_length_310_cov_1.222749	181	244	2	19	63	0.3015873
NODE_155864_length_310_cov_1.142180	65	135	7	1	70	0.0142857
NODE_155864_length_310_cov_1.142180	65	135	8	1	70	0.0142857
NODE_155864_length_310_cov_1.142180	65	135	14	3	70	0.0428571
NODE_155864_length_310_cov_1.142180	65	135	16	4	70	0.0571429
NODE_155864_length_310_cov_1.142180	65	135	18	31	70	0.4428571
NODE_155864_length_310_cov_1.142180	65	135	20	8	70	0.1142857
NODE_155864_length_310_cov_1.142180	65	135	21	1	70	0.0142857
NODE_155864_length_310_cov_1.142180	65	135	22	21	70	0.3000000
NODE_155937_length_310_cov_0.966825	131	212	0	9	81	0.1111111
NODE_155937_length_310_cov_0.966825	131	212	2	72	81	0.8888889
NODE_155937_length_310_cov_0.966825	193	256	0	45	63	0.7142857
NODE_155937_length_310_cov_0.966825	193	256	2	18	63	0.2857143
NODE_156078_length_310_cov_0.924171	180	222	0	42	42	1.0000000
NODE_156174_length_310_cov_0.739336	208	288	0	80	80	1.0000000
NODE_156332_length_309_cov_8.552381	154	234	0	80	80	1.0000000
NODE_156340_length_309_cov_6.147619	20	83	0	63	63	1.0000000
NODE_156349_length_309_cov_5.147619	213	291	0	78	78	1.0000000
NODE_156364_length_309_cov_4.585714	15	95	0	80	80	1.0000000
NODE_156472_length_309_cov_3.028571	0	47	0	47	47	1.0000000
NODE_156472_length_309_cov_3.028571	20	101	0	64	81	0.7901235
NODE_156472_length_309_cov_3.028571	20	101	2	17	81	0.2098765
NODE_156563_length_309_cov_2.304762	179	218	0	39	39	1.0000000
NODE_156615_length_309_cov_2.095238	55	85	0	30	30	1.0000000
NODE_156678_length_309_cov_1.938095	2	73	0	71	71	1.0000000
NODE_156950_length_309_cov_1.414286	189	231	0	42	42	1.0000000
NODE_156978_length_309_cov_1.376190	94	168	0	74	74	1.0000000
NODE_157334_length_309_cov_0.966667	134	153	0	19	19	1.0000000
NODE_157469_length_309_cov_0.738095	150	215	16	9	65	0.1384615
NODE_157469_length_309_cov_0.738095	150	215	17	18	65	0.2769231
NODE_157469_length_309_cov_0.738095	150	215	19	38	65	0.5846154
NODE_157661_length_308_cov_4.775120	137	174	0	35	37	0.9459459
NODE_157661_length_308_cov_4.775120	137	174	2	2	37	0.0540541
NODE_157690_length_308_cov_3.966507	126	206	0	80	80	1.0000000
NODE_157705_length_308_cov_3.665072	11	75	0	64	64	1.0000000
NODE_157819_length_308_cov_2.593301	137	193	2	56	56	1.0000000
NODE_157852_length_308_cov_2.435407	14	58	0	44	44	1.0000000
NODE_157852_length_308_cov_2.435407	31	111	0	80	80	1.0000000
NODE_157898_length_308_cov_2.191388	14	80	0	66	66	1.0000000
NODE_157903_length_308_cov_2.191388	236	296	0	60	60	1.0000000
NODE_157969_length_308_cov_1.952153	251	296	0	45	45	1.0000000
NODE_158083_length_308_cov_1.708134	102	148	0	46	46	1.0000000
NODE_158276_length_308_cov_1.435407	196	276	0	80	80	1.0000000
NODE_158439_length_308_cov_1.162679	260	300	2	40	40	1.0000000
NODE_158439_length_308_cov_1.162679	273	307	0	3	34	0.0882353
NODE_158439_length_308_cov_1.162679	273	307	2	31	34	0.9117647
NODE_158447_length_308_cov_1.148325	35	83	0	48	48	1.0000000
NODE_158448_length_308_cov_1.148325	253	308	0	27	55	0.4909091
NODE_158448_length_308_cov_1.148325	253	308	2	28	55	0.5090909
NODE_158510_length_308_cov_1.038278	147	202	0	55	55	1.0000000
NODE_158811_length_308_cov_0.684211	196	275	0	79	79	1.0000000
NODE_158821_length_308_cov_0.660287	109	157	0	14	48	0.2916667
NODE_158821_length_308_cov_0.660287	109	157	2	6	48	0.1250000
NODE_158821_length_308_cov_0.660287	109	157	3	1	48	0.0208333
NODE_158821_length_308_cov_0.660287	109	157	5	4	48	0.0833333
NODE_158821_length_308_cov_0.660287	109	157	9	1	48	0.0208333
NODE_158821_length_308_cov_0.660287	109	157	13	5	48	0.1041667
NODE_158821_length_308_cov_0.660287	109	157	15	3	48	0.0625000
NODE_158821_length_308_cov_0.660287	109	157	17	4	48	0.0833333
NODE_158821_length_308_cov_0.660287	109	157	18	10	48	0.2083333
NODE_158821_length_308_cov_0.660287	130	210	5	4	80	0.0500000
NODE_158821_length_308_cov_0.660287	130	210	9	1	80	0.0125000
NODE_158821_length_308_cov_0.660287	130	210	13	5	80	0.0625000
NODE_158821_length_308_cov_0.660287	130	210	15	3	80	0.0375000
NODE_158821_length_308_cov_0.660287	130	210	17	4	80	0.0500000
NODE_158821_length_308_cov_0.660287	130	210	18	63	80	0.7875000
NODE_158905_length_307_cov_30.725962	0	73	0	73	73	1.0000000
NODE_158905_length_307_cov_30.725962	46	99	0	53	53	1.0000000
NODE_158906_length_307_cov_25.096154	84	164	0	80	80	1.0000000
NODE_158906_length_307_cov_25.096154	137	217	0	80	80	1.0000000
NODE_158933_length_307_cov_5.524038	150	221	0	71	71	1.0000000
NODE_158983_length_307_cov_3.730769	172	252	0	80	80	1.0000000
NODE_158983_length_307_cov_3.730769	225	305	0	80	80	1.0000000
NODE_158999_length_307_cov_3.322115	20	100	0	63	80	0.7875000
NODE_158999_length_307_cov_3.322115	20	100	2	17	80	0.2125000
NODE_158999_length_307_cov_3.322115	78	153	0	5	75	0.0666667
NODE_158999_length_307_cov_3.322115	78	153	2	70	75	0.9333333
NODE_159000_length_307_cov_3.317308	12	94	0	66	82	0.8048781
NODE_159000_length_307_cov_3.317308	12	94	2	3	82	0.0365854
NODE_159000_length_307_cov_3.317308	12	94	4	13	82	0.1585366
NODE_159000_length_307_cov_3.317308	76	134	0	2	58	0.0344828
NODE_159000_length_307_cov_3.317308	76	134	2	3	58	0.0517241
NODE_159000_length_307_cov_3.317308	76	134	4	37	58	0.6379310
NODE_159000_length_307_cov_3.317308	76	134	5	2	58	0.0344828
NODE_159000_length_307_cov_3.317308	76	134	6	14	58	0.2413793
NODE_159053_length_307_cov_2.870192	43	108	0	65	65	1.0000000
NODE_159084_length_307_cov_2.653846	117	177	16	7	60	0.1166667
NODE_159084_length_307_cov_2.653846	117	177	18	37	60	0.6166667
NODE_159084_length_307_cov_2.653846	117	177	22	2	60	0.0333333
NODE_159084_length_307_cov_2.653846	117	177	24	14	60	0.2333333
NODE_159142_length_307_cov_2.346154	54	105	0	51	51	1.0000000
NODE_159351_length_307_cov_1.716346	124	165	0	41	41	1.0000000
NODE_159362_length_307_cov_1.716346	30	93	0	8	63	0.1269841
NODE_159362_length_307_cov_1.716346	30	93	4	55	63	0.8730159
NODE_159407_length_307_cov_1.600962	221	269	0	29	48	0.6041667
NODE_159407_length_307_cov_1.600962	221	269	2	19	48	0.3958333
NODE_159407_length_307_cov_1.600962	242	307	0	65	65	1.0000000
NODE_159447_length_307_cov_1.475962	252	307	0	55	55	1.0000000
NODE_159585_length_307_cov_1.326923	96	142	0	19	46	0.4130435
NODE_159585_length_307_cov_1.326923	96	142	2	27	46	0.5869565
NODE_159585_length_307_cov_1.326923	115	195	2	57	80	0.7125000
NODE_159585_length_307_cov_1.326923	115	195	4	23	80	0.2875000
NODE_159618_length_307_cov_1.264423	13	61	0	48	48	1.0000000
NODE_159618_length_307_cov_1.264423	23	54	0	31	31	1.0000000
NODE_159696_length_307_cov_1.197115	92	121	1	29	29	1.0000000
NODE_159787_length_307_cov_1.000000	132	168	0	11	36	0.3055556
NODE_159787_length_307_cov_1.000000	132	168	2	25	36	0.6944444
NODE_160213_length_306_cov_74.526570	68	136	0	68	68	1.0000000
NODE_160213_length_306_cov_74.526570	68	148	0	80	80	1.0000000
NODE_160213_length_306_cov_74.526570	121	201	0	80	80	1.0000000
NODE_160213_length_306_cov_74.526570	121	201	0	80	80	1.0000000
NODE_160213_length_306_cov_74.526570	197	277	0	80	80	1.0000000
NODE_160213_length_306_cov_74.526570	197	277	0	80	80	1.0000000
NODE_160213_length_306_cov_74.526570	197	277	0	80	80	1.0000000
NODE_160213_length_306_cov_74.526570	250	299	0	49	49	1.0000000
NODE_160213_length_306_cov_74.526570	250	306	0	56	56	1.0000000
NODE_160213_length_306_cov_74.526570	255	306	0	51	51	1.0000000
NODE_160217_length_306_cov_7.396135	23	117	0	59	94	0.6276596
NODE_160217_length_306_cov_7.396135	23	117	2	35	94	0.3723404
NODE_160217_length_306_cov_7.396135	90	170	2	80	80	1.0000000
NODE_160261_length_306_cov_4.275362	67	147	0	80	80	1.0000000
NODE_160275_length_306_cov_3.937198	104	176	0	72	72	1.0000000
NODE_160300_length_306_cov_3.444444	130	206	0	76	76	1.0000000
NODE_160323_length_306_cov_3.217391	198	278	2	80	80	1.0000000
NODE_160333_length_306_cov_3.043478	90	171	0	81	81	1.0000000
NODE_160333_length_306_cov_3.043478	144	202	0	58	58	1.0000000
NODE_160340_length_306_cov_2.956522	242	273	0	31	31	1.0000000
NODE_160355_length_306_cov_2.884058	173	243	2	70	70	1.0000000
NODE_160403_length_306_cov_2.574879	122	203	0	14	81	0.1728395
NODE_160403_length_306_cov_2.574879	122	203	2	67	81	0.8271605
NODE_160403_length_306_cov_2.574879	176	254	0	65	78	0.8333333
NODE_160403_length_306_cov_2.574879	176	254	2	13	78	0.1666667
NODE_160475_length_306_cov_2.265700	223	278	2	55	55	1.0000000
NODE_160512_length_306_cov_2.106280	73	149	0	65	76	0.8552632
NODE_160512_length_306_cov_2.106280	73	149	2	11	76	0.1447368
NODE_160512_length_306_cov_2.106280	125	205	0	13	80	0.1625000
NODE_160512_length_306_cov_2.106280	125	205	2	16	80	0.2000000
NODE_160512_length_306_cov_2.106280	125	205	4	51	80	0.6375000
NODE_160608_length_306_cov_1.879227	165	196	6	31	31	1.0000000
NODE_160752_length_306_cov_1.478261	206	237	2	31	31	1.0000000
NODE_160761_length_306_cov_1.478261	157	220	0	46	63	0.7301587
NODE_160761_length_306_cov_1.478261	157	220	6	17	63	0.2698413
NODE_160833_length_306_cov_1.434783	40	88	0	48	48	1.0000000
NODE_160875_length_306_cov_1.357488	128	171	0	30	43	0.6976744
NODE_160875_length_306_cov_1.357488	128	171	2	13	43	0.3023256
NODE_160992_length_306_cov_1.222222	216	252	0	36	36	1.0000000
NODE_160992_length_306_cov_1.222222	230	305	0	75	75	1.0000000
NODE_161018_length_306_cov_1.188406	79	159	0	80	80	1.0000000
NODE_161042_length_306_cov_1.130435	122	202	0	80	80	1.0000000
NODE_161042_length_306_cov_1.130435	175	255	0	80	80	1.0000000
NODE_161078_length_306_cov_1.067633	156	188	0	32	32	1.0000000
NODE_161234_length_306_cov_0.975845	219	247	0	28	28	1.0000000
NODE_161246_length_306_cov_0.956522	206	284	0	78	78	1.0000000
NODE_161550_length_305_cov_5.718447	177	243	0	66	66	1.0000000
NODE_161566_length_305_cov_4.854369	55	135	0	12	80	0.1500000
NODE_161566_length_305_cov_4.854369	55	135	2	15	80	0.1875000
NODE_161566_length_305_cov_4.854369	55	135	4	53	80	0.6625000
NODE_161584_length_305_cov_4.266990	186	266	0	80	80	1.0000000
NODE_161723_length_305_cov_2.616505	220	263	0	35	43	0.8139535
NODE_161723_length_305_cov_2.616505	220	263	2	8	43	0.1860465
NODE_161723_length_305_cov_2.616505	236	305	0	19	69	0.2753623
NODE_161723_length_305_cov_2.616505	236	305	2	50	69	0.7246377
NODE_161726_length_305_cov_2.597087	171	256	151	5	85	0.0588235
NODE_161726_length_305_cov_2.597087	171	256	153	2	85	0.0235294
NODE_161726_length_305_cov_2.597087	171	256	157	2	85	0.0235294
NODE_161726_length_305_cov_2.597087	171	256	165	1	85	0.0117647
NODE_161726_length_305_cov_2.597087	171	256	171	1	85	0.0117647
NODE_161726_length_305_cov_2.597087	171	256	178	1	85	0.0117647
NODE_161726_length_305_cov_2.597087	171	256	179	3	85	0.0352941
NODE_161726_length_305_cov_2.597087	171	256	181	1	85	0.0117647
NODE_161726_length_305_cov_2.597087	171	256	186	1	85	0.0117647
NODE_161726_length_305_cov_2.597087	171	256	188	2	85	0.0235294
NODE_161726_length_305_cov_2.597087	171	256	190	1	85	0.0117647
NODE_161726_length_305_cov_2.597087	171	256	192	1	85	0.0117647
NODE_161726_length_305_cov_2.597087	171	256	194	1	85	0.0117647
NODE_161726_length_305_cov_2.597087	171	256	201	1	85	0.0117647
NODE_161726_length_305_cov_2.597087	171	256	206	1	85	0.0117647
NODE_161726_length_305_cov_2.597087	171	256	207	1	85	0.0117647
NODE_161726_length_305_cov_2.597087	171	256	210	1	85	0.0117647
NODE_161726_length_305_cov_2.597087	171	256	214	1	85	0.0117647
NODE_161726_length_305_cov_2.597087	171	256	219	1	85	0.0117647
NODE_161726_length_305_cov_2.597087	171	256	222	1	85	0.0117647
NODE_161726_length_305_cov_2.597087	171	256	226	2	85	0.0235294
NODE_161726_length_305_cov_2.597087	171	256	230	1	85	0.0117647
NODE_161726_length_305_cov_2.597087	171	256	248	1	85	0.0117647
NODE_161726_length_305_cov_2.597087	171	256	250	1	85	0.0117647
NODE_161726_length_305_cov_2.597087	171	256	253	1	85	0.0117647
NODE_161726_length_305_cov_2.597087	171	256	256	2	85	0.0235294
NODE_161726_length_305_cov_2.597087	171	256	259	2	85	0.0235294
NODE_161726_length_305_cov_2.597087	171	256	262	1	85	0.0117647
NODE_161726_length_305_cov_2.597087	171	256	268	1	85	0.0117647
NODE_161726_length_305_cov_2.597087	171	256	281	2	85	0.0235294
NODE_161726_length_305_cov_2.597087	171	256	286	1	85	0.0117647
NODE_161726_length_305_cov_2.597087	171	256	288	1	85	0.0117647
NODE_161726_length_305_cov_2.597087	171	256	290	1	85	0.0117647
NODE_161726_length_305_cov_2.597087	171	256	296	1	85	0.0117647
NODE_161726_length_305_cov_2.597087	171	256	305	2	85	0.0235294
NODE_161726_length_305_cov_2.597087	171	256	309	1	85	0.0117647
NODE_161726_length_305_cov_2.597087	171	256	312	1	85	0.0117647
NODE_161726_length_305_cov_2.597087	171	256	313	1	85	0.0117647
NODE_161726_length_305_cov_2.597087	171	256	320	1	85	0.0117647
NODE_161726_length_305_cov_2.597087	171	256	322	2	85	0.0235294
NODE_161726_length_305_cov_2.597087	171	256	324	2	85	0.0235294
NODE_161726_length_305_cov_2.597087	171	256	325	1	85	0.0117647
NODE_161726_length_305_cov_2.597087	171	256	326	2	85	0.0235294
NODE_161726_length_305_cov_2.597087	171	256	327	5	85	0.0588235
NODE_161726_length_305_cov_2.597087	171	256	328	20	85	0.2352941
NODE_161732_length_305_cov_2.533981	3	57	0	54	54	1.0000000
NODE_161775_length_305_cov_2.339806	149	237	8	2	88	0.0227273
NODE_161775_length_305_cov_2.339806	149	237	15	6	88	0.0681818
NODE_161775_length_305_cov_2.339806	149	237	16	10	88	0.1136364
NODE_161775_length_305_cov_2.339806	149	237	17	9	88	0.1022727
NODE_161775_length_305_cov_2.339806	149	237	18	61	88	0.6931818
NODE_161795_length_305_cov_2.228155	194	274	0	80	80	1.0000000
NODE_161795_length_305_cov_2.228155	247	300	0	53	53	1.0000000
NODE_161877_length_305_cov_1.975728	44	116	0	72	72	1.0000000
NODE_161908_length_305_cov_1.883495	135	172	60	4	37	0.1081081
NODE_161908_length_305_cov_1.883495	135	172	61	1	37	0.0270270
NODE_161908_length_305_cov_1.883495	135	172	63	1	37	0.0270270
NODE_161908_length_305_cov_1.883495	135	172	69	6	37	0.1621622
NODE_161908_length_305_cov_1.883495	135	172	71	1	37	0.0270270
NODE_161908_length_305_cov_1.883495	135	172	73	4	37	0.1081081
NODE_161908_length_305_cov_1.883495	135	172	79	1	37	0.0270270
NODE_161908_length_305_cov_1.883495	135	172	81	3	37	0.0810811
NODE_161908_length_305_cov_1.883495	135	172	82	1	37	0.0270270
NODE_161908_length_305_cov_1.883495	135	172	84	1	37	0.0270270
NODE_161908_length_305_cov_1.883495	135	172	85	1	37	0.0270270
NODE_161908_length_305_cov_1.883495	135	172	89	4	37	0.1081081
NODE_161908_length_305_cov_1.883495	135	172	91	6	37	0.1621622
NODE_161908_length_305_cov_1.883495	135	172	93	3	37	0.0810811
NODE_161990_length_305_cov_1.674757	14	80	0	66	66	1.0000000
NODE_161990_length_305_cov_1.674757	53	133	0	80	80	1.0000000
NODE_161996_length_305_cov_1.655340	110	179	7	6	69	0.0869565
NODE_161996_length_305_cov_1.655340	110	179	8	46	69	0.6666667
NODE_161996_length_305_cov_1.655340	110	179	9	17	69	0.2463768
NODE_162123_length_305_cov_1.466019	153	238	12	14	85	0.1647059
NODE_162123_length_305_cov_1.466019	153	238	18	7	85	0.0823529
NODE_162123_length_305_cov_1.466019	153	238	20	1	85	0.0117647
NODE_162123_length_305_cov_1.466019	153	238	21	5	85	0.0588235
NODE_162123_length_305_cov_1.466019	153	238	22	8	85	0.0941176
NODE_162123_length_305_cov_1.466019	153	238	24	9	85	0.1058824
NODE_162123_length_305_cov_1.466019	153	238	26	21	85	0.2470588
NODE_162123_length_305_cov_1.466019	153	238	28	10	85	0.1176471
NODE_162123_length_305_cov_1.466019	153	238	30	10	85	0.1176471
NODE_162123_length_305_cov_1.466019	222	284	22	12	62	0.1935484
NODE_162123_length_305_cov_1.466019	222	284	26	5	62	0.0806452
NODE_162123_length_305_cov_1.466019	222	284	28	12	62	0.1935484
NODE_162123_length_305_cov_1.466019	222	284	30	33	62	0.5322581
NODE_162169_length_305_cov_1.398058	28	75	0	47	47	1.0000000
NODE_162198_length_305_cov_1.330097	212	292	2	6	80	0.0750000
NODE_162198_length_305_cov_1.330097	212	292	4	3	80	0.0375000
NODE_162198_length_305_cov_1.330097	212	292	6	1	80	0.0125000
NODE_162198_length_305_cov_1.330097	212	292	12	3	80	0.0375000
NODE_162198_length_305_cov_1.330097	212	292	14	2	80	0.0250000
NODE_162198_length_305_cov_1.330097	212	292	16	3	80	0.0375000
NODE_162198_length_305_cov_1.330097	212	292	18	1	80	0.0125000
NODE_162198_length_305_cov_1.330097	212	292	20	6	80	0.0750000
NODE_162198_length_305_cov_1.330097	212	292	22	4	80	0.0500000
NODE_162198_length_305_cov_1.330097	212	292	24	8	80	0.1000000
NODE_162198_length_305_cov_1.330097	212	292	26	4	80	0.0500000
NODE_162198_length_305_cov_1.330097	212	292	28	1	80	0.0125000
NODE_162198_length_305_cov_1.330097	212	292	40	3	80	0.0375000
NODE_162198_length_305_cov_1.330097	212	292	42	2	80	0.0250000
NODE_162198_length_305_cov_1.330097	212	292	44	1	80	0.0125000
NODE_162198_length_305_cov_1.330097	212	292	46	1	80	0.0125000
NODE_162198_length_305_cov_1.330097	212	292	48	7	80	0.0875000
NODE_162198_length_305_cov_1.330097	212	292	50	5	80	0.0625000
NODE_162198_length_305_cov_1.330097	212	292	52	7	80	0.0875000
NODE_162198_length_305_cov_1.330097	212	292	54	1	80	0.0125000
NODE_162198_length_305_cov_1.330097	212	292	56	11	80	0.1375000
NODE_162198_length_305_cov_1.330097	265	305	0	3	40	0.0750000
NODE_162198_length_305_cov_1.330097	265	305	2	16	40	0.4000000
NODE_162198_length_305_cov_1.330097	265	305	4	3	40	0.0750000
NODE_162198_length_305_cov_1.330097	265	305	6	1	40	0.0250000
NODE_162198_length_305_cov_1.330097	265	305	12	3	40	0.0750000
NODE_162198_length_305_cov_1.330097	265	305	14	2	40	0.0500000
NODE_162198_length_305_cov_1.330097	265	305	16	3	40	0.0750000
NODE_162198_length_305_cov_1.330097	265	305	18	1	40	0.0250000
NODE_162198_length_305_cov_1.330097	265	305	20	6	40	0.1500000
NODE_162198_length_305_cov_1.330097	265	305	22	2	40	0.0500000
NODE_162359_length_305_cov_1.111650	245	275	0	30	30	1.0000000
NODE_162411_length_305_cov_0.990291	46	126	0	80	80	1.0000000
NODE_162593_length_305_cov_0.873786	73	109	0	36	36	1.0000000
NODE_162782_length_305_cov_0.631068	86	166	0	80	80	1.0000000
NODE_162782_length_305_cov_0.631068	139	186	0	47	47	1.0000000
NODE_162854_length_304_cov_44.482927	61	102	46	4	41	0.0975610
NODE_162854_length_304_cov_44.482927	61	102	47	10	41	0.2439024
NODE_162854_length_304_cov_44.482927	61	102	49	19	41	0.4634146
NODE_162854_length_304_cov_44.482927	61	102	51	4	41	0.0975610
NODE_162854_length_304_cov_44.482927	61	102	53	4	41	0.0975610
NODE_162855_length_304_cov_30.678049	205	281	0	76	76	1.0000000
NODE_162855_length_304_cov_30.678049	254	304	0	50	50	1.0000000
NODE_162886_length_304_cov_4.956098	72	152	2	1	80	0.0125000
NODE_162886_length_304_cov_4.956098	72	152	4	20	80	0.2500000
NODE_162886_length_304_cov_4.956098	72	152	6	1	80	0.0125000
NODE_162886_length_304_cov_4.956098	72	152	8	58	80	0.7250000
NODE_162919_length_304_cov_3.980488	46	126	0	80	80	1.0000000
NODE_162919_length_304_cov_3.980488	99	179	0	80	80	1.0000000
NODE_162932_length_304_cov_3.809756	108	156	0	48	48	1.0000000
NODE_162955_length_304_cov_3.424390	67	129	0	23	62	0.3709677
NODE_162955_length_304_cov_3.424390	67	129	2	39	62	0.6290323
NODE_162955_length_304_cov_3.424390	120	182	2	62	62	1.0000000
NODE_162997_length_304_cov_2.980488	105	126	0	21	21	1.0000000
NODE_163048_length_304_cov_2.629268	106	186	10	80	80	1.0000000
NODE_163048_length_304_cov_2.629268	159	209	0	3	50	0.0600000
NODE_163048_length_304_cov_2.629268	159	209	6	13	50	0.2600000
NODE_163048_length_304_cov_2.629268	159	209	10	34	50	0.6800000
NODE_163116_length_304_cov_2.239024	57	137	0	80	80	1.0000000
NODE_163116_length_304_cov_2.239024	110	152	0	42	42	1.0000000
NODE_163148_length_304_cov_2.170732	112	145	0	1	33	0.0303030
NODE_163148_length_304_cov_2.170732	112	145	2	20	33	0.6060606
NODE_163148_length_304_cov_2.170732	112	145	6	9	33	0.2727273
NODE_163148_length_304_cov_2.170732	112	145	10	3	33	0.0909091
NODE_163148_length_304_cov_2.170732	146	198	10	52	52	1.0000000
NODE_163333_length_304_cov_1.687805	219	288	0	69	69	1.0000000
NODE_163432_length_304_cov_1.492683	190	238	2	48	48	1.0000000
NODE_163559_length_304_cov_1.287805	99	165	2	22	66	0.3333333
NODE_163559_length_304_cov_1.287805	99	165	4	14	66	0.2121212
NODE_163559_length_304_cov_1.287805	99	165	6	30	66	0.4545455
NODE_163670_length_304_cov_1.175610	0	30	0	30	30	1.0000000
NODE_163895_length_304_cov_0.951220	70	150	4	3	80	0.0375000
NODE_163895_length_304_cov_0.951220	70	150	6	13	80	0.1625000
NODE_163895_length_304_cov_0.951220	70	150	8	32	80	0.4000000
NODE_163895_length_304_cov_0.951220	70	150	10	32	80	0.4000000
NODE_164171_length_303_cov_30.843137	46	97	0	51	51	1.0000000
NODE_164194_length_303_cov_5.401961	33	79	0	22	46	0.4782609
NODE_164194_length_303_cov_5.401961	33	79	2	24	46	0.5217391
NODE_164224_length_303_cov_4.210784	136	205	0	1	69	0.0144928
NODE_164224_length_303_cov_4.210784	136	205	2	7	69	0.1014493
NODE_164224_length_303_cov_4.210784	136	205	6	1	69	0.0144928
NODE_164224_length_303_cov_4.210784	136	205	8	46	69	0.6666667
NODE_164224_length_303_cov_4.210784	136	205	10	14	69	0.2028985
NODE_164224_length_303_cov_4.210784	178	259	0	55	81	0.6790124
NODE_164224_length_303_cov_4.210784	178	259	2	7	81	0.0864198
NODE_164224_length_303_cov_4.210784	178	259	6	1	81	0.0123457
NODE_164224_length_303_cov_4.210784	178	259	8	18	81	0.2222222
NODE_164251_length_303_cov_3.671569	9	75	2	54	66	0.8181818
NODE_164251_length_303_cov_3.671569	9	75	6	12	66	0.1818182
NODE_164251_length_303_cov_3.671569	48	128	2	15	80	0.1875000
NODE_164251_length_303_cov_3.671569	48	128	6	23	80	0.2875000
NODE_164251_length_303_cov_3.671569	48	128	8	42	80	0.5250000
NODE_164251_length_303_cov_3.671569	48	128	2	15	80	0.1875000
NODE_164251_length_303_cov_3.671569	48	128	6	23	80	0.2875000
NODE_164251_length_303_cov_3.671569	48	128	8	42	80	0.5250000
NODE_164251_length_303_cov_3.671569	220	300	4	80	80	1.0000000
NODE_164267_length_303_cov_3.500000	55	123	0	68	68	1.0000000
NODE_164272_length_303_cov_3.460784	0	67	0	31	67	0.4626866
NODE_164272_length_303_cov_3.460784	0	67	2	2	67	0.0298507
NODE_164272_length_303_cov_3.460784	0	67	3	6	67	0.0895522
NODE_164272_length_303_cov_3.460784	0	67	12	12	67	0.1791045
NODE_164272_length_303_cov_3.460784	0	67	13	1	67	0.0149254
NODE_164272_length_303_cov_3.460784	0	67	15	1	67	0.0149254
NODE_164272_length_303_cov_3.460784	0	67	17	14	67	0.2089552
NODE_164272_length_303_cov_3.460784	98	178	42	1	80	0.0125000
NODE_164272_length_303_cov_3.460784	98	178	44	2	80	0.0250000
NODE_164272_length_303_cov_3.460784	98	178	46	1	80	0.0125000
NODE_164272_length_303_cov_3.460784	98	178	51	1	80	0.0125000
NODE_164272_length_303_cov_3.460784	98	178	60	2	80	0.0250000
NODE_164272_length_303_cov_3.460784	98	178	72	1	80	0.0125000
NODE_164272_length_303_cov_3.460784	98	178	73	2	80	0.0250000
NODE_164272_length_303_cov_3.460784	98	178	75	4	80	0.0500000
NODE_164272_length_303_cov_3.460784	98	178	76	1	80	0.0125000
NODE_164272_length_303_cov_3.460784	98	178	83	1	80	0.0125000
NODE_164272_length_303_cov_3.460784	98	178	85	2	80	0.0250000
NODE_164272_length_303_cov_3.460784	98	178	87	2	80	0.0250000
NODE_164272_length_303_cov_3.460784	98	178	90	1	80	0.0125000
NODE_164272_length_303_cov_3.460784	98	178	94	3	80	0.0375000
NODE_164272_length_303_cov_3.460784	98	178	96	2	80	0.0250000
NODE_164272_length_303_cov_3.460784	98	178	97	1	80	0.0125000
NODE_164272_length_303_cov_3.460784	98	178	99	2	80	0.0250000
NODE_164272_length_303_cov_3.460784	98	178	100	3	80	0.0375000
NODE_164272_length_303_cov_3.460784	98	178	106	1	80	0.0125000
NODE_164272_length_303_cov_3.460784	98	178	110	1	80	0.0125000
NODE_164272_length_303_cov_3.460784	98	178	111	1	80	0.0125000
NODE_164272_length_303_cov_3.460784	98	178	119	1	80	0.0125000
NODE_164272_length_303_cov_3.460784	98	178	121	1	80	0.0125000
NODE_164272_length_303_cov_3.460784	98	178	125	1	80	0.0125000
NODE_164272_length_303_cov_3.460784	98	178	130	1	80	0.0125000
NODE_164272_length_303_cov_3.460784	98	178	134	2	80	0.0250000
NODE_164272_length_303_cov_3.460784	98	178	135	1	80	0.0125000
NODE_164272_length_303_cov_3.460784	98	178	138	1	80	0.0125000
NODE_164272_length_303_cov_3.460784	98	178	150	1	80	0.0125000
NODE_164272_length_303_cov_3.460784	98	178	151	1	80	0.0125000
NODE_164272_length_303_cov_3.460784	98	178	154	5	80	0.0625000
NODE_164272_length_303_cov_3.460784	98	178	155	4	80	0.0500000
NODE_164272_length_303_cov_3.460784	98	178	156	2	80	0.0250000
NODE_164272_length_303_cov_3.460784	98	178	157	1	80	0.0125000
NODE_164272_length_303_cov_3.460784	98	178	158	1	80	0.0125000
NODE_164272_length_303_cov_3.460784	98	178	160	1	80	0.0125000
NODE_164272_length_303_cov_3.460784	98	178	162	5	80	0.0625000
NODE_164272_length_303_cov_3.460784	98	178	163	4	80	0.0500000
NODE_164272_length_303_cov_3.460784	98	178	164	3	80	0.0375000
NODE_164272_length_303_cov_3.460784	98	178	165	1	80	0.0125000
NODE_164272_length_303_cov_3.460784	98	178	178	1	80	0.0125000
NODE_164272_length_303_cov_3.460784	98	178	192	1	80	0.0125000
NODE_164272_length_303_cov_3.460784	98	178	194	1	80	0.0125000
NODE_164272_length_303_cov_3.460784	98	178	196	1	80	0.0125000
NODE_164272_length_303_cov_3.460784	98	178	204	1	80	0.0125000
NODE_164272_length_303_cov_3.460784	98	178	208	1	80	0.0125000
NODE_164272_length_303_cov_3.460784	98	178	212	1	80	0.0125000
NODE_164272_length_303_cov_3.460784	98	178	213	1	80	0.0125000
NODE_164272_length_303_cov_3.460784	151	191	155	4	40	0.1000000
NODE_164272_length_303_cov_3.460784	151	191	156	1	40	0.0250000
NODE_164272_length_303_cov_3.460784	151	191	157	1	40	0.0250000
NODE_164272_length_303_cov_3.460784	151	191	158	1	40	0.0250000
NODE_164272_length_303_cov_3.460784	151	191	160	1	40	0.0250000
NODE_164272_length_303_cov_3.460784	151	191	162	3	40	0.0750000
NODE_164272_length_303_cov_3.460784	151	191	163	4	40	0.1000000
NODE_164272_length_303_cov_3.460784	151	191	164	3	40	0.0750000
NODE_164272_length_303_cov_3.460784	151	191	165	1	40	0.0250000
NODE_164272_length_303_cov_3.460784	151	191	178	1	40	0.0250000
NODE_164272_length_303_cov_3.460784	151	191	192	1	40	0.0250000
NODE_164272_length_303_cov_3.460784	151	191	194	1	40	0.0250000
NODE_164272_length_303_cov_3.460784	151	191	196	1	40	0.0250000
NODE_164272_length_303_cov_3.460784	151	191	204	1	40	0.0250000
NODE_164272_length_303_cov_3.460784	151	191	208	1	40	0.0250000
NODE_164272_length_303_cov_3.460784	151	191	212	1	40	0.0250000
NODE_164272_length_303_cov_3.460784	151	191	213	4	40	0.1000000
NODE_164272_length_303_cov_3.460784	151	191	216	2	40	0.0500000
NODE_164272_length_303_cov_3.460784	151	191	217	1	40	0.0250000
NODE_164272_length_303_cov_3.460784	151	191	220	1	40	0.0250000
NODE_164272_length_303_cov_3.460784	151	191	221	1	40	0.0250000
NODE_164272_length_303_cov_3.460784	151	191	224	1	40	0.0250000
NODE_164272_length_303_cov_3.460784	151	191	226	1	40	0.0250000
NODE_164272_length_303_cov_3.460784	151	191	228	1	40	0.0250000
NODE_164272_length_303_cov_3.460784	151	191	230	1	40	0.0250000
NODE_164272_length_303_cov_3.460784	151	191	231	1	40	0.0250000
NODE_164283_length_303_cov_3.352941	77	146	0	59	69	0.8550724
NODE_164283_length_303_cov_3.352941	77	146	4	10	69	0.1449275
NODE_164433_length_303_cov_2.284314	78	158	0	24	80	0.3000000
NODE_164433_length_303_cov_2.284314	78	158	1	26	80	0.3250000
NODE_164433_length_303_cov_2.284314	78	158	2	30	80	0.3750000
NODE_164433_length_303_cov_2.284314	215	295	0	20	80	0.2500000
NODE_164433_length_303_cov_2.284314	215	295	1	33	80	0.4125000
NODE_164433_length_303_cov_2.284314	215	295	2	27	80	0.3375000
NODE_164581_length_303_cov_1.848039	90	170	0	80	80	1.0000000
NODE_164581_length_303_cov_1.848039	143	223	0	80	80	1.0000000
NODE_164581_length_303_cov_1.848039	212	235	0	23	23	1.0000000
NODE_164668_length_303_cov_1.686275	62	88	0	26	26	1.0000000
NODE_164695_length_303_cov_1.583333	206	270	0	64	64	1.0000000
NODE_164800_length_303_cov_1.475490	155	221	4	55	66	0.8333333
NODE_164800_length_303_cov_1.475490	155	221	6	11	66	0.1666667
NODE_164846_length_303_cov_1.392157	135	213	16	27	78	0.3461539
NODE_164846_length_303_cov_1.392157	135	213	18	1	78	0.0128205
NODE_164846_length_303_cov_1.392157	135	213	20	50	78	0.6410257
NODE_164878_length_303_cov_1.318627	0	75	0	75	75	1.0000000
NODE_164974_length_303_cov_1.215686	278	297	0	19	19	1.0000000
NODE_165498_length_302_cov_10.852217	266	300	0	34	34	1.0000000
NODE_165502_length_302_cov_7.896552	46	131	0	85	85	1.0000000
NODE_165502_length_302_cov_7.896552	104	160	0	56	56	1.0000000
NODE_165505_length_302_cov_7.266010	135	191	0	56	56	1.0000000
NODE_165507_length_302_cov_7.216749	93	149	0	56	56	1.0000000
NODE_165507_length_302_cov_7.216749	155	226	2	3	71	0.0422535
NODE_165507_length_302_cov_7.216749	155	226	4	68	71	0.9577465
NODE_165517_length_302_cov_6.172414	179	243	0	64	64	1.0000000
NODE_165517_length_302_cov_6.172414	232	287	0	55	55	1.0000000
NODE_165528_length_302_cov_5.586207	221	293	0	6	72	0.0833333
NODE_165528_length_302_cov_5.586207	221	293	2	2	72	0.0277778
NODE_165528_length_302_cov_5.586207	221	293	3	15	72	0.2083333
NODE_165528_length_302_cov_5.586207	221	293	5	29	72	0.4027778
NODE_165528_length_302_cov_5.586207	221	293	9	16	72	0.2222222
NODE_165528_length_302_cov_5.586207	221	293	10	4	72	0.0555556
NODE_165641_length_302_cov_2.985222	104	186	1	12	82	0.1463415
NODE_165641_length_302_cov_2.985222	104	186	3	1	82	0.0121951
NODE_165641_length_302_cov_2.985222	104	186	4	69	82	0.8414634
NODE_165848_length_302_cov_2.009852	12	34	0	22	22	1.0000000
NODE_165934_length_302_cov_1.758621	98	152	0	54	54	1.0000000
NODE_165945_length_302_cov_1.758621	230	294	0	64	64	1.0000000
NODE_166007_length_302_cov_1.620690	172	232	0	48	60	0.8000000
NODE_166007_length_302_cov_1.620690	172	232	2	4	60	0.0666667
NODE_166007_length_302_cov_1.620690	172	232	4	3	60	0.0500000
NODE_166007_length_302_cov_1.620690	172	232	6	5	60	0.0833333
NODE_166007_length_302_cov_1.620690	225	277	0	52	52	1.0000000
NODE_166320_length_302_cov_1.172414	34	103	0	69	69	1.0000000
NODE_166381_length_302_cov_1.044335	54	130	0	5	76	0.0657895
NODE_166381_length_302_cov_1.044335	54	130	2	18	76	0.2368421
NODE_166381_length_302_cov_1.044335	54	130	4	53	76	0.6973684
NODE_166617_length_302_cov_0.847291	94	172	14	1	78	0.0128205
NODE_166617_length_302_cov_0.847291	94	172	15	2	78	0.0256410
NODE_166617_length_302_cov_0.847291	94	172	16	5	78	0.0641026
NODE_166617_length_302_cov_0.847291	94	172	22	7	78	0.0897436
NODE_166617_length_302_cov_0.847291	94	172	24	2	78	0.0256410
NODE_166617_length_302_cov_0.847291	94	172	28	7	78	0.0897436
NODE_166617_length_302_cov_0.847291	94	172	30	2	78	0.0256410
NODE_166617_length_302_cov_0.847291	94	172	32	18	78	0.2307692
NODE_166617_length_302_cov_0.847291	94	172	34	15	78	0.1923077
NODE_166617_length_302_cov_0.847291	94	172	36	7	78	0.0897436
NODE_166617_length_302_cov_0.847291	94	172	40	2	78	0.0256410
NODE_166617_length_302_cov_0.847291	94	172	45	10	78	0.1282051
NODE_166617_length_302_cov_0.847291	94	172	14	1	78	0.0128205
NODE_166617_length_302_cov_0.847291	94	172	15	2	78	0.0256410
NODE_166617_length_302_cov_0.847291	94	172	16	5	78	0.0641026
NODE_166617_length_302_cov_0.847291	94	172	22	7	78	0.0897436
NODE_166617_length_302_cov_0.847291	94	172	24	2	78	0.0256410
NODE_166617_length_302_cov_0.847291	94	172	28	7	78	0.0897436
NODE_166617_length_302_cov_0.847291	94	172	30	2	78	0.0256410
NODE_166617_length_302_cov_0.847291	94	172	32	18	78	0.2307692
NODE_166617_length_302_cov_0.847291	94	172	34	15	78	0.1923077
NODE_166617_length_302_cov_0.847291	94	172	36	7	78	0.0897436
NODE_166617_length_302_cov_0.847291	94	172	40	2	78	0.0256410
NODE_166617_length_302_cov_0.847291	94	172	45	10	78	0.1282051
NODE_166617_length_302_cov_0.847291	103	172	22	6	69	0.0869565
NODE_166617_length_302_cov_0.847291	103	172	24	2	69	0.0289855
NODE_166617_length_302_cov_0.847291	103	172	28	7	69	0.1014493
NODE_166617_length_302_cov_0.847291	103	172	30	2	69	0.0289855
NODE_166617_length_302_cov_0.847291	103	172	32	18	69	0.2608696
NODE_166617_length_302_cov_0.847291	103	172	34	15	69	0.2173913
NODE_166617_length_302_cov_0.847291	103	172	36	7	69	0.1014493
NODE_166617_length_302_cov_0.847291	103	172	40	2	69	0.0289855
NODE_166617_length_302_cov_0.847291	103	172	45	10	69	0.1449275
NODE_166638_length_302_cov_0.807882	97	177	0	80	80	1.0000000
NODE_166819_length_301_cov_6.960396	268	299	0	31	31	1.0000000
NODE_166827_length_301_cov_6.148515	214	283	0	69	69	1.0000000
NODE_166889_length_301_cov_3.747525	116	196	0	80	80	1.0000000
NODE_166904_length_301_cov_3.509901	217	277	1	1	60	0.0166667
NODE_166904_length_301_cov_3.509901	217	277	2	9	60	0.1500000
NODE_166904_length_301_cov_3.509901	217	277	4	2	60	0.0333333
NODE_166904_length_301_cov_3.509901	217	277	7	3	60	0.0500000
NODE_166904_length_301_cov_3.509901	217	277	9	5	60	0.0833333
NODE_166904_length_301_cov_3.509901	217	277	16	2	60	0.0333333
NODE_166904_length_301_cov_3.509901	217	277	18	2	60	0.0333333
NODE_166904_length_301_cov_3.509901	217	277	19	1	60	0.0166667
NODE_166904_length_301_cov_3.509901	217	277	21	5	60	0.0833333
NODE_166904_length_301_cov_3.509901	217	277	25	2	60	0.0333333
NODE_166904_length_301_cov_3.509901	217	277	33	3	60	0.0500000
NODE_166904_length_301_cov_3.509901	217	277	35	2	60	0.0333333
NODE_166904_length_301_cov_3.509901	217	277	38	1	60	0.0166667
NODE_166904_length_301_cov_3.509901	217	277	39	1	60	0.0166667
NODE_166904_length_301_cov_3.509901	217	277	46	1	60	0.0166667
NODE_166904_length_301_cov_3.509901	217	277	47	1	60	0.0166667
NODE_166904_length_301_cov_3.509901	217	277	49	2	60	0.0333333
NODE_166904_length_301_cov_3.509901	217	277	51	1	60	0.0166667
NODE_166904_length_301_cov_3.509901	217	277	57	1	60	0.0166667
NODE_166904_length_301_cov_3.509901	217	277	67	1	60	0.0166667
NODE_166904_length_301_cov_3.509901	217	277	69	2	60	0.0333333
NODE_166904_length_301_cov_3.509901	217	277	75	2	60	0.0333333
NODE_166904_length_301_cov_3.509901	217	277	77	1	60	0.0166667
NODE_166904_length_301_cov_3.509901	217	277	79	1	60	0.0166667
NODE_166904_length_301_cov_3.509901	217	277	83	1	60	0.0166667
NODE_166904_length_301_cov_3.509901	217	277	93	1	60	0.0166667
NODE_166904_length_301_cov_3.509901	217	277	94	2	60	0.0333333
NODE_166904_length_301_cov_3.509901	217	277	98	1	60	0.0166667
NODE_166904_length_301_cov_3.509901	217	277	102	1	60	0.0166667
NODE_166904_length_301_cov_3.509901	217	277	104	1	60	0.0166667
NODE_166904_length_301_cov_3.509901	217	277	108	1	60	0.0166667
NODE_166993_length_301_cov_2.653465	133	213	0	80	80	1.0000000
NODE_167126_length_301_cov_2.084158	178	258	44	8	80	0.1000000
NODE_167126_length_301_cov_2.084158	178	258	52	4	80	0.0500000
NODE_167126_length_301_cov_2.084158	178	258	54	7	80	0.0875000
NODE_167126_length_301_cov_2.084158	178	258	56	4	80	0.0500000
NODE_167126_length_301_cov_2.084158	178	258	58	18	80	0.2250000
NODE_167126_length_301_cov_2.084158	178	258	60	4	80	0.0500000
NODE_167126_length_301_cov_2.084158	178	258	62	9	80	0.1125000
NODE_167126_length_301_cov_2.084158	178	258	64	9	80	0.1125000
NODE_167126_length_301_cov_2.084158	178	258	66	17	80	0.2125000
NODE_167215_length_301_cov_1.831683	111	175	1	64	64	1.0000000
NODE_167215_length_301_cov_1.831683	164	228	0	38	64	0.5937500
NODE_167215_length_301_cov_1.831683	164	228	1	26	64	0.4062500
NODE_167308_length_301_cov_1.603960	173	233	0	60	60	1.0000000
NODE_167313_length_301_cov_1.584158	30	108	0	78	78	1.0000000
NODE_167434_length_301_cov_1.470297	90	165	0	75	75	1.0000000
NODE_167508_length_301_cov_1.326733	175	247	0	5	72	0.0694444
NODE_167508_length_301_cov_1.326733	175	247	2	9	72	0.1250000
NODE_167508_length_301_cov_1.326733	175	247	4	58	72	0.8055556
NODE_167612_length_301_cov_1.247525	29	73	0	44	44	1.0000000
NODE_167642_length_301_cov_1.183168	123	203	4	5	80	0.0625000
NODE_167642_length_301_cov_1.183168	123	203	6	1	80	0.0125000
NODE_167642_length_301_cov_1.183168	123	203	8	26	80	0.3250000
NODE_167642_length_301_cov_1.183168	123	203	12	8	80	0.1000000
NODE_167642_length_301_cov_1.183168	123	203	14	6	80	0.0750000
NODE_167642_length_301_cov_1.183168	123	203	16	13	80	0.1625000
NODE_167642_length_301_cov_1.183168	123	203	20	21	80	0.2625000
NODE_167659_length_301_cov_1.163366	10	83	0	73	73	1.0000000
NODE_167659_length_301_cov_1.163366	91	121	0	30	30	1.0000000
NODE_167668_length_301_cov_1.148515	161	209	0	48	48	1.0000000
NODE_167880_length_301_cov_0.980198	242	297	0	55	55	1.0000000
NODE_167891_length_301_cov_0.960396	22	63	0	41	41	1.0000000
NODE_168253_length_300_cov_3.402985	44	124	0	80	80	1.0000000
NODE_168253_length_300_cov_3.402985	97	177	0	80	80	1.0000000
NODE_168253_length_300_cov_3.402985	173	254	0	81	81	1.0000000
NODE_168253_length_300_cov_3.402985	233	300	0	67	67	1.0000000
NODE_168265_length_300_cov_3.298507	18	98	0	80	80	1.0000000
NODE_168360_length_300_cov_2.597015	110	182	19	8	72	0.1111111
NODE_168360_length_300_cov_2.597015	110	182	20	64	72	0.8888889
NODE_168363_length_300_cov_2.572139	28	102	0	15	74	0.2027027
NODE_168363_length_300_cov_2.572139	28	102	3	2	74	0.0270270
NODE_168363_length_300_cov_2.572139	28	102	4	28	74	0.3783784
NODE_168363_length_300_cov_2.572139	28	102	6	8	74	0.1081081
NODE_168363_length_300_cov_2.572139	28	102	8	3	74	0.0405405
NODE_168363_length_300_cov_2.572139	28	102	10	2	74	0.0270270
NODE_168363_length_300_cov_2.572139	28	102	14	6	74	0.0810811
NODE_168363_length_300_cov_2.572139	28	102	16	5	74	0.0675676
NODE_168363_length_300_cov_2.572139	28	102	20	3	74	0.0405405
NODE_168363_length_300_cov_2.572139	28	102	22	2	74	0.0270270
NODE_168363_length_300_cov_2.572139	75	141	6	6	66	0.0909091
NODE_168363_length_300_cov_2.572139	75	141	8	3	66	0.0454545
NODE_168363_length_300_cov_2.572139	75	141	10	2	66	0.0303030
NODE_168363_length_300_cov_2.572139	75	141	14	6	66	0.0909091
NODE_168363_length_300_cov_2.572139	75	141	16	5	66	0.0757576
NODE_168363_length_300_cov_2.572139	75	141	20	3	66	0.0454545
NODE_168363_length_300_cov_2.572139	75	141	22	3	66	0.0454545
NODE_168363_length_300_cov_2.572139	75	141	26	2	66	0.0303030
NODE_168363_length_300_cov_2.572139	75	141	28	3	66	0.0454545
NODE_168363_length_300_cov_2.572139	75	141	30	33	66	0.5000000
NODE_168402_length_300_cov_2.417910	0	44	0	33	44	0.7500000
NODE_168402_length_300_cov_2.417910	0	44	2	11	44	0.2500000
NODE_168459_length_300_cov_2.174129	117	197	2	16	80	0.2000000
NODE_168459_length_300_cov_2.174129	117	197	3	4	80	0.0500000
NODE_168459_length_300_cov_2.174129	117	197	4	5	80	0.0625000
NODE_168459_length_300_cov_2.174129	117	197	8	1	80	0.0125000
NODE_168459_length_300_cov_2.174129	117	197	10	8	80	0.1000000
NODE_168459_length_300_cov_2.174129	117	197	12	1	80	0.0125000
NODE_168459_length_300_cov_2.174129	117	197	13	3	80	0.0375000
NODE_168459_length_300_cov_2.174129	117	197	14	22	80	0.2750000
NODE_168459_length_300_cov_2.174129	117	197	15	1	80	0.0125000
NODE_168459_length_300_cov_2.174129	117	197	16	8	80	0.1000000
NODE_168459_length_300_cov_2.174129	117	197	19	2	80	0.0250000
NODE_168459_length_300_cov_2.174129	117	197	20	9	80	0.1125000
NODE_168459_length_300_cov_2.174129	170	250	14	10	80	0.1250000
NODE_168459_length_300_cov_2.174129	170	250	16	8	80	0.1000000
NODE_168459_length_300_cov_2.174129	170	250	20	23	80	0.2875000
NODE_168459_length_300_cov_2.174129	170	250	22	2	80	0.0250000
NODE_168459_length_300_cov_2.174129	170	250	24	4	80	0.0500000
NODE_168459_length_300_cov_2.174129	170	250	26	1	80	0.0125000
NODE_168459_length_300_cov_2.174129	170	250	30	5	80	0.0625000
NODE_168459_length_300_cov_2.174129	170	250	31	27	80	0.3375000
NODE_168459_length_300_cov_2.174129	216	296	6	2	80	0.0250000
NODE_168459_length_300_cov_2.174129	216	296	10	3	80	0.0375000
NODE_168459_length_300_cov_2.174129	216	296	16	1	80	0.0125000
NODE_168459_length_300_cov_2.174129	216	296	20	1	80	0.0125000
NODE_168459_length_300_cov_2.174129	216	296	22	2	80	0.0250000
NODE_168459_length_300_cov_2.174129	216	296	24	3	80	0.0375000
NODE_168459_length_300_cov_2.174129	216	296	26	13	80	0.1625000
NODE_168459_length_300_cov_2.174129	216	296	27	18	80	0.2250000
NODE_168459_length_300_cov_2.174129	216	296	29	2	80	0.0250000
NODE_168459_length_300_cov_2.174129	216	296	30	5	80	0.0625000
NODE_168459_length_300_cov_2.174129	216	296	31	30	80	0.3750000
NODE_168462_length_300_cov_2.164179	122	141	0	19	19	1.0000000
NODE_168479_length_300_cov_2.079602	127	207	0	1	80	0.0125000
NODE_168479_length_300_cov_2.079602	127	207	2	41	80	0.5125000
NODE_168479_length_300_cov_2.079602	127	207	4	38	80	0.4750000
NODE_168479_length_300_cov_2.079602	203	273	0	31	70	0.4428571
NODE_168479_length_300_cov_2.079602	203	273	2	27	70	0.3857143
NODE_168479_length_300_cov_2.079602	203	273	4	12	70	0.1714286
NODE_168541_length_300_cov_1.965174	15	86	0	71	71	1.0000000
NODE_168656_length_300_cov_1.731343	31	88	6	2	57	0.0350877
NODE_168656_length_300_cov_1.731343	31	88	10	8	57	0.1403509
NODE_168656_length_300_cov_1.731343	31	88	12	47	57	0.8245614
NODE_168906_length_300_cov_1.268657	62	98	0	36	36	1.0000000
NODE_168906_length_300_cov_1.268657	151	186	0	35	35	1.0000000
NODE_169014_length_300_cov_1.104478	86	165	6	14	79	0.1772152
NODE_169014_length_300_cov_1.104478	86	165	8	61	79	0.7721519
NODE_169014_length_300_cov_1.104478	86	165	10	4	79	0.0506329
NODE_169053_length_300_cov_1.029851	110	177	0	25	67	0.3731343
NODE_169053_length_300_cov_1.029851	110	177	2	4	67	0.0597015
NODE_169053_length_300_cov_1.029851	110	177	4	15	67	0.2238806
NODE_169053_length_300_cov_1.029851	110	177	6	23	67	0.3432836
NODE_169053_length_300_cov_1.029851	120	177	0	25	57	0.4385965
NODE_169053_length_300_cov_1.029851	120	177	2	4	57	0.0701754
NODE_169053_length_300_cov_1.029851	120	177	4	15	57	0.2631579
NODE_169053_length_300_cov_1.029851	120	177	6	13	57	0.2280702
NODE_169378_length_300_cov_0.716418	191	210	0	19	19	1.0000000
NODE_169528_length_299_cov_4.435000	48	128	0	26	80	0.3250000
NODE_169528_length_299_cov_4.435000	48	128	2	18	80	0.2250000
NODE_169528_length_299_cov_4.435000	48	128	4	36	80	0.4500000
NODE_169528_length_299_cov_4.435000	101	167	0	65	66	0.9848485
NODE_169528_length_299_cov_4.435000	101	167	2	1	66	0.0151515
NODE_169567_length_299_cov_3.780000	114	181	0	67	67	1.0000000
NODE_169631_length_299_cov_3.095000	0	73	0	73	73	1.0000000
NODE_169631_length_299_cov_3.095000	0	20	0	20	20	1.0000000
NODE_169725_length_299_cov_2.495000	46	126	0	20	80	0.2500000
NODE_169725_length_299_cov_2.495000	46	126	2	60	80	0.7500000
NODE_169725_length_299_cov_2.495000	99	179	0	73	80	0.9125000
NODE_169725_length_299_cov_2.495000	99	179	2	7	80	0.0875000
NODE_169769_length_299_cov_2.275000	127	192	0	65	65	1.0000000
NODE_169781_length_299_cov_2.250000	72	135	4	34	63	0.5396826
NODE_169781_length_299_cov_2.250000	72	135	5	6	63	0.0952381
NODE_169781_length_299_cov_2.250000	72	135	6	23	63	0.3650794
NODE_169781_length_299_cov_2.250000	108	188	2	41	80	0.5125000
NODE_169781_length_299_cov_2.250000	108	188	4	36	80	0.4500000
NODE_169781_length_299_cov_2.250000	108	188	6	3	80	0.0375000
NODE_169811_length_299_cov_2.090000	25	105	0	80	80	1.0000000
NODE_169888_length_299_cov_1.955000	173	214	4	13	41	0.3170732
NODE_169888_length_299_cov_1.955000	173	214	6	11	41	0.2682927
NODE_169888_length_299_cov_1.955000	173	214	8	10	41	0.2439024
NODE_169888_length_299_cov_1.955000	173	214	10	7	41	0.1707317
NODE_169888_length_299_cov_1.955000	187	227	4	3	40	0.0750000
NODE_169888_length_299_cov_1.955000	187	227	6	7	40	0.1750000
NODE_169888_length_299_cov_1.955000	187	227	8	10	40	0.2500000
NODE_169888_length_299_cov_1.955000	187	227	10	12	40	0.3000000
NODE_169888_length_299_cov_1.955000	187	227	14	8	40	0.2000000
NODE_169916_length_299_cov_1.885000	29	109	10	10	80	0.1250000
NODE_169916_length_299_cov_1.885000	29	109	11	10	80	0.1250000
NODE_169916_length_299_cov_1.885000	29	109	12	60	80	0.7500000
NODE_169920_length_299_cov_1.880000	204	236	0	32	32	1.0000000
NODE_169938_length_299_cov_1.840000	154	190	0	1	36	0.0277778
NODE_169938_length_299_cov_1.840000	154	190	2	35	36	0.9722222
NODE_169995_length_299_cov_1.710000	211	291	0	80	80	1.0000000
NODE_170048_length_299_cov_1.550000	174	205	0	31	31	1.0000000
NODE_170501_length_299_cov_1.020000	42	115	0	73	73	1.0000000
NODE_170546_length_299_cov_1.020000	132	175	2	43	43	1.0000000
NODE_170620_length_299_cov_0.935000	173	216	0	43	43	1.0000000
NODE_170691_length_299_cov_0.765000	86	128	0	42	42	1.0000000
NODE_170887_length_298_cov_20.894472	70	150	0	80	80	1.0000000
NODE_170887_length_298_cov_20.894472	123	203	0	80	80	1.0000000
NODE_170888_length_298_cov_13.859296	228	298	0	9	70	0.1285714
NODE_170888_length_298_cov_13.859296	228	298	2	1	70	0.0142857
NODE_170888_length_298_cov_13.859296	228	298	4	9	70	0.1285714
NODE_170888_length_298_cov_13.859296	228	298	9	1	70	0.0142857
NODE_170888_length_298_cov_13.859296	228	298	11	5	70	0.0714286
NODE_170888_length_298_cov_13.859296	228	298	12	7	70	0.1000000
NODE_170888_length_298_cov_13.859296	228	298	18	2	70	0.0285714
NODE_170888_length_298_cov_13.859296	228	298	20	7	70	0.1000000
NODE_170888_length_298_cov_13.859296	228	298	22	2	70	0.0285714
NODE_170888_length_298_cov_13.859296	228	298	24	2	70	0.0285714
NODE_170888_length_298_cov_13.859296	228	298	26	1	70	0.0142857
NODE_170888_length_298_cov_13.859296	228	298	28	1	70	0.0142857
NODE_170888_length_298_cov_13.859296	228	298	30	2	70	0.0285714
NODE_170888_length_298_cov_13.859296	228	298	34	1	70	0.0142857
NODE_170888_length_298_cov_13.859296	228	298	36	2	70	0.0285714
NODE_170888_length_298_cov_13.859296	228	298	38	18	70	0.2571429
NODE_170909_length_298_cov_5.859296	1	65	0	3	64	0.0468750
NODE_170909_length_298_cov_5.859296	1	65	2	2	64	0.0312500
NODE_170909_length_298_cov_5.859296	1	65	4	2	64	0.0312500
NODE_170909_length_298_cov_5.859296	1	65	6	57	64	0.8906250
NODE_170909_length_298_cov_5.859296	38	118	4	11	80	0.1375000
NODE_170909_length_298_cov_5.859296	38	118	6	53	80	0.6625000
NODE_170909_length_298_cov_5.859296	38	118	8	16	80	0.2000000
NODE_170909_length_298_cov_5.859296	114	194	2	3	80	0.0375000
NODE_170909_length_298_cov_5.859296	114	194	4	18	80	0.2250000
NODE_170909_length_298_cov_5.859296	114	194	6	8	80	0.1000000
NODE_170909_length_298_cov_5.859296	114	194	8	34	80	0.4250000
NODE_170909_length_298_cov_5.859296	114	194	10	2	80	0.0250000
NODE_170909_length_298_cov_5.859296	114	194	12	15	80	0.1875000
NODE_170909_length_298_cov_5.859296	167	238	8	10	71	0.1408451
NODE_170909_length_298_cov_5.859296	167	238	9	1	71	0.0140845
NODE_170909_length_298_cov_5.859296	167	238	10	19	71	0.2676056
NODE_170909_length_298_cov_5.859296	167	238	12	29	71	0.4084507
NODE_170909_length_298_cov_5.859296	167	238	14	12	71	0.1690141
NODE_170964_length_298_cov_3.829146	80	160	16	7	80	0.0875000
NODE_170964_length_298_cov_3.829146	80	160	17	8	80	0.1000000
NODE_170964_length_298_cov_3.829146	80	160	18	10	80	0.1250000
NODE_170964_length_298_cov_3.829146	80	160	20	2	80	0.0250000
NODE_170964_length_298_cov_3.829146	80	160	28	6	80	0.0750000
NODE_170964_length_298_cov_3.829146	80	160	29	1	80	0.0125000
NODE_170964_length_298_cov_3.829146	80	160	30	16	80	0.2000000
NODE_170964_length_298_cov_3.829146	80	160	31	12	80	0.1500000
NODE_170964_length_298_cov_3.829146	80	160	33	18	80	0.2250000
NODE_170964_length_298_cov_3.829146	133	213	5	25	80	0.3125000
NODE_170964_length_298_cov_3.829146	133	213	7	2	80	0.0250000
NODE_170964_length_298_cov_3.829146	133	213	9	11	80	0.1375000
NODE_170964_length_298_cov_3.829146	133	213	11	1	80	0.0125000
NODE_170964_length_298_cov_3.829146	133	213	13	2	80	0.0250000
NODE_170964_length_298_cov_3.829146	133	213	14	1	80	0.0125000
NODE_170964_length_298_cov_3.829146	133	213	15	5	80	0.0625000
NODE_170964_length_298_cov_3.829146	133	213	16	7	80	0.0875000
NODE_170964_length_298_cov_3.829146	133	213	17	14	80	0.1750000
NODE_170964_length_298_cov_3.829146	133	213	18	10	80	0.1250000
NODE_170964_length_298_cov_3.829146	133	213	20	2	80	0.0250000
NODE_170968_length_298_cov_3.733668	203	283	0	80	80	1.0000000
NODE_170972_length_298_cov_3.673367	117	175	7	7	58	0.1206897
NODE_170972_length_298_cov_3.673367	117	175	8	15	58	0.2586207
NODE_170972_length_298_cov_3.673367	117	175	10	5	58	0.0862069
NODE_170972_length_298_cov_3.673367	117	175	12	4	58	0.0689655
NODE_170972_length_298_cov_3.673367	117	175	14	27	58	0.4655173
NODE_171043_length_298_cov_2.924623	159	239	2	8	80	0.1000000
NODE_171043_length_298_cov_2.924623	159	239	4	56	80	0.7000000
NODE_171043_length_298_cov_2.924623	159	239	6	4	80	0.0500000
NODE_171043_length_298_cov_2.924623	159	239	8	9	80	0.1125000
NODE_171043_length_298_cov_2.924623	159	239	10	2	80	0.0250000
NODE_171043_length_298_cov_2.924623	159	239	11	1	80	0.0125000
NODE_171043_length_298_cov_2.924623	212	265	2	15	53	0.2830189
NODE_171043_length_298_cov_2.924623	212	265	4	38	53	0.7169811
NODE_171047_length_298_cov_2.854271	50	120	0	70	70	1.0000000
NODE_171082_length_298_cov_2.663317	87	167	0	17	80	0.2125000
NODE_171082_length_298_cov_2.663317	87	167	1	55	80	0.6875000
NODE_171082_length_298_cov_2.663317	87	167	2	8	80	0.1000000
NODE_171082_length_298_cov_2.663317	140	192	1	22	52	0.4230769
NODE_171082_length_298_cov_2.663317	140	192	2	30	52	0.5769231
NODE_171191_length_298_cov_2.201005	112	166	0	54	54	1.0000000
NODE_171210_length_298_cov_2.120603	135	166	0	31	31	1.0000000
NODE_171226_length_298_cov_2.055276	69	132	2	63	63	1.0000000
NODE_171286_length_298_cov_2.025126	21	92	0	71	71	1.0000000
NODE_171356_length_298_cov_1.798995	0	67	0	67	67	1.0000000
NODE_171356_length_298_cov_1.798995	40	106	0	66	66	1.0000000
NODE_171391_length_298_cov_1.788945	140	197	0	57	57	1.0000000
NODE_171415_length_298_cov_1.733668	56	91	12	3	35	0.0857143
NODE_171415_length_298_cov_1.733668	56	91	14	1	35	0.0285714
NODE_171415_length_298_cov_1.733668	56	91	16	6	35	0.1714286
NODE_171415_length_298_cov_1.733668	56	91	18	3	35	0.0857143
NODE_171415_length_298_cov_1.733668	56	91	20	5	35	0.1428571
NODE_171415_length_298_cov_1.733668	56	91	22	17	35	0.4857143
NODE_171415_length_298_cov_1.733668	118	172	6	2	54	0.0370370
NODE_171415_length_298_cov_1.733668	118	172	8	7	54	0.1296296
NODE_171415_length_298_cov_1.733668	118	172	10	2	54	0.0370370
NODE_171415_length_298_cov_1.733668	118	172	12	9	54	0.1666667
NODE_171415_length_298_cov_1.733668	118	172	14	1	54	0.0185185
NODE_171415_length_298_cov_1.733668	118	172	16	14	54	0.2592593
NODE_171415_length_298_cov_1.733668	118	172	18	19	54	0.3518519
NODE_171505_length_298_cov_1.537688	101	154	0	53	53	1.0000000
NODE_172083_length_298_cov_0.829146	34	96	0	62	62	1.0000000
NODE_172330_length_297_cov_6.525253	100	122	0	22	22	1.0000000
NODE_172352_length_297_cov_4.888889	150	218	2	57	68	0.8382353
NODE_172352_length_297_cov_4.888889	150	218	4	11	68	0.1617647
NODE_172356_length_297_cov_4.671717	56	120	0	64	64	1.0000000
NODE_172422_length_297_cov_3.338384	96	176	0	14	80	0.1750000
NODE_172422_length_297_cov_3.338384	96	176	2	66	80	0.8250000
NODE_172422_length_297_cov_3.338384	149	198	0	36	49	0.7346939
NODE_172422_length_297_cov_3.338384	149	198	2	13	49	0.2653061
NODE_172447_length_297_cov_3.040404	0	55	0	55	55	1.0000000
NODE_172447_length_297_cov_3.040404	14	55	0	41	41	1.0000000
NODE_172447_length_297_cov_3.040404	65	119	0	54	54	1.0000000
NODE_172574_length_297_cov_2.308081	8	70	0	8	62	0.1290323
NODE_172574_length_297_cov_2.308081	8	70	4	54	62	0.8709677
NODE_172606_length_297_cov_2.196970	219	259	105	1	40	0.0250000
NODE_172606_length_297_cov_2.196970	219	259	106	1	40	0.0250000
NODE_172606_length_297_cov_2.196970	219	259	115	1	40	0.0250000
NODE_172606_length_297_cov_2.196970	219	259	123	2	40	0.0500000
NODE_172606_length_297_cov_2.196970	219	259	125	1	40	0.0250000
NODE_172606_length_297_cov_2.196970	219	259	127	3	40	0.0750000
NODE_172606_length_297_cov_2.196970	219	259	131	2	40	0.0500000
NODE_172606_length_297_cov_2.196970	219	259	132	1	40	0.0250000
NODE_172606_length_297_cov_2.196970	219	259	137	1	40	0.0250000
NODE_172606_length_297_cov_2.196970	219	259	141	1	40	0.0250000
NODE_172606_length_297_cov_2.196970	219	259	143	1	40	0.0250000
NODE_172606_length_297_cov_2.196970	219	259	150	1	40	0.0250000
NODE_172606_length_297_cov_2.196970	219	259	152	1	40	0.0250000
NODE_172606_length_297_cov_2.196970	219	259	154	1	40	0.0250000
NODE_172606_length_297_cov_2.196970	219	259	156	1	40	0.0250000
NODE_172606_length_297_cov_2.196970	219	259	169	2	40	0.0500000
NODE_172606_length_297_cov_2.196970	219	259	171	1	40	0.0250000
NODE_172606_length_297_cov_2.196970	219	259	177	3	40	0.0750000
NODE_172606_length_297_cov_2.196970	219	259	182	1	40	0.0250000
NODE_172606_length_297_cov_2.196970	219	259	184	1	40	0.0250000
NODE_172606_length_297_cov_2.196970	219	259	188	3	40	0.0750000
NODE_172606_length_297_cov_2.196970	219	259	194	2	40	0.0500000
NODE_172606_length_297_cov_2.196970	219	259	197	4	40	0.1000000
NODE_172606_length_297_cov_2.196970	219	259	199	1	40	0.0250000
NODE_172606_length_297_cov_2.196970	219	259	200	1	40	0.0250000
NODE_172606_length_297_cov_2.196970	219	259	204	2	40	0.0500000
NODE_172629_length_297_cov_2.106061	81	161	6	44	80	0.5500000
NODE_172629_length_297_cov_2.106061	81	161	8	7	80	0.0875000
NODE_172629_length_297_cov_2.106061	81	161	10	14	80	0.1750000
NODE_172629_length_297_cov_2.106061	81	161	12	15	80	0.1875000
NODE_172629_length_297_cov_2.106061	134	178	10	25	44	0.5681818
NODE_172629_length_297_cov_2.106061	134	178	12	15	44	0.3409091
NODE_172629_length_297_cov_2.106061	134	178	14	4	44	0.0909091
NODE_172668_length_297_cov_2.060606	46	76	0	30	30	1.0000000
NODE_172697_length_297_cov_2.010101	9	85	0	4	76	0.0526316
NODE_172697_length_297_cov_2.010101	9	85	4	7	76	0.0921053
NODE_172697_length_297_cov_2.010101	9	85	6	3	76	0.0394737
NODE_172697_length_297_cov_2.010101	9	85	7	1	76	0.0131579
NODE_172697_length_297_cov_2.010101	9	85	9	5	76	0.0657895
NODE_172697_length_297_cov_2.010101	9	85	10	10	76	0.1315790
NODE_172697_length_297_cov_2.010101	9	85	12	8	76	0.1052632
NODE_172697_length_297_cov_2.010101	9	85	14	38	76	0.5000000
NODE_172783_length_297_cov_1.777778	168	208	4	12	40	0.3000000
NODE_172783_length_297_cov_1.777778	168	208	6	5	40	0.1250000
NODE_172783_length_297_cov_1.777778	168	208	8	23	40	0.5750000
NODE_172855_length_297_cov_1.595960	175	255	6	6	80	0.0750000
NODE_172855_length_297_cov_1.595960	175	255	8	9	80	0.1125000
NODE_172855_length_297_cov_1.595960	175	255	10	4	80	0.0500000
NODE_172855_length_297_cov_1.595960	175	255	12	3	80	0.0375000
NODE_172855_length_297_cov_1.595960	175	255	13	1	80	0.0125000
NODE_172855_length_297_cov_1.595960	175	255	15	4	80	0.0500000
NODE_172855_length_297_cov_1.595960	175	255	17	22	80	0.2750000
NODE_172855_length_297_cov_1.595960	175	255	18	31	80	0.3875000
NODE_172862_length_297_cov_1.570707	100	177	0	74	77	0.9610389
NODE_172862_length_297_cov_1.570707	100	177	2	3	77	0.0389610
NODE_172863_length_297_cov_1.570707	194	275	0	81	81	1.0000000
NODE_173063_length_297_cov_1.338384	140	199	0	59	59	1.0000000
NODE_173136_length_297_cov_1.277778	39	115	0	76	76	1.0000000
NODE_173176_length_297_cov_1.196970	7	87	2	80	80	1.0000000
NODE_173176_length_297_cov_1.196970	60	116	1	3	56	0.0535714
NODE_173176_length_297_cov_1.196970	60	116	2	53	56	0.9464286
NODE_173345_length_297_cov_1.030303	0	33	0	33	33	1.0000000
NODE_173467_length_297_cov_0.888889	109	172	0	58	63	0.9206349
NODE_173467_length_297_cov_0.888889	109	172	2	5	63	0.0793651
NODE_173520_length_297_cov_0.782828	24	104	0	80	80	1.0000000
NODE_173708_length_296_cov_41.390863	189	260	31	12	71	0.1690141
NODE_173708_length_296_cov_41.390863	189	260	32	1	71	0.0140845
NODE_173708_length_296_cov_41.390863	189	260	33	2	71	0.0281690
NODE_173708_length_296_cov_41.390863	189	260	37	1	71	0.0140845
NODE_173708_length_296_cov_41.390863	189	260	39	23	71	0.3239437
NODE_173708_length_296_cov_41.390863	189	260	40	3	71	0.0422535
NODE_173708_length_296_cov_41.390863	189	260	42	3	71	0.0422535
NODE_173708_length_296_cov_41.390863	189	260	43	6	71	0.0845070
NODE_173708_length_296_cov_41.390863	189	260	45	2	71	0.0281690
NODE_173708_length_296_cov_41.390863	189	260	47	3	71	0.0422535
NODE_173708_length_296_cov_41.390863	189	260	48	4	71	0.0563380
NODE_173708_length_296_cov_41.390863	189	260	49	9	71	0.1267606
NODE_173708_length_296_cov_41.390863	189	260	51	2	71	0.0281690
NODE_173709_length_296_cov_34.776650	214	294	0	80	80	1.0000000
NODE_173758_length_296_cov_4.243655	14	54	0	40	40	1.0000000
NODE_173773_length_296_cov_3.954315	120	200	0	80	80	1.0000000
NODE_173787_length_296_cov_3.736041	6	46	0	40	40	1.0000000
NODE_173797_length_296_cov_3.619289	193	251	4	58	58	1.0000000
NODE_173797_length_296_cov_3.619289	246	296	0	2	50	0.0400000
NODE_173797_length_296_cov_3.619289	246	296	1	16	50	0.3200000
NODE_173797_length_296_cov_3.619289	246	296	3	2	50	0.0400000
NODE_173797_length_296_cov_3.619289	246	296	4	30	50	0.6000000
NODE_173859_length_296_cov_3.015228	177	257	4	36	80	0.4500000
NODE_173859_length_296_cov_3.015228	177	257	7	1	80	0.0125000
NODE_173859_length_296_cov_3.015228	177	257	8	43	80	0.5375000
NODE_173992_length_296_cov_2.309645	5	77	2	8	72	0.1111111
NODE_173992_length_296_cov_2.309645	5	77	6	4	72	0.0555556
NODE_173992_length_296_cov_2.309645	5	77	8	4	72	0.0555556
NODE_173992_length_296_cov_2.309645	5	77	10	4	72	0.0555556
NODE_173992_length_296_cov_2.309645	5	77	14	5	72	0.0694444
NODE_173992_length_296_cov_2.309645	5	77	16	13	72	0.1805556
NODE_173992_length_296_cov_2.309645	5	77	18	14	72	0.1944444
NODE_173992_length_296_cov_2.309645	5	77	20	20	72	0.2777778
NODE_173992_length_296_cov_2.309645	50	130	16	23	80	0.2875000
NODE_173992_length_296_cov_2.309645	50	130	18	28	80	0.3500000
NODE_173992_length_296_cov_2.309645	50	130	20	29	80	0.3625000
NODE_174040_length_296_cov_2.081218	90	139	0	49	49	1.0000000
NODE_174167_length_296_cov_1.807107	199	246	0	47	47	1.0000000
NODE_174167_length_296_cov_1.807107	219	296	0	77	77	1.0000000
NODE_174213_length_296_cov_1.670051	28	103	6	5	75	0.0666667
NODE_174213_length_296_cov_1.670051	28	103	8	25	75	0.3333333
NODE_174213_length_296_cov_1.670051	28	103	9	1	75	0.0133333
NODE_174213_length_296_cov_1.670051	28	103	10	5	75	0.0666667
NODE_174213_length_296_cov_1.670051	28	103	12	4	75	0.0533333
NODE_174213_length_296_cov_1.670051	28	103	14	11	75	0.1466667
NODE_174213_length_296_cov_1.670051	28	103	18	24	75	0.3200000
NODE_174274_length_296_cov_1.553299	102	179	0	69	77	0.8961039
NODE_174274_length_296_cov_1.553299	102	179	2	8	77	0.1038961
NODE_174274_length_296_cov_1.553299	160	179	0	11	19	0.5789474
NODE_174274_length_296_cov_1.553299	160	179	2	8	19	0.4210526
NODE_174438_length_296_cov_1.319797	82	162	0	80	80	1.0000000
NODE_174438_length_296_cov_1.319797	135	205	0	70	70	1.0000000
NODE_174545_length_296_cov_1.258883	222	280	0	6	58	0.1034483
NODE_174545_length_296_cov_1.258883	222	280	4	49	58	0.8448276
NODE_174545_length_296_cov_1.258883	222	280	6	3	58	0.0517241
NODE_174554_length_296_cov_1.238579	90	147	0	57	57	1.0000000
NODE_174614_length_296_cov_1.116751	130	169	2	39	39	1.0000000
NODE_175210_length_295_cov_4.290816	2	70	0	68	68	1.0000000
NODE_175210_length_295_cov_4.290816	55	123	0	68	68	1.0000000
NODE_175220_length_295_cov_4.040816	119	165	0	46	46	1.0000000
NODE_175258_length_295_cov_3.576531	130	198	0	68	68	1.0000000
NODE_175324_length_295_cov_2.918367	0	77	0	77	77	1.0000000
NODE_175416_length_295_cov_2.454082	216	277	2	61	61	1.0000000
NODE_175475_length_295_cov_2.224490	11	91	4	45	80	0.5625000
NODE_175475_length_295_cov_2.224490	11	91	6	17	80	0.2125000
NODE_175475_length_295_cov_2.224490	11	91	8	18	80	0.2250000
NODE_175483_length_295_cov_2.183673	93	151	12	1	58	0.0172414
NODE_175483_length_295_cov_2.183673	93	151	14	6	58	0.1034483
NODE_175483_length_295_cov_2.183673	93	151	16	1	58	0.0172414
NODE_175483_length_295_cov_2.183673	93	151	22	1	58	0.0172414
NODE_175483_length_295_cov_2.183673	93	151	25	4	58	0.0689655
NODE_175483_length_295_cov_2.183673	93	151	29	1	58	0.0172414
NODE_175483_length_295_cov_2.183673	93	151	33	4	58	0.0689655
NODE_175483_length_295_cov_2.183673	93	151	38	2	58	0.0344828
NODE_175483_length_295_cov_2.183673	93	151	44	1	58	0.0172414
NODE_175483_length_295_cov_2.183673	93	151	60	1	58	0.0172414
NODE_175483_length_295_cov_2.183673	93	151	65	1	58	0.0172414
NODE_175483_length_295_cov_2.183673	93	151	68	2	58	0.0344828
NODE_175483_length_295_cov_2.183673	93	151	71	4	58	0.0689655
NODE_175483_length_295_cov_2.183673	93	151	73	16	58	0.2758621
NODE_175483_length_295_cov_2.183673	93	151	81	5	58	0.0862069
NODE_175483_length_295_cov_2.183673	93	151	82	8	58	0.1379310
NODE_175483_length_295_cov_2.183673	124	204	73	14	80	0.1750000
NODE_175483_length_295_cov_2.183673	124	204	78	24	80	0.3000000
NODE_175483_length_295_cov_2.183673	124	204	80	15	80	0.1875000
NODE_175483_length_295_cov_2.183673	124	204	81	5	80	0.0625000
NODE_175483_length_295_cov_2.183673	124	204	82	22	80	0.2750000
NODE_175597_length_295_cov_1.867347	191	239	8	48	48	1.0000000
NODE_175598_length_295_cov_1.862245	225	285	0	15	60	0.2500000
NODE_175598_length_295_cov_1.862245	225	285	1	17	60	0.2833333
NODE_175598_length_295_cov_1.862245	225	285	2	28	60	0.4666667
NODE_175721_length_295_cov_1.596939	173	254	4	25	81	0.3086420
NODE_175721_length_295_cov_1.596939	173	254	6	5	81	0.0617284
NODE_175721_length_295_cov_1.596939	173	254	10	10	81	0.1234568
NODE_175721_length_295_cov_1.596939	173	254	12	41	81	0.5061728
NODE_175804_length_295_cov_1.520408	217	282	0	16	65	0.2461538
NODE_175804_length_295_cov_1.520408	217	282	2	49	65	0.7538462
NODE_175930_length_295_cov_1.301020	99	121	0	22	22	1.0000000
NODE_176250_length_295_cov_0.938776	200	247	0	43	47	0.9148936
NODE_176250_length_295_cov_0.938776	200	247	2	1	47	0.0212766
NODE_176250_length_295_cov_0.938776	200	247	4	3	47	0.0638298
NODE_176367_length_295_cov_0.780612	24	44	0	20	20	1.0000000
NODE_176436_length_295_cov_0.724490	6	87	0	81	81	1.0000000
NODE_176436_length_295_cov_0.724490	83	163	0	80	80	1.0000000
NODE_176436_length_295_cov_0.724490	136	216	0	80	80	1.0000000
NODE_176547_length_294_cov_83.882051	143	173	0	30	30	1.0000000
NODE_176547_length_294_cov_83.882051	209	239	0	30	30	1.0000000
NODE_176549_length_294_cov_50.589744	187	258	20	1	71	0.0140845
NODE_176549_length_294_cov_50.589744	187	258	22	1	71	0.0140845
NODE_176549_length_294_cov_50.589744	187	258	24	3	71	0.0422535
NODE_176549_length_294_cov_50.589744	187	258	25	3	71	0.0422535
NODE_176549_length_294_cov_50.589744	187	258	33	6	71	0.0845070
NODE_176549_length_294_cov_50.589744	187	258	39	1	71	0.0140845
NODE_176549_length_294_cov_50.589744	187	258	62	3	71	0.0422535
NODE_176549_length_294_cov_50.589744	187	258	69	1	71	0.0140845
NODE_176549_length_294_cov_50.589744	187	258	72	8	71	0.1126761
NODE_176549_length_294_cov_50.589744	187	258	74	2	71	0.0281690
NODE_176549_length_294_cov_50.589744	187	258	84	6	71	0.0845070
NODE_176549_length_294_cov_50.589744	187	258	90	2	71	0.0281690
NODE_176549_length_294_cov_50.589744	187	258	92	1	71	0.0140845
NODE_176549_length_294_cov_50.589744	187	258	94	2	71	0.0281690
NODE_176549_length_294_cov_50.589744	187	258	96	2	71	0.0281690
NODE_176549_length_294_cov_50.589744	187	258	98	2	71	0.0281690
NODE_176549_length_294_cov_50.589744	187	258	100	1	71	0.0140845
NODE_176549_length_294_cov_50.589744	187	258	102	2	71	0.0281690
NODE_176549_length_294_cov_50.589744	187	258	106	5	71	0.0704225
NODE_176549_length_294_cov_50.589744	187	258	109	1	71	0.0140845
NODE_176549_length_294_cov_50.589744	187	258	112	2	71	0.0281690
NODE_176549_length_294_cov_50.589744	187	258	113	1	71	0.0140845
NODE_176549_length_294_cov_50.589744	187	258	117	2	71	0.0281690
NODE_176549_length_294_cov_50.589744	187	258	119	2	71	0.0281690
NODE_176549_length_294_cov_50.589744	187	258	120	2	71	0.0281690
NODE_176549_length_294_cov_50.589744	187	258	127	1	71	0.0140845
NODE_176549_length_294_cov_50.589744	187	258	129	2	71	0.0281690
NODE_176549_length_294_cov_50.589744	187	258	131	1	71	0.0140845
NODE_176549_length_294_cov_50.589744	187	258	133	1	71	0.0140845
NODE_176549_length_294_cov_50.589744	187	258	134	1	71	0.0140845
NODE_176549_length_294_cov_50.589744	187	258	136	1	71	0.0140845
NODE_176549_length_294_cov_50.589744	187	258	140	1	71	0.0140845
NODE_176549_length_294_cov_50.589744	187	258	143	1	71	0.0140845
NODE_176561_length_294_cov_6.676923	61	138	0	77	77	1.0000000
NODE_176596_length_294_cov_4.538462	127	214	4	29	87	0.3333333
NODE_176596_length_294_cov_4.538462	127	214	8	11	87	0.1264368
NODE_176596_length_294_cov_4.538462	127	214	10	5	87	0.0574713
NODE_176596_length_294_cov_4.538462	127	214	12	42	87	0.4827586
NODE_176598_length_294_cov_4.512821	218	248	0	30	30	1.0000000
NODE_176600_length_294_cov_4.497436	159	200	0	41	41	1.0000000
NODE_176697_length_294_cov_2.953846	114	194	0	5	80	0.0625000
NODE_176697_length_294_cov_2.953846	114	194	2	6	80	0.0750000
NODE_176697_length_294_cov_2.953846	114	194	6	6	80	0.0750000
NODE_176697_length_294_cov_2.953846	114	194	10	1	80	0.0125000
NODE_176697_length_294_cov_2.953846	114	194	12	38	80	0.4750000
NODE_176697_length_294_cov_2.953846	114	194	14	24	80	0.3000000
NODE_176727_length_294_cov_2.764103	103	183	0	73	80	0.9125000
NODE_176727_length_294_cov_2.764103	103	183	2	7	80	0.0875000
NODE_176727_length_294_cov_2.764103	156	236	0	80	80	1.0000000
NODE_176728_length_294_cov_2.764103	224	282	0	44	58	0.7586207
NODE_176728_length_294_cov_2.764103	224	282	2	14	58	0.2413793
NODE_176728_length_294_cov_2.764103	225	277	0	39	52	0.7500000
NODE_176728_length_294_cov_2.764103	225	277	2	13	52	0.2500000
NODE_176735_length_294_cov_2.697436	204	261	4	57	57	1.0000000
NODE_176735_length_294_cov_2.697436	234	294	0	12	60	0.2000000
NODE_176735_length_294_cov_2.697436	234	294	4	48	60	0.8000000
NODE_176779_length_294_cov_2.517949	23	85	4	13	62	0.2096774
NODE_176779_length_294_cov_2.517949	23	85	8	49	62	0.7903226
NODE_176816_length_294_cov_2.353846	129	167	6	2	38	0.0526316
NODE_176816_length_294_cov_2.353846	129	167	8	36	38	0.9473684
NODE_176833_length_294_cov_2.338462	133	213	4	51	80	0.6375000
NODE_176833_length_294_cov_2.338462	133	213	6	14	80	0.1750000
NODE_176833_length_294_cov_2.338462	133	213	8	15	80	0.1875000
NODE_176943_length_294_cov_2.046154	219	269	0	50	50	1.0000000
NODE_176957_length_294_cov_2.010256	191	235	0	44	44	1.0000000
NODE_176999_length_294_cov_1.902564	52	83	0	27	31	0.8709677
NODE_176999_length_294_cov_1.902564	52	83	2	4	31	0.1290323
NODE_177102_length_294_cov_1.692308	46	112	0	66	66	1.0000000
NODE_177187_length_294_cov_1.569231	49	95	0	46	46	1.0000000
NODE_177252_length_294_cov_1.482051	28	108	0	80	80	1.0000000
NODE_177252_length_294_cov_1.482051	201	281	0	80	80	1.0000000
NODE_177252_length_294_cov_1.482051	201	281	0	80	80	1.0000000
NODE_177298_length_294_cov_1.420513	216	262	2	46	46	1.0000000
NODE_177298_length_294_cov_1.420513	235	294	0	32	59	0.5423729
NODE_177298_length_294_cov_1.420513	235	294	2	27	59	0.4576271
NODE_177972_length_294_cov_0.666667	245	293	0	48	48	1.0000000
NODE_178066_length_293_cov_6.257732	167	247	0	80	80	1.0000000
NODE_178161_length_293_cov_3.567010	50	130	10	54	80	0.6750000
NODE_178161_length_293_cov_3.567010	50	130	12	26	80	0.3250000
NODE_178226_length_293_cov_2.907216	218	281	0	63	63	1.0000000
NODE_178246_length_293_cov_2.768041	95	175	0	80	80	1.0000000
NODE_178246_length_293_cov_2.768041	148	228	0	80	80	1.0000000
NODE_178268_length_293_cov_2.628866	207	266	4	17	59	0.2881356
NODE_178268_length_293_cov_2.628866	207	266	5	28	59	0.4745763
NODE_178268_length_293_cov_2.628866	207	266	7	1	59	0.0169492
NODE_178268_length_293_cov_2.628866	207	266	8	13	59	0.2203390
NODE_178277_length_293_cov_2.623711	182	223	0	41	41	1.0000000
NODE_178299_length_293_cov_2.561856	139	192	0	53	53	1.0000000
NODE_178299_length_293_cov_2.561856	177	223	0	46	46	1.0000000
NODE_178317_length_293_cov_2.448454	98	158	0	60	60	1.0000000
NODE_178351_length_293_cov_2.335052	62	91	0	5	29	0.1724138
NODE_178351_length_293_cov_2.335052	62	91	2	24	29	0.8275862
NODE_178357_length_293_cov_2.314433	35	89	0	53	54	0.9814815
NODE_178357_length_293_cov_2.314433	35	89	2	1	54	0.0185185
NODE_178523_length_293_cov_1.840206	27	107	6	80	80	1.0000000
NODE_178523_length_293_cov_1.840206	80	160	0	21	80	0.2625000
NODE_178523_length_293_cov_1.840206	80	160	2	32	80	0.4000000
NODE_178523_length_293_cov_1.840206	80	160	6	27	80	0.3375000
NODE_178560_length_293_cov_1.804124	144	173	7	17	29	0.5862069
NODE_178560_length_293_cov_1.804124	144	173	9	2	29	0.0689655
NODE_178560_length_293_cov_1.804124	144	173	11	10	29	0.3448276
NODE_178570_length_293_cov_1.778351	224	258	2	34	34	1.0000000
NODE_178646_length_293_cov_1.577320	158	177	0	19	19	1.0000000
NODE_178692_length_293_cov_1.577320	161	225	0	64	64	1.0000000
NODE_178693_length_293_cov_1.577320	15	55	0	40	40	1.0000000
NODE_178788_length_293_cov_1.402062	3	72	0	69	69	1.0000000
NODE_178822_length_293_cov_1.319588	202	268	2	66	66	1.0000000
NODE_178927_length_293_cov_1.226804	84	141	0	57	57	1.0000000
NODE_179542_length_292_cov_4.523316	240	290	0	50	50	1.0000000
NODE_179552_length_292_cov_4.145078	106	186	0	14	80	0.1750000
NODE_179552_length_292_cov_4.145078	106	186	2	66	80	0.8250000
NODE_179604_length_292_cov_3.502591	129	205	2	3	76	0.0394737
NODE_179604_length_292_cov_3.502591	129	205	4	4	76	0.0526316
NODE_179604_length_292_cov_3.502591	129	205	6	4	76	0.0526316
NODE_179604_length_292_cov_3.502591	129	205	12	65	76	0.8552632
NODE_179613_length_292_cov_3.435233	176	200	0	24	24	1.0000000
NODE_179621_length_292_cov_3.341969	70	150	0	80	80	1.0000000
NODE_179621_length_292_cov_3.341969	118	175	0	57	57	1.0000000
NODE_179627_length_292_cov_3.222798	47	127	0	80	80	1.0000000
NODE_179627_length_292_cov_3.222798	100	129	0	29	29	1.0000000
NODE_179819_length_292_cov_2.238342	211	290	4	79	79	1.0000000
NODE_179943_length_292_cov_1.865285	34	114	57	18	80	0.2250000
NODE_179943_length_292_cov_1.865285	34	114	58	1	80	0.0125000
NODE_179943_length_292_cov_1.865285	34	114	60	22	80	0.2750000
NODE_179943_length_292_cov_1.865285	34	114	63	4	80	0.0500000
NODE_179943_length_292_cov_1.865285	34	114	64	2	80	0.0250000
NODE_179943_length_292_cov_1.865285	34	114	65	1	80	0.0125000
NODE_179943_length_292_cov_1.865285	34	114	66	13	80	0.1625000
NODE_179943_length_292_cov_1.865285	34	114	67	19	80	0.2375000
NODE_179943_length_292_cov_1.865285	87	167	15	9	80	0.1125000
NODE_179943_length_292_cov_1.865285	87	167	18	5	80	0.0625000
NODE_179943_length_292_cov_1.865285	87	167	26	18	80	0.2250000
NODE_179943_length_292_cov_1.865285	87	167	28	1	80	0.0125000
NODE_179943_length_292_cov_1.865285	87	167	43	2	80	0.0250000
NODE_179943_length_292_cov_1.865285	87	167	53	17	80	0.2125000
NODE_179943_length_292_cov_1.865285	87	167	57	19	80	0.2375000
NODE_179943_length_292_cov_1.865285	87	167	58	1	80	0.0125000
NODE_179943_length_292_cov_1.865285	87	167	60	8	80	0.1000000
NODE_180013_length_292_cov_1.761658	174	254	0	80	80	1.0000000
NODE_180029_length_292_cov_1.699482	0	80	0	43	80	0.5375000
NODE_180029_length_292_cov_1.699482	0	80	2	7	80	0.0875000
NODE_180029_length_292_cov_1.699482	0	80	4	14	80	0.1750000
NODE_180029_length_292_cov_1.699482	0	80	6	16	80	0.2000000
NODE_180068_length_292_cov_1.611399	89	157	0	2	68	0.0294118
NODE_180068_length_292_cov_1.611399	89	157	4	13	68	0.1911765
NODE_180068_length_292_cov_1.611399	89	157	6	3	68	0.0441176
NODE_180068_length_292_cov_1.611399	89	157	8	50	68	0.7352941
NODE_180210_length_292_cov_1.455959	72	115	7	17	43	0.3953488
NODE_180210_length_292_cov_1.455959	72	115	9	26	43	0.6046512
NODE_180210_length_292_cov_1.455959	203	265	1	44	62	0.7096774
NODE_180210_length_292_cov_1.455959	203	265	2	3	62	0.0483871
NODE_180210_length_292_cov_1.455959	203	265	4	15	62	0.2419355
NODE_180302_length_292_cov_1.321244	102	182	5	1	80	0.0125000
NODE_180302_length_292_cov_1.321244	102	182	6	79	80	0.9875000
NODE_180302_length_292_cov_1.321244	155	217	6	62	62	1.0000000
NODE_180968_length_291_cov_45.031250	71	145	15	1	74	0.0135135
NODE_180968_length_291_cov_45.031250	71	145	16	4	74	0.0540541
NODE_180968_length_291_cov_45.031250	71	145	32	1	74	0.0135135
NODE_180968_length_291_cov_45.031250	71	145	33	1	74	0.0135135
NODE_180968_length_291_cov_45.031250	71	145	34	9	74	0.1216216
NODE_180968_length_291_cov_45.031250	71	145	38	4	74	0.0540541
NODE_180968_length_291_cov_45.031250	71	145	40	3	74	0.0405405
NODE_180968_length_291_cov_45.031250	71	145	46	2	74	0.0270270
NODE_180968_length_291_cov_45.031250	71	145	48	49	74	0.6621622
NODE_180968_length_291_cov_45.031250	71	145	15	1	74	0.0135135
NODE_180968_length_291_cov_45.031250	71	145	16	4	74	0.0540541
NODE_180968_length_291_cov_45.031250	71	145	32	1	74	0.0135135
NODE_180968_length_291_cov_45.031250	71	145	33	1	74	0.0135135
NODE_180968_length_291_cov_45.031250	71	145	34	9	74	0.1216216
NODE_180968_length_291_cov_45.031250	71	145	38	4	74	0.0540541
NODE_180968_length_291_cov_45.031250	71	145	40	3	74	0.0405405
NODE_180968_length_291_cov_45.031250	71	145	46	2	74	0.0270270
NODE_180968_length_291_cov_45.031250	71	145	48	49	74	0.6621622
NODE_180968_length_291_cov_45.031250	118	184	4	3	66	0.0454545
NODE_180968_length_291_cov_45.031250	118	184	6	2	66	0.0303030
NODE_180968_length_291_cov_45.031250	118	184	7	17	66	0.2575758
NODE_180968_length_291_cov_45.031250	118	184	8	9	66	0.1363636
NODE_180968_length_291_cov_45.031250	118	184	9	4	66	0.0606061
NODE_180968_length_291_cov_45.031250	118	184	10	3	66	0.0454545
NODE_180968_length_291_cov_45.031250	118	184	11	1	66	0.0151515
NODE_180968_length_291_cov_45.031250	118	184	15	1	66	0.0151515
NODE_180968_length_291_cov_45.031250	118	184	16	4	66	0.0606061
NODE_180968_length_291_cov_45.031250	118	184	32	1	66	0.0151515
NODE_180968_length_291_cov_45.031250	118	184	33	1	66	0.0151515
NODE_180968_length_291_cov_45.031250	118	184	34	9	66	0.1363636
NODE_180968_length_291_cov_45.031250	118	184	38	4	66	0.0606061
NODE_180968_length_291_cov_45.031250	118	184	40	3	66	0.0454545
NODE_180968_length_291_cov_45.031250	118	184	46	2	66	0.0303030
NODE_180968_length_291_cov_45.031250	118	184	48	2	66	0.0303030
NODE_180969_length_291_cov_14.791667	125	205	0	80	80	1.0000000
NODE_180969_length_291_cov_14.791667	178	258	0	80	80	1.0000000
NODE_180983_length_291_cov_5.536458	97	169	0	72	72	1.0000000
NODE_180986_length_291_cov_5.401042	77	130	0	53	53	1.0000000
NODE_180998_length_291_cov_4.859375	185	257	2	72	72	1.0000000
NODE_181043_length_291_cov_3.723958	196	276	3	80	80	1.0000000
NODE_181057_length_291_cov_3.531250	129	152	0	23	23	1.0000000
NODE_181191_length_291_cov_2.390625	18	80	0	62	62	1.0000000
NODE_181272_length_291_cov_2.125000	70	117	0	47	47	1.0000000
NODE_181391_length_291_cov_1.859375	197	228	4	31	31	1.0000000
NODE_181497_length_291_cov_1.593750	144	175	0	31	31	1.0000000
NODE_181530_length_291_cov_1.593750	206	281	4	75	75	1.0000000
NODE_181599_length_291_cov_1.552083	189	269	0	25	80	0.3125000
NODE_181599_length_291_cov_1.552083	189	269	4	55	80	0.6875000
NODE_181615_length_291_cov_1.520833	180	258	0	78	78	1.0000000
NODE_181623_length_291_cov_1.510417	245	291	0	46	46	1.0000000
NODE_181696_length_291_cov_1.385417	80	120	0	40	40	1.0000000
NODE_181791_length_291_cov_1.322917	70	96	0	26	26	1.0000000
NODE_181799_length_291_cov_1.307292	108	188	8	7	80	0.0875000
NODE_181799_length_291_cov_1.307292	108	188	10	19	80	0.2375000
NODE_181799_length_291_cov_1.307292	108	188	12	18	80	0.2250000
NODE_181799_length_291_cov_1.307292	108	188	16	4	80	0.0500000
NODE_181799_length_291_cov_1.307292	108	188	18	4	80	0.0500000
NODE_181799_length_291_cov_1.307292	108	188	20	28	80	0.3500000
NODE_181907_length_291_cov_1.114583	79	174	37	1	95	0.0105263
NODE_181907_length_291_cov_1.114583	79	174	43	1	95	0.0105263
NODE_181907_length_291_cov_1.114583	79	174	47	3	95	0.0315789
NODE_181907_length_291_cov_1.114583	79	174	51	11	95	0.1157895
NODE_181907_length_291_cov_1.114583	79	174	53	5	95	0.0526316
NODE_181907_length_291_cov_1.114583	79	174	55	1	95	0.0105263
NODE_181907_length_291_cov_1.114583	79	174	57	10	95	0.1052632
NODE_181907_length_291_cov_1.114583	79	174	59	20	95	0.2105263
NODE_181907_length_291_cov_1.114583	79	174	61	9	95	0.0947368
NODE_181907_length_291_cov_1.114583	79	174	63	15	95	0.1578947
NODE_181907_length_291_cov_1.114583	79	174	65	19	95	0.2000000
NODE_181930_length_291_cov_1.078125	4	85	0	15	81	0.1851852
NODE_181930_length_291_cov_1.078125	4	85	2	21	81	0.2592593
NODE_181930_length_291_cov_1.078125	4	85	3	4	81	0.0493827
NODE_181930_length_291_cov_1.078125	4	85	4	9	81	0.1111111
NODE_181930_length_291_cov_1.078125	4	85	6	3	81	0.0370370
NODE_181930_length_291_cov_1.078125	4	85	8	23	81	0.2839506
NODE_181930_length_291_cov_1.078125	4	85	10	6	81	0.0740741
NODE_182112_length_291_cov_1.031250	5	50	0	45	45	1.0000000
NODE_182205_length_291_cov_0.890625	0	55	0	33	55	0.6000000
NODE_182205_length_291_cov_0.890625	0	55	2	10	55	0.1818182
NODE_182205_length_291_cov_0.890625	0	55	4	12	55	0.2181818
NODE_182252_length_291_cov_0.802083	80	160	0	32	80	0.4000000
NODE_182252_length_291_cov_0.802083	80	160	2	12	80	0.1500000
NODE_182252_length_291_cov_0.802083	80	160	6	10	80	0.1250000
NODE_182252_length_291_cov_0.802083	80	160	8	26	80	0.3250000
NODE_182491_length_290_cov_96.963351	44	124	0	80	80	1.0000000
NODE_182491_length_290_cov_96.963351	97	177	0	80	80	1.0000000
NODE_182512_length_290_cov_5.968586	89	150	0	2	61	0.0327869
NODE_182512_length_290_cov_5.968586	89	150	2	12	61	0.1967213
NODE_182512_length_290_cov_5.968586	89	150	3	26	61	0.4262295
NODE_182512_length_290_cov_5.968586	89	150	4	2	61	0.0327869
NODE_182512_length_290_cov_5.968586	89	150	5	5	61	0.0819672
NODE_182512_length_290_cov_5.968586	89	150	7	14	61	0.2295082
NODE_182512_length_290_cov_5.968586	142	203	6	15	61	0.2459016
NODE_182512_length_290_cov_5.968586	142	203	7	46	61	0.7540984
NODE_182535_length_290_cov_4.968586	32	52	0	20	20	1.0000000
NODE_182535_length_290_cov_4.968586	73	93	0	20	20	1.0000000
NODE_182547_length_290_cov_4.670157	63	139	0	11	76	0.1447368
NODE_182547_length_290_cov_4.670157	63	139	2	65	76	0.8552632
NODE_182550_length_290_cov_4.575916	110	153	0	43	43	1.0000000
NODE_182589_length_290_cov_3.816754	113	186	0	73	73	1.0000000
NODE_182607_length_290_cov_3.612565	114	181	2	67	67	1.0000000
NODE_182622_length_290_cov_3.445026	91	150	0	59	59	1.0000000
NODE_182772_length_290_cov_2.596859	189	218	0	29	29	1.0000000
NODE_182844_length_290_cov_2.319372	45	74	0	29	29	1.0000000
NODE_182973_length_290_cov_2.041885	59	139	4	7	80	0.0875000
NODE_182973_length_290_cov_2.041885	59	139	6	73	80	0.9125000
NODE_182995_length_290_cov_1.979058	229	271	8	5	42	0.1190476
NODE_182995_length_290_cov_1.979058	229	271	10	2	42	0.0476190
NODE_182995_length_290_cov_1.979058	229	271	12	10	42	0.2380952
NODE_182995_length_290_cov_1.979058	229	271	14	1	42	0.0238095
NODE_182995_length_290_cov_1.979058	229	271	16	4	42	0.0952381
NODE_182995_length_290_cov_1.979058	229	271	18	1	42	0.0238095
NODE_182995_length_290_cov_1.979058	229	271	20	7	42	0.1666667
NODE_182995_length_290_cov_1.979058	229	271	21	12	42	0.2857143
NODE_183288_length_290_cov_1.602094	16	68	0	7	52	0.1346154
NODE_183288_length_290_cov_1.602094	16	68	1	2	52	0.0384615
NODE_183288_length_290_cov_1.602094	16	68	4	38	52	0.7307692
NODE_183288_length_290_cov_1.602094	16	68	5	5	52	0.0961538
NODE_183347_length_290_cov_1.575916	173	250	0	77	77	1.0000000
NODE_183373_length_290_cov_1.544503	151	203	0	18	52	0.3461539
NODE_183373_length_290_cov_1.544503	151	203	4	34	52	0.6538461
NODE_183403_length_290_cov_1.513089	22	107	0	85	85	1.0000000
NODE_183436_length_290_cov_1.460733	11	91	0	80	80	1.0000000
NODE_183546_length_290_cov_1.335079	91	163	0	72	72	1.0000000
NODE_183546_length_290_cov_1.335079	144	216	0	72	72	1.0000000
NODE_183642_length_290_cov_1.314136	0	80	0	44	80	0.5500000
NODE_183642_length_290_cov_1.314136	0	80	2	36	80	0.4500000
NODE_183663_length_290_cov_1.287958	17	97	0	52	80	0.6500000
NODE_183663_length_290_cov_1.287958	17	97	2	28	80	0.3500000
NODE_183946_length_290_cov_1.068063	0	60	0	60	60	1.0000000
NODE_183946_length_290_cov_1.068063	33	113	0	80	80	1.0000000
NODE_184119_length_290_cov_1.000000	198	254	66	1	56	0.0178571
NODE_184119_length_290_cov_1.000000	198	254	78	1	56	0.0178571
NODE_184119_length_290_cov_1.000000	198	254	84	1	56	0.0178571
NODE_184119_length_290_cov_1.000000	198	254	86	3	56	0.0535714
NODE_184119_length_290_cov_1.000000	198	254	88	1	56	0.0178571
NODE_184119_length_290_cov_1.000000	198	254	89	3	56	0.0535714
NODE_184119_length_290_cov_1.000000	198	254	90	1	56	0.0178571
NODE_184119_length_290_cov_1.000000	198	254	92	1	56	0.0178571
NODE_184119_length_290_cov_1.000000	198	254	94	3	56	0.0535714
NODE_184119_length_290_cov_1.000000	198	254	96	9	56	0.1607143
NODE_184119_length_290_cov_1.000000	198	254	98	3	56	0.0535714
NODE_184119_length_290_cov_1.000000	198	254	100	1	56	0.0178571
NODE_184119_length_290_cov_1.000000	198	254	104	1	56	0.0178571
NODE_184119_length_290_cov_1.000000	198	254	105	4	56	0.0714286
NODE_184119_length_290_cov_1.000000	198	254	107	9	56	0.1607143
NODE_184119_length_290_cov_1.000000	198	254	111	5	56	0.0892857
NODE_184119_length_290_cov_1.000000	198	254	112	1	56	0.0178571
NODE_184119_length_290_cov_1.000000	198	254	113	8	56	0.1428571
NODE_184326_length_290_cov_0.832461	154	236	0	82	82	1.0000000
NODE_184585_length_290_cov_0.701571	201	281	0	80	80	1.0000000
NODE_184716_length_289_cov_554.947368	45	125	160	1	80	0.0125000
NODE_184716_length_289_cov_554.947368	45	125	161	1	80	0.0125000
NODE_184716_length_289_cov_554.947368	45	125	163	1	80	0.0125000
NODE_184716_length_289_cov_554.947368	45	125	169	1	80	0.0125000
NODE_184716_length_289_cov_554.947368	45	125	181	1	80	0.0125000
NODE_184716_length_289_cov_554.947368	45	125	185	1	80	0.0125000
NODE_184716_length_289_cov_554.947368	45	125	186	2	80	0.0250000
NODE_184716_length_289_cov_554.947368	45	125	188	2	80	0.0250000
NODE_184716_length_289_cov_554.947368	45	125	190	1	80	0.0125000
NODE_184716_length_289_cov_554.947368	45	125	194	1	80	0.0125000
NODE_184716_length_289_cov_554.947368	45	125	195	3	80	0.0375000
NODE_184716_length_289_cov_554.947368	45	125	199	1	80	0.0125000
NODE_184716_length_289_cov_554.947368	45	125	207	2	80	0.0250000
NODE_184716_length_289_cov_554.947368	45	125	209	1	80	0.0125000
NODE_184716_length_289_cov_554.947368	45	125	211	2	80	0.0250000
NODE_184716_length_289_cov_554.947368	45	125	217	1	80	0.0125000
NODE_184716_length_289_cov_554.947368	45	125	221	1	80	0.0125000
NODE_184716_length_289_cov_554.947368	45	125	227	1	80	0.0125000
NODE_184716_length_289_cov_554.947368	45	125	229	11	80	0.1375000
NODE_184716_length_289_cov_554.947368	45	125	231	1	80	0.0125000
NODE_184716_length_289_cov_554.947368	45	125	232	1	80	0.0125000
NODE_184716_length_289_cov_554.947368	45	125	233	1	80	0.0125000
NODE_184716_length_289_cov_554.947368	45	125	235	16	80	0.2000000
NODE_184716_length_289_cov_554.947368	45	125	236	4	80	0.0500000
NODE_184716_length_289_cov_554.947368	45	125	237	2	80	0.0250000
NODE_184716_length_289_cov_554.947368	45	125	238	5	80	0.0625000
NODE_184716_length_289_cov_554.947368	45	125	239	4	80	0.0500000
NODE_184716_length_289_cov_554.947368	45	125	241	7	80	0.0875000
NODE_184716_length_289_cov_554.947368	45	125	242	4	80	0.0500000
NODE_184729_length_289_cov_7.436842	181	229	0	48	48	1.0000000
NODE_184745_length_289_cov_5.789474	35	100	0	26	65	0.4000000
NODE_184745_length_289_cov_5.789474	35	100	2	39	65	0.6000000
NODE_184745_length_289_cov_5.789474	85	153	2	68	68	1.0000000
NODE_184745_length_289_cov_5.789474	146	181	0	10	35	0.2857143
NODE_184745_length_289_cov_5.789474	146	181	2	25	35	0.7142857
NODE_184781_length_289_cov_4.515789	192	254	0	62	62	1.0000000
NODE_184806_length_289_cov_4.136842	101	148	0	41	47	0.8723404
NODE_184806_length_289_cov_4.136842	101	148	2	6	47	0.1276596
NODE_184892_length_289_cov_2.973684	38	83	0	45	45	1.0000000
NODE_184960_length_289_cov_2.678947	105	168	8	17	63	0.2698413
NODE_184960_length_289_cov_2.678947	105	168	10	7	63	0.1111111
NODE_184960_length_289_cov_2.678947	105	168	12	12	63	0.1904762
NODE_184960_length_289_cov_2.678947	105	168	14	27	63	0.4285714
NODE_184960_length_289_cov_2.678947	158	204	10	14	46	0.3043478
NODE_184960_length_289_cov_2.678947	158	204	12	2	46	0.0434783
NODE_184960_length_289_cov_2.678947	158	204	14	15	46	0.3260870
NODE_184960_length_289_cov_2.678947	158	204	16	15	46	0.3260870
NODE_184963_length_289_cov_2.673684	216	263	0	47	47	1.0000000
NODE_185036_length_289_cov_2.378947	233	289	0	56	56	1.0000000
NODE_185152_length_289_cov_2.089474	26	91	0	65	65	1.0000000
NODE_185213_length_289_cov_1.921053	0	54	0	4	54	0.0740741
NODE_185213_length_289_cov_1.921053	0	54	2	50	54	0.9259259
NODE_185383_length_289_cov_1.642105	58	123	0	65	65	1.0000000
NODE_185570_length_289_cov_1.547368	81	124	0	14	43	0.3255814
NODE_185570_length_289_cov_1.547368	81	124	4	29	43	0.6744186
NODE_185617_length_289_cov_1.489474	192	274	0	82	82	1.0000000
NODE_185622_length_289_cov_1.484211	50	69	0	19	19	1.0000000
NODE_185708_length_289_cov_1.357895	31	74	0	41	43	0.9534883
NODE_185708_length_289_cov_1.357895	31	74	2	2	43	0.0465116
NODE_185852_length_289_cov_1.278947	239	270	0	31	31	1.0000000
NODE_185864_length_289_cov_1.252632	23	66	6	43	43	1.0000000
NODE_185926_length_289_cov_1.168421	40	100	2	49	60	0.8166667
NODE_185926_length_289_cov_1.168421	40	100	4	11	60	0.1833333
NODE_185937_length_289_cov_1.152632	0	50	0	50	50	1.0000000
NODE_185937_length_289_cov_1.152632	41	103	0	62	62	1.0000000
NODE_186095_length_289_cov_1.073684	152	198	0	46	46	1.0000000
NODE_186491_length_289_cov_0.878947	113	193	0	13	80	0.1625000
NODE_186491_length_289_cov_0.878947	113	193	4	16	80	0.2000000
NODE_186491_length_289_cov_0.878947	113	193	8	51	80	0.6375000
NODE_186491_length_289_cov_0.878947	166	246	4	16	80	0.2000000
NODE_186491_length_289_cov_0.878947	166	246	8	64	80	0.8000000
NODE_186507_length_289_cov_0.863158	116	211	8	2	95	0.0210526
NODE_186507_length_289_cov_0.863158	116	211	10	25	95	0.2631579
NODE_186507_length_289_cov_0.863158	116	211	12	4	95	0.0421053
NODE_186507_length_289_cov_0.863158	116	211	14	33	95	0.3473684
NODE_186507_length_289_cov_0.863158	116	211	16	2	95	0.0210526
NODE_186507_length_289_cov_0.863158	116	211	18	29	95	0.3052632
NODE_186515_length_289_cov_0.857895	6	75	0	69	69	1.0000000
NODE_186547_length_289_cov_0.831579	230	289	0	1	59	0.0169492
NODE_186547_length_289_cov_0.831579	230	289	2	14	59	0.2372881
NODE_186547_length_289_cov_0.831579	230	289	4	44	59	0.7457627
NODE_186631_length_289_cov_0.805263	98	159	0	11	61	0.1803279
NODE_186631_length_289_cov_0.805263	98	159	2	50	61	0.8196721
NODE_186865_length_289_cov_0.568421	141	213	0	72	72	1.0000000
NODE_186934_length_288_cov_11.089947	135	195	0	10	60	0.1666667
NODE_186934_length_288_cov_11.089947	135	195	4	12	60	0.2000000
NODE_186934_length_288_cov_11.089947	135	195	6	38	60	0.6333333
NODE_187025_length_288_cov_3.587302	108	188	0	80	80	1.0000000
NODE_187049_length_288_cov_3.296296	61	125	0	26	64	0.4062500
NODE_187049_length_288_cov_3.296296	61	125	2	38	64	0.5937500
NODE_187049_length_288_cov_3.296296	102	178	0	4	76	0.0526316
NODE_187049_length_288_cov_3.296296	102	178	2	72	76	0.9473684
NODE_187062_length_288_cov_3.206349	149	202	0	53	53	1.0000000
NODE_187170_length_288_cov_2.539683	4	68	25	2	64	0.0312500
NODE_187170_length_288_cov_2.539683	4	68	31	1	64	0.0156250
NODE_187170_length_288_cov_2.539683	4	68	33	1	64	0.0156250
NODE_187170_length_288_cov_2.539683	4	68	37	2	64	0.0312500
NODE_187170_length_288_cov_2.539683	4	68	41	2	64	0.0312500
NODE_187170_length_288_cov_2.539683	4	68	45	3	64	0.0468750
NODE_187170_length_288_cov_2.539683	4	68	47	4	64	0.0625000
NODE_187170_length_288_cov_2.539683	4	68	48	7	64	0.1093750
NODE_187170_length_288_cov_2.539683	4	68	49	35	64	0.5468750
NODE_187170_length_288_cov_2.539683	4	68	50	2	64	0.0312500
NODE_187170_length_288_cov_2.539683	4	68	51	5	64	0.0781250
NODE_187187_length_288_cov_2.465608	137	182	0	45	45	1.0000000
NODE_187191_length_288_cov_2.449735	216	278	0	16	62	0.2580645
NODE_187191_length_288_cov_2.449735	216	278	2	46	62	0.7419355
NODE_187191_length_288_cov_2.449735	237	273	0	11	36	0.3055556
NODE_187191_length_288_cov_2.449735	237	273	2	25	36	0.6944444
NODE_187248_length_288_cov_2.275132	10	46	2	36	36	1.0000000
NODE_187248_length_288_cov_2.275132	13	86	2	73	73	1.0000000
NODE_187248_length_288_cov_2.275132	47	100	0	2	53	0.0377358
NODE_187248_length_288_cov_2.275132	47	100	2	51	53	0.9622642
NODE_187318_length_288_cov_2.153439	50	81	2	31	31	1.0000000
NODE_187431_length_288_cov_1.915344	0	75	0	75	75	1.0000000
NODE_187443_length_288_cov_1.888889	49	125	0	76	76	1.0000000
NODE_187484_length_288_cov_1.878307	0	42	0	42	42	1.0000000
NODE_187484_length_288_cov_1.878307	15	63	0	48	48	1.0000000
NODE_187810_length_288_cov_1.492063	0	42	0	42	42	1.0000000
NODE_188135_length_288_cov_1.158730	213	288	0	75	75	1.0000000
NODE_188161_length_288_cov_1.100529	256	288	0	32	32	1.0000000
NODE_188169_length_288_cov_1.079365	10	74	0	64	64	1.0000000
NODE_188169_length_288_cov_1.079365	65	110	0	45	45	1.0000000
NODE_188760_length_288_cov_0.809524	141	170	2	6	29	0.2068966
NODE_188760_length_288_cov_0.809524	141	170	4	23	29	0.7931035
NODE_189068_length_287_cov_7.632979	117	184	27	7	67	0.1044776
NODE_189068_length_287_cov_7.632979	117	184	29	41	67	0.6119403
NODE_189068_length_287_cov_7.632979	117	184	30	11	67	0.1641791
NODE_189068_length_287_cov_7.632979	117	184	31	8	67	0.1194030
NODE_189079_length_287_cov_6.510638	20	100	0	80	80	1.0000000
NODE_189097_length_287_cov_5.781915	164	246	0	52	82	0.6341463
NODE_189097_length_287_cov_5.781915	164	246	2	30	82	0.3658537
NODE_189182_length_287_cov_3.590426	114	194	0	80	80	1.0000000
NODE_189192_length_287_cov_3.452128	0	52	0	52	52	1.0000000
NODE_189208_length_287_cov_3.281915	263	286	4	23	23	1.0000000
NODE_189266_length_287_cov_2.936170	41	110	0	69	69	1.0000000
NODE_189266_length_287_cov_2.936170	41	111	0	70	70	1.0000000
NODE_189266_length_287_cov_2.936170	94	167	0	52	73	0.7123288
NODE_189266_length_287_cov_2.936170	94	167	2	21	73	0.2876712
NODE_189266_length_287_cov_2.936170	156	179	2	23	23	1.0000000
NODE_189330_length_287_cov_2.638298	22	86	0	64	64	1.0000000
NODE_189381_length_287_cov_2.436170	182	262	0	80	80	1.0000000
NODE_189582_length_287_cov_1.984043	137	166	14	5	29	0.1724138
NODE_189582_length_287_cov_1.984043	137	166	16	6	29	0.2068966
NODE_189582_length_287_cov_1.984043	137	166	24	2	29	0.0689655
NODE_189582_length_287_cov_1.984043	137	166	26	16	29	0.5517241
NODE_189594_length_287_cov_1.941489	56	123	0	67	67	1.0000000
NODE_189614_length_287_cov_1.904255	8	51	0	42	43	0.9767442
NODE_189614_length_287_cov_1.904255	8	51	2	1	43	0.0232558
NODE_189710_length_287_cov_1.803191	146	217	0	3	71	0.0422535
NODE_189710_length_287_cov_1.803191	146	217	4	68	71	0.9577465
NODE_189843_length_287_cov_1.627660	113	175	9	9	62	0.1451613
NODE_189843_length_287_cov_1.627660	113	175	10	4	62	0.0645161
NODE_189843_length_287_cov_1.627660	113	175	11	47	62	0.7580645
NODE_189843_length_287_cov_1.627660	113	175	13	2	62	0.0322581
NODE_189843_length_287_cov_1.627660	148	228	6	1	80	0.0125000
NODE_189843_length_287_cov_1.627660	148	228	8	27	80	0.3375000
NODE_189843_length_287_cov_1.627660	148	228	9	11	80	0.1375000
NODE_189843_length_287_cov_1.627660	148	228	10	2	80	0.0250000
NODE_189843_length_287_cov_1.627660	148	228	11	39	80	0.4875000
NODE_189864_length_287_cov_1.627660	14	59	0	45	45	1.0000000
NODE_189864_length_287_cov_1.627660	41	112	0	71	71	1.0000000
NODE_189949_length_287_cov_1.574468	150	220	0	16	70	0.2285714
NODE_189949_length_287_cov_1.574468	150	220	2	54	70	0.7714286
NODE_189985_length_287_cov_1.531915	123	154	0	31	31	1.0000000
NODE_190122_length_287_cov_1.356383	93	147	0	54	54	1.0000000
NODE_190142_length_287_cov_1.356383	135	199	0	12	64	0.1875000
NODE_190142_length_287_cov_1.356383	135	199	2	52	64	0.8125000
NODE_190189_length_287_cov_1.335106	149	201	0	52	52	1.0000000
NODE_190654_length_287_cov_1.037234	23	44	0	21	21	1.0000000
NODE_190701_length_287_cov_0.994681	206	225	0	19	19	1.0000000
NODE_190802_length_287_cov_0.898936	0	57	0	3	57	0.0526316
NODE_190802_length_287_cov_0.898936	0	57	1	6	57	0.1052632
NODE_190802_length_287_cov_0.898936	0	57	2	6	57	0.1052632
NODE_190802_length_287_cov_0.898936	0	57	4	1	57	0.0175439
NODE_190802_length_287_cov_0.898936	0	57	5	6	57	0.1052632
NODE_190802_length_287_cov_0.898936	0	57	7	10	57	0.1754386
NODE_190802_length_287_cov_0.898936	0	57	19	1	57	0.0175439
NODE_190802_length_287_cov_0.898936	0	57	20	5	57	0.0877193
NODE_190802_length_287_cov_0.898936	0	57	25	1	57	0.0175439
NODE_190802_length_287_cov_0.898936	0	57	26	2	57	0.0350877
NODE_190802_length_287_cov_0.898936	0	57	28	8	57	0.1403509
NODE_190802_length_287_cov_0.898936	0	57	30	8	57	0.1403509
NODE_190873_length_287_cov_0.840426	46	121	2	11	75	0.1466667
NODE_190873_length_287_cov_0.840426	46	121	4	64	75	0.8533334
NODE_191306_length_286_cov_141.540107	4	63	0	3	59	0.0508475
NODE_191306_length_286_cov_141.540107	4	63	2	56	59	0.9491525
NODE_191389_length_286_cov_3.935829	79	123	0	12	44	0.2727273
NODE_191389_length_286_cov_3.935829	79	123	2	13	44	0.2954545
NODE_191389_length_286_cov_3.935829	79	123	4	19	44	0.4318182
NODE_191391_length_286_cov_3.871658	45	121	0	76	76	1.0000000
NODE_191391_length_286_cov_3.871658	102	169	0	20	67	0.2985075
NODE_191391_length_286_cov_3.871658	102	169	2	37	67	0.5522388
NODE_191391_length_286_cov_3.871658	102	169	4	10	67	0.1492537
NODE_191393_length_286_cov_3.812834	62	142	0	80	80	1.0000000
NODE_191430_length_286_cov_3.352941	63	143	0	80	80	1.0000000
NODE_191430_length_286_cov_3.352941	116	196	0	80	80	1.0000000
NODE_191466_length_286_cov_3.101604	217	271	0	54	54	1.0000000
NODE_191509_length_286_cov_2.823529	56	122	12	3	66	0.0454545
NODE_191509_length_286_cov_2.823529	56	122	18	4	66	0.0606061
NODE_191509_length_286_cov_2.823529	56	122	20	6	66	0.0909091
NODE_191509_length_286_cov_2.823529	56	122	21	1	66	0.0151515
NODE_191509_length_286_cov_2.823529	56	122	28	2	66	0.0303030
NODE_191509_length_286_cov_2.823529	56	122	30	2	66	0.0303030
NODE_191509_length_286_cov_2.823529	56	122	32	1	66	0.0151515
NODE_191509_length_286_cov_2.823529	56	122	36	1	66	0.0151515
NODE_191509_length_286_cov_2.823529	56	122	40	1	66	0.0151515
NODE_191509_length_286_cov_2.823529	56	122	42	1	66	0.0151515
NODE_191509_length_286_cov_2.823529	56	122	46	2	66	0.0303030
NODE_191509_length_286_cov_2.823529	56	122	50	2	66	0.0303030
NODE_191509_length_286_cov_2.823529	56	122	56	6	66	0.0909091
NODE_191509_length_286_cov_2.823529	56	122	58	3	66	0.0454545
NODE_191509_length_286_cov_2.823529	56	122	60	2	66	0.0303030
NODE_191509_length_286_cov_2.823529	56	122	62	1	66	0.0151515
NODE_191509_length_286_cov_2.823529	56	122	66	1	66	0.0151515
NODE_191509_length_286_cov_2.823529	56	122	68	1	66	0.0151515
NODE_191509_length_286_cov_2.823529	56	122	70	2	66	0.0303030
NODE_191509_length_286_cov_2.823529	56	122	72	2	66	0.0303030
NODE_191509_length_286_cov_2.823529	56	122	74	3	66	0.0454545
NODE_191509_length_286_cov_2.823529	56	122	76	1	66	0.0151515
NODE_191509_length_286_cov_2.823529	56	122	84	9	66	0.1363636
NODE_191509_length_286_cov_2.823529	56	122	86	9	66	0.1363636
NODE_191598_length_286_cov_2.438503	151	218	0	67	67	1.0000000
NODE_191754_length_286_cov_2.037433	57	138	0	2	81	0.0246914
NODE_191754_length_286_cov_2.037433	57	138	2	30	81	0.3703704
NODE_191754_length_286_cov_2.037433	57	138	4	49	81	0.6049383
NODE_191892_length_286_cov_1.807487	186	232	4	46	46	1.0000000
NODE_191892_length_286_cov_1.807487	239	285	0	31	46	0.6739131
NODE_191892_length_286_cov_1.807487	239	285	4	15	46	0.3260870
NODE_192100_length_286_cov_1.566845	112	160	0	2	48	0.0416667
NODE_192100_length_286_cov_1.566845	112	160	1	13	48	0.2708333
NODE_192100_length_286_cov_1.566845	112	160	3	33	48	0.6875000
NODE_192100_length_286_cov_1.566845	165	213	2	48	48	1.0000000
NODE_192150_length_286_cov_1.497326	107	160	4	53	53	1.0000000
NODE_192233_length_286_cov_1.363636	20	87	8	67	67	1.0000000
NODE_192302_length_286_cov_1.358289	218	262	0	44	44	1.0000000
NODE_192357_length_286_cov_1.304813	147	205	0	58	58	1.0000000
NODE_192427_length_286_cov_1.203209	30	76	0	46	46	1.0000000
NODE_192427_length_286_cov_1.203209	49	129	0	80	80	1.0000000
NODE_192757_length_286_cov_1.074866	160	220	0	60	60	1.0000000
NODE_193023_length_286_cov_0.871658	218	279	0	61	61	1.0000000
NODE_193038_length_286_cov_0.855615	224	281	0	33	57	0.5789474
NODE_193038_length_286_cov_0.855615	224	281	2	4	57	0.0701754
NODE_193038_length_286_cov_0.855615	224	281	4	2	57	0.0350877
NODE_193038_length_286_cov_0.855615	224	281	6	16	57	0.2807018
NODE_193038_length_286_cov_0.855615	224	281	8	2	57	0.0350877
NODE_193362_length_286_cov_0.625668	110	190	0	46	80	0.5750000
NODE_193362_length_286_cov_0.625668	110	190	2	10	80	0.1250000
NODE_193362_length_286_cov_0.625668	110	190	4	24	80	0.3000000
NODE_193362_length_286_cov_0.625668	163	240	0	77	77	1.0000000
NODE_193481_length_285_cov_7.392473	91	152	0	61	61	1.0000000
NODE_193481_length_285_cov_7.392473	150	184	0	34	34	1.0000000
NODE_193513_length_285_cov_4.650538	0	74	0	74	74	1.0000000
NODE_193513_length_285_cov_4.650538	47	127	0	80	80	1.0000000
NODE_193513_length_285_cov_4.650538	123	203	0	80	80	1.0000000
NODE_193513_length_285_cov_4.650538	176	256	0	80	80	1.0000000
NODE_193532_length_285_cov_4.091398	91	154	2	63	63	1.0000000
NODE_193538_length_285_cov_4.010753	120	201	0	81	81	1.0000000
NODE_193547_length_285_cov_3.854839	97	151	0	26	54	0.4814815
NODE_193547_length_285_cov_3.854839	97	151	1	28	54	0.5185185
NODE_193547_length_285_cov_3.854839	106	153	0	28	47	0.5957447
NODE_193547_length_285_cov_3.854839	106	153	1	19	47	0.4042553
NODE_193566_length_285_cov_3.607527	197	258	0	21	61	0.3442623
NODE_193566_length_285_cov_3.607527	197	258	1	4	61	0.0655738
NODE_193566_length_285_cov_3.607527	197	258	2	9	61	0.1475410
NODE_193566_length_285_cov_3.607527	197	258	3	2	61	0.0327869
NODE_193566_length_285_cov_3.607527	197	258	4	10	61	0.1639344
NODE_193566_length_285_cov_3.607527	197	258	6	14	61	0.2295082
NODE_193566_length_285_cov_3.607527	197	258	8	1	61	0.0163934
NODE_193624_length_285_cov_3.037634	190	272	4	75	82	0.9146342
NODE_193624_length_285_cov_3.037634	190	272	6	1	82	0.0121951
NODE_193624_length_285_cov_3.037634	190	272	8	6	82	0.0731707
NODE_193660_length_285_cov_2.806452	215	279	0	64	64	1.0000000
NODE_193688_length_285_cov_2.736559	106	173	0	67	67	1.0000000
NODE_193784_length_285_cov_2.311828	220	262	0	42	42	1.0000000
NODE_193883_length_285_cov_2.043011	77	150	0	73	73	1.0000000
NODE_193883_length_285_cov_2.043011	155	197	0	42	42	1.0000000
NODE_193978_length_285_cov_1.876344	67	110	0	43	43	1.0000000
NODE_194150_length_285_cov_1.645161	112	160	0	3	48	0.0625000
NODE_194150_length_285_cov_1.645161	112	160	2	2	48	0.0416667
NODE_194150_length_285_cov_1.645161	112	160	4	43	48	0.8958333
NODE_194260_length_285_cov_1.548387	124	172	0	48	48	1.0000000
NODE_194332_length_285_cov_1.456989	210	277	0	67	67	1.0000000
NODE_194499_length_285_cov_1.327957	114	191	3	4	77	0.0519481
NODE_194499_length_285_cov_1.327957	114	191	5	2	77	0.0259740
NODE_194499_length_285_cov_1.327957	114	191	7	5	77	0.0649351
NODE_194499_length_285_cov_1.327957	114	191	9	3	77	0.0389610
NODE_194499_length_285_cov_1.327957	114	191	10	6	77	0.0779221
NODE_194499_length_285_cov_1.327957	114	191	12	1	77	0.0129870
NODE_194499_length_285_cov_1.327957	114	191	14	3	77	0.0389610
NODE_194499_length_285_cov_1.327957	114	191	16	3	77	0.0389610
NODE_194499_length_285_cov_1.327957	114	191	18	5	77	0.0649351
NODE_194499_length_285_cov_1.327957	114	191	20	17	77	0.2207792
NODE_194499_length_285_cov_1.327957	114	191	22	28	77	0.3636364
NODE_194865_length_285_cov_1.096774	175	229	2	54	54	1.0000000
NODE_194865_length_285_cov_1.096774	230	271	0	19	41	0.4634146
NODE_194865_length_285_cov_1.096774	230	271	2	22	41	0.5365854
NODE_195109_length_285_cov_0.924731	128	208	0	80	80	1.0000000
NODE_195115_length_285_cov_0.919355	5	65	0	60	60	1.0000000
NODE_195124_length_285_cov_0.913978	6	80	0	74	74	1.0000000
NODE_195124_length_285_cov_0.913978	58	133	0	75	75	1.0000000
NODE_195642_length_284_cov_7.967568	143	207	8	1	64	0.0156250
NODE_195642_length_284_cov_7.967568	143	207	10	63	64	0.9843750
NODE_195667_length_284_cov_5.016216	115	169	0	54	54	1.0000000
NODE_195715_length_284_cov_3.913514	26	82	0	56	56	1.0000000
NODE_195760_length_284_cov_3.405405	209	283	0	74	74	1.0000000
NODE_195863_length_284_cov_2.718919	138	162	0	8	24	0.3333333
NODE_195863_length_284_cov_2.718919	138	162	2	7	24	0.2916667
NODE_195863_length_284_cov_2.718919	138	162	4	9	24	0.3750000
NODE_195863_length_284_cov_2.718919	138	215	0	8	77	0.1038961
NODE_195863_length_284_cov_2.718919	138	215	2	7	77	0.0909091
NODE_195863_length_284_cov_2.718919	138	215	4	62	77	0.8051948
NODE_196090_length_284_cov_2.097297	46	122	0	41	76	0.5394737
NODE_196090_length_284_cov_2.097297	46	122	2	1	76	0.0131579
NODE_196090_length_284_cov_2.097297	46	122	4	34	76	0.4473684
NODE_196253_length_284_cov_1.756757	27	100	0	73	73	1.0000000
NODE_196253_length_284_cov_1.756757	97	153	0	36	56	0.6428571
NODE_196253_length_284_cov_1.756757	97	153	2	20	56	0.3571429
NODE_196273_length_284_cov_1.713514	24	59	0	35	35	1.0000000
NODE_196372_length_284_cov_1.654054	207	251	2	44	44	1.0000000
NODE_196426_length_284_cov_1.643243	180	239	0	2	59	0.0338983
NODE_196426_length_284_cov_1.643243	180	239	2	57	59	0.9661017
NODE_196505_length_284_cov_1.540541	148	186	24	3	38	0.0789474
NODE_196505_length_284_cov_1.540541	148	186	28	2	38	0.0526316
NODE_196505_length_284_cov_1.540541	148	186	30	15	38	0.3947369
NODE_196505_length_284_cov_1.540541	148	186	32	11	38	0.2894737
NODE_196505_length_284_cov_1.540541	148	186	34	5	38	0.1315790
NODE_196505_length_284_cov_1.540541	148	186	36	2	38	0.0526316
NODE_196670_length_284_cov_1.378378	65	145	2	6	80	0.0750000
NODE_196670_length_284_cov_1.378378	65	145	6	66	80	0.8250000
NODE_196670_length_284_cov_1.378378	65	145	8	8	80	0.1000000
NODE_196670_length_284_cov_1.378378	118	165	6	19	47	0.4042553
NODE_196670_length_284_cov_1.378378	118	165	8	20	47	0.4255319
NODE_196670_length_284_cov_1.378378	118	165	12	8	47	0.1702128
NODE_196733_length_284_cov_1.329730	114	170	2	56	56	1.0000000
NODE_197755_length_284_cov_0.686486	13	94	0	81	81	1.0000000
NODE_197755_length_284_cov_0.686486	13	94	0	81	81	1.0000000
NODE_197755_length_284_cov_0.686486	13	94	0	81	81	1.0000000
NODE_197835_length_284_cov_0.551351	167	219	0	52	52	1.0000000
NODE_197936_length_283_cov_4.434783	81	137	41	13	56	0.2321429
NODE_197936_length_283_cov_4.434783	81	137	42	28	56	0.5000000
NODE_197936_length_283_cov_4.434783	81	137	43	5	56	0.0892857
NODE_197936_length_283_cov_4.434783	81	137	44	10	56	0.1785714
NODE_197936_length_283_cov_4.434783	114	190	0	1	76	0.0131579
NODE_197936_length_283_cov_4.434783	114	190	1	2	76	0.0263158
NODE_197936_length_283_cov_4.434783	114	190	2	5	76	0.0657895
NODE_197936_length_283_cov_4.434783	114	190	6	1	76	0.0131579
NODE_197936_length_283_cov_4.434783	114	190	9	6	76	0.0789474
NODE_197936_length_283_cov_4.434783	114	190	16	14	76	0.1842105
NODE_197936_length_283_cov_4.434783	114	190	22	5	76	0.0657895
NODE_197936_length_283_cov_4.434783	114	190	28	3	76	0.0394737
NODE_197936_length_283_cov_4.434783	114	190	30	2	76	0.0263158
NODE_197936_length_283_cov_4.434783	114	190	34	2	76	0.0263158
NODE_197936_length_283_cov_4.434783	114	190	36	5	76	0.0657895
NODE_197936_length_283_cov_4.434783	114	190	38	2	76	0.0263158
NODE_197936_length_283_cov_4.434783	114	190	41	18	76	0.2368421
NODE_197936_length_283_cov_4.434783	114	190	42	10	76	0.1315790
NODE_197936_length_283_cov_4.434783	190	270	0	25	80	0.3125000
NODE_197936_length_283_cov_4.434783	190	270	2	55	80	0.6875000
NODE_197937_length_283_cov_4.429348	104	168	18	16	64	0.2500000
NODE_197937_length_283_cov_4.429348	104	168	19	8	64	0.1250000
NODE_197937_length_283_cov_4.429348	104	168	21	5	64	0.0781250
NODE_197937_length_283_cov_4.429348	104	168	22	35	64	0.5468750
NODE_197937_length_283_cov_4.429348	104	168	18	16	64	0.2500000
NODE_197937_length_283_cov_4.429348	104	168	19	8	64	0.1250000
NODE_197937_length_283_cov_4.429348	104	168	21	5	64	0.0781250
NODE_197937_length_283_cov_4.429348	104	168	22	35	64	0.5468750
NODE_197937_length_283_cov_4.429348	141	207	14	17	66	0.2575758
NODE_197937_length_283_cov_4.429348	141	207	16	20	66	0.3030303
NODE_197937_length_283_cov_4.429348	141	207	19	10	66	0.1515152
NODE_197937_length_283_cov_4.429348	141	207	22	19	66	0.2878788
NODE_197937_length_283_cov_4.429348	141	221	10	7	80	0.0875000
NODE_197937_length_283_cov_4.429348	141	221	14	24	80	0.3000000
NODE_197937_length_283_cov_4.429348	141	221	16	20	80	0.2500000
NODE_197937_length_283_cov_4.429348	141	221	19	10	80	0.1250000
NODE_197937_length_283_cov_4.429348	141	221	22	19	80	0.2375000
NODE_198007_length_283_cov_3.369565	0	35	0	35	35	1.0000000
NODE_198022_length_283_cov_3.309783	47	91	0	44	44	1.0000000
NODE_198081_length_283_cov_2.923913	95	137	0	6	42	0.1428571
NODE_198081_length_283_cov_2.923913	95	137	1	8	42	0.1904762
NODE_198081_length_283_cov_2.923913	95	137	2	26	42	0.6190476
NODE_198081_length_283_cov_2.923913	95	137	7	1	42	0.0238095
NODE_198081_length_283_cov_2.923913	95	137	8	1	42	0.0238095
NODE_198081_length_283_cov_2.923913	110	190	2	25	80	0.3125000
NODE_198081_length_283_cov_2.923913	110	190	7	1	80	0.0125000
NODE_198081_length_283_cov_2.923913	110	190	8	54	80	0.6750000
NODE_198098_length_283_cov_2.782609	120	200	2	80	80	1.0000000
NODE_198109_length_283_cov_2.771739	29	72	0	43	43	1.0000000
NODE_198171_length_283_cov_2.494565	186	229	0	43	43	1.0000000
NODE_198176_length_283_cov_2.494565	181	238	0	57	57	1.0000000
NODE_198271_length_283_cov_2.217391	222	281	0	59	59	1.0000000
NODE_198518_length_283_cov_1.777174	40	120	0	80	80	1.0000000
NODE_198745_length_283_cov_1.543478	125	161	4	1	36	0.0277778
NODE_198745_length_283_cov_1.543478	125	161	5	1	36	0.0277778
NODE_198745_length_283_cov_1.543478	125	161	7	1	36	0.0277778
NODE_198745_length_283_cov_1.543478	125	161	9	5	36	0.1388889
NODE_198745_length_283_cov_1.543478	125	161	13	1	36	0.0277778
NODE_198745_length_283_cov_1.543478	125	161	15	6	36	0.1666667
NODE_198745_length_283_cov_1.543478	125	161	17	5	36	0.1388889
NODE_198745_length_283_cov_1.543478	125	161	19	1	36	0.0277778
NODE_198745_length_283_cov_1.543478	125	161	20	3	36	0.0833333
NODE_198745_length_283_cov_1.543478	125	161	22	8	36	0.2222222
NODE_198745_length_283_cov_1.543478	125	161	24	4	36	0.1111111
NODE_198751_length_283_cov_1.538043	182	203	0	21	21	1.0000000
NODE_198986_length_283_cov_1.304348	208	270	8	2	62	0.0322581
NODE_198986_length_283_cov_1.304348	208	270	10	2	62	0.0322581
NODE_198986_length_283_cov_1.304348	208	270	12	26	62	0.4193548
NODE_198986_length_283_cov_1.304348	208	270	14	32	62	0.5161290
NODE_199042_length_283_cov_1.211957	157	234	2	77	77	1.0000000
NODE_199070_length_283_cov_1.168478	183	250	0	6	67	0.0895522
NODE_199070_length_283_cov_1.168478	183	250	4	17	67	0.2537313
NODE_199070_length_283_cov_1.168478	183	250	6	44	67	0.6567164
NODE_199606_length_283_cov_0.918478	146	226	4	1	80	0.0125000
NODE_199606_length_283_cov_0.918478	146	226	6	79	80	0.9875000
NODE_199606_length_283_cov_0.918478	199	279	2	49	80	0.6125000
NODE_199606_length_283_cov_0.918478	199	279	4	5	80	0.0625000
NODE_199606_length_283_cov_0.918478	199	279	6	26	80	0.3250000
NODE_199641_length_283_cov_0.885870	143	205	0	62	62	1.0000000
NODE_199958_length_283_cov_0.706522	119	159	2	40	40	1.0000000
NODE_200085_length_282_cov_51.027322	219	280	0	61	61	1.0000000
NODE_200085_length_282_cov_51.027322	219	282	0	63	63	1.0000000
NODE_200166_length_282_cov_3.901639	38	118	0	80	80	1.0000000
NODE_200166_length_282_cov_3.901639	91	171	0	80	80	1.0000000
NODE_200171_length_282_cov_3.874317	96	116	0	20	20	1.0000000
NODE_200201_length_282_cov_3.562842	224	279	0	55	55	1.0000000
NODE_200270_length_282_cov_2.890710	41	123	0	82	82	1.0000000
NODE_200276_length_282_cov_2.846995	26	47	0	21	21	1.0000000
NODE_200304_length_282_cov_2.770492	145	225	0	80	80	1.0000000
NODE_200304_length_282_cov_2.770492	198	278	0	80	80	1.0000000
NODE_200329_length_282_cov_2.655738	46	119	6	34	73	0.4657534
NODE_200329_length_282_cov_2.655738	46	119	8	39	73	0.5342466
NODE_200329_length_282_cov_2.655738	100	159	4	8	59	0.1355932
NODE_200329_length_282_cov_2.655738	100	159	6	23	59	0.3898305
NODE_200329_length_282_cov_2.655738	100	159	8	28	59	0.4745763
NODE_200335_length_282_cov_2.622951	0	36	0	36	36	1.0000000
NODE_200335_length_282_cov_2.622951	9	89	0	80	80	1.0000000
NODE_200336_length_282_cov_2.622951	38	111	0	23	73	0.3150685
NODE_200336_length_282_cov_2.622951	38	111	2	34	73	0.4657534
NODE_200336_length_282_cov_2.622951	38	111	4	16	73	0.2191781
NODE_200336_length_282_cov_2.622951	98	144	4	15	46	0.3260870
NODE_200336_length_282_cov_2.622951	98	144	6	17	46	0.3695652
NODE_200336_length_282_cov_2.622951	98	144	8	14	46	0.3043478
NODE_200367_length_282_cov_2.508197	138	186	0	48	48	1.0000000
NODE_200367_length_282_cov_2.508197	191	234	0	43	43	1.0000000
NODE_200425_length_282_cov_2.289617	68	137	2	35	69	0.5072464
NODE_200425_length_282_cov_2.289617	68	137	4	34	69	0.4927536
NODE_200443_length_282_cov_2.229508	169	249	0	80	80	1.0000000
NODE_200501_length_282_cov_2.163934	138	192	0	54	54	1.0000000
NODE_200634_length_282_cov_1.901639	149	216	0	6	67	0.0895522
NODE_200634_length_282_cov_1.901639	149	216	2	61	67	0.9104478
NODE_200924_length_282_cov_1.612022	123	162	0	32	39	0.8205128
NODE_200924_length_282_cov_1.612022	123	162	4	7	39	0.1794872
NODE_201084_length_282_cov_1.393443	158	225	0	67	67	1.0000000
NODE_201219_length_282_cov_1.273224	91	140	0	49	49	1.0000000
NODE_201413_length_282_cov_1.114754	5	53	0	8	48	0.1666667
NODE_201413_length_282_cov_1.114754	5	53	2	40	48	0.8333333
NODE_202284_length_281_cov_7.895604	165	210	2	11	45	0.2444444
NODE_202284_length_281_cov_7.895604	165	210	4	4	45	0.0888889
NODE_202284_length_281_cov_7.895604	165	210	6	25	45	0.5555556
NODE_202284_length_281_cov_7.895604	165	210	8	2	45	0.0444444
NODE_202284_length_281_cov_7.895604	165	210	9	2	45	0.0444444
NODE_202284_length_281_cov_7.895604	165	210	11	1	45	0.0222222
NODE_202284_length_281_cov_7.895604	183	263	0	24	80	0.3000000
NODE_202284_length_281_cov_7.895604	183	263	2	40	80	0.5000000
NODE_202284_length_281_cov_7.895604	183	263	4	4	80	0.0500000
NODE_202284_length_281_cov_7.895604	183	263	6	12	80	0.1500000
NODE_202294_length_281_cov_6.379121	151	231	0	80	80	1.0000000
NODE_202333_length_281_cov_4.565934	71	127	0	56	56	1.0000000
NODE_202337_length_281_cov_4.494505	211	261	0	50	50	1.0000000
NODE_202356_length_281_cov_4.219780	85	135	0	50	50	1.0000000
NODE_202356_length_281_cov_4.219780	145	188	0	43	43	1.0000000
NODE_202401_length_281_cov_3.620879	245	281	0	36	36	1.0000000
NODE_202421_length_281_cov_3.324176	104	161	0	2	57	0.0350877
NODE_202421_length_281_cov_3.324176	104	161	4	1	57	0.0175439
NODE_202421_length_281_cov_3.324176	104	161	6	5	57	0.0877193
NODE_202421_length_281_cov_3.324176	104	161	8	8	57	0.1403509
NODE_202421_length_281_cov_3.324176	104	161	10	14	57	0.2456140
NODE_202421_length_281_cov_3.324176	104	161	14	27	57	0.4736842
NODE_202421_length_281_cov_3.324176	112	192	8	8	80	0.1000000
NODE_202421_length_281_cov_3.324176	112	192	10	14	80	0.1750000
NODE_202421_length_281_cov_3.324176	112	192	12	1	80	0.0125000
NODE_202421_length_281_cov_3.324176	112	192	14	57	80	0.7125000
NODE_202436_length_281_cov_3.197802	6	80	0	74	74	1.0000000
NODE_202473_length_281_cov_2.923077	92	150	0	58	58	1.0000000
NODE_202650_length_281_cov_2.241758	5	58	0	53	53	1.0000000
NODE_202712_length_281_cov_2.120879	56	136	0	80	80	1.0000000
NODE_202788_length_281_cov_1.961538	199	270	0	9	71	0.1267606
NODE_202788_length_281_cov_1.961538	199	270	4	62	71	0.8732395
NODE_203008_length_281_cov_1.675824	147	199	0	1	52	0.0192308
NODE_203008_length_281_cov_1.675824	147	199	4	51	52	0.9807692
NODE_203008_length_281_cov_1.675824	178	198	4	20	20	1.0000000
NODE_203008_length_281_cov_1.675824	200	241	0	41	41	1.0000000
NODE_203065_length_281_cov_1.653846	29	65	0	36	36	1.0000000
NODE_203168_length_281_cov_1.483516	85	135	0	50	50	1.0000000
NODE_203168_length_281_cov_1.483516	86	166	0	80	80	1.0000000
NODE_203168_length_281_cov_1.483516	139	184	0	45	45	1.0000000
NODE_203183_length_281_cov_1.461538	223	276	0	16	53	0.3018868
NODE_203183_length_281_cov_1.461538	223	276	2	37	53	0.6981132
NODE_203262_length_281_cov_1.401099	237	281	0	44	44	1.0000000
NODE_203281_length_281_cov_1.401099	150	214	0	26	64	0.4062500
NODE_203281_length_281_cov_1.401099	150	214	6	16	64	0.2500000
NODE_203281_length_281_cov_1.401099	150	214	8	22	64	0.3437500
NODE_203281_length_281_cov_1.401099	187	267	0	79	80	0.9875000
NODE_203281_length_281_cov_1.401099	187	267	6	1	80	0.0125000
NODE_203292_length_281_cov_1.401099	31	111	0	80	80	1.0000000
NODE_203440_length_281_cov_1.186813	0	79	0	44	79	0.5569620
NODE_203440_length_281_cov_1.186813	0	79	2	4	79	0.0506329
NODE_203440_length_281_cov_1.186813	0	79	3	5	79	0.0632911
NODE_203440_length_281_cov_1.186813	0	79	5	3	79	0.0379747
NODE_203440_length_281_cov_1.186813	0	79	7	1	79	0.0126582
NODE_203440_length_281_cov_1.186813	0	79	8	1	79	0.0126582
NODE_203440_length_281_cov_1.186813	0	79	9	8	79	0.1012658
NODE_203440_length_281_cov_1.186813	0	79	11	3	79	0.0379747
NODE_203440_length_281_cov_1.186813	0	79	13	10	79	0.1265823
NODE_203440_length_281_cov_1.186813	52	132	3	1	80	0.0125000
NODE_203440_length_281_cov_1.186813	52	132	5	3	80	0.0375000
NODE_203440_length_281_cov_1.186813	52	132	7	1	80	0.0125000
NODE_203440_length_281_cov_1.186813	52	132	8	1	80	0.0125000
NODE_203440_length_281_cov_1.186813	52	132	9	8	80	0.1000000
NODE_203440_length_281_cov_1.186813	52	132	11	3	80	0.0375000
NODE_203440_length_281_cov_1.186813	52	132	13	12	80	0.1500000
NODE_203440_length_281_cov_1.186813	52	132	15	6	80	0.0750000
NODE_203440_length_281_cov_1.186813	52	132	17	3	80	0.0375000
NODE_203440_length_281_cov_1.186813	52	132	19	6	80	0.0750000
NODE_203440_length_281_cov_1.186813	52	132	20	15	80	0.1875000
NODE_203440_length_281_cov_1.186813	52	132	22	21	80	0.2625000
NODE_203516_length_281_cov_1.120879	47	82	0	35	35	1.0000000
NODE_203534_length_281_cov_1.120879	243	276	0	33	33	1.0000000
NODE_203544_length_281_cov_1.120879	216	281	0	65	65	1.0000000
NODE_203785_length_281_cov_1.060440	139	179	18	2	40	0.0500000
NODE_203785_length_281_cov_1.060440	139	179	20	12	40	0.3000000
NODE_203785_length_281_cov_1.060440	139	179	24	5	40	0.1250000
NODE_203785_length_281_cov_1.060440	139	179	26	1	40	0.0250000
NODE_203785_length_281_cov_1.060440	139	179	28	3	40	0.0750000
NODE_203785_length_281_cov_1.060440	139	179	30	3	40	0.0750000
NODE_203785_length_281_cov_1.060440	139	179	34	7	40	0.1750000
NODE_203785_length_281_cov_1.060440	139	179	36	7	40	0.1750000
NODE_204094_length_281_cov_0.840659	72	138	0	66	66	1.0000000
NODE_204094_length_281_cov_0.840659	111	191	0	80	80	1.0000000
NODE_204467_length_280_cov_39.320442	118	198	0	80	80	1.0000000
NODE_204467_length_280_cov_39.320442	181	251	0	70	70	1.0000000
NODE_204468_length_280_cov_34.259669	97	137	0	1	40	0.0250000
NODE_204468_length_280_cov_34.259669	97	137	2	1	40	0.0250000
NODE_204468_length_280_cov_34.259669	97	137	3	2	40	0.0500000
NODE_204468_length_280_cov_34.259669	97	137	4	1	40	0.0250000
NODE_204468_length_280_cov_34.259669	97	137	6	1	40	0.0250000
NODE_204468_length_280_cov_34.259669	97	137	8	5	40	0.1250000
NODE_204468_length_280_cov_34.259669	97	137	10	17	40	0.4250000
NODE_204468_length_280_cov_34.259669	97	137	12	3	40	0.0750000
NODE_204468_length_280_cov_34.259669	97	137	14	1	40	0.0250000
NODE_204468_length_280_cov_34.259669	97	137	16	2	40	0.0500000
NODE_204468_length_280_cov_34.259669	97	137	18	3	40	0.0750000
NODE_204468_length_280_cov_34.259669	97	137	20	3	40	0.0750000
NODE_204532_length_280_cov_4.287293	53	100	0	47	47	1.0000000
NODE_204532_length_280_cov_4.287293	129	186	0	57	57	1.0000000
NODE_204596_length_280_cov_3.436464	34	103	16	6	69	0.0869565
NODE_204596_length_280_cov_3.436464	34	103	36	1	69	0.0144928
NODE_204596_length_280_cov_3.436464	34	103	38	1	69	0.0144928
NODE_204596_length_280_cov_3.436464	34	103	40	1	69	0.0144928
NODE_204596_length_280_cov_3.436464	34	103	42	1	69	0.0144928
NODE_204596_length_280_cov_3.436464	34	103	49	1	69	0.0144928
NODE_204596_length_280_cov_3.436464	34	103	51	7	69	0.1014493
NODE_204596_length_280_cov_3.436464	34	103	53	1	69	0.0144928
NODE_204596_length_280_cov_3.436464	34	103	57	1	69	0.0144928
NODE_204596_length_280_cov_3.436464	34	103	61	3	69	0.0434783
NODE_204596_length_280_cov_3.436464	34	103	67	4	69	0.0579710
NODE_204596_length_280_cov_3.436464	34	103	71	8	69	0.1159420
NODE_204596_length_280_cov_3.436464	34	103	73	2	69	0.0289855
NODE_204596_length_280_cov_3.436464	34	103	75	32	69	0.4637681
NODE_204597_length_280_cov_3.430939	17	97	0	1	80	0.0125000
NODE_204597_length_280_cov_3.430939	17	97	2	46	80	0.5750000
NODE_204597_length_280_cov_3.430939	17	97	3	33	80	0.4125000
NODE_204597_length_280_cov_3.430939	27	97	0	1	70	0.0142857
NODE_204597_length_280_cov_3.430939	27	97	2	36	70	0.5142857
NODE_204597_length_280_cov_3.430939	27	97	3	33	70	0.4714286
NODE_204674_length_280_cov_2.988950	118	164	0	46	46	1.0000000
NODE_204938_length_280_cov_2.165746	2	48	0	46	46	1.0000000
NODE_204938_length_280_cov_2.165746	6	48	0	42	42	1.0000000
NODE_204938_length_280_cov_2.165746	21	101	0	80	80	1.0000000
NODE_204938_length_280_cov_2.165746	22	101	0	79	79	1.0000000
NODE_204938_length_280_cov_2.165746	32	101	0	69	69	1.0000000
NODE_204976_length_280_cov_2.022099	105	148	0	43	43	1.0000000
NODE_204976_length_280_cov_2.022099	121	148	0	27	27	1.0000000
NODE_205044_length_280_cov_1.889503	50	132	0	1	82	0.0121951
NODE_205044_length_280_cov_1.889503	50	132	2	81	82	0.9878049
NODE_205062_length_280_cov_1.828729	45	75	24	4	30	0.1333333
NODE_205062_length_280_cov_1.828729	45	75	26	26	30	0.8666667
NODE_205410_length_280_cov_1.425414	17	50	0	33	33	1.0000000
NODE_205410_length_280_cov_1.425414	70	112	0	41	42	0.9761904
NODE_205410_length_280_cov_1.425414	70	112	2	1	42	0.0238095
NODE_205416_length_280_cov_1.414365	37	97	0	2	60	0.0333333
NODE_205416_length_280_cov_1.414365	37	97	2	10	60	0.1666667
NODE_205416_length_280_cov_1.414365	37	97	4	48	60	0.8000000
NODE_205633_length_280_cov_1.187845	56	136	0	80	80	1.0000000
NODE_205635_length_280_cov_1.182320	154	234	0	20	80	0.2500000
NODE_205635_length_280_cov_1.182320	154	234	2	5	80	0.0625000
NODE_205635_length_280_cov_1.182320	154	234	6	14	80	0.1750000
NODE_205635_length_280_cov_1.182320	154	234	8	41	80	0.5125000
NODE_205635_length_280_cov_1.182320	207	280	0	66	73	0.9041096
NODE_205635_length_280_cov_1.182320	207	280	2	5	73	0.0684932
NODE_205635_length_280_cov_1.182320	207	280	6	2	73	0.0273973
NODE_205701_length_280_cov_1.127072	204	265	2	52	61	0.8524590
NODE_205701_length_280_cov_1.127072	204	265	4	9	61	0.1475410
NODE_205794_length_280_cov_1.127072	0	39	0	39	39	1.0000000
NODE_205801_length_280_cov_1.127072	218	253	0	35	35	1.0000000
NODE_205894_length_280_cov_1.127072	0	59	0	59	59	1.0000000
NODE_206211_length_280_cov_0.911602	176	256	0	3	80	0.0375000
NODE_206211_length_280_cov_0.911602	176	256	2	4	80	0.0500000
NODE_206211_length_280_cov_0.911602	176	256	4	73	80	0.9125000
NODE_206211_length_280_cov_0.911602	229	280	0	27	51	0.5294118
NODE_206211_length_280_cov_0.911602	229	280	2	4	51	0.0784314
NODE_206211_length_280_cov_0.911602	229	280	4	20	51	0.3921569
NODE_206319_length_280_cov_0.845304	211	268	0	57	57	1.0000000
NODE_206531_length_280_cov_0.779006	129	203	20	4	74	0.0540541
NODE_206531_length_280_cov_0.779006	129	203	26	19	74	0.2567568
NODE_206531_length_280_cov_0.779006	129	203	28	51	74	0.6891892
NODE_206721_length_279_cov_50.005556	51	130	10	12	79	0.1518987
NODE_206721_length_279_cov_50.005556	51	130	12	6	79	0.0759494
NODE_206721_length_279_cov_50.005556	51	130	14	12	79	0.1518987
NODE_206721_length_279_cov_50.005556	51	130	16	22	79	0.2784810
NODE_206721_length_279_cov_50.005556	51	130	18	2	79	0.0253165
NODE_206721_length_279_cov_50.005556	51	130	19	1	79	0.0126582
NODE_206721_length_279_cov_50.005556	51	130	20	24	79	0.3037975
NODE_206721_length_279_cov_50.005556	103	179	0	4	76	0.0526316
NODE_206721_length_279_cov_50.005556	103	179	2	4	76	0.0526316
NODE_206721_length_279_cov_50.005556	103	179	4	1	76	0.0131579
NODE_206721_length_279_cov_50.005556	103	179	8	4	76	0.0526316
NODE_206721_length_279_cov_50.005556	103	179	12	8	76	0.1052632
NODE_206721_length_279_cov_50.005556	103	179	14	40	76	0.5263158
NODE_206721_length_279_cov_50.005556	103	179	16	3	76	0.0394737
NODE_206721_length_279_cov_50.005556	103	179	18	2	76	0.0263158
NODE_206721_length_279_cov_50.005556	103	179	20	10	76	0.1315790
NODE_206744_length_279_cov_6.055556	196	228	0	32	32	1.0000000
NODE_206762_length_279_cov_5.166667	197	277	0	80	80	1.0000000
NODE_206788_length_279_cov_4.427778	107	187	0	33	80	0.4125000
NODE_206788_length_279_cov_4.427778	107	187	2	47	80	0.5875000
NODE_206879_length_279_cov_3.200000	205	225	0	20	20	1.0000000
NODE_206886_length_279_cov_3.116667	115	195	0	80	80	1.0000000
NODE_206886_length_279_cov_3.116667	168	248	0	80	80	1.0000000
NODE_206972_length_279_cov_2.600000	67	147	0	21	80	0.2625000
NODE_206972_length_279_cov_2.600000	67	147	2	59	80	0.7375000
NODE_206972_length_279_cov_2.600000	120	199	0	73	79	0.9240506
NODE_206972_length_279_cov_2.600000	120	199	2	6	79	0.0759494
NODE_207023_length_279_cov_2.427778	155	199	6	38	44	0.8636364
NODE_207023_length_279_cov_2.427778	155	199	8	6	44	0.1363636
NODE_207052_length_279_cov_2.283333	168	240	0	72	72	1.0000000
NODE_207054_length_279_cov_2.277778	190	265	4	31	75	0.4133333
NODE_207054_length_279_cov_2.277778	190	265	9	3	75	0.0400000
NODE_207054_length_279_cov_2.277778	190	265	10	41	75	0.5466667
NODE_207086_length_279_cov_2.266667	66	109	0	43	43	1.0000000
NODE_207115_length_279_cov_2.255556	115	176	0	61	61	1.0000000
NODE_207115_length_279_cov_2.255556	168	222	0	54	54	1.0000000
NODE_207155_length_279_cov_2.200000	57	104	3	1	47	0.0212766
NODE_207155_length_279_cov_2.200000	57	104	4	17	47	0.3617021
NODE_207155_length_279_cov_2.200000	57	104	6	29	47	0.6170213
NODE_207269_length_279_cov_1.977778	0	62	0	62	62	1.0000000
NODE_207293_length_279_cov_1.944444	63	105	0	42	42	1.0000000
NODE_207306_length_279_cov_1.916667	182	262	0	80	80	1.0000000
NODE_207318_length_279_cov_1.866667	63	143	0	39	80	0.4875000
NODE_207318_length_279_cov_1.866667	63	143	2	41	80	0.5125000
NODE_207387_length_279_cov_1.700000	8	37	0	29	29	1.0000000
NODE_207389_length_279_cov_1.700000	10	42	0	32	32	1.0000000
NODE_207534_length_279_cov_1.672222	103	183	0	80	80	1.0000000
NODE_207641_length_279_cov_1.433333	51	110	0	59	59	1.0000000
NODE_207641_length_279_cov_1.433333	83	119	0	36	36	1.0000000
NODE_207929_length_279_cov_1.144444	146	211	0	35	65	0.5384616
NODE_207929_length_279_cov_1.144444	146	211	2	30	65	0.4615385
NODE_207929_length_279_cov_1.144444	184	266	0	82	82	1.0000000
NODE_207931_length_279_cov_1.138889	125	188	12	6	63	0.0952381
NODE_207931_length_279_cov_1.138889	125	188	13	7	63	0.1111111
NODE_207931_length_279_cov_1.138889	125	188	14	2	63	0.0317460
NODE_207931_length_279_cov_1.138889	125	188	19	5	63	0.0793651
NODE_207931_length_279_cov_1.138889	125	188	22	3	63	0.0476190
NODE_207931_length_279_cov_1.138889	125	188	23	1	63	0.0158730
NODE_207931_length_279_cov_1.138889	125	188	24	6	63	0.0952381
NODE_207931_length_279_cov_1.138889	125	188	25	15	63	0.2380952
NODE_207931_length_279_cov_1.138889	125	188	26	4	63	0.0634921
NODE_207931_length_279_cov_1.138889	125	188	27	12	63	0.1904762
NODE_207931_length_279_cov_1.138889	125	188	29	2	63	0.0317460
NODE_207932_length_279_cov_1.138889	111	191	0	80	80	1.0000000
NODE_207948_length_279_cov_1.133333	231	271	0	40	40	1.0000000
NODE_208183_length_279_cov_1.116667	15	92	0	77	77	1.0000000
NODE_208334_length_279_cov_0.988889	181	261	0	17	80	0.2125000
NODE_208334_length_279_cov_0.988889	181	261	2	63	80	0.7875000
NODE_208410_length_279_cov_0.927778	50	69	0	19	19	1.0000000
NODE_208410_length_279_cov_0.927778	50	69	0	19	19	1.0000000
NODE_208664_length_279_cov_0.844444	35	70	0	35	35	1.0000000
NODE_209293_length_278_cov_44.882682	158	210	6	13	52	0.2500000
NODE_209293_length_278_cov_44.882682	158	210	8	4	52	0.0769231
NODE_209293_length_278_cov_44.882682	158	210	10	8	52	0.1538462
NODE_209293_length_278_cov_44.882682	158	210	11	11	52	0.2115385
NODE_209293_length_278_cov_44.882682	158	210	13	5	52	0.0961538
NODE_209293_length_278_cov_44.882682	158	210	15	5	52	0.0961538
NODE_209293_length_278_cov_44.882682	158	210	17	6	52	0.1153846
NODE_209293_length_278_cov_44.882682	206	232	6	26	26	1.0000000
NODE_209293_length_278_cov_44.882682	206	265	2	8	59	0.1355932
NODE_209293_length_278_cov_44.882682	206	265	4	19	59	0.3220339
NODE_209293_length_278_cov_44.882682	206	265	6	32	59	0.5423729
NODE_209294_length_278_cov_37.474860	0	52	0	52	52	1.0000000
NODE_209294_length_278_cov_37.474860	48	128	0	65	80	0.8125000
NODE_209294_length_278_cov_37.474860	48	128	2	15	80	0.1875000
NODE_209294_length_278_cov_37.474860	101	181	0	12	80	0.1500000
NODE_209294_length_278_cov_37.474860	101	181	2	68	80	0.8500000
NODE_209295_length_278_cov_21.340782	84	164	0	80	80	1.0000000
NODE_209295_length_278_cov_21.340782	137	217	0	80	80	1.0000000
NODE_209360_length_278_cov_4.156425	132	210	0	26	78	0.3333333
NODE_209360_length_278_cov_4.156425	132	210	4	52	78	0.6666667
NODE_209360_length_278_cov_4.156425	193	263	0	70	70	1.0000000
NODE_209372_length_278_cov_3.977654	142	221	0	79	79	1.0000000
NODE_209378_length_278_cov_3.865922	168	210	0	42	42	1.0000000
NODE_209552_length_278_cov_2.558659	93	123	0	30	30	1.0000000
NODE_209565_length_278_cov_2.513966	54	106	0	52	52	1.0000000
NODE_209565_length_278_cov_2.513966	79	158	0	79	79	1.0000000
NODE_209605_length_278_cov_2.296089	127	207	0	80	80	1.0000000
NODE_209883_length_278_cov_1.731844	145	194	12	2	49	0.0408163
NODE_209883_length_278_cov_1.731844	145	194	14	4	49	0.0816327
NODE_209883_length_278_cov_1.731844	145	194	18	12	49	0.2448980
NODE_209883_length_278_cov_1.731844	145	194	20	1	49	0.0204082
NODE_209883_length_278_cov_1.731844	145	194	22	1	49	0.0204082
NODE_209883_length_278_cov_1.731844	145	194	28	15	49	0.3061225
NODE_209883_length_278_cov_1.731844	145	194	30	8	49	0.1632653
NODE_209883_length_278_cov_1.731844	145	194	32	6	49	0.1224490
NODE_210038_length_278_cov_1.681564	129	184	0	29	55	0.5272727
NODE_210038_length_278_cov_1.681564	129	184	2	7	55	0.1272727
NODE_210038_length_278_cov_1.681564	129	184	4	16	55	0.2909091
NODE_210038_length_278_cov_1.681564	129	184	6	3	55	0.0545455
NODE_210068_length_278_cov_1.636872	13	41	14	6	28	0.2142857
NODE_210068_length_278_cov_1.636872	13	41	20	1	28	0.0357143
NODE_210068_length_278_cov_1.636872	13	41	22	21	28	0.7500000
NODE_210373_length_278_cov_1.290503	3	67	2	6	64	0.0937500
NODE_210373_length_278_cov_1.290503	3	67	4	2	64	0.0312500
NODE_210373_length_278_cov_1.290503	3	67	5	3	64	0.0468750
NODE_210373_length_278_cov_1.290503	3	67	6	3	64	0.0468750
NODE_210373_length_278_cov_1.290503	3	67	11	1	64	0.0156250
NODE_210373_length_278_cov_1.290503	3	67	25	4	64	0.0625000
NODE_210373_length_278_cov_1.290503	3	67	29	1	64	0.0156250
NODE_210373_length_278_cov_1.290503	3	67	31	1	64	0.0156250
NODE_210373_length_278_cov_1.290503	3	67	38	7	64	0.1093750
NODE_210373_length_278_cov_1.290503	3	67	40	10	64	0.1562500
NODE_210373_length_278_cov_1.290503	3	67	41	7	64	0.1093750
NODE_210373_length_278_cov_1.290503	3	67	43	11	64	0.1718750
NODE_210373_length_278_cov_1.290503	3	67	45	8	64	0.1250000
NODE_210373_length_278_cov_1.290503	3	67	2	6	64	0.0937500
NODE_210373_length_278_cov_1.290503	3	67	4	2	64	0.0312500
NODE_210373_length_278_cov_1.290503	3	67	5	3	64	0.0468750
NODE_210373_length_278_cov_1.290503	3	67	6	3	64	0.0468750
NODE_210373_length_278_cov_1.290503	3	67	11	1	64	0.0156250
NODE_210373_length_278_cov_1.290503	3	67	25	4	64	0.0625000
NODE_210373_length_278_cov_1.290503	3	67	29	1	64	0.0156250
NODE_210373_length_278_cov_1.290503	3	67	31	1	64	0.0156250
NODE_210373_length_278_cov_1.290503	3	67	38	7	64	0.1093750
NODE_210373_length_278_cov_1.290503	3	67	40	10	64	0.1562500
NODE_210373_length_278_cov_1.290503	3	67	41	7	64	0.1093750
NODE_210373_length_278_cov_1.290503	3	67	43	11	64	0.1718750
NODE_210373_length_278_cov_1.290503	3	67	45	8	64	0.1250000
NODE_210373_length_278_cov_1.290503	3	67	2	6	64	0.0937500
NODE_210373_length_278_cov_1.290503	3	67	4	2	64	0.0312500
NODE_210373_length_278_cov_1.290503	3	67	5	3	64	0.0468750
NODE_210373_length_278_cov_1.290503	3	67	6	3	64	0.0468750
NODE_210373_length_278_cov_1.290503	3	67	11	1	64	0.0156250
NODE_210373_length_278_cov_1.290503	3	67	25	4	64	0.0625000
NODE_210373_length_278_cov_1.290503	3	67	29	1	64	0.0156250
NODE_210373_length_278_cov_1.290503	3	67	31	1	64	0.0156250
NODE_210373_length_278_cov_1.290503	3	67	38	7	64	0.1093750
NODE_210373_length_278_cov_1.290503	3	67	40	10	64	0.1562500
NODE_210373_length_278_cov_1.290503	3	67	41	7	64	0.1093750
NODE_210373_length_278_cov_1.290503	3	67	43	11	64	0.1718750
NODE_210373_length_278_cov_1.290503	3	67	45	8	64	0.1250000
NODE_210463_length_278_cov_1.150838	52	76	4	24	24	1.0000000
NODE_210463_length_278_cov_1.150838	58	84	4	26	26	1.0000000
NODE_210559_length_278_cov_1.139665	108	187	0	12	79	0.1518987
NODE_210559_length_278_cov_1.139665	108	187	1	33	79	0.4177215
NODE_210559_length_278_cov_1.139665	108	187	2	34	79	0.4303797
NODE_210612_length_278_cov_1.139665	232	278	0	46	46	1.0000000
NODE_210691_length_278_cov_1.139665	210	278	0	42	68	0.6176471
NODE_210691_length_278_cov_1.139665	210	278	3	26	68	0.3823529
NODE_212166_length_277_cov_2.691011	0	60	0	60	60	1.0000000
NODE_212166_length_277_cov_2.691011	33	113	0	80	80	1.0000000
NODE_212175_length_277_cov_2.617978	85	127	0	42	42	1.0000000
NODE_212233_length_277_cov_2.438202	137	218	0	58	81	0.7160494
NODE_212233_length_277_cov_2.438202	137	218	2	23	81	0.2839506
NODE_212357_length_277_cov_2.140449	234	276	0	42	42	1.0000000
NODE_212377_length_277_cov_2.095506	41	114	0	73	73	1.0000000
NODE_212377_length_277_cov_2.095506	41	114	0	73	73	1.0000000
NODE_212377_length_277_cov_2.095506	94	161	0	67	67	1.0000000
NODE_212525_length_277_cov_1.837079	92	172	4	7	80	0.0875000
NODE_212525_length_277_cov_1.837079	92	172	6	73	80	0.9125000
NODE_212558_length_277_cov_1.764045	115	155	0	18	40	0.4500000
NODE_212558_length_277_cov_1.764045	115	155	2	4	40	0.1000000
NODE_212558_length_277_cov_1.764045	115	155	4	3	40	0.0750000
NODE_212558_length_277_cov_1.764045	115	155	6	13	40	0.3250000
NODE_212558_length_277_cov_1.764045	115	155	8	2	40	0.0500000
NODE_212605_length_277_cov_1.719101	150	215	4	65	65	1.0000000
NODE_212845_length_277_cov_1.505618	0	47	0	47	47	1.0000000
NODE_212845_length_277_cov_1.505618	20	100	0	80	80	1.0000000
NODE_212970_length_277_cov_1.426966	113	191	0	78	78	1.0000000
NODE_213057_length_277_cov_1.314607	127	176	0	49	49	1.0000000
NODE_213091_length_277_cov_1.258427	141	222	0	36	81	0.4444444
NODE_213091_length_277_cov_1.258427	141	222	2	45	81	0.5555556
NODE_213223_length_277_cov_1.146067	19	95	0	32	76	0.4210526
NODE_213223_length_277_cov_1.146067	19	95	4	44	76	0.5789474
NODE_213490_length_277_cov_1.061798	67	105	2	38	38	1.0000000
NODE_213505_length_277_cov_1.044944	19	77	0	58	58	1.0000000
NODE_214572_length_276_cov_31.774011	91	153	20	1	62	0.0161290
NODE_214572_length_276_cov_31.774011	91	153	22	4	62	0.0645161
NODE_214572_length_276_cov_31.774011	91	153	25	2	62	0.0322581
NODE_214572_length_276_cov_31.774011	91	153	31	1	62	0.0161290
NODE_214572_length_276_cov_31.774011	91	153	40	1	62	0.0161290
NODE_214572_length_276_cov_31.774011	91	153	42	2	62	0.0322581
NODE_214572_length_276_cov_31.774011	91	153	48	3	62	0.0483871
NODE_214572_length_276_cov_31.774011	91	153	50	1	62	0.0161290
NODE_214572_length_276_cov_31.774011	91	153	52	4	62	0.0645161
NODE_214572_length_276_cov_31.774011	91	153	54	2	62	0.0322581
NODE_214572_length_276_cov_31.774011	91	153	56	1	62	0.0161290
NODE_214572_length_276_cov_31.774011	91	153	58	3	62	0.0483871
NODE_214572_length_276_cov_31.774011	91	153	59	1	62	0.0161290
NODE_214572_length_276_cov_31.774011	91	153	60	1	62	0.0161290
NODE_214572_length_276_cov_31.774011	91	153	61	1	62	0.0161290
NODE_214572_length_276_cov_31.774011	91	153	65	1	62	0.0161290
NODE_214572_length_276_cov_31.774011	91	153	74	3	62	0.0483871
NODE_214572_length_276_cov_31.774011	91	153	79	1	62	0.0161290
NODE_214572_length_276_cov_31.774011	91	153	82	1	62	0.0161290
NODE_214572_length_276_cov_31.774011	91	153	92	1	62	0.0161290
NODE_214572_length_276_cov_31.774011	91	153	94	1	62	0.0161290
NODE_214572_length_276_cov_31.774011	91	153	98	1	62	0.0161290
NODE_214572_length_276_cov_31.774011	91	153	100	1	62	0.0161290
NODE_214572_length_276_cov_31.774011	91	153	102	1	62	0.0161290
NODE_214572_length_276_cov_31.774011	91	153	103	1	62	0.0161290
NODE_214572_length_276_cov_31.774011	91	153	107	1	62	0.0161290
NODE_214572_length_276_cov_31.774011	91	153	109	1	62	0.0161290
NODE_214572_length_276_cov_31.774011	91	153	111	1	62	0.0161290
NODE_214572_length_276_cov_31.774011	91	153	112	1	62	0.0161290
NODE_214572_length_276_cov_31.774011	91	153	117	1	62	0.0161290
NODE_214572_length_276_cov_31.774011	91	153	118	1	62	0.0161290
NODE_214572_length_276_cov_31.774011	91	153	125	1	62	0.0161290
NODE_214572_length_276_cov_31.774011	91	153	137	1	62	0.0161290
NODE_214572_length_276_cov_31.774011	91	153	141	1	62	0.0161290
NODE_214572_length_276_cov_31.774011	91	153	145	1	62	0.0161290
NODE_214572_length_276_cov_31.774011	91	153	152	1	62	0.0161290
NODE_214572_length_276_cov_31.774011	91	153	155	1	62	0.0161290
NODE_214572_length_276_cov_31.774011	91	153	159	1	62	0.0161290
NODE_214572_length_276_cov_31.774011	91	153	160	1	62	0.0161290
NODE_214572_length_276_cov_31.774011	91	153	162	1	62	0.0161290
NODE_214572_length_276_cov_31.774011	91	153	163	3	62	0.0483871
NODE_214572_length_276_cov_31.774011	91	153	165	2	62	0.0322581
NODE_214572_length_276_cov_31.774011	91	153	168	1	62	0.0161290
NODE_214572_length_276_cov_31.774011	91	153	172	1	62	0.0161290
NODE_214576_length_276_cov_10.056497	66	146	0	80	80	1.0000000
NODE_214698_length_276_cov_3.564972	176	256	0	80	80	1.0000000
NODE_214785_length_276_cov_2.920904	203	260	0	57	57	1.0000000
NODE_214785_length_276_cov_2.920904	233	276	0	43	43	1.0000000
NODE_214883_length_276_cov_2.542373	164	204	17	6	40	0.1500000
NODE_214883_length_276_cov_2.542373	164	204	19	9	40	0.2250000
NODE_214883_length_276_cov_2.542373	164	204	20	10	40	0.2500000
NODE_214883_length_276_cov_2.542373	164	204	21	15	40	0.3750000
NODE_215016_length_276_cov_2.197740	64	144	0	3	80	0.0375000
NODE_215016_length_276_cov_2.197740	64	144	2	77	80	0.9625000
NODE_215086_length_276_cov_2.022599	136	193	4	2	57	0.0350877
NODE_215086_length_276_cov_2.022599	136	193	6	1	57	0.0175439
NODE_215086_length_276_cov_2.022599	136	193	9	54	57	0.9473684
NODE_215105_length_276_cov_2.016949	97	138	0	41	41	1.0000000
NODE_215139_length_276_cov_2.005650	82	153	0	9	71	0.1267606
NODE_215139_length_276_cov_2.005650	82	153	2	62	71	0.8732395
NODE_215234_length_276_cov_1.734463	102	182	14	7	80	0.0875000
NODE_215234_length_276_cov_1.734463	102	182	18	2	80	0.0250000
NODE_215234_length_276_cov_1.734463	102	182	24	2	80	0.0250000
NODE_215234_length_276_cov_1.734463	102	182	26	6	80	0.0750000
NODE_215234_length_276_cov_1.734463	102	182	28	2	80	0.0250000
NODE_215234_length_276_cov_1.734463	102	182	31	27	80	0.3375000
NODE_215234_length_276_cov_1.734463	102	182	32	1	80	0.0125000
NODE_215234_length_276_cov_1.734463	102	182	33	16	80	0.2000000
NODE_215234_length_276_cov_1.734463	102	182	35	14	80	0.1750000
NODE_215234_length_276_cov_1.734463	102	182	37	3	80	0.0375000
NODE_215516_length_276_cov_1.525424	70	116	0	46	46	1.0000000
NODE_215516_length_276_cov_1.525424	123	169	0	46	46	1.0000000
NODE_215519_length_276_cov_1.514124	115	155	53	1	40	0.0250000
NODE_215519_length_276_cov_1.514124	115	155	54	4	40	0.1000000
NODE_215519_length_276_cov_1.514124	115	155	56	2	40	0.0500000
NODE_215519_length_276_cov_1.514124	115	155	57	12	40	0.3000000
NODE_215519_length_276_cov_1.514124	115	155	58	18	40	0.4500000
NODE_215519_length_276_cov_1.514124	115	155	59	3	40	0.0750000
NODE_215748_length_276_cov_1.288136	114	154	3	25	40	0.6250000
NODE_215748_length_276_cov_1.288136	114	154	5	9	40	0.2250000
NODE_215748_length_276_cov_1.288136	114	154	7	2	40	0.0500000
NODE_215748_length_276_cov_1.288136	114	154	9	4	40	0.1000000
NODE_216141_length_276_cov_1.124294	122	170	4	28	48	0.5833333
NODE_216141_length_276_cov_1.124294	122	170	5	1	48	0.0208333
NODE_216141_length_276_cov_1.124294	122	170	6	19	48	0.3958333
NODE_216141_length_276_cov_1.124294	132	163	4	16	31	0.5161290
NODE_216141_length_276_cov_1.124294	132	163	6	15	31	0.4838710
NODE_216220_length_276_cov_1.039548	7	68	0	12	61	0.1967213
NODE_216220_length_276_cov_1.039548	7	68	2	1	61	0.0163934
NODE_216220_length_276_cov_1.039548	7	68	3	7	61	0.1147541
NODE_216220_length_276_cov_1.039548	7	68	5	6	61	0.0983607
NODE_216220_length_276_cov_1.039548	7	68	7	35	61	0.5737705
NODE_216220_length_276_cov_1.039548	7	70	0	12	63	0.1904762
NODE_216220_length_276_cov_1.039548	7	70	2	1	63	0.0158730
NODE_216220_length_276_cov_1.039548	7	70	3	7	63	0.1111111
NODE_216220_length_276_cov_1.039548	7	70	5	6	63	0.0952381
NODE_216220_length_276_cov_1.039548	7	70	7	37	63	0.5873016
NODE_216220_length_276_cov_1.039548	7	70	0	12	63	0.1904762
NODE_216220_length_276_cov_1.039548	7	70	2	1	63	0.0158730
NODE_216220_length_276_cov_1.039548	7	70	3	7	63	0.1111111
NODE_216220_length_276_cov_1.039548	7	70	5	6	63	0.0952381
NODE_216220_length_276_cov_1.039548	7	70	7	37	63	0.5873016
NODE_216220_length_276_cov_1.039548	7	70	0	12	63	0.1904762
NODE_216220_length_276_cov_1.039548	7	70	2	1	63	0.0158730
NODE_216220_length_276_cov_1.039548	7	70	3	7	63	0.1111111
NODE_216220_length_276_cov_1.039548	7	70	5	6	63	0.0952381
NODE_216220_length_276_cov_1.039548	7	70	7	37	63	0.5873016
NODE_216269_length_276_cov_1.000000	48	89	2	1	41	0.0243902
NODE_216269_length_276_cov_1.000000	48	89	4	40	41	0.9756098
NODE_216269_length_276_cov_1.000000	62	106	4	44	44	1.0000000
NODE_216414_length_276_cov_0.898305	54	105	0	51	51	1.0000000
NODE_217265_length_275_cov_85.085227	94	174	0	80	80	1.0000000
NODE_217265_length_275_cov_85.085227	147	227	0	80	80	1.0000000
NODE_217287_length_275_cov_5.818182	0	44	0	44	44	1.0000000
NODE_217355_length_275_cov_3.857955	0	67	0	67	67	1.0000000
NODE_217396_length_275_cov_3.306818	199	275	0	76	76	1.0000000
NODE_217402_length_275_cov_3.284091	127	175	0	48	48	1.0000000
NODE_217433_length_275_cov_2.977273	95	145	8	1	50	0.0200000
NODE_217433_length_275_cov_2.977273	95	145	10	37	50	0.7400000
NODE_217433_length_275_cov_2.977273	95	145	12	12	50	0.2400000
NODE_217531_length_275_cov_2.585227	85	122	65	2	37	0.0540541
NODE_217531_length_275_cov_2.585227	85	122	67	2	37	0.0540541
NODE_217531_length_275_cov_2.585227	85	122	69	3	37	0.0810811
NODE_217531_length_275_cov_2.585227	85	122	71	17	37	0.4594595
NODE_217531_length_275_cov_2.585227	85	122	72	1	37	0.0270270
NODE_217531_length_275_cov_2.585227	85	122	73	12	37	0.3243243
NODE_217714_length_275_cov_2.090909	0	47	0	45	47	0.9574468
NODE_217714_length_275_cov_2.090909	0	47	2	2	47	0.0425532
NODE_217714_length_275_cov_2.090909	20	91	0	25	71	0.3521127
NODE_217714_length_275_cov_2.090909	20	91	2	46	71	0.6478873
NODE_217801_length_275_cov_1.960227	198	251	0	53	53	1.0000000
NODE_217835_length_275_cov_1.875000	190	247	0	57	57	1.0000000
NODE_217839_length_275_cov_1.857955	52	119	2	28	67	0.4179105
NODE_217839_length_275_cov_1.857955	52	119	4	12	67	0.1791045
NODE_217839_length_275_cov_1.857955	52	119	6	1	67	0.0149254
NODE_217839_length_275_cov_1.857955	52	119	10	26	67	0.3880597
NODE_217839_length_275_cov_1.857955	136	182	8	9	46	0.1956522
NODE_217839_length_275_cov_1.857955	136	182	10	8	46	0.1739130
NODE_217839_length_275_cov_1.857955	136	182	12	29	46	0.6304348
NODE_217885_length_275_cov_1.755682	21	76	0	28	55	0.5090909
NODE_217885_length_275_cov_1.755682	21	76	2	27	55	0.4909091
NODE_217912_length_275_cov_1.738636	225	256	0	31	31	1.0000000
NODE_217967_length_275_cov_1.738636	161	241	0	80	80	1.0000000
NODE_218257_length_275_cov_1.448864	123	155	6	32	32	1.0000000
NODE_218402_length_275_cov_1.301136	132	196	0	8	64	0.1250000
NODE_218402_length_275_cov_1.301136	132	196	2	56	64	0.8750000
NODE_218706_length_275_cov_1.159091	13	93	0	80	80	1.0000000
NODE_218734_length_275_cov_1.153409	11	91	0	80	80	1.0000000
NODE_219031_length_275_cov_0.937500	13	49	17	8	36	0.2222222
NODE_219031_length_275_cov_0.937500	13	49	18	3	36	0.0833333
NODE_219031_length_275_cov_0.937500	13	49	19	1	36	0.0277778
NODE_219031_length_275_cov_0.937500	13	49	23	4	36	0.1111111
NODE_219031_length_275_cov_0.937500	13	49	25	3	36	0.0833333
NODE_219031_length_275_cov_0.937500	13	49	26	2	36	0.0555556
NODE_219031_length_275_cov_0.937500	13	49	31	1	36	0.0277778
NODE_219031_length_275_cov_0.937500	13	49	32	3	36	0.0833333
NODE_219031_length_275_cov_0.937500	13	49	34	2	36	0.0555556
NODE_219031_length_275_cov_0.937500	13	49	36	2	36	0.0555556
NODE_219031_length_275_cov_0.937500	13	49	40	2	36	0.0555556
NODE_219031_length_275_cov_0.937500	13	49	42	2	36	0.0555556
NODE_219031_length_275_cov_0.937500	13	49	45	2	36	0.0555556
NODE_219031_length_275_cov_0.937500	13	49	48	1	36	0.0277778
NODE_219031_length_275_cov_0.937500	22	86	18	2	64	0.0312500
NODE_219031_length_275_cov_0.937500	22	86	19	1	64	0.0156250
NODE_219031_length_275_cov_0.937500	22	86	23	4	64	0.0625000
NODE_219031_length_275_cov_0.937500	22	86	25	3	64	0.0468750
NODE_219031_length_275_cov_0.937500	22	86	26	2	64	0.0312500
NODE_219031_length_275_cov_0.937500	22	86	31	1	64	0.0156250
NODE_219031_length_275_cov_0.937500	22	86	32	3	64	0.0468750
NODE_219031_length_275_cov_0.937500	22	86	34	2	64	0.0312500
NODE_219031_length_275_cov_0.937500	22	86	36	2	64	0.0312500
NODE_219031_length_275_cov_0.937500	22	86	40	2	64	0.0312500
NODE_219031_length_275_cov_0.937500	22	86	42	2	64	0.0312500
NODE_219031_length_275_cov_0.937500	22	86	45	2	64	0.0312500
NODE_219031_length_275_cov_0.937500	22	86	48	1	64	0.0156250
NODE_219031_length_275_cov_0.937500	22	86	49	6	64	0.0937500
NODE_219031_length_275_cov_0.937500	22	86	51	4	64	0.0625000
NODE_219031_length_275_cov_0.937500	22	86	53	17	64	0.2656250
NODE_219031_length_275_cov_0.937500	22	86	57	4	64	0.0625000
NODE_219031_length_275_cov_0.937500	22	86	61	1	64	0.0156250
NODE_219031_length_275_cov_0.937500	22	86	63	2	64	0.0312500
NODE_219031_length_275_cov_0.937500	22	86	65	1	64	0.0156250
NODE_219031_length_275_cov_0.937500	22	86	70	2	64	0.0312500
NODE_219220_length_275_cov_0.869318	67	126	0	59	59	1.0000000
NODE_219655_length_275_cov_0.579545	40	70	0	30	30	1.0000000
NODE_220021_length_274_cov_6.074286	141	175	0	16	34	0.4705882
NODE_220021_length_274_cov_6.074286	141	175	1	2	34	0.0588235
NODE_220021_length_274_cov_6.074286	141	175	2	16	34	0.4705882
NODE_220047_length_274_cov_4.845714	48	105	0	57	57	1.0000000
NODE_220047_length_274_cov_4.845714	113	175	0	49	62	0.7903226
NODE_220047_length_274_cov_4.845714	113	175	2	13	62	0.2096774
NODE_220078_length_274_cov_4.080000	210	274	0	64	64	1.0000000
NODE_220215_length_274_cov_2.988571	104	161	0	41	57	0.7192982
NODE_220215_length_274_cov_2.988571	104	161	2	16	57	0.2807018
NODE_220221_length_274_cov_2.937143	199	234	0	35	35	1.0000000
NODE_220293_length_274_cov_2.622857	29	76	0	3	47	0.0638298
NODE_220293_length_274_cov_2.622857	29	76	4	44	47	0.9361702
NODE_220293_length_274_cov_2.622857	82	157	0	75	75	1.0000000
NODE_220413_length_274_cov_2.308571	51	130	15	5	79	0.0632911
NODE_220413_length_274_cov_2.308571	51	130	21	8	79	0.1012658
NODE_220413_length_274_cov_2.308571	51	130	27	1	79	0.0126582
NODE_220413_length_274_cov_2.308571	51	130	33	5	79	0.0632911
NODE_220413_length_274_cov_2.308571	51	130	35	3	79	0.0379747
NODE_220413_length_274_cov_2.308571	51	130	41	4	79	0.0506329
NODE_220413_length_274_cov_2.308571	51	130	43	3	79	0.0379747
NODE_220413_length_274_cov_2.308571	51	130	49	1	79	0.0126582
NODE_220413_length_274_cov_2.308571	51	130	51	1	79	0.0126582
NODE_220413_length_274_cov_2.308571	51	130	55	2	79	0.0253165
NODE_220413_length_274_cov_2.308571	51	130	59	2	79	0.0253165
NODE_220413_length_274_cov_2.308571	51	130	61	1	79	0.0126582
NODE_220413_length_274_cov_2.308571	51	130	66	3	79	0.0379747
NODE_220413_length_274_cov_2.308571	51	130	67	3	79	0.0379747
NODE_220413_length_274_cov_2.308571	51	130	71	1	79	0.0126582
NODE_220413_length_274_cov_2.308571	51	130	73	1	79	0.0126582
NODE_220413_length_274_cov_2.308571	51	130	75	5	79	0.0632911
NODE_220413_length_274_cov_2.308571	51	130	77	1	79	0.0126582
NODE_220413_length_274_cov_2.308571	51	130	79	1	79	0.0126582
NODE_220413_length_274_cov_2.308571	51	130	83	3	79	0.0379747
NODE_220413_length_274_cov_2.308571	51	130	84	1	79	0.0126582
NODE_220413_length_274_cov_2.308571	51	130	85	8	79	0.1012658
NODE_220413_length_274_cov_2.308571	51	130	86	2	79	0.0253165
NODE_220413_length_274_cov_2.308571	51	130	88	1	79	0.0126582
NODE_220413_length_274_cov_2.308571	51	130	89	13	79	0.1645570
NODE_220504_length_274_cov_2.062857	172	242	0	70	70	1.0000000
NODE_220504_length_274_cov_2.062857	215	256	0	41	41	1.0000000
NODE_220662_length_274_cov_1.754286	219	259	0	40	40	1.0000000
NODE_220681_length_274_cov_1.748571	168	231	4	3	63	0.0476190
NODE_220681_length_274_cov_1.748571	168	231	6	21	63	0.3333333
NODE_220681_length_274_cov_1.748571	168	231	8	14	63	0.2222222
NODE_220681_length_274_cov_1.748571	168	231	10	25	63	0.3968254
NODE_220806_length_274_cov_1.737143	134	172	0	38	38	1.0000000
NODE_220847_length_274_cov_1.685714	132	189	0	43	57	0.7543859
NODE_220847_length_274_cov_1.685714	132	189	4	14	57	0.2456140
NODE_220847_length_274_cov_1.685714	141	199	0	53	58	0.9137931
NODE_220847_length_274_cov_1.685714	141	199	4	5	58	0.0862069
NODE_220966_length_274_cov_1.502857	170	232	0	62	62	1.0000000
NODE_220966_length_274_cov_1.502857	223	274	0	51	51	1.0000000
NODE_221005_length_274_cov_1.457143	118	147	0	29	29	1.0000000
NODE_221101_length_274_cov_1.434286	25	69	0	10	44	0.2272727
NODE_221101_length_274_cov_1.434286	25	69	2	34	44	0.7727273
NODE_221211_length_274_cov_1.285714	84	156	0	72	72	1.0000000
NODE_221612_length_274_cov_1.131429	205	251	0	46	46	1.0000000
NODE_221764_length_274_cov_0.994286	219	260	0	10	41	0.2439024
NODE_221764_length_274_cov_0.994286	219	260	2	31	41	0.7560976
NODE_222849_length_273_cov_4.948276	204	262	0	58	58	1.0000000
NODE_222849_length_273_cov_4.948276	204	258	0	54	54	1.0000000
NODE_222914_length_273_cov_3.712644	103	183	0	2	80	0.0250000
NODE_222914_length_273_cov_3.712644	103	183	5	5	80	0.0625000
NODE_222914_length_273_cov_3.712644	103	183	7	3	80	0.0375000
NODE_222914_length_273_cov_3.712644	103	183	9	12	80	0.1500000
NODE_222914_length_273_cov_3.712644	103	183	13	2	80	0.0250000
NODE_222914_length_273_cov_3.712644	103	183	15	39	80	0.4875000
NODE_222914_length_273_cov_3.712644	103	183	17	17	80	0.2125000
NODE_222955_length_273_cov_3.298851	69	100	0	31	31	1.0000000
NODE_222955_length_273_cov_3.298851	73	153	0	80	80	1.0000000
NODE_222974_length_273_cov_3.195402	122	189	2	67	67	1.0000000
NODE_222991_length_273_cov_3.063218	76	151	2	16	75	0.2133333
NODE_222991_length_273_cov_3.063218	76	151	10	3	75	0.0400000
NODE_222991_length_273_cov_3.063218	76	151	12	7	75	0.0933333
NODE_222991_length_273_cov_3.063218	76	151	16	3	75	0.0400000
NODE_222991_length_273_cov_3.063218	76	151	18	6	75	0.0800000
NODE_222991_length_273_cov_3.063218	76	151	20	3	75	0.0400000
NODE_222991_length_273_cov_3.063218	76	151	24	27	75	0.3600000
NODE_222991_length_273_cov_3.063218	76	151	26	1	75	0.0133333
NODE_222991_length_273_cov_3.063218	76	151	28	1	75	0.0133333
NODE_222991_length_273_cov_3.063218	76	151	30	5	75	0.0666667
NODE_222991_length_273_cov_3.063218	76	151	32	3	75	0.0400000
NODE_222991_length_273_cov_3.063218	135	191	1	4	56	0.0714286
NODE_222991_length_273_cov_3.063218	135	191	2	52	56	0.9285714
NODE_223066_length_273_cov_2.706897	11	45	0	34	34	1.0000000
NODE_223203_length_273_cov_2.339080	69	145	4	10	76	0.1315790
NODE_223203_length_273_cov_2.339080	69	145	8	1	76	0.0131579
NODE_223203_length_273_cov_2.339080	69	145	10	1	76	0.0131579
NODE_223203_length_273_cov_2.339080	69	145	12	3	76	0.0394737
NODE_223203_length_273_cov_2.339080	69	145	14	9	76	0.1184211
NODE_223203_length_273_cov_2.339080	69	145	16	7	76	0.0921053
NODE_223203_length_273_cov_2.339080	69	145	20	1	76	0.0131579
NODE_223203_length_273_cov_2.339080	69	145	22	5	76	0.0657895
NODE_223203_length_273_cov_2.339080	69	145	24	7	76	0.0921053
NODE_223203_length_273_cov_2.339080	69	145	26	32	76	0.4210526
NODE_223353_length_273_cov_2.051724	31	74	0	43	43	1.0000000
NODE_223377_length_273_cov_2.034483	81	161	0	13	80	0.1625000
NODE_223377_length_273_cov_2.034483	81	161	2	1	80	0.0125000
NODE_223377_length_273_cov_2.034483	81	161	3	3	80	0.0375000
NODE_223377_length_273_cov_2.034483	81	161	4	16	80	0.2000000
NODE_223377_length_273_cov_2.034483	81	161	6	47	80	0.5875000
NODE_223377_length_273_cov_2.034483	213	263	0	16	50	0.3200000
NODE_223377_length_273_cov_2.034483	213	263	1	3	50	0.0600000
NODE_223377_length_273_cov_2.034483	213	263	2	6	50	0.1200000
NODE_223377_length_273_cov_2.034483	213	263	3	3	50	0.0600000
NODE_223377_length_273_cov_2.034483	213	263	4	22	50	0.4400000
NODE_223680_length_273_cov_1.706897	181	238	0	57	57	1.0000000
NODE_223913_length_273_cov_1.442529	5	47	2	22	42	0.5238096
NODE_223913_length_273_cov_1.442529	5	47	3	8	42	0.1904762
NODE_223913_length_273_cov_1.442529	5	47	4	12	42	0.2857143
NODE_224023_length_273_cov_1.281609	167	247	0	80	80	1.0000000
NODE_224082_length_273_cov_1.189655	120	156	0	36	36	1.0000000
NODE_224082_length_273_cov_1.189655	129	160	0	31	31	1.0000000
NODE_224165_length_273_cov_1.172414	94	130	0	36	36	1.0000000
NODE_224254_length_273_cov_1.172414	8	58	0	1	50	0.0200000
NODE_224254_length_273_cov_1.172414	8	58	2	49	50	0.9800000
NODE_224367_length_273_cov_1.166667	74	93	0	19	19	1.0000000
NODE_224441_length_273_cov_1.091954	6	42	0	36	36	1.0000000
NODE_224441_length_273_cov_1.091954	43	95	0	52	52	1.0000000
NODE_224587_length_273_cov_0.971264	188	235	0	47	47	1.0000000
NODE_225303_length_273_cov_0.586207	27	88	0	61	61	1.0000000
NODE_225344_length_273_cov_0.586207	24	79	0	43	55	0.7818182
NODE_225344_length_273_cov_0.586207	24	79	2	12	55	0.2181818
NODE_225344_length_273_cov_0.586207	81	113	2	32	32	1.0000000
NODE_225592_length_272_cov_6.190751	172	236	0	64	64	1.0000000
NODE_225607_length_272_cov_5.335260	193	272	0	43	79	0.5443038
NODE_225607_length_272_cov_5.335260	193	272	2	36	79	0.4556962
NODE_225633_length_272_cov_4.716763	228	257	0	29	29	1.0000000
NODE_225656_length_272_cov_4.219653	93	166	0	3	73	0.0410959
NODE_225656_length_272_cov_4.219653	93	166	2	21	73	0.2876712
NODE_225656_length_272_cov_4.219653	93	166	4	49	73	0.6712329
NODE_225656_length_272_cov_4.219653	146	219	2	28	73	0.3835616
NODE_225656_length_272_cov_4.219653	146	219	4	45	73	0.6164383
NODE_225658_length_272_cov_4.184971	75	128	0	53	53	1.0000000
NODE_225739_length_272_cov_3.352601	154	199	0	45	45	1.0000000
NODE_225872_length_272_cov_2.664740	106	186	0	80	80	1.0000000
NODE_226010_length_272_cov_2.335260	33	103	0	70	70	1.0000000
NODE_226029_length_272_cov_2.277457	219	256	0	37	37	1.0000000
NODE_226045_length_272_cov_2.236994	104	184	2	25	80	0.3125000
NODE_226045_length_272_cov_2.236994	104	184	8	17	80	0.2125000
NODE_226045_length_272_cov_2.236994	104	184	10	38	80	0.4750000
NODE_226169_length_272_cov_1.982659	172	252	0	80	80	1.0000000
NODE_226245_length_272_cov_1.780347	37	99	0	62	62	1.0000000
NODE_226245_length_272_cov_1.780347	90	152	0	62	62	1.0000000
NODE_226248_length_272_cov_1.768786	12	45	0	33	33	1.0000000
NODE_226461_length_272_cov_1.618497	97	160	4	2	63	0.0317460
NODE_226461_length_272_cov_1.618497	97	160	6	1	63	0.0158730
NODE_226461_length_272_cov_1.618497	97	160	7	1	63	0.0158730
NODE_226461_length_272_cov_1.618497	97	160	8	2	63	0.0317460
NODE_226461_length_272_cov_1.618497	97	160	11	2	63	0.0317460
NODE_226461_length_272_cov_1.618497	97	160	18	3	63	0.0476190
NODE_226461_length_272_cov_1.618497	97	160	20	3	63	0.0476190
NODE_226461_length_272_cov_1.618497	97	160	21	3	63	0.0476190
NODE_226461_length_272_cov_1.618497	97	160	23	7	63	0.1111111
NODE_226461_length_272_cov_1.618497	97	160	25	21	63	0.3333333
NODE_226461_length_272_cov_1.618497	97	160	27	4	63	0.0634921
NODE_226461_length_272_cov_1.618497	97	160	29	1	63	0.0158730
NODE_226461_length_272_cov_1.618497	97	160	30	2	63	0.0317460
NODE_226461_length_272_cov_1.618497	97	160	32	1	63	0.0158730
NODE_226461_length_272_cov_1.618497	97	160	34	9	63	0.1428571
NODE_226461_length_272_cov_1.618497	97	160	36	1	63	0.0158730
NODE_226508_length_272_cov_1.543353	69	137	2	58	68	0.8529412
NODE_226508_length_272_cov_1.543353	69	137	4	10	68	0.1470588
NODE_227037_length_272_cov_1.173410	147	203	0	56	56	1.0000000
NODE_227265_length_272_cov_0.988439	169	215	1	9	46	0.1956522
NODE_227265_length_272_cov_0.988439	169	215	3	32	46	0.6956522
NODE_227265_length_272_cov_0.988439	169	215	4	5	46	0.1086956
NODE_227444_length_272_cov_0.884393	126	163	6	37	37	1.0000000
NODE_228332_length_271_cov_5.238372	103	183	0	80	80	1.0000000
NODE_228423_length_271_cov_3.546512	102	165	0	24	63	0.3809524
NODE_228423_length_271_cov_3.546512	102	165	1	39	63	0.6190476
NODE_228429_length_271_cov_3.476744	62	93	0	31	31	1.0000000
NODE_228494_length_271_cov_2.959302	96	176	0	80	80	1.0000000
NODE_228494_length_271_cov_2.959302	149	229	0	80	80	1.0000000
NODE_228554_length_271_cov_2.715116	160	241	0	81	81	1.0000000
NODE_228593_length_271_cov_2.622093	180	253	0	73	73	1.0000000
NODE_228623_length_271_cov_2.465116	45	75	0	30	30	1.0000000
NODE_228731_length_271_cov_2.284884	95	158	0	1	63	0.0158730
NODE_228731_length_271_cov_2.284884	95	158	2	29	63	0.4603175
NODE_228731_length_271_cov_2.284884	95	158	6	3	63	0.0476190
NODE_228731_length_271_cov_2.284884	95	158	8	30	63	0.4761905
NODE_228731_length_271_cov_2.284884	131	211	6	15	80	0.1875000
NODE_228731_length_271_cov_2.284884	131	211	8	65	80	0.8125000
NODE_228737_length_271_cov_2.273256	163	219	0	31	56	0.5535714
NODE_228737_length_271_cov_2.273256	163	219	2	25	56	0.4464286
NODE_228830_length_271_cov_2.069767	130	212	0	25	82	0.3048781
NODE_228830_length_271_cov_2.069767	130	212	2	57	82	0.6951219
NODE_228932_length_271_cov_1.784884	135	183	0	48	48	1.0000000
NODE_228937_length_271_cov_1.779070	204	268	0	64	64	1.0000000
NODE_229085_length_271_cov_1.755814	119	199	0	12	80	0.1500000
NODE_229085_length_271_cov_1.755814	119	199	2	68	80	0.8500000
NODE_229242_length_271_cov_1.523256	122	183	6	61	61	1.0000000
NODE_229254_length_271_cov_1.511628	106	186	13	5	80	0.0625000
NODE_229254_length_271_cov_1.511628	106	186	14	5	80	0.0625000
NODE_229254_length_271_cov_1.511628	106	186	15	7	80	0.0875000
NODE_229254_length_271_cov_1.511628	106	186	19	7	80	0.0875000
NODE_229254_length_271_cov_1.511628	106	186	20	14	80	0.1750000
NODE_229254_length_271_cov_1.511628	106	186	22	11	80	0.1375000
NODE_229254_length_271_cov_1.511628	106	186	24	1	80	0.0125000
NODE_229254_length_271_cov_1.511628	106	186	26	9	80	0.1125000
NODE_229254_length_271_cov_1.511628	106	186	27	1	80	0.0125000
NODE_229254_length_271_cov_1.511628	106	186	28	3	80	0.0375000
NODE_229254_length_271_cov_1.511628	106	186	30	11	80	0.1375000
NODE_229254_length_271_cov_1.511628	106	186	32	6	80	0.0750000
NODE_229525_length_271_cov_1.226744	119	184	0	65	65	1.0000000
NODE_229541_length_271_cov_1.197674	88	145	0	38	57	0.6666667
NODE_229541_length_271_cov_1.197674	88	145	4	19	57	0.3333333
NODE_229541_length_271_cov_1.197674	118	192	0	74	74	1.0000000
NODE_230154_length_271_cov_0.918605	155	227	0	72	72	1.0000000
NODE_230255_length_271_cov_0.889535	101	148	0	47	47	1.0000000
NODE_230318_length_271_cov_0.889535	127	188	0	61	61	1.0000000
NODE_231165_length_270_cov_4.818713	72	118	0	46	46	1.0000000
NODE_231187_length_270_cov_4.327485	5	82	0	77	77	1.0000000
NODE_231240_length_270_cov_3.666667	87	154	0	9	67	0.1343284
NODE_231240_length_270_cov_3.666667	87	154	2	6	67	0.0895522
NODE_231240_length_270_cov_3.666667	87	154	4	44	67	0.6567164
NODE_231240_length_270_cov_3.666667	87	154	6	8	67	0.1194030
NODE_231240_length_270_cov_3.666667	140	207	4	55	67	0.8208955
NODE_231240_length_270_cov_3.666667	140	207	6	12	67	0.1791045
NODE_231263_length_270_cov_3.491228	186	270	0	49	84	0.5833333
NODE_231263_length_270_cov_3.491228	186	270	2	1	84	0.0119048
NODE_231263_length_270_cov_3.491228	186	270	4	19	84	0.2261905
NODE_231263_length_270_cov_3.491228	186	270	6	15	84	0.1785714
NODE_231310_length_270_cov_3.105263	43	90	0	8	47	0.1702128
NODE_231310_length_270_cov_3.105263	43	90	2	15	47	0.3191489
NODE_231310_length_270_cov_3.105263	43	90	4	19	47	0.4042553
NODE_231310_length_270_cov_3.105263	43	90	6	5	47	0.1063830
NODE_231316_length_270_cov_3.046784	64	135	0	71	71	1.0000000
NODE_231439_length_270_cov_2.649123	210	270	0	60	60	1.0000000
NODE_231655_length_270_cov_2.087719	16	55	0	39	39	1.0000000
NODE_231655_length_270_cov_2.087719	78	108	0	30	30	1.0000000
NODE_231714_length_270_cov_2.040936	103	159	15	1	56	0.0178571
NODE_231714_length_270_cov_2.040936	103	159	32	2	56	0.0357143
NODE_231714_length_270_cov_2.040936	103	159	36	1	56	0.0178571
NODE_231714_length_270_cov_2.040936	103	159	38	1	56	0.0178571
NODE_231714_length_270_cov_2.040936	103	159	41	1	56	0.0178571
NODE_231714_length_270_cov_2.040936	103	159	48	2	56	0.0357143
NODE_231714_length_270_cov_2.040936	103	159	52	2	56	0.0357143
NODE_231714_length_270_cov_2.040936	103	159	55	1	56	0.0178571
NODE_231714_length_270_cov_2.040936	103	159	62	2	56	0.0357143
NODE_231714_length_270_cov_2.040936	103	159	64	1	56	0.0178571
NODE_231714_length_270_cov_2.040936	103	159	66	3	56	0.0535714
NODE_231714_length_270_cov_2.040936	103	159	70	3	56	0.0535714
NODE_231714_length_270_cov_2.040936	103	159	72	1	56	0.0178571
NODE_231714_length_270_cov_2.040936	103	159	74	2	56	0.0357143
NODE_231714_length_270_cov_2.040936	103	159	82	5	56	0.0892857
NODE_231714_length_270_cov_2.040936	103	159	84	3	56	0.0535714
NODE_231714_length_270_cov_2.040936	103	159	86	1	56	0.0178571
NODE_231714_length_270_cov_2.040936	103	159	88	1	56	0.0178571
NODE_231714_length_270_cov_2.040936	103	159	90	1	56	0.0178571
NODE_231714_length_270_cov_2.040936	103	159	92	1	56	0.0178571
NODE_231714_length_270_cov_2.040936	103	159	94	3	56	0.0535714
NODE_231714_length_270_cov_2.040936	103	159	96	2	56	0.0357143
NODE_231714_length_270_cov_2.040936	103	159	98	1	56	0.0178571
NODE_231714_length_270_cov_2.040936	103	159	103	3	56	0.0535714
NODE_231714_length_270_cov_2.040936	103	159	105	2	56	0.0357143
NODE_231714_length_270_cov_2.040936	103	159	107	6	56	0.1071429
NODE_231714_length_270_cov_2.040936	103	159	109	4	56	0.0714286
NODE_231726_length_270_cov_2.017544	1	48	2	47	47	1.0000000
NODE_231820_length_270_cov_1.789474	146	228	0	13	82	0.1585366
NODE_231820_length_270_cov_1.789474	146	228	4	69	82	0.8414634
NODE_232008_length_270_cov_1.678363	178	246	0	68	68	1.0000000
NODE_232021_length_270_cov_1.666667	127	191	18	8	64	0.1250000
NODE_232021_length_270_cov_1.666667	127	191	20	11	64	0.1718750
NODE_232021_length_270_cov_1.666667	127	191	22	1	64	0.0156250
NODE_232021_length_270_cov_1.666667	127	191	24	4	64	0.0625000
NODE_232021_length_270_cov_1.666667	127	191	26	1	64	0.0156250
NODE_232021_length_270_cov_1.666667	127	191	30	7	64	0.1093750
NODE_232021_length_270_cov_1.666667	127	191	34	1	64	0.0156250
NODE_232021_length_270_cov_1.666667	127	191	38	3	64	0.0468750
NODE_232021_length_270_cov_1.666667	127	191	40	6	64	0.0937500
NODE_232021_length_270_cov_1.666667	127	191	44	1	64	0.0156250
NODE_232021_length_270_cov_1.666667	127	191	46	7	64	0.1093750
NODE_232021_length_270_cov_1.666667	127	191	48	2	64	0.0312500
NODE_232021_length_270_cov_1.666667	127	191	50	1	64	0.0156250
NODE_232021_length_270_cov_1.666667	127	191	52	1	64	0.0156250
NODE_232021_length_270_cov_1.666667	127	191	54	5	64	0.0781250
NODE_232021_length_270_cov_1.666667	127	191	58	5	64	0.0781250
NODE_232021_length_270_cov_1.666667	180	227	8	6	47	0.1276596
NODE_232021_length_270_cov_1.666667	180	227	9	3	47	0.0638298
NODE_232021_length_270_cov_1.666667	180	227	10	5	47	0.1063830
NODE_232021_length_270_cov_1.666667	180	227	12	3	47	0.0638298
NODE_232021_length_270_cov_1.666667	180	227	14	2	47	0.0425532
NODE_232021_length_270_cov_1.666667	180	227	15	7	47	0.1489362
NODE_232021_length_270_cov_1.666667	180	227	16	9	47	0.1914894
NODE_232021_length_270_cov_1.666667	180	227	18	9	47	0.1914894
NODE_232021_length_270_cov_1.666667	180	227	20	3	47	0.0638298
NODE_232087_length_270_cov_1.555556	138	218	0	17	80	0.2125000
NODE_232087_length_270_cov_1.555556	138	218	2	21	80	0.2625000
NODE_232087_length_270_cov_1.555556	138	218	4	42	80	0.5250000
NODE_232331_length_270_cov_1.280702	4	75	0	59	71	0.8309859
NODE_232331_length_270_cov_1.280702	4	75	2	12	71	0.1690141
NODE_232331_length_270_cov_1.280702	57	137	0	6	80	0.0750000
NODE_232331_length_270_cov_1.280702	57	137	2	74	80	0.9250000
NODE_232331_length_270_cov_1.280702	65	120	2	55	55	1.0000000
NODE_232331_length_270_cov_1.280702	125	198	0	42	73	0.5753425
NODE_232331_length_270_cov_1.280702	125	198	2	31	73	0.4246575
NODE_232440_length_270_cov_1.192982	146	194	0	48	48	1.0000000
NODE_232583_length_270_cov_1.192982	61	141	0	16	80	0.2000000
NODE_232583_length_270_cov_1.192982	61	141	2	64	80	0.8000000
NODE_233290_length_270_cov_0.847953	53	128	0	3	75	0.0400000
NODE_233290_length_270_cov_0.847953	53	128	2	72	75	0.9600000
NODE_234072_length_269_cov_3.894118	30	110	0	15	80	0.1875000
NODE_234072_length_269_cov_3.894118	30	110	2	65	80	0.8125000
NODE_234072_length_269_cov_3.894118	83	163	0	15	80	0.1875000
NODE_234072_length_269_cov_3.894118	83	163	2	65	80	0.8125000
NODE_234100_length_269_cov_3.605882	175	205	0	30	30	1.0000000
NODE_234116_length_269_cov_3.523529	192	233	0	41	41	1.0000000
NODE_234116_length_269_cov_3.523529	206	268	0	62	62	1.0000000
NODE_234118_length_269_cov_3.505882	13	93	0	80	80	1.0000000
NODE_234118_length_269_cov_3.505882	66	145	0	79	79	1.0000000
NODE_234162_length_269_cov_3.147059	134	174	0	40	40	1.0000000
NODE_234167_length_269_cov_3.111765	39	119	0	80	80	1.0000000
NODE_234167_length_269_cov_3.111765	92	169	0	77	77	1.0000000
NODE_234178_length_269_cov_3.000000	166	233	0	55	67	0.8208955
NODE_234178_length_269_cov_3.000000	166	233	2	12	67	0.1791045
NODE_234205_length_269_cov_2.947059	55	123	0	68	68	1.0000000
NODE_234224_length_269_cov_2.858824	9	89	0	80	80	1.0000000
NODE_234224_length_269_cov_2.858824	62	91	0	29	29	1.0000000
NODE_234228_length_269_cov_2.823529	0	73	0	31	73	0.4246575
NODE_234228_length_269_cov_2.823529	0	73	2	10	73	0.1369863
NODE_234228_length_269_cov_2.823529	0	73	8	32	73	0.4383562
NODE_234228_length_269_cov_2.823529	46	77	8	31	31	1.0000000
NODE_234431_length_269_cov_2.311765	111	157	2	46	46	1.0000000
NODE_234431_length_269_cov_2.311765	130	209	2	79	79	1.0000000
NODE_234606_length_269_cov_1.958824	176	248	0	13	72	0.1805556
NODE_234606_length_269_cov_1.958824	176	248	2	59	72	0.8194444
NODE_234647_length_269_cov_1.847059	72	99	0	27	27	1.0000000
NODE_234657_length_269_cov_1.823529	30	81	4	51	51	1.0000000
NODE_234758_length_269_cov_1.800000	0	42	0	42	42	1.0000000
NODE_234978_length_269_cov_1.552941	90	170	0	16	80	0.2000000
NODE_234978_length_269_cov_1.552941	90	170	2	64	80	0.8000000
NODE_235157_length_269_cov_1.400000	139	219	4	11	80	0.1375000
NODE_235157_length_269_cov_1.400000	139	219	6	13	80	0.1625000
NODE_235157_length_269_cov_1.400000	139	219	8	3	80	0.0375000
NODE_235157_length_269_cov_1.400000	139	219	10	2	80	0.0250000
NODE_235157_length_269_cov_1.400000	139	219	12	14	80	0.1750000
NODE_235157_length_269_cov_1.400000	139	219	13	17	80	0.2125000
NODE_235157_length_269_cov_1.400000	139	219	17	3	80	0.0375000
NODE_235157_length_269_cov_1.400000	139	219	19	14	80	0.1750000
NODE_235157_length_269_cov_1.400000	139	219	20	3	80	0.0375000
NODE_235168_length_269_cov_1.388235	185	252	0	67	67	1.0000000
NODE_235239_length_269_cov_1.288235	150	179	0	4	29	0.1379310
NODE_235239_length_269_cov_1.288235	150	179	2	9	29	0.3103448
NODE_235239_length_269_cov_1.288235	150	179	4	12	29	0.4137931
NODE_235239_length_269_cov_1.288235	150	179	6	4	29	0.1379310
NODE_235292_length_269_cov_1.217647	141	221	0	80	80	1.0000000
NODE_235561_length_269_cov_1.194118	107	170	0	63	63	1.0000000
NODE_235561_length_269_cov_1.194118	143	221	0	68	78	0.8717949
NODE_235561_length_269_cov_1.194118	143	221	2	10	78	0.1282051
NODE_235714_length_269_cov_1.094118	38	72	0	34	34	1.0000000
NODE_235780_length_269_cov_1.035294	6	36	0	30	30	1.0000000
NODE_235780_length_269_cov_1.035294	96	150	0	54	54	1.0000000
NODE_235930_length_269_cov_0.917647	4	79	0	75	75	1.0000000
NODE_235930_length_269_cov_0.917647	57	93	0	36	36	1.0000000
NODE_236243_length_269_cov_0.782353	2	52	4	3	50	0.0600000
NODE_236243_length_269_cov_0.782353	2	52	6	29	50	0.5800000
NODE_236243_length_269_cov_0.782353	2	52	8	3	50	0.0600000
NODE_236243_length_269_cov_0.782353	2	52	10	1	50	0.0200000
NODE_236243_length_269_cov_0.782353	2	52	12	14	50	0.2800000
NODE_236243_length_269_cov_0.782353	76	132	6	1	56	0.0178571
NODE_236243_length_269_cov_0.782353	76	132	8	7	56	0.1250000
NODE_236243_length_269_cov_0.782353	76	132	10	3	56	0.0535714
NODE_236243_length_269_cov_0.782353	76	132	12	30	56	0.5357143
NODE_236243_length_269_cov_0.782353	76	132	14	15	56	0.2678571
NODE_236856_length_268_cov_223.165680	161	188	4	4	27	0.1481481
NODE_236856_length_268_cov_223.165680	161	188	8	23	27	0.8518519
NODE_236856_length_268_cov_223.165680	161	241	4	15	80	0.1875000
NODE_236856_length_268_cov_223.165680	161	241	8	65	80	0.8125000
NODE_236878_length_268_cov_6.266272	29	111	0	41	82	0.5000000
NODE_236878_length_268_cov_6.266272	29	111	2	41	82	0.5000000
NODE_236909_length_268_cov_5.053254	137	217	0	80	80	1.0000000
NODE_236909_length_268_cov_5.053254	190	253	0	63	63	1.0000000
NODE_236911_length_268_cov_4.994083	92	168	0	76	76	1.0000000
NODE_236972_length_268_cov_3.905325	1	61	0	59	60	0.9833333
NODE_236972_length_268_cov_3.905325	1	61	2	1	60	0.0166667
NODE_237107_length_268_cov_2.982249	95	175	13	11	80	0.1375000
NODE_237107_length_268_cov_2.982249	95	175	17	3	80	0.0375000
NODE_237107_length_268_cov_2.982249	95	175	19	2	80	0.0250000
NODE_237107_length_268_cov_2.982249	95	175	21	7	80	0.0875000
NODE_237107_length_268_cov_2.982249	95	175	23	7	80	0.0875000
NODE_237107_length_268_cov_2.982249	95	175	25	14	80	0.1750000
NODE_237107_length_268_cov_2.982249	95	175	29	14	80	0.1750000
NODE_237107_length_268_cov_2.982249	95	175	31	22	80	0.2750000
NODE_237115_length_268_cov_2.940828	28	97	0	69	69	1.0000000
NODE_237185_length_268_cov_2.668639	57	110	0	53	53	1.0000000
NODE_237190_length_268_cov_2.621302	149	176	0	1	27	0.0370370
NODE_237190_length_268_cov_2.621302	149	176	2	26	27	0.9629630
NODE_237325_length_268_cov_2.289941	87	127	23	2	40	0.0500000
NODE_237325_length_268_cov_2.289941	87	127	24	3	40	0.0750000
NODE_237325_length_268_cov_2.289941	87	127	25	35	40	0.8750000
NODE_237345_length_268_cov_2.224852	96	176	0	18	80	0.2250000
NODE_237345_length_268_cov_2.224852	96	176	2	62	80	0.7750000
NODE_237345_length_268_cov_2.224852	149	229	0	4	80	0.0500000
NODE_237345_length_268_cov_2.224852	149	229	2	76	80	0.9500000
NODE_237457_length_268_cov_2.005917	97	162	1	7	65	0.1076923
NODE_237457_length_268_cov_2.005917	97	162	2	58	65	0.8923077
NODE_237502_length_268_cov_1.840237	80	155	2	9	75	0.1200000
NODE_237502_length_268_cov_1.840237	80	155	4	38	75	0.5066667
NODE_237502_length_268_cov_1.840237	80	155	6	28	75	0.3733333
NODE_237572_length_268_cov_1.810651	8	84	0	76	76	1.0000000
NODE_237831_length_268_cov_1.532544	186	257	6	14	71	0.1971831
NODE_237831_length_268_cov_1.532544	186	257	8	1	71	0.0140845
NODE_237831_length_268_cov_1.532544	186	257	10	1	71	0.0140845
NODE_237831_length_268_cov_1.532544	186	257	12	9	71	0.1267606
NODE_237831_length_268_cov_1.532544	186	257	14	6	71	0.0845070
NODE_237831_length_268_cov_1.532544	186	257	16	1	71	0.0140845
NODE_237831_length_268_cov_1.532544	186	257	18	2	71	0.0281690
NODE_237831_length_268_cov_1.532544	186	257	20	11	71	0.1549296
NODE_237831_length_268_cov_1.532544	186	257	22	1	71	0.0140845
NODE_237831_length_268_cov_1.532544	186	257	24	1	71	0.0140845
NODE_237831_length_268_cov_1.532544	186	257	30	6	71	0.0845070
NODE_237831_length_268_cov_1.532544	186	257	31	3	71	0.0422535
NODE_237831_length_268_cov_1.532544	186	257	33	1	71	0.0140845
NODE_237831_length_268_cov_1.532544	186	257	35	1	71	0.0140845
NODE_237831_length_268_cov_1.532544	186	257	36	3	71	0.0422535
NODE_237831_length_268_cov_1.532544	186	257	38	6	71	0.0845070
NODE_237831_length_268_cov_1.532544	186	257	40	4	71	0.0563380
NODE_237906_length_268_cov_1.508876	52	131	0	79	79	1.0000000
NODE_238009_length_268_cov_1.384615	0	46	0	46	46	1.0000000
NODE_238070_length_268_cov_1.278107	100	175	0	75	75	1.0000000
NODE_238153_length_268_cov_1.207101	187	209	2	22	22	1.0000000
NODE_238478_length_268_cov_1.153846	135	195	0	60	60	1.0000000
NODE_239018_length_268_cov_0.852071	59	119	9	11	60	0.1833333
NODE_239018_length_268_cov_0.852071	59	119	11	37	60	0.6166667
NODE_239018_length_268_cov_0.852071	59	119	12	2	60	0.0333333
NODE_239018_length_268_cov_0.852071	59	119	13	3	60	0.0500000
NODE_239018_length_268_cov_0.852071	59	119	14	7	60	0.1166667
NODE_239805_length_267_cov_4.297619	0	52	0	52	52	1.0000000
NODE_239817_length_267_cov_4.119048	41	87	4	46	46	1.0000000
NODE_239845_length_267_cov_3.785714	96	163	0	67	67	1.0000000
NODE_239845_length_267_cov_3.785714	136	178	0	42	42	1.0000000
NODE_239873_length_267_cov_3.535714	40	101	0	12	61	0.1967213
NODE_239873_length_267_cov_3.535714	40	101	2	10	61	0.1639344
NODE_239873_length_267_cov_3.535714	40	101	6	39	61	0.6393443
NODE_239873_length_267_cov_3.535714	74	154	0	10	80	0.1250000
NODE_239873_length_267_cov_3.535714	74	154	4	21	80	0.2625000
NODE_239873_length_267_cov_3.535714	74	154	6	49	80	0.6125000
NODE_239958_length_267_cov_3.005952	216	267	0	51	51	1.0000000
NODE_239959_length_267_cov_3.000000	87	144	0	2	57	0.0350877
NODE_239959_length_267_cov_3.000000	87	144	6	3	57	0.0526316
NODE_239959_length_267_cov_3.000000	87	144	10	2	57	0.0350877
NODE_239959_length_267_cov_3.000000	87	144	11	9	57	0.1578947
NODE_239959_length_267_cov_3.000000	87	144	13	11	57	0.1929825
NODE_239959_length_267_cov_3.000000	87	144	15	1	57	0.0175439
NODE_239959_length_267_cov_3.000000	87	144	17	19	57	0.3333333
NODE_239959_length_267_cov_3.000000	87	144	21	2	57	0.0350877
NODE_239959_length_267_cov_3.000000	87	144	23	8	57	0.1403509
NODE_240007_length_267_cov_2.726190	177	220	0	43	43	1.0000000
NODE_240024_length_267_cov_2.690476	117	170	13	6	53	0.1132075
NODE_240024_length_267_cov_2.690476	117	170	14	14	53	0.2641509
NODE_240024_length_267_cov_2.690476	117	170	16	33	53	0.6226415
NODE_240029_length_267_cov_2.666667	198	267	0	69	69	1.0000000
NODE_240114_length_267_cov_2.428571	189	254	0	63	65	0.9692308
NODE_240114_length_267_cov_2.428571	189	254	3	2	65	0.0307692
NODE_240207_length_267_cov_2.208333	45	103	0	58	58	1.0000000
NODE_240246_length_267_cov_2.125000	124	175	0	51	51	1.0000000
NODE_240303_length_267_cov_2.077381	65	146	2	81	81	1.0000000
NODE_240303_length_267_cov_2.077381	229	264	0	35	35	1.0000000
NODE_240331_length_267_cov_2.005952	147	228	2	13	81	0.1604938
NODE_240331_length_267_cov_2.005952	147	228	3	13	81	0.1604938
NODE_240331_length_267_cov_2.005952	147	228	4	38	81	0.4691358
NODE_240331_length_267_cov_2.005952	147	228	12	5	81	0.0617284
NODE_240331_length_267_cov_2.005952	147	228	14	2	81	0.0246914
NODE_240331_length_267_cov_2.005952	147	228	18	10	81	0.1234568
NODE_240331_length_267_cov_2.005952	201	267	0	27	66	0.4090909
NODE_240331_length_267_cov_2.005952	201	267	2	25	66	0.3787879
NODE_240331_length_267_cov_2.005952	201	267	3	13	66	0.1969697
NODE_240331_length_267_cov_2.005952	201	267	4	1	66	0.0151515
NODE_240336_length_267_cov_1.988095	77	157	0	80	80	1.0000000
NODE_240336_length_267_cov_1.988095	130	210	0	80	80	1.0000000
NODE_240620_length_267_cov_1.755952	119	199	0	80	80	1.0000000
NODE_240624_length_267_cov_1.750000	23	104	15	6	81	0.0740741
NODE_240624_length_267_cov_1.750000	23	104	19	1	81	0.0123457
NODE_240624_length_267_cov_1.750000	23	104	23	12	81	0.1481481
NODE_240624_length_267_cov_1.750000	23	104	25	1	81	0.0123457
NODE_240624_length_267_cov_1.750000	23	104	27	14	81	0.1728395
NODE_240624_length_267_cov_1.750000	23	104	29	6	81	0.0740741
NODE_240624_length_267_cov_1.750000	23	104	31	1	81	0.0123457
NODE_240624_length_267_cov_1.750000	23	104	33	2	81	0.0246914
NODE_240624_length_267_cov_1.750000	23	104	35	3	81	0.0370370
NODE_240624_length_267_cov_1.750000	23	104	37	7	81	0.0864198
NODE_240624_length_267_cov_1.750000	23	104	38	28	81	0.3456790
NODE_240624_length_267_cov_1.750000	179	208	2	2	29	0.0689655
NODE_240624_length_267_cov_1.750000	179	208	4	4	29	0.1379310
NODE_240624_length_267_cov_1.750000	179	208	6	6	29	0.2068966
NODE_240624_length_267_cov_1.750000	179	208	8	5	29	0.1724138
NODE_240624_length_267_cov_1.750000	179	208	10	12	29	0.4137931
NODE_240653_length_267_cov_1.690476	18	90	0	72	72	1.0000000
NODE_240790_length_267_cov_1.517857	6	43	0	37	37	1.0000000
NODE_241075_length_267_cov_1.214286	37	91	0	54	54	1.0000000
NODE_241240_length_267_cov_1.214286	89	126	0	37	37	1.0000000
NODE_241352_length_267_cov_1.208333	124	164	6	40	40	1.0000000
NODE_241484_length_267_cov_1.125000	57	103	0	46	46	1.0000000
NODE_241512_length_267_cov_1.089286	119	196	0	77	77	1.0000000
NODE_241512_length_267_cov_1.089286	169	249	0	80	80	1.0000000
NODE_241517_length_267_cov_1.083333	133	152	22	2	19	0.1052632
NODE_241517_length_267_cov_1.083333	133	152	23	2	19	0.1052632
NODE_241517_length_267_cov_1.083333	133	152	26	15	19	0.7894737
NODE_241517_length_267_cov_1.083333	183	264	8	6	81	0.0740741
NODE_241517_length_267_cov_1.083333	183	264	12	1	81	0.0123457
NODE_241517_length_267_cov_1.083333	183	264	14	19	81	0.2345679
NODE_241517_length_267_cov_1.083333	183	264	16	4	81	0.0493827
NODE_241517_length_267_cov_1.083333	183	264	18	8	81	0.0987654
NODE_241517_length_267_cov_1.083333	183	264	20	9	81	0.1111111
NODE_241517_length_267_cov_1.083333	183	264	22	2	81	0.0246914
NODE_241517_length_267_cov_1.083333	183	264	24	17	81	0.2098765
NODE_241517_length_267_cov_1.083333	183	264	26	9	81	0.1111111
NODE_241517_length_267_cov_1.083333	183	264	28	6	81	0.0740741
NODE_241588_length_267_cov_1.017857	205	267	0	62	62	1.0000000
NODE_241633_length_267_cov_0.982143	4	75	0	63	71	0.8873239
NODE_241633_length_267_cov_0.982143	4	75	2	8	71	0.1126761
NODE_242999_length_266_cov_5.706587	120	199	0	79	79	1.0000000
NODE_242999_length_266_cov_5.706587	172	239	0	67	67	1.0000000
NODE_243010_length_266_cov_5.107784	68	150	2	25	82	0.3048781
NODE_243010_length_266_cov_5.107784	68	150	4	57	82	0.6951219
NODE_243064_length_266_cov_4.125749	99	168	4	9	69	0.1304348
NODE_243064_length_266_cov_4.125749	99	168	6	1	69	0.0144928
NODE_243064_length_266_cov_4.125749	99	168	8	59	69	0.8550724
NODE_243079_length_266_cov_3.958084	40	120	0	80	80	1.0000000
NODE_243079_length_266_cov_3.958084	93	159	0	66	66	1.0000000
NODE_243136_length_266_cov_3.419162	68	130	4	62	62	1.0000000
NODE_243136_length_266_cov_3.419162	116	183	0	39	67	0.5820895
NODE_243136_length_266_cov_3.419162	116	183	4	28	67	0.4179105
NODE_243168_length_266_cov_3.137725	6	86	0	80	80	1.0000000
NODE_243168_length_266_cov_3.137725	59	120	0	61	61	1.0000000
NODE_243174_length_266_cov_3.107784	166	232	12	5	66	0.0757576
NODE_243174_length_266_cov_3.107784	166	232	14	10	66	0.1515152
NODE_243174_length_266_cov_3.107784	166	232	16	13	66	0.1969697
NODE_243174_length_266_cov_3.107784	166	232	22	8	66	0.1212121
NODE_243174_length_266_cov_3.107784	166	232	25	1	66	0.0151515
NODE_243174_length_266_cov_3.107784	166	232	26	7	66	0.1060606
NODE_243174_length_266_cov_3.107784	166	232	27	4	66	0.0606061
NODE_243174_length_266_cov_3.107784	166	232	28	2	66	0.0303030
NODE_243174_length_266_cov_3.107784	166	232	29	3	66	0.0454545
NODE_243174_length_266_cov_3.107784	166	232	30	5	66	0.0757576
NODE_243174_length_266_cov_3.107784	166	232	32	3	66	0.0454545
NODE_243174_length_266_cov_3.107784	166	232	34	3	66	0.0454545
NODE_243174_length_266_cov_3.107784	166	232	36	2	66	0.0303030
NODE_243475_length_266_cov_2.179641	110	191	0	36	81	0.4444444
NODE_243475_length_266_cov_2.179641	110	191	2	7	81	0.0864198
NODE_243475_length_266_cov_2.179641	110	191	4	19	81	0.2345679
NODE_243475_length_266_cov_2.179641	110	191	6	5	81	0.0617284
NODE_243475_length_266_cov_2.179641	110	191	8	14	81	0.1728395
NODE_243497_length_266_cov_2.137725	156	236	0	39	80	0.4875000
NODE_243497_length_266_cov_2.137725	156	236	1	11	80	0.1375000
NODE_243497_length_266_cov_2.137725	156	236	2	30	80	0.3750000
NODE_243570_length_266_cov_2.023952	47	123	0	76	76	1.0000000
NODE_243972_length_266_cov_1.532934	155	235	0	80	80	1.0000000
NODE_244681_length_266_cov_1.113772	70	97	0	27	27	1.0000000
NODE_244760_length_266_cov_1.023952	144	201	0	57	57	1.0000000
NODE_244760_length_266_cov_1.023952	199	265	0	66	66	1.0000000
NODE_245049_length_266_cov_0.916168	51	122	0	71	71	1.0000000
NODE_245280_length_266_cov_0.730539	132	158	0	26	26	1.0000000
NODE_245538_length_266_cov_0.610778	99	139	0	40	40	1.0000000
NODE_245538_length_266_cov_0.610778	112	156	0	44	44	1.0000000
NODE_246087_length_265_cov_7.843373	128	208	0	54	80	0.6750000
NODE_246087_length_265_cov_7.843373	128	208	2	5	80	0.0625000
NODE_246087_length_265_cov_7.843373	128	208	4	1	80	0.0125000
NODE_246087_length_265_cov_7.843373	128	208	6	4	80	0.0500000
NODE_246087_length_265_cov_7.843373	128	208	8	5	80	0.0625000
NODE_246087_length_265_cov_7.843373	128	208	10	8	80	0.1000000
NODE_246087_length_265_cov_7.843373	128	208	12	3	80	0.0375000
NODE_246192_length_265_cov_4.054217	65	145	0	80	80	1.0000000
NODE_246192_length_265_cov_4.054217	118	198	0	80	80	1.0000000
NODE_246198_length_265_cov_3.993976	195	231	0	36	36	1.0000000
NODE_246284_length_265_cov_3.150602	183	263	0	80	80	1.0000000
NODE_246374_length_265_cov_2.789157	177	238	0	61	61	1.0000000
NODE_246409_length_265_cov_2.734940	167	247	0	17	80	0.2125000
NODE_246409_length_265_cov_2.734940	167	247	2	63	80	0.7875000
NODE_246432_length_265_cov_2.608434	188	259	0	71	71	1.0000000
NODE_246606_length_265_cov_2.156627	197	237	2	35	40	0.8750000
NODE_246606_length_265_cov_2.156627	197	237	4	5	40	0.1250000
NODE_246624_length_265_cov_2.150602	169	218	2	35	49	0.7142857
NODE_246624_length_265_cov_2.150602	169	218	12	4	49	0.0816327
NODE_246624_length_265_cov_2.150602	169	218	14	8	49	0.1632653
NODE_246624_length_265_cov_2.150602	169	218	16	2	49	0.0408163
NODE_246692_length_265_cov_1.975904	15	44	0	29	29	1.0000000
NODE_246811_length_265_cov_1.843373	195	265	4	70	70	1.0000000
NODE_247028_length_265_cov_1.620482	115	186	0	71	71	1.0000000
NODE_247028_length_265_cov_1.620482	117	171	0	54	54	1.0000000
NODE_247031_length_265_cov_1.614458	53	113	1	23	60	0.3833333
NODE_247031_length_265_cov_1.614458	53	113	7	10	60	0.1666667
NODE_247031_length_265_cov_1.614458	53	113	17	2	60	0.0333333
NODE_247031_length_265_cov_1.614458	53	113	19	4	60	0.0666667
NODE_247031_length_265_cov_1.614458	53	113	20	1	60	0.0166667
NODE_247031_length_265_cov_1.614458	53	113	26	20	60	0.3333333
NODE_247031_length_265_cov_1.614458	86	166	17	2	80	0.0250000
NODE_247031_length_265_cov_1.614458	86	166	19	4	80	0.0500000
NODE_247031_length_265_cov_1.614458	86	166	20	1	80	0.0125000
NODE_247031_length_265_cov_1.614458	86	166	26	21	80	0.2625000
NODE_247031_length_265_cov_1.614458	86	166	28	11	80	0.1375000
NODE_247031_length_265_cov_1.614458	86	166	42	2	80	0.0250000
NODE_247031_length_265_cov_1.614458	86	166	48	9	80	0.1125000
NODE_247031_length_265_cov_1.614458	86	166	50	1	80	0.0125000
NODE_247031_length_265_cov_1.614458	86	166	52	6	80	0.0750000
NODE_247031_length_265_cov_1.614458	86	166	54	23	80	0.2875000
NODE_247314_length_265_cov_1.337349	107	168	4	45	61	0.7377049
NODE_247314_length_265_cov_1.337349	107	168	6	16	61	0.2622951
NODE_247952_length_265_cov_1.000000	187	251	0	64	64	1.0000000
NODE_247972_length_265_cov_0.987952	44	63	0	19	19	1.0000000
NODE_249395_length_264_cov_4.018182	141	178	0	37	37	1.0000000
NODE_249404_length_264_cov_3.957576	59	132	0	12	73	0.1643836
NODE_249404_length_264_cov_3.957576	59	132	2	61	73	0.8356164
NODE_249404_length_264_cov_3.957576	112	192	0	31	80	0.3875000
NODE_249404_length_264_cov_3.957576	112	192	2	49	80	0.6125000
NODE_249415_length_264_cov_3.824242	178	220	0	42	42	1.0000000
NODE_249452_length_264_cov_3.400000	73	125	8	52	52	1.0000000
NODE_249452_length_264_cov_3.400000	124	165	0	37	41	0.9024390
NODE_249452_length_264_cov_3.400000	124	165	8	4	41	0.0975610
NODE_249485_length_264_cov_3.133333	119	186	0	67	67	1.0000000
NODE_249530_length_264_cov_3.012121	122	198	0	54	76	0.7105263
NODE_249530_length_264_cov_3.012121	122	198	2	22	76	0.2894737
NODE_249904_length_264_cov_2.048485	32	98	2	8	66	0.1212121
NODE_249904_length_264_cov_2.048485	32	98	4	27	66	0.4090909
NODE_249904_length_264_cov_2.048485	32	98	6	16	66	0.2424242
NODE_249904_length_264_cov_2.048485	32	98	8	6	66	0.0909091
NODE_249904_length_264_cov_2.048485	32	98	10	2	66	0.0303030
NODE_249904_length_264_cov_2.048485	32	98	12	1	66	0.0151515
NODE_249904_length_264_cov_2.048485	32	98	14	2	66	0.0303030
NODE_249904_length_264_cov_2.048485	32	98	18	2	66	0.0303030
NODE_249904_length_264_cov_2.048485	32	98	22	2	66	0.0303030
NODE_249905_length_264_cov_2.048485	133	176	0	28	43	0.6511628
NODE_249905_length_264_cov_2.048485	133	176	2	15	43	0.3488372
NODE_249912_length_264_cov_2.012121	20	84	0	64	64	1.0000000
NODE_249931_length_264_cov_1.951515	178	211	0	33	33	1.0000000
NODE_249982_length_264_cov_1.854545	130	161	0	31	31	1.0000000
NODE_250202_length_264_cov_1.745455	26	81	0	55	55	1.0000000
NODE_250202_length_264_cov_1.745455	86	153	0	67	67	1.0000000
NODE_250203_length_264_cov_1.745455	90	169	3	20	79	0.2531646
NODE_250203_length_264_cov_1.745455	90	169	4	35	79	0.4430380
NODE_250203_length_264_cov_1.745455	90	169	6	1	79	0.0126582
NODE_250203_length_264_cov_1.745455	90	169	8	23	79	0.2911392
NODE_250203_length_264_cov_1.745455	143	207	4	19	64	0.2968750
NODE_250203_length_264_cov_1.745455	143	207	6	1	64	0.0156250
NODE_250203_length_264_cov_1.745455	143	207	8	44	64	0.6875000
NODE_250297_length_264_cov_1.569697	173	236	0	63	63	1.0000000
NODE_250314_length_264_cov_1.545455	206	255	2	49	49	1.0000000
NODE_250381_length_264_cov_1.545455	35	66	0	31	31	1.0000000
NODE_250446_length_264_cov_1.503030	0	63	0	63	63	1.0000000
NODE_250513_length_264_cov_1.406061	149	230	0	81	81	1.0000000
NODE_250513_length_264_cov_1.406061	225	260	0	35	35	1.0000000
NODE_250635_length_264_cov_1.236364	2	63	2	3	61	0.0491803
NODE_250635_length_264_cov_1.236364	2	63	6	4	61	0.0655738
NODE_250635_length_264_cov_1.236364	2	63	7	6	61	0.0983607
NODE_250635_length_264_cov_1.236364	2	63	9	48	61	0.7868853
NODE_251015_length_264_cov_1.151515	11	68	0	57	57	1.0000000
NODE_251529_length_264_cov_0.921212	49	85	0	36	36	1.0000000
NODE_251703_length_264_cov_0.721212	233	252	0	19	19	1.0000000
NODE_252559_length_263_cov_5.115854	132	219	12	15	87	0.1724138
NODE_252559_length_263_cov_5.115854	132	219	16	23	87	0.2643678
NODE_252559_length_263_cov_5.115854	132	219	18	49	87	0.5632184
NODE_252563_length_263_cov_4.914634	45	117	0	7	72	0.0972222
NODE_252563_length_263_cov_4.914634	45	117	4	50	72	0.6944444
NODE_252563_length_263_cov_4.914634	45	117	8	15	72	0.2083333
NODE_252595_length_263_cov_4.225610	67	124	4	13	57	0.2280702
NODE_252595_length_263_cov_4.225610	67	124	6	31	57	0.5438597
NODE_252595_length_263_cov_4.225610	67	124	8	13	57	0.2280702
NODE_252663_length_263_cov_3.518293	104	176	0	20	72	0.2777778
NODE_252663_length_263_cov_3.518293	104	176	3	7	72	0.0972222
NODE_252663_length_263_cov_3.518293	104	176	6	45	72	0.6250000
NODE_252766_length_263_cov_2.908537	7	93	0	24	86	0.2790698
NODE_252766_length_263_cov_2.908537	7	93	1	20	86	0.2325581
NODE_252766_length_263_cov_2.908537	7	93	3	18	86	0.2093023
NODE_252766_length_263_cov_2.908537	7	93	5	24	86	0.2790698
NODE_252778_length_263_cov_2.798780	67	146	10	11	79	0.1392405
NODE_252778_length_263_cov_2.798780	67	146	11	10	79	0.1265823
NODE_252778_length_263_cov_2.798780	67	146	12	40	79	0.5063291
NODE_252778_length_263_cov_2.798780	67	146	16	18	79	0.2278481
NODE_252932_length_263_cov_2.396341	207	238	0	31	31	1.0000000
NODE_253261_length_263_cov_1.865854	51	81	0	1	30	0.0333333
NODE_253261_length_263_cov_1.865854	51	81	5	1	30	0.0333333
NODE_253261_length_263_cov_1.865854	51	81	7	3	30	0.1000000
NODE_253261_length_263_cov_1.865854	51	81	9	4	30	0.1333333
NODE_253261_length_263_cov_1.865854	51	81	11	4	30	0.1333333
NODE_253261_length_263_cov_1.865854	51	81	13	17	30	0.5666667
NODE_253310_length_263_cov_1.847561	113	189	0	76	76	1.0000000
NODE_253379_length_263_cov_1.750000	151	231	2	25	80	0.3125000
NODE_253379_length_263_cov_1.750000	151	231	4	21	80	0.2625000
NODE_253379_length_263_cov_1.750000	151	231	6	34	80	0.4250000
NODE_253468_length_263_cov_1.579268	32	95	19	2	63	0.0317460
NODE_253468_length_263_cov_1.579268	32	95	26	1	63	0.0158730
NODE_253468_length_263_cov_1.579268	32	95	30	1	63	0.0158730
NODE_253468_length_263_cov_1.579268	32	95	32	2	63	0.0317460
NODE_253468_length_263_cov_1.579268	32	95	40	4	63	0.0634921
NODE_253468_length_263_cov_1.579268	32	95	44	17	63	0.2698413
NODE_253468_length_263_cov_1.579268	32	95	48	4	63	0.0634921
NODE_253468_length_263_cov_1.579268	32	95	50	1	63	0.0158730
NODE_253468_length_263_cov_1.579268	32	95	52	20	63	0.3174603
NODE_253468_length_263_cov_1.579268	32	95	54	11	63	0.1746032
NODE_253477_length_263_cov_1.567073	98	155	2	57	57	1.0000000
NODE_253619_length_263_cov_1.506098	157	217	0	46	60	0.7666667
NODE_253619_length_263_cov_1.506098	157	217	4	14	60	0.2333333
NODE_253620_length_263_cov_1.506098	84	113	6	6	29	0.2068966
NODE_253620_length_263_cov_1.506098	84	113	8	23	29	0.7931035
NODE_253753_length_263_cov_1.286585	143	223	4	1	80	0.0125000
NODE_253753_length_263_cov_1.286585	143	223	8	2	80	0.0250000
NODE_253753_length_263_cov_1.286585	143	223	12	7	80	0.0875000
NODE_253753_length_263_cov_1.286585	143	223	14	1	80	0.0125000
NODE_253753_length_263_cov_1.286585	143	223	18	22	80	0.2750000
NODE_253753_length_263_cov_1.286585	143	223	21	3	80	0.0375000
NODE_253753_length_263_cov_1.286585	143	223	22	2	80	0.0250000
NODE_253753_length_263_cov_1.286585	143	223	24	1	80	0.0125000
NODE_253753_length_263_cov_1.286585	143	223	30	1	80	0.0125000
NODE_253753_length_263_cov_1.286585	143	223	32	8	80	0.1000000
NODE_253753_length_263_cov_1.286585	143	223	34	2	80	0.0250000
NODE_253753_length_263_cov_1.286585	143	223	36	30	80	0.3750000
NODE_253788_length_263_cov_1.243902	206	263	0	57	57	1.0000000
NODE_254174_length_263_cov_1.170732	12	66	0	54	54	1.0000000
NODE_254174_length_263_cov_1.170732	39	119	0	80	80	1.0000000
NODE_254301_length_263_cov_1.067073	137	202	0	65	65	1.0000000
NODE_254301_length_263_cov_1.067073	175	255	0	80	80	1.0000000
NODE_254783_length_263_cov_0.810976	163	245	76	1	82	0.0121951
NODE_254783_length_263_cov_0.810976	163	245	80	1	82	0.0121951
NODE_254783_length_263_cov_0.810976	163	245	82	1	82	0.0121951
NODE_254783_length_263_cov_0.810976	163	245	86	1	82	0.0121951
NODE_254783_length_263_cov_0.810976	163	245	97	2	82	0.0243902
NODE_254783_length_263_cov_0.810976	163	245	101	1	82	0.0121951
NODE_254783_length_263_cov_0.810976	163	245	107	2	82	0.0243902
NODE_254783_length_263_cov_0.810976	163	245	113	1	82	0.0121951
NODE_254783_length_263_cov_0.810976	163	245	116	2	82	0.0243902
NODE_254783_length_263_cov_0.810976	163	245	126	1	82	0.0121951
NODE_254783_length_263_cov_0.810976	163	245	128	1	82	0.0121951
NODE_254783_length_263_cov_0.810976	163	245	142	1	82	0.0121951
NODE_254783_length_263_cov_0.810976	163	245	152	1	82	0.0121951
NODE_254783_length_263_cov_0.810976	163	245	155	1	82	0.0121951
NODE_254783_length_263_cov_0.810976	163	245	166	1	82	0.0121951
NODE_254783_length_263_cov_0.810976	163	245	170	2	82	0.0243902
NODE_254783_length_263_cov_0.810976	163	245	172	2	82	0.0243902
NODE_254783_length_263_cov_0.810976	163	245	174	1	82	0.0121951
NODE_254783_length_263_cov_0.810976	163	245	177	1	82	0.0121951
NODE_254783_length_263_cov_0.810976	163	245	178	1	82	0.0121951
NODE_254783_length_263_cov_0.810976	163	245	180	1	82	0.0121951
NODE_254783_length_263_cov_0.810976	163	245	187	1	82	0.0121951
NODE_254783_length_263_cov_0.810976	163	245	189	2	82	0.0243902
NODE_254783_length_263_cov_0.810976	163	245	191	1	82	0.0121951
NODE_254783_length_263_cov_0.810976	163	245	193	1	82	0.0121951
NODE_254783_length_263_cov_0.810976	163	245	199	1	82	0.0121951
NODE_254783_length_263_cov_0.810976	163	245	202	1	82	0.0121951
NODE_254783_length_263_cov_0.810976	163	245	206	1	82	0.0121951
NODE_254783_length_263_cov_0.810976	163	245	209	1	82	0.0121951
NODE_254783_length_263_cov_0.810976	163	245	210	1	82	0.0121951
NODE_254783_length_263_cov_0.810976	163	245	226	1	82	0.0121951
NODE_254783_length_263_cov_0.810976	163	245	234	1	82	0.0121951
NODE_254783_length_263_cov_0.810976	163	245	236	1	82	0.0121951
NODE_254783_length_263_cov_0.810976	163	245	254	1	82	0.0121951
NODE_254783_length_263_cov_0.810976	163	245	262	1	82	0.0121951
NODE_254783_length_263_cov_0.810976	163	245	277	1	82	0.0121951
NODE_254783_length_263_cov_0.810976	163	245	278	1	82	0.0121951
NODE_254783_length_263_cov_0.810976	163	245	280	1	82	0.0121951
NODE_254783_length_263_cov_0.810976	163	245	284	1	82	0.0121951
NODE_254783_length_263_cov_0.810976	163	245	295	1	82	0.0121951
NODE_254783_length_263_cov_0.810976	163	245	304	1	82	0.0121951
NODE_254783_length_263_cov_0.810976	163	245	305	1	82	0.0121951
NODE_254783_length_263_cov_0.810976	163	245	311	1	82	0.0121951
NODE_254783_length_263_cov_0.810976	163	245	319	1	82	0.0121951
NODE_254783_length_263_cov_0.810976	163	245	321	1	82	0.0121951
NODE_254783_length_263_cov_0.810976	163	245	322	1	82	0.0121951
NODE_254783_length_263_cov_0.810976	163	245	328	1	82	0.0121951
NODE_254783_length_263_cov_0.810976	163	245	331	1	82	0.0121951
NODE_254783_length_263_cov_0.810976	163	245	333	1	82	0.0121951
NODE_254783_length_263_cov_0.810976	163	245	335	2	82	0.0243902
NODE_254783_length_263_cov_0.810976	163	245	348	1	82	0.0121951
NODE_254783_length_263_cov_0.810976	163	245	349	2	82	0.0243902
NODE_254783_length_263_cov_0.810976	163	245	353	1	82	0.0121951
NODE_254783_length_263_cov_0.810976	163	245	364	3	82	0.0365854
NODE_254783_length_263_cov_0.810976	163	245	366	1	82	0.0121951
NODE_254783_length_263_cov_0.810976	163	245	369	2	82	0.0243902
NODE_254783_length_263_cov_0.810976	163	245	373	1	82	0.0121951
NODE_254783_length_263_cov_0.810976	163	245	379	1	82	0.0121951
NODE_254783_length_263_cov_0.810976	163	245	381	1	82	0.0121951
NODE_254783_length_263_cov_0.810976	163	245	385	2	82	0.0243902
NODE_254783_length_263_cov_0.810976	163	245	387	3	82	0.0365854
NODE_254783_length_263_cov_0.810976	163	245	388	3	82	0.0365854
NODE_254783_length_263_cov_0.810976	163	245	390	3	82	0.0365854
NODE_254783_length_263_cov_0.810976	163	245	391	1	82	0.0121951
NODE_255446_length_263_cov_0.621951	212	258	0	46	46	1.0000000
NODE_255524_length_263_cov_0.621951	131	151	0	20	20	1.0000000
NODE_255559_length_263_cov_0.621951	67	86	0	19	19	1.0000000
NODE_255727_length_262_cov_5.312883	20	82	0	62	62	1.0000000
NODE_255769_length_262_cov_4.447853	102	155	0	53	53	1.0000000
NODE_255821_length_262_cov_3.766871	48	89	0	41	41	1.0000000
NODE_255860_length_262_cov_3.435583	158	235	0	77	77	1.0000000
NODE_255945_length_262_cov_2.938650	142	222	0	48	80	0.6000000
NODE_255945_length_262_cov_2.938650	142	222	2	32	80	0.4000000
NODE_256009_length_262_cov_2.723926	103	183	0	39	80	0.4875000
NODE_256009_length_262_cov_2.723926	103	183	8	41	80	0.5125000
NODE_256049_length_262_cov_2.509202	88	148	4	60	60	1.0000000
NODE_256050_length_262_cov_2.509202	0	61	0	61	61	1.0000000
NODE_256050_length_262_cov_2.509202	107	171	0	64	64	1.0000000
NODE_256050_length_262_cov_2.509202	144	224	0	80	80	1.0000000
NODE_256129_length_262_cov_2.429448	14	87	2	8	73	0.1095890
NODE_256129_length_262_cov_2.429448	14	87	4	21	73	0.2876712
NODE_256129_length_262_cov_2.429448	14	87	6	44	73	0.6027398
NODE_256129_length_262_cov_2.429448	62	149	0	15	87	0.1724138
NODE_256129_length_262_cov_2.429448	62	149	2	22	87	0.2528736
NODE_256129_length_262_cov_2.429448	62	149	4	42	87	0.4827586
NODE_256129_length_262_cov_2.429448	62	149	6	8	87	0.0919540
NODE_256176_length_262_cov_2.226994	2	79	0	77	77	1.0000000
NODE_256187_length_262_cov_2.202454	61	81	0	20	20	1.0000000
NODE_256199_length_262_cov_2.190184	172	235	25	3	63	0.0476190
NODE_256199_length_262_cov_2.190184	172	235	29	3	63	0.0476190
NODE_256199_length_262_cov_2.190184	172	235	31	10	63	0.1587302
NODE_256199_length_262_cov_2.190184	172	235	32	2	63	0.0317460
NODE_256199_length_262_cov_2.190184	172	235	33	1	63	0.0158730
NODE_256199_length_262_cov_2.190184	172	235	34	18	63	0.2857143
NODE_256199_length_262_cov_2.190184	172	235	36	26	63	0.4126984
NODE_256239_length_262_cov_2.177914	133	189	0	56	56	1.0000000
NODE_256265_length_262_cov_2.122699	96	157	0	61	61	1.0000000
NODE_256386_length_262_cov_1.877301	0	77	0	24	77	0.3116883
NODE_256386_length_262_cov_1.877301	0	77	2	22	77	0.2857143
NODE_256386_length_262_cov_1.877301	0	77	3	6	77	0.0779221
NODE_256386_length_262_cov_1.877301	0	77	5	10	77	0.1298701
NODE_256386_length_262_cov_1.877301	0	77	6	15	77	0.1948052
NODE_256390_length_262_cov_1.877301	77	124	10	47	47	1.0000000
NODE_256481_length_262_cov_1.871166	192	252	0	60	60	1.0000000
NODE_256596_length_262_cov_1.736196	149	208	0	59	59	1.0000000
NODE_256630_length_262_cov_1.680982	2	82	0	80	80	1.0000000
NODE_256650_length_262_cov_1.656442	135	166	0	31	31	1.0000000
NODE_256659_length_262_cov_1.638037	111	142	0	12	31	0.3870968
NODE_256659_length_262_cov_1.638037	111	142	4	10	31	0.3225806
NODE_256659_length_262_cov_1.638037	111	142	6	6	31	0.1935484
NODE_256659_length_262_cov_1.638037	111	142	8	3	31	0.0967742
NODE_256704_length_262_cov_1.576687	102	182	0	80	80	1.0000000
NODE_256704_length_262_cov_1.576687	155	221	0	66	66	1.0000000
NODE_256742_length_262_cov_1.564417	69	124	0	55	55	1.0000000
NODE_256742_length_262_cov_1.564417	106	177	0	71	71	1.0000000
NODE_256933_length_262_cov_1.349693	52	102	0	50	50	1.0000000
NODE_256933_length_262_cov_1.349693	83	149	0	66	66	1.0000000
NODE_257199_length_262_cov_1.251534	44	124	4	24	80	0.3000000
NODE_257199_length_262_cov_1.251534	44	124	6	1	80	0.0125000
NODE_257199_length_262_cov_1.251534	44	124	8	7	80	0.0875000
NODE_257199_length_262_cov_1.251534	44	124	12	19	80	0.2375000
NODE_257199_length_262_cov_1.251534	44	124	14	29	80	0.3625000
NODE_257199_length_262_cov_1.251534	97	171	8	5	74	0.0675676
NODE_257199_length_262_cov_1.251534	97	171	10	6	74	0.0810811
NODE_257199_length_262_cov_1.251534	97	171	12	30	74	0.4054054
NODE_257199_length_262_cov_1.251534	97	171	14	33	74	0.4459459
NODE_258876_length_261_cov_31.913580	32	112	0	80	80	1.0000000
NODE_258876_length_261_cov_31.913580	85	171	0	86	86	1.0000000
NODE_258901_length_261_cov_6.376543	126	201	0	75	75	1.0000000
NODE_258901_length_261_cov_6.376543	179	254	0	75	75	1.0000000
NODE_258929_length_261_cov_5.469136	56	132	0	76	76	1.0000000
NODE_259329_length_261_cov_2.425926	53	134	0	36	81	0.4444444
NODE_259329_length_261_cov_2.425926	53	134	2	45	81	0.5555556
NODE_259361_length_261_cov_2.333333	41	136	2	5	95	0.0526316
NODE_259361_length_261_cov_2.333333	41	136	4	1	95	0.0105263
NODE_259361_length_261_cov_2.333333	41	136	6	2	95	0.0210526
NODE_259361_length_261_cov_2.333333	41	136	8	19	95	0.2000000
NODE_259361_length_261_cov_2.333333	41	136	9	1	95	0.0105263
NODE_259361_length_261_cov_2.333333	41	136	10	67	95	0.7052631
NODE_259435_length_261_cov_2.191358	86	122	0	36	36	1.0000000
NODE_259495_length_261_cov_1.993827	134	214	0	80	80	1.0000000
NODE_259672_length_261_cov_1.882716	51	105	12	7	54	0.1296296
NODE_259672_length_261_cov_1.882716	51	105	14	6	54	0.1111111
NODE_259672_length_261_cov_1.882716	51	105	16	4	54	0.0740741
NODE_259672_length_261_cov_1.882716	51	105	18	1	54	0.0185185
NODE_259672_length_261_cov_1.882716	51	105	20	36	54	0.6666667
NODE_259740_length_261_cov_1.839506	118	197	4	26	79	0.3291139
NODE_259740_length_261_cov_1.839506	118	197	6	7	79	0.0886076
NODE_259740_length_261_cov_1.839506	118	197	8	37	79	0.4683544
NODE_259740_length_261_cov_1.839506	118	197	10	9	79	0.1139240
NODE_259769_length_261_cov_1.783951	69	141	0	49	72	0.6805556
NODE_259769_length_261_cov_1.783951	69	141	2	1	72	0.0138889
NODE_259769_length_261_cov_1.783951	69	141	4	2	72	0.0277778
NODE_259769_length_261_cov_1.783951	69	141	6	2	72	0.0277778
NODE_259769_length_261_cov_1.783951	69	141	7	3	72	0.0416667
NODE_259769_length_261_cov_1.783951	69	141	8	15	72	0.2083333
NODE_260089_length_261_cov_1.388889	202	247	0	45	45	1.0000000
NODE_260090_length_261_cov_1.382716	14	61	0	47	47	1.0000000
NODE_260428_length_261_cov_1.253086	100	138	4	38	38	1.0000000
NODE_260738_length_261_cov_1.030864	122	205	2	22	83	0.2650602
NODE_260738_length_261_cov_1.030864	122	205	4	61	83	0.7349398
NODE_260738_length_261_cov_1.030864	129	210	2	16	81	0.1975309
NODE_260738_length_261_cov_1.030864	129	210	4	65	81	0.8024691
NODE_260738_length_261_cov_1.030864	129	184	2	15	55	0.2727273
NODE_260738_length_261_cov_1.030864	129	184	4	40	55	0.7272727
NODE_260738_length_261_cov_1.030864	187	248	2	39	61	0.6393443
NODE_260738_length_261_cov_1.030864	187	248	4	22	61	0.3606557
NODE_260767_length_261_cov_1.006173	3	45	0	42	42	1.0000000
NODE_260767_length_261_cov_1.006173	46	98	0	52	52	1.0000000
NODE_262062_length_261_cov_0.580247	11	31	0	20	20	1.0000000
NODE_262121_length_260_cov_8.844720	74	138	0	64	64	1.0000000
NODE_262123_length_260_cov_8.447205	30	110	0	31	80	0.3875000
NODE_262123_length_260_cov_8.447205	30	110	2	49	80	0.6125000
NODE_262123_length_260_cov_8.447205	83	167	0	33	84	0.3928571
NODE_262123_length_260_cov_8.447205	83	167	2	51	84	0.6071429
NODE_262123_length_260_cov_8.447205	163	243	0	80	80	1.0000000
NODE_262149_length_260_cov_5.807453	38	118	0	80	80	1.0000000
NODE_262149_length_260_cov_5.807453	91	171	0	80	80	1.0000000
NODE_262264_length_260_cov_3.645963	5	57	0	52	52	1.0000000
NODE_262329_length_260_cov_3.167702	91	163	2	72	72	1.0000000
NODE_262378_length_260_cov_2.981366	58	127	0	60	69	0.8695652
NODE_262378_length_260_cov_2.981366	58	127	2	9	69	0.1304348
NODE_262384_length_260_cov_2.913043	10	90	0	80	80	1.0000000
NODE_262708_length_260_cov_2.161491	174	251	0	77	77	1.0000000
NODE_262733_length_260_cov_2.080745	188	258	0	70	70	1.0000000
NODE_262788_length_260_cov_1.950311	27	85	0	58	58	1.0000000
NODE_262930_length_260_cov_1.900621	14	50	0	36	36	1.0000000
NODE_263117_length_260_cov_1.683230	50	130	0	80	80	1.0000000
NODE_263428_length_260_cov_1.347826	38	118	0	80	80	1.0000000
NODE_263533_length_260_cov_1.267081	114	199	0	85	85	1.0000000
NODE_263556_length_260_cov_1.267081	198	244	0	46	46	1.0000000
NODE_263568_length_260_cov_1.267081	145	189	2	44	44	1.0000000
NODE_265483_length_259_cov_4.800000	35	95	0	20	60	0.3333333
NODE_265483_length_259_cov_4.800000	35	95	1	5	60	0.0833333
NODE_265483_length_259_cov_4.800000	35	95	2	23	60	0.3833333
NODE_265483_length_259_cov_4.800000	35	95	3	12	60	0.2000000
NODE_265584_length_259_cov_3.675000	119	161	0	42	42	1.0000000
NODE_265584_length_259_cov_3.675000	134	214	0	80	80	1.0000000
NODE_265592_length_259_cov_3.593750	100	143	2	43	43	1.0000000
NODE_265611_length_259_cov_3.475000	198	259	0	61	61	1.0000000
NODE_265625_length_259_cov_3.331250	72	118	2	29	46	0.6304348
NODE_265625_length_259_cov_3.331250	72	118	4	17	46	0.3695652
NODE_265636_length_259_cov_3.237500	103	160	0	27	57	0.4736842
NODE_265636_length_259_cov_3.237500	103	160	2	30	57	0.5263158
NODE_265704_length_259_cov_2.937500	209	233	0	20	24	0.8333333
NODE_265704_length_259_cov_2.937500	209	233	6	2	24	0.0833333
NODE_265704_length_259_cov_2.937500	209	233	8	1	24	0.0416667
NODE_265704_length_259_cov_2.937500	209	233	13	1	24	0.0416667
NODE_265735_length_259_cov_2.850000	0	41	0	41	41	1.0000000
NODE_265735_length_259_cov_2.850000	14	94	0	39	80	0.4875000
NODE_265735_length_259_cov_2.850000	14	94	2	41	80	0.5125000
NODE_265818_length_259_cov_2.550000	9	82	0	73	73	1.0000000
NODE_265942_length_259_cov_2.287500	147	225	2	78	78	1.0000000
NODE_265942_length_259_cov_2.287500	198	241	2	43	43	1.0000000
NODE_266032_length_259_cov_2.156250	0	72	0	72	72	1.0000000
NODE_266080_length_259_cov_2.012500	8	73	0	65	65	1.0000000
NODE_266080_length_259_cov_2.012500	53	126	0	35	73	0.4794520
NODE_266080_length_259_cov_2.012500	53	126	2	38	73	0.5205479
NODE_266101_length_259_cov_1.962500	108	189	4	45	81	0.5555556
NODE_266101_length_259_cov_1.962500	108	189	8	36	81	0.4444444
NODE_266117_length_259_cov_1.918750	49	120	0	71	71	1.0000000
NODE_266183_length_259_cov_1.912500	114	177	0	57	63	0.9047619
NODE_266183_length_259_cov_1.912500	114	177	2	6	63	0.0952381
NODE_266365_length_259_cov_1.837500	180	252	4	46	72	0.6388889
NODE_266365_length_259_cov_1.837500	180	252	6	10	72	0.1388889
NODE_266365_length_259_cov_1.837500	180	252	8	16	72	0.2222222
NODE_266609_length_259_cov_1.593750	27	67	0	40	40	1.0000000
NODE_266746_length_259_cov_1.400000	117	164	0	47	47	1.0000000
NODE_266746_length_259_cov_1.400000	137	217	0	80	80	1.0000000
NODE_268816_length_258_cov_6.415094	129	209	0	80	80	1.0000000
NODE_268816_length_258_cov_6.415094	182	258	0	76	76	1.0000000
NODE_268823_length_258_cov_6.157233	1	81	0	80	80	1.0000000
NODE_268823_length_258_cov_6.157233	9	64	0	55	55	1.0000000
NODE_268852_length_258_cov_4.798742	83	163	4	80	80	1.0000000
NODE_268870_length_258_cov_4.396226	0	44	0	44	44	1.0000000
NODE_268870_length_258_cov_4.396226	24	97	0	73	73	1.0000000
NODE_268880_length_258_cov_4.301887	0	54	0	54	54	1.0000000
NODE_268942_length_258_cov_3.616352	29	58	0	29	29	1.0000000
NODE_268982_length_258_cov_3.352201	47	127	8	3	80	0.0375000
NODE_268982_length_258_cov_3.352201	47	127	12	52	80	0.6500000
NODE_268982_length_258_cov_3.352201	47	127	13	1	80	0.0125000
NODE_268982_length_258_cov_3.352201	47	127	14	24	80	0.3000000
NODE_269086_length_258_cov_2.886792	102	121	0	19	19	1.0000000
NODE_269091_length_258_cov_2.880503	92	172	0	80	80	1.0000000
NODE_269102_length_258_cov_2.855346	96	138	20	1	42	0.0238095
NODE_269102_length_258_cov_2.855346	96	138	24	1	42	0.0238095
NODE_269102_length_258_cov_2.855346	96	138	26	4	42	0.0952381
NODE_269102_length_258_cov_2.855346	96	138	28	4	42	0.0952381
NODE_269102_length_258_cov_2.855346	96	138	30	4	42	0.0952381
NODE_269102_length_258_cov_2.855346	96	138	32	4	42	0.0952381
NODE_269102_length_258_cov_2.855346	96	138	34	3	42	0.0714286
NODE_269102_length_258_cov_2.855346	96	138	36	15	42	0.3571429
NODE_269102_length_258_cov_2.855346	96	138	38	6	42	0.1428571
NODE_269102_length_258_cov_2.855346	148	191	2	2	43	0.0465116
NODE_269102_length_258_cov_2.855346	148	191	5	17	43	0.3953488
NODE_269102_length_258_cov_2.855346	148	191	7	2	43	0.0465116
NODE_269102_length_258_cov_2.855346	148	191	8	6	43	0.1395349
NODE_269102_length_258_cov_2.855346	148	191	10	16	43	0.3720930
NODE_269113_length_258_cov_2.817610	10	58	0	2	48	0.0416667
NODE_269113_length_258_cov_2.817610	10	58	2	41	48	0.8541667
NODE_269113_length_258_cov_2.817610	10	58	4	5	48	0.1041667
NODE_269264_length_258_cov_2.383648	48	128	2	47	80	0.5875000
NODE_269264_length_258_cov_2.383648	48	128	4	33	80	0.4125000
NODE_269264_length_258_cov_2.383648	101	182	0	54	81	0.6666667
NODE_269264_length_258_cov_2.383648	101	182	2	27	81	0.3333333
NODE_269338_length_258_cov_2.238994	61	141	0	80	80	1.0000000
NODE_269615_length_258_cov_1.918239	0	51	0	1	51	0.0196078
NODE_269615_length_258_cov_1.918239	0	51	2	50	51	0.9803922
NODE_269682_length_258_cov_1.855346	26	47	0	7	21	0.3333333
NODE_269682_length_258_cov_1.855346	26	47	2	4	21	0.1904762
NODE_269682_length_258_cov_1.855346	26	47	4	10	21	0.4761905
NODE_269682_length_258_cov_1.855346	71	104	4	33	33	1.0000000
NODE_269682_length_258_cov_1.855346	81	156	4	56	75	0.7466667
NODE_269682_length_258_cov_1.855346	81	156	6	15	75	0.2000000
NODE_269682_length_258_cov_1.855346	81	156	8	4	75	0.0533333
NODE_269749_length_258_cov_1.735849	105	176	2	11	71	0.1549296
NODE_269749_length_258_cov_1.735849	105	176	4	45	71	0.6338028
NODE_269749_length_258_cov_1.735849	105	176	6	14	71	0.1971831
NODE_269749_length_258_cov_1.735849	105	176	8	1	71	0.0140845
NODE_269767_length_258_cov_1.710692	8	49	0	41	41	1.0000000
NODE_270191_length_258_cov_1.283019	127	191	0	64	64	1.0000000
NODE_270191_length_258_cov_1.283019	164	227	0	63	63	1.0000000
NODE_270465_length_258_cov_1.270440	4	55	0	51	51	1.0000000
NODE_270504_length_258_cov_1.232704	90	166	10	5	76	0.0657895
NODE_270504_length_258_cov_1.232704	90	166	14	4	76	0.0526316
NODE_270504_length_258_cov_1.232704	90	166	16	1	76	0.0131579
NODE_270504_length_258_cov_1.232704	90	166	20	4	76	0.0526316
NODE_270504_length_258_cov_1.232704	90	166	22	3	76	0.0394737
NODE_270504_length_258_cov_1.232704	90	166	24	6	76	0.0789474
NODE_270504_length_258_cov_1.232704	90	166	26	3	76	0.0394737
NODE_270504_length_258_cov_1.232704	90	166	32	6	76	0.0789474
NODE_270504_length_258_cov_1.232704	90	166	33	1	76	0.0131579
NODE_270504_length_258_cov_1.232704	90	166	34	11	76	0.1447368
NODE_270504_length_258_cov_1.232704	90	166	36	5	76	0.0657895
NODE_270504_length_258_cov_1.232704	90	166	38	27	76	0.3552631
NODE_270547_length_258_cov_1.201258	49	98	6	49	49	1.0000000
NODE_270876_length_258_cov_0.962264	186	258	0	11	72	0.1527778
NODE_270876_length_258_cov_0.962264	186	258	2	61	72	0.8472222
NODE_270970_length_258_cov_0.962264	69	124	0	29	55	0.5272727
NODE_270970_length_258_cov_0.962264	69	124	3	25	55	0.4545455
NODE_270970_length_258_cov_0.962264	69	124	7	1	55	0.0181818
NODE_272169_length_257_cov_71.158228	81	165	59	1	84	0.0119048
NODE_272169_length_257_cov_71.158228	81	165	60	3	84	0.0357143
NODE_272169_length_257_cov_71.158228	81	165	61	5	84	0.0595238
NODE_272169_length_257_cov_71.158228	81	165	62	5	84	0.0595238
NODE_272169_length_257_cov_71.158228	81	165	64	9	84	0.1071429
NODE_272169_length_257_cov_71.158228	81	165	65	10	84	0.1190476
NODE_272169_length_257_cov_71.158228	81	165	67	2	84	0.0238095
NODE_272169_length_257_cov_71.158228	81	165	68	3	84	0.0357143
NODE_272169_length_257_cov_71.158228	81	165	69	2	84	0.0238095
NODE_272169_length_257_cov_71.158228	81	165	70	3	84	0.0357143
NODE_272169_length_257_cov_71.158228	81	165	71	3	84	0.0357143
NODE_272169_length_257_cov_71.158228	81	165	73	10	84	0.1190476
NODE_272169_length_257_cov_71.158228	81	165	74	1	84	0.0119048
NODE_272169_length_257_cov_71.158228	81	165	75	1	84	0.0119048
NODE_272169_length_257_cov_71.158228	81	165	76	1	84	0.0119048
NODE_272169_length_257_cov_71.158228	81	165	77	1	84	0.0119048
NODE_272169_length_257_cov_71.158228	81	165	79	3	84	0.0357143
NODE_272169_length_257_cov_71.158228	81	165	80	2	84	0.0238095
NODE_272169_length_257_cov_71.158228	81	165	81	1	84	0.0119048
NODE_272169_length_257_cov_71.158228	81	165	82	2	84	0.0238095
NODE_272169_length_257_cov_71.158228	81	165	83	1	84	0.0119048
NODE_272169_length_257_cov_71.158228	81	165	84	1	84	0.0119048
NODE_272169_length_257_cov_71.158228	81	165	85	2	84	0.0238095
NODE_272169_length_257_cov_71.158228	81	165	86	1	84	0.0119048
NODE_272169_length_257_cov_71.158228	81	165	87	2	84	0.0238095
NODE_272169_length_257_cov_71.158228	81	165	88	3	84	0.0357143
NODE_272169_length_257_cov_71.158228	81	165	89	4	84	0.0476190
NODE_272169_length_257_cov_71.158228	81	165	91	2	84	0.0238095
NODE_272169_length_257_cov_71.158228	145	218	36	6	73	0.0821918
NODE_272169_length_257_cov_71.158228	145	218	38	8	73	0.1095890
NODE_272169_length_257_cov_71.158228	145	218	42	4	73	0.0547945
NODE_272169_length_257_cov_71.158228	145	218	44	1	73	0.0136986
NODE_272169_length_257_cov_71.158228	145	218	46	4	73	0.0547945
NODE_272169_length_257_cov_71.158228	145	218	47	1	73	0.0136986
NODE_272169_length_257_cov_71.158228	145	218	49	7	73	0.0958904
NODE_272169_length_257_cov_71.158228	145	218	51	2	73	0.0273973
NODE_272169_length_257_cov_71.158228	145	218	53	2	73	0.0273973
NODE_272169_length_257_cov_71.158228	145	218	55	2	73	0.0273973
NODE_272169_length_257_cov_71.158228	145	218	57	7	73	0.0958904
NODE_272169_length_257_cov_71.158228	145	218	58	1	73	0.0136986
NODE_272169_length_257_cov_71.158228	145	218	60	11	73	0.1506849
NODE_272169_length_257_cov_71.158228	145	218	64	5	73	0.0684932
NODE_272169_length_257_cov_71.158228	145	218	68	3	73	0.0410959
NODE_272169_length_257_cov_71.158228	145	218	70	3	73	0.0410959
NODE_272169_length_257_cov_71.158228	145	218	74	1	73	0.0136986
NODE_272169_length_257_cov_71.158228	145	218	76	1	73	0.0136986
NODE_272169_length_257_cov_71.158228	145	218	77	1	73	0.0136986
NODE_272169_length_257_cov_71.158228	145	218	79	1	73	0.0136986
NODE_272169_length_257_cov_71.158228	145	218	81	1	73	0.0136986
NODE_272169_length_257_cov_71.158228	145	218	82	1	73	0.0136986
NODE_272194_length_257_cov_6.329114	15	93	2	78	78	1.0000000
NODE_272275_length_257_cov_4.177215	25	86	0	58	61	0.9508197
NODE_272275_length_257_cov_4.177215	25	86	2	3	61	0.0491803
NODE_272291_length_257_cov_3.987342	55	107	0	52	52	1.0000000
NODE_272304_length_257_cov_3.873418	145	225	0	80	80	1.0000000
NODE_272304_length_257_cov_3.873418	198	254	0	56	56	1.0000000
NODE_272322_length_257_cov_3.740506	133	199	2	3	66	0.0454545
NODE_272322_length_257_cov_3.740506	133	199	4	7	66	0.1060606
NODE_272322_length_257_cov_3.740506	133	199	6	8	66	0.1212121
NODE_272322_length_257_cov_3.740506	133	199	8	10	66	0.1515152
NODE_272322_length_257_cov_3.740506	133	199	10	5	66	0.0757576
NODE_272322_length_257_cov_3.740506	133	199	12	3	66	0.0454545
NODE_272322_length_257_cov_3.740506	133	199	14	12	66	0.1818182
NODE_272322_length_257_cov_3.740506	133	199	16	13	66	0.1969697
NODE_272322_length_257_cov_3.740506	133	199	20	4	66	0.0606061
NODE_272322_length_257_cov_3.740506	133	199	22	1	66	0.0151515
NODE_272322_length_257_cov_3.740506	177	256	0	31	79	0.3924051
NODE_272322_length_257_cov_3.740506	177	256	2	29	79	0.3670886
NODE_272322_length_257_cov_3.740506	177	256	4	7	79	0.0886076
NODE_272322_length_257_cov_3.740506	177	256	6	8	79	0.1012658
NODE_272322_length_257_cov_3.740506	177	256	8	4	79	0.0506329
NODE_272486_length_257_cov_2.734177	1	65	0	64	64	1.0000000
NODE_272491_length_257_cov_2.677215	170	250	0	30	80	0.3750000
NODE_272491_length_257_cov_2.677215	170	250	3	7	80	0.0875000
NODE_272491_length_257_cov_2.677215	170	250	5	1	80	0.0125000
NODE_272491_length_257_cov_2.677215	170	250	9	10	80	0.1250000
NODE_272491_length_257_cov_2.677215	170	250	10	1	80	0.0125000
NODE_272491_length_257_cov_2.677215	170	250	11	3	80	0.0375000
NODE_272491_length_257_cov_2.677215	170	250	13	3	80	0.0375000
NODE_272491_length_257_cov_2.677215	170	250	16	2	80	0.0250000
NODE_272491_length_257_cov_2.677215	170	250	17	16	80	0.2000000
NODE_272491_length_257_cov_2.677215	170	250	19	1	80	0.0125000
NODE_272491_length_257_cov_2.677215	170	250	20	4	80	0.0500000
NODE_272491_length_257_cov_2.677215	170	250	22	2	80	0.0250000
NODE_272580_length_257_cov_2.537975	60	137	4	77	77	1.0000000
NODE_272596_length_257_cov_2.487342	95	172	0	47	77	0.6103896
NODE_272596_length_257_cov_2.487342	95	172	7	30	77	0.3896104
NODE_272625_length_257_cov_2.379747	106	186	2	9	80	0.1125000
NODE_272625_length_257_cov_2.379747	106	186	4	46	80	0.5750000
NODE_272625_length_257_cov_2.379747	106	186	6	25	80	0.3125000
NODE_272625_length_257_cov_2.379747	159	207	4	12	48	0.2500000
NODE_272625_length_257_cov_2.379747	159	207	6	36	48	0.7500000
NODE_272724_length_257_cov_2.221519	163	240	0	2	77	0.0259740
NODE_272724_length_257_cov_2.221519	163	240	2	5	77	0.0649351
NODE_272724_length_257_cov_2.221519	163	240	4	5	77	0.0649351
NODE_272724_length_257_cov_2.221519	163	240	6	65	77	0.8441558
NODE_272729_length_257_cov_2.202532	16	97	2	16	81	0.1975309
NODE_272729_length_257_cov_2.202532	16	97	4	8	81	0.0987654
NODE_272729_length_257_cov_2.202532	16	97	6	24	81	0.2962963
NODE_272729_length_257_cov_2.202532	16	97	10	2	81	0.0246914
NODE_272729_length_257_cov_2.202532	16	97	12	31	81	0.3827161
NODE_273151_length_257_cov_1.664557	220	239	0	19	19	1.0000000
NODE_273357_length_257_cov_1.500000	85	166	0	81	81	1.0000000
NODE_273462_length_257_cov_1.329114	120	186	6	66	66	1.0000000
NODE_273533_length_257_cov_1.291139	13	53	2	40	40	1.0000000
NODE_273697_length_257_cov_1.291139	205	257	0	13	52	0.2500000
NODE_273697_length_257_cov_1.291139	205	257	2	39	52	0.7500000
NODE_273894_length_257_cov_1.221519	10	74	0	64	64	1.0000000
NODE_273917_length_257_cov_1.196203	70	150	0	31	80	0.3875000
NODE_273917_length_257_cov_1.196203	70	150	2	49	80	0.6125000
NODE_273917_length_257_cov_1.196203	123	204	0	80	81	0.9876543
NODE_273917_length_257_cov_1.196203	123	204	2	1	81	0.0123457
NODE_275399_length_257_cov_0.645570	138	158	0	20	20	1.0000000
NODE_275419_length_257_cov_0.645570	181	241	0	58	60	0.9666666
NODE_275419_length_257_cov_0.645570	181	241	2	2	60	0.0333333
NODE_275598_length_256_cov_5.235669	30	77	2	47	47	1.0000000
NODE_275624_length_256_cov_4.598726	100	180	0	80	80	1.0000000
NODE_275624_length_256_cov_4.598726	160	211	0	51	51	1.0000000
NODE_275682_length_256_cov_3.866242	112	166	2	14	54	0.2592593
NODE_275682_length_256_cov_3.866242	112	166	4	12	54	0.2222222
NODE_275682_length_256_cov_3.866242	112	166	6	28	54	0.5185185
NODE_275840_length_256_cov_2.878981	79	159	0	80	80	1.0000000
NODE_275840_length_256_cov_2.878981	132	212	0	80	80	1.0000000
NODE_275909_length_256_cov_2.598726	157	222	0	65	65	1.0000000
NODE_275909_length_256_cov_2.598726	195	249	0	54	54	1.0000000
NODE_275981_length_256_cov_2.445860	104	183	0	79	79	1.0000000
NODE_276082_length_256_cov_2.229299	0	58	0	58	58	1.0000000
NODE_276082_length_256_cov_2.229299	17	68	0	51	51	1.0000000
NODE_276082_length_256_cov_2.229299	41	88	0	47	47	1.0000000
NODE_276082_length_256_cov_2.229299	42	122	0	80	80	1.0000000
NODE_276098_length_256_cov_2.184713	192	246	0	54	54	1.0000000
NODE_276119_length_256_cov_2.121019	150	236	0	57	86	0.6627907
NODE_276119_length_256_cov_2.121019	150	236	2	3	86	0.0348837
NODE_276119_length_256_cov_2.121019	150	236	4	26	86	0.3023256
NODE_276174_length_256_cov_1.974522	130	174	4	2	44	0.0454545
NODE_276174_length_256_cov_1.974522	130	174	6	42	44	0.9545454
NODE_276471_length_256_cov_1.707006	39	92	0	1	53	0.0188679
NODE_276471_length_256_cov_1.707006	39	92	2	12	53	0.2264151
NODE_276471_length_256_cov_1.707006	39	92	4	3	53	0.0566038
NODE_276471_length_256_cov_1.707006	39	92	8	8	53	0.1509434
NODE_276471_length_256_cov_1.707006	39	92	10	7	53	0.1320755
NODE_276471_length_256_cov_1.707006	39	92	12	4	53	0.0754717
NODE_276471_length_256_cov_1.707006	39	92	14	2	53	0.0377358
NODE_276471_length_256_cov_1.707006	39	92	15	3	53	0.0566038
NODE_276471_length_256_cov_1.707006	39	92	19	2	53	0.0377358
NODE_276471_length_256_cov_1.707006	39	92	20	2	53	0.0377358
NODE_276471_length_256_cov_1.707006	39	92	22	3	53	0.0566038
NODE_276471_length_256_cov_1.707006	39	92	24	6	53	0.1132075
NODE_276471_length_256_cov_1.707006	93	135	25	3	42	0.0714286
NODE_276471_length_256_cov_1.707006	93	135	27	20	42	0.4761905
NODE_276471_length_256_cov_1.707006	93	135	28	11	42	0.2619048
NODE_276471_length_256_cov_1.707006	93	135	30	6	42	0.1428571
NODE_276471_length_256_cov_1.707006	93	135	32	2	42	0.0476190
NODE_276484_length_256_cov_1.700637	107	129	0	22	22	1.0000000
NODE_276495_length_256_cov_1.675159	52	98	0	46	46	1.0000000
NODE_276654_length_256_cov_1.598726	125	202	8	21	77	0.2727273
NODE_276654_length_256_cov_1.598726	125	202	10	34	77	0.4415585
NODE_276654_length_256_cov_1.598726	125	202	12	22	77	0.2857143
NODE_276654_length_256_cov_1.598726	178	256	2	10	78	0.1282051
NODE_276654_length_256_cov_1.598726	178	256	8	21	78	0.2692308
NODE_276654_length_256_cov_1.598726	178	256	10	4	78	0.0512821
NODE_276654_length_256_cov_1.598726	178	256	12	43	78	0.5512820
NODE_276672_length_256_cov_1.579618	110	172	2	8	62	0.1290323
NODE_276672_length_256_cov_1.579618	110	172	4	41	62	0.6612903
NODE_276672_length_256_cov_1.579618	110	172	5	1	62	0.0161290
NODE_276672_length_256_cov_1.579618	110	172	6	12	62	0.1935484
NODE_276672_length_256_cov_1.579618	194	239	2	45	45	1.0000000
NODE_276742_length_256_cov_1.464968	112	135	0	23	23	1.0000000
NODE_276826_length_256_cov_1.331210	138	209	2	71	71	1.0000000
NODE_276826_length_256_cov_1.331210	182	240	0	28	58	0.4827586
NODE_276826_length_256_cov_1.331210	182	240	2	30	58	0.5172414
NODE_277113_length_256_cov_1.299363	88	160	0	72	72	1.0000000
NODE_277305_length_256_cov_1.203822	3	43	0	1	40	0.0250000
NODE_277305_length_256_cov_1.203822	3	43	1	1	40	0.0250000
NODE_277305_length_256_cov_1.203822	3	43	2	1	40	0.0250000
NODE_277305_length_256_cov_1.203822	3	43	4	6	40	0.1500000
NODE_277305_length_256_cov_1.203822	3	43	8	12	40	0.3000000
NODE_277305_length_256_cov_1.203822	3	43	10	2	40	0.0500000
NODE_277305_length_256_cov_1.203822	3	43	12	1	40	0.0250000
NODE_277305_length_256_cov_1.203822	3	43	14	16	40	0.4000000
NODE_277305_length_256_cov_1.203822	16	96	8	8	80	0.1000000
NODE_277305_length_256_cov_1.203822	16	96	10	2	80	0.0250000
NODE_277305_length_256_cov_1.203822	16	96	12	3	80	0.0375000
NODE_277305_length_256_cov_1.203822	16	96	14	23	80	0.2875000
NODE_277305_length_256_cov_1.203822	16	96	16	44	80	0.5500000
NODE_278934_length_255_cov_73.756410	52	99	0	3	47	0.0638298
NODE_278934_length_255_cov_73.756410	52	99	2	44	47	0.9361702
NODE_278934_length_255_cov_73.756410	133	184	0	21	51	0.4117647
NODE_278934_length_255_cov_73.756410	133	184	2	30	51	0.5882353
NODE_278934_length_255_cov_73.756410	157	237	0	74	80	0.9250000
NODE_278934_length_255_cov_73.756410	157	237	2	6	80	0.0750000
NODE_278937_length_255_cov_15.538462	219	255	0	36	36	1.0000000
NODE_279003_length_255_cov_4.884615	157	230	0	73	73	1.0000000
NODE_279003_length_255_cov_4.884615	203	248	0	45	45	1.0000000
NODE_279058_length_255_cov_4.012821	68	148	0	23	80	0.2875000
NODE_279058_length_255_cov_4.012821	68	148	6	47	80	0.5875000
NODE_279058_length_255_cov_4.012821	68	148	8	10	80	0.1250000
NODE_279075_length_255_cov_3.826923	16	80	6	7	64	0.1093750
NODE_279075_length_255_cov_3.826923	16	80	8	15	64	0.2343750
NODE_279075_length_255_cov_3.826923	16	80	10	9	64	0.1406250
NODE_279075_length_255_cov_3.826923	16	80	12	2	64	0.0312500
NODE_279075_length_255_cov_3.826923	16	80	14	31	64	0.4843750
NODE_279102_length_255_cov_3.596154	30	60	0	30	30	1.0000000
NODE_279134_length_255_cov_3.423077	64	109	0	2	45	0.0444444
NODE_279134_length_255_cov_3.423077	64	109	4	33	45	0.7333333
NODE_279134_length_255_cov_3.423077	64	109	10	1	45	0.0222222
NODE_279134_length_255_cov_3.423077	64	109	11	4	45	0.0888889
NODE_279134_length_255_cov_3.423077	64	109	12	5	45	0.1111111
NODE_279166_length_255_cov_3.262821	0	48	0	17	48	0.3541667
NODE_279166_length_255_cov_3.262821	0	48	2	5	48	0.1041667
NODE_279166_length_255_cov_3.262821	0	48	4	11	48	0.2291667
NODE_279166_length_255_cov_3.262821	0	48	6	15	48	0.3125000
NODE_279166_length_255_cov_3.262821	66	113	6	44	47	0.9361702
NODE_279166_length_255_cov_3.262821	66	113	8	2	47	0.0425532
NODE_279166_length_255_cov_3.262821	66	113	12	1	47	0.0212766
NODE_279241_length_255_cov_2.942308	157	176	0	19	19	1.0000000
NODE_279320_length_255_cov_2.621795	227	254	0	27	27	1.0000000
NODE_279379_length_255_cov_2.602564	131	185	2	10	54	0.1851852
NODE_279379_length_255_cov_2.602564	131	185	4	44	54	0.8148148
NODE_279427_length_255_cov_2.487179	43	119	8	11	76	0.1447368
NODE_279427_length_255_cov_2.487179	43	119	10	2	76	0.0263158
NODE_279427_length_255_cov_2.487179	43	119	14	63	76	0.8289474
NODE_279447_length_255_cov_2.435897	0	58	0	34	58	0.5862069
NODE_279447_length_255_cov_2.435897	0	58	4	24	58	0.4137931
NODE_279462_length_255_cov_2.391026	189	255	0	66	66	1.0000000
NODE_279507_length_255_cov_2.288462	0	60	0	60	60	1.0000000
NODE_279510_length_255_cov_2.288462	0	74	0	74	74	1.0000000
NODE_279620_length_255_cov_2.089744	105	145	0	40	40	1.0000000
NODE_279649_length_255_cov_1.987179	0	72	0	72	72	1.0000000
NODE_279842_length_255_cov_1.910256	198	255	0	57	57	1.0000000
NODE_279871_length_255_cov_1.871795	16	68	0	52	52	1.0000000
NODE_279892_length_255_cov_1.826923	146	218	0	20	72	0.2777778
NODE_279892_length_255_cov_1.826923	146	218	2	52	72	0.7222222
NODE_279956_length_255_cov_1.705128	0	45	0	45	45	1.0000000
NODE_279956_length_255_cov_1.705128	41	121	0	4	80	0.0500000
NODE_279956_length_255_cov_1.705128	41	121	2	76	80	0.9500000
NODE_279956_length_255_cov_1.705128	94	174	0	14	80	0.1750000
NODE_279956_length_255_cov_1.705128	94	174	2	66	80	0.8250000
NODE_280153_length_255_cov_1.576923	43	117	2	5	74	0.0675676
NODE_280153_length_255_cov_1.576923	43	117	4	24	74	0.3243243
NODE_280153_length_255_cov_1.576923	43	117	6	21	74	0.2837838
NODE_280153_length_255_cov_1.576923	43	117	12	1	74	0.0135135
NODE_280153_length_255_cov_1.576923	43	117	14	1	74	0.0135135
NODE_280153_length_255_cov_1.576923	43	117	16	22	74	0.2972973
NODE_280153_length_255_cov_1.576923	90	175	2	3	85	0.0352941
NODE_280153_length_255_cov_1.576923	90	175	12	1	85	0.0117647
NODE_280153_length_255_cov_1.576923	90	175	14	1	85	0.0117647
NODE_280153_length_255_cov_1.576923	90	175	16	33	85	0.3882353
NODE_280153_length_255_cov_1.576923	90	175	18	47	85	0.5529412
NODE_280168_length_255_cov_1.557692	62	125	0	63	63	1.0000000
NODE_280297_length_255_cov_1.358974	178	246	0	68	68	1.0000000
NODE_280904_length_255_cov_1.128205	183	219	0	36	36	1.0000000
NODE_281094_length_255_cov_0.987179	220	241	0	21	21	1.0000000
NODE_281380_length_255_cov_0.955128	119	171	4	52	52	1.0000000
NODE_281384_length_255_cov_0.955128	12	92	14	80	80	1.0000000
NODE_282137_length_255_cov_0.653846	87	106	0	19	19	1.0000000
NODE_282534_length_254_cov_4.935484	144	189	0	45	45	1.0000000
NODE_282534_length_254_cov_4.935484	164	242	0	78	78	1.0000000
NODE_282548_length_254_cov_4.722581	44	85	18	41	41	1.0000000
NODE_282576_length_254_cov_4.296774	149	174	2	25	25	1.0000000
NODE_282576_length_254_cov_4.296774	149	223	0	3	74	0.0405405
NODE_282576_length_254_cov_4.296774	149	223	2	71	74	0.9594595
NODE_282590_length_254_cov_4.206452	57	86	20	12	29	0.4137931
NODE_282590_length_254_cov_4.206452	57	86	22	1	29	0.0344828
NODE_282590_length_254_cov_4.206452	57	86	23	6	29	0.2068966
NODE_282590_length_254_cov_4.206452	57	86	24	2	29	0.0689655
NODE_282590_length_254_cov_4.206452	57	86	25	8	29	0.2758621
NODE_282626_length_254_cov_3.677419	7	64	8	5	57	0.0877193
NODE_282626_length_254_cov_3.677419	7	64	11	4	57	0.0701754
NODE_282626_length_254_cov_3.677419	7	64	15	4	57	0.0701754
NODE_282626_length_254_cov_3.677419	7	64	19	1	57	0.0175439
NODE_282626_length_254_cov_3.677419	7	64	21	26	57	0.4561403
NODE_282626_length_254_cov_3.677419	7	64	22	17	57	0.2982456
NODE_282626_length_254_cov_3.677419	60	117	6	6	57	0.1052632
NODE_282626_length_254_cov_3.677419	60	117	10	3	57	0.0526316
NODE_282626_length_254_cov_3.677419	60	117	12	2	57	0.0350877
NODE_282626_length_254_cov_3.677419	60	117	16	14	57	0.2456140
NODE_282626_length_254_cov_3.677419	60	117	20	4	57	0.0701754
NODE_282626_length_254_cov_3.677419	60	117	22	28	57	0.4912281
NODE_282642_length_254_cov_3.593548	154	197	0	43	43	1.0000000
NODE_282659_length_254_cov_3.438710	82	129	1	43	47	0.9148936
NODE_282659_length_254_cov_3.438710	82	129	5	4	47	0.0851064
NODE_282659_length_254_cov_3.438710	102	182	1	23	80	0.2875000
NODE_282659_length_254_cov_3.438710	102	182	5	39	80	0.4875000
NODE_282659_length_254_cov_3.438710	102	182	7	13	80	0.1625000
NODE_282659_length_254_cov_3.438710	102	182	8	5	80	0.0625000
NODE_282736_length_254_cov_2.961290	5	79	0	74	74	1.0000000
NODE_282736_length_254_cov_2.961290	52	118	0	66	66	1.0000000
NODE_282771_length_254_cov_2.780645	169	252	0	7	83	0.0843373
NODE_282771_length_254_cov_2.780645	169	252	2	14	83	0.1686747
NODE_282771_length_254_cov_2.780645	169	252	4	30	83	0.3614458
NODE_282771_length_254_cov_2.780645	169	252	8	3	83	0.0361446
NODE_282771_length_254_cov_2.780645	169	252	10	2	83	0.0240964
NODE_282771_length_254_cov_2.780645	169	252	12	3	83	0.0361446
NODE_282771_length_254_cov_2.780645	169	252	14	6	83	0.0722892
NODE_282771_length_254_cov_2.780645	169	252	16	5	83	0.0602410
NODE_282771_length_254_cov_2.780645	169	252	18	13	83	0.1566265
NODE_282947_length_254_cov_2.341935	167	201	6	15	34	0.4411765
NODE_282947_length_254_cov_2.341935	167	201	7	9	34	0.2647059
NODE_282947_length_254_cov_2.341935	167	201	8	3	34	0.0882353
NODE_282947_length_254_cov_2.341935	167	201	10	1	34	0.0294118
NODE_282947_length_254_cov_2.341935	167	201	11	3	34	0.0882353
NODE_282947_length_254_cov_2.341935	167	201	12	3	34	0.0882353
NODE_283082_length_254_cov_2.161290	14	74	0	60	60	1.0000000
NODE_283244_length_254_cov_1.974194	156	204	0	3	48	0.0625000
NODE_283244_length_254_cov_1.974194	156	204	2	1	48	0.0208333
NODE_283244_length_254_cov_1.974194	156	204	4	44	48	0.9166667
NODE_283440_length_254_cov_1.780645	79	126	7	1	47	0.0212766
NODE_283440_length_254_cov_1.780645	79	126	9	1	47	0.0212766
NODE_283440_length_254_cov_1.780645	79	126	11	3	47	0.0638298
NODE_283440_length_254_cov_1.780645	79	126	17	1	47	0.0212766
NODE_283440_length_254_cov_1.780645	79	126	19	3	47	0.0638298
NODE_283440_length_254_cov_1.780645	79	126	20	5	47	0.1063830
NODE_283440_length_254_cov_1.780645	79	126	22	1	47	0.0212766
NODE_283440_length_254_cov_1.780645	79	126	24	26	47	0.5531915
NODE_283440_length_254_cov_1.780645	79	126	25	1	47	0.0212766
NODE_283440_length_254_cov_1.780645	79	126	27	5	47	0.1063830
NODE_283952_length_254_cov_1.316129	23	87	0	64	64	1.0000000
NODE_284013_length_254_cov_1.316129	193	215	0	22	22	1.0000000
NODE_284256_length_254_cov_1.258065	181	249	0	68	68	1.0000000
NODE_284275_length_254_cov_1.238710	9	82	0	73	73	1.0000000
NODE_284275_length_254_cov_1.238710	62	82	0	20	20	1.0000000
NODE_284277_length_254_cov_1.238710	54	73	0	19	19	1.0000000
NODE_284301_length_254_cov_1.219355	98	157	0	59	59	1.0000000
NODE_284638_length_254_cov_0.987097	139	193	0	54	54	1.0000000
NODE_284638_length_254_cov_0.987097	205	254	0	49	49	1.0000000
NODE_284796_length_254_cov_0.987097	121	152	0	31	31	1.0000000
NODE_285963_length_253_cov_60.311688	137	202	4	1	65	0.0153846
NODE_285963_length_253_cov_60.311688	137	202	26	7	65	0.1076923
NODE_285963_length_253_cov_60.311688	137	202	30	2	65	0.0307692
NODE_285963_length_253_cov_60.311688	137	202	32	4	65	0.0615385
NODE_285963_length_253_cov_60.311688	137	202	38	51	65	0.7846154
NODE_285963_length_253_cov_60.311688	175	253	0	4	78	0.0512821
NODE_285963_length_253_cov_60.311688	175	253	2	1	78	0.0128205
NODE_285963_length_253_cov_60.311688	175	253	9	2	78	0.0256410
NODE_285963_length_253_cov_60.311688	175	253	11	1	78	0.0128205
NODE_285963_length_253_cov_60.311688	175	253	26	2	78	0.0256410
NODE_285963_length_253_cov_60.311688	175	253	28	1	78	0.0128205
NODE_285963_length_253_cov_60.311688	175	253	30	1	78	0.0128205
NODE_285963_length_253_cov_60.311688	175	253	32	1	78	0.0128205
NODE_285963_length_253_cov_60.311688	175	253	34	4	78	0.0512821
NODE_285963_length_253_cov_60.311688	175	253	38	61	78	0.7820513
NODE_285965_length_253_cov_41.519481	0	68	0	1	68	0.0147059
NODE_285965_length_253_cov_41.519481	0	68	2	1	68	0.0147059
NODE_285965_length_253_cov_41.519481	0	68	4	23	68	0.3382353
NODE_285965_length_253_cov_41.519481	0	68	13	5	68	0.0735294
NODE_285965_length_253_cov_41.519481	0	68	15	1	68	0.0147059
NODE_285965_length_253_cov_41.519481	0	68	17	2	68	0.0294118
NODE_285965_length_253_cov_41.519481	0	68	27	2	68	0.0294118
NODE_285965_length_253_cov_41.519481	0	68	38	11	68	0.1617647
NODE_285965_length_253_cov_41.519481	0	68	48	6	68	0.0882353
NODE_285965_length_253_cov_41.519481	0	68	50	3	68	0.0441176
NODE_285965_length_253_cov_41.519481	0	68	51	4	68	0.0588235
NODE_285965_length_253_cov_41.519481	0	68	55	9	68	0.1323529
NODE_285965_length_253_cov_41.519481	0	70	0	1	70	0.0142857
NODE_285965_length_253_cov_41.519481	0	70	2	1	70	0.0142857
NODE_285965_length_253_cov_41.519481	0	70	4	23	70	0.3285714
NODE_285965_length_253_cov_41.519481	0	70	13	5	70	0.0714286
NODE_285965_length_253_cov_41.519481	0	70	15	1	70	0.0142857
NODE_285965_length_253_cov_41.519481	0	70	17	2	70	0.0285714
NODE_285965_length_253_cov_41.519481	0	70	27	2	70	0.0285714
NODE_285965_length_253_cov_41.519481	0	70	38	11	70	0.1571429
NODE_285965_length_253_cov_41.519481	0	70	48	6	70	0.0857143
NODE_285965_length_253_cov_41.519481	0	70	50	3	70	0.0428571
NODE_285965_length_253_cov_41.519481	0	70	51	4	70	0.0571429
NODE_285965_length_253_cov_41.519481	0	70	55	11	70	0.1571429
NODE_285965_length_253_cov_41.519481	2	73	4	23	71	0.3239437
NODE_285965_length_253_cov_41.519481	2	73	13	5	71	0.0704225
NODE_285965_length_253_cov_41.519481	2	73	15	1	71	0.0140845
NODE_285965_length_253_cov_41.519481	2	73	17	2	71	0.0281690
NODE_285965_length_253_cov_41.519481	2	73	27	2	71	0.0281690
NODE_285965_length_253_cov_41.519481	2	73	38	11	71	0.1549296
NODE_285965_length_253_cov_41.519481	2	73	48	6	71	0.0845070
NODE_285965_length_253_cov_41.519481	2	73	50	3	71	0.0422535
NODE_285965_length_253_cov_41.519481	2	73	51	4	71	0.0563380
NODE_285965_length_253_cov_41.519481	2	73	55	14	71	0.1971831
NODE_285965_length_253_cov_41.519481	7	73	4	18	66	0.2727273
NODE_285965_length_253_cov_41.519481	7	73	13	5	66	0.0757576
NODE_285965_length_253_cov_41.519481	7	73	15	1	66	0.0151515
NODE_285965_length_253_cov_41.519481	7	73	17	2	66	0.0303030
NODE_285965_length_253_cov_41.519481	7	73	27	2	66	0.0303030
NODE_285965_length_253_cov_41.519481	7	73	38	11	66	0.1666667
NODE_285965_length_253_cov_41.519481	7	73	48	6	66	0.0909091
NODE_285965_length_253_cov_41.519481	7	73	50	3	66	0.0454545
NODE_285965_length_253_cov_41.519481	7	73	51	4	66	0.0606061
NODE_285965_length_253_cov_41.519481	7	73	55	14	66	0.2121212
NODE_285965_length_253_cov_41.519481	46	123	48	6	77	0.0779221
NODE_285965_length_253_cov_41.519481	46	123	50	3	77	0.0389610
NODE_285965_length_253_cov_41.519481	46	123	51	4	77	0.0519481
NODE_285965_length_253_cov_41.519481	46	123	55	30	77	0.3896104
NODE_285965_length_253_cov_41.519481	46	123	56	34	77	0.4415585
NODE_285965_length_253_cov_41.519481	46	123	48	6	77	0.0779221
NODE_285965_length_253_cov_41.519481	46	123	50	3	77	0.0389610
NODE_285965_length_253_cov_41.519481	46	123	51	4	77	0.0519481
NODE_285965_length_253_cov_41.519481	46	123	55	30	77	0.3896104
NODE_285965_length_253_cov_41.519481	46	123	56	34	77	0.4415585
NODE_285965_length_253_cov_41.519481	46	123	48	6	77	0.0779221
NODE_285965_length_253_cov_41.519481	46	123	50	3	77	0.0389610
NODE_285965_length_253_cov_41.519481	46	123	51	4	77	0.0519481
NODE_285965_length_253_cov_41.519481	46	123	55	30	77	0.3896104
NODE_285965_length_253_cov_41.519481	46	123	56	34	77	0.4415585
NODE_285967_length_253_cov_13.967532	25	105	0	80	80	1.0000000
NODE_285967_length_253_cov_13.967532	78	158	0	80	80	1.0000000
NODE_285969_length_253_cov_12.259740	0	54	0	54	54	1.0000000
NODE_285969_length_253_cov_12.259740	27	62	0	35	35	1.0000000
NODE_285969_length_253_cov_12.259740	51	131	0	80	80	1.0000000
NODE_285969_length_253_cov_12.259740	104	139	0	35	35	1.0000000
NODE_285969_length_253_cov_12.259740	128	208	0	80	80	1.0000000
NODE_285969_length_253_cov_12.259740	181	216	0	35	35	1.0000000
NODE_285987_length_253_cov_7.279221	184	250	2	16	66	0.2424242
NODE_285987_length_253_cov_7.279221	184	250	4	1	66	0.0151515
NODE_285987_length_253_cov_7.279221	184	250	6	40	66	0.6060606
NODE_285987_length_253_cov_7.279221	184	250	8	9	66	0.1363636
NODE_286022_length_253_cov_5.376623	66	147	2	15	81	0.1851852
NODE_286022_length_253_cov_5.376623	66	147	6	7	81	0.0864198
NODE_286022_length_253_cov_5.376623	66	147	7	17	81	0.2098765
NODE_286022_length_253_cov_5.376623	66	147	8	42	81	0.5185185
NODE_286022_length_253_cov_5.376623	120	185	2	6	65	0.0923077
NODE_286022_length_253_cov_5.376623	120	185	4	22	65	0.3384615
NODE_286022_length_253_cov_5.376623	120	185	6	1	65	0.0153846
NODE_286022_length_253_cov_5.376623	120	185	7	26	65	0.4000000
NODE_286022_length_253_cov_5.376623	120	185	8	10	65	0.1538462
NODE_286042_length_253_cov_4.896104	102	182	12	2	80	0.0250000
NODE_286042_length_253_cov_4.896104	102	182	16	3	80	0.0375000
NODE_286042_length_253_cov_4.896104	102	182	19	1	80	0.0125000
NODE_286042_length_253_cov_4.896104	102	182	20	1	80	0.0125000
NODE_286042_length_253_cov_4.896104	102	182	22	3	80	0.0375000
NODE_286042_length_253_cov_4.896104	102	182	25	1	80	0.0125000
NODE_286042_length_253_cov_4.896104	102	182	27	12	80	0.1500000
NODE_286042_length_253_cov_4.896104	102	182	33	9	80	0.1125000
NODE_286042_length_253_cov_4.896104	102	182	34	12	80	0.1500000
NODE_286042_length_253_cov_4.896104	102	182	36	6	80	0.0750000
NODE_286042_length_253_cov_4.896104	102	182	43	1	80	0.0125000
NODE_286042_length_253_cov_4.896104	102	182	45	3	80	0.0375000
NODE_286042_length_253_cov_4.896104	102	182	46	13	80	0.1625000
NODE_286042_length_253_cov_4.896104	102	182	47	2	80	0.0250000
NODE_286042_length_253_cov_4.896104	102	182	48	5	80	0.0625000
NODE_286042_length_253_cov_4.896104	102	182	49	1	80	0.0125000
NODE_286042_length_253_cov_4.896104	102	182	50	2	80	0.0250000
NODE_286042_length_253_cov_4.896104	102	182	51	2	80	0.0250000
NODE_286042_length_253_cov_4.896104	102	182	52	1	80	0.0125000
NODE_286046_length_253_cov_4.798701	199	253	0	54	54	1.0000000
NODE_286069_length_253_cov_4.487013	85	126	6	8	41	0.1951219
NODE_286069_length_253_cov_4.487013	85	126	12	1	41	0.0243902
NODE_286069_length_253_cov_4.487013	85	126	14	1	41	0.0243902
NODE_286069_length_253_cov_4.487013	85	126	16	2	41	0.0487805
NODE_286069_length_253_cov_4.487013	85	126	18	29	41	0.7073171
NODE_286151_length_253_cov_3.500000	44	105	4	12	61	0.1967213
NODE_286151_length_253_cov_3.500000	44	105	6	49	61	0.8032787
NODE_286151_length_253_cov_3.500000	90	158	0	24	68	0.3529412
NODE_286151_length_253_cov_3.500000	90	158	2	10	68	0.1470588
NODE_286151_length_253_cov_3.500000	90	158	4	31	68	0.4558823
NODE_286151_length_253_cov_3.500000	90	158	6	3	68	0.0441176
NODE_286259_length_253_cov_2.987013	85	165	2	80	80	1.0000000
NODE_286259_length_253_cov_2.987013	138	169	2	31	31	1.0000000
NODE_286275_length_253_cov_2.954545	100	148	0	48	48	1.0000000
NODE_286281_length_253_cov_2.909091	34	99	10	5	65	0.0769231
NODE_286281_length_253_cov_2.909091	34	99	12	1	65	0.0153846
NODE_286281_length_253_cov_2.909091	34	99	13	9	65	0.1384615
NODE_286281_length_253_cov_2.909091	34	99	15	5	65	0.0769231
NODE_286281_length_253_cov_2.909091	34	99	16	33	65	0.5076923
NODE_286281_length_253_cov_2.909091	34	99	18	12	65	0.1846154
NODE_286288_length_253_cov_2.889610	129	200	32	4	71	0.0563380
NODE_286288_length_253_cov_2.889610	129	200	34	2	71	0.0281690
NODE_286288_length_253_cov_2.889610	129	200	36	6	71	0.0845070
NODE_286288_length_253_cov_2.889610	129	200	38	17	71	0.2394366
NODE_286288_length_253_cov_2.889610	129	200	40	8	71	0.1126761
NODE_286288_length_253_cov_2.889610	129	200	42	3	71	0.0422535
NODE_286288_length_253_cov_2.889610	129	200	46	3	71	0.0422535
NODE_286288_length_253_cov_2.889610	129	200	48	10	71	0.1408451
NODE_286288_length_253_cov_2.889610	129	200	50	18	71	0.2535211
NODE_286288_length_253_cov_2.889610	173	253	17	2	80	0.0250000
NODE_286288_length_253_cov_2.889610	173	253	24	2	80	0.0250000
NODE_286288_length_253_cov_2.889610	173	253	34	1	80	0.0125000
NODE_286288_length_253_cov_2.889610	173	253	36	1	80	0.0125000
NODE_286288_length_253_cov_2.889610	173	253	42	11	80	0.1375000
NODE_286288_length_253_cov_2.889610	173	253	48	13	80	0.1625000
NODE_286288_length_253_cov_2.889610	173	253	50	50	80	0.6250000
NODE_286289_length_253_cov_2.889610	21	76	0	25	55	0.4545455
NODE_286289_length_253_cov_2.889610	21	76	2	30	55	0.5454546
NODE_286289_length_253_cov_2.889610	149	229	0	80	80	1.0000000
NODE_286379_length_253_cov_2.610390	113	193	0	80	80	1.0000000
NODE_286386_length_253_cov_2.584416	97	154	0	57	57	1.0000000
NODE_286545_length_253_cov_2.240260	185	250	0	65	65	1.0000000
NODE_286667_length_253_cov_1.987013	157	237	0	80	80	1.0000000
NODE_286667_length_253_cov_1.987013	210	253	0	43	43	1.0000000
NODE_286685_length_253_cov_1.987013	18	60	2	42	42	1.0000000
NODE_286829_length_253_cov_1.961039	186	232	0	20	46	0.4347826
NODE_286829_length_253_cov_1.961039	186	232	2	26	46	0.5652174
NODE_286837_length_253_cov_1.948052	68	120	0	52	52	1.0000000
NODE_286838_length_253_cov_1.948052	63	114	0	51	51	1.0000000
NODE_286947_length_253_cov_1.746753	164	193	0	4	29	0.1379310
NODE_286947_length_253_cov_1.746753	164	193	2	25	29	0.8620690
NODE_287031_length_253_cov_1.655844	40	120	0	26	80	0.3250000
NODE_287031_length_253_cov_1.655844	40	120	2	54	80	0.6750000
NODE_287031_length_253_cov_1.655844	93	152	0	1	59	0.0169492
NODE_287031_length_253_cov_1.655844	93	152	2	58	59	0.9830508
NODE_287133_length_253_cov_1.590909	102	148	2	46	46	1.0000000
NODE_287156_length_253_cov_1.558442	67	149	0	82	82	1.0000000
NODE_287230_length_253_cov_1.441558	49	113	0	64	64	1.0000000
NODE_287230_length_253_cov_1.441558	102	166	0	64	64	1.0000000
NODE_287232_length_253_cov_1.441558	121	185	0	64	64	1.0000000
NODE_287234_length_253_cov_1.435065	50	81	0	31	31	1.0000000
NODE_287584_length_253_cov_1.324675	193	239	2	42	46	0.9130435
NODE_287584_length_253_cov_1.324675	193	239	4	4	46	0.0869565
NODE_287599_length_253_cov_1.324675	90	132	30	15	42	0.3571429
NODE_287599_length_253_cov_1.324675	90	132	32	12	42	0.2857143
NODE_287599_length_253_cov_1.324675	90	132	34	15	42	0.3571429
NODE_287599_length_253_cov_1.324675	133	185	4	4	52	0.0769231
NODE_287599_length_253_cov_1.324675	133	185	6	7	52	0.1346154
NODE_287599_length_253_cov_1.324675	133	185	8	2	52	0.0384615
NODE_287599_length_253_cov_1.324675	133	185	10	2	52	0.0384615
NODE_287599_length_253_cov_1.324675	133	185	12	4	52	0.0769231
NODE_287599_length_253_cov_1.324675	133	185	16	3	52	0.0576923
NODE_287599_length_253_cov_1.324675	133	185	18	1	52	0.0192308
NODE_287599_length_253_cov_1.324675	133	185	22	3	52	0.0576923
NODE_287599_length_253_cov_1.324675	133	185	24	1	52	0.0192308
NODE_287599_length_253_cov_1.324675	133	185	26	17	52	0.3269231
NODE_287599_length_253_cov_1.324675	133	185	30	8	52	0.1538462
NODE_287721_length_253_cov_1.285714	87	125	0	5	38	0.1315790
NODE_287721_length_253_cov_1.285714	87	125	2	21	38	0.5526316
NODE_287721_length_253_cov_1.285714	87	125	4	12	38	0.3157895
NODE_287794_length_253_cov_1.214286	99	148	2	49	49	1.0000000
NODE_287845_length_253_cov_1.181818	185	247	0	62	62	1.0000000
NODE_287845_length_253_cov_1.181818	185	247	0	62	62	1.0000000
NODE_287989_length_253_cov_1.064935	83	159	2	2	76	0.0263158
NODE_287989_length_253_cov_1.064935	83	159	4	15	76	0.1973684
NODE_287989_length_253_cov_1.064935	83	159	5	1	76	0.0131579
NODE_287989_length_253_cov_1.064935	83	159	6	11	76	0.1447368
NODE_287989_length_253_cov_1.064935	83	159	8	1	76	0.0131579
NODE_287989_length_253_cov_1.064935	83	159	10	17	76	0.2236842
NODE_287989_length_253_cov_1.064935	83	159	12	29	76	0.3815790
NODE_288099_length_253_cov_0.993506	0	44	0	44	44	1.0000000
NODE_288465_length_253_cov_0.870130	17	46	0	29	29	1.0000000
NODE_288478_length_253_cov_0.850649	0	89	0	89	89	1.0000000
NODE_289563_length_252_cov_4.771242	94	148	0	54	54	1.0000000
NODE_289574_length_252_cov_4.614379	16	37	0	11	21	0.5238096
NODE_289574_length_252_cov_4.614379	16	37	1	10	21	0.4761905
NODE_289624_length_252_cov_3.960784	7	85	0	78	78	1.0000000
NODE_289624_length_252_cov_3.960784	63	136	0	73	73	1.0000000
NODE_289663_length_252_cov_3.549020	89	157	0	68	68	1.0000000
NODE_289672_length_252_cov_3.405229	26	107	5	17	81	0.2098765
NODE_289672_length_252_cov_3.405229	26	107	7	6	81	0.0740741
NODE_289672_length_252_cov_3.405229	26	107	8	24	81	0.2962963
NODE_289672_length_252_cov_3.405229	26	107	10	1	81	0.0123457
NODE_289672_length_252_cov_3.405229	26	107	14	3	81	0.0370370
NODE_289672_length_252_cov_3.405229	26	107	16	5	81	0.0617284
NODE_289672_length_252_cov_3.405229	26	107	18	2	81	0.0246914
NODE_289672_length_252_cov_3.405229	26	107	22	4	81	0.0493827
NODE_289672_length_252_cov_3.405229	26	107	24	14	81	0.1728395
NODE_289672_length_252_cov_3.405229	26	107	25	1	81	0.0123457
NODE_289672_length_252_cov_3.405229	26	107	26	4	81	0.0493827
NODE_289705_length_252_cov_3.307190	91	141	0	50	50	1.0000000
NODE_289742_length_252_cov_3.032680	135	212	6	77	77	1.0000000
NODE_289775_length_252_cov_2.928105	0	57	0	57	57	1.0000000
NODE_289799_length_252_cov_2.803922	41	121	0	80	80	1.0000000
NODE_290032_length_252_cov_2.320261	0	64	0	64	64	1.0000000
NODE_290046_length_252_cov_2.281046	120	170	0	24	50	0.4800000
NODE_290046_length_252_cov_2.281046	120	170	2	26	50	0.5200000
NODE_290066_length_252_cov_2.215686	137	175	52	1	38	0.0263158
NODE_290066_length_252_cov_2.215686	137	175	54	6	38	0.1578947
NODE_290066_length_252_cov_2.215686	137	175	56	18	38	0.4736842
NODE_290066_length_252_cov_2.215686	137	175	58	7	38	0.1842105
NODE_290066_length_252_cov_2.215686	137	175	60	5	38	0.1315790
NODE_290066_length_252_cov_2.215686	137	175	62	1	38	0.0263158
NODE_290103_length_252_cov_2.052288	18	39	0	21	21	1.0000000
NODE_290238_length_252_cov_1.993464	80	139	4	59	59	1.0000000
NODE_290385_length_252_cov_1.810458	3	49	0	46	46	1.0000000
NODE_290623_length_252_cov_1.594771	103	156	0	53	53	1.0000000
NODE_290623_length_252_cov_1.594771	152	192	0	40	40	1.0000000
NODE_290638_length_252_cov_1.568627	1	68	0	67	67	1.0000000
NODE_290767_length_252_cov_1.359477	26	93	0	67	67	1.0000000
NODE_290790_length_252_cov_1.333333	179	232	0	7	53	0.1320755
NODE_290790_length_252_cov_1.333333	179	232	2	46	53	0.8679245
NODE_290850_length_252_cov_1.333333	187	222	0	35	35	1.0000000
NODE_291072_length_252_cov_1.333333	31	111	0	80	80	1.0000000
NODE_291076_length_252_cov_1.333333	90	140	4	9	50	0.1800000
NODE_291076_length_252_cov_1.333333	90	140	6	40	50	0.8000000
NODE_291076_length_252_cov_1.333333	90	140	8	1	50	0.0200000
NODE_291118_length_252_cov_1.326797	112	143	0	31	31	1.0000000
NODE_291351_length_252_cov_1.156863	1	32	0	31	31	1.0000000
NODE_291650_length_252_cov_1.000000	49	79	0	30	30	1.0000000
NODE_291911_length_252_cov_0.836601	125	172	0	36	47	0.7659575
NODE_291911_length_252_cov_0.836601	125	172	2	11	47	0.2340426
NODE_293004_length_251_cov_5.032895	0	62	0	62	62	1.0000000
NODE_293005_length_251_cov_5.026316	84	164	0	80	80	1.0000000
NODE_293165_length_251_cov_3.302632	187	249	0	62	62	1.0000000
NODE_293195_length_251_cov_3.131579	96	148	0	52	52	1.0000000
NODE_293238_length_251_cov_2.980263	11	38	22	1	27	0.0370370
NODE_293238_length_251_cov_2.980263	11	38	26	3	27	0.1111111
NODE_293238_length_251_cov_2.980263	11	38	30	2	27	0.0740741
NODE_293238_length_251_cov_2.980263	11	38	37	2	27	0.0740741
NODE_293238_length_251_cov_2.980263	11	38	39	2	27	0.0740741
NODE_293238_length_251_cov_2.980263	11	38	41	2	27	0.0740741
NODE_293238_length_251_cov_2.980263	11	38	45	15	27	0.5555556
NODE_293238_length_251_cov_2.980263	11	91	22	1	80	0.0125000
NODE_293238_length_251_cov_2.980263	11	91	26	3	80	0.0375000
NODE_293238_length_251_cov_2.980263	11	91	30	2	80	0.0250000
NODE_293238_length_251_cov_2.980263	11	91	37	2	80	0.0250000
NODE_293238_length_251_cov_2.980263	11	91	39	2	80	0.0250000
NODE_293238_length_251_cov_2.980263	11	91	41	2	80	0.0250000
NODE_293238_length_251_cov_2.980263	11	91	45	23	80	0.2875000
NODE_293238_length_251_cov_2.980263	11	91	53	2	80	0.0250000
NODE_293238_length_251_cov_2.980263	11	91	54	33	80	0.4125000
NODE_293238_length_251_cov_2.980263	11	91	56	10	80	0.1250000
NODE_293259_length_251_cov_2.842105	170	198	2	1	28	0.0357143
NODE_293259_length_251_cov_2.842105	170	198	4	5	28	0.1785714
NODE_293259_length_251_cov_2.842105	170	198	6	9	28	0.3214286
NODE_293259_length_251_cov_2.842105	170	198	8	13	28	0.4642857
NODE_293279_length_251_cov_2.743421	181	232	0	51	51	1.0000000
NODE_293335_length_251_cov_2.677632	35	54	0	19	19	1.0000000
NODE_293454_length_251_cov_2.348684	196	251	0	55	55	1.0000000
NODE_293502_length_251_cov_2.328947	86	149	0	57	63	0.9047619
NODE_293502_length_251_cov_2.328947	86	149	2	6	63	0.0952381
NODE_293516_length_251_cov_2.296053	91	171	0	80	80	1.0000000
NODE_293516_length_251_cov_2.296053	144	224	0	80	80	1.0000000
NODE_293591_length_251_cov_2.065789	7	52	0	45	45	1.0000000
NODE_293698_length_251_cov_2.013158	96	179	0	83	83	1.0000000
NODE_293698_length_251_cov_2.013158	96	179	0	83	83	1.0000000
NODE_293698_length_251_cov_2.013158	152	203	0	51	51	1.0000000
NODE_293698_length_251_cov_2.013158	152	201	0	49	49	1.0000000
NODE_293919_length_251_cov_1.710526	135	194	0	59	59	1.0000000
NODE_294028_length_251_cov_1.671053	94	127	0	33	33	1.0000000
NODE_294063_length_251_cov_1.644737	135	164	0	29	29	1.0000000
NODE_294147_length_251_cov_1.473684	137	202	0	5	65	0.0769231
NODE_294147_length_251_cov_1.473684	137	202	2	60	65	0.9230769
NODE_294153_length_251_cov_1.460526	17	78	0	61	61	1.0000000
NODE_294190_length_251_cov_1.407895	182	246	2	64	64	1.0000000
NODE_294393_length_251_cov_1.342105	9	89	0	80	80	1.0000000
NODE_294393_length_251_cov_1.342105	62	91	0	29	29	1.0000000
NODE_294624_length_251_cov_1.296053	7	47	0	40	40	1.0000000
NODE_294624_length_251_cov_1.296053	24	47	0	23	23	1.0000000
NODE_295165_length_251_cov_1.006579	4	50	0	46	46	1.0000000
NODE_296033_length_251_cov_0.671053	184	204	0	11	20	0.5500000
NODE_296033_length_251_cov_0.671053	184	204	2	9	20	0.4500000
NODE_296386_length_251_cov_0.572368	54	74	0	20	20	1.0000000
NODE_296437_length_250_cov_35.662252	33	99	0	66	66	1.0000000
NODE_296437_length_250_cov_35.662252	143	223	0	80	80	1.0000000
NODE_296456_length_250_cov_6.503311	186	250	0	64	64	1.0000000
NODE_296467_length_250_cov_5.867550	99	120	0	21	21	1.0000000
NODE_296520_length_250_cov_4.662252	143	187	0	44	44	1.0000000
NODE_296520_length_250_cov_4.662252	160	227	0	67	67	1.0000000
NODE_296598_length_250_cov_3.715232	37	90	2	53	53	1.0000000
NODE_296633_length_250_cov_3.417219	113	193	3	39	80	0.4875000
NODE_296633_length_250_cov_3.417219	113	193	5	41	80	0.5125000
NODE_296633_length_250_cov_3.417219	166	246	0	34	80	0.4250000
NODE_296633_length_250_cov_3.417219	166	246	1	3	80	0.0375000
NODE_296633_length_250_cov_3.417219	166	246	3	43	80	0.5375000
NODE_296653_length_250_cov_3.364238	0	61	0	5	61	0.0819672
NODE_296653_length_250_cov_3.364238	0	61	4	31	61	0.5081967
NODE_296653_length_250_cov_3.364238	0	61	6	25	61	0.4098361
NODE_296653_length_250_cov_3.364238	34	94	4	2	60	0.0333333
NODE_296653_length_250_cov_3.364238	34	94	6	58	60	0.9666666
NODE_296680_length_250_cov_3.225166	157	209	0	52	52	1.0000000
NODE_296680_length_250_cov_3.225166	182	250	0	68	68	1.0000000
NODE_296699_length_250_cov_3.086093	33	67	0	34	34	1.0000000
NODE_296703_length_250_cov_3.052980	29	94	2	6	65	0.0923077
NODE_296703_length_250_cov_3.052980	29	94	4	10	65	0.1538462
NODE_296703_length_250_cov_3.052980	29	94	8	6	65	0.0923077
NODE_296703_length_250_cov_3.052980	29	94	10	6	65	0.0923077
NODE_296703_length_250_cov_3.052980	29	94	12	4	65	0.0615385
NODE_296703_length_250_cov_3.052980	29	94	14	17	65	0.2615385
NODE_296703_length_250_cov_3.052980	29	94	16	16	65	0.2461538
NODE_296707_length_250_cov_3.039735	51	106	0	27	55	0.4909091
NODE_296707_length_250_cov_3.039735	51	106	2	28	55	0.5090909
NODE_296737_length_250_cov_2.986755	124	185	2	61	61	1.0000000
NODE_296737_length_250_cov_2.986755	172	243	0	58	71	0.8169014
NODE_296737_length_250_cov_2.986755	172	243	2	13	71	0.1830986
NODE_296885_length_250_cov_2.516556	0	49	0	49	49	1.0000000
NODE_296893_length_250_cov_2.476821	94	174	0	80	80	1.0000000
NODE_296893_length_250_cov_2.476821	147	227	0	80	80	1.0000000
NODE_296897_length_250_cov_2.470199	166	212	0	46	46	1.0000000
NODE_297070_length_250_cov_2.059603	150	207	0	57	57	1.0000000
NODE_297211_length_250_cov_2.019868	74	141	23	5	67	0.0746269
NODE_297211_length_250_cov_2.019868	74	141	24	51	67	0.7611941
NODE_297211_length_250_cov_2.019868	74	141	26	10	67	0.1492537
NODE_297211_length_250_cov_2.019868	74	141	27	1	67	0.0149254
NODE_297211_length_250_cov_2.019868	158	204	9	9	46	0.1956522
NODE_297211_length_250_cov_2.019868	158	204	10	6	46	0.1304348
NODE_297211_length_250_cov_2.019868	158	204	16	7	46	0.1521739
NODE_297211_length_250_cov_2.019868	158	204	18	5	46	0.1086956
NODE_297211_length_250_cov_2.019868	158	204	20	19	46	0.4130435
NODE_297550_length_250_cov_1.688742	6	42	0	36	36	1.0000000
NODE_297624_length_250_cov_1.635762	150	191	0	41	41	1.0000000
NODE_297679_length_250_cov_1.529801	59	108	0	49	49	1.0000000
NODE_297679_length_250_cov_1.529801	81	161	0	80	80	1.0000000
NODE_297693_length_250_cov_1.516556	124	184	0	60	60	1.0000000
NODE_297693_length_250_cov_1.516556	166	237	0	71	71	1.0000000
NODE_297762_length_250_cov_1.377483	0	80	0	80	80	1.0000000
NODE_297963_length_250_cov_1.350993	40	98	0	58	58	1.0000000
NODE_298213_length_250_cov_1.291391	116	196	0	80	80	1.0000000
NODE_298719_length_250_cov_1.013245	126	163	0	37	37	1.0000000
NODE_298794_length_250_cov_1.006623	129	148	0	19	19	1.0000000
NODE_298900_length_250_cov_0.920530	126	178	14	1	52	0.0192308
NODE_298900_length_250_cov_0.920530	126	178	16	2	52	0.0384615
NODE_298900_length_250_cov_0.920530	126	178	18	6	52	0.1153846
NODE_298900_length_250_cov_0.920530	126	178	20	2	52	0.0384615
NODE_298900_length_250_cov_0.920530	126	178	21	10	52	0.1923077
NODE_298900_length_250_cov_0.920530	126	178	22	7	52	0.1346154
NODE_298900_length_250_cov_0.920530	126	178	24	4	52	0.0769231
NODE_298900_length_250_cov_0.920530	126	178	26	4	52	0.0769231
NODE_298900_length_250_cov_0.920530	126	178	28	4	52	0.0769231
NODE_298900_length_250_cov_0.920530	126	178	30	12	52	0.2307692
NODE_299979_length_249_cov_55.413333	97	172	0	75	75	1.0000000
NODE_299979_length_249_cov_55.413333	150	225	0	75	75	1.0000000
NODE_300012_length_247_cov_51.243243	172	247	0	75	75	1.0000000
NODE_300014_length_247_cov_37.614865	156	239	0	38	83	0.4578313
NODE_300014_length_247_cov_37.614865	156	239	1	7	83	0.0843373
NODE_300014_length_247_cov_37.614865	156	239	2	38	83	0.4578313
NODE_300056_length_245_cov_40.876712	138	202	13	6	64	0.0937500
NODE_300056_length_245_cov_40.876712	138	202	16	4	64	0.0625000
NODE_300056_length_245_cov_40.876712	138	202	20	2	64	0.0312500
NODE_300056_length_245_cov_40.876712	138	202	22	4	64	0.0625000
NODE_300056_length_245_cov_40.876712	138	202	24	1	64	0.0156250
NODE_300056_length_245_cov_40.876712	138	202	28	1	64	0.0156250
NODE_300056_length_245_cov_40.876712	138	202	31	2	64	0.0312500
NODE_300056_length_245_cov_40.876712	138	202	33	1	64	0.0156250
NODE_300056_length_245_cov_40.876712	138	202	40	1	64	0.0156250
NODE_300056_length_245_cov_40.876712	138	202	44	3	64	0.0468750
NODE_300056_length_245_cov_40.876712	138	202	46	1	64	0.0156250
NODE_300056_length_245_cov_40.876712	138	202	47	5	64	0.0781250
NODE_300056_length_245_cov_40.876712	138	202	49	1	64	0.0156250
NODE_300056_length_245_cov_40.876712	138	202	51	1	64	0.0156250
NODE_300056_length_245_cov_40.876712	138	202	53	9	64	0.1406250
NODE_300056_length_245_cov_40.876712	138	202	54	2	64	0.0312500
NODE_300056_length_245_cov_40.876712	138	202	55	5	64	0.0781250
NODE_300056_length_245_cov_40.876712	138	202	56	1	64	0.0156250
NODE_300056_length_245_cov_40.876712	138	202	57	1	64	0.0156250
NODE_300056_length_245_cov_40.876712	138	202	64	1	64	0.0156250
NODE_300056_length_245_cov_40.876712	138	202	66	1	64	0.0156250
NODE_300056_length_245_cov_40.876712	138	202	67	1	64	0.0156250
NODE_300056_length_245_cov_40.876712	138	202	71	1	64	0.0156250
NODE_300056_length_245_cov_40.876712	138	202	72	1	64	0.0156250
NODE_300056_length_245_cov_40.876712	138	202	73	1	64	0.0156250
NODE_300056_length_245_cov_40.876712	138	202	75	7	64	0.1093750
NODE_300056_length_245_cov_40.876712	138	202	13	6	64	0.0937500
NODE_300056_length_245_cov_40.876712	138	202	16	4	64	0.0625000
NODE_300056_length_245_cov_40.876712	138	202	20	2	64	0.0312500
NODE_300056_length_245_cov_40.876712	138	202	22	4	64	0.0625000
NODE_300056_length_245_cov_40.876712	138	202	24	1	64	0.0156250
NODE_300056_length_245_cov_40.876712	138	202	28	1	64	0.0156250
NODE_300056_length_245_cov_40.876712	138	202	31	2	64	0.0312500
NODE_300056_length_245_cov_40.876712	138	202	33	1	64	0.0156250
NODE_300056_length_245_cov_40.876712	138	202	40	1	64	0.0156250
NODE_300056_length_245_cov_40.876712	138	202	44	3	64	0.0468750
NODE_300056_length_245_cov_40.876712	138	202	46	1	64	0.0156250
NODE_300056_length_245_cov_40.876712	138	202	47	5	64	0.0781250
NODE_300056_length_245_cov_40.876712	138	202	49	1	64	0.0156250
NODE_300056_length_245_cov_40.876712	138	202	51	1	64	0.0156250
NODE_300056_length_245_cov_40.876712	138	202	53	9	64	0.1406250
NODE_300056_length_245_cov_40.876712	138	202	54	2	64	0.0312500
NODE_300056_length_245_cov_40.876712	138	202	55	5	64	0.0781250
NODE_300056_length_245_cov_40.876712	138	202	56	1	64	0.0156250
NODE_300056_length_245_cov_40.876712	138	202	57	1	64	0.0156250
NODE_300056_length_245_cov_40.876712	138	202	64	1	64	0.0156250
NODE_300056_length_245_cov_40.876712	138	202	66	1	64	0.0156250
NODE_300056_length_245_cov_40.876712	138	202	67	1	64	0.0156250
NODE_300056_length_245_cov_40.876712	138	202	71	1	64	0.0156250
NODE_300056_length_245_cov_40.876712	138	202	72	1	64	0.0156250
NODE_300056_length_245_cov_40.876712	138	202	73	1	64	0.0156250
NODE_300056_length_245_cov_40.876712	138	202	75	7	64	0.1093750
NODE_300056_length_245_cov_40.876712	138	202	13	6	64	0.0937500
NODE_300056_length_245_cov_40.876712	138	202	16	4	64	0.0625000
NODE_300056_length_245_cov_40.876712	138	202	20	2	64	0.0312500
NODE_300056_length_245_cov_40.876712	138	202	22	4	64	0.0625000
NODE_300056_length_245_cov_40.876712	138	202	24	1	64	0.0156250
NODE_300056_length_245_cov_40.876712	138	202	28	1	64	0.0156250
NODE_300056_length_245_cov_40.876712	138	202	31	2	64	0.0312500
NODE_300056_length_245_cov_40.876712	138	202	33	1	64	0.0156250
NODE_300056_length_245_cov_40.876712	138	202	40	1	64	0.0156250
NODE_300056_length_245_cov_40.876712	138	202	44	3	64	0.0468750
NODE_300056_length_245_cov_40.876712	138	202	46	1	64	0.0156250
NODE_300056_length_245_cov_40.876712	138	202	47	5	64	0.0781250
NODE_300056_length_245_cov_40.876712	138	202	49	1	64	0.0156250
NODE_300056_length_245_cov_40.876712	138	202	51	1	64	0.0156250
NODE_300056_length_245_cov_40.876712	138	202	53	9	64	0.1406250
NODE_300056_length_245_cov_40.876712	138	202	54	2	64	0.0312500
NODE_300056_length_245_cov_40.876712	138	202	55	5	64	0.0781250
NODE_300056_length_245_cov_40.876712	138	202	56	1	64	0.0156250
NODE_300056_length_245_cov_40.876712	138	202	57	1	64	0.0156250
NODE_300056_length_245_cov_40.876712	138	202	64	1	64	0.0156250
NODE_300056_length_245_cov_40.876712	138	202	66	1	64	0.0156250
NODE_300056_length_245_cov_40.876712	138	202	67	1	64	0.0156250
NODE_300056_length_245_cov_40.876712	138	202	71	1	64	0.0156250
NODE_300056_length_245_cov_40.876712	138	202	72	1	64	0.0156250
NODE_300056_length_245_cov_40.876712	138	202	73	1	64	0.0156250
NODE_300056_length_245_cov_40.876712	138	202	75	7	64	0.1093750
NODE_300056_length_245_cov_40.876712	175	241	4	18	66	0.2727273
NODE_300056_length_245_cov_40.876712	175	241	5	1	66	0.0151515
NODE_300056_length_245_cov_40.876712	175	241	6	5	66	0.0757576
NODE_300056_length_245_cov_40.876712	175	241	10	9	66	0.1363636
NODE_300056_length_245_cov_40.876712	175	241	12	4	66	0.0606061
NODE_300056_length_245_cov_40.876712	175	241	13	8	66	0.1212121
NODE_300056_length_245_cov_40.876712	175	241	16	4	66	0.0606061
NODE_300056_length_245_cov_40.876712	175	241	20	2	66	0.0303030
NODE_300056_length_245_cov_40.876712	175	241	22	4	66	0.0606061
NODE_300056_length_245_cov_40.876712	175	241	24	1	66	0.0151515
NODE_300056_length_245_cov_40.876712	175	241	28	1	66	0.0151515
NODE_300056_length_245_cov_40.876712	175	241	31	2	66	0.0303030
NODE_300056_length_245_cov_40.876712	175	241	33	1	66	0.0151515
NODE_300056_length_245_cov_40.876712	175	241	40	1	66	0.0151515
NODE_300056_length_245_cov_40.876712	175	241	44	3	66	0.0454545
NODE_300056_length_245_cov_40.876712	175	241	46	1	66	0.0151515
NODE_300056_length_245_cov_40.876712	175	241	47	1	66	0.0151515
NODE_300147_length_240_cov_80.744681	167	238	0	60	71	0.8450704
NODE_300147_length_240_cov_80.744681	167	238	1	11	71	0.1549296
NODE_300148_length_240_cov_38.035461	31	82	0	51	51	1.0000000
NODE_300165_length_239_cov_72.878571	0	48	0	30	48	0.6250000
NODE_300165_length_239_cov_72.878571	0	48	2	18	48	0.3750000
NODE_300165_length_239_cov_72.878571	21	101	0	9	80	0.1125000
NODE_300165_length_239_cov_72.878571	21	101	2	69	80	0.8625000
NODE_300165_length_239_cov_72.878571	21	101	7	1	80	0.0125000
NODE_300165_length_239_cov_72.878571	21	101	10	1	80	0.0125000
NODE_300165_length_239_cov_72.878571	150	230	10	26	80	0.3250000
NODE_300165_length_239_cov_72.878571	150	230	18	53	80	0.6625000
NODE_300165_length_239_cov_72.878571	150	230	20	1	80	0.0125000
NODE_300165_length_239_cov_72.878571	150	230	10	26	80	0.3250000
NODE_300165_length_239_cov_72.878571	150	230	18	53	80	0.6625000
NODE_300165_length_239_cov_72.878571	150	230	20	1	80	0.0125000
NODE_300165_length_239_cov_72.878571	150	212	10	8	62	0.1290323
NODE_300165_length_239_cov_72.878571	150	212	18	53	62	0.8548387
NODE_300165_length_239_cov_72.878571	150	212	20	1	62	0.0161290
NODE_300165_length_239_cov_72.878571	150	221	10	17	71	0.2394366
NODE_300165_length_239_cov_72.878571	150	221	18	53	71	0.7464789
NODE_300165_length_239_cov_72.878571	150	221	20	1	71	0.0140845
NODE_300208_length_238_cov_385.683453	35	104	71	2	69	0.0289855
NODE_300208_length_238_cov_385.683453	35	104	83	1	69	0.0144928
NODE_300208_length_238_cov_385.683453	35	104	86	5	69	0.0724638
NODE_300208_length_238_cov_385.683453	35	104	87	8	69	0.1159420
NODE_300208_length_238_cov_385.683453	35	104	95	6	69	0.0869565
NODE_300208_length_238_cov_385.683453	35	104	101	1	69	0.0144928
NODE_300208_length_238_cov_385.683453	35	104	104	1	69	0.0144928
NODE_300208_length_238_cov_385.683453	35	104	110	8	69	0.1159420
NODE_300208_length_238_cov_385.683453	35	104	112	1	69	0.0144928
NODE_300208_length_238_cov_385.683453	35	104	114	7	69	0.1014493
NODE_300208_length_238_cov_385.683453	35	104	116	8	69	0.1159420
NODE_300208_length_238_cov_385.683453	35	104	118	2	69	0.0289855
NODE_300208_length_238_cov_385.683453	35	104	120	4	69	0.0579710
NODE_300208_length_238_cov_385.683453	35	104	122	7	69	0.1014493
NODE_300208_length_238_cov_385.683453	35	104	126	8	69	0.1159420
NODE_300225_length_237_cov_101.543478	83	163	0	80	80	1.0000000
NODE_300225_length_237_cov_101.543478	83	163	0	80	80	1.0000000
NODE_300225_length_237_cov_101.543478	83	163	0	80	80	1.0000000
NODE_300225_length_237_cov_101.543478	83	163	0	80	80	1.0000000
NODE_300225_length_237_cov_101.543478	136	216	0	80	80	1.0000000
NODE_300225_length_237_cov_101.543478	136	216	0	80	80	1.0000000
NODE_300225_length_237_cov_101.543478	136	216	0	80	80	1.0000000
NODE_300225_length_237_cov_101.543478	138	216	0	78	78	1.0000000
NODE_300225_length_237_cov_101.543478	138	216	0	78	78	1.0000000
NODE_300227_length_237_cov_49.623188	13	88	0	75	75	1.0000000
NODE_300227_length_237_cov_49.623188	73	153	0	80	80	1.0000000
NODE_300227_length_237_cov_49.623188	126	206	0	80	80	1.0000000
NODE_300289_length_235_cov_67.904412	0	62	0	62	62	1.0000000
NODE_300289_length_235_cov_67.904412	25	111	0	86	86	1.0000000
NODE_300289_length_235_cov_67.904412	69	150	0	81	81	1.0000000
NODE_300289_length_235_cov_67.904412	113	194	0	81	81	1.0000000
NODE_300289_length_235_cov_67.904412	157	235	0	78	78	1.0000000
NODE_300322_length_234_cov_76.496296	0	76	0	76	76	1.0000000
NODE_300322_length_234_cov_76.496296	0	76	0	76	76	1.0000000
NODE_300322_length_234_cov_76.496296	0	76	0	76	76	1.0000000
NODE_300322_length_234_cov_76.496296	0	76	0	76	76	1.0000000
NODE_300322_length_234_cov_76.496296	49	128	0	79	79	1.0000000
NODE_300322_length_234_cov_76.496296	49	128	0	79	79	1.0000000
NODE_300322_length_234_cov_76.496296	124	204	0	80	80	1.0000000
NODE_300322_length_234_cov_76.496296	124	204	0	80	80	1.0000000
NODE_300322_length_234_cov_76.496296	124	204	0	80	80	1.0000000
NODE_300322_length_234_cov_76.496296	177	226	0	49	49	1.0000000
NODE_300322_length_234_cov_76.496296	177	234	0	57	57	1.0000000
NODE_300322_length_234_cov_76.496296	182	234	0	52	52	1.0000000
NODE_300323_length_234_cov_71.548148	90	162	8	72	72	1.0000000
NODE_300323_length_234_cov_71.548148	90	162	8	72	72	1.0000000
NODE_300323_length_234_cov_71.548148	135	215	0	19	80	0.2375000
NODE_300323_length_234_cov_71.548148	135	215	7	19	80	0.2375000
NODE_300323_length_234_cov_71.548148	135	215	8	42	80	0.5250000
NODE_300323_length_234_cov_71.548148	135	215	0	19	80	0.2375000
NODE_300323_length_234_cov_71.548148	135	215	7	19	80	0.2375000
NODE_300323_length_234_cov_71.548148	135	215	8	42	80	0.5250000
NODE_300357_length_233_cov_180.701493	0	65	0	65	65	1.0000000
NODE_300357_length_233_cov_180.701493	38	118	0	80	80	1.0000000
NODE_300392_length_232_cov_132.045113	53	133	0	57	80	0.7125000
NODE_300392_length_232_cov_132.045113	53	133	6	5	80	0.0625000
NODE_300392_length_232_cov_132.045113	53	133	18	18	80	0.2250000
NODE_300392_length_232_cov_132.045113	106	186	0	4	80	0.0500000
NODE_300392_length_232_cov_132.045113	106	186	6	5	80	0.0625000
NODE_300392_length_232_cov_132.045113	106	186	17	33	80	0.4125000
NODE_300392_length_232_cov_132.045113	106	186	18	38	80	0.4750000
NODE_300471_length_230_cov_34.427481	0	59	0	59	59	1.0000000
NODE_300471_length_230_cov_34.427481	0	59	0	59	59	1.0000000
NODE_300471_length_230_cov_34.427481	10	59	0	49	49	1.0000000
NODE_300487_length_229_cov_76.907692	94	176	32	5	82	0.0609756
NODE_300487_length_229_cov_76.907692	94	176	34	2	82	0.0243902
NODE_300487_length_229_cov_76.907692	94	176	36	1	82	0.0121951
NODE_300487_length_229_cov_76.907692	94	176	38	7	82	0.0853659
NODE_300487_length_229_cov_76.907692	94	176	40	6	82	0.0731707
NODE_300487_length_229_cov_76.907692	94	176	42	18	82	0.2195122
NODE_300487_length_229_cov_76.907692	94	176	44	19	82	0.2317073
NODE_300487_length_229_cov_76.907692	94	176	46	24	82	0.2926829
NODE_300523_length_228_cov_127.131783	0	76	0	76	76	1.0000000
NODE_300523_length_228_cov_127.131783	5	76	0	71	71	1.0000000
NODE_300523_length_228_cov_127.131783	10	76	0	66	66	1.0000000
NODE_300523_length_228_cov_127.131783	49	129	0	80	80	1.0000000
NODE_300523_length_228_cov_127.131783	49	129	0	80	80	1.0000000
NODE_300523_length_228_cov_127.131783	49	129	0	80	80	1.0000000
NODE_300523_length_228_cov_127.131783	125	205	0	80	80	1.0000000
NODE_300523_length_228_cov_127.131783	125	205	0	80	80	1.0000000
NODE_300523_length_228_cov_127.131783	125	205	0	80	80	1.0000000
NODE_300523_length_228_cov_127.131783	178	228	0	50	50	1.0000000
NODE_300523_length_228_cov_127.131783	178	228	0	50	50	1.0000000
NODE_300523_length_228_cov_127.131783	178	228	0	50	50	1.0000000
NODE_300524_length_228_cov_94.255814	34	99	0	17	65	0.2615385
NODE_300524_length_228_cov_94.255814	34	99	6	28	65	0.4307692
NODE_300524_length_228_cov_94.255814	34	99	11	1	65	0.0153846
NODE_300524_length_228_cov_94.255814	34	99	12	19	65	0.2923077
NODE_300524_length_228_cov_94.255814	34	114	0	17	80	0.2125000
NODE_300524_length_228_cov_94.255814	34	114	6	28	80	0.3500000
NODE_300524_length_228_cov_94.255814	34	114	11	1	80	0.0125000
NODE_300524_length_228_cov_94.255814	34	114	12	33	80	0.4125000
NODE_300524_length_228_cov_94.255814	34	114	14	1	80	0.0125000
NODE_300524_length_228_cov_94.255814	41	111	0	10	70	0.1428571
NODE_300524_length_228_cov_94.255814	41	111	6	28	70	0.4000000
NODE_300524_length_228_cov_94.255814	41	111	11	1	70	0.0142857
NODE_300524_length_228_cov_94.255814	41	111	12	31	70	0.4428571
NODE_300524_length_228_cov_94.255814	43	114	0	8	71	0.1126761
NODE_300524_length_228_cov_94.255814	43	114	6	28	71	0.3943662
NODE_300524_length_228_cov_94.255814	43	114	11	1	71	0.0140845
NODE_300524_length_228_cov_94.255814	43	114	12	33	71	0.4647887
NODE_300524_length_228_cov_94.255814	43	114	14	1	71	0.0140845
NODE_300524_length_228_cov_94.255814	87	167	8	11	80	0.1375000
NODE_300524_length_228_cov_94.255814	87	167	12	26	80	0.3250000
NODE_300524_length_228_cov_94.255814	87	167	14	43	80	0.5375000
NODE_300524_length_228_cov_94.255814	87	167	8	11	80	0.1375000
NODE_300524_length_228_cov_94.255814	87	167	12	26	80	0.3250000
NODE_300524_length_228_cov_94.255814	87	167	14	43	80	0.5375000
NODE_300524_length_228_cov_94.255814	87	167	8	11	80	0.1375000
NODE_300524_length_228_cov_94.255814	87	167	12	26	80	0.3250000
NODE_300524_length_228_cov_94.255814	87	167	14	43	80	0.5375000
NODE_300524_length_228_cov_94.255814	87	167	8	11	80	0.1375000
NODE_300524_length_228_cov_94.255814	87	167	12	26	80	0.3250000
NODE_300524_length_228_cov_94.255814	87	167	14	43	80	0.5375000
NODE_300547_length_228_cov_0.395349	27	107	0	80	80	1.0000000
NODE_300547_length_228_cov_0.395349	70	150	0	80	80	1.0000000
NODE_300556_length_227_cov_37.429688	40	111	0	43	71	0.6056338
NODE_300556_length_227_cov_37.429688	40	111	4	10	71	0.1408451
NODE_300556_length_227_cov_37.429688	40	111	8	16	71	0.2253521
NODE_300556_length_227_cov_37.429688	40	111	10	2	71	0.0281690
NODE_300556_length_227_cov_37.429688	49	112	0	34	63	0.5396826
NODE_300556_length_227_cov_37.429688	49	112	4	10	63	0.1587302
NODE_300556_length_227_cov_37.429688	49	112	8	16	63	0.2539683
NODE_300556_length_227_cov_37.429688	49	112	10	3	63	0.0476190
NODE_300556_length_227_cov_37.429688	93	172	8	16	79	0.2025317
NODE_300556_length_227_cov_37.429688	93	172	10	63	79	0.7974684
NODE_300556_length_227_cov_37.429688	168	227	0	46	59	0.7796610
NODE_300556_length_227_cov_37.429688	168	227	6	3	59	0.0508475
NODE_300556_length_227_cov_37.429688	168	227	10	10	59	0.1694915
NODE_300556_length_227_cov_37.429688	168	227	0	46	59	0.7796610
NODE_300556_length_227_cov_37.429688	168	227	6	3	59	0.0508475
NODE_300556_length_227_cov_37.429688	168	227	10	10	59	0.1694915
NODE_300595_length_226_cov_547.629921	82	162	453	1	80	0.0125000
NODE_300595_length_226_cov_547.629921	82	162	474	1	80	0.0125000
NODE_300595_length_226_cov_547.629921	82	162	480	1	80	0.0125000
NODE_300595_length_226_cov_547.629921	82	162	482	1	80	0.0125000
NODE_300595_length_226_cov_547.629921	82	162	492	1	80	0.0125000
NODE_300595_length_226_cov_547.629921	82	162	493	1	80	0.0125000
NODE_300595_length_226_cov_547.629921	82	162	494	1	80	0.0125000
NODE_300595_length_226_cov_547.629921	82	162	496	1	80	0.0125000
NODE_300595_length_226_cov_547.629921	82	162	501	1	80	0.0125000
NODE_300595_length_226_cov_547.629921	82	162	503	1	80	0.0125000
NODE_300595_length_226_cov_547.629921	82	162	506	1	80	0.0125000
NODE_300595_length_226_cov_547.629921	82	162	509	1	80	0.0125000
NODE_300595_length_226_cov_547.629921	82	162	512	3	80	0.0375000
NODE_300595_length_226_cov_547.629921	82	162	514	2	80	0.0250000
NODE_300595_length_226_cov_547.629921	82	162	518	1	80	0.0125000
NODE_300595_length_226_cov_547.629921	82	162	519	1	80	0.0125000
NODE_300595_length_226_cov_547.629921	82	162	521	2	80	0.0250000
NODE_300595_length_226_cov_547.629921	82	162	526	1	80	0.0125000
NODE_300595_length_226_cov_547.629921	82	162	529	1	80	0.0125000
NODE_300595_length_226_cov_547.629921	82	162	538	1	80	0.0125000
NODE_300595_length_226_cov_547.629921	82	162	541	1	80	0.0125000
NODE_300595_length_226_cov_547.629921	82	162	544	1	80	0.0125000
NODE_300595_length_226_cov_547.629921	82	162	548	1	80	0.0125000
NODE_300595_length_226_cov_547.629921	82	162	551	1	80	0.0125000
NODE_300595_length_226_cov_547.629921	82	162	554	1	80	0.0125000
NODE_300595_length_226_cov_547.629921	82	162	558	1	80	0.0125000
NODE_300595_length_226_cov_547.629921	82	162	560	1	80	0.0125000
NODE_300595_length_226_cov_547.629921	82	162	569	1	80	0.0125000
NODE_300595_length_226_cov_547.629921	82	162	574	1	80	0.0125000
NODE_300595_length_226_cov_547.629921	82	162	580	1	80	0.0125000
NODE_300595_length_226_cov_547.629921	82	162	581	1	80	0.0125000
NODE_300595_length_226_cov_547.629921	82	162	585	1	80	0.0125000
NODE_300595_length_226_cov_547.629921	82	162	589	2	80	0.0250000
NODE_300595_length_226_cov_547.629921	82	162	593	3	80	0.0375000
NODE_300595_length_226_cov_547.629921	82	162	594	3	80	0.0375000
NODE_300595_length_226_cov_547.629921	82	162	595	1	80	0.0125000
NODE_300595_length_226_cov_547.629921	82	162	596	5	80	0.0625000
NODE_300595_length_226_cov_547.629921	82	162	597	3	80	0.0375000
NODE_300595_length_226_cov_547.629921	82	162	599	1	80	0.0125000
NODE_300595_length_226_cov_547.629921	82	162	600	1	80	0.0125000
NODE_300595_length_226_cov_547.629921	82	162	601	1	80	0.0125000
NODE_300595_length_226_cov_547.629921	82	162	605	1	80	0.0125000
NODE_300595_length_226_cov_547.629921	82	162	606	1	80	0.0125000
NODE_300595_length_226_cov_547.629921	82	162	607	1	80	0.0125000
NODE_300595_length_226_cov_547.629921	82	162	609	3	80	0.0375000
NODE_300595_length_226_cov_547.629921	82	162	610	2	80	0.0250000
NODE_300595_length_226_cov_547.629921	82	162	612	1	80	0.0125000
NODE_300595_length_226_cov_547.629921	82	162	619	4	80	0.0500000
NODE_300595_length_226_cov_547.629921	82	162	620	3	80	0.0375000
NODE_300595_length_226_cov_547.629921	82	162	621	1	80	0.0125000
NODE_300595_length_226_cov_547.629921	82	162	622	5	80	0.0625000
NODE_300595_length_226_cov_547.629921	82	162	624	1	80	0.0125000
NODE_300595_length_226_cov_547.629921	82	162	626	1	80	0.0125000
NODE_300617_length_225_cov_41.269841	81	165	18	4	84	0.0476190
NODE_300617_length_225_cov_41.269841	81	165	20	7	84	0.0833333
NODE_300617_length_225_cov_41.269841	81	165	22	4	84	0.0476190
NODE_300617_length_225_cov_41.269841	81	165	24	1	84	0.0119048
NODE_300617_length_225_cov_41.269841	81	165	27	1	84	0.0119048
NODE_300617_length_225_cov_41.269841	81	165	28	1	84	0.0119048
NODE_300617_length_225_cov_41.269841	81	165	30	3	84	0.0357143
NODE_300617_length_225_cov_41.269841	81	165	32	1	84	0.0119048
NODE_300617_length_225_cov_41.269841	81	165	39	8	84	0.0952381
NODE_300617_length_225_cov_41.269841	81	165	41	15	84	0.1785714
NODE_300617_length_225_cov_41.269841	81	165	42	6	84	0.0714286
NODE_300617_length_225_cov_41.269841	81	165	44	2	84	0.0238095
NODE_300617_length_225_cov_41.269841	81	165	46	11	84	0.1309524
NODE_300617_length_225_cov_41.269841	81	165	47	4	84	0.0476190
NODE_300617_length_225_cov_41.269841	81	165	49	16	84	0.1904762
NODE_300617_length_225_cov_41.269841	134	218	1	1	84	0.0119048
NODE_300617_length_225_cov_41.269841	134	218	2	7	84	0.0833333
NODE_300617_length_225_cov_41.269841	134	218	4	11	84	0.1309524
NODE_300617_length_225_cov_41.269841	134	218	6	5	84	0.0595238
NODE_300617_length_225_cov_41.269841	134	218	10	7	84	0.0833333
NODE_300617_length_225_cov_41.269841	134	218	12	3	84	0.0357143
NODE_300617_length_225_cov_41.269841	134	218	16	16	84	0.1904762
NODE_300617_length_225_cov_41.269841	134	218	17	1	84	0.0119048
NODE_300617_length_225_cov_41.269841	134	218	18	6	84	0.0714286
NODE_300617_length_225_cov_41.269841	134	218	20	7	84	0.0833333
NODE_300617_length_225_cov_41.269841	134	218	22	4	84	0.0476190
NODE_300617_length_225_cov_41.269841	134	218	24	1	84	0.0119048
NODE_300617_length_225_cov_41.269841	134	218	27	1	84	0.0119048
NODE_300617_length_225_cov_41.269841	134	218	28	1	84	0.0119048
NODE_300617_length_225_cov_41.269841	134	218	30	3	84	0.0357143
NODE_300617_length_225_cov_41.269841	134	218	32	1	84	0.0119048
NODE_300617_length_225_cov_41.269841	134	218	39	8	84	0.0952381
NODE_300617_length_225_cov_41.269841	134	218	41	1	84	0.0119048
NODE_300661_length_224_cov_209.528000	12	84	11	3	72	0.0416667
NODE_300661_length_224_cov_209.528000	12	84	13	23	72	0.3194444
NODE_300661_length_224_cov_209.528000	12	84	15	2	72	0.0277778
NODE_300661_length_224_cov_209.528000	12	84	16	21	72	0.2916667
NODE_300661_length_224_cov_209.528000	12	84	18	4	72	0.0555556
NODE_300661_length_224_cov_209.528000	12	84	19	12	72	0.1666667
NODE_300661_length_224_cov_209.528000	12	84	21	7	72	0.0972222
NODE_300663_length_224_cov_146.568000	13	72	4	2	59	0.0338983
NODE_300663_length_224_cov_146.568000	13	72	6	6	59	0.1016949
NODE_300663_length_224_cov_146.568000	13	72	7	3	59	0.0508475
NODE_300663_length_224_cov_146.568000	13	72	8	3	59	0.0508475
NODE_300663_length_224_cov_146.568000	13	72	10	8	59	0.1355932
NODE_300663_length_224_cov_146.568000	13	72	11	1	59	0.0169492
NODE_300663_length_224_cov_146.568000	13	72	13	28	59	0.4745763
NODE_300663_length_224_cov_146.568000	13	72	17	2	59	0.0338983
NODE_300663_length_224_cov_146.568000	13	72	19	4	59	0.0677966
NODE_300663_length_224_cov_146.568000	13	72	21	2	59	0.0338983
NODE_300663_length_224_cov_146.568000	46	72	13	18	26	0.6923077
NODE_300663_length_224_cov_146.568000	46	72	17	2	26	0.0769231
NODE_300663_length_224_cov_146.568000	46	72	19	4	26	0.1538462
NODE_300663_length_224_cov_146.568000	46	72	21	2	26	0.0769231
NODE_300663_length_224_cov_146.568000	68	120	19	2	52	0.0384615
NODE_300663_length_224_cov_146.568000	68	120	21	3	52	0.0576923
NODE_300663_length_224_cov_146.568000	68	120	22	3	52	0.0576923
NODE_300663_length_224_cov_146.568000	68	120	25	2	52	0.0384615
NODE_300663_length_224_cov_146.568000	68	120	29	1	52	0.0192308
NODE_300663_length_224_cov_146.568000	68	120	31	1	52	0.0192308
NODE_300663_length_224_cov_146.568000	68	120	32	1	52	0.0192308
NODE_300663_length_224_cov_146.568000	68	120	33	2	52	0.0384615
NODE_300663_length_224_cov_146.568000	68	120	37	1	52	0.0192308
NODE_300663_length_224_cov_146.568000	68	120	38	2	52	0.0384615
NODE_300663_length_224_cov_146.568000	68	120	42	3	52	0.0576923
NODE_300663_length_224_cov_146.568000	68	120	44	1	52	0.0192308
NODE_300663_length_224_cov_146.568000	68	120	46	3	52	0.0576923
NODE_300663_length_224_cov_146.568000	68	120	50	2	52	0.0384615
NODE_300663_length_224_cov_146.568000	68	120	54	8	52	0.1538462
NODE_300663_length_224_cov_146.568000	68	120	55	1	52	0.0192308
NODE_300663_length_224_cov_146.568000	68	120	60	3	52	0.0576923
NODE_300663_length_224_cov_146.568000	68	120	62	1	52	0.0192308
NODE_300663_length_224_cov_146.568000	68	120	64	1	52	0.0192308
NODE_300663_length_224_cov_146.568000	68	120	66	11	52	0.2115385
NODE_300665_length_224_cov_59.088000	98	178	16	17	80	0.2125000
NODE_300665_length_224_cov_59.088000	98	178	20	11	80	0.1375000
NODE_300665_length_224_cov_59.088000	98	178	22	2	80	0.0250000
NODE_300665_length_224_cov_59.088000	98	178	28	50	80	0.6250000
NODE_300665_length_224_cov_59.088000	98	178	16	17	80	0.2125000
NODE_300665_length_224_cov_59.088000	98	178	20	11	80	0.1375000
NODE_300665_length_224_cov_59.088000	98	178	22	2	80	0.0250000
NODE_300665_length_224_cov_59.088000	98	178	28	50	80	0.6250000
NODE_300665_length_224_cov_59.088000	98	178	16	17	80	0.2125000
NODE_300665_length_224_cov_59.088000	98	178	20	11	80	0.1375000
NODE_300665_length_224_cov_59.088000	98	178	22	2	80	0.0250000
NODE_300665_length_224_cov_59.088000	98	178	28	50	80	0.6250000
NODE_300665_length_224_cov_59.088000	151	217	0	3	66	0.0454545
NODE_300665_length_224_cov_59.088000	151	217	8	15	66	0.2272727
NODE_300665_length_224_cov_59.088000	151	217	12	1	66	0.0151515
NODE_300665_length_224_cov_59.088000	151	217	16	37	66	0.5606061
NODE_300665_length_224_cov_59.088000	151	217	22	2	66	0.0303030
NODE_300665_length_224_cov_59.088000	151	217	28	8	66	0.1212121
NODE_300665_length_224_cov_59.088000	151	224	0	10	73	0.1369863
NODE_300665_length_224_cov_59.088000	151	224	8	15	73	0.2054795
NODE_300665_length_224_cov_59.088000	151	224	12	1	73	0.0136986
NODE_300665_length_224_cov_59.088000	151	224	16	37	73	0.5068493
NODE_300665_length_224_cov_59.088000	151	224	22	2	73	0.0273973
NODE_300665_length_224_cov_59.088000	151	224	28	8	73	0.1095890
NODE_300667_length_224_cov_43.640000	98	157	0	59	59	1.0000000
NODE_300667_length_224_cov_43.640000	98	157	0	59	59	1.0000000
NODE_300667_length_224_cov_43.640000	106	157	0	51	51	1.0000000
NODE_300669_length_224_cov_36.224000	100	171	7	13	71	0.1830986
NODE_300669_length_224_cov_36.224000	100	171	8	58	71	0.8169014
NODE_300669_length_224_cov_36.224000	151	224	0	4	73	0.0547945
NODE_300669_length_224_cov_36.224000	151	224	4	1	73	0.0136986
NODE_300669_length_224_cov_36.224000	151	224	7	61	73	0.8356164
NODE_300669_length_224_cov_36.224000	151	224	8	7	73	0.0958904
NODE_300696_length_223_cov_35.814516	0	54	0	35	54	0.6481481
NODE_300696_length_223_cov_35.814516	0	54	1	13	54	0.2407407
NODE_300696_length_223_cov_35.814516	0	54	3	3	54	0.0555556
NODE_300696_length_223_cov_35.814516	0	54	4	3	54	0.0555556
NODE_300696_length_223_cov_35.814516	30	107	0	5	77	0.0649351
NODE_300696_length_223_cov_35.814516	30	107	1	13	77	0.1688312
NODE_300696_length_223_cov_35.814516	30	107	2	5	77	0.0649351
NODE_300696_length_223_cov_35.814516	30	107	3	3	77	0.0389610
NODE_300696_length_223_cov_35.814516	30	107	4	51	77	0.6623377
NODE_300768_length_221_cov_71.319672	14	94	76	1	80	0.0125000
NODE_300768_length_221_cov_71.319672	14	94	78	2	80	0.0250000
NODE_300768_length_221_cov_71.319672	14	94	84	1	80	0.0125000
NODE_300768_length_221_cov_71.319672	14	94	85	1	80	0.0125000
NODE_300768_length_221_cov_71.319672	14	94	91	3	80	0.0375000
NODE_300768_length_221_cov_71.319672	14	94	92	1	80	0.0125000
NODE_300768_length_221_cov_71.319672	14	94	93	1	80	0.0125000
NODE_300768_length_221_cov_71.319672	14	94	96	3	80	0.0375000
NODE_300768_length_221_cov_71.319672	14	94	110	1	80	0.0125000
NODE_300768_length_221_cov_71.319672	14	94	113	1	80	0.0125000
NODE_300768_length_221_cov_71.319672	14	94	119	1	80	0.0125000
NODE_300768_length_221_cov_71.319672	14	94	139	3	80	0.0375000
NODE_300768_length_221_cov_71.319672	14	94	143	1	80	0.0125000
NODE_300768_length_221_cov_71.319672	14	94	152	1	80	0.0125000
NODE_300768_length_221_cov_71.319672	14	94	155	2	80	0.0250000
NODE_300768_length_221_cov_71.319672	14	94	160	1	80	0.0125000
NODE_300768_length_221_cov_71.319672	14	94	164	1	80	0.0125000
NODE_300768_length_221_cov_71.319672	14	94	167	1	80	0.0125000
NODE_300768_length_221_cov_71.319672	14	94	169	1	80	0.0125000
NODE_300768_length_221_cov_71.319672	14	94	177	1	80	0.0125000
NODE_300768_length_221_cov_71.319672	14	94	178	1	80	0.0125000
NODE_300768_length_221_cov_71.319672	14	94	181	1	80	0.0125000
NODE_300768_length_221_cov_71.319672	14	94	189	3	80	0.0375000
NODE_300768_length_221_cov_71.319672	14	94	190	3	80	0.0375000
NODE_300768_length_221_cov_71.319672	14	94	192	3	80	0.0375000
NODE_300768_length_221_cov_71.319672	14	94	193	1	80	0.0125000
NODE_300768_length_221_cov_71.319672	14	94	198	4	80	0.0500000
NODE_300768_length_221_cov_71.319672	14	94	200	1	80	0.0125000
NODE_300768_length_221_cov_71.319672	14	94	203	3	80	0.0375000
NODE_300768_length_221_cov_71.319672	14	94	204	1	80	0.0125000
NODE_300768_length_221_cov_71.319672	14	94	206	2	80	0.0250000
NODE_300768_length_221_cov_71.319672	14	94	207	2	80	0.0250000
NODE_300768_length_221_cov_71.319672	14	94	212	5	80	0.0625000
NODE_300768_length_221_cov_71.319672	14	94	226	22	80	0.2750000
NODE_300800_length_220_cov_42.206612	3	74	7	1	71	0.0140845
NODE_300800_length_220_cov_42.206612	3	74	11	2	71	0.0281690
NODE_300800_length_220_cov_42.206612	3	74	31	6	71	0.0845070
NODE_300800_length_220_cov_42.206612	3	74	35	3	71	0.0422535
NODE_300800_length_220_cov_42.206612	3	74	39	1	71	0.0140845
NODE_300800_length_220_cov_42.206612	3	74	51	2	71	0.0281690
NODE_300800_length_220_cov_42.206612	3	74	57	7	71	0.0985916
NODE_300800_length_220_cov_42.206612	3	74	59	1	71	0.0140845
NODE_300800_length_220_cov_42.206612	3	74	60	7	71	0.0985916
NODE_300800_length_220_cov_42.206612	3	74	62	9	71	0.1267606
NODE_300800_length_220_cov_42.206612	3	74	66	1	71	0.0140845
NODE_300800_length_220_cov_42.206612	3	74	68	3	71	0.0422535
NODE_300800_length_220_cov_42.206612	3	74	70	1	71	0.0140845
NODE_300800_length_220_cov_42.206612	3	74	86	4	71	0.0563380
NODE_300800_length_220_cov_42.206612	3	74	87	4	71	0.0563380
NODE_300800_length_220_cov_42.206612	3	74	95	1	71	0.0140845
NODE_300800_length_220_cov_42.206612	3	74	98	18	71	0.2535211
NODE_300800_length_220_cov_42.206612	8	74	31	4	66	0.0606061
NODE_300800_length_220_cov_42.206612	8	74	35	3	66	0.0454545
NODE_300800_length_220_cov_42.206612	8	74	39	1	66	0.0151515
NODE_300800_length_220_cov_42.206612	8	74	51	2	66	0.0303030
NODE_300800_length_220_cov_42.206612	8	74	57	7	66	0.1060606
NODE_300800_length_220_cov_42.206612	8	74	59	1	66	0.0151515
NODE_300800_length_220_cov_42.206612	8	74	60	7	66	0.1060606
NODE_300800_length_220_cov_42.206612	8	74	62	9	66	0.1363636
NODE_300800_length_220_cov_42.206612	8	74	66	1	66	0.0151515
NODE_300800_length_220_cov_42.206612	8	74	68	3	66	0.0454545
NODE_300800_length_220_cov_42.206612	8	74	70	1	66	0.0151515
NODE_300800_length_220_cov_42.206612	8	74	86	4	66	0.0606061
NODE_300800_length_220_cov_42.206612	8	74	87	4	66	0.0606061
NODE_300800_length_220_cov_42.206612	8	74	95	1	66	0.0151515
NODE_300800_length_220_cov_42.206612	8	74	98	18	66	0.2727273
NODE_300800_length_220_cov_42.206612	47	98	86	4	51	0.0784314
NODE_300800_length_220_cov_42.206612	47	98	87	4	51	0.0784314
NODE_300800_length_220_cov_42.206612	47	98	95	1	51	0.0196078
NODE_300800_length_220_cov_42.206612	47	98	98	42	51	0.8235294
NODE_300800_length_220_cov_42.206612	47	98	86	4	51	0.0784314
NODE_300800_length_220_cov_42.206612	47	98	87	4	51	0.0784314
NODE_300800_length_220_cov_42.206612	47	98	95	1	51	0.0196078
NODE_300800_length_220_cov_42.206612	47	98	98	42	51	0.8235294
NODE_300800_length_220_cov_42.206612	47	98	86	4	51	0.0784314
NODE_300800_length_220_cov_42.206612	47	98	87	4	51	0.0784314
NODE_300800_length_220_cov_42.206612	47	98	95	1	51	0.0196078
NODE_300800_length_220_cov_42.206612	47	98	98	42	51	0.8235294
NODE_300874_length_218_cov_244.773109	128	203	5	2	75	0.0266667
NODE_300874_length_218_cov_244.773109	128	203	9	12	75	0.1600000
NODE_300874_length_218_cov_244.773109	128	203	10	2	75	0.0266667
NODE_300874_length_218_cov_244.773109	128	203	13	3	75	0.0400000
NODE_300874_length_218_cov_244.773109	128	203	17	4	75	0.0533333
NODE_300874_length_218_cov_244.773109	128	203	21	1	75	0.0133333
NODE_300874_length_218_cov_244.773109	128	203	22	2	75	0.0266667
NODE_300874_length_218_cov_244.773109	128	203	24	2	75	0.0266667
NODE_300874_length_218_cov_244.773109	128	203	26	5	75	0.0666667
NODE_300874_length_218_cov_244.773109	128	203	28	2	75	0.0266667
NODE_300874_length_218_cov_244.773109	128	203	32	2	75	0.0266667
NODE_300874_length_218_cov_244.773109	128	203	34	1	75	0.0133333
NODE_300874_length_218_cov_244.773109	128	203	36	4	75	0.0533333
NODE_300874_length_218_cov_244.773109	128	203	38	7	75	0.0933333
NODE_300874_length_218_cov_244.773109	128	203	40	1	75	0.0133333
NODE_300874_length_218_cov_244.773109	128	203	41	5	75	0.0666667
NODE_300874_length_218_cov_244.773109	128	203	42	6	75	0.0800000
NODE_300874_length_218_cov_244.773109	128	203	44	1	75	0.0133333
NODE_300874_length_218_cov_244.773109	128	203	45	2	75	0.0266667
NODE_300874_length_218_cov_244.773109	128	203	47	2	75	0.0266667
NODE_300874_length_218_cov_244.773109	128	203	49	2	75	0.0266667
NODE_300874_length_218_cov_244.773109	128	203	53	7	75	0.0933333
NODE_300874_length_218_cov_244.773109	176	218	0	1	42	0.0238095
NODE_300874_length_218_cov_244.773109	176	218	3	12	42	0.2857143
NODE_300874_length_218_cov_244.773109	176	218	5	4	42	0.0952381
NODE_300874_length_218_cov_244.773109	176	218	9	12	42	0.2857143
NODE_300874_length_218_cov_244.773109	176	218	10	2	42	0.0476190
NODE_300874_length_218_cov_244.773109	176	218	13	3	42	0.0714286
NODE_300874_length_218_cov_244.773109	176	218	17	4	42	0.0952381
NODE_300874_length_218_cov_244.773109	176	218	21	1	42	0.0238095
NODE_300874_length_218_cov_244.773109	176	218	22	2	42	0.0476190
NODE_300874_length_218_cov_244.773109	176	218	24	1	42	0.0238095
NODE_300915_length_217_cov_2.144068	14	49	0	35	35	1.0000000
NODE_300915_length_217_cov_2.144068	132	167	0	35	35	1.0000000
NODE_300924_length_216_cov_215.410256	0	63	0	34	63	0.5396826
NODE_300924_length_216_cov_215.410256	0	63	2	29	63	0.4603175
NODE_300924_length_216_cov_215.410256	36	102	2	66	66	1.0000000
NODE_300925_length_216_cov_51.940171	164	216	0	5	52	0.0961538
NODE_300925_length_216_cov_51.940171	164	216	6	47	52	0.9038461
NODE_300953_length_215_cov_14.784483	0	50	0	50	50	1.0000000
NODE_300953_length_215_cov_14.784483	23	103	0	80	80	1.0000000
NODE_300984_length_214_cov_144.165217	0	62	0	62	62	1.0000000
NODE_300984_length_214_cov_144.165217	0	62	0	62	62	1.0000000
NODE_300984_length_214_cov_144.165217	35	115	0	80	80	1.0000000
NODE_300984_length_214_cov_144.165217	35	115	0	80	80	1.0000000
NODE_300984_length_214_cov_144.165217	35	115	0	80	80	1.0000000
NODE_300984_length_214_cov_144.165217	111	191	0	80	80	1.0000000
NODE_300984_length_214_cov_144.165217	111	191	0	80	80	1.0000000
NODE_300984_length_214_cov_144.165217	111	191	0	80	80	1.0000000
NODE_300984_length_214_cov_144.165217	164	214	0	50	50	1.0000000
NODE_300984_length_214_cov_144.165217	164	214	0	50	50	1.0000000
NODE_300984_length_214_cov_144.165217	164	214	0	50	50	1.0000000
NODE_301068_length_211_cov_39.571429	4	84	0	80	80	1.0000000
NODE_301169_length_208_cov_45.238532	3	59	0	21	56	0.3750000
NODE_301169_length_208_cov_45.238532	3	59	3	14	56	0.2500000
NODE_301169_length_208_cov_45.238532	3	59	7	6	56	0.1071429
NODE_301169_length_208_cov_45.238532	3	59	9	15	56	0.2678571
NODE_301169_length_208_cov_45.238532	35	112	3	3	77	0.0389610
NODE_301169_length_208_cov_45.238532	35	112	7	6	77	0.0779221
NODE_301169_length_208_cov_45.238532	35	112	9	68	77	0.8831169
NODE_301170_length_208_cov_35.229358	76	156	5	75	80	0.9375000
NODE_301170_length_208_cov_35.229358	76	156	6	5	80	0.0625000
NODE_301179_length_207_cov_341.324074	33	113	0	80	80	1.0000000
NODE_301179_length_207_cov_341.324074	86	166	0	80	80	1.0000000
NODE_301248_length_205_cov_64.179245	6	77	0	2	71	0.0281690
NODE_301248_length_205_cov_64.179245	6	77	6	10	71	0.1408451
NODE_301248_length_205_cov_64.179245	6	77	9	21	71	0.2957746
NODE_301248_length_205_cov_64.179245	6	77	11	4	71	0.0563380
NODE_301248_length_205_cov_64.179245	6	77	17	5	71	0.0704225
NODE_301248_length_205_cov_64.179245	6	77	21	7	71	0.0985916
NODE_301248_length_205_cov_64.179245	6	77	23	3	71	0.0422535
NODE_301248_length_205_cov_64.179245	6	77	29	9	71	0.1267606
NODE_301248_length_205_cov_64.179245	6	77	30	1	71	0.0140845
NODE_301248_length_205_cov_64.179245	6	77	32	3	71	0.0422535
NODE_301248_length_205_cov_64.179245	6	77	34	1	71	0.0140845
NODE_301248_length_205_cov_64.179245	6	77	37	5	71	0.0704225
NODE_301248_length_205_cov_64.179245	11	77	6	7	66	0.1060606
NODE_301248_length_205_cov_64.179245	11	77	9	21	66	0.3181818
NODE_301248_length_205_cov_64.179245	11	77	11	4	66	0.0606061
NODE_301248_length_205_cov_64.179245	11	77	17	5	66	0.0757576
NODE_301248_length_205_cov_64.179245	11	77	21	7	66	0.1060606
NODE_301248_length_205_cov_64.179245	11	77	23	3	66	0.0454545
NODE_301248_length_205_cov_64.179245	11	77	29	9	66	0.1363636
NODE_301248_length_205_cov_64.179245	11	77	30	1	66	0.0151515
NODE_301248_length_205_cov_64.179245	11	77	32	3	66	0.0454545
NODE_301248_length_205_cov_64.179245	11	77	34	1	66	0.0151515
NODE_301248_length_205_cov_64.179245	11	77	37	5	66	0.0757576
NODE_301248_length_205_cov_64.179245	50	98	21	5	48	0.1041667
NODE_301248_length_205_cov_64.179245	50	98	23	3	48	0.0625000
NODE_301248_length_205_cov_64.179245	50	98	29	9	48	0.1875000
NODE_301248_length_205_cov_64.179245	50	98	30	1	48	0.0208333
NODE_301248_length_205_cov_64.179245	50	98	32	3	48	0.0625000
NODE_301248_length_205_cov_64.179245	50	98	34	1	48	0.0208333
NODE_301248_length_205_cov_64.179245	50	98	37	9	48	0.1875000
NODE_301248_length_205_cov_64.179245	50	98	39	4	48	0.0833333
NODE_301248_length_205_cov_64.179245	50	98	41	13	48	0.2708333
NODE_301248_length_205_cov_64.179245	50	98	21	5	48	0.1041667
NODE_301248_length_205_cov_64.179245	50	98	23	3	48	0.0625000
NODE_301248_length_205_cov_64.179245	50	98	29	9	48	0.1875000
NODE_301248_length_205_cov_64.179245	50	98	30	1	48	0.0208333
NODE_301248_length_205_cov_64.179245	50	98	32	3	48	0.0625000
NODE_301248_length_205_cov_64.179245	50	98	34	1	48	0.0208333
NODE_301248_length_205_cov_64.179245	50	98	37	9	48	0.1875000
NODE_301248_length_205_cov_64.179245	50	98	39	4	48	0.0833333
NODE_301248_length_205_cov_64.179245	50	98	41	13	48	0.2708333
NODE_301248_length_205_cov_64.179245	50	98	21	5	48	0.1041667
NODE_301248_length_205_cov_64.179245	50	98	23	3	48	0.0625000
NODE_301248_length_205_cov_64.179245	50	98	29	9	48	0.1875000
NODE_301248_length_205_cov_64.179245	50	98	30	1	48	0.0208333
NODE_301248_length_205_cov_64.179245	50	98	32	3	48	0.0625000
NODE_301248_length_205_cov_64.179245	50	98	34	1	48	0.0208333
NODE_301248_length_205_cov_64.179245	50	98	37	9	48	0.1875000
NODE_301248_length_205_cov_64.179245	50	98	39	4	48	0.0833333
NODE_301248_length_205_cov_64.179245	50	98	41	13	48	0.2708333
NODE_301281_length_204_cov_183.390476	119	199	8	1	80	0.0125000
NODE_301281_length_204_cov_183.390476	119	199	12	1	80	0.0125000
NODE_301281_length_204_cov_183.390476	119	199	16	2	80	0.0250000
NODE_301281_length_204_cov_183.390476	119	199	22	2	80	0.0250000
NODE_301281_length_204_cov_183.390476	119	199	23	2	80	0.0250000
NODE_301281_length_204_cov_183.390476	119	199	27	3	80	0.0375000
NODE_301281_length_204_cov_183.390476	119	199	39	17	80	0.2125000
NODE_301281_length_204_cov_183.390476	119	199	44	6	80	0.0750000
NODE_301281_length_204_cov_183.390476	119	199	49	11	80	0.1375000
NODE_301281_length_204_cov_183.390476	119	199	51	6	80	0.0750000
NODE_301281_length_204_cov_183.390476	119	199	53	7	80	0.0875000
NODE_301281_length_204_cov_183.390476	119	199	55	9	80	0.1125000
NODE_301281_length_204_cov_183.390476	119	199	56	13	80	0.1625000
NODE_301281_length_204_cov_183.390476	172	194	22	1	22	0.0454545
NODE_301281_length_204_cov_183.390476	172	194	23	2	22	0.0909091
NODE_301281_length_204_cov_183.390476	172	194	27	3	22	0.1363636
NODE_301281_length_204_cov_183.390476	172	194	39	16	22	0.7272727
NODE_301283_length_204_cov_80.095238	10	90	0	80	80	1.0000000
NODE_301283_length_204_cov_80.095238	63	143	0	80	80	1.0000000
NODE_301345_length_202_cov_123.184466	0	64	5	1	64	0.0156250
NODE_301345_length_202_cov_123.184466	0	64	18	3	64	0.0468750
NODE_301345_length_202_cov_123.184466	0	64	20	1	64	0.0156250
NODE_301345_length_202_cov_123.184466	0	64	32	4	64	0.0625000
NODE_301345_length_202_cov_123.184466	0	64	34	1	64	0.0156250
NODE_301345_length_202_cov_123.184466	0	64	37	1	64	0.0156250
NODE_301345_length_202_cov_123.184466	0	64	39	1	64	0.0156250
NODE_301345_length_202_cov_123.184466	0	64	41	1	64	0.0156250
NODE_301345_length_202_cov_123.184466	0	64	45	1	64	0.0156250
NODE_301345_length_202_cov_123.184466	0	64	49	2	64	0.0312500
NODE_301345_length_202_cov_123.184466	0	64	53	2	64	0.0312500
NODE_301345_length_202_cov_123.184466	0	64	63	2	64	0.0312500
NODE_301345_length_202_cov_123.184466	0	64	65	1	64	0.0156250
NODE_301345_length_202_cov_123.184466	0	64	69	2	64	0.0312500
NODE_301345_length_202_cov_123.184466	0	64	70	1	64	0.0156250
NODE_301345_length_202_cov_123.184466	0	64	72	1	64	0.0156250
NODE_301345_length_202_cov_123.184466	0	64	76	1	64	0.0156250
NODE_301345_length_202_cov_123.184466	0	64	78	1	64	0.0156250
NODE_301345_length_202_cov_123.184466	0	64	80	2	64	0.0312500
NODE_301345_length_202_cov_123.184466	0	64	86	1	64	0.0156250
NODE_301345_length_202_cov_123.184466	0	64	90	1	64	0.0156250
NODE_301345_length_202_cov_123.184466	0	64	94	1	64	0.0156250
NODE_301345_length_202_cov_123.184466	0	64	100	4	64	0.0625000
NODE_301345_length_202_cov_123.184466	0	64	104	1	64	0.0156250
NODE_301345_length_202_cov_123.184466	0	64	110	1	64	0.0156250
NODE_301345_length_202_cov_123.184466	0	64	112	1	64	0.0156250
NODE_301345_length_202_cov_123.184466	0	64	114	1	64	0.0156250
NODE_301345_length_202_cov_123.184466	0	64	115	1	64	0.0156250
NODE_301345_length_202_cov_123.184466	0	64	120	2	64	0.0312500
NODE_301345_length_202_cov_123.184466	0	64	122	1	64	0.0156250
NODE_301345_length_202_cov_123.184466	0	64	124	2	64	0.0312500
NODE_301345_length_202_cov_123.184466	0	64	126	1	64	0.0156250
NODE_301345_length_202_cov_123.184466	0	64	131	1	64	0.0156250
NODE_301345_length_202_cov_123.184466	0	64	140	1	64	0.0156250
NODE_301345_length_202_cov_123.184466	0	64	144	1	64	0.0156250
NODE_301345_length_202_cov_123.184466	0	64	149	2	64	0.0312500
NODE_301345_length_202_cov_123.184466	0	64	159	1	64	0.0156250
NODE_301345_length_202_cov_123.184466	0	64	168	1	64	0.0156250
NODE_301345_length_202_cov_123.184466	0	64	169	1	64	0.0156250
NODE_301345_length_202_cov_123.184466	0	64	171	2	64	0.0312500
NODE_301345_length_202_cov_123.184466	0	64	173	1	64	0.0156250
NODE_301345_length_202_cov_123.184466	0	64	183	3	64	0.0468750
NODE_301345_length_202_cov_123.184466	0	64	187	1	64	0.0156250
NODE_301345_length_202_cov_123.184466	0	64	191	1	64	0.0156250
NODE_301345_length_202_cov_123.184466	0	64	193	1	64	0.0156250
NODE_301345_length_202_cov_123.184466	31	72	94	1	41	0.0243902
NODE_301345_length_202_cov_123.184466	31	72	100	4	41	0.0975610
NODE_301345_length_202_cov_123.184466	31	72	104	1	41	0.0243902
NODE_301345_length_202_cov_123.184466	31	72	110	1	41	0.0243902
NODE_301345_length_202_cov_123.184466	31	72	112	1	41	0.0243902
NODE_301345_length_202_cov_123.184466	31	72	114	1	41	0.0243902
NODE_301345_length_202_cov_123.184466	31	72	115	1	41	0.0243902
NODE_301345_length_202_cov_123.184466	31	72	120	2	41	0.0487805
NODE_301345_length_202_cov_123.184466	31	72	122	1	41	0.0243902
NODE_301345_length_202_cov_123.184466	31	72	124	2	41	0.0487805
NODE_301345_length_202_cov_123.184466	31	72	126	1	41	0.0243902
NODE_301345_length_202_cov_123.184466	31	72	131	1	41	0.0243902
NODE_301345_length_202_cov_123.184466	31	72	140	1	41	0.0243902
NODE_301345_length_202_cov_123.184466	31	72	144	1	41	0.0243902
NODE_301345_length_202_cov_123.184466	31	72	149	2	41	0.0487805
NODE_301345_length_202_cov_123.184466	31	72	159	1	41	0.0243902
NODE_301345_length_202_cov_123.184466	31	72	168	1	41	0.0243902
NODE_301345_length_202_cov_123.184466	31	72	169	1	41	0.0243902
NODE_301345_length_202_cov_123.184466	31	72	171	2	41	0.0487805
NODE_301345_length_202_cov_123.184466	31	72	173	1	41	0.0243902
NODE_301345_length_202_cov_123.184466	31	72	183	3	41	0.0731707
NODE_301345_length_202_cov_123.184466	31	72	187	1	41	0.0243902
NODE_301345_length_202_cov_123.184466	31	72	191	1	41	0.0243902
NODE_301345_length_202_cov_123.184466	31	72	193	2	41	0.0487805
NODE_301345_length_202_cov_123.184466	31	72	197	1	41	0.0243902
NODE_301345_length_202_cov_123.184466	31	72	199	1	41	0.0243902
NODE_301345_length_202_cov_123.184466	31	72	203	1	41	0.0243902
NODE_301345_length_202_cov_123.184466	31	72	205	1	41	0.0243902
NODE_301345_length_202_cov_123.184466	31	72	211	3	41	0.0731707
NODE_301370_length_201_cov_56.323529	133	201	0	5	68	0.0735294
NODE_301370_length_201_cov_56.323529	133	201	2	11	68	0.1617647
NODE_301370_length_201_cov_56.323529	133	201	4	2	68	0.0294118
NODE_301370_length_201_cov_56.323529	133	201	6	10	68	0.1470588
NODE_301370_length_201_cov_56.323529	133	201	8	7	68	0.1029412
NODE_301370_length_201_cov_56.323529	133	201	10	33	68	0.4852941
NODE_301371_length_201_cov_50.647059	44	99	26	5	55	0.0909091
NODE_301371_length_201_cov_50.647059	44	99	33	1	55	0.0181818
NODE_301371_length_201_cov_50.647059	44	99	37	3	55	0.0545455
NODE_301371_length_201_cov_50.647059	44	99	39	6	55	0.1090909
NODE_301371_length_201_cov_50.647059	44	99	43	1	55	0.0181818
NODE_301371_length_201_cov_50.647059	44	99	45	5	55	0.0909091
NODE_301371_length_201_cov_50.647059	44	99	47	2	55	0.0363636
NODE_301371_length_201_cov_50.647059	44	99	48	18	55	0.3272727
NODE_301371_length_201_cov_50.647059	44	99	52	14	55	0.2545455
NODE_301371_length_201_cov_50.647059	136	201	0	1	65	0.0153846
NODE_301371_length_201_cov_50.647059	136	201	2	1	65	0.0153846
NODE_301371_length_201_cov_50.647059	136	201	9	1	65	0.0153846
NODE_301371_length_201_cov_50.647059	136	201	11	6	65	0.0923077
NODE_301371_length_201_cov_50.647059	136	201	15	3	65	0.0461538
NODE_301371_length_201_cov_50.647059	136	201	17	5	65	0.0769231
NODE_301371_length_201_cov_50.647059	136	201	19	1	65	0.0153846
NODE_301371_length_201_cov_50.647059	136	201	21	2	65	0.0307692
NODE_301371_length_201_cov_50.647059	136	201	23	1	65	0.0153846
NODE_301371_length_201_cov_50.647059	136	201	24	1	65	0.0153846
NODE_301371_length_201_cov_50.647059	136	201	33	4	65	0.0615385
NODE_301371_length_201_cov_50.647059	136	201	34	9	65	0.1384615
NODE_301371_length_201_cov_50.647059	136	201	36	30	65	0.4615385
NODE_301371_length_201_cov_50.647059	136	201	0	1	65	0.0153846
NODE_301371_length_201_cov_50.647059	136	201	2	1	65	0.0153846
NODE_301371_length_201_cov_50.647059	136	201	9	1	65	0.0153846
NODE_301371_length_201_cov_50.647059	136	201	11	6	65	0.0923077
NODE_301371_length_201_cov_50.647059	136	201	15	3	65	0.0461538
NODE_301371_length_201_cov_50.647059	136	201	17	5	65	0.0769231
NODE_301371_length_201_cov_50.647059	136	201	19	1	65	0.0153846
NODE_301371_length_201_cov_50.647059	136	201	21	2	65	0.0307692
NODE_301371_length_201_cov_50.647059	136	201	23	1	65	0.0153846
NODE_301371_length_201_cov_50.647059	136	201	24	1	65	0.0153846
NODE_301371_length_201_cov_50.647059	136	201	33	4	65	0.0615385
NODE_301371_length_201_cov_50.647059	136	201	34	9	65	0.1384615
NODE_301371_length_201_cov_50.647059	136	201	36	30	65	0.4615385
NODE_301371_length_201_cov_50.647059	136	201	0	1	65	0.0153846
NODE_301371_length_201_cov_50.647059	136	201	2	1	65	0.0153846
NODE_301371_length_201_cov_50.647059	136	201	9	1	65	0.0153846
NODE_301371_length_201_cov_50.647059	136	201	11	6	65	0.0923077
NODE_301371_length_201_cov_50.647059	136	201	15	3	65	0.0461538
NODE_301371_length_201_cov_50.647059	136	201	17	5	65	0.0769231
NODE_301371_length_201_cov_50.647059	136	201	19	1	65	0.0153846
NODE_301371_length_201_cov_50.647059	136	201	21	2	65	0.0307692
NODE_301371_length_201_cov_50.647059	136	201	23	1	65	0.0153846
NODE_301371_length_201_cov_50.647059	136	201	24	1	65	0.0153846
NODE_301371_length_201_cov_50.647059	136	201	33	4	65	0.0615385
NODE_301371_length_201_cov_50.647059	136	201	34	9	65	0.1384615
NODE_301371_length_201_cov_50.647059	136	201	36	30	65	0.4615385
NODE_301371_length_201_cov_50.647059	136	201	0	1	65	0.0153846
NODE_301371_length_201_cov_50.647059	136	201	2	1	65	0.0153846
NODE_301371_length_201_cov_50.647059	136	201	9	1	65	0.0153846
NODE_301371_length_201_cov_50.647059	136	201	11	6	65	0.0923077
NODE_301371_length_201_cov_50.647059	136	201	15	3	65	0.0461538
NODE_301371_length_201_cov_50.647059	136	201	17	5	65	0.0769231
NODE_301371_length_201_cov_50.647059	136	201	19	1	65	0.0153846
NODE_301371_length_201_cov_50.647059	136	201	21	2	65	0.0307692
NODE_301371_length_201_cov_50.647059	136	201	23	1	65	0.0153846
NODE_301371_length_201_cov_50.647059	136	201	24	1	65	0.0153846
NODE_301371_length_201_cov_50.647059	136	201	33	4	65	0.0615385
NODE_301371_length_201_cov_50.647059	136	201	34	9	65	0.1384615
NODE_301371_length_201_cov_50.647059	136	201	36	30	65	0.4615385
NODE_301405_length_200_cov_29.118812	0	73	2	2	73	0.0273973
NODE_301405_length_200_cov_29.118812	0	73	10	2	73	0.0273973
NODE_301405_length_200_cov_29.118812	0	73	14	5	73	0.0684932
NODE_301405_length_200_cov_29.118812	0	73	20	1	73	0.0136986
NODE_301405_length_200_cov_29.118812	0	73	22	4	73	0.0547945
NODE_301405_length_200_cov_29.118812	0	73	24	3	73	0.0410959
NODE_301405_length_200_cov_29.118812	0	73	34	1	73	0.0136986
NODE_301405_length_200_cov_29.118812	0	73	36	5	73	0.0684932
NODE_301405_length_200_cov_29.118812	0	73	38	2	73	0.0273973
NODE_301405_length_200_cov_29.118812	0	73	40	1	73	0.0136986
NODE_301405_length_200_cov_29.118812	0	73	44	5	73	0.0684932
NODE_301405_length_200_cov_29.118812	0	73	46	5	73	0.0684932
NODE_301405_length_200_cov_29.118812	0	73	48	9	73	0.1232877
NODE_301405_length_200_cov_29.118812	0	73	50	5	73	0.0684932
NODE_301405_length_200_cov_29.118812	0	73	52	3	73	0.0410959
NODE_301405_length_200_cov_29.118812	0	73	54	7	73	0.0958904
NODE_301405_length_200_cov_29.118812	0	73	56	3	73	0.0410959
NODE_301405_length_200_cov_29.118812	0	73	58	10	73	0.1369863
NODE_301419_length_199_cov_768.700000	94	142	237	8	48	0.1666667
NODE_301419_length_199_cov_768.700000	94	142	239	2	48	0.0416667
NODE_301419_length_199_cov_768.700000	94	142	241	8	48	0.1666667
NODE_301419_length_199_cov_768.700000	94	142	243	1	48	0.0208333
NODE_301419_length_199_cov_768.700000	94	142	245	12	48	0.2500000
NODE_301419_length_199_cov_768.700000	94	142	247	2	48	0.0416667
NODE_301419_length_199_cov_768.700000	94	142	249	15	48	0.3125000
NODE_301419_length_199_cov_768.700000	115	186	80	1	71	0.0140845
NODE_301419_length_199_cov_768.700000	115	186	87	1	71	0.0140845
NODE_301419_length_199_cov_768.700000	115	186	95	1	71	0.0140845
NODE_301419_length_199_cov_768.700000	115	186	99	2	71	0.0281690
NODE_301419_length_199_cov_768.700000	115	186	105	1	71	0.0140845
NODE_301419_length_199_cov_768.700000	115	186	107	1	71	0.0140845
NODE_301419_length_199_cov_768.700000	115	186	115	1	71	0.0140845
NODE_301419_length_199_cov_768.700000	115	186	123	1	71	0.0140845
NODE_301419_length_199_cov_768.700000	115	186	137	2	71	0.0281690
NODE_301419_length_199_cov_768.700000	115	186	139	1	71	0.0140845
NODE_301419_length_199_cov_768.700000	115	186	146	1	71	0.0140845
NODE_301419_length_199_cov_768.700000	115	186	152	1	71	0.0140845
NODE_301419_length_199_cov_768.700000	115	186	154	1	71	0.0140845
NODE_301419_length_199_cov_768.700000	115	186	157	1	71	0.0140845
NODE_301419_length_199_cov_768.700000	115	186	158	2	71	0.0281690
NODE_301419_length_199_cov_768.700000	115	186	162	1	71	0.0140845
NODE_301419_length_199_cov_768.700000	115	186	168	1	71	0.0140845
NODE_301419_length_199_cov_768.700000	115	186	170	1	71	0.0140845
NODE_301419_length_199_cov_768.700000	115	186	174	1	71	0.0140845
NODE_301419_length_199_cov_768.700000	115	186	180	1	71	0.0140845
NODE_301419_length_199_cov_768.700000	115	186	186	1	71	0.0140845
NODE_301419_length_199_cov_768.700000	115	186	187	2	71	0.0281690
NODE_301419_length_199_cov_768.700000	115	186	191	2	71	0.0281690
NODE_301419_length_199_cov_768.700000	115	186	197	1	71	0.0140845
NODE_301419_length_199_cov_768.700000	115	186	201	2	71	0.0281690
NODE_301419_length_199_cov_768.700000	115	186	209	1	71	0.0140845
NODE_301419_length_199_cov_768.700000	115	186	213	3	71	0.0422535
NODE_301419_length_199_cov_768.700000	115	186	215	1	71	0.0140845
NODE_301419_length_199_cov_768.700000	115	186	221	1	71	0.0140845
NODE_301419_length_199_cov_768.700000	115	186	223	2	71	0.0281690
NODE_301419_length_199_cov_768.700000	115	186	231	1	71	0.0140845
NODE_301419_length_199_cov_768.700000	115	186	233	1	71	0.0140845
NODE_301419_length_199_cov_768.700000	115	186	237	11	71	0.1549296
NODE_301419_length_199_cov_768.700000	115	186	239	2	71	0.0281690
NODE_301419_length_199_cov_768.700000	115	186	241	8	71	0.1126761
NODE_301419_length_199_cov_768.700000	115	186	243	1	71	0.0140845
NODE_301419_length_199_cov_768.700000	115	186	245	8	71	0.1126761
NODE_301420_length_199_cov_702.860000	3	78	53	1	75	0.0133333
NODE_301420_length_199_cov_702.860000	3	78	59	2	75	0.0266667
NODE_301420_length_199_cov_702.860000	3	78	63	3	75	0.0400000
NODE_301420_length_199_cov_702.860000	3	78	78	1	75	0.0133333
NODE_301420_length_199_cov_702.860000	3	78	80	2	75	0.0266667
NODE_301420_length_199_cov_702.860000	3	78	81	1	75	0.0133333
NODE_301420_length_199_cov_702.860000	3	78	87	1	75	0.0133333
NODE_301420_length_199_cov_702.860000	3	78	92	1	75	0.0133333
NODE_301420_length_199_cov_702.860000	3	78	96	1	75	0.0133333
NODE_301420_length_199_cov_702.860000	3	78	99	1	75	0.0133333
NODE_301420_length_199_cov_702.860000	3	78	122	1	75	0.0133333
NODE_301420_length_199_cov_702.860000	3	78	129	1	75	0.0133333
NODE_301420_length_199_cov_702.860000	3	78	130	1	75	0.0133333
NODE_301420_length_199_cov_702.860000	3	78	132	1	75	0.0133333
NODE_301420_length_199_cov_702.860000	3	78	152	1	75	0.0133333
NODE_301420_length_199_cov_702.860000	3	78	171	2	75	0.0266667
NODE_301420_length_199_cov_702.860000	3	78	174	1	75	0.0133333
NODE_301420_length_199_cov_702.860000	3	78	175	1	75	0.0133333
NODE_301420_length_199_cov_702.860000	3	78	195	1	75	0.0133333
NODE_301420_length_199_cov_702.860000	3	78	205	1	75	0.0133333
NODE_301420_length_199_cov_702.860000	3	78	218	1	75	0.0133333
NODE_301420_length_199_cov_702.860000	3	78	223	1	75	0.0133333
NODE_301420_length_199_cov_702.860000	3	78	248	1	75	0.0133333
NODE_301420_length_199_cov_702.860000	3	78	253	1	75	0.0133333
NODE_301420_length_199_cov_702.860000	3	78	257	1	75	0.0133333
NODE_301420_length_199_cov_702.860000	3	78	276	2	75	0.0266667
NODE_301420_length_199_cov_702.860000	3	78	277	1	75	0.0133333
NODE_301420_length_199_cov_702.860000	3	78	281	1	75	0.0133333
NODE_301420_length_199_cov_702.860000	3	78	288	1	75	0.0133333
NODE_301420_length_199_cov_702.860000	3	78	310	1	75	0.0133333
NODE_301420_length_199_cov_702.860000	3	78	318	1	75	0.0133333
NODE_301420_length_199_cov_702.860000	3	78	320	1	75	0.0133333
NODE_301420_length_199_cov_702.860000	3	78	340	1	75	0.0133333
NODE_301420_length_199_cov_702.860000	3	78	350	1	75	0.0133333
NODE_301420_length_199_cov_702.860000	3	78	365	1	75	0.0133333
NODE_301420_length_199_cov_702.860000	3	78	367	1	75	0.0133333
NODE_301420_length_199_cov_702.860000	3	78	373	1	75	0.0133333
NODE_301420_length_199_cov_702.860000	3	78	375	1	75	0.0133333
NODE_301420_length_199_cov_702.860000	3	78	395	1	75	0.0133333
NODE_301420_length_199_cov_702.860000	3	78	415	1	75	0.0133333
NODE_301420_length_199_cov_702.860000	3	78	431	1	75	0.0133333
NODE_301420_length_199_cov_702.860000	3	78	436	2	75	0.0266667
NODE_301420_length_199_cov_702.860000	3	78	442	2	75	0.0266667
NODE_301420_length_199_cov_702.860000	3	78	448	1	75	0.0133333
NODE_301420_length_199_cov_702.860000	3	78	461	1	75	0.0133333
NODE_301420_length_199_cov_702.860000	3	78	465	1	75	0.0133333
NODE_301420_length_199_cov_702.860000	3	78	471	1	75	0.0133333
NODE_301420_length_199_cov_702.860000	3	78	477	1	75	0.0133333
NODE_301420_length_199_cov_702.860000	3	78	479	1	75	0.0133333
NODE_301420_length_199_cov_702.860000	3	78	495	2	75	0.0266667
NODE_301420_length_199_cov_702.860000	3	78	501	5	75	0.0666667
NODE_301420_length_199_cov_702.860000	3	78	505	1	75	0.0133333
NODE_301420_length_199_cov_702.860000	3	78	509	2	75	0.0266667
NODE_301420_length_199_cov_702.860000	3	78	511	1	75	0.0133333
NODE_301420_length_199_cov_702.860000	3	78	515	2	75	0.0266667
NODE_301420_length_199_cov_702.860000	3	78	537	1	75	0.0133333
NODE_301420_length_199_cov_702.860000	3	78	539	4	75	0.0533333
NODE_301420_length_199_cov_702.860000	51	131	393	1	80	0.0125000
NODE_301420_length_199_cov_702.860000	51	131	394	1	80	0.0125000
NODE_301420_length_199_cov_702.860000	51	131	406	1	80	0.0125000
NODE_301420_length_199_cov_702.860000	51	131	412	1	80	0.0125000
NODE_301420_length_199_cov_702.860000	51	131	422	1	80	0.0125000
NODE_301420_length_199_cov_702.860000	51	131	428	1	80	0.0125000
NODE_301420_length_199_cov_702.860000	51	131	429	1	80	0.0125000
NODE_301420_length_199_cov_702.860000	51	131	436	1	80	0.0125000
NODE_301420_length_199_cov_702.860000	51	131	442	2	80	0.0250000
NODE_301420_length_199_cov_702.860000	51	131	448	2	80	0.0250000
NODE_301420_length_199_cov_702.860000	51	131	453	1	80	0.0125000
NODE_301420_length_199_cov_702.860000	51	131	461	1	80	0.0125000
NODE_301420_length_199_cov_702.860000	51	131	463	1	80	0.0125000
NODE_301420_length_199_cov_702.860000	51	131	465	1	80	0.0125000
NODE_301420_length_199_cov_702.860000	51	131	471	1	80	0.0125000
NODE_301420_length_199_cov_702.860000	51	131	473	1	80	0.0125000
NODE_301420_length_199_cov_702.860000	51	131	477	1	80	0.0125000
NODE_301420_length_199_cov_702.860000	51	131	479	1	80	0.0125000
NODE_301420_length_199_cov_702.860000	51	131	488	1	80	0.0125000
NODE_301420_length_199_cov_702.860000	51	131	495	2	80	0.0250000
NODE_301420_length_199_cov_702.860000	51	131	501	5	80	0.0625000
NODE_301420_length_199_cov_702.860000	51	131	505	2	80	0.0250000
NODE_301420_length_199_cov_702.860000	51	131	509	2	80	0.0250000
NODE_301420_length_199_cov_702.860000	51	131	511	1	80	0.0125000
NODE_301420_length_199_cov_702.860000	51	131	512	1	80	0.0125000
NODE_301420_length_199_cov_702.860000	51	131	515	2	80	0.0250000
NODE_301420_length_199_cov_702.860000	51	131	520	1	80	0.0125000
NODE_301420_length_199_cov_702.860000	51	131	529	1	80	0.0125000
NODE_301420_length_199_cov_702.860000	51	131	536	2	80	0.0250000
NODE_301420_length_199_cov_702.860000	51	131	537	1	80	0.0125000
NODE_301420_length_199_cov_702.860000	51	131	539	4	80	0.0500000
NODE_301420_length_199_cov_702.860000	51	131	547	2	80	0.0250000
NODE_301420_length_199_cov_702.860000	51	131	548	1	80	0.0125000
NODE_301420_length_199_cov_702.860000	51	131	550	1	80	0.0125000
NODE_301420_length_199_cov_702.860000	51	131	556	2	80	0.0250000
NODE_301420_length_199_cov_702.860000	51	131	557	1	80	0.0125000
NODE_301420_length_199_cov_702.860000	51	131	558	1	80	0.0125000
NODE_301420_length_199_cov_702.860000	51	131	565	1	80	0.0125000
NODE_301420_length_199_cov_702.860000	51	131	566	4	80	0.0500000
NODE_301420_length_199_cov_702.860000	51	131	574	1	80	0.0125000
NODE_301420_length_199_cov_702.860000	51	131	578	2	80	0.0250000
NODE_301420_length_199_cov_702.860000	51	131	582	1	80	0.0125000
NODE_301420_length_199_cov_702.860000	51	131	584	5	80	0.0625000
NODE_301420_length_199_cov_702.860000	51	131	586	3	80	0.0375000
NODE_301420_length_199_cov_702.860000	51	131	590	4	80	0.0500000
NODE_301420_length_199_cov_702.860000	51	131	592	6	80	0.0750000
NODE_301421_length_199_cov_670.570000	22	52	237	1	30	0.0333333
NODE_301421_length_199_cov_670.570000	22	52	241	1	30	0.0333333
NODE_301421_length_199_cov_670.570000	22	52	273	1	30	0.0333333
NODE_301421_length_199_cov_670.570000	22	52	282	1	30	0.0333333
NODE_301421_length_199_cov_670.570000	22	52	295	1	30	0.0333333
NODE_301421_length_199_cov_670.570000	22	52	303	1	30	0.0333333
NODE_301421_length_199_cov_670.570000	22	52	315	1	30	0.0333333
NODE_301421_length_199_cov_670.570000	22	52	323	1	30	0.0333333
NODE_301421_length_199_cov_670.570000	22	52	327	4	30	0.1333333
NODE_301421_length_199_cov_670.570000	22	52	329	1	30	0.0333333
NODE_301421_length_199_cov_670.570000	22	52	354	1	30	0.0333333
NODE_301421_length_199_cov_670.570000	22	52	364	1	30	0.0333333
NODE_301421_length_199_cov_670.570000	22	52	368	1	30	0.0333333
NODE_301421_length_199_cov_670.570000	22	52	371	1	30	0.0333333
NODE_301421_length_199_cov_670.570000	22	52	375	1	30	0.0333333
NODE_301421_length_199_cov_670.570000	22	52	383	1	30	0.0333333
NODE_301421_length_199_cov_670.570000	22	52	387	1	30	0.0333333
NODE_301421_length_199_cov_670.570000	22	52	388	1	30	0.0333333
NODE_301421_length_199_cov_670.570000	22	52	392	1	30	0.0333333
NODE_301421_length_199_cov_670.570000	22	52	394	1	30	0.0333333
NODE_301421_length_199_cov_670.570000	22	52	397	1	30	0.0333333
NODE_301421_length_199_cov_670.570000	22	52	403	1	30	0.0333333
NODE_301421_length_199_cov_670.570000	22	52	422	1	30	0.0333333
NODE_301421_length_199_cov_670.570000	22	52	426	1	30	0.0333333
NODE_301421_length_199_cov_670.570000	22	52	438	1	30	0.0333333
NODE_301421_length_199_cov_670.570000	22	52	453	1	30	0.0333333
NODE_301421_length_199_cov_670.570000	22	52	456	1	30	0.0333333
NODE_301421_length_199_cov_670.570000	25	105	282	1	80	0.0125000
NODE_301421_length_199_cov_670.570000	25	105	295	1	80	0.0125000
NODE_301421_length_199_cov_670.570000	25	105	303	1	80	0.0125000
NODE_301421_length_199_cov_670.570000	25	105	315	1	80	0.0125000
NODE_301421_length_199_cov_670.570000	25	105	323	1	80	0.0125000
NODE_301421_length_199_cov_670.570000	25	105	327	4	80	0.0500000
NODE_301421_length_199_cov_670.570000	25	105	329	1	80	0.0125000
NODE_301421_length_199_cov_670.570000	25	105	354	1	80	0.0125000
NODE_301421_length_199_cov_670.570000	25	105	364	1	80	0.0125000
NODE_301421_length_199_cov_670.570000	25	105	368	1	80	0.0125000
NODE_301421_length_199_cov_670.570000	25	105	371	1	80	0.0125000
NODE_301421_length_199_cov_670.570000	25	105	375	1	80	0.0125000
NODE_301421_length_199_cov_670.570000	25	105	383	1	80	0.0125000
NODE_301421_length_199_cov_670.570000	25	105	387	1	80	0.0125000
NODE_301421_length_199_cov_670.570000	25	105	388	1	80	0.0125000
NODE_301421_length_199_cov_670.570000	25	105	392	1	80	0.0125000
NODE_301421_length_199_cov_670.570000	25	105	394	1	80	0.0125000
NODE_301421_length_199_cov_670.570000	25	105	397	1	80	0.0125000
NODE_301421_length_199_cov_670.570000	25	105	403	1	80	0.0125000
NODE_301421_length_199_cov_670.570000	25	105	422	1	80	0.0125000
NODE_301421_length_199_cov_670.570000	25	105	426	1	80	0.0125000
NODE_301421_length_199_cov_670.570000	25	105	438	1	80	0.0125000
NODE_301421_length_199_cov_670.570000	25	105	453	1	80	0.0125000
NODE_301421_length_199_cov_670.570000	25	105	456	1	80	0.0125000
NODE_301421_length_199_cov_670.570000	25	105	485	1	80	0.0125000
NODE_301421_length_199_cov_670.570000	25	105	486	1	80	0.0125000
NODE_301421_length_199_cov_670.570000	25	105	495	1	80	0.0125000
NODE_301421_length_199_cov_670.570000	25	105	497	1	80	0.0125000
NODE_301421_length_199_cov_670.570000	25	105	500	1	80	0.0125000
NODE_301421_length_199_cov_670.570000	25	105	502	1	80	0.0125000
NODE_301421_length_199_cov_670.570000	25	105	504	2	80	0.0250000
NODE_301421_length_199_cov_670.570000	25	105	508	1	80	0.0125000
NODE_301421_length_199_cov_670.570000	25	105	514	1	80	0.0125000
NODE_301421_length_199_cov_670.570000	25	105	518	1	80	0.0125000
NODE_301421_length_199_cov_670.570000	25	105	519	4	80	0.0500000
NODE_301421_length_199_cov_670.570000	25	105	521	1	80	0.0125000
NODE_301421_length_199_cov_670.570000	25	105	525	1	80	0.0125000
NODE_301421_length_199_cov_670.570000	25	105	527	1	80	0.0125000
NODE_301421_length_199_cov_670.570000	25	105	529	1	80	0.0125000
NODE_301421_length_199_cov_670.570000	25	105	531	3	80	0.0375000
NODE_301421_length_199_cov_670.570000	25	105	535	1	80	0.0125000
NODE_301421_length_199_cov_670.570000	25	105	537	1	80	0.0125000
NODE_301421_length_199_cov_670.570000	25	105	539	1	80	0.0125000
NODE_301421_length_199_cov_670.570000	25	105	541	2	80	0.0250000
NODE_301421_length_199_cov_670.570000	25	105	546	1	80	0.0125000
NODE_301421_length_199_cov_670.570000	25	105	553	1	80	0.0125000
NODE_301421_length_199_cov_670.570000	25	105	560	1	80	0.0125000
NODE_301421_length_199_cov_670.570000	25	105	568	1	80	0.0125000
NODE_301421_length_199_cov_670.570000	25	105	570	1	80	0.0125000
NODE_301421_length_199_cov_670.570000	25	105	572	1	80	0.0125000
NODE_301421_length_199_cov_670.570000	25	105	574	1	80	0.0125000
NODE_301421_length_199_cov_670.570000	25	105	578	1	80	0.0125000
NODE_301421_length_199_cov_670.570000	25	105	580	5	80	0.0625000
NODE_301421_length_199_cov_670.570000	25	105	582	13	80	0.1625000
NODE_301430_length_199_cov_215.860000	3	75	4	24	72	0.3333333
NODE_301430_length_199_cov_215.860000	3	75	10	10	72	0.1388889
NODE_301430_length_199_cov_215.860000	3	75	12	5	72	0.0694444
NODE_301430_length_199_cov_215.860000	3	75	14	1	72	0.0138889
NODE_301430_length_199_cov_215.860000	3	75	16	2	72	0.0277778
NODE_301430_length_199_cov_215.860000	3	75	18	11	72	0.1527778
NODE_301430_length_199_cov_215.860000	3	75	22	3	72	0.0416667
NODE_301430_length_199_cov_215.860000	3	75	24	6	72	0.0833333
NODE_301430_length_199_cov_215.860000	3	75	28	5	72	0.0694444
NODE_301430_length_199_cov_215.860000	3	75	30	4	72	0.0555556
NODE_301430_length_199_cov_215.860000	3	75	32	1	72	0.0138889
NODE_301430_length_199_cov_215.860000	48	128	18	14	80	0.1750000
NODE_301430_length_199_cov_215.860000	48	128	20	2	80	0.0250000
NODE_301430_length_199_cov_215.860000	48	128	22	8	80	0.1000000
NODE_301430_length_199_cov_215.860000	48	128	24	11	80	0.1375000
NODE_301430_length_199_cov_215.860000	48	128	28	5	80	0.0625000
NODE_301430_length_199_cov_215.860000	48	128	30	4	80	0.0500000
NODE_301430_length_199_cov_215.860000	48	128	32	36	80	0.4500000
NODE_301432_length_199_cov_206.800000	120	199	0	79	79	1.0000000
NODE_301441_length_199_cov_131.120000	97	177	0	80	80	1.0000000
NODE_301448_length_199_cov_97.490000	4	77	6	1	73	0.0136986
NODE_301448_length_199_cov_97.490000	4	77	10	1	73	0.0136986
NODE_301448_length_199_cov_97.490000	4	77	12	3	73	0.0410959
NODE_301448_length_199_cov_97.490000	4	77	13	4	73	0.0547945
NODE_301448_length_199_cov_97.490000	4	77	14	3	73	0.0410959
NODE_301448_length_199_cov_97.490000	4	77	16	4	73	0.0547945
NODE_301448_length_199_cov_97.490000	4	77	18	2	73	0.0273973
NODE_301448_length_199_cov_97.490000	4	77	20	1	73	0.0136986
NODE_301448_length_199_cov_97.490000	4	77	21	1	73	0.0136986
NODE_301448_length_199_cov_97.490000	4	77	22	2	73	0.0273973
NODE_301448_length_199_cov_97.490000	4	77	26	2	73	0.0273973
NODE_301448_length_199_cov_97.490000	4	77	32	1	73	0.0136986
NODE_301448_length_199_cov_97.490000	4	77	42	1	73	0.0136986
NODE_301448_length_199_cov_97.490000	4	77	44	1	73	0.0136986
NODE_301448_length_199_cov_97.490000	4	77	46	1	73	0.0136986
NODE_301448_length_199_cov_97.490000	4	77	54	2	73	0.0273973
NODE_301448_length_199_cov_97.490000	4	77	56	3	73	0.0410959
NODE_301448_length_199_cov_97.490000	4	77	58	1	73	0.0136986
NODE_301448_length_199_cov_97.490000	4	77	62	5	73	0.0684932
NODE_301448_length_199_cov_97.490000	4	77	66	4	73	0.0547945
NODE_301448_length_199_cov_97.490000	4	77	68	1	73	0.0136986
NODE_301448_length_199_cov_97.490000	4	77	70	7	73	0.0958904
NODE_301448_length_199_cov_97.490000	4	77	74	1	73	0.0136986
NODE_301448_length_199_cov_97.490000	4	77	76	3	73	0.0410959
NODE_301448_length_199_cov_97.490000	4	77	80	2	73	0.0273973
NODE_301448_length_199_cov_97.490000	4	77	84	1	73	0.0136986
NODE_301448_length_199_cov_97.490000	4	77	85	2	73	0.0273973
NODE_301448_length_199_cov_97.490000	4	77	87	1	73	0.0136986
NODE_301448_length_199_cov_97.490000	4	77	89	1	73	0.0136986
NODE_301448_length_199_cov_97.490000	4	77	91	5	73	0.0684932
NODE_301448_length_199_cov_97.490000	4	77	92	1	73	0.0136986
NODE_301448_length_199_cov_97.490000	4	77	96	3	73	0.0410959
NODE_301448_length_199_cov_97.490000	4	77	98	2	73	0.0273973
NODE_301449_length_199_cov_96.090000	91	171	4	1	80	0.0125000
NODE_301449_length_199_cov_96.090000	91	171	5	3	80	0.0375000
NODE_301449_length_199_cov_96.090000	91	171	11	2	80	0.0250000
NODE_301449_length_199_cov_96.090000	91	171	12	8	80	0.1000000
NODE_301449_length_199_cov_96.090000	91	171	14	17	80	0.2125000
NODE_301449_length_199_cov_96.090000	91	171	16	9	80	0.1125000
NODE_301449_length_199_cov_96.090000	91	171	18	18	80	0.2250000
NODE_301449_length_199_cov_96.090000	91	171	20	4	80	0.0500000
NODE_301449_length_199_cov_96.090000	91	171	22	18	80	0.2250000
NODE_301455_length_199_cov_84.060000	44	75	22	7	31	0.2258064
NODE_301455_length_199_cov_84.060000	44	75	25	2	31	0.0645161
NODE_301455_length_199_cov_84.060000	44	75	26	11	31	0.3548387
NODE_301455_length_199_cov_84.060000	44	75	28	3	31	0.0967742
NODE_301455_length_199_cov_84.060000	44	75	32	8	31	0.2580645
NODE_301456_length_199_cov_83.220000	0	64	0	64	64	1.0000000
NODE_301459_length_199_cov_80.390000	15	98	2	24	83	0.2891566
NODE_301459_length_199_cov_80.390000	15	98	8	7	83	0.0843373
NODE_301459_length_199_cov_80.390000	15	98	10	49	83	0.5903614
NODE_301459_length_199_cov_80.390000	15	98	12	3	83	0.0361446
NODE_301469_length_199_cov_63.420000	128	194	7	6	66	0.0909091
NODE_301469_length_199_cov_63.420000	128	194	10	1	66	0.0151515
NODE_301469_length_199_cov_63.420000	128	194	13	2	66	0.0303030
NODE_301469_length_199_cov_63.420000	128	194	15	2	66	0.0303030
NODE_301469_length_199_cov_63.420000	128	194	18	1	66	0.0151515
NODE_301469_length_199_cov_63.420000	128	194	19	5	66	0.0757576
NODE_301469_length_199_cov_63.420000	128	194	20	1	66	0.0151515
NODE_301469_length_199_cov_63.420000	128	194	21	4	66	0.0606061
NODE_301469_length_199_cov_63.420000	128	194	23	2	66	0.0303030
NODE_301469_length_199_cov_63.420000	128	194	25	2	66	0.0303030
NODE_301469_length_199_cov_63.420000	128	194	31	1	66	0.0151515
NODE_301469_length_199_cov_63.420000	128	194	33	1	66	0.0151515
NODE_301469_length_199_cov_63.420000	128	194	35	3	66	0.0454545
NODE_301469_length_199_cov_63.420000	128	194	37	2	66	0.0303030
NODE_301469_length_199_cov_63.420000	128	194	40	1	66	0.0151515
NODE_301469_length_199_cov_63.420000	128	194	41	3	66	0.0454545
NODE_301469_length_199_cov_63.420000	128	194	43	1	66	0.0151515
NODE_301469_length_199_cov_63.420000	128	194	47	4	66	0.0606061
NODE_301469_length_199_cov_63.420000	128	194	52	6	66	0.0909091
NODE_301469_length_199_cov_63.420000	128	194	54	2	66	0.0303030
NODE_301469_length_199_cov_63.420000	128	194	58	1	66	0.0151515
NODE_301469_length_199_cov_63.420000	128	194	60	5	66	0.0757576
NODE_301469_length_199_cov_63.420000	128	194	62	2	66	0.0303030
NODE_301469_length_199_cov_63.420000	128	194	63	1	66	0.0151515
NODE_301469_length_199_cov_63.420000	128	194	65	3	66	0.0454545
NODE_301469_length_199_cov_63.420000	128	194	67	1	66	0.0151515
NODE_301469_length_199_cov_63.420000	128	194	69	1	66	0.0151515
NODE_301469_length_199_cov_63.420000	128	194	71	1	66	0.0151515
NODE_301469_length_199_cov_63.420000	128	194	75	1	66	0.0151515
NODE_301477_length_199_cov_58.660000	18	85	0	34	67	0.5074627
NODE_301477_length_199_cov_58.660000	18	85	6	1	67	0.0149254
NODE_301477_length_199_cov_58.660000	18	85	7	7	67	0.1044776
NODE_301477_length_199_cov_58.660000	18	85	14	1	67	0.0149254
NODE_301477_length_199_cov_58.660000	18	85	15	8	67	0.1194030
NODE_301477_length_199_cov_58.660000	18	85	16	16	67	0.2388060
NODE_301484_length_199_cov_50.350000	102	183	0	81	81	1.0000000
NODE_301485_length_199_cov_49.630000	5	47	1	1	42	0.0238095
NODE_301485_length_199_cov_49.630000	5	47	2	15	42	0.3571429
NODE_301485_length_199_cov_49.630000	5	47	4	9	42	0.2142857
NODE_301485_length_199_cov_49.630000	5	47	6	11	42	0.2619048
NODE_301485_length_199_cov_49.630000	5	47	8	6	42	0.1428571
NODE_301485_length_199_cov_49.630000	100	163	2	8	63	0.1269841
NODE_301485_length_199_cov_49.630000	100	163	3	2	63	0.0317460
NODE_301485_length_199_cov_49.630000	100	163	5	12	63	0.1904762
NODE_301485_length_199_cov_49.630000	100	163	6	23	63	0.3650794
NODE_301485_length_199_cov_49.630000	100	163	8	18	63	0.2857143
NODE_301485_length_199_cov_49.630000	100	163	2	8	63	0.1269841
NODE_301485_length_199_cov_49.630000	100	163	3	2	63	0.0317460
NODE_301485_length_199_cov_49.630000	100	163	5	12	63	0.1904762
NODE_301485_length_199_cov_49.630000	100	163	6	23	63	0.3650794
NODE_301485_length_199_cov_49.630000	100	163	8	18	63	0.2857143
NODE_301485_length_199_cov_49.630000	100	163	2	8	63	0.1269841
NODE_301485_length_199_cov_49.630000	100	163	3	2	63	0.0317460
NODE_301485_length_199_cov_49.630000	100	163	5	12	63	0.1904762
NODE_301485_length_199_cov_49.630000	100	163	6	23	63	0.3650794
NODE_301485_length_199_cov_49.630000	100	163	8	18	63	0.2857143
NODE_301485_length_199_cov_49.630000	136	185	0	5	49	0.1020408
NODE_301485_length_199_cov_49.630000	136	185	2	25	49	0.5102041
NODE_301485_length_199_cov_49.630000	136	185	3	2	49	0.0408163
NODE_301485_length_199_cov_49.630000	136	185	5	12	49	0.2448980
NODE_301485_length_199_cov_49.630000	136	185	6	5	49	0.1020408
NODE_301485_length_199_cov_49.630000	153	199	0	19	46	0.4130435
NODE_301485_length_199_cov_49.630000	153	199	2	25	46	0.5434783
NODE_301485_length_199_cov_49.630000	153	199	3	2	46	0.0434783
NODE_301491_length_199_cov_40.000000	0	66	0	5	66	0.0757576
NODE_301491_length_199_cov_40.000000	0	66	2	37	66	0.5606061
NODE_301491_length_199_cov_40.000000	0	66	3	20	66	0.3030303
NODE_301491_length_199_cov_40.000000	0	66	4	4	66	0.0606061
NODE_301491_length_199_cov_40.000000	34	114	2	8	80	0.1000000
NODE_301491_length_199_cov_40.000000	34	114	3	20	80	0.2500000
NODE_301491_length_199_cov_40.000000	34	114	4	52	80	0.6500000
NODE_301491_length_199_cov_40.000000	39	61	2	3	22	0.1363636
NODE_301491_length_199_cov_40.000000	39	61	3	19	22	0.8636364
NODE_301498_length_199_cov_31.400000	3	77	0	74	74	1.0000000
NODE_301498_length_199_cov_31.400000	76	153	0	77	77	1.0000000
NODE_301498_length_199_cov_31.400000	76	153	0	77	77	1.0000000
NODE_301498_length_199_cov_31.400000	76	153	0	77	77	1.0000000
NODE_301498_length_199_cov_31.400000	126	192	0	66	66	1.0000000
NODE_301498_length_199_cov_31.400000	129	199	0	70	70	1.0000000
NODE_301498_length_199_cov_31.400000	131	199	0	68	68	1.0000000
NODE_301500_length_199_cov_30.140000	118	198	1	4	80	0.0500000
NODE_301500_length_199_cov_30.140000	118	198	2	10	80	0.1250000
NODE_301500_length_199_cov_30.140000	118	198	3	14	80	0.1750000
NODE_301500_length_199_cov_30.140000	118	198	7	1	80	0.0125000
NODE_301500_length_199_cov_30.140000	118	198	8	5	80	0.0625000
NODE_301500_length_199_cov_30.140000	118	198	10	4	80	0.0500000
NODE_301500_length_199_cov_30.140000	118	198	12	42	80	0.5250000
NODE_301500_length_199_cov_30.140000	118	198	1	4	80	0.0500000
NODE_301500_length_199_cov_30.140000	118	198	2	10	80	0.1250000
NODE_301500_length_199_cov_30.140000	118	198	3	14	80	0.1750000
NODE_301500_length_199_cov_30.140000	118	198	7	1	80	0.0125000
NODE_301500_length_199_cov_30.140000	118	198	8	5	80	0.0625000
NODE_301500_length_199_cov_30.140000	118	198	10	4	80	0.0500000
NODE_301500_length_199_cov_30.140000	118	198	12	42	80	0.5250000
NODE_301500_length_199_cov_30.140000	118	198	1	4	80	0.0500000
NODE_301500_length_199_cov_30.140000	118	198	2	10	80	0.1250000
NODE_301500_length_199_cov_30.140000	118	198	3	14	80	0.1750000
NODE_301500_length_199_cov_30.140000	118	198	7	1	80	0.0125000
NODE_301500_length_199_cov_30.140000	118	198	8	5	80	0.0625000
NODE_301500_length_199_cov_30.140000	118	198	10	4	80	0.0500000
NODE_301500_length_199_cov_30.140000	118	198	12	42	80	0.5250000
NODE_301500_length_199_cov_30.140000	118	198	1	4	80	0.0500000
NODE_301500_length_199_cov_30.140000	118	198	2	10	80	0.1250000
NODE_301500_length_199_cov_30.140000	118	198	3	14	80	0.1750000
NODE_301500_length_199_cov_30.140000	118	198	7	1	80	0.0125000
NODE_301500_length_199_cov_30.140000	118	198	8	5	80	0.0625000
NODE_301500_length_199_cov_30.140000	118	198	10	4	80	0.0500000
NODE_301500_length_199_cov_30.140000	118	198	12	42	80	0.5250000
NODE_301500_length_199_cov_30.140000	118	198	1	4	80	0.0500000
NODE_301500_length_199_cov_30.140000	118	198	2	10	80	0.1250000
NODE_301500_length_199_cov_30.140000	118	198	3	14	80	0.1750000
NODE_301500_length_199_cov_30.140000	118	198	7	1	80	0.0125000
NODE_301500_length_199_cov_30.140000	118	198	8	5	80	0.0625000
NODE_301500_length_199_cov_30.140000	118	198	10	4	80	0.0500000
NODE_301500_length_199_cov_30.140000	118	198	12	42	80	0.5250000
NODE_301500_length_199_cov_30.140000	127	198	1	4	71	0.0563380
NODE_301500_length_199_cov_30.140000	127	198	2	10	71	0.1408451
NODE_301500_length_199_cov_30.140000	127	198	3	14	71	0.1971831
NODE_301500_length_199_cov_30.140000	127	198	7	1	71	0.0140845
NODE_301500_length_199_cov_30.140000	127	198	8	5	71	0.0704225
NODE_301500_length_199_cov_30.140000	127	198	10	4	71	0.0563380
NODE_301500_length_199_cov_30.140000	127	198	12	33	71	0.4647887
NODE_301581_length_197_cov_41.265306	0	70	0	70	70	1.0000000
NODE_301611_length_196_cov_101.855670	72	136	72	8	64	0.1250000
NODE_301611_length_196_cov_101.855670	72	136	76	19	64	0.2968750
NODE_301611_length_196_cov_101.855670	72	136	78	37	64	0.5781250
NODE_301611_length_196_cov_101.855670	72	136	72	8	64	0.1250000
NODE_301611_length_196_cov_101.855670	72	136	76	19	64	0.2968750
NODE_301611_length_196_cov_101.855670	72	136	78	37	64	0.5781250
NODE_301611_length_196_cov_101.855670	109	169	29	2	60	0.0333333
NODE_301611_length_196_cov_101.855670	109	169	30	10	60	0.1666667
NODE_301611_length_196_cov_101.855670	109	169	34	8	60	0.1333333
NODE_301611_length_196_cov_101.855670	109	169	36	4	60	0.0666667
NODE_301611_length_196_cov_101.855670	109	169	46	3	60	0.0500000
NODE_301611_length_196_cov_101.855670	109	169	57	2	60	0.0333333
NODE_301611_length_196_cov_101.855670	109	169	58	1	60	0.0166667
NODE_301611_length_196_cov_101.855670	109	169	64	3	60	0.0500000
NODE_301611_length_196_cov_101.855670	109	169	72	8	60	0.1333333
NODE_301611_length_196_cov_101.855670	109	169	76	18	60	0.3000000
NODE_301611_length_196_cov_101.855670	109	169	78	1	60	0.0166667
NODE_301613_length_196_cov_100.618557	129	196	2	5	67	0.0746269
NODE_301613_length_196_cov_100.618557	129	196	4	8	67	0.1194030
NODE_301613_length_196_cov_100.618557	129	196	6	4	67	0.0597015
NODE_301613_length_196_cov_100.618557	129	196	10	2	67	0.0298507
NODE_301613_length_196_cov_100.618557	129	196	14	3	67	0.0447761
NODE_301613_length_196_cov_100.618557	129	196	18	3	67	0.0447761
NODE_301613_length_196_cov_100.618557	129	196	22	7	67	0.1044776
NODE_301613_length_196_cov_100.618557	129	196	24	5	67	0.0746269
NODE_301613_length_196_cov_100.618557	129	196	33	1	67	0.0149254
NODE_301613_length_196_cov_100.618557	129	196	34	8	67	0.1194030
NODE_301613_length_196_cov_100.618557	129	196	36	7	67	0.1044776
NODE_301613_length_196_cov_100.618557	129	196	37	3	67	0.0447761
NODE_301613_length_196_cov_100.618557	129	196	40	3	67	0.0447761
NODE_301613_length_196_cov_100.618557	129	196	42	8	67	0.1194030
NODE_301618_length_196_cov_67.268041	8	88	7	3	80	0.0375000
NODE_301618_length_196_cov_67.268041	8	88	8	1	80	0.0125000
NODE_301618_length_196_cov_67.268041	8	88	9	3	80	0.0375000
NODE_301618_length_196_cov_67.268041	8	88	10	25	80	0.3125000
NODE_301618_length_196_cov_67.268041	8	88	12	3	80	0.0375000
NODE_301618_length_196_cov_67.268041	8	88	14	6	80	0.0750000
NODE_301618_length_196_cov_67.268041	8	88	16	3	80	0.0375000
NODE_301618_length_196_cov_67.268041	8	88	18	1	80	0.0125000
NODE_301618_length_196_cov_67.268041	8	88	22	6	80	0.0750000
NODE_301618_length_196_cov_67.268041	8	88	24	1	80	0.0125000
NODE_301618_length_196_cov_67.268041	8	88	30	1	80	0.0125000
NODE_301618_length_196_cov_67.268041	8	88	34	27	80	0.3375000
NODE_301618_length_196_cov_67.268041	61	124	34	63	63	1.0000000
NODE_301629_length_196_cov_40.195876	101	184	9	1	83	0.0120482
NODE_301629_length_196_cov_40.195876	101	184	10	29	83	0.3493976
NODE_301629_length_196_cov_40.195876	101	184	15	1	83	0.0120482
NODE_301629_length_196_cov_40.195876	101	184	16	52	83	0.6265060
NODE_301704_length_194_cov_63.252632	12	78	2	13	66	0.1969697
NODE_301704_length_194_cov_63.252632	12	78	6	21	66	0.3181818
NODE_301704_length_194_cov_63.252632	12	78	9	1	66	0.0151515
NODE_301704_length_194_cov_63.252632	12	78	10	2	66	0.0303030
NODE_301704_length_194_cov_63.252632	12	78	19	1	66	0.0151515
NODE_301704_length_194_cov_63.252632	12	78	20	1	66	0.0151515
NODE_301704_length_194_cov_63.252632	12	78	35	4	66	0.0606061
NODE_301704_length_194_cov_63.252632	12	78	37	1	66	0.0151515
NODE_301704_length_194_cov_63.252632	12	78	41	3	66	0.0454545
NODE_301704_length_194_cov_63.252632	12	78	43	4	66	0.0606061
NODE_301704_length_194_cov_63.252632	12	78	45	2	66	0.0303030
NODE_301704_length_194_cov_63.252632	12	78	47	2	66	0.0303030
NODE_301704_length_194_cov_63.252632	12	78	48	4	66	0.0606061
NODE_301704_length_194_cov_63.252632	12	78	50	7	66	0.1060606
NODE_301704_length_194_cov_63.252632	51	112	35	4	61	0.0655738
NODE_301704_length_194_cov_63.252632	51	112	37	1	61	0.0163934
NODE_301704_length_194_cov_63.252632	51	112	41	3	61	0.0491803
NODE_301704_length_194_cov_63.252632	51	112	43	4	61	0.0655738
NODE_301704_length_194_cov_63.252632	51	112	45	2	61	0.0327869
NODE_301704_length_194_cov_63.252632	51	112	47	2	61	0.0327869
NODE_301704_length_194_cov_63.252632	51	112	48	4	61	0.0655738
NODE_301704_length_194_cov_63.252632	51	112	50	41	61	0.6721311
NODE_301704_length_194_cov_63.252632	51	99	35	4	48	0.0833333
NODE_301704_length_194_cov_63.252632	51	99	37	1	48	0.0208333
NODE_301704_length_194_cov_63.252632	51	99	41	3	48	0.0625000
NODE_301704_length_194_cov_63.252632	51	99	43	4	48	0.0833333
NODE_301704_length_194_cov_63.252632	51	99	45	2	48	0.0416667
NODE_301704_length_194_cov_63.252632	51	99	47	2	48	0.0416667
NODE_301704_length_194_cov_63.252632	51	99	48	4	48	0.0833333
NODE_301704_length_194_cov_63.252632	51	99	50	28	48	0.5833333
NODE_301704_length_194_cov_63.252632	51	112	35	4	61	0.0655738
NODE_301704_length_194_cov_63.252632	51	112	37	1	61	0.0163934
NODE_301704_length_194_cov_63.252632	51	112	41	3	61	0.0491803
NODE_301704_length_194_cov_63.252632	51	112	43	4	61	0.0655738
NODE_301704_length_194_cov_63.252632	51	112	45	2	61	0.0327869
NODE_301704_length_194_cov_63.252632	51	112	47	2	61	0.0327869
NODE_301704_length_194_cov_63.252632	51	112	48	4	61	0.0655738
NODE_301704_length_194_cov_63.252632	51	112	50	41	61	0.6721311
NODE_301708_length_194_cov_35.010526	95	162	1	15	67	0.2238806
NODE_301708_length_194_cov_35.010526	95	162	11	33	67	0.4925373
NODE_301708_length_194_cov_35.010526	95	162	12	19	67	0.2835821
NODE_301708_length_194_cov_35.010526	95	162	1	15	67	0.2238806
NODE_301708_length_194_cov_35.010526	95	162	11	33	67	0.4925373
NODE_301708_length_194_cov_35.010526	95	162	12	19	67	0.2835821
NODE_301708_length_194_cov_35.010526	135	184	0	22	49	0.4489796
NODE_301708_length_194_cov_35.010526	135	184	1	15	49	0.3061225
NODE_301708_length_194_cov_35.010526	135	184	11	12	49	0.2448980
NODE_301714_length_194_cov_9.978947	153	194	0	41	41	1.0000000
NODE_301727_length_193_cov_117.170213	21	93	22	1	72	0.0138889
NODE_301727_length_193_cov_117.170213	21	93	24	9	72	0.1250000
NODE_301727_length_193_cov_117.170213	21	93	28	2	72	0.0277778
NODE_301727_length_193_cov_117.170213	21	93	32	4	72	0.0555556
NODE_301727_length_193_cov_117.170213	21	93	34	2	72	0.0277778
NODE_301727_length_193_cov_117.170213	21	93	36	3	72	0.0416667
NODE_301727_length_193_cov_117.170213	21	93	39	1	72	0.0138889
NODE_301727_length_193_cov_117.170213	21	93	41	1	72	0.0138889
NODE_301727_length_193_cov_117.170213	21	93	43	1	72	0.0138889
NODE_301727_length_193_cov_117.170213	21	93	45	1	72	0.0138889
NODE_301727_length_193_cov_117.170213	21	93	46	1	72	0.0138889
NODE_301727_length_193_cov_117.170213	21	93	48	3	72	0.0416667
NODE_301727_length_193_cov_117.170213	21	93	50	2	72	0.0277778
NODE_301727_length_193_cov_117.170213	21	93	54	3	72	0.0416667
NODE_301727_length_193_cov_117.170213	21	93	56	1	72	0.0138889
NODE_301727_length_193_cov_117.170213	21	93	60	2	72	0.0277778
NODE_301727_length_193_cov_117.170213	21	93	62	2	72	0.0277778
NODE_301727_length_193_cov_117.170213	21	93	63	1	72	0.0138889
NODE_301727_length_193_cov_117.170213	21	93	66	21	72	0.2916667
NODE_301727_length_193_cov_117.170213	21	93	72	3	72	0.0416667
NODE_301727_length_193_cov_117.170213	21	93	74	8	72	0.1111111
NODE_301727_length_193_cov_117.170213	41	121	36	1	80	0.0125000
NODE_301727_length_193_cov_117.170213	41	121	39	1	80	0.0125000
NODE_301727_length_193_cov_117.170213	41	121	41	1	80	0.0125000
NODE_301727_length_193_cov_117.170213	41	121	43	1	80	0.0125000
NODE_301727_length_193_cov_117.170213	41	121	45	1	80	0.0125000
NODE_301727_length_193_cov_117.170213	41	121	46	1	80	0.0125000
NODE_301727_length_193_cov_117.170213	41	121	48	3	80	0.0375000
NODE_301727_length_193_cov_117.170213	41	121	50	2	80	0.0250000
NODE_301727_length_193_cov_117.170213	41	121	54	3	80	0.0375000
NODE_301727_length_193_cov_117.170213	41	121	56	2	80	0.0250000
NODE_301727_length_193_cov_117.170213	41	121	58	1	80	0.0125000
NODE_301727_length_193_cov_117.170213	41	121	60	7	80	0.0875000
NODE_301727_length_193_cov_117.170213	41	121	62	2	80	0.0250000
NODE_301727_length_193_cov_117.170213	41	121	63	1	80	0.0125000
NODE_301727_length_193_cov_117.170213	41	121	66	21	80	0.2625000
NODE_301727_length_193_cov_117.170213	41	121	68	1	80	0.0125000
NODE_301727_length_193_cov_117.170213	41	121	70	5	80	0.0625000
NODE_301727_length_193_cov_117.170213	41	121	72	4	80	0.0500000
NODE_301727_length_193_cov_117.170213	41	121	74	22	80	0.2750000
NODE_301729_length_193_cov_54.734043	108	188	14	24	80	0.3000000
NODE_301729_length_193_cov_54.734043	108	188	18	1	80	0.0125000
NODE_301729_length_193_cov_54.734043	108	188	20	17	80	0.2125000
NODE_301729_length_193_cov_54.734043	108	188	22	38	80	0.4750000
NODE_301729_length_193_cov_54.734043	161	183	14	19	22	0.8636364
NODE_301729_length_193_cov_54.734043	161	183	18	1	22	0.0454545
NODE_301729_length_193_cov_54.734043	161	183	20	2	22	0.0909091
NODE_301735_length_193_cov_30.638298	108	188	42	2	80	0.0250000
NODE_301735_length_193_cov_30.638298	108	188	44	1	80	0.0125000
NODE_301735_length_193_cov_30.638298	108	188	49	1	80	0.0125000
NODE_301735_length_193_cov_30.638298	108	188	50	2	80	0.0250000
NODE_301735_length_193_cov_30.638298	108	188	62	1	80	0.0125000
NODE_301735_length_193_cov_30.638298	108	188	63	6	80	0.0750000
NODE_301735_length_193_cov_30.638298	108	188	69	2	80	0.0250000
NODE_301735_length_193_cov_30.638298	108	188	71	7	80	0.0875000
NODE_301735_length_193_cov_30.638298	108	188	72	2	80	0.0250000
NODE_301735_length_193_cov_30.638298	108	188	73	12	80	0.1500000
NODE_301735_length_193_cov_30.638298	108	188	74	3	80	0.0375000
NODE_301735_length_193_cov_30.638298	108	188	76	8	80	0.1000000
NODE_301735_length_193_cov_30.638298	108	188	77	19	80	0.2375000
NODE_301735_length_193_cov_30.638298	108	188	78	3	80	0.0375000
NODE_301735_length_193_cov_30.638298	108	188	80	11	80	0.1375000
NODE_301735_length_193_cov_30.638298	161	183	50	1	22	0.0454545
NODE_301735_length_193_cov_30.638298	161	183	62	1	22	0.0454545
NODE_301735_length_193_cov_30.638298	161	183	63	6	22	0.2727273
NODE_301735_length_193_cov_30.638298	161	183	69	2	22	0.0909091
NODE_301735_length_193_cov_30.638298	161	183	71	7	22	0.3181818
NODE_301735_length_193_cov_30.638298	161	183	72	2	22	0.0909091
NODE_301735_length_193_cov_30.638298	161	183	73	3	22	0.1363636
NODE_301737_length_193_cov_29.968085	0	45	0	6	45	0.1333333
NODE_301737_length_193_cov_29.968085	0	45	40	2	45	0.0444444
NODE_301737_length_193_cov_29.968085	0	45	46	1	45	0.0222222
NODE_301737_length_193_cov_29.968085	0	45	48	7	45	0.1555556
NODE_301737_length_193_cov_29.968085	0	45	49	5	45	0.1111111
NODE_301737_length_193_cov_29.968085	0	45	50	4	45	0.0888889
NODE_301737_length_193_cov_29.968085	0	45	52	5	45	0.1111111
NODE_301737_length_193_cov_29.968085	0	45	56	9	45	0.2000000
NODE_301737_length_193_cov_29.968085	0	45	57	6	45	0.1333333
NODE_301737_length_193_cov_29.968085	8	57	46	1	49	0.0204082
NODE_301737_length_193_cov_29.968085	8	57	48	7	49	0.1428571
NODE_301737_length_193_cov_29.968085	8	57	49	5	49	0.1020408
NODE_301737_length_193_cov_29.968085	8	57	50	4	49	0.0816327
NODE_301737_length_193_cov_29.968085	8	57	52	5	49	0.1020408
NODE_301737_length_193_cov_29.968085	8	57	56	9	49	0.1836735
NODE_301737_length_193_cov_29.968085	8	57	57	8	49	0.1632653
NODE_301737_length_193_cov_29.968085	8	57	58	2	49	0.0408163
NODE_301737_length_193_cov_29.968085	8	57	65	8	49	0.1632653
NODE_301737_length_193_cov_29.968085	30	98	56	9	68	0.1323529
NODE_301737_length_193_cov_29.968085	30	98	57	8	68	0.1176471
NODE_301737_length_193_cov_29.968085	30	98	58	2	68	0.0294118
NODE_301737_length_193_cov_29.968085	30	98	65	10	68	0.1470588
NODE_301737_length_193_cov_29.968085	30	98	71	2	68	0.0294118
NODE_301737_length_193_cov_29.968085	30	98	72	7	68	0.1029412
NODE_301737_length_193_cov_29.968085	30	98	77	8	68	0.1176471
NODE_301737_length_193_cov_29.968085	30	98	78	22	68	0.3235294
NODE_301737_length_193_cov_29.968085	30	98	56	9	68	0.1323529
NODE_301737_length_193_cov_29.968085	30	98	57	8	68	0.1176471
NODE_301737_length_193_cov_29.968085	30	98	58	2	68	0.0294118
NODE_301737_length_193_cov_29.968085	30	98	65	10	68	0.1470588
NODE_301737_length_193_cov_29.968085	30	98	71	2	68	0.0294118
NODE_301737_length_193_cov_29.968085	30	98	72	7	68	0.1029412
NODE_301737_length_193_cov_29.968085	30	98	77	8	68	0.1176471
NODE_301737_length_193_cov_29.968085	30	98	78	22	68	0.3235294
NODE_301737_length_193_cov_29.968085	30	98	56	9	68	0.1323529
NODE_301737_length_193_cov_29.968085	30	98	57	8	68	0.1176471
NODE_301737_length_193_cov_29.968085	30	98	58	2	68	0.0294118
NODE_301737_length_193_cov_29.968085	30	98	65	10	68	0.1470588
NODE_301737_length_193_cov_29.968085	30	98	71	2	68	0.0294118
NODE_301737_length_193_cov_29.968085	30	98	72	7	68	0.1029412
NODE_301737_length_193_cov_29.968085	30	98	77	8	68	0.1176471
NODE_301737_length_193_cov_29.968085	30	98	78	22	68	0.3235294
NODE_301737_length_193_cov_29.968085	146	188	0	19	42	0.4523810
NODE_301737_length_193_cov_29.968085	146	188	6	3	42	0.0714286
NODE_301737_length_193_cov_29.968085	146	188	20	20	42	0.4761905
NODE_301776_length_192_cov_160.258065	0	76	22	1	76	0.0131579
NODE_301776_length_192_cov_160.258065	0	76	30	6	76	0.0789474
NODE_301776_length_192_cov_160.258065	0	76	38	3	76	0.0394737
NODE_301776_length_192_cov_160.258065	0	76	40	2	76	0.0263158
NODE_301776_length_192_cov_160.258065	0	76	44	4	76	0.0526316
NODE_301776_length_192_cov_160.258065	0	76	45	4	76	0.0526316
NODE_301776_length_192_cov_160.258065	0	76	47	2	76	0.0263158
NODE_301776_length_192_cov_160.258065	0	76	51	1	76	0.0131579
NODE_301776_length_192_cov_160.258065	0	76	53	2	76	0.0263158
NODE_301776_length_192_cov_160.258065	0	76	57	2	76	0.0263158
NODE_301776_length_192_cov_160.258065	0	76	59	1	76	0.0131579
NODE_301776_length_192_cov_160.258065	0	76	62	3	76	0.0394737
NODE_301776_length_192_cov_160.258065	0	76	63	2	76	0.0263158
NODE_301776_length_192_cov_160.258065	0	76	65	1	76	0.0131579
NODE_301776_length_192_cov_160.258065	0	76	66	1	76	0.0131579
NODE_301776_length_192_cov_160.258065	0	76	70	2	76	0.0263158
NODE_301776_length_192_cov_160.258065	0	76	72	1	76	0.0131579
NODE_301776_length_192_cov_160.258065	0	76	73	1	76	0.0131579
NODE_301776_length_192_cov_160.258065	0	76	78	1	76	0.0131579
NODE_301776_length_192_cov_160.258065	0	76	80	1	76	0.0131579
NODE_301776_length_192_cov_160.258065	0	76	81	1	76	0.0131579
NODE_301776_length_192_cov_160.258065	0	76	84	1	76	0.0131579
NODE_301776_length_192_cov_160.258065	0	76	95	1	76	0.0131579
NODE_301776_length_192_cov_160.258065	0	76	96	2	76	0.0263158
NODE_301776_length_192_cov_160.258065	0	76	100	1	76	0.0131579
NODE_301776_length_192_cov_160.258065	0	76	102	2	76	0.0263158
NODE_301776_length_192_cov_160.258065	0	76	104	3	76	0.0394737
NODE_301776_length_192_cov_160.258065	0	76	107	2	76	0.0263158
NODE_301776_length_192_cov_160.258065	0	76	109	1	76	0.0131579
NODE_301776_length_192_cov_160.258065	0	76	110	1	76	0.0131579
NODE_301776_length_192_cov_160.258065	0	76	112	1	76	0.0131579
NODE_301776_length_192_cov_160.258065	0	76	114	3	76	0.0394737
NODE_301776_length_192_cov_160.258065	0	76	116	1	76	0.0131579
NODE_301776_length_192_cov_160.258065	0	76	118	2	76	0.0263158
NODE_301776_length_192_cov_160.258065	0	76	120	1	76	0.0131579
NODE_301776_length_192_cov_160.258065	0	76	124	1	76	0.0131579
NODE_301776_length_192_cov_160.258065	0	76	128	1	76	0.0131579
NODE_301776_length_192_cov_160.258065	0	76	132	2	76	0.0263158
NODE_301776_length_192_cov_160.258065	0	76	134	2	76	0.0263158
NODE_301776_length_192_cov_160.258065	0	76	136	1	76	0.0131579
NODE_301776_length_192_cov_160.258065	0	76	141	2	76	0.0263158
NODE_301776_length_192_cov_160.258065	0	76	145	1	76	0.0131579
NODE_301776_length_192_cov_160.258065	0	76	147	2	76	0.0263158
NODE_301825_length_191_cov_92.913043	81	144	3	14	63	0.2222222
NODE_301825_length_191_cov_92.913043	81	144	4	1	63	0.0158730
NODE_301825_length_191_cov_92.913043	81	144	6	48	63	0.7619048
NODE_301855_length_190_cov_112.285714	8	91	0	17	83	0.2048193
NODE_301855_length_190_cov_112.285714	8	91	2	66	83	0.7951807
NODE_301859_length_190_cov_41.373626	92	172	5	4	80	0.0500000
NODE_301859_length_190_cov_41.373626	92	172	7	4	80	0.0500000
NODE_301859_length_190_cov_41.373626	92	172	13	6	80	0.0750000
NODE_301859_length_190_cov_41.373626	92	172	17	1	80	0.0125000
NODE_301859_length_190_cov_41.373626	92	172	18	5	80	0.0625000
NODE_301859_length_190_cov_41.373626	92	172	22	4	80	0.0500000
NODE_301859_length_190_cov_41.373626	92	172	24	1	80	0.0125000
NODE_301859_length_190_cov_41.373626	92	172	28	8	80	0.1000000
NODE_301859_length_190_cov_41.373626	92	172	30	6	80	0.0750000
NODE_301859_length_190_cov_41.373626	92	172	32	41	80	0.5125000
NODE_301859_length_190_cov_41.373626	145	190	0	12	45	0.2666667
NODE_301859_length_190_cov_41.373626	145	190	5	10	45	0.2222222
NODE_301859_length_190_cov_41.373626	145	190	7	4	45	0.0888889
NODE_301859_length_190_cov_41.373626	145	190	13	6	45	0.1333333
NODE_301859_length_190_cov_41.373626	145	190	17	1	45	0.0222222
NODE_301859_length_190_cov_41.373626	145	190	18	5	45	0.1111111
NODE_301859_length_190_cov_41.373626	145	190	22	4	45	0.0888889
NODE_301859_length_190_cov_41.373626	145	190	24	1	45	0.0222222
NODE_301859_length_190_cov_41.373626	145	190	28	2	45	0.0444444
NODE_301880_length_189_cov_234.500000	19	88	0	69	69	1.0000000
NODE_301882_length_189_cov_192.211111	134	186	12	1	52	0.0192308
NODE_301882_length_189_cov_192.211111	134	186	14	2	52	0.0384615
NODE_301882_length_189_cov_192.211111	134	186	17	14	52	0.2692308
NODE_301882_length_189_cov_192.211111	134	186	19	1	52	0.0192308
NODE_301882_length_189_cov_192.211111	134	186	21	1	52	0.0192308
NODE_301882_length_189_cov_192.211111	134	186	23	6	52	0.1153846
NODE_301882_length_189_cov_192.211111	134	186	24	5	52	0.0961538
NODE_301882_length_189_cov_192.211111	134	186	26	3	52	0.0576923
NODE_301882_length_189_cov_192.211111	134	186	28	1	52	0.0192308
NODE_301882_length_189_cov_192.211111	134	186	30	8	52	0.1538462
NODE_301882_length_189_cov_192.211111	134	186	32	2	52	0.0384615
NODE_301882_length_189_cov_192.211111	134	186	34	5	52	0.0961538
NODE_301882_length_189_cov_192.211111	134	186	36	3	52	0.0576923
NODE_301885_length_189_cov_70.600000	19	88	0	69	69	1.0000000
NODE_301885_length_189_cov_70.600000	72	156	0	84	84	1.0000000
NODE_301886_length_189_cov_63.455556	70	150	160	1	80	0.0125000
NODE_301886_length_189_cov_63.455556	70	150	161	6	80	0.0750000
NODE_301886_length_189_cov_63.455556	70	150	165	2	80	0.0250000
NODE_301886_length_189_cov_63.455556	70	150	173	9	80	0.1125000
NODE_301886_length_189_cov_63.455556	70	150	175	3	80	0.0375000
NODE_301886_length_189_cov_63.455556	70	150	177	5	80	0.0625000
NODE_301886_length_189_cov_63.455556	70	150	180	4	80	0.0500000
NODE_301886_length_189_cov_63.455556	70	150	181	1	80	0.0125000
NODE_301886_length_189_cov_63.455556	70	150	182	4	80	0.0500000
NODE_301886_length_189_cov_63.455556	70	150	184	3	80	0.0375000
NODE_301886_length_189_cov_63.455556	70	150	186	5	80	0.0625000
NODE_301886_length_189_cov_63.455556	70	150	188	2	80	0.0250000
NODE_301886_length_189_cov_63.455556	70	150	189	1	80	0.0125000
NODE_301886_length_189_cov_63.455556	70	150	190	3	80	0.0375000
NODE_301886_length_189_cov_63.455556	70	150	192	1	80	0.0125000
NODE_301886_length_189_cov_63.455556	70	150	193	1	80	0.0125000
NODE_301886_length_189_cov_63.455556	70	150	195	2	80	0.0250000
NODE_301886_length_189_cov_63.455556	70	150	196	1	80	0.0125000
NODE_301886_length_189_cov_63.455556	70	150	197	2	80	0.0250000
NODE_301886_length_189_cov_63.455556	70	150	199	5	80	0.0625000
NODE_301886_length_189_cov_63.455556	70	150	200	1	80	0.0125000
NODE_301886_length_189_cov_63.455556	70	150	202	13	80	0.1625000
NODE_301886_length_189_cov_63.455556	70	150	203	5	80	0.0625000
NODE_301886_length_189_cov_63.455556	70	141	173	9	71	0.1267606
NODE_301886_length_189_cov_63.455556	70	141	175	3	71	0.0422535
NODE_301886_length_189_cov_63.455556	70	141	177	5	71	0.0704225
NODE_301886_length_189_cov_63.455556	70	141	180	4	71	0.0563380
NODE_301886_length_189_cov_63.455556	70	141	181	1	71	0.0140845
NODE_301886_length_189_cov_63.455556	70	141	182	4	71	0.0563380
NODE_301886_length_189_cov_63.455556	70	141	184	3	71	0.0422535
NODE_301886_length_189_cov_63.455556	70	141	186	5	71	0.0704225
NODE_301886_length_189_cov_63.455556	70	141	188	2	71	0.0281690
NODE_301886_length_189_cov_63.455556	70	141	189	1	71	0.0140845
NODE_301886_length_189_cov_63.455556	70	141	190	3	71	0.0422535
NODE_301886_length_189_cov_63.455556	70	141	192	1	71	0.0140845
NODE_301886_length_189_cov_63.455556	70	141	193	1	71	0.0140845
NODE_301886_length_189_cov_63.455556	70	141	195	2	71	0.0281690
NODE_301886_length_189_cov_63.455556	70	141	196	1	71	0.0140845
NODE_301886_length_189_cov_63.455556	70	141	197	2	71	0.0281690
NODE_301886_length_189_cov_63.455556	70	141	199	5	71	0.0704225
NODE_301886_length_189_cov_63.455556	70	141	200	1	71	0.0140845
NODE_301886_length_189_cov_63.455556	70	141	202	13	71	0.1830986
NODE_301886_length_189_cov_63.455556	70	141	203	5	71	0.0704225
NODE_301891_length_189_cov_43.600000	0	73	4	2	73	0.0273973
NODE_301891_length_189_cov_43.600000	0	73	6	3	73	0.0410959
NODE_301891_length_189_cov_43.600000	0	73	9	1	73	0.0136986
NODE_301891_length_189_cov_43.600000	0	73	13	2	73	0.0273973
NODE_301891_length_189_cov_43.600000	0	73	18	2	73	0.0273973
NODE_301891_length_189_cov_43.600000	0	73	20	1	73	0.0136986
NODE_301891_length_189_cov_43.600000	0	73	23	2	73	0.0273973
NODE_301891_length_189_cov_43.600000	0	73	24	1	73	0.0136986
NODE_301891_length_189_cov_43.600000	0	73	27	1	73	0.0136986
NODE_301891_length_189_cov_43.600000	0	73	31	1	73	0.0136986
NODE_301891_length_189_cov_43.600000	0	73	32	1	73	0.0136986
NODE_301891_length_189_cov_43.600000	0	73	36	3	73	0.0410959
NODE_301891_length_189_cov_43.600000	0	73	38	1	73	0.0136986
NODE_301891_length_189_cov_43.600000	0	73	40	1	73	0.0136986
NODE_301891_length_189_cov_43.600000	0	73	42	2	73	0.0273973
NODE_301891_length_189_cov_43.600000	0	73	46	2	73	0.0273973
NODE_301891_length_189_cov_43.600000	0	73	48	3	73	0.0410959
NODE_301891_length_189_cov_43.600000	0	73	52	1	73	0.0136986
NODE_301891_length_189_cov_43.600000	0	73	54	1	73	0.0136986
NODE_301891_length_189_cov_43.600000	0	73	58	1	73	0.0136986
NODE_301891_length_189_cov_43.600000	0	73	60	1	73	0.0136986
NODE_301891_length_189_cov_43.600000	0	73	62	2	73	0.0273973
NODE_301891_length_189_cov_43.600000	0	73	68	1	73	0.0136986
NODE_301891_length_189_cov_43.600000	0	73	71	1	73	0.0136986
NODE_301891_length_189_cov_43.600000	0	73	72	5	73	0.0684932
NODE_301891_length_189_cov_43.600000	0	73	74	4	73	0.0547945
NODE_301891_length_189_cov_43.600000	0	73	80	2	73	0.0273973
NODE_301891_length_189_cov_43.600000	0	73	84	6	73	0.0821918
NODE_301891_length_189_cov_43.600000	0	73	86	4	73	0.0547945
NODE_301891_length_189_cov_43.600000	0	73	90	2	73	0.0273973
NODE_301891_length_189_cov_43.600000	0	73	92	2	73	0.0273973
NODE_301891_length_189_cov_43.600000	0	73	94	1	73	0.0136986
NODE_301891_length_189_cov_43.600000	0	73	96	10	73	0.1369863
NODE_301940_length_188_cov_2021.561798	108	188	10	1	80	0.0125000
NODE_301940_length_188_cov_2021.561798	108	188	14	2	80	0.0250000
NODE_301940_length_188_cov_2021.561798	108	188	50	1	80	0.0125000
NODE_301940_length_188_cov_2021.561798	108	188	75	2	80	0.0250000
NODE_301940_length_188_cov_2021.561798	108	188	123	1	80	0.0125000
NODE_301940_length_188_cov_2021.561798	108	188	125	2	80	0.0250000
NODE_301940_length_188_cov_2021.561798	108	188	131	2	80	0.0250000
NODE_301940_length_188_cov_2021.561798	108	188	134	1	80	0.0125000
NODE_301940_length_188_cov_2021.561798	108	188	147	1	80	0.0125000
NODE_301940_length_188_cov_2021.561798	108	188	150	1	80	0.0125000
NODE_301940_length_188_cov_2021.561798	108	188	159	1	80	0.0125000
NODE_301940_length_188_cov_2021.561798	108	188	162	1	80	0.0125000
NODE_301940_length_188_cov_2021.561798	108	188	168	1	80	0.0125000
NODE_301940_length_188_cov_2021.561798	108	188	172	1	80	0.0125000
NODE_301940_length_188_cov_2021.561798	108	188	182	1	80	0.0125000
NODE_301940_length_188_cov_2021.561798	108	188	183	1	80	0.0125000
NODE_301940_length_188_cov_2021.561798	108	188	184	3	80	0.0375000
NODE_301940_length_188_cov_2021.561798	108	188	194	1	80	0.0125000
NODE_301940_length_188_cov_2021.561798	108	188	205	1	80	0.0125000
NODE_301940_length_188_cov_2021.561798	108	188	214	1	80	0.0125000
NODE_301940_length_188_cov_2021.561798	108	188	220	1	80	0.0125000
NODE_301940_length_188_cov_2021.561798	108	188	235	1	80	0.0125000
NODE_301940_length_188_cov_2021.561798	108	188	239	1	80	0.0125000
NODE_301940_length_188_cov_2021.561798	108	188	252	4	80	0.0500000
NODE_301940_length_188_cov_2021.561798	108	188	255	1	80	0.0125000
NODE_301940_length_188_cov_2021.561798	108	188	259	1	80	0.0125000
NODE_301940_length_188_cov_2021.561798	108	188	260	1	80	0.0125000
NODE_301940_length_188_cov_2021.561798	108	188	262	4	80	0.0500000
NODE_301940_length_188_cov_2021.561798	108	188	263	1	80	0.0125000
NODE_301940_length_188_cov_2021.561798	108	188	266	1	80	0.0125000
NODE_301940_length_188_cov_2021.561798	108	188	270	2	80	0.0250000
NODE_301940_length_188_cov_2021.561798	108	188	273	1	80	0.0125000
NODE_301940_length_188_cov_2021.561798	108	188	277	1	80	0.0125000
NODE_301940_length_188_cov_2021.561798	108	188	284	1	80	0.0125000
NODE_301940_length_188_cov_2021.561798	108	188	289	1	80	0.0125000
NODE_301940_length_188_cov_2021.561798	108	188	290	1	80	0.0125000
NODE_301940_length_188_cov_2021.561798	108	188	291	1	80	0.0125000
NODE_301940_length_188_cov_2021.561798	108	188	295	1	80	0.0125000
NODE_301940_length_188_cov_2021.561798	108	188	297	1	80	0.0125000
NODE_301940_length_188_cov_2021.561798	108	188	299	5	80	0.0625000
NODE_301940_length_188_cov_2021.561798	108	188	300	1	80	0.0125000
NODE_301940_length_188_cov_2021.561798	108	188	302	3	80	0.0375000
NODE_301940_length_188_cov_2021.561798	108	188	306	2	80	0.0250000
NODE_301940_length_188_cov_2021.561798	108	188	311	1	80	0.0125000
NODE_301940_length_188_cov_2021.561798	108	188	317	2	80	0.0250000
NODE_301940_length_188_cov_2021.561798	108	188	326	1	80	0.0125000
NODE_301940_length_188_cov_2021.561798	108	188	327	1	80	0.0125000
NODE_301940_length_188_cov_2021.561798	108	188	328	6	80	0.0750000
NODE_301940_length_188_cov_2021.561798	108	188	330	3	80	0.0375000
NODE_301940_length_188_cov_2021.561798	108	188	332	2	80	0.0250000
NODE_301940_length_188_cov_2021.561798	108	188	334	1	80	0.0125000
NODE_301940_length_188_cov_2021.561798	161	183	75	1	22	0.0454545
NODE_301940_length_188_cov_2021.561798	161	183	123	1	22	0.0454545
NODE_301940_length_188_cov_2021.561798	161	183	125	2	22	0.0909091
NODE_301940_length_188_cov_2021.561798	161	183	131	2	22	0.0909091
NODE_301940_length_188_cov_2021.561798	161	183	134	1	22	0.0454545
NODE_301940_length_188_cov_2021.561798	161	183	147	1	22	0.0454545
NODE_301940_length_188_cov_2021.561798	161	183	150	1	22	0.0454545
NODE_301940_length_188_cov_2021.561798	161	183	159	1	22	0.0454545
NODE_301940_length_188_cov_2021.561798	161	183	162	1	22	0.0454545
NODE_301940_length_188_cov_2021.561798	161	183	168	1	22	0.0454545
NODE_301940_length_188_cov_2021.561798	161	183	172	1	22	0.0454545
NODE_301940_length_188_cov_2021.561798	161	183	182	1	22	0.0454545
NODE_301940_length_188_cov_2021.561798	161	183	183	1	22	0.0454545
NODE_301940_length_188_cov_2021.561798	161	183	184	3	22	0.1363636
NODE_301940_length_188_cov_2021.561798	161	183	194	1	22	0.0454545
NODE_301940_length_188_cov_2021.561798	161	183	205	1	22	0.0454545
NODE_301940_length_188_cov_2021.561798	161	183	214	1	22	0.0454545
NODE_301940_length_188_cov_2021.561798	161	183	220	1	22	0.0454545
NODE_301952_length_188_cov_37.988764	0	50	2	31	50	0.6200000
NODE_301952_length_188_cov_37.988764	0	50	4	3	50	0.0600000
NODE_301952_length_188_cov_37.988764	0	50	6	16	50	0.3200000
NODE_301980_length_187_cov_71.170455	124	155	21	1	31	0.0322581
NODE_301980_length_187_cov_71.170455	124	155	23	3	31	0.0967742
NODE_301980_length_187_cov_71.170455	124	155	29	7	31	0.2258064
NODE_301980_length_187_cov_71.170455	124	155	31	8	31	0.2580645
NODE_301980_length_187_cov_71.170455	124	155	32	12	31	0.3870968
NODE_301981_length_187_cov_56.000000	72	136	115	1	64	0.0156250
NODE_301981_length_187_cov_56.000000	72	136	121	1	64	0.0156250
NODE_301981_length_187_cov_56.000000	72	136	122	4	64	0.0625000
NODE_301981_length_187_cov_56.000000	72	136	125	1	64	0.0156250
NODE_301981_length_187_cov_56.000000	72	136	128	1	64	0.0156250
NODE_301981_length_187_cov_56.000000	72	136	139	2	64	0.0312500
NODE_301981_length_187_cov_56.000000	72	136	143	2	64	0.0312500
NODE_301981_length_187_cov_56.000000	72	136	151	2	64	0.0312500
NODE_301981_length_187_cov_56.000000	72	136	153	2	64	0.0312500
NODE_301981_length_187_cov_56.000000	72	136	159	2	64	0.0312500
NODE_301981_length_187_cov_56.000000	72	136	163	2	64	0.0312500
NODE_301981_length_187_cov_56.000000	72	136	165	5	64	0.0781250
NODE_301981_length_187_cov_56.000000	72	136	167	2	64	0.0312500
NODE_301981_length_187_cov_56.000000	72	136	169	1	64	0.0156250
NODE_301981_length_187_cov_56.000000	72	136	171	5	64	0.0781250
NODE_301981_length_187_cov_56.000000	72	136	172	3	64	0.0468750
NODE_301981_length_187_cov_56.000000	72	136	173	4	64	0.0625000
NODE_301981_length_187_cov_56.000000	72	136	174	24	64	0.3750000
NODE_301981_length_187_cov_56.000000	72	136	115	1	64	0.0156250
NODE_301981_length_187_cov_56.000000	72	136	121	1	64	0.0156250
NODE_301981_length_187_cov_56.000000	72	136	122	4	64	0.0625000
NODE_301981_length_187_cov_56.000000	72	136	125	1	64	0.0156250
NODE_301981_length_187_cov_56.000000	72	136	128	1	64	0.0156250
NODE_301981_length_187_cov_56.000000	72	136	139	2	64	0.0312500
NODE_301981_length_187_cov_56.000000	72	136	143	2	64	0.0312500
NODE_301981_length_187_cov_56.000000	72	136	151	2	64	0.0312500
NODE_301981_length_187_cov_56.000000	72	136	153	2	64	0.0312500
NODE_301981_length_187_cov_56.000000	72	136	159	2	64	0.0312500
NODE_301981_length_187_cov_56.000000	72	136	163	2	64	0.0312500
NODE_301981_length_187_cov_56.000000	72	136	165	5	64	0.0781250
NODE_301981_length_187_cov_56.000000	72	136	167	2	64	0.0312500
NODE_301981_length_187_cov_56.000000	72	136	169	1	64	0.0156250
NODE_301981_length_187_cov_56.000000	72	136	171	5	64	0.0781250
NODE_301981_length_187_cov_56.000000	72	136	172	3	64	0.0468750
NODE_301981_length_187_cov_56.000000	72	136	173	4	64	0.0625000
NODE_301981_length_187_cov_56.000000	72	136	174	24	64	0.3750000
NODE_301981_length_187_cov_56.000000	109	175	35	1	66	0.0151515
NODE_301981_length_187_cov_56.000000	109	175	43	3	66	0.0454545
NODE_301981_length_187_cov_56.000000	109	175	44	1	66	0.0151515
NODE_301981_length_187_cov_56.000000	109	175	50	1	66	0.0151515
NODE_301981_length_187_cov_56.000000	109	175	53	1	66	0.0151515
NODE_301981_length_187_cov_56.000000	109	175	57	1	66	0.0151515
NODE_301981_length_187_cov_56.000000	109	175	63	1	66	0.0151515
NODE_301981_length_187_cov_56.000000	109	175	65	2	66	0.0303030
NODE_301981_length_187_cov_56.000000	109	175	67	5	66	0.0757576
NODE_301981_length_187_cov_56.000000	109	175	69	2	66	0.0303030
NODE_301981_length_187_cov_56.000000	109	175	73	3	66	0.0454545
NODE_301981_length_187_cov_56.000000	109	175	82	1	66	0.0151515
NODE_301981_length_187_cov_56.000000	109	175	83	1	66	0.0151515
NODE_301981_length_187_cov_56.000000	109	175	90	5	66	0.0757576
NODE_301981_length_187_cov_56.000000	109	175	91	2	66	0.0303030
NODE_301981_length_187_cov_56.000000	109	175	92	1	66	0.0151515
NODE_301981_length_187_cov_56.000000	109	175	96	1	66	0.0151515
NODE_301981_length_187_cov_56.000000	109	175	102	1	66	0.0151515
NODE_301981_length_187_cov_56.000000	109	175	105	1	66	0.0151515
NODE_301981_length_187_cov_56.000000	109	175	109	5	66	0.0757576
NODE_301981_length_187_cov_56.000000	109	175	115	1	66	0.0151515
NODE_301981_length_187_cov_56.000000	109	175	121	1	66	0.0151515
NODE_301981_length_187_cov_56.000000	109	175	122	4	66	0.0606061
NODE_301981_length_187_cov_56.000000	109	175	125	1	66	0.0151515
NODE_301981_length_187_cov_56.000000	109	175	128	1	66	0.0151515
NODE_301981_length_187_cov_56.000000	109	175	139	2	66	0.0303030
NODE_301981_length_187_cov_56.000000	109	175	143	2	66	0.0303030
NODE_301981_length_187_cov_56.000000	109	175	151	2	66	0.0303030
NODE_301981_length_187_cov_56.000000	109	175	153	2	66	0.0303030
NODE_301981_length_187_cov_56.000000	109	175	159	1	66	0.0151515
NODE_301981_length_187_cov_56.000000	109	175	163	2	66	0.0303030
NODE_301981_length_187_cov_56.000000	109	175	165	1	66	0.0151515
NODE_301981_length_187_cov_56.000000	109	175	167	2	66	0.0303030
NODE_301981_length_187_cov_56.000000	109	175	169	1	66	0.0151515
NODE_301981_length_187_cov_56.000000	109	175	171	4	66	0.0606061
NODE_301981_length_187_cov_56.000000	109	180	31	1	71	0.0140845
NODE_301981_length_187_cov_56.000000	109	180	32	2	71	0.0281690
NODE_301981_length_187_cov_56.000000	109	180	33	1	71	0.0140845
NODE_301981_length_187_cov_56.000000	109	180	35	2	71	0.0281690
NODE_301981_length_187_cov_56.000000	109	180	43	3	71	0.0422535
NODE_301981_length_187_cov_56.000000	109	180	44	1	71	0.0140845
NODE_301981_length_187_cov_56.000000	109	180	50	1	71	0.0140845
NODE_301981_length_187_cov_56.000000	109	180	53	1	71	0.0140845
NODE_301981_length_187_cov_56.000000	109	180	57	1	71	0.0140845
NODE_301981_length_187_cov_56.000000	109	180	63	1	71	0.0140845
NODE_301981_length_187_cov_56.000000	109	180	65	2	71	0.0281690
NODE_301981_length_187_cov_56.000000	109	180	67	5	71	0.0704225
NODE_301981_length_187_cov_56.000000	109	180	69	2	71	0.0281690
NODE_301981_length_187_cov_56.000000	109	180	73	3	71	0.0422535
NODE_301981_length_187_cov_56.000000	109	180	82	1	71	0.0140845
NODE_301981_length_187_cov_56.000000	109	180	83	1	71	0.0140845
NODE_301981_length_187_cov_56.000000	109	180	90	5	71	0.0704225
NODE_301981_length_187_cov_56.000000	109	180	91	2	71	0.0281690
NODE_301981_length_187_cov_56.000000	109	180	92	1	71	0.0140845
NODE_301981_length_187_cov_56.000000	109	180	96	1	71	0.0140845
NODE_301981_length_187_cov_56.000000	109	180	102	1	71	0.0140845
NODE_301981_length_187_cov_56.000000	109	180	105	1	71	0.0140845
NODE_301981_length_187_cov_56.000000	109	180	109	5	71	0.0704225
NODE_301981_length_187_cov_56.000000	109	180	115	1	71	0.0140845
NODE_301981_length_187_cov_56.000000	109	180	121	1	71	0.0140845
NODE_301981_length_187_cov_56.000000	109	180	122	4	71	0.0563380
NODE_301981_length_187_cov_56.000000	109	180	125	1	71	0.0140845
NODE_301981_length_187_cov_56.000000	109	180	128	1	71	0.0140845
NODE_301981_length_187_cov_56.000000	109	180	139	2	71	0.0281690
NODE_301981_length_187_cov_56.000000	109	180	143	2	71	0.0281690
NODE_301981_length_187_cov_56.000000	109	180	151	2	71	0.0281690
NODE_301981_length_187_cov_56.000000	109	180	153	2	71	0.0281690
NODE_301981_length_187_cov_56.000000	109	180	159	1	71	0.0140845
NODE_301981_length_187_cov_56.000000	109	180	163	2	71	0.0281690
NODE_301981_length_187_cov_56.000000	109	180	165	1	71	0.0140845
NODE_301981_length_187_cov_56.000000	109	180	167	2	71	0.0281690
NODE_301981_length_187_cov_56.000000	109	180	169	1	71	0.0140845
NODE_301981_length_187_cov_56.000000	109	180	171	4	71	0.0563380
NODE_301986_length_187_cov_37.397727	4	57	0	27	53	0.5094340
NODE_301986_length_187_cov_37.397727	4	57	5	1	53	0.0188679
NODE_301986_length_187_cov_37.397727	4	57	7	1	53	0.0188679
NODE_301986_length_187_cov_37.397727	4	57	17	4	53	0.0754717
NODE_301986_length_187_cov_37.397727	4	57	22	1	53	0.0188679
NODE_301986_length_187_cov_37.397727	4	57	23	4	53	0.0754717
NODE_301986_length_187_cov_37.397727	4	57	25	4	53	0.0754717
NODE_301986_length_187_cov_37.397727	4	57	29	3	53	0.0566038
NODE_301986_length_187_cov_37.397727	4	57	33	2	53	0.0377358
NODE_301986_length_187_cov_37.397727	4	57	35	2	53	0.0377358
NODE_301986_length_187_cov_37.397727	4	57	37	2	53	0.0377358
NODE_301986_length_187_cov_37.397727	4	57	49	2	53	0.0377358
NODE_301986_length_187_cov_37.397727	12	78	0	19	66	0.2878788
NODE_301986_length_187_cov_37.397727	12	78	5	1	66	0.0151515
NODE_301986_length_187_cov_37.397727	12	78	7	1	66	0.0151515
NODE_301986_length_187_cov_37.397727	12	78	17	4	66	0.0606061
NODE_301986_length_187_cov_37.397727	12	78	22	1	66	0.0151515
NODE_301986_length_187_cov_37.397727	12	78	23	4	66	0.0606061
NODE_301986_length_187_cov_37.397727	12	78	25	4	66	0.0606061
NODE_301986_length_187_cov_37.397727	12	78	29	3	66	0.0454545
NODE_301986_length_187_cov_37.397727	12	78	33	2	66	0.0303030
NODE_301986_length_187_cov_37.397727	12	78	35	2	66	0.0303030
NODE_301986_length_187_cov_37.397727	12	78	37	2	66	0.0303030
NODE_301986_length_187_cov_37.397727	12	78	49	4	66	0.0606061
NODE_301986_length_187_cov_37.397727	12	78	51	8	66	0.1212121
NODE_301986_length_187_cov_37.397727	12	78	53	4	66	0.0606061
NODE_301986_length_187_cov_37.397727	12	78	57	5	66	0.0757576
NODE_301986_length_187_cov_37.397727	12	78	59	2	66	0.0303030
NODE_301986_length_187_cov_37.397727	51	112	35	2	61	0.0327869
NODE_301986_length_187_cov_37.397727	51	112	37	2	61	0.0327869
NODE_301986_length_187_cov_37.397727	51	112	49	4	61	0.0655738
NODE_301986_length_187_cov_37.397727	51	112	51	8	61	0.1311475
NODE_301986_length_187_cov_37.397727	51	112	53	4	61	0.0655738
NODE_301986_length_187_cov_37.397727	51	112	57	5	61	0.0819672
NODE_301986_length_187_cov_37.397727	51	112	58	3	61	0.0491803
NODE_301986_length_187_cov_37.397727	51	112	59	3	61	0.0491803
NODE_301986_length_187_cov_37.397727	51	112	60	30	61	0.4918033
NODE_301986_length_187_cov_37.397727	51	114	35	2	63	0.0317460
NODE_301986_length_187_cov_37.397727	51	114	37	2	63	0.0317460
NODE_301986_length_187_cov_37.397727	51	114	49	4	63	0.0634921
NODE_301986_length_187_cov_37.397727	51	114	51	8	63	0.1269841
NODE_301986_length_187_cov_37.397727	51	114	53	4	63	0.0634921
NODE_301986_length_187_cov_37.397727	51	114	57	5	63	0.0793651
NODE_301986_length_187_cov_37.397727	51	114	58	5	63	0.0793651
NODE_301986_length_187_cov_37.397727	51	114	59	3	63	0.0476190
NODE_301986_length_187_cov_37.397727	51	114	60	30	63	0.4761905
NODE_302020_length_186_cov_309.620690	20	104	0	84	84	1.0000000
NODE_302021_length_186_cov_295.505747	57	115	44	2	58	0.0344828
NODE_302021_length_186_cov_295.505747	57	115	46	11	58	0.1896552
NODE_302021_length_186_cov_295.505747	57	115	48	16	58	0.2758621
NODE_302021_length_186_cov_295.505747	57	115	50	4	58	0.0689655
NODE_302021_length_186_cov_295.505747	57	115	52	25	58	0.4310345
NODE_302021_length_186_cov_295.505747	101	168	6	4	67	0.0597015
NODE_302021_length_186_cov_295.505747	101	168	14	2	67	0.0298507
NODE_302021_length_186_cov_295.505747	101	168	18	2	67	0.0298507
NODE_302021_length_186_cov_295.505747	101	168	20	8	67	0.1194030
NODE_302021_length_186_cov_295.505747	101	168	21	6	67	0.0895522
NODE_302021_length_186_cov_295.505747	101	168	22	1	67	0.0149254
NODE_302021_length_186_cov_295.505747	101	168	23	4	67	0.0597015
NODE_302021_length_186_cov_295.505747	101	168	27	2	67	0.0298507
NODE_302021_length_186_cov_295.505747	101	168	33	1	67	0.0149254
NODE_302021_length_186_cov_295.505747	101	168	34	4	67	0.0597015
NODE_302021_length_186_cov_295.505747	101	168	36	5	67	0.0746269
NODE_302021_length_186_cov_295.505747	101	168	37	1	67	0.0149254
NODE_302021_length_186_cov_295.505747	101	168	38	2	67	0.0298507
NODE_302021_length_186_cov_295.505747	101	168	43	2	67	0.0298507
NODE_302021_length_186_cov_295.505747	101	168	44	3	67	0.0447761
NODE_302021_length_186_cov_295.505747	101	168	48	19	67	0.2835821
NODE_302021_length_186_cov_295.505747	101	168	52	1	67	0.0149254
NODE_302025_length_186_cov_61.344828	38	118	28	5	80	0.0625000
NODE_302025_length_186_cov_61.344828	38	118	36	33	80	0.4125000
NODE_302025_length_186_cov_61.344828	38	118	44	5	80	0.0625000
NODE_302025_length_186_cov_61.344828	38	118	45	1	80	0.0125000
NODE_302025_length_186_cov_61.344828	38	118	46	36	80	0.4500000
NODE_302025_length_186_cov_61.344828	91	171	5	5	80	0.0625000
NODE_302025_length_186_cov_61.344828	91	171	11	3	80	0.0375000
NODE_302025_length_186_cov_61.344828	91	171	21	1	80	0.0125000
NODE_302025_length_186_cov_61.344828	91	171	23	3	80	0.0375000
NODE_302025_length_186_cov_61.344828	91	171	27	1	80	0.0125000
NODE_302025_length_186_cov_61.344828	91	171	34	9	80	0.1125000
NODE_302025_length_186_cov_61.344828	91	171	36	18	80	0.2250000
NODE_302025_length_186_cov_61.344828	91	171	38	2	80	0.0250000
NODE_302025_length_186_cov_61.344828	91	171	44	15	80	0.1875000
NODE_302025_length_186_cov_61.344828	91	171	46	23	80	0.2875000
NODE_302201_length_182_cov_127.759036	6	52	29	3	46	0.0652174
NODE_302201_length_182_cov_127.759036	6	52	33	2	46	0.0434783
NODE_302201_length_182_cov_127.759036	6	52	35	1	46	0.0217391
NODE_302201_length_182_cov_127.759036	6	52	39	2	46	0.0434783
NODE_302201_length_182_cov_127.759036	6	52	41	1	46	0.0217391
NODE_302201_length_182_cov_127.759036	6	52	46	3	46	0.0652174
NODE_302201_length_182_cov_127.759036	6	52	48	1	46	0.0217391
NODE_302201_length_182_cov_127.759036	6	52	58	2	46	0.0434783
NODE_302201_length_182_cov_127.759036	6	52	62	2	46	0.0434783
NODE_302201_length_182_cov_127.759036	6	52	68	2	46	0.0434783
NODE_302201_length_182_cov_127.759036	6	52	70	1	46	0.0217391
NODE_302201_length_182_cov_127.759036	6	52	72	2	46	0.0434783
NODE_302201_length_182_cov_127.759036	6	52	76	1	46	0.0217391
NODE_302201_length_182_cov_127.759036	6	52	78	1	46	0.0217391
NODE_302201_length_182_cov_127.759036	6	52	82	3	46	0.0652174
NODE_302201_length_182_cov_127.759036	6	52	86	1	46	0.0217391
NODE_302201_length_182_cov_127.759036	6	52	87	1	46	0.0217391
NODE_302201_length_182_cov_127.759036	6	52	89	1	46	0.0217391
NODE_302201_length_182_cov_127.759036	6	52	92	10	46	0.2173913
NODE_302201_length_182_cov_127.759036	6	52	96	4	46	0.0869565
NODE_302201_length_182_cov_127.759036	6	52	99	1	46	0.0217391
NODE_302201_length_182_cov_127.759036	6	52	105	1	46	0.0217391
NODE_302201_length_182_cov_127.759036	59	105	113	1	46	0.0217391
NODE_302201_length_182_cov_127.759036	59	105	115	1	46	0.0217391
NODE_302201_length_182_cov_127.759036	59	105	117	2	46	0.0434783
NODE_302201_length_182_cov_127.759036	59	105	121	1	46	0.0217391
NODE_302201_length_182_cov_127.759036	59	105	125	5	46	0.1086956
NODE_302201_length_182_cov_127.759036	59	105	129	7	46	0.1521739
NODE_302201_length_182_cov_127.759036	59	105	131	29	46	0.6304348
NODE_302214_length_182_cov_29.421687	5	35	0	3	30	0.1000000
NODE_302214_length_182_cov_29.421687	5	35	2	6	30	0.2000000
NODE_302214_length_182_cov_29.421687	5	35	4	16	30	0.5333334
NODE_302214_length_182_cov_29.421687	5	35	6	1	30	0.0333333
NODE_302214_length_182_cov_29.421687	5	35	10	4	30	0.1333333
NODE_302214_length_182_cov_29.421687	8	88	2	6	80	0.0750000
NODE_302214_length_182_cov_29.421687	8	88	4	16	80	0.2000000
NODE_302214_length_182_cov_29.421687	8	88	6	1	80	0.0125000
NODE_302214_length_182_cov_29.421687	8	88	10	57	80	0.7125000
NODE_302236_length_181_cov_141.195122	1	60	0	29	59	0.4915254
NODE_302236_length_181_cov_141.195122	1	60	12	30	59	0.5084746
NODE_302236_length_181_cov_141.195122	34	60	12	26	26	1.0000000
NODE_302236_length_181_cov_141.195122	114	145	12	31	31	1.0000000
NODE_302285_length_180_cov_102.567901	6	75	58	2	69	0.0289855
NODE_302285_length_180_cov_102.567901	6	75	62	2	69	0.0289855
NODE_302285_length_180_cov_102.567901	6	75	64	3	69	0.0434783
NODE_302285_length_180_cov_102.567901	6	75	66	1	69	0.0144928
NODE_302285_length_180_cov_102.567901	6	75	67	2	69	0.0289855
NODE_302285_length_180_cov_102.567901	6	75	72	1	69	0.0144928
NODE_302285_length_180_cov_102.567901	6	75	73	2	69	0.0289855
NODE_302285_length_180_cov_102.567901	6	75	75	2	69	0.0289855
NODE_302285_length_180_cov_102.567901	6	75	77	1	69	0.0144928
NODE_302285_length_180_cov_102.567901	6	75	83	1	69	0.0144928
NODE_302285_length_180_cov_102.567901	6	75	86	2	69	0.0289855
NODE_302285_length_180_cov_102.567901	6	75	89	3	69	0.0434783
NODE_302285_length_180_cov_102.567901	6	75	90	1	69	0.0144928
NODE_302285_length_180_cov_102.567901	6	75	92	1	69	0.0144928
NODE_302285_length_180_cov_102.567901	6	75	98	1	69	0.0144928
NODE_302285_length_180_cov_102.567901	6	75	99	1	69	0.0144928
NODE_302285_length_180_cov_102.567901	6	75	102	1	69	0.0144928
NODE_302285_length_180_cov_102.567901	6	75	107	1	69	0.0144928
NODE_302285_length_180_cov_102.567901	6	75	121	2	69	0.0289855
NODE_302285_length_180_cov_102.567901	6	75	128	3	69	0.0434783
NODE_302285_length_180_cov_102.567901	6	75	130	2	69	0.0289855
NODE_302285_length_180_cov_102.567901	6	75	135	2	69	0.0289855
NODE_302285_length_180_cov_102.567901	6	75	149	1	69	0.0144928
NODE_302285_length_180_cov_102.567901	6	75	153	1	69	0.0144928
NODE_302285_length_180_cov_102.567901	6	75	155	1	69	0.0144928
NODE_302285_length_180_cov_102.567901	6	75	159	3	69	0.0434783
NODE_302285_length_180_cov_102.567901	6	75	165	4	69	0.0579710
NODE_302285_length_180_cov_102.567901	6	75	169	1	69	0.0144928
NODE_302285_length_180_cov_102.567901	6	75	171	1	69	0.0144928
NODE_302285_length_180_cov_102.567901	6	75	177	1	69	0.0144928
NODE_302285_length_180_cov_102.567901	6	75	185	2	69	0.0289855
NODE_302285_length_180_cov_102.567901	6	75	187	1	69	0.0144928
NODE_302285_length_180_cov_102.567901	6	75	189	2	69	0.0289855
NODE_302285_length_180_cov_102.567901	6	75	193	1	69	0.0144928
NODE_302285_length_180_cov_102.567901	6	75	194	1	69	0.0144928
NODE_302285_length_180_cov_102.567901	6	75	195	5	69	0.0724638
NODE_302285_length_180_cov_102.567901	6	75	201	1	69	0.0144928
NODE_302285_length_180_cov_102.567901	6	75	203	1	69	0.0144928
NODE_302285_length_180_cov_102.567901	6	75	205	5	69	0.0724638
NODE_302363_length_178_cov_93.620253	81	112	14	31	31	1.0000000
NODE_302365_length_178_cov_62.696203	0	78	0	8	78	0.1025641
NODE_302365_length_178_cov_62.696203	0	78	2	8	78	0.1025641
NODE_302365_length_178_cov_62.696203	0	78	10	11	78	0.1410256
NODE_302365_length_178_cov_62.696203	0	78	12	20	78	0.2564103
NODE_302365_length_178_cov_62.696203	0	78	20	3	78	0.0384615
NODE_302365_length_178_cov_62.696203	0	78	22	3	78	0.0384615
NODE_302365_length_178_cov_62.696203	0	78	28	25	78	0.3205128
NODE_302365_length_178_cov_62.696203	51	131	20	8	80	0.1000000
NODE_302365_length_178_cov_62.696203	51	131	22	2	80	0.0250000
NODE_302365_length_178_cov_62.696203	51	131	24	6	80	0.0750000
NODE_302365_length_178_cov_62.696203	51	131	26	12	80	0.1500000
NODE_302365_length_178_cov_62.696203	51	131	28	52	80	0.6500000
NODE_302477_length_175_cov_116.684211	42	122	2	80	80	1.0000000
NODE_302477_length_175_cov_116.684211	95	175	0	33	80	0.4125000
NODE_302477_length_175_cov_116.684211	95	175	2	47	80	0.5875000
NODE_302482_length_175_cov_61.000000	81	121	310	1	40	0.0250000
NODE_302482_length_175_cov_61.000000	81	121	316	1	40	0.0250000
NODE_302482_length_175_cov_61.000000	81	121	320	2	40	0.0500000
NODE_302482_length_175_cov_61.000000	81	121	322	3	40	0.0750000
NODE_302482_length_175_cov_61.000000	81	121	324	2	40	0.0500000
NODE_302482_length_175_cov_61.000000	81	121	326	1	40	0.0250000
NODE_302482_length_175_cov_61.000000	81	121	328	2	40	0.0500000
NODE_302482_length_175_cov_61.000000	81	121	330	1	40	0.0250000
NODE_302482_length_175_cov_61.000000	81	121	334	1	40	0.0250000
NODE_302482_length_175_cov_61.000000	81	121	336	3	40	0.0750000
NODE_302482_length_175_cov_61.000000	81	121	340	1	40	0.0250000
NODE_302482_length_175_cov_61.000000	81	121	344	1	40	0.0250000
NODE_302482_length_175_cov_61.000000	81	121	348	21	40	0.5250000
NODE_302538_length_174_cov_173.893333	53	93	190	1	40	0.0250000
NODE_302538_length_174_cov_173.893333	53	93	196	1	40	0.0250000
NODE_302538_length_174_cov_173.893333	53	93	208	2	40	0.0500000
NODE_302538_length_174_cov_173.893333	53	93	212	2	40	0.0500000
NODE_302538_length_174_cov_173.893333	53	93	216	1	40	0.0250000
NODE_302538_length_174_cov_173.893333	53	93	218	2	40	0.0500000
NODE_302538_length_174_cov_173.893333	53	93	222	2	40	0.0500000
NODE_302538_length_174_cov_173.893333	53	93	226	1	40	0.0250000
NODE_302538_length_174_cov_173.893333	53	93	230	1	40	0.0250000
NODE_302538_length_174_cov_173.893333	53	93	232	1	40	0.0250000
NODE_302538_length_174_cov_173.893333	53	93	238	3	40	0.0750000
NODE_302538_length_174_cov_173.893333	53	93	248	23	40	0.5750000
NODE_302543_length_174_cov_50.346667	91	161	14	3	70	0.0428571
NODE_302543_length_174_cov_50.346667	91	161	15	14	70	0.2000000
NODE_302543_length_174_cov_50.346667	91	161	17	9	70	0.1285714
NODE_302543_length_174_cov_50.346667	91	161	19	8	70	0.1142857
NODE_302543_length_174_cov_50.346667	91	161	21	4	70	0.0571429
NODE_302543_length_174_cov_50.346667	91	161	25	4	70	0.0571429
NODE_302543_length_174_cov_50.346667	91	161	26	2	70	0.0285714
NODE_302543_length_174_cov_50.346667	91	161	28	1	70	0.0142857
NODE_302543_length_174_cov_50.346667	91	161	38	1	70	0.0142857
NODE_302543_length_174_cov_50.346667	91	161	40	1	70	0.0142857
NODE_302543_length_174_cov_50.346667	91	161	42	1	70	0.0142857
NODE_302543_length_174_cov_50.346667	91	161	44	5	70	0.0714286
NODE_302543_length_174_cov_50.346667	91	161	46	17	70	0.2428571
NODE_302590_length_173_cov_184.351351	62	126	232	5	64	0.0781250
NODE_302590_length_173_cov_184.351351	62	126	236	1	64	0.0156250
NODE_302590_length_173_cov_184.351351	62	126	238	2	64	0.0312500
NODE_302590_length_173_cov_184.351351	62	126	246	2	64	0.0312500
NODE_302590_length_173_cov_184.351351	62	126	250	2	64	0.0312500
NODE_302590_length_173_cov_184.351351	62	126	256	1	64	0.0156250
NODE_302590_length_173_cov_184.351351	62	126	258	2	64	0.0312500
NODE_302590_length_173_cov_184.351351	62	126	262	1	64	0.0156250
NODE_302590_length_173_cov_184.351351	62	126	263	1	64	0.0156250
NODE_302590_length_173_cov_184.351351	62	126	265	3	64	0.0468750
NODE_302590_length_173_cov_184.351351	62	126	267	4	64	0.0625000
NODE_302590_length_173_cov_184.351351	62	126	269	1	64	0.0156250
NODE_302590_length_173_cov_184.351351	62	126	270	39	64	0.6093750
NODE_302590_length_173_cov_184.351351	62	126	232	5	64	0.0781250
NODE_302590_length_173_cov_184.351351	62	126	236	1	64	0.0156250
NODE_302590_length_173_cov_184.351351	62	126	238	2	64	0.0312500
NODE_302590_length_173_cov_184.351351	62	126	246	2	64	0.0312500
NODE_302590_length_173_cov_184.351351	62	126	250	2	64	0.0312500
NODE_302590_length_173_cov_184.351351	62	126	256	1	64	0.0156250
NODE_302590_length_173_cov_184.351351	62	126	258	2	64	0.0312500
NODE_302590_length_173_cov_184.351351	62	126	262	1	64	0.0156250
NODE_302590_length_173_cov_184.351351	62	126	263	1	64	0.0156250
NODE_302590_length_173_cov_184.351351	62	126	265	3	64	0.0468750
NODE_302590_length_173_cov_184.351351	62	126	267	4	64	0.0625000
NODE_302590_length_173_cov_184.351351	62	126	269	1	64	0.0156250
NODE_302590_length_173_cov_184.351351	62	126	270	39	64	0.6093750
NODE_302590_length_173_cov_184.351351	62	126	232	5	64	0.0781250
NODE_302590_length_173_cov_184.351351	62	126	236	1	64	0.0156250
NODE_302590_length_173_cov_184.351351	62	126	238	2	64	0.0312500
NODE_302590_length_173_cov_184.351351	62	126	246	2	64	0.0312500
NODE_302590_length_173_cov_184.351351	62	126	250	2	64	0.0312500
NODE_302590_length_173_cov_184.351351	62	126	256	1	64	0.0156250
NODE_302590_length_173_cov_184.351351	62	126	258	2	64	0.0312500
NODE_302590_length_173_cov_184.351351	62	126	262	1	64	0.0156250
NODE_302590_length_173_cov_184.351351	62	126	263	1	64	0.0156250
NODE_302590_length_173_cov_184.351351	62	126	265	3	64	0.0468750
NODE_302590_length_173_cov_184.351351	62	126	267	4	64	0.0625000
NODE_302590_length_173_cov_184.351351	62	126	269	1	64	0.0156250
NODE_302590_length_173_cov_184.351351	62	126	270	39	64	0.6093750
NODE_302590_length_173_cov_184.351351	62	126	232	5	64	0.0781250
NODE_302590_length_173_cov_184.351351	62	126	236	1	64	0.0156250
NODE_302590_length_173_cov_184.351351	62	126	238	2	64	0.0312500
NODE_302590_length_173_cov_184.351351	62	126	246	2	64	0.0312500
NODE_302590_length_173_cov_184.351351	62	126	250	2	64	0.0312500
NODE_302590_length_173_cov_184.351351	62	126	256	1	64	0.0156250
NODE_302590_length_173_cov_184.351351	62	126	258	2	64	0.0312500
NODE_302590_length_173_cov_184.351351	62	126	262	1	64	0.0156250
NODE_302590_length_173_cov_184.351351	62	126	263	1	64	0.0156250
NODE_302590_length_173_cov_184.351351	62	126	265	3	64	0.0468750
NODE_302590_length_173_cov_184.351351	62	126	267	4	64	0.0625000
NODE_302590_length_173_cov_184.351351	62	126	269	1	64	0.0156250
NODE_302590_length_173_cov_184.351351	62	126	270	39	64	0.6093750
NODE_302590_length_173_cov_184.351351	99	165	82	1	66	0.0151515
NODE_302590_length_173_cov_184.351351	99	165	85	4	66	0.0606061
NODE_302590_length_173_cov_184.351351	99	165	86	1	66	0.0151515
NODE_302590_length_173_cov_184.351351	99	165	90	3	66	0.0454545
NODE_302590_length_173_cov_184.351351	99	165	95	2	66	0.0303030
NODE_302590_length_173_cov_184.351351	99	165	101	1	66	0.0151515
NODE_302590_length_173_cov_184.351351	99	165	112	1	66	0.0151515
NODE_302590_length_173_cov_184.351351	99	165	118	4	66	0.0606061
NODE_302590_length_173_cov_184.351351	99	165	127	1	66	0.0151515
NODE_302590_length_173_cov_184.351351	99	165	128	1	66	0.0151515
NODE_302590_length_173_cov_184.351351	99	165	129	1	66	0.0151515
NODE_302590_length_173_cov_184.351351	99	165	145	1	66	0.0151515
NODE_302590_length_173_cov_184.351351	99	165	159	1	66	0.0151515
NODE_302590_length_173_cov_184.351351	99	165	161	1	66	0.0151515
NODE_302590_length_173_cov_184.351351	99	165	167	2	66	0.0303030
NODE_302590_length_173_cov_184.351351	99	165	168	2	66	0.0303030
NODE_302590_length_173_cov_184.351351	99	165	170	1	66	0.0151515
NODE_302590_length_173_cov_184.351351	99	165	179	1	66	0.0151515
NODE_302590_length_173_cov_184.351351	99	165	192	1	66	0.0151515
NODE_302590_length_173_cov_184.351351	99	165	202	1	66	0.0151515
NODE_302590_length_173_cov_184.351351	99	165	204	1	66	0.0151515
NODE_302590_length_173_cov_184.351351	99	165	213	2	66	0.0303030
NODE_302590_length_173_cov_184.351351	99	165	214	2	66	0.0303030
NODE_302590_length_173_cov_184.351351	99	165	220	1	66	0.0151515
NODE_302590_length_173_cov_184.351351	99	165	222	1	66	0.0151515
NODE_302590_length_173_cov_184.351351	99	165	226	1	66	0.0151515
NODE_302590_length_173_cov_184.351351	99	165	232	5	66	0.0757576
NODE_302590_length_173_cov_184.351351	99	165	236	1	66	0.0151515
NODE_302590_length_173_cov_184.351351	99	165	238	2	66	0.0303030
NODE_302590_length_173_cov_184.351351	99	165	246	2	66	0.0303030
NODE_302590_length_173_cov_184.351351	99	165	250	2	66	0.0303030
NODE_302590_length_173_cov_184.351351	99	165	256	1	66	0.0151515
NODE_302590_length_173_cov_184.351351	99	165	258	2	66	0.0303030
NODE_302590_length_173_cov_184.351351	99	165	262	1	66	0.0151515
NODE_302590_length_173_cov_184.351351	99	165	263	1	66	0.0151515
NODE_302590_length_173_cov_184.351351	99	165	265	3	66	0.0454545
NODE_302590_length_173_cov_184.351351	99	165	267	4	66	0.0606061
NODE_302590_length_173_cov_184.351351	99	165	269	1	66	0.0151515
NODE_302590_length_173_cov_184.351351	99	165	270	2	66	0.0303030
NODE_302590_length_173_cov_184.351351	99	170	57	1	71	0.0140845
NODE_302590_length_173_cov_184.351351	99	170	61	1	71	0.0140845
NODE_302590_length_173_cov_184.351351	99	170	78	2	71	0.0281690
NODE_302590_length_173_cov_184.351351	99	170	82	2	71	0.0281690
NODE_302590_length_173_cov_184.351351	99	170	85	4	71	0.0563380
NODE_302590_length_173_cov_184.351351	99	170	86	1	71	0.0140845
NODE_302590_length_173_cov_184.351351	99	170	90	3	71	0.0422535
NODE_302590_length_173_cov_184.351351	99	170	95	2	71	0.0281690
NODE_302590_length_173_cov_184.351351	99	170	101	1	71	0.0140845
NODE_302590_length_173_cov_184.351351	99	170	112	1	71	0.0140845
NODE_302590_length_173_cov_184.351351	99	170	118	4	71	0.0563380
NODE_302590_length_173_cov_184.351351	99	170	127	1	71	0.0140845
NODE_302590_length_173_cov_184.351351	99	170	128	1	71	0.0140845
NODE_302590_length_173_cov_184.351351	99	170	129	1	71	0.0140845
NODE_302590_length_173_cov_184.351351	99	170	145	1	71	0.0140845
NODE_302590_length_173_cov_184.351351	99	170	159	1	71	0.0140845
NODE_302590_length_173_cov_184.351351	99	170	161	1	71	0.0140845
NODE_302590_length_173_cov_184.351351	99	170	167	2	71	0.0281690
NODE_302590_length_173_cov_184.351351	99	170	168	2	71	0.0281690
NODE_302590_length_173_cov_184.351351	99	170	170	1	71	0.0140845
NODE_302590_length_173_cov_184.351351	99	170	179	1	71	0.0140845
NODE_302590_length_173_cov_184.351351	99	170	192	1	71	0.0140845
NODE_302590_length_173_cov_184.351351	99	170	202	1	71	0.0140845
NODE_302590_length_173_cov_184.351351	99	170	204	1	71	0.0140845
NODE_302590_length_173_cov_184.351351	99	170	213	2	71	0.0281690
NODE_302590_length_173_cov_184.351351	99	170	214	2	71	0.0281690
NODE_302590_length_173_cov_184.351351	99	170	220	1	71	0.0140845
NODE_302590_length_173_cov_184.351351	99	170	222	1	71	0.0140845
NODE_302590_length_173_cov_184.351351	99	170	226	1	71	0.0140845
NODE_302590_length_173_cov_184.351351	99	170	232	5	71	0.0704225
NODE_302590_length_173_cov_184.351351	99	170	236	1	71	0.0140845
NODE_302590_length_173_cov_184.351351	99	170	238	2	71	0.0281690
NODE_302590_length_173_cov_184.351351	99	170	246	2	71	0.0281690
NODE_302590_length_173_cov_184.351351	99	170	250	2	71	0.0281690
NODE_302590_length_173_cov_184.351351	99	170	256	1	71	0.0140845
NODE_302590_length_173_cov_184.351351	99	170	258	2	71	0.0281690
NODE_302590_length_173_cov_184.351351	99	170	262	1	71	0.0140845
NODE_302590_length_173_cov_184.351351	99	170	263	1	71	0.0140845
NODE_302590_length_173_cov_184.351351	99	170	265	3	71	0.0422535
NODE_302590_length_173_cov_184.351351	99	170	267	4	71	0.0563380
NODE_302590_length_173_cov_184.351351	99	170	269	1	71	0.0140845
NODE_302590_length_173_cov_184.351351	99	170	270	2	71	0.0281690
NODE_302590_length_173_cov_184.351351	115	173	31	1	58	0.0172414
NODE_302590_length_173_cov_184.351351	115	173	41	1	58	0.0172414
NODE_302590_length_173_cov_184.351351	115	173	47	1	58	0.0172414
NODE_302590_length_173_cov_184.351351	115	173	57	1	58	0.0172414
NODE_302590_length_173_cov_184.351351	115	173	61	1	58	0.0172414
NODE_302590_length_173_cov_184.351351	115	173	78	2	58	0.0344828
NODE_302590_length_173_cov_184.351351	115	173	82	2	58	0.0344828
NODE_302590_length_173_cov_184.351351	115	173	85	4	58	0.0689655
NODE_302590_length_173_cov_184.351351	115	173	86	1	58	0.0172414
NODE_302590_length_173_cov_184.351351	115	173	90	3	58	0.0517241
NODE_302590_length_173_cov_184.351351	115	173	95	2	58	0.0344828
NODE_302590_length_173_cov_184.351351	115	173	101	1	58	0.0172414
NODE_302590_length_173_cov_184.351351	115	173	112	1	58	0.0172414
NODE_302590_length_173_cov_184.351351	115	173	118	4	58	0.0689655
NODE_302590_length_173_cov_184.351351	115	173	127	1	58	0.0172414
NODE_302590_length_173_cov_184.351351	115	173	128	1	58	0.0172414
NODE_302590_length_173_cov_184.351351	115	173	129	1	58	0.0172414
NODE_302590_length_173_cov_184.351351	115	173	145	1	58	0.0172414
NODE_302590_length_173_cov_184.351351	115	173	159	1	58	0.0172414
NODE_302590_length_173_cov_184.351351	115	173	161	1	58	0.0172414
NODE_302590_length_173_cov_184.351351	115	173	167	2	58	0.0344828
NODE_302590_length_173_cov_184.351351	115	173	168	2	58	0.0344828
NODE_302590_length_173_cov_184.351351	115	173	170	1	58	0.0172414
NODE_302590_length_173_cov_184.351351	115	173	179	1	58	0.0172414
NODE_302590_length_173_cov_184.351351	115	173	192	1	58	0.0172414
NODE_302590_length_173_cov_184.351351	115	173	202	1	58	0.0172414
NODE_302590_length_173_cov_184.351351	115	173	204	1	58	0.0172414
NODE_302590_length_173_cov_184.351351	115	173	213	2	58	0.0344828
NODE_302590_length_173_cov_184.351351	115	173	214	2	58	0.0344828
NODE_302590_length_173_cov_184.351351	115	173	220	1	58	0.0172414
NODE_302590_length_173_cov_184.351351	115	173	222	1	58	0.0172414
NODE_302590_length_173_cov_184.351351	115	173	226	1	58	0.0172414
NODE_302590_length_173_cov_184.351351	115	173	232	5	58	0.0862069
NODE_302590_length_173_cov_184.351351	115	173	236	1	58	0.0172414
NODE_302590_length_173_cov_184.351351	115	173	238	2	58	0.0344828
NODE_302590_length_173_cov_184.351351	115	173	246	2	58	0.0344828
NODE_302590_length_173_cov_184.351351	115	173	250	1	58	0.0172414
NODE_302596_length_173_cov_58.472973	0	78	2	11	78	0.1410256
NODE_302596_length_173_cov_58.472973	0	78	5	6	78	0.0769231
NODE_302596_length_173_cov_58.472973	0	78	7	3	78	0.0384615
NODE_302596_length_173_cov_58.472973	0	78	8	4	78	0.0512821
NODE_302596_length_173_cov_58.472973	0	78	10	4	78	0.0512821
NODE_302596_length_173_cov_58.472973	0	78	12	1	78	0.0128205
NODE_302596_length_173_cov_58.472973	0	78	14	1	78	0.0128205
NODE_302596_length_173_cov_58.472973	0	78	16	6	78	0.0769231
NODE_302596_length_173_cov_58.472973	0	78	20	4	78	0.0512821
NODE_302596_length_173_cov_58.472973	0	78	26	1	78	0.0128205
NODE_302596_length_173_cov_58.472973	0	78	30	1	78	0.0128205
NODE_302596_length_173_cov_58.472973	0	78	34	2	78	0.0256410
NODE_302596_length_173_cov_58.472973	0	78	36	1	78	0.0128205
NODE_302596_length_173_cov_58.472973	0	78	38	1	78	0.0128205
NODE_302596_length_173_cov_58.472973	0	78	40	1	78	0.0128205
NODE_302596_length_173_cov_58.472973	0	78	42	4	78	0.0512821
NODE_302596_length_173_cov_58.472973	0	78	44	6	78	0.0769231
NODE_302596_length_173_cov_58.472973	0	78	46	1	78	0.0128205
NODE_302596_length_173_cov_58.472973	0	78	48	1	78	0.0128205
NODE_302596_length_173_cov_58.472973	0	78	50	3	78	0.0384615
NODE_302596_length_173_cov_58.472973	0	78	52	2	78	0.0256410
NODE_302596_length_173_cov_58.472973	0	78	56	1	78	0.0128205
NODE_302596_length_173_cov_58.472973	0	78	58	6	78	0.0769231
NODE_302596_length_173_cov_58.472973	0	78	60	7	78	0.0897436
NODE_302597_length_173_cov_57.148649	101	142	109	1	41	0.0243902
NODE_302597_length_173_cov_57.148649	101	142	115	1	41	0.0243902
NODE_302597_length_173_cov_57.148649	101	142	117	3	41	0.0731707
NODE_302597_length_173_cov_57.148649	101	142	123	1	41	0.0243902
NODE_302597_length_173_cov_57.148649	101	142	126	3	41	0.0731707
NODE_302597_length_173_cov_57.148649	101	142	130	1	41	0.0243902
NODE_302597_length_173_cov_57.148649	101	142	138	1	41	0.0243902
NODE_302597_length_173_cov_57.148649	101	142	142	1	41	0.0243902
NODE_302597_length_173_cov_57.148649	101	142	144	1	41	0.0243902
NODE_302597_length_173_cov_57.148649	101	142	150	2	41	0.0487805
NODE_302597_length_173_cov_57.148649	101	142	154	1	41	0.0243902
NODE_302597_length_173_cov_57.148649	101	142	158	1	41	0.0243902
NODE_302597_length_173_cov_57.148649	101	142	162	1	41	0.0243902
NODE_302597_length_173_cov_57.148649	101	142	164	3	41	0.0731707
NODE_302597_length_173_cov_57.148649	101	142	168	1	41	0.0243902
NODE_302597_length_173_cov_57.148649	101	142	170	1	41	0.0243902
NODE_302597_length_173_cov_57.148649	101	142	172	1	41	0.0243902
NODE_302597_length_173_cov_57.148649	101	142	174	1	41	0.0243902
NODE_302597_length_173_cov_57.148649	101	142	178	2	41	0.0487805
NODE_302597_length_173_cov_57.148649	101	142	180	3	41	0.0731707
NODE_302597_length_173_cov_57.148649	101	142	184	3	41	0.0731707
NODE_302597_length_173_cov_57.148649	101	142	186	2	41	0.0487805
NODE_302597_length_173_cov_57.148649	101	142	188	1	41	0.0243902
NODE_302597_length_173_cov_57.148649	101	142	190	5	41	0.1219512
NODE_302597_length_173_cov_57.148649	109	173	15	1	64	0.0156250
NODE_302597_length_173_cov_57.148649	109	173	23	3	64	0.0468750
NODE_302597_length_173_cov_57.148649	109	173	30	1	64	0.0156250
NODE_302597_length_173_cov_57.148649	109	173	36	1	64	0.0156250
NODE_302597_length_173_cov_57.148649	109	173	37	3	64	0.0468750
NODE_302597_length_173_cov_57.148649	109	173	44	2	64	0.0312500
NODE_302597_length_173_cov_57.148649	109	173	46	1	64	0.0156250
NODE_302597_length_173_cov_57.148649	109	173	48	1	64	0.0156250
NODE_302597_length_173_cov_57.148649	109	173	49	1	64	0.0156250
NODE_302597_length_173_cov_57.148649	109	173	51	1	64	0.0156250
NODE_302597_length_173_cov_57.148649	109	173	55	1	64	0.0156250
NODE_302597_length_173_cov_57.148649	109	173	63	2	64	0.0312500
NODE_302597_length_173_cov_57.148649	109	173	76	3	64	0.0468750
NODE_302597_length_173_cov_57.148649	109	173	78	2	64	0.0312500
NODE_302597_length_173_cov_57.148649	109	173	81	1	64	0.0156250
NODE_302597_length_173_cov_57.148649	109	173	91	1	64	0.0156250
NODE_302597_length_173_cov_57.148649	109	173	93	3	64	0.0468750
NODE_302597_length_173_cov_57.148649	109	173	95	1	64	0.0156250
NODE_302597_length_173_cov_57.148649	109	173	97	1	64	0.0156250
NODE_302597_length_173_cov_57.148649	109	173	105	1	64	0.0156250
NODE_302597_length_173_cov_57.148649	109	173	109	1	64	0.0156250
NODE_302597_length_173_cov_57.148649	109	173	115	1	64	0.0156250
NODE_302597_length_173_cov_57.148649	109	173	117	3	64	0.0468750
NODE_302597_length_173_cov_57.148649	109	173	123	1	64	0.0156250
NODE_302597_length_173_cov_57.148649	109	173	126	3	64	0.0468750
NODE_302597_length_173_cov_57.148649	109	173	130	1	64	0.0156250
NODE_302597_length_173_cov_57.148649	109	173	138	1	64	0.0156250
NODE_302597_length_173_cov_57.148649	109	173	142	1	64	0.0156250
NODE_302597_length_173_cov_57.148649	109	173	144	1	64	0.0156250
NODE_302597_length_173_cov_57.148649	109	173	150	2	64	0.0312500
NODE_302597_length_173_cov_57.148649	109	173	154	1	64	0.0156250
NODE_302597_length_173_cov_57.148649	109	173	158	1	64	0.0156250
NODE_302597_length_173_cov_57.148649	109	173	162	1	64	0.0156250
NODE_302597_length_173_cov_57.148649	109	173	164	3	64	0.0468750
NODE_302597_length_173_cov_57.148649	109	173	168	1	64	0.0156250
NODE_302597_length_173_cov_57.148649	109	173	170	1	64	0.0156250
NODE_302597_length_173_cov_57.148649	109	173	172	1	64	0.0156250
NODE_302597_length_173_cov_57.148649	109	173	174	1	64	0.0156250
NODE_302597_length_173_cov_57.148649	109	173	178	2	64	0.0312500
NODE_302597_length_173_cov_57.148649	109	173	180	3	64	0.0468750
NODE_302597_length_173_cov_57.148649	109	173	184	3	64	0.0468750
NODE_302686_length_171_cov_218.666667	12	90	14	4	78	0.0512821
NODE_302686_length_171_cov_218.666667	12	90	19	5	78	0.0641026
NODE_302686_length_171_cov_218.666667	12	90	25	6	78	0.0769231
NODE_302686_length_171_cov_218.666667	12	90	27	6	78	0.0769231
NODE_302686_length_171_cov_218.666667	12	90	31	11	78	0.1410256
NODE_302686_length_171_cov_218.666667	12	90	32	1	78	0.0128205
NODE_302686_length_171_cov_218.666667	12	90	45	6	78	0.0769231
NODE_302686_length_171_cov_218.666667	12	90	46	2	78	0.0256410
NODE_302686_length_171_cov_218.666667	12	90	48	7	78	0.0897436
NODE_302686_length_171_cov_218.666667	12	90	50	5	78	0.0641026
NODE_302686_length_171_cov_218.666667	12	90	52	2	78	0.0256410
NODE_302686_length_171_cov_218.666667	12	90	56	23	78	0.2948718
NODE_302686_length_171_cov_218.666667	12	90	14	4	78	0.0512821
NODE_302686_length_171_cov_218.666667	12	90	19	5	78	0.0641026
NODE_302686_length_171_cov_218.666667	12	90	25	6	78	0.0769231
NODE_302686_length_171_cov_218.666667	12	90	27	6	78	0.0769231
NODE_302686_length_171_cov_218.666667	12	90	31	11	78	0.1410256
NODE_302686_length_171_cov_218.666667	12	90	32	1	78	0.0128205
NODE_302686_length_171_cov_218.666667	12	90	45	6	78	0.0769231
NODE_302686_length_171_cov_218.666667	12	90	46	2	78	0.0256410
NODE_302686_length_171_cov_218.666667	12	90	48	7	78	0.0897436
NODE_302686_length_171_cov_218.666667	12	90	50	5	78	0.0641026
NODE_302686_length_171_cov_218.666667	12	90	52	2	78	0.0256410
NODE_302686_length_171_cov_218.666667	12	90	56	23	78	0.2948718
NODE_302686_length_171_cov_218.666667	21	90	25	6	69	0.0869565
NODE_302686_length_171_cov_218.666667	21	90	27	6	69	0.0869565
NODE_302686_length_171_cov_218.666667	21	90	31	11	69	0.1594203
NODE_302686_length_171_cov_218.666667	21	90	32	1	69	0.0144928
NODE_302686_length_171_cov_218.666667	21	90	45	6	69	0.0869565
NODE_302686_length_171_cov_218.666667	21	90	46	2	69	0.0289855
NODE_302686_length_171_cov_218.666667	21	90	48	7	69	0.1014493
NODE_302686_length_171_cov_218.666667	21	90	50	5	69	0.0724638
NODE_302686_length_171_cov_218.666667	21	90	52	2	69	0.0289855
NODE_302686_length_171_cov_218.666667	21	90	56	23	69	0.3333333
NODE_302689_length_171_cov_110.194444	81	161	0	4	80	0.0500000
NODE_302689_length_171_cov_110.194444	81	161	15	4	80	0.0500000
NODE_302689_length_171_cov_110.194444	81	161	27	7	80	0.0875000
NODE_302689_length_171_cov_110.194444	81	161	28	2	80	0.0250000
NODE_302689_length_171_cov_110.194444	81	161	55	1	80	0.0125000
NODE_302689_length_171_cov_110.194444	81	161	66	40	80	0.5000000
NODE_302689_length_171_cov_110.194444	81	161	67	21	80	0.2625000
NODE_302689_length_171_cov_110.194444	81	161	68	1	80	0.0125000
NODE_302689_length_171_cov_110.194444	81	152	27	6	71	0.0845070
NODE_302689_length_171_cov_110.194444	81	152	28	2	71	0.0281690
NODE_302689_length_171_cov_110.194444	81	152	55	1	71	0.0140845
NODE_302689_length_171_cov_110.194444	81	152	66	40	71	0.5633803
NODE_302689_length_171_cov_110.194444	81	152	67	21	71	0.2957746
NODE_302689_length_171_cov_110.194444	81	152	68	1	71	0.0140845
NODE_302691_length_171_cov_86.013889	106	171	0	65	65	1.0000000
NODE_302697_length_171_cov_46.430556	0	59	7	1	59	0.0169492
NODE_302697_length_171_cov_46.430556	0	59	17	2	59	0.0338983
NODE_302697_length_171_cov_46.430556	0	59	25	3	59	0.0508475
NODE_302697_length_171_cov_46.430556	0	59	39	1	59	0.0169492
NODE_302697_length_171_cov_46.430556	0	59	45	3	59	0.0508475
NODE_302697_length_171_cov_46.430556	0	59	53	2	59	0.0338983
NODE_302697_length_171_cov_46.430556	0	59	54	1	59	0.0169492
NODE_302697_length_171_cov_46.430556	0	59	56	2	59	0.0338983
NODE_302697_length_171_cov_46.430556	0	59	60	1	59	0.0169492
NODE_302697_length_171_cov_46.430556	0	59	68	1	59	0.0169492
NODE_302697_length_171_cov_46.430556	0	59	72	2	59	0.0338983
NODE_302697_length_171_cov_46.430556	0	59	74	1	59	0.0169492
NODE_302697_length_171_cov_46.430556	0	59	76	5	59	0.0847458
NODE_302697_length_171_cov_46.430556	0	59	80	1	59	0.0169492
NODE_302697_length_171_cov_46.430556	0	59	92	3	59	0.0508475
NODE_302697_length_171_cov_46.430556	0	59	96	1	59	0.0169492
NODE_302697_length_171_cov_46.430556	0	59	106	1	59	0.0169492
NODE_302697_length_171_cov_46.430556	0	59	110	2	59	0.0338983
NODE_302697_length_171_cov_46.430556	0	59	118	2	59	0.0338983
NODE_302697_length_171_cov_46.430556	0	59	120	2	59	0.0338983
NODE_302697_length_171_cov_46.430556	0	59	124	1	59	0.0169492
NODE_302697_length_171_cov_46.430556	0	59	128	4	59	0.0677966
NODE_302697_length_171_cov_46.430556	0	59	134	1	59	0.0169492
NODE_302697_length_171_cov_46.430556	0	59	136	6	59	0.1016949
NODE_302697_length_171_cov_46.430556	0	59	140	2	59	0.0338983
NODE_302697_length_171_cov_46.430556	0	59	142	4	59	0.0677966
NODE_302697_length_171_cov_46.430556	0	59	144	1	59	0.0169492
NODE_302697_length_171_cov_46.430556	0	59	146	1	59	0.0169492
NODE_302697_length_171_cov_46.430556	0	59	148	1	59	0.0169492
NODE_302697_length_171_cov_46.430556	0	59	158	1	59	0.0169492
NODE_302697_length_171_cov_46.430556	32	98	110	1	66	0.0151515
NODE_302697_length_171_cov_46.430556	32	98	118	2	66	0.0303030
NODE_302697_length_171_cov_46.430556	32	98	120	2	66	0.0303030
NODE_302697_length_171_cov_46.430556	32	98	124	1	66	0.0151515
NODE_302697_length_171_cov_46.430556	32	98	128	4	66	0.0606061
NODE_302697_length_171_cov_46.430556	32	98	134	1	66	0.0151515
NODE_302697_length_171_cov_46.430556	32	98	136	6	66	0.0909091
NODE_302697_length_171_cov_46.430556	32	98	140	2	66	0.0303030
NODE_302697_length_171_cov_46.430556	32	98	142	4	66	0.0606061
NODE_302697_length_171_cov_46.430556	32	98	144	1	66	0.0151515
NODE_302697_length_171_cov_46.430556	32	98	146	1	66	0.0151515
NODE_302697_length_171_cov_46.430556	32	98	148	1	66	0.0151515
NODE_302697_length_171_cov_46.430556	32	98	158	1	66	0.0151515
NODE_302697_length_171_cov_46.430556	32	98	166	2	66	0.0303030
NODE_302697_length_171_cov_46.430556	32	98	168	1	66	0.0151515
NODE_302697_length_171_cov_46.430556	32	98	170	3	66	0.0454545
NODE_302697_length_171_cov_46.430556	32	98	172	2	66	0.0303030
NODE_302697_length_171_cov_46.430556	32	98	174	31	66	0.4696970
NODE_302700_length_171_cov_40.069444	13	87	0	74	74	1.0000000
NODE_302702_length_171_cov_33.319444	84	158	0	47	74	0.6351351
NODE_302702_length_171_cov_33.319444	84	158	4	27	74	0.3648649
NODE_302764_length_170_cov_217.422535	10	90	24	1	80	0.0125000
NODE_302764_length_170_cov_217.422535	10	90	27	2	80	0.0250000
NODE_302764_length_170_cov_217.422535	10	90	29	1	80	0.0125000
NODE_302764_length_170_cov_217.422535	10	90	53	5	80	0.0625000
NODE_302764_length_170_cov_217.422535	10	90	71	5	80	0.0625000
NODE_302764_length_170_cov_217.422535	10	90	77	4	80	0.0500000
NODE_302764_length_170_cov_217.422535	10	90	81	1	80	0.0125000
NODE_302764_length_170_cov_217.422535	10	90	85	9	80	0.1125000
NODE_302764_length_170_cov_217.422535	10	90	87	3	80	0.0375000
NODE_302764_length_170_cov_217.422535	10	90	95	1	80	0.0125000
NODE_302764_length_170_cov_217.422535	10	90	113	4	80	0.0500000
NODE_302764_length_170_cov_217.422535	10	90	115	2	80	0.0250000
NODE_302764_length_170_cov_217.422535	10	90	117	1	80	0.0125000
NODE_302764_length_170_cov_217.422535	10	90	123	2	80	0.0250000
NODE_302764_length_170_cov_217.422535	10	90	130	1	80	0.0125000
NODE_302764_length_170_cov_217.422535	10	90	132	1	80	0.0125000
NODE_302764_length_170_cov_217.422535	10	90	134	1	80	0.0125000
NODE_302764_length_170_cov_217.422535	10	90	138	1	80	0.0125000
NODE_302764_length_170_cov_217.422535	10	90	142	1	80	0.0125000
NODE_302764_length_170_cov_217.422535	10	90	144	1	80	0.0125000
NODE_302764_length_170_cov_217.422535	10	90	145	1	80	0.0125000
NODE_302764_length_170_cov_217.422535	10	90	146	2	80	0.0250000
NODE_302764_length_170_cov_217.422535	10	90	148	1	80	0.0125000
NODE_302764_length_170_cov_217.422535	10	90	149	1	80	0.0125000
NODE_302764_length_170_cov_217.422535	10	90	150	1	80	0.0125000
NODE_302764_length_170_cov_217.422535	10	90	160	2	80	0.0250000
NODE_302764_length_170_cov_217.422535	10	90	166	2	80	0.0250000
NODE_302764_length_170_cov_217.422535	10	90	167	2	80	0.0250000
NODE_302764_length_170_cov_217.422535	10	90	169	21	80	0.2625000
NODE_302764_length_170_cov_217.422535	10	90	24	1	80	0.0125000
NODE_302764_length_170_cov_217.422535	10	90	27	2	80	0.0250000
NODE_302764_length_170_cov_217.422535	10	90	29	1	80	0.0125000
NODE_302764_length_170_cov_217.422535	10	90	53	5	80	0.0625000
NODE_302764_length_170_cov_217.422535	10	90	71	5	80	0.0625000
NODE_302764_length_170_cov_217.422535	10	90	77	4	80	0.0500000
NODE_302764_length_170_cov_217.422535	10	90	81	1	80	0.0125000
NODE_302764_length_170_cov_217.422535	10	90	85	9	80	0.1125000
NODE_302764_length_170_cov_217.422535	10	90	87	3	80	0.0375000
NODE_302764_length_170_cov_217.422535	10	90	95	1	80	0.0125000
NODE_302764_length_170_cov_217.422535	10	90	113	4	80	0.0500000
NODE_302764_length_170_cov_217.422535	10	90	115	2	80	0.0250000
NODE_302764_length_170_cov_217.422535	10	90	117	1	80	0.0125000
NODE_302764_length_170_cov_217.422535	10	90	123	2	80	0.0250000
NODE_302764_length_170_cov_217.422535	10	90	130	1	80	0.0125000
NODE_302764_length_170_cov_217.422535	10	90	132	1	80	0.0125000
NODE_302764_length_170_cov_217.422535	10	90	134	1	80	0.0125000
NODE_302764_length_170_cov_217.422535	10	90	138	1	80	0.0125000
NODE_302764_length_170_cov_217.422535	10	90	142	1	80	0.0125000
NODE_302764_length_170_cov_217.422535	10	90	144	1	80	0.0125000
NODE_302764_length_170_cov_217.422535	10	90	145	1	80	0.0125000
NODE_302764_length_170_cov_217.422535	10	90	146	2	80	0.0250000
NODE_302764_length_170_cov_217.422535	10	90	148	1	80	0.0125000
NODE_302764_length_170_cov_217.422535	10	90	149	1	80	0.0125000
NODE_302764_length_170_cov_217.422535	10	90	150	1	80	0.0125000
NODE_302764_length_170_cov_217.422535	10	90	160	2	80	0.0250000
NODE_302764_length_170_cov_217.422535	10	90	166	2	80	0.0250000
NODE_302764_length_170_cov_217.422535	10	90	167	2	80	0.0250000
NODE_302764_length_170_cov_217.422535	10	90	169	21	80	0.2625000
NODE_302764_length_170_cov_217.422535	10	90	24	1	80	0.0125000
NODE_302764_length_170_cov_217.422535	10	90	27	2	80	0.0250000
NODE_302764_length_170_cov_217.422535	10	90	29	1	80	0.0125000
NODE_302764_length_170_cov_217.422535	10	90	53	5	80	0.0625000
NODE_302764_length_170_cov_217.422535	10	90	71	5	80	0.0625000
NODE_302764_length_170_cov_217.422535	10	90	77	4	80	0.0500000
NODE_302764_length_170_cov_217.422535	10	90	81	1	80	0.0125000
NODE_302764_length_170_cov_217.422535	10	90	85	9	80	0.1125000
NODE_302764_length_170_cov_217.422535	10	90	87	3	80	0.0375000
NODE_302764_length_170_cov_217.422535	10	90	95	1	80	0.0125000
NODE_302764_length_170_cov_217.422535	10	90	113	4	80	0.0500000
NODE_302764_length_170_cov_217.422535	10	90	115	2	80	0.0250000
NODE_302764_length_170_cov_217.422535	10	90	117	1	80	0.0125000
NODE_302764_length_170_cov_217.422535	10	90	123	2	80	0.0250000
NODE_302764_length_170_cov_217.422535	10	90	130	1	80	0.0125000
NODE_302764_length_170_cov_217.422535	10	90	132	1	80	0.0125000
NODE_302764_length_170_cov_217.422535	10	90	134	1	80	0.0125000
NODE_302764_length_170_cov_217.422535	10	90	138	1	80	0.0125000
NODE_302764_length_170_cov_217.422535	10	90	142	1	80	0.0125000
NODE_302764_length_170_cov_217.422535	10	90	144	1	80	0.0125000
NODE_302764_length_170_cov_217.422535	10	90	145	1	80	0.0125000
NODE_302764_length_170_cov_217.422535	10	90	146	2	80	0.0250000
NODE_302764_length_170_cov_217.422535	10	90	148	1	80	0.0125000
NODE_302764_length_170_cov_217.422535	10	90	149	1	80	0.0125000
NODE_302764_length_170_cov_217.422535	10	90	150	1	80	0.0125000
NODE_302764_length_170_cov_217.422535	10	90	160	2	80	0.0250000
NODE_302764_length_170_cov_217.422535	10	90	166	2	80	0.0250000
NODE_302764_length_170_cov_217.422535	10	90	167	2	80	0.0250000
NODE_302764_length_170_cov_217.422535	10	90	169	21	80	0.2625000
NODE_302764_length_170_cov_217.422535	10	90	24	1	80	0.0125000
NODE_302764_length_170_cov_217.422535	10	90	27	2	80	0.0250000
NODE_302764_length_170_cov_217.422535	10	90	29	1	80	0.0125000
NODE_302764_length_170_cov_217.422535	10	90	53	5	80	0.0625000
NODE_302764_length_170_cov_217.422535	10	90	71	5	80	0.0625000
NODE_302764_length_170_cov_217.422535	10	90	77	4	80	0.0500000
NODE_302764_length_170_cov_217.422535	10	90	81	1	80	0.0125000
NODE_302764_length_170_cov_217.422535	10	90	85	9	80	0.1125000
NODE_302764_length_170_cov_217.422535	10	90	87	3	80	0.0375000
NODE_302764_length_170_cov_217.422535	10	90	95	1	80	0.0125000
NODE_302764_length_170_cov_217.422535	10	90	113	4	80	0.0500000
NODE_302764_length_170_cov_217.422535	10	90	115	2	80	0.0250000
NODE_302764_length_170_cov_217.422535	10	90	117	1	80	0.0125000
NODE_302764_length_170_cov_217.422535	10	90	123	2	80	0.0250000
NODE_302764_length_170_cov_217.422535	10	90	130	1	80	0.0125000
NODE_302764_length_170_cov_217.422535	10	90	132	1	80	0.0125000
NODE_302764_length_170_cov_217.422535	10	90	134	1	80	0.0125000
NODE_302764_length_170_cov_217.422535	10	90	138	1	80	0.0125000
NODE_302764_length_170_cov_217.422535	10	90	142	1	80	0.0125000
NODE_302764_length_170_cov_217.422535	10	90	144	1	80	0.0125000
NODE_302764_length_170_cov_217.422535	10	90	145	1	80	0.0125000
NODE_302764_length_170_cov_217.422535	10	90	146	2	80	0.0250000
NODE_302764_length_170_cov_217.422535	10	90	148	1	80	0.0125000
NODE_302764_length_170_cov_217.422535	10	90	149	1	80	0.0125000
NODE_302764_length_170_cov_217.422535	10	90	150	1	80	0.0125000
NODE_302764_length_170_cov_217.422535	10	90	160	2	80	0.0250000
NODE_302764_length_170_cov_217.422535	10	90	166	2	80	0.0250000
NODE_302764_length_170_cov_217.422535	10	90	167	2	80	0.0250000
NODE_302764_length_170_cov_217.422535	10	90	169	21	80	0.2625000
NODE_302764_length_170_cov_217.422535	10	90	24	1	80	0.0125000
NODE_302764_length_170_cov_217.422535	10	90	27	2	80	0.0250000
NODE_302764_length_170_cov_217.422535	10	90	29	1	80	0.0125000
NODE_302764_length_170_cov_217.422535	10	90	53	5	80	0.0625000
NODE_302764_length_170_cov_217.422535	10	90	71	5	80	0.0625000
NODE_302764_length_170_cov_217.422535	10	90	77	4	80	0.0500000
NODE_302764_length_170_cov_217.422535	10	90	81	1	80	0.0125000
NODE_302764_length_170_cov_217.422535	10	90	85	9	80	0.1125000
NODE_302764_length_170_cov_217.422535	10	90	87	3	80	0.0375000
NODE_302764_length_170_cov_217.422535	10	90	95	1	80	0.0125000
NODE_302764_length_170_cov_217.422535	10	90	113	4	80	0.0500000
NODE_302764_length_170_cov_217.422535	10	90	115	2	80	0.0250000
NODE_302764_length_170_cov_217.422535	10	90	117	1	80	0.0125000
NODE_302764_length_170_cov_217.422535	10	90	123	2	80	0.0250000
NODE_302764_length_170_cov_217.422535	10	90	130	1	80	0.0125000
NODE_302764_length_170_cov_217.422535	10	90	132	1	80	0.0125000
NODE_302764_length_170_cov_217.422535	10	90	134	1	80	0.0125000
NODE_302764_length_170_cov_217.422535	10	90	138	1	80	0.0125000
NODE_302764_length_170_cov_217.422535	10	90	142	1	80	0.0125000
NODE_302764_length_170_cov_217.422535	10	90	144	1	80	0.0125000
NODE_302764_length_170_cov_217.422535	10	90	145	1	80	0.0125000
NODE_302764_length_170_cov_217.422535	10	90	146	2	80	0.0250000
NODE_302764_length_170_cov_217.422535	10	90	148	1	80	0.0125000
NODE_302764_length_170_cov_217.422535	10	90	149	1	80	0.0125000
NODE_302764_length_170_cov_217.422535	10	90	150	1	80	0.0125000
NODE_302764_length_170_cov_217.422535	10	90	160	2	80	0.0250000
NODE_302764_length_170_cov_217.422535	10	90	166	2	80	0.0250000
NODE_302764_length_170_cov_217.422535	10	90	167	2	80	0.0250000
NODE_302764_length_170_cov_217.422535	10	90	169	21	80	0.2625000
NODE_302764_length_170_cov_217.422535	19	90	71	5	71	0.0704225
NODE_302764_length_170_cov_217.422535	19	90	77	4	71	0.0563380
NODE_302764_length_170_cov_217.422535	19	90	81	1	71	0.0140845
NODE_302764_length_170_cov_217.422535	19	90	85	9	71	0.1267606
NODE_302764_length_170_cov_217.422535	19	90	87	3	71	0.0422535
NODE_302764_length_170_cov_217.422535	19	90	95	1	71	0.0140845
NODE_302764_length_170_cov_217.422535	19	90	113	4	71	0.0563380
NODE_302764_length_170_cov_217.422535	19	90	115	2	71	0.0281690
NODE_302764_length_170_cov_217.422535	19	90	117	1	71	0.0140845
NODE_302764_length_170_cov_217.422535	19	90	123	2	71	0.0281690
NODE_302764_length_170_cov_217.422535	19	90	130	1	71	0.0140845
NODE_302764_length_170_cov_217.422535	19	90	132	1	71	0.0140845
NODE_302764_length_170_cov_217.422535	19	90	134	1	71	0.0140845
NODE_302764_length_170_cov_217.422535	19	90	138	1	71	0.0140845
NODE_302764_length_170_cov_217.422535	19	90	142	1	71	0.0140845
NODE_302764_length_170_cov_217.422535	19	90	144	1	71	0.0140845
NODE_302764_length_170_cov_217.422535	19	90	145	1	71	0.0140845
NODE_302764_length_170_cov_217.422535	19	90	146	2	71	0.0281690
NODE_302764_length_170_cov_217.422535	19	90	148	1	71	0.0140845
NODE_302764_length_170_cov_217.422535	19	90	149	1	71	0.0140845
NODE_302764_length_170_cov_217.422535	19	90	150	1	71	0.0140845
NODE_302764_length_170_cov_217.422535	19	90	160	2	71	0.0281690
NODE_302764_length_170_cov_217.422535	19	90	166	2	71	0.0281690
NODE_302764_length_170_cov_217.422535	19	90	167	2	71	0.0281690
NODE_302764_length_170_cov_217.422535	19	90	169	21	71	0.2957746
NODE_302764_length_170_cov_217.422535	63	126	155	5	63	0.0793651
NODE_302764_length_170_cov_217.422535	63	126	160	2	63	0.0317460
NODE_302764_length_170_cov_217.422535	63	126	164	1	63	0.0158730
NODE_302764_length_170_cov_217.422535	63	126	166	6	63	0.0952381
NODE_302764_length_170_cov_217.422535	63	126	167	9	63	0.1428571
NODE_302764_length_170_cov_217.422535	63	126	169	40	63	0.6349207
NODE_302764_length_170_cov_217.422535	63	126	155	5	63	0.0793651
NODE_302764_length_170_cov_217.422535	63	126	160	2	63	0.0317460
NODE_302764_length_170_cov_217.422535	63	126	164	1	63	0.0158730
NODE_302764_length_170_cov_217.422535	63	126	166	6	63	0.0952381
NODE_302764_length_170_cov_217.422535	63	126	167	9	63	0.1428571
NODE_302764_length_170_cov_217.422535	63	126	169	40	63	0.6349207
NODE_302768_length_170_cov_102.816901	23	86	12	3	63	0.0476190
NODE_302768_length_170_cov_102.816901	23	86	14	18	63	0.2857143
NODE_302768_length_170_cov_102.816901	23	86	16	13	63	0.2063492
NODE_302768_length_170_cov_102.816901	23	86	17	9	63	0.1428571
NODE_302768_length_170_cov_102.816901	23	86	18	20	63	0.3174603
NODE_302806_length_169_cov_47.757143	70	150	33	8	80	0.1000000
NODE_302806_length_169_cov_47.757143	70	150	35	19	80	0.2375000
NODE_302806_length_169_cov_47.757143	70	150	37	3	80	0.0375000
NODE_302806_length_169_cov_47.757143	70	150	39	1	80	0.0125000
NODE_302806_length_169_cov_47.757143	70	150	50	49	80	0.6125000
NODE_302869_length_168_cov_10.391304	66	99	0	33	33	1.0000000
NODE_302869_length_168_cov_10.391304	135	168	0	33	33	1.0000000
NODE_302966_length_166_cov_401.149254	31	109	59	2	78	0.0256410
NODE_302966_length_166_cov_401.149254	31	109	61	1	78	0.0128205
NODE_302966_length_166_cov_401.149254	31	109	63	1	78	0.0128205
NODE_302966_length_166_cov_401.149254	31	109	69	1	78	0.0128205
NODE_302966_length_166_cov_401.149254	31	109	77	2	78	0.0256410
NODE_302966_length_166_cov_401.149254	31	109	88	1	78	0.0128205
NODE_302966_length_166_cov_401.149254	31	109	113	1	78	0.0128205
NODE_302966_length_166_cov_401.149254	31	109	115	1	78	0.0128205
NODE_302966_length_166_cov_401.149254	31	109	126	1	78	0.0128205
NODE_302966_length_166_cov_401.149254	31	109	132	1	78	0.0128205
NODE_302966_length_166_cov_401.149254	31	109	141	1	78	0.0128205
NODE_302966_length_166_cov_401.149254	31	109	144	1	78	0.0128205
NODE_302966_length_166_cov_401.149254	31	109	145	1	78	0.0128205
NODE_302966_length_166_cov_401.149254	31	109	172	1	78	0.0128205
NODE_302966_length_166_cov_401.149254	31	109	174	1	78	0.0128205
NODE_302966_length_166_cov_401.149254	31	109	176	1	78	0.0128205
NODE_302966_length_166_cov_401.149254	31	109	178	1	78	0.0128205
NODE_302966_length_166_cov_401.149254	31	109	180	1	78	0.0128205
NODE_302966_length_166_cov_401.149254	31	109	184	3	78	0.0384615
NODE_302966_length_166_cov_401.149254	31	109	185	1	78	0.0128205
NODE_302966_length_166_cov_401.149254	31	109	195	1	78	0.0128205
NODE_302966_length_166_cov_401.149254	31	109	197	2	78	0.0256410
NODE_302966_length_166_cov_401.149254	31	109	199	1	78	0.0128205
NODE_302966_length_166_cov_401.149254	31	109	200	1	78	0.0128205
NODE_302966_length_166_cov_401.149254	31	109	201	1	78	0.0128205
NODE_302966_length_166_cov_401.149254	31	109	202	3	78	0.0384615
NODE_302966_length_166_cov_401.149254	31	109	204	1	78	0.0128205
NODE_302966_length_166_cov_401.149254	31	109	205	44	78	0.5641026
NODE_302966_length_166_cov_401.149254	82	157	59	2	75	0.0266667
NODE_302966_length_166_cov_401.149254	82	157	63	2	75	0.0266667
NODE_302966_length_166_cov_401.149254	82	157	67	3	75	0.0400000
NODE_302966_length_166_cov_401.149254	82	157	71	2	75	0.0266667
NODE_302966_length_166_cov_401.149254	82	157	75	1	75	0.0133333
NODE_302966_length_166_cov_401.149254	82	157	94	1	75	0.0133333
NODE_302966_length_166_cov_401.149254	82	157	106	3	75	0.0400000
NODE_302966_length_166_cov_401.149254	82	157	108	3	75	0.0400000
NODE_302966_length_166_cov_401.149254	82	157	110	1	75	0.0133333
NODE_302966_length_166_cov_401.149254	82	157	112	2	75	0.0266667
NODE_302966_length_166_cov_401.149254	82	157	115	1	75	0.0133333
NODE_302966_length_166_cov_401.149254	82	157	119	3	75	0.0400000
NODE_302966_length_166_cov_401.149254	82	157	125	1	75	0.0133333
NODE_302966_length_166_cov_401.149254	82	157	136	1	75	0.0133333
NODE_302966_length_166_cov_401.149254	82	157	138	1	75	0.0133333
NODE_302966_length_166_cov_401.149254	82	157	139	1	75	0.0133333
NODE_302966_length_166_cov_401.149254	82	157	147	3	75	0.0400000
NODE_302966_length_166_cov_401.149254	82	157	151	4	75	0.0533333
NODE_302966_length_166_cov_401.149254	82	157	164	1	75	0.0133333
NODE_302966_length_166_cov_401.149254	82	157	172	2	75	0.0266667
NODE_302966_length_166_cov_401.149254	82	157	176	2	75	0.0266667
NODE_302966_length_166_cov_401.149254	82	157	184	2	75	0.0266667
NODE_302966_length_166_cov_401.149254	82	157	188	2	75	0.0266667
NODE_302966_length_166_cov_401.149254	82	157	192	1	75	0.0133333
NODE_302966_length_166_cov_401.149254	82	157	194	1	75	0.0133333
NODE_302966_length_166_cov_401.149254	82	157	196	1	75	0.0133333
NODE_302966_length_166_cov_401.149254	82	157	202	4	75	0.0533333
NODE_302966_length_166_cov_401.149254	82	157	204	1	75	0.0133333
NODE_302966_length_166_cov_401.149254	82	157	205	23	75	0.3066667
NODE_302974_length_166_cov_123.223881	46	97	4	6	51	0.1176471
NODE_302974_length_166_cov_123.223881	46	97	6	2	51	0.0392157
NODE_302974_length_166_cov_123.223881	46	97	8	43	51	0.8431373
NODE_303071_length_164_cov_154.076923	0	75	0	75	75	1.0000000
NODE_303071_length_164_cov_154.076923	48	128	0	80	80	1.0000000
NODE_303074_length_164_cov_69.369231	0	64	0	10	64	0.1562500
NODE_303074_length_164_cov_69.369231	0	64	2	21	64	0.3281250
NODE_303074_length_164_cov_69.369231	0	64	6	3	64	0.0468750
NODE_303074_length_164_cov_69.369231	0	64	8	30	64	0.4687500
NODE_303079_length_164_cov_43.923077	36	100	64	4	64	0.0625000
NODE_303079_length_164_cov_43.923077	36	100	66	60	64	0.9375000
NODE_303079_length_164_cov_43.923077	36	100	64	4	64	0.0625000
NODE_303079_length_164_cov_43.923077	36	100	66	60	64	0.9375000
NODE_303079_length_164_cov_43.923077	73	153	23	1	80	0.0125000
NODE_303079_length_164_cov_43.923077	73	153	25	2	80	0.0250000
NODE_303079_length_164_cov_43.923077	73	153	27	4	80	0.0500000
NODE_303079_length_164_cov_43.923077	73	153	35	1	80	0.0125000
NODE_303079_length_164_cov_43.923077	73	153	39	1	80	0.0125000
NODE_303079_length_164_cov_43.923077	73	153	40	1	80	0.0125000
NODE_303079_length_164_cov_43.923077	73	153	41	5	80	0.0625000
NODE_303079_length_164_cov_43.923077	73	153	43	2	80	0.0250000
NODE_303079_length_164_cov_43.923077	73	153	44	3	80	0.0375000
NODE_303079_length_164_cov_43.923077	73	153	48	6	80	0.0750000
NODE_303079_length_164_cov_43.923077	73	153	55	4	80	0.0500000
NODE_303079_length_164_cov_43.923077	73	153	58	1	80	0.0125000
NODE_303079_length_164_cov_43.923077	73	153	60	1	80	0.0125000
NODE_303079_length_164_cov_43.923077	73	153	62	11	80	0.1375000
NODE_303079_length_164_cov_43.923077	73	153	66	37	80	0.4625000
NODE_303079_length_164_cov_43.923077	73	153	23	1	80	0.0125000
NODE_303079_length_164_cov_43.923077	73	153	25	2	80	0.0250000
NODE_303079_length_164_cov_43.923077	73	153	27	4	80	0.0500000
NODE_303079_length_164_cov_43.923077	73	153	35	1	80	0.0125000
NODE_303079_length_164_cov_43.923077	73	153	39	1	80	0.0125000
NODE_303079_length_164_cov_43.923077	73	153	40	1	80	0.0125000
NODE_303079_length_164_cov_43.923077	73	153	41	5	80	0.0625000
NODE_303079_length_164_cov_43.923077	73	153	43	2	80	0.0250000
NODE_303079_length_164_cov_43.923077	73	153	44	3	80	0.0375000
NODE_303079_length_164_cov_43.923077	73	153	48	6	80	0.0750000
NODE_303079_length_164_cov_43.923077	73	153	55	4	80	0.0500000
NODE_303079_length_164_cov_43.923077	73	153	58	1	80	0.0125000
NODE_303079_length_164_cov_43.923077	73	153	60	1	80	0.0125000
NODE_303079_length_164_cov_43.923077	73	153	62	11	80	0.1375000
NODE_303079_length_164_cov_43.923077	73	153	66	37	80	0.4625000
NODE_303079_length_164_cov_43.923077	73	153	23	1	80	0.0125000
NODE_303079_length_164_cov_43.923077	73	153	25	2	80	0.0250000
NODE_303079_length_164_cov_43.923077	73	153	27	4	80	0.0500000
NODE_303079_length_164_cov_43.923077	73	153	35	1	80	0.0125000
NODE_303079_length_164_cov_43.923077	73	153	39	1	80	0.0125000
NODE_303079_length_164_cov_43.923077	73	153	40	1	80	0.0125000
NODE_303079_length_164_cov_43.923077	73	153	41	5	80	0.0625000
NODE_303079_length_164_cov_43.923077	73	153	43	2	80	0.0250000
NODE_303079_length_164_cov_43.923077	73	153	44	3	80	0.0375000
NODE_303079_length_164_cov_43.923077	73	153	48	6	80	0.0750000
NODE_303079_length_164_cov_43.923077	73	153	55	4	80	0.0500000
NODE_303079_length_164_cov_43.923077	73	153	58	1	80	0.0125000
NODE_303079_length_164_cov_43.923077	73	153	60	1	80	0.0125000
NODE_303079_length_164_cov_43.923077	73	153	62	11	80	0.1375000
NODE_303079_length_164_cov_43.923077	73	153	66	37	80	0.4625000
NODE_303079_length_164_cov_43.923077	73	153	23	1	80	0.0125000
NODE_303079_length_164_cov_43.923077	73	153	25	2	80	0.0250000
NODE_303079_length_164_cov_43.923077	73	153	27	4	80	0.0500000
NODE_303079_length_164_cov_43.923077	73	153	35	1	80	0.0125000
NODE_303079_length_164_cov_43.923077	73	153	39	1	80	0.0125000
NODE_303079_length_164_cov_43.923077	73	153	40	1	80	0.0125000
NODE_303079_length_164_cov_43.923077	73	153	41	5	80	0.0625000
NODE_303079_length_164_cov_43.923077	73	153	43	2	80	0.0250000
NODE_303079_length_164_cov_43.923077	73	153	44	3	80	0.0375000
NODE_303079_length_164_cov_43.923077	73	153	48	6	80	0.0750000
NODE_303079_length_164_cov_43.923077	73	153	55	4	80	0.0500000
NODE_303079_length_164_cov_43.923077	73	153	58	1	80	0.0125000
NODE_303079_length_164_cov_43.923077	73	153	60	1	80	0.0125000
NODE_303079_length_164_cov_43.923077	73	153	62	11	80	0.1375000
NODE_303079_length_164_cov_43.923077	73	153	66	37	80	0.4625000
NODE_303079_length_164_cov_43.923077	73	153	23	1	80	0.0125000
NODE_303079_length_164_cov_43.923077	73	153	25	2	80	0.0250000
NODE_303079_length_164_cov_43.923077	73	153	27	4	80	0.0500000
NODE_303079_length_164_cov_43.923077	73	153	35	1	80	0.0125000
NODE_303079_length_164_cov_43.923077	73	153	39	1	80	0.0125000
NODE_303079_length_164_cov_43.923077	73	153	40	1	80	0.0125000
NODE_303079_length_164_cov_43.923077	73	153	41	5	80	0.0625000
NODE_303079_length_164_cov_43.923077	73	153	43	2	80	0.0250000
NODE_303079_length_164_cov_43.923077	73	153	44	3	80	0.0375000
NODE_303079_length_164_cov_43.923077	73	153	48	6	80	0.0750000
NODE_303079_length_164_cov_43.923077	73	153	55	4	80	0.0500000
NODE_303079_length_164_cov_43.923077	73	153	58	1	80	0.0125000
NODE_303079_length_164_cov_43.923077	73	153	60	1	80	0.0125000
NODE_303079_length_164_cov_43.923077	73	153	62	11	80	0.1375000
NODE_303079_length_164_cov_43.923077	73	153	66	37	80	0.4625000
NODE_303079_length_164_cov_43.923077	73	144	40	1	71	0.0140845
NODE_303079_length_164_cov_43.923077	73	144	41	5	71	0.0704225
NODE_303079_length_164_cov_43.923077	73	144	43	2	71	0.0281690
NODE_303079_length_164_cov_43.923077	73	144	44	3	71	0.0422535
NODE_303079_length_164_cov_43.923077	73	144	48	6	71	0.0845070
NODE_303079_length_164_cov_43.923077	73	144	55	4	71	0.0563380
NODE_303079_length_164_cov_43.923077	73	144	58	1	71	0.0140845
NODE_303079_length_164_cov_43.923077	73	144	60	1	71	0.0140845
NODE_303079_length_164_cov_43.923077	73	144	62	11	71	0.1549296
NODE_303079_length_164_cov_43.923077	73	144	66	37	71	0.5211267
NODE_303135_length_163_cov_480.593750	0	40	0	2	40	0.0500000
NODE_303135_length_163_cov_480.593750	0	40	2	2	40	0.0500000
NODE_303135_length_163_cov_480.593750	0	40	4	3	40	0.0750000
NODE_303135_length_163_cov_480.593750	0	40	10	2	40	0.0500000
NODE_303135_length_163_cov_480.593750	0	40	15	5	40	0.1250000
NODE_303135_length_163_cov_480.593750	0	40	19	1	40	0.0250000
NODE_303135_length_163_cov_480.593750	0	40	21	2	40	0.0500000
NODE_303135_length_163_cov_480.593750	0	40	25	3	40	0.0750000
NODE_303135_length_163_cov_480.593750	0	40	27	1	40	0.0250000
NODE_303135_length_163_cov_480.593750	0	40	29	1	40	0.0250000
NODE_303135_length_163_cov_480.593750	0	40	31	5	40	0.1250000
NODE_303135_length_163_cov_480.593750	0	40	33	4	40	0.1000000
NODE_303135_length_163_cov_480.593750	0	40	35	1	40	0.0250000
NODE_303135_length_163_cov_480.593750	0	40	39	1	40	0.0250000
NODE_303135_length_163_cov_480.593750	0	40	41	1	40	0.0250000
NODE_303135_length_163_cov_480.593750	0	40	43	4	40	0.1000000
NODE_303135_length_163_cov_480.593750	0	40	45	2	40	0.0500000
NODE_303136_length_163_cov_368.000000	24	96	10	1	72	0.0138889
NODE_303136_length_163_cov_368.000000	24	96	14	5	72	0.0694444
NODE_303136_length_163_cov_368.000000	24	96	16	6	72	0.0833333
NODE_303136_length_163_cov_368.000000	24	96	18	1	72	0.0138889
NODE_303136_length_163_cov_368.000000	24	96	20	59	72	0.8194444
NODE_303138_length_163_cov_319.843750	0	68	3	2	68	0.0294118
NODE_303138_length_163_cov_319.843750	0	68	5	1	68	0.0147059
NODE_303138_length_163_cov_319.843750	0	68	6	1	68	0.0147059
NODE_303138_length_163_cov_319.843750	0	68	8	1	68	0.0147059
NODE_303138_length_163_cov_319.843750	0	68	10	2	68	0.0294118
NODE_303138_length_163_cov_319.843750	0	68	12	6	68	0.0882353
NODE_303138_length_163_cov_319.843750	0	68	14	3	68	0.0441176
NODE_303138_length_163_cov_319.843750	0	68	16	4	68	0.0588235
NODE_303138_length_163_cov_319.843750	0	68	18	8	68	0.1176471
NODE_303138_length_163_cov_319.843750	0	68	20	1	68	0.0147059
NODE_303138_length_163_cov_319.843750	0	68	22	5	68	0.0735294
NODE_303138_length_163_cov_319.843750	0	68	24	2	68	0.0294118
NODE_303138_length_163_cov_319.843750	0	68	26	2	68	0.0294118
NODE_303138_length_163_cov_319.843750	0	68	28	1	68	0.0147059
NODE_303138_length_163_cov_319.843750	0	68	32	5	68	0.0735294
NODE_303138_length_163_cov_319.843750	0	68	34	10	68	0.1470588
NODE_303138_length_163_cov_319.843750	0	68	36	3	68	0.0441176
NODE_303138_length_163_cov_319.843750	0	68	38	11	68	0.1617647
NODE_303139_length_163_cov_198.078125	34	109	104	12	75	0.1600000
NODE_303139_length_163_cov_198.078125	34	109	106	3	75	0.0400000
NODE_303139_length_163_cov_198.078125	34	109	107	1	75	0.0133333
NODE_303139_length_163_cov_198.078125	34	109	108	59	75	0.7866667
NODE_303139_length_163_cov_198.078125	34	114	104	12	80	0.1500000
NODE_303139_length_163_cov_198.078125	34	114	106	3	80	0.0375000
NODE_303139_length_163_cov_198.078125	34	114	107	1	80	0.0125000
NODE_303139_length_163_cov_198.078125	34	114	108	64	80	0.8000000
NODE_303139_length_163_cov_198.078125	35	110	104	11	75	0.1466667
NODE_303139_length_163_cov_198.078125	35	110	106	3	75	0.0400000
NODE_303139_length_163_cov_198.078125	35	110	107	1	75	0.0133333
NODE_303139_length_163_cov_198.078125	35	110	108	60	75	0.8000000
NODE_303139_length_163_cov_198.078125	87	163	22	1	76	0.0131579
NODE_303139_length_163_cov_198.078125	87	163	25	1	76	0.0131579
NODE_303139_length_163_cov_198.078125	87	163	27	10	76	0.1315790
NODE_303139_length_163_cov_198.078125	87	163	64	1	76	0.0131579
NODE_303139_length_163_cov_198.078125	87	163	77	1	76	0.0131579
NODE_303139_length_163_cov_198.078125	87	163	79	7	76	0.0921053
NODE_303139_length_163_cov_198.078125	87	163	89	3	76	0.0394737
NODE_303139_length_163_cov_198.078125	87	163	91	6	76	0.0789474
NODE_303139_length_163_cov_198.078125	87	163	95	1	76	0.0131579
NODE_303139_length_163_cov_198.078125	87	163	96	2	76	0.0263158
NODE_303139_length_163_cov_198.078125	87	163	100	7	76	0.0921053
NODE_303139_length_163_cov_198.078125	87	163	102	1	76	0.0131579
NODE_303139_length_163_cov_198.078125	87	163	106	1	76	0.0131579
NODE_303139_length_163_cov_198.078125	87	163	108	34	76	0.4473684
NODE_303139_length_163_cov_198.078125	87	163	22	1	76	0.0131579
NODE_303139_length_163_cov_198.078125	87	163	25	1	76	0.0131579
NODE_303139_length_163_cov_198.078125	87	163	27	10	76	0.1315790
NODE_303139_length_163_cov_198.078125	87	163	64	1	76	0.0131579
NODE_303139_length_163_cov_198.078125	87	163	77	1	76	0.0131579
NODE_303139_length_163_cov_198.078125	87	163	79	7	76	0.0921053
NODE_303139_length_163_cov_198.078125	87	163	89	3	76	0.0394737
NODE_303139_length_163_cov_198.078125	87	163	91	6	76	0.0789474
NODE_303139_length_163_cov_198.078125	87	163	95	1	76	0.0131579
NODE_303139_length_163_cov_198.078125	87	163	96	2	76	0.0263158
NODE_303139_length_163_cov_198.078125	87	163	100	7	76	0.0921053
NODE_303139_length_163_cov_198.078125	87	163	102	1	76	0.0131579
NODE_303139_length_163_cov_198.078125	87	163	106	1	76	0.0131579
NODE_303139_length_163_cov_198.078125	87	163	108	34	76	0.4473684
NODE_303139_length_163_cov_198.078125	87	163	22	1	76	0.0131579
NODE_303139_length_163_cov_198.078125	87	163	25	1	76	0.0131579
NODE_303139_length_163_cov_198.078125	87	163	27	10	76	0.1315790
NODE_303139_length_163_cov_198.078125	87	163	64	1	76	0.0131579
NODE_303139_length_163_cov_198.078125	87	163	77	1	76	0.0131579
NODE_303139_length_163_cov_198.078125	87	163	79	7	76	0.0921053
NODE_303139_length_163_cov_198.078125	87	163	89	3	76	0.0394737
NODE_303139_length_163_cov_198.078125	87	163	91	6	76	0.0789474
NODE_303139_length_163_cov_198.078125	87	163	95	1	76	0.0131579
NODE_303139_length_163_cov_198.078125	87	163	96	2	76	0.0263158
NODE_303139_length_163_cov_198.078125	87	163	100	7	76	0.0921053
NODE_303139_length_163_cov_198.078125	87	163	102	1	76	0.0131579
NODE_303139_length_163_cov_198.078125	87	163	106	1	76	0.0131579
NODE_303139_length_163_cov_198.078125	87	163	108	34	76	0.4473684
NODE_303231_length_162_cov_421.047619	7	56	62	1	49	0.0204082
NODE_303231_length_162_cov_421.047619	7	56	66	2	49	0.0408163
NODE_303231_length_162_cov_421.047619	7	56	70	1	49	0.0204082
NODE_303231_length_162_cov_421.047619	7	56	72	1	49	0.0204082
NODE_303231_length_162_cov_421.047619	7	56	74	1	49	0.0204082
NODE_303231_length_162_cov_421.047619	7	56	76	2	49	0.0408163
NODE_303231_length_162_cov_421.047619	7	56	85	1	49	0.0204082
NODE_303231_length_162_cov_421.047619	7	56	86	2	49	0.0408163
NODE_303231_length_162_cov_421.047619	7	56	104	2	49	0.0408163
NODE_303231_length_162_cov_421.047619	7	56	110	3	49	0.0612245
NODE_303231_length_162_cov_421.047619	7	56	115	1	49	0.0204082
NODE_303231_length_162_cov_421.047619	7	56	122	2	49	0.0408163
NODE_303231_length_162_cov_421.047619	7	56	124	1	49	0.0204082
NODE_303231_length_162_cov_421.047619	7	56	128	2	49	0.0408163
NODE_303231_length_162_cov_421.047619	7	56	143	1	49	0.0204082
NODE_303231_length_162_cov_421.047619	7	56	144	1	49	0.0204082
NODE_303231_length_162_cov_421.047619	7	56	146	4	49	0.0816327
NODE_303231_length_162_cov_421.047619	7	56	152	1	49	0.0204082
NODE_303231_length_162_cov_421.047619	7	56	153	1	49	0.0204082
NODE_303231_length_162_cov_421.047619	7	56	155	1	49	0.0204082
NODE_303231_length_162_cov_421.047619	7	56	159	3	49	0.0612245
NODE_303231_length_162_cov_421.047619	7	56	161	1	49	0.0204082
NODE_303231_length_162_cov_421.047619	7	56	165	1	49	0.0204082
NODE_303231_length_162_cov_421.047619	7	56	175	1	49	0.0204082
NODE_303231_length_162_cov_421.047619	7	56	177	2	49	0.0408163
NODE_303231_length_162_cov_421.047619	7	56	194	1	49	0.0204082
NODE_303231_length_162_cov_421.047619	7	56	195	1	49	0.0204082
NODE_303231_length_162_cov_421.047619	7	56	200	3	49	0.0612245
NODE_303231_length_162_cov_421.047619	7	56	204	1	49	0.0204082
NODE_303231_length_162_cov_421.047619	7	56	205	1	49	0.0204082
NODE_303231_length_162_cov_421.047619	7	56	209	2	49	0.0408163
NODE_303231_length_162_cov_421.047619	7	56	211	1	49	0.0204082
NODE_303231_length_162_cov_421.047619	29	90	143	1	61	0.0163934
NODE_303231_length_162_cov_421.047619	29	90	144	1	61	0.0163934
NODE_303231_length_162_cov_421.047619	29	90	146	4	61	0.0655738
NODE_303231_length_162_cov_421.047619	29	90	152	1	61	0.0163934
NODE_303231_length_162_cov_421.047619	29	90	153	1	61	0.0163934
NODE_303231_length_162_cov_421.047619	29	90	155	1	61	0.0163934
NODE_303231_length_162_cov_421.047619	29	90	159	3	61	0.0491803
NODE_303231_length_162_cov_421.047619	29	90	161	1	61	0.0163934
NODE_303231_length_162_cov_421.047619	29	90	165	1	61	0.0163934
NODE_303231_length_162_cov_421.047619	29	90	175	1	61	0.0163934
NODE_303231_length_162_cov_421.047619	29	90	177	2	61	0.0327869
NODE_303231_length_162_cov_421.047619	29	90	194	1	61	0.0163934
NODE_303231_length_162_cov_421.047619	29	90	195	1	61	0.0163934
NODE_303231_length_162_cov_421.047619	29	90	200	3	61	0.0491803
NODE_303231_length_162_cov_421.047619	29	90	204	1	61	0.0163934
NODE_303231_length_162_cov_421.047619	29	90	205	1	61	0.0163934
NODE_303231_length_162_cov_421.047619	29	90	209	2	61	0.0327869
NODE_303231_length_162_cov_421.047619	29	90	211	1	61	0.0163934
NODE_303231_length_162_cov_421.047619	29	90	213	34	61	0.5573770
NODE_303231_length_162_cov_421.047619	29	92	143	1	63	0.0158730
NODE_303231_length_162_cov_421.047619	29	92	144	1	63	0.0158730
NODE_303231_length_162_cov_421.047619	29	92	146	4	63	0.0634921
NODE_303231_length_162_cov_421.047619	29	92	152	1	63	0.0158730
NODE_303231_length_162_cov_421.047619	29	92	153	1	63	0.0158730
NODE_303231_length_162_cov_421.047619	29	92	155	1	63	0.0158730
NODE_303231_length_162_cov_421.047619	29	92	159	3	63	0.0476190
NODE_303231_length_162_cov_421.047619	29	92	161	1	63	0.0158730
NODE_303231_length_162_cov_421.047619	29	92	165	1	63	0.0158730
NODE_303231_length_162_cov_421.047619	29	92	175	1	63	0.0158730
NODE_303231_length_162_cov_421.047619	29	92	177	2	63	0.0317460
NODE_303231_length_162_cov_421.047619	29	92	194	1	63	0.0158730
NODE_303231_length_162_cov_421.047619	29	92	195	1	63	0.0158730
NODE_303231_length_162_cov_421.047619	29	92	200	3	63	0.0476190
NODE_303231_length_162_cov_421.047619	29	92	204	1	63	0.0158730
NODE_303231_length_162_cov_421.047619	29	92	205	1	63	0.0158730
NODE_303231_length_162_cov_421.047619	29	92	209	2	63	0.0317460
NODE_303231_length_162_cov_421.047619	29	92	211	1	63	0.0158730
NODE_303231_length_162_cov_421.047619	29	92	213	36	63	0.5714286
NODE_303231_length_162_cov_421.047619	29	92	143	1	63	0.0158730
NODE_303231_length_162_cov_421.047619	29	92	144	1	63	0.0158730
NODE_303231_length_162_cov_421.047619	29	92	146	4	63	0.0634921
NODE_303231_length_162_cov_421.047619	29	92	152	1	63	0.0158730
NODE_303231_length_162_cov_421.047619	29	92	153	1	63	0.0158730
NODE_303231_length_162_cov_421.047619	29	92	155	1	63	0.0158730
NODE_303231_length_162_cov_421.047619	29	92	159	3	63	0.0476190
NODE_303231_length_162_cov_421.047619	29	92	161	1	63	0.0158730
NODE_303231_length_162_cov_421.047619	29	92	165	1	63	0.0158730
NODE_303231_length_162_cov_421.047619	29	92	175	1	63	0.0158730
NODE_303231_length_162_cov_421.047619	29	92	177	2	63	0.0317460
NODE_303231_length_162_cov_421.047619	29	92	194	1	63	0.0158730
NODE_303231_length_162_cov_421.047619	29	92	195	1	63	0.0158730
NODE_303231_length_162_cov_421.047619	29	92	200	3	63	0.0476190
NODE_303231_length_162_cov_421.047619	29	92	204	1	63	0.0158730
NODE_303231_length_162_cov_421.047619	29	92	205	1	63	0.0158730
NODE_303231_length_162_cov_421.047619	29	92	209	2	63	0.0317460
NODE_303231_length_162_cov_421.047619	29	92	211	1	63	0.0158730
NODE_303231_length_162_cov_421.047619	29	92	213	36	63	0.5714286
NODE_303231_length_162_cov_421.047619	29	92	143	1	63	0.0158730
NODE_303231_length_162_cov_421.047619	29	92	144	1	63	0.0158730
NODE_303231_length_162_cov_421.047619	29	92	146	4	63	0.0634921
NODE_303231_length_162_cov_421.047619	29	92	152	1	63	0.0158730
NODE_303231_length_162_cov_421.047619	29	92	153	1	63	0.0158730
NODE_303231_length_162_cov_421.047619	29	92	155	1	63	0.0158730
NODE_303231_length_162_cov_421.047619	29	92	159	3	63	0.0476190
NODE_303231_length_162_cov_421.047619	29	92	161	1	63	0.0158730
NODE_303231_length_162_cov_421.047619	29	92	165	1	63	0.0158730
NODE_303231_length_162_cov_421.047619	29	92	175	1	63	0.0158730
NODE_303231_length_162_cov_421.047619	29	92	177	2	63	0.0317460
NODE_303231_length_162_cov_421.047619	29	92	194	1	63	0.0158730
NODE_303231_length_162_cov_421.047619	29	92	195	1	63	0.0158730
NODE_303231_length_162_cov_421.047619	29	92	200	3	63	0.0476190
NODE_303231_length_162_cov_421.047619	29	92	204	1	63	0.0158730
NODE_303231_length_162_cov_421.047619	29	92	205	1	63	0.0158730
NODE_303231_length_162_cov_421.047619	29	92	209	2	63	0.0317460
NODE_303231_length_162_cov_421.047619	29	92	211	1	63	0.0158730
NODE_303231_length_162_cov_421.047619	29	92	213	36	63	0.5714286
NODE_303250_length_162_cov_45.380952	63	127	45	2	64	0.0312500
NODE_303250_length_162_cov_45.380952	63	127	51	4	64	0.0625000
NODE_303250_length_162_cov_45.380952	63	127	56	2	64	0.0312500
NODE_303250_length_162_cov_45.380952	63	127	57	8	64	0.1250000
NODE_303250_length_162_cov_45.380952	63	127	59	48	64	0.7500000
NODE_303250_length_162_cov_45.380952	63	127	45	2	64	0.0312500
NODE_303250_length_162_cov_45.380952	63	127	51	4	64	0.0625000
NODE_303250_length_162_cov_45.380952	63	127	56	2	64	0.0312500
NODE_303250_length_162_cov_45.380952	63	127	57	8	64	0.1250000
NODE_303250_length_162_cov_45.380952	63	127	59	48	64	0.7500000
NODE_303250_length_162_cov_45.380952	100	162	0	6	62	0.0967742
NODE_303250_length_162_cov_45.380952	100	162	4	7	62	0.1129032
NODE_303250_length_162_cov_45.380952	100	162	14	1	62	0.0161290
NODE_303250_length_162_cov_45.380952	100	162	22	7	62	0.1129032
NODE_303250_length_162_cov_45.380952	100	162	28	3	62	0.0483871
NODE_303250_length_162_cov_45.380952	100	162	31	2	62	0.0322581
NODE_303250_length_162_cov_45.380952	100	162	39	8	62	0.1290323
NODE_303250_length_162_cov_45.380952	100	162	43	1	62	0.0161290
NODE_303250_length_162_cov_45.380952	100	162	45	2	62	0.0322581
NODE_303250_length_162_cov_45.380952	100	162	51	4	62	0.0645161
NODE_303250_length_162_cov_45.380952	100	162	56	2	62	0.0322581
NODE_303250_length_162_cov_45.380952	100	162	57	8	62	0.1290323
NODE_303250_length_162_cov_45.380952	100	162	59	11	62	0.1774193
NODE_303301_length_161_cov_1483.177419	51	131	50	8	80	0.1000000
NODE_303301_length_161_cov_1483.177419	51	131	54	1	80	0.0125000
NODE_303301_length_161_cov_1483.177419	51	131	56	5	80	0.0625000
NODE_303301_length_161_cov_1483.177419	51	131	58	1	80	0.0125000
NODE_303301_length_161_cov_1483.177419	51	131	60	2	80	0.0250000
NODE_303301_length_161_cov_1483.177419	51	131	64	4	80	0.0500000
NODE_303301_length_161_cov_1483.177419	51	131	66	2	80	0.0250000
NODE_303301_length_161_cov_1483.177419	51	131	68	5	80	0.0625000
NODE_303301_length_161_cov_1483.177419	51	131	70	52	80	0.6500000
NODE_303301_length_161_cov_1483.177419	104	161	3	1	57	0.0175439
NODE_303301_length_161_cov_1483.177419	104	161	4	2	57	0.0350877
NODE_303301_length_161_cov_1483.177419	104	161	6	4	57	0.0701754
NODE_303301_length_161_cov_1483.177419	104	161	10	2	57	0.0350877
NODE_303301_length_161_cov_1483.177419	104	161	14	1	57	0.0175439
NODE_303301_length_161_cov_1483.177419	104	161	16	2	57	0.0350877
NODE_303301_length_161_cov_1483.177419	104	161	30	2	57	0.0350877
NODE_303301_length_161_cov_1483.177419	104	161	38	3	57	0.0526316
NODE_303301_length_161_cov_1483.177419	104	161	40	2	57	0.0350877
NODE_303301_length_161_cov_1483.177419	104	161	42	5	57	0.0877193
NODE_303301_length_161_cov_1483.177419	104	161	44	2	57	0.0350877
NODE_303301_length_161_cov_1483.177419	104	161	48	1	57	0.0175439
NODE_303301_length_161_cov_1483.177419	104	161	50	11	57	0.1929825
NODE_303301_length_161_cov_1483.177419	104	161	54	1	57	0.0175439
NODE_303301_length_161_cov_1483.177419	104	161	56	5	57	0.0877193
NODE_303301_length_161_cov_1483.177419	104	161	58	1	57	0.0175439
NODE_303301_length_161_cov_1483.177419	104	161	60	2	57	0.0350877
NODE_303301_length_161_cov_1483.177419	104	161	64	2	57	0.0350877
NODE_303301_length_161_cov_1483.177419	104	161	66	2	57	0.0350877
NODE_303301_length_161_cov_1483.177419	104	161	68	5	57	0.0877193
NODE_303301_length_161_cov_1483.177419	104	161	70	1	57	0.0175439
NODE_303312_length_161_cov_71.500000	33	110	6	77	77	1.0000000
NODE_303312_length_161_cov_71.500000	33	110	6	77	77	1.0000000
NODE_303312_length_161_cov_71.500000	33	110	6	77	77	1.0000000
NODE_303312_length_161_cov_71.500000	33	110	6	77	77	1.0000000
NODE_303312_length_161_cov_71.500000	83	149	0	20	66	0.3030303
NODE_303312_length_161_cov_71.500000	83	149	2	4	66	0.0606061
NODE_303312_length_161_cov_71.500000	83	149	4	6	66	0.0909091
NODE_303312_length_161_cov_71.500000	83	149	6	36	66	0.5454546
NODE_303312_length_161_cov_71.500000	83	161	0	32	78	0.4102564
NODE_303312_length_161_cov_71.500000	83	161	2	4	78	0.0512821
NODE_303312_length_161_cov_71.500000	83	161	4	6	78	0.0769231
NODE_303312_length_161_cov_71.500000	83	161	6	36	78	0.4615385
NODE_303312_length_161_cov_71.500000	86	161	0	32	75	0.4266667
NODE_303312_length_161_cov_71.500000	86	161	2	4	75	0.0533333
NODE_303312_length_161_cov_71.500000	86	161	4	6	75	0.0800000
NODE_303312_length_161_cov_71.500000	86	161	6	33	75	0.4400000
NODE_303312_length_161_cov_71.500000	86	161	0	32	75	0.4266667
NODE_303312_length_161_cov_71.500000	86	161	2	4	75	0.0533333
NODE_303312_length_161_cov_71.500000	86	161	4	6	75	0.0800000
NODE_303312_length_161_cov_71.500000	86	161	6	33	75	0.4400000
NODE_303312_length_161_cov_71.500000	88	161	0	32	73	0.4383562
NODE_303312_length_161_cov_71.500000	88	161	2	4	73	0.0547945
NODE_303312_length_161_cov_71.500000	88	161	4	6	73	0.0821918
NODE_303312_length_161_cov_71.500000	88	161	6	31	73	0.4246575
NODE_303321_length_161_cov_29.758065	0	80	0	1	80	0.0125000
NODE_303321_length_161_cov_29.758065	0	80	6	23	80	0.2875000
NODE_303321_length_161_cov_29.758065	0	80	10	27	80	0.3375000
NODE_303321_length_161_cov_29.758065	0	80	12	29	80	0.3625000
NODE_303381_length_160_cov_143.573770	45	125	10	1	80	0.0125000
NODE_303381_length_160_cov_143.573770	45	125	12	16	80	0.2000000
NODE_303381_length_160_cov_143.573770	45	125	22	63	80	0.7875000
NODE_303381_length_160_cov_143.573770	93	160	0	14	67	0.2089552
NODE_303381_length_160_cov_143.573770	93	160	4	14	67	0.2089552
NODE_303381_length_160_cov_143.573770	93	160	6	2	67	0.0298507
NODE_303381_length_160_cov_143.573770	93	160	8	3	67	0.0447761
NODE_303381_length_160_cov_143.573770	93	160	10	3	67	0.0447761
NODE_303381_length_160_cov_143.573770	93	160	12	16	67	0.2388060
NODE_303381_length_160_cov_143.573770	93	160	22	15	67	0.2238806
NODE_303381_length_160_cov_143.573770	98	120	12	12	22	0.5454546
NODE_303381_length_160_cov_143.573770	98	120	22	10	22	0.4545455
NODE_303388_length_160_cov_58.245902	0	45	2	6	45	0.1333333
NODE_303388_length_160_cov_58.245902	0	45	4	4	45	0.0888889
NODE_303388_length_160_cov_58.245902	0	45	6	35	45	0.7777778
NODE_303431_length_159_cov_182.016667	71	156	2	20	85	0.2352941
NODE_303431_length_159_cov_182.016667	71	156	4	1	85	0.0117647
NODE_303431_length_159_cov_182.016667	71	156	8	64	85	0.7529412
NODE_303431_length_159_cov_182.016667	71	156	2	20	85	0.2352941
NODE_303431_length_159_cov_182.016667	71	156	4	1	85	0.0117647
NODE_303431_length_159_cov_182.016667	71	156	8	64	85	0.7529412
NODE_303431_length_159_cov_182.016667	71	156	2	20	85	0.2352941
NODE_303431_length_159_cov_182.016667	71	156	4	1	85	0.0117647
NODE_303431_length_159_cov_182.016667	71	156	8	64	85	0.7529412
NODE_303440_length_159_cov_85.750000	0	43	1	2	43	0.0465116
NODE_303440_length_159_cov_85.750000	0	43	5	1	43	0.0232558
NODE_303440_length_159_cov_85.750000	0	43	6	1	43	0.0232558
NODE_303440_length_159_cov_85.750000	0	43	7	7	43	0.1627907
NODE_303440_length_159_cov_85.750000	0	43	9	16	43	0.3720930
NODE_303440_length_159_cov_85.750000	0	43	13	1	43	0.0232558
NODE_303440_length_159_cov_85.750000	0	43	41	3	43	0.0697674
NODE_303440_length_159_cov_85.750000	0	43	83	2	43	0.0465116
NODE_303440_length_159_cov_85.750000	0	43	93	1	43	0.0232558
NODE_303440_length_159_cov_85.750000	0	43	94	2	43	0.0465116
NODE_303440_length_159_cov_85.750000	0	43	130	1	43	0.0232558
NODE_303440_length_159_cov_85.750000	0	43	138	6	43	0.1395349
NODE_303440_length_159_cov_85.750000	16	97	9	11	81	0.1358025
NODE_303440_length_159_cov_85.750000	16	97	13	1	81	0.0123457
NODE_303440_length_159_cov_85.750000	16	97	41	3	81	0.0370370
NODE_303440_length_159_cov_85.750000	16	97	83	2	81	0.0246914
NODE_303440_length_159_cov_85.750000	16	97	93	1	81	0.0123457
NODE_303440_length_159_cov_85.750000	16	97	94	2	81	0.0246914
NODE_303440_length_159_cov_85.750000	16	97	130	1	81	0.0123457
NODE_303440_length_159_cov_85.750000	16	97	138	12	81	0.1481481
NODE_303440_length_159_cov_85.750000	16	97	140	8	81	0.0987654
NODE_303440_length_159_cov_85.750000	16	97	141	40	81	0.4938272
NODE_303440_length_159_cov_85.750000	65	145	110	1	80	0.0125000
NODE_303440_length_159_cov_85.750000	65	145	120	1	80	0.0125000
NODE_303440_length_159_cov_85.750000	65	145	130	4	80	0.0500000
NODE_303440_length_159_cov_85.750000	65	145	131	8	80	0.1000000
NODE_303440_length_159_cov_85.750000	65	145	132	5	80	0.0625000
NODE_303440_length_159_cov_85.750000	65	145	134	4	80	0.0500000
NODE_303440_length_159_cov_85.750000	65	145	136	1	80	0.0125000
NODE_303440_length_159_cov_85.750000	65	145	137	9	80	0.1125000
NODE_303440_length_159_cov_85.750000	65	145	140	4	80	0.0500000
NODE_303440_length_159_cov_85.750000	65	145	141	43	80	0.5375000
NODE_303440_length_159_cov_85.750000	70	92	141	22	22	1.0000000
NODE_303546_length_158_cov_119.813559	34	77	10	43	43	1.0000000
NODE_303546_length_158_cov_119.813559	78	113	8	4	35	0.1142857
NODE_303546_length_158_cov_119.813559	78	113	10	31	35	0.8857143
NODE_303546_length_158_cov_119.813559	123	158	4	26	35	0.7428572
NODE_303546_length_158_cov_119.813559	123	158	8	9	35	0.2571429
NODE_303552_length_158_cov_70.135593	5	82	10	77	77	1.0000000
NODE_303552_length_158_cov_70.135593	5	82	10	77	77	1.0000000
NODE_303552_length_158_cov_70.135593	81	155	0	17	74	0.2297297
NODE_303552_length_158_cov_70.135593	81	155	10	57	74	0.7702703
NODE_303555_length_158_cov_63.559322	80	151	16	2	71	0.0281690
NODE_303555_length_158_cov_63.559322	80	151	22	6	71	0.0845070
NODE_303555_length_158_cov_63.559322	80	151	24	21	71	0.2957746
NODE_303555_length_158_cov_63.559322	80	151	26	5	71	0.0704225
NODE_303555_length_158_cov_63.559322	80	151	28	9	71	0.1267606
NODE_303555_length_158_cov_63.559322	80	151	30	28	71	0.3943662
NODE_303556_length_158_cov_61.203390	2	66	111	1	64	0.0156250
NODE_303556_length_158_cov_61.203390	2	66	125	4	64	0.0625000
NODE_303556_length_158_cov_61.203390	2	66	128	1	64	0.0156250
NODE_303556_length_158_cov_61.203390	2	66	132	1	64	0.0156250
NODE_303556_length_158_cov_61.203390	2	66	134	1	64	0.0156250
NODE_303556_length_158_cov_61.203390	2	66	135	3	64	0.0468750
NODE_303556_length_158_cov_61.203390	2	66	137	1	64	0.0156250
NODE_303556_length_158_cov_61.203390	2	66	153	4	64	0.0625000
NODE_303556_length_158_cov_61.203390	2	66	155	1	64	0.0156250
NODE_303556_length_158_cov_61.203390	2	66	156	1	64	0.0156250
NODE_303556_length_158_cov_61.203390	2	66	163	1	64	0.0156250
NODE_303556_length_158_cov_61.203390	2	66	192	1	64	0.0156250
NODE_303556_length_158_cov_61.203390	2	66	195	1	64	0.0156250
NODE_303556_length_158_cov_61.203390	2	66	197	1	64	0.0156250
NODE_303556_length_158_cov_61.203390	2	66	219	2	64	0.0312500
NODE_303556_length_158_cov_61.203390	2	66	225	1	64	0.0156250
NODE_303556_length_158_cov_61.203390	2	66	234	2	64	0.0312500
NODE_303556_length_158_cov_61.203390	2	66	239	1	64	0.0156250
NODE_303556_length_158_cov_61.203390	2	66	246	2	64	0.0312500
NODE_303556_length_158_cov_61.203390	2	66	253	1	64	0.0156250
NODE_303556_length_158_cov_61.203390	2	66	255	2	64	0.0312500
NODE_303556_length_158_cov_61.203390	2	66	259	2	64	0.0312500
NODE_303556_length_158_cov_61.203390	2	66	261	4	64	0.0625000
NODE_303556_length_158_cov_61.203390	2	66	262	2	64	0.0312500
NODE_303556_length_158_cov_61.203390	2	66	270	1	64	0.0156250
NODE_303556_length_158_cov_61.203390	2	66	272	1	64	0.0156250
NODE_303556_length_158_cov_61.203390	2	66	276	1	64	0.0156250
NODE_303556_length_158_cov_61.203390	2	66	278	3	64	0.0468750
NODE_303556_length_158_cov_61.203390	2	66	284	1	64	0.0156250
NODE_303556_length_158_cov_61.203390	2	66	286	2	64	0.0312500
NODE_303556_length_158_cov_61.203390	2	66	291	2	64	0.0312500
NODE_303556_length_158_cov_61.203390	2	66	294	9	64	0.1406250
NODE_303556_length_158_cov_61.203390	2	66	295	3	64	0.0468750
NODE_303556_length_158_cov_61.203390	2	66	111	1	64	0.0156250
NODE_303556_length_158_cov_61.203390	2	66	125	4	64	0.0625000
NODE_303556_length_158_cov_61.203390	2	66	128	1	64	0.0156250
NODE_303556_length_158_cov_61.203390	2	66	132	1	64	0.0156250
NODE_303556_length_158_cov_61.203390	2	66	134	1	64	0.0156250
NODE_303556_length_158_cov_61.203390	2	66	135	3	64	0.0468750
NODE_303556_length_158_cov_61.203390	2	66	137	1	64	0.0156250
NODE_303556_length_158_cov_61.203390	2	66	153	4	64	0.0625000
NODE_303556_length_158_cov_61.203390	2	66	155	1	64	0.0156250
NODE_303556_length_158_cov_61.203390	2	66	156	1	64	0.0156250
NODE_303556_length_158_cov_61.203390	2	66	163	1	64	0.0156250
NODE_303556_length_158_cov_61.203390	2	66	192	1	64	0.0156250
NODE_303556_length_158_cov_61.203390	2	66	195	1	64	0.0156250
NODE_303556_length_158_cov_61.203390	2	66	197	1	64	0.0156250
NODE_303556_length_158_cov_61.203390	2	66	219	2	64	0.0312500
NODE_303556_length_158_cov_61.203390	2	66	225	1	64	0.0156250
NODE_303556_length_158_cov_61.203390	2	66	234	2	64	0.0312500
NODE_303556_length_158_cov_61.203390	2	66	239	1	64	0.0156250
NODE_303556_length_158_cov_61.203390	2	66	246	2	64	0.0312500
NODE_303556_length_158_cov_61.203390	2	66	253	1	64	0.0156250
NODE_303556_length_158_cov_61.203390	2	66	255	2	64	0.0312500
NODE_303556_length_158_cov_61.203390	2	66	259	2	64	0.0312500
NODE_303556_length_158_cov_61.203390	2	66	261	4	64	0.0625000
NODE_303556_length_158_cov_61.203390	2	66	262	2	64	0.0312500
NODE_303556_length_158_cov_61.203390	2	66	270	1	64	0.0156250
NODE_303556_length_158_cov_61.203390	2	66	272	1	64	0.0156250
NODE_303556_length_158_cov_61.203390	2	66	276	1	64	0.0156250
NODE_303556_length_158_cov_61.203390	2	66	278	3	64	0.0468750
NODE_303556_length_158_cov_61.203390	2	66	284	1	64	0.0156250
NODE_303556_length_158_cov_61.203390	2	66	286	2	64	0.0312500
NODE_303556_length_158_cov_61.203390	2	66	291	2	64	0.0312500
NODE_303556_length_158_cov_61.203390	2	66	294	9	64	0.1406250
NODE_303556_length_158_cov_61.203390	2	66	295	3	64	0.0468750
NODE_303556_length_158_cov_61.203390	2	66	111	1	64	0.0156250
NODE_303556_length_158_cov_61.203390	2	66	125	4	64	0.0625000
NODE_303556_length_158_cov_61.203390	2	66	128	1	64	0.0156250
NODE_303556_length_158_cov_61.203390	2	66	132	1	64	0.0156250
NODE_303556_length_158_cov_61.203390	2	66	134	1	64	0.0156250
NODE_303556_length_158_cov_61.203390	2	66	135	3	64	0.0468750
NODE_303556_length_158_cov_61.203390	2	66	137	1	64	0.0156250
NODE_303556_length_158_cov_61.203390	2	66	153	4	64	0.0625000
NODE_303556_length_158_cov_61.203390	2	66	155	1	64	0.0156250
NODE_303556_length_158_cov_61.203390	2	66	156	1	64	0.0156250
NODE_303556_length_158_cov_61.203390	2	66	163	1	64	0.0156250
NODE_303556_length_158_cov_61.203390	2	66	192	1	64	0.0156250
NODE_303556_length_158_cov_61.203390	2	66	195	1	64	0.0156250
NODE_303556_length_158_cov_61.203390	2	66	197	1	64	0.0156250
NODE_303556_length_158_cov_61.203390	2	66	219	2	64	0.0312500
NODE_303556_length_158_cov_61.203390	2	66	225	1	64	0.0156250
NODE_303556_length_158_cov_61.203390	2	66	234	2	64	0.0312500
NODE_303556_length_158_cov_61.203390	2	66	239	1	64	0.0156250
NODE_303556_length_158_cov_61.203390	2	66	246	2	64	0.0312500
NODE_303556_length_158_cov_61.203390	2	66	253	1	64	0.0156250
NODE_303556_length_158_cov_61.203390	2	66	255	2	64	0.0312500
NODE_303556_length_158_cov_61.203390	2	66	259	2	64	0.0312500
NODE_303556_length_158_cov_61.203390	2	66	261	4	64	0.0625000
NODE_303556_length_158_cov_61.203390	2	66	262	2	64	0.0312500
NODE_303556_length_158_cov_61.203390	2	66	270	1	64	0.0156250
NODE_303556_length_158_cov_61.203390	2	66	272	1	64	0.0156250
NODE_303556_length_158_cov_61.203390	2	66	276	1	64	0.0156250
NODE_303556_length_158_cov_61.203390	2	66	278	3	64	0.0468750
NODE_303556_length_158_cov_61.203390	2	66	284	1	64	0.0156250
NODE_303556_length_158_cov_61.203390	2	66	286	2	64	0.0312500
NODE_303556_length_158_cov_61.203390	2	66	291	2	64	0.0312500
NODE_303556_length_158_cov_61.203390	2	66	294	9	64	0.1406250
NODE_303556_length_158_cov_61.203390	2	66	295	3	64	0.0468750
NODE_303556_length_158_cov_61.203390	39	119	258	1	80	0.0125000
NODE_303556_length_158_cov_61.203390	39	119	260	2	80	0.0250000
NODE_303556_length_158_cov_61.203390	39	119	261	2	80	0.0250000
NODE_303556_length_158_cov_61.203390	39	119	262	2	80	0.0250000
NODE_303556_length_158_cov_61.203390	39	119	266	1	80	0.0125000
NODE_303556_length_158_cov_61.203390	39	119	270	1	80	0.0125000
NODE_303556_length_158_cov_61.203390	39	119	272	4	80	0.0500000
NODE_303556_length_158_cov_61.203390	39	119	275	4	80	0.0500000
NODE_303556_length_158_cov_61.203390	39	119	276	1	80	0.0125000
NODE_303556_length_158_cov_61.203390	39	119	278	3	80	0.0375000
NODE_303556_length_158_cov_61.203390	39	119	281	3	80	0.0375000
NODE_303556_length_158_cov_61.203390	39	119	284	1	80	0.0125000
NODE_303556_length_158_cov_61.203390	39	119	286	2	80	0.0250000
NODE_303556_length_158_cov_61.203390	39	119	290	2	80	0.0250000
NODE_303556_length_158_cov_61.203390	39	119	291	2	80	0.0250000
NODE_303556_length_158_cov_61.203390	39	119	292	1	80	0.0125000
NODE_303556_length_158_cov_61.203390	39	119	294	16	80	0.2000000
NODE_303556_length_158_cov_61.203390	39	119	295	4	80	0.0500000
NODE_303556_length_158_cov_61.203390	39	119	296	19	80	0.2375000
NODE_303556_length_158_cov_61.203390	39	119	297	4	80	0.0500000
NODE_303556_length_158_cov_61.203390	39	119	298	5	80	0.0625000
NODE_303563_length_158_cov_40.271186	43	107	68	8	64	0.1250000
NODE_303563_length_158_cov_40.271186	43	107	70	56	64	0.8750000
NODE_303563_length_158_cov_40.271186	80	151	9	4	71	0.0563380
NODE_303563_length_158_cov_40.271186	80	151	12	1	71	0.0140845
NODE_303563_length_158_cov_40.271186	80	151	13	2	71	0.0281690
NODE_303563_length_158_cov_40.271186	80	151	17	1	71	0.0140845
NODE_303563_length_158_cov_40.271186	80	151	20	1	71	0.0140845
NODE_303563_length_158_cov_40.271186	80	151	21	11	71	0.1549296
NODE_303563_length_158_cov_40.271186	80	151	22	1	71	0.0140845
NODE_303563_length_158_cov_40.271186	80	151	24	2	71	0.0281690
NODE_303563_length_158_cov_40.271186	80	151	32	6	71	0.0845070
NODE_303563_length_158_cov_40.271186	80	151	38	1	71	0.0140845
NODE_303563_length_158_cov_40.271186	80	151	41	1	71	0.0140845
NODE_303563_length_158_cov_40.271186	80	151	42	3	71	0.0422535
NODE_303563_length_158_cov_40.271186	80	151	47	1	71	0.0140845
NODE_303563_length_158_cov_40.271186	80	151	52	3	71	0.0422535
NODE_303563_length_158_cov_40.271186	80	151	60	1	71	0.0140845
NODE_303563_length_158_cov_40.271186	80	151	62	1	71	0.0140845
NODE_303563_length_158_cov_40.271186	80	151	66	3	71	0.0422535
NODE_303563_length_158_cov_40.271186	80	151	68	5	71	0.0704225
NODE_303563_length_158_cov_40.271186	80	151	70	23	71	0.3239437
NODE_303566_length_158_cov_29.661017	0	61	0	61	61	1.0000000
NODE_303566_length_158_cov_29.661017	34	64	0	30	30	1.0000000
NODE_303605_length_157_cov_1488.586207	57	138	49	1	81	0.0123457
NODE_303605_length_157_cov_1488.586207	57	138	51	4	81	0.0493827
NODE_303605_length_157_cov_1488.586207	57	138	55	2	81	0.0246914
NODE_303605_length_157_cov_1488.586207	57	138	63	1	81	0.0123457
NODE_303605_length_157_cov_1488.586207	57	138	67	2	81	0.0246914
NODE_303605_length_157_cov_1488.586207	57	138	69	1	81	0.0123457
NODE_303605_length_157_cov_1488.586207	57	138	71	1	81	0.0123457
NODE_303605_length_157_cov_1488.586207	57	138	76	1	81	0.0123457
NODE_303605_length_157_cov_1488.586207	57	138	84	5	81	0.0617284
NODE_303605_length_157_cov_1488.586207	57	138	88	2	81	0.0246914
NODE_303605_length_157_cov_1488.586207	57	138	90	3	81	0.0370370
NODE_303605_length_157_cov_1488.586207	57	138	92	1	81	0.0123457
NODE_303605_length_157_cov_1488.586207	57	138	96	3	81	0.0370370
NODE_303605_length_157_cov_1488.586207	57	138	98	2	81	0.0246914
NODE_303605_length_157_cov_1488.586207	57	138	100	3	81	0.0370370
NODE_303605_length_157_cov_1488.586207	57	138	102	1	81	0.0123457
NODE_303605_length_157_cov_1488.586207	57	138	104	48	81	0.5925926
NODE_303605_length_157_cov_1488.586207	111	157	2	3	46	0.0652174
NODE_303605_length_157_cov_1488.586207	111	157	8	1	46	0.0217391
NODE_303605_length_157_cov_1488.586207	111	157	10	1	46	0.0217391
NODE_303605_length_157_cov_1488.586207	111	157	23	1	46	0.0217391
NODE_303605_length_157_cov_1488.586207	111	157	24	1	46	0.0217391
NODE_303605_length_157_cov_1488.586207	111	157	26	3	46	0.0652174
NODE_303605_length_157_cov_1488.586207	111	157	35	5	46	0.1086956
NODE_303605_length_157_cov_1488.586207	111	157	39	2	46	0.0434783
NODE_303605_length_157_cov_1488.586207	111	157	41	1	46	0.0217391
NODE_303605_length_157_cov_1488.586207	111	157	48	1	46	0.0217391
NODE_303605_length_157_cov_1488.586207	111	157	49	1	46	0.0217391
NODE_303605_length_157_cov_1488.586207	111	157	51	4	46	0.0869565
NODE_303605_length_157_cov_1488.586207	111	157	55	2	46	0.0434783
NODE_303605_length_157_cov_1488.586207	111	157	63	1	46	0.0217391
NODE_303605_length_157_cov_1488.586207	111	157	67	2	46	0.0434783
NODE_303605_length_157_cov_1488.586207	111	157	69	1	46	0.0217391
NODE_303605_length_157_cov_1488.586207	111	157	71	1	46	0.0217391
NODE_303605_length_157_cov_1488.586207	111	157	76	1	46	0.0217391
NODE_303605_length_157_cov_1488.586207	111	157	84	5	46	0.1086956
NODE_303605_length_157_cov_1488.586207	111	157	88	2	46	0.0434783
NODE_303605_length_157_cov_1488.586207	111	157	90	3	46	0.0652174
NODE_303605_length_157_cov_1488.586207	111	157	92	1	46	0.0217391
NODE_303605_length_157_cov_1488.586207	111	157	96	3	46	0.0652174
NODE_303606_length_157_cov_295.896552	32	78	50	3	46	0.0652174
NODE_303606_length_157_cov_295.896552	32	78	54	3	46	0.0652174
NODE_303606_length_157_cov_295.896552	32	78	56	11	46	0.2391304
NODE_303606_length_157_cov_295.896552	32	78	58	2	46	0.0434783
NODE_303606_length_157_cov_295.896552	32	78	60	27	46	0.5869565
NODE_303608_length_157_cov_161.689655	0	59	0	11	59	0.1864407
NODE_303608_length_157_cov_161.689655	0	59	1	48	59	0.8135593
NODE_303608_length_157_cov_161.689655	0	59	0	11	59	0.1864407
NODE_303608_length_157_cov_161.689655	0	59	1	48	59	0.8135593
NODE_303608_length_157_cov_161.689655	55	135	0	32	80	0.4000000
NODE_303608_length_157_cov_161.689655	55	135	1	7	80	0.0875000
NODE_303608_length_157_cov_161.689655	55	135	2	41	80	0.5125000
NODE_303608_length_157_cov_161.689655	55	135	0	32	80	0.4000000
NODE_303608_length_157_cov_161.689655	55	135	1	7	80	0.0875000
NODE_303608_length_157_cov_161.689655	55	135	2	41	80	0.5125000
NODE_303608_length_157_cov_161.689655	108	157	0	49	49	1.0000000
NODE_303608_length_157_cov_161.689655	113	157	0	44	44	1.0000000
NODE_303677_length_156_cov_100.491228	0	41	0	10	41	0.2439024
NODE_303677_length_156_cov_100.491228	0	41	2	8	41	0.1951219
NODE_303677_length_156_cov_100.491228	0	41	4	13	41	0.3170732
NODE_303677_length_156_cov_100.491228	0	41	6	10	41	0.2439024
NODE_303677_length_156_cov_100.491228	21	94	4	10	73	0.1369863
NODE_303677_length_156_cov_100.491228	21	94	6	15	73	0.2054795
NODE_303677_length_156_cov_100.491228	21	94	12	48	73	0.6575342
NODE_303688_length_156_cov_37.368421	24	81	0	8	57	0.1403509
NODE_303688_length_156_cov_37.368421	24	81	2	7	57	0.1228070
NODE_303688_length_156_cov_37.368421	24	81	4	4	57	0.0701754
NODE_303688_length_156_cov_37.368421	24	81	6	10	57	0.1754386
NODE_303688_length_156_cov_37.368421	24	81	8	28	57	0.4912281
NODE_303688_length_156_cov_37.368421	54	134	8	80	80	1.0000000
NODE_303700_length_156_cov_9.543860	2	48	0	46	46	1.0000000
NODE_303700_length_156_cov_9.543860	59	105	0	46	46	1.0000000
NODE_303752_length_155_cov_56.750000	27	102	0	75	75	1.0000000
NODE_303752_length_155_cov_56.750000	80	155	0	75	75	1.0000000
NODE_304022_length_153_cov_0.944444	5	48	0	43	43	1.0000000
NODE_304022_length_153_cov_0.944444	37	86	0	49	49	1.0000000
NODE_304022_length_153_cov_0.944444	59	102	0	43	43	1.0000000
NODE_304022_length_153_cov_0.944444	91	140	0	49	49	1.0000000
NODE_304022_length_153_cov_0.944444	113	153	0	40	40	1.0000000
NODE_304027_length_152_cov_195.396226	9	89	0	80	80	1.0000000
NODE_304027_length_152_cov_195.396226	9	89	0	80	80	1.0000000
NODE_304027_length_152_cov_195.396226	85	149	0	64	64	1.0000000
NODE_304027_length_152_cov_195.396226	85	152	0	67	67	1.0000000
NODE_304027_length_152_cov_195.396226	85	152	0	67	67	1.0000000
NODE_304027_length_152_cov_195.396226	85	152	0	67	67	1.0000000
NODE_304030_length_152_cov_68.094340	99	150	4	3	51	0.0588235
NODE_304030_length_152_cov_68.094340	99	150	5	6	51	0.1176471
NODE_304030_length_152_cov_68.094340	99	150	8	1	51	0.0196078
NODE_304030_length_152_cov_68.094340	99	150	10	38	51	0.7450981
NODE_304030_length_152_cov_68.094340	99	150	12	3	51	0.0588235
NODE_304112_length_151_cov_541.615385	19	88	11	7	69	0.1014493
NODE_304112_length_151_cov_541.615385	19	88	13	13	69	0.1884058
NODE_304112_length_151_cov_541.615385	19	88	19	6	69	0.0869565
NODE_304112_length_151_cov_541.615385	19	88	21	1	69	0.0144928
NODE_304112_length_151_cov_541.615385	19	88	27	1	69	0.0144928
NODE_304112_length_151_cov_541.615385	19	88	29	41	69	0.5942029
NODE_304112_length_151_cov_541.615385	72	149	0	3	77	0.0389610
NODE_304112_length_151_cov_541.615385	72	149	6	2	77	0.0259740
NODE_304112_length_151_cov_541.615385	72	149	12	7	77	0.0909091
NODE_304112_length_151_cov_541.615385	72	149	14	5	77	0.0649351
NODE_304112_length_151_cov_541.615385	72	149	16	1	77	0.0129870
NODE_304112_length_151_cov_541.615385	72	149	18	5	77	0.0649351
NODE_304112_length_151_cov_541.615385	72	149	22	2	77	0.0259740
NODE_304112_length_151_cov_541.615385	72	149	24	14	77	0.1818182
NODE_304112_length_151_cov_541.615385	72	149	25	2	77	0.0259740
NODE_304112_length_151_cov_541.615385	72	149	28	1	77	0.0129870
NODE_304112_length_151_cov_541.615385	72	149	29	35	77	0.4545455
NODE_304229_length_150_cov_88.647059	51	102	4	51	51	1.0000000
NODE_304472_length_148_cov_34.183673	23	99	22	1	76	0.0131579
NODE_304472_length_148_cov_34.183673	23	99	25	3	76	0.0394737
NODE_304472_length_148_cov_34.183673	23	99	27	1	76	0.0131579
NODE_304472_length_148_cov_34.183673	23	99	29	1	76	0.0131579
NODE_304472_length_148_cov_34.183673	23	99	33	4	76	0.0526316
NODE_304472_length_148_cov_34.183673	23	99	37	3	76	0.0394737
NODE_304472_length_148_cov_34.183673	23	99	39	4	76	0.0526316
NODE_304472_length_148_cov_34.183673	23	99	41	59	76	0.7763158
NODE_304570_length_147_cov_472.354167	0	55	8	1	55	0.0181818
NODE_304570_length_147_cov_472.354167	0	55	12	1	55	0.0181818
NODE_304570_length_147_cov_472.354167	0	55	14	2	55	0.0363636
NODE_304570_length_147_cov_472.354167	0	55	24	2	55	0.0363636
NODE_304570_length_147_cov_472.354167	0	55	26	1	55	0.0181818
NODE_304570_length_147_cov_472.354167	0	55	28	8	55	0.1454545
NODE_304570_length_147_cov_472.354167	0	55	32	2	55	0.0363636
NODE_304570_length_147_cov_472.354167	0	55	38	1	55	0.0181818
NODE_304570_length_147_cov_472.354167	0	55	40	7	55	0.1272727
NODE_304570_length_147_cov_472.354167	0	55	42	2	55	0.0363636
NODE_304570_length_147_cov_472.354167	0	55	46	3	55	0.0545455
NODE_304570_length_147_cov_472.354167	0	55	48	25	55	0.4545455
NODE_304570_length_147_cov_472.354167	12	89	28	3	77	0.0389610
NODE_304570_length_147_cov_472.354167	12	89	32	2	77	0.0259740
NODE_304570_length_147_cov_472.354167	12	89	38	1	77	0.0129870
NODE_304570_length_147_cov_472.354167	12	89	40	7	77	0.0909091
NODE_304570_length_147_cov_472.354167	12	89	42	2	77	0.0259740
NODE_304570_length_147_cov_472.354167	12	89	46	3	77	0.0389610
NODE_304570_length_147_cov_472.354167	12	89	48	59	77	0.7662337
NODE_304570_length_147_cov_472.354167	65	137	6	3	72	0.0416667
NODE_304570_length_147_cov_472.354167	65	137	14	3	72	0.0416667
NODE_304570_length_147_cov_472.354167	65	137	16	3	72	0.0416667
NODE_304570_length_147_cov_472.354167	65	137	22	1	72	0.0138889
NODE_304570_length_147_cov_472.354167	65	137	26	1	72	0.0138889
NODE_304570_length_147_cov_472.354167	65	137	34	5	72	0.0694444
NODE_304570_length_147_cov_472.354167	65	137	36	5	72	0.0694444
NODE_304570_length_147_cov_472.354167	65	137	40	1	72	0.0138889
NODE_304570_length_147_cov_472.354167	65	137	44	7	72	0.0972222
NODE_304570_length_147_cov_472.354167	65	137	46	4	72	0.0555556
NODE_304570_length_147_cov_472.354167	65	137	48	39	72	0.5416667
NODE_304572_length_147_cov_229.729167	7	56	9	3	49	0.0612245
NODE_304572_length_147_cov_229.729167	7	56	10	1	49	0.0204082
NODE_304572_length_147_cov_229.729167	7	56	16	1	49	0.0204082
NODE_304572_length_147_cov_229.729167	7	56	18	2	49	0.0408163
NODE_304572_length_147_cov_229.729167	7	56	42	1	49	0.0204082
NODE_304572_length_147_cov_229.729167	7	56	45	2	49	0.0408163
NODE_304572_length_147_cov_229.729167	7	56	48	1	49	0.0204082
NODE_304572_length_147_cov_229.729167	7	56	58	1	49	0.0204082
NODE_304572_length_147_cov_229.729167	7	56	62	1	49	0.0204082
NODE_304572_length_147_cov_229.729167	7	56	66	3	49	0.0612245
NODE_304572_length_147_cov_229.729167	7	56	67	1	49	0.0204082
NODE_304572_length_147_cov_229.729167	7	56	68	5	49	0.1020408
NODE_304572_length_147_cov_229.729167	7	56	72	5	49	0.1020408
NODE_304572_length_147_cov_229.729167	7	56	78	1	49	0.0204082
NODE_304572_length_147_cov_229.729167	7	56	84	2	49	0.0408163
NODE_304572_length_147_cov_229.729167	7	56	93	1	49	0.0204082
NODE_304572_length_147_cov_229.729167	7	56	97	1	49	0.0204082
NODE_304572_length_147_cov_229.729167	7	56	98	1	49	0.0204082
NODE_304572_length_147_cov_229.729167	7	56	102	16	49	0.3265306
NODE_304572_length_147_cov_229.729167	29	93	72	5	64	0.0781250
NODE_304572_length_147_cov_229.729167	29	93	78	1	64	0.0156250
NODE_304572_length_147_cov_229.729167	29	93	84	2	64	0.0312500
NODE_304572_length_147_cov_229.729167	29	93	93	1	64	0.0156250
NODE_304572_length_147_cov_229.729167	29	93	97	1	64	0.0156250
NODE_304572_length_147_cov_229.729167	29	93	98	1	64	0.0156250
NODE_304572_length_147_cov_229.729167	29	93	102	53	64	0.8281250
NODE_304572_length_147_cov_229.729167	29	93	72	5	64	0.0781250
NODE_304572_length_147_cov_229.729167	29	93	78	1	64	0.0156250
NODE_304572_length_147_cov_229.729167	29	93	84	2	64	0.0312500
NODE_304572_length_147_cov_229.729167	29	93	93	1	64	0.0156250
NODE_304572_length_147_cov_229.729167	29	93	97	1	64	0.0156250
NODE_304572_length_147_cov_229.729167	29	93	98	1	64	0.0156250
NODE_304572_length_147_cov_229.729167	29	93	102	53	64	0.8281250
NODE_304572_length_147_cov_229.729167	29	93	72	5	64	0.0781250
NODE_304572_length_147_cov_229.729167	29	93	78	1	64	0.0156250
NODE_304572_length_147_cov_229.729167	29	93	84	2	64	0.0312500
NODE_304572_length_147_cov_229.729167	29	93	93	1	64	0.0156250
NODE_304572_length_147_cov_229.729167	29	93	97	1	64	0.0156250
NODE_304572_length_147_cov_229.729167	29	93	98	1	64	0.0156250
NODE_304572_length_147_cov_229.729167	29	93	102	53	64	0.8281250
NODE_304573_length_147_cov_213.770833	37	117	0	80	80	1.0000000
NODE_304573_length_147_cov_213.770833	90	146	0	56	56	1.0000000
NODE_304697_length_146_cov_182.893617	1	60	0	6	59	0.1016949
NODE_304697_length_146_cov_182.893617	1	60	4	17	59	0.2881356
NODE_304697_length_146_cov_182.893617	1	60	8	12	59	0.2033898
NODE_304697_length_146_cov_182.893617	1	60	10	24	59	0.4067796
NODE_304697_length_146_cov_182.893617	34	60	8	2	26	0.0769231
NODE_304697_length_146_cov_182.893617	34	60	10	24	26	0.9230769
NODE_304697_length_146_cov_182.893617	113	144	2	9	31	0.2903226
NODE_304697_length_146_cov_182.893617	113	144	4	6	31	0.1935484
NODE_304697_length_146_cov_182.893617	113	144	9	2	31	0.0645161
NODE_304697_length_146_cov_182.893617	113	144	10	14	31	0.4516129
NODE_304698_length_146_cov_152.808511	0	69	0	69	69	1.0000000
NODE_304698_length_146_cov_152.808511	42	122	0	80	80	1.0000000
NODE_304703_length_146_cov_89.808511	0	53	0	1	53	0.0188679
NODE_304703_length_146_cov_89.808511	0	53	2	9	53	0.1698113
NODE_304703_length_146_cov_89.808511	0	53	6	43	53	0.8113208
NODE_304703_length_146_cov_89.808511	26	106	6	80	80	1.0000000
NODE_304703_length_146_cov_89.808511	74	146	0	28	72	0.3888889
NODE_304703_length_146_cov_89.808511	74	146	4	3	72	0.0416667
NODE_304703_length_146_cov_89.808511	74	146	6	41	72	0.5694444
NODE_304703_length_146_cov_89.808511	79	101	6	22	22	1.0000000
NODE_304707_length_146_cov_57.446809	44	124	0	80	80	1.0000000
NODE_304708_length_146_cov_54.106383	0	69	0	69	69	1.0000000
NODE_304708_length_146_cov_54.106383	42	122	0	80	80	1.0000000
NODE_304710_length_146_cov_46.765957	3	83	0	17	80	0.2125000
NODE_304710_length_146_cov_46.765957	3	83	2	63	80	0.7875000
NODE_304710_length_146_cov_46.765957	3	83	0	17	80	0.2125000
NODE_304710_length_146_cov_46.765957	3	83	2	63	80	0.7875000
NODE_304710_length_146_cov_46.765957	3	83	0	17	80	0.2125000
NODE_304710_length_146_cov_46.765957	3	83	2	63	80	0.7875000
NODE_304710_length_146_cov_46.765957	3	83	0	17	80	0.2125000
NODE_304710_length_146_cov_46.765957	3	83	2	63	80	0.7875000
NODE_304710_length_146_cov_46.765957	3	83	0	17	80	0.2125000
NODE_304710_length_146_cov_46.765957	3	83	2	63	80	0.7875000
NODE_304710_length_146_cov_46.765957	12	83	0	8	71	0.1126761
NODE_304710_length_146_cov_46.765957	12	83	2	63	71	0.8873239
NODE_304710_length_146_cov_46.765957	56	136	0	27	80	0.3375000
NODE_304710_length_146_cov_46.765957	56	136	2	53	80	0.6625000
NODE_304710_length_146_cov_46.765957	56	136	0	27	80	0.3375000
NODE_304710_length_146_cov_46.765957	56	136	2	53	80	0.6625000
NODE_304711_length_146_cov_44.021277	0	69	0	69	69	1.0000000
NODE_304711_length_146_cov_44.021277	42	122	0	80	80	1.0000000
NODE_304798_length_145_cov_1385.413043	0	69	27	1	69	0.0144928
NODE_304798_length_145_cov_1385.413043	0	69	29	1	69	0.0144928
NODE_304798_length_145_cov_1385.413043	0	69	31	1	69	0.0144928
NODE_304798_length_145_cov_1385.413043	0	69	32	2	69	0.0289855
NODE_304798_length_145_cov_1385.413043	0	69	34	1	69	0.0144928
NODE_304798_length_145_cov_1385.413043	0	69	42	1	69	0.0144928
NODE_304798_length_145_cov_1385.413043	0	69	58	1	69	0.0144928
NODE_304798_length_145_cov_1385.413043	0	69	67	2	69	0.0289855
NODE_304798_length_145_cov_1385.413043	0	69	71	1	69	0.0144928
NODE_304798_length_145_cov_1385.413043	0	69	72	1	69	0.0144928
NODE_304798_length_145_cov_1385.413043	0	69	88	1	69	0.0144928
NODE_304798_length_145_cov_1385.413043	0	69	89	1	69	0.0144928
NODE_304798_length_145_cov_1385.413043	0	69	99	1	69	0.0144928
NODE_304798_length_145_cov_1385.413043	0	69	108	1	69	0.0144928
NODE_304798_length_145_cov_1385.413043	0	69	112	1	69	0.0144928
NODE_304798_length_145_cov_1385.413043	0	69	116	1	69	0.0144928
NODE_304798_length_145_cov_1385.413043	0	69	118	1	69	0.0144928
NODE_304798_length_145_cov_1385.413043	0	69	124	1	69	0.0144928
NODE_304798_length_145_cov_1385.413043	0	69	128	1	69	0.0144928
NODE_304798_length_145_cov_1385.413043	0	69	130	1	69	0.0144928
NODE_304798_length_145_cov_1385.413043	0	69	140	1	69	0.0144928
NODE_304798_length_145_cov_1385.413043	0	69	142	2	69	0.0289855
NODE_304798_length_145_cov_1385.413043	0	69	144	2	69	0.0289855
NODE_304798_length_145_cov_1385.413043	0	69	150	2	69	0.0289855
NODE_304798_length_145_cov_1385.413043	0	69	157	1	69	0.0144928
NODE_304798_length_145_cov_1385.413043	0	69	163	1	69	0.0144928
NODE_304798_length_145_cov_1385.413043	0	69	177	1	69	0.0144928
NODE_304798_length_145_cov_1385.413043	0	69	182	1	69	0.0144928
NODE_304798_length_145_cov_1385.413043	0	69	198	1	69	0.0144928
NODE_304798_length_145_cov_1385.413043	0	69	201	3	69	0.0434783
NODE_304798_length_145_cov_1385.413043	0	69	203	1	69	0.0144928
NODE_304798_length_145_cov_1385.413043	0	69	205	2	69	0.0289855
NODE_304798_length_145_cov_1385.413043	0	69	219	1	69	0.0144928
NODE_304798_length_145_cov_1385.413043	0	69	221	1	69	0.0144928
NODE_304798_length_145_cov_1385.413043	0	69	223	4	69	0.0579710
NODE_304798_length_145_cov_1385.413043	0	69	224	4	69	0.0579710
NODE_304798_length_145_cov_1385.413043	0	69	225	18	69	0.2608696
NODE_304798_length_145_cov_1385.413043	0	69	226	1	69	0.0144928
NODE_304798_length_145_cov_1385.413043	42	122	175	1	80	0.0125000
NODE_304798_length_145_cov_1385.413043	42	122	179	2	80	0.0250000
NODE_304798_length_145_cov_1385.413043	42	122	181	4	80	0.0500000
NODE_304798_length_145_cov_1385.413043	42	122	183	2	80	0.0250000
NODE_304798_length_145_cov_1385.413043	42	122	195	2	80	0.0250000
NODE_304798_length_145_cov_1385.413043	42	122	207	1	80	0.0125000
NODE_304798_length_145_cov_1385.413043	42	122	213	1	80	0.0125000
NODE_304798_length_145_cov_1385.413043	42	122	215	4	80	0.0500000
NODE_304798_length_145_cov_1385.413043	42	122	217	1	80	0.0125000
NODE_304798_length_145_cov_1385.413043	42	122	222	1	80	0.0125000
NODE_304798_length_145_cov_1385.413043	42	122	223	4	80	0.0500000
NODE_304798_length_145_cov_1385.413043	42	122	224	4	80	0.0500000
NODE_304798_length_145_cov_1385.413043	42	122	225	52	80	0.6500000
NODE_304798_length_145_cov_1385.413043	42	122	226	1	80	0.0125000
NODE_304799_length_145_cov_880.369565	56	120	134	2	64	0.0312500
NODE_304799_length_145_cov_880.369565	56	120	140	2	64	0.0312500
NODE_304799_length_145_cov_880.369565	56	120	144	2	64	0.0312500
NODE_304799_length_145_cov_880.369565	56	120	148	3	64	0.0468750
NODE_304799_length_145_cov_880.369565	56	120	150	1	64	0.0156250
NODE_304799_length_145_cov_880.369565	56	120	158	2	64	0.0312500
NODE_304799_length_145_cov_880.369565	56	120	172	2	64	0.0312500
NODE_304799_length_145_cov_880.369565	56	120	174	2	64	0.0312500
NODE_304799_length_145_cov_880.369565	56	120	178	4	64	0.0625000
NODE_304799_length_145_cov_880.369565	56	120	188	44	64	0.6875000
NODE_304799_length_145_cov_880.369565	56	120	134	2	64	0.0312500
NODE_304799_length_145_cov_880.369565	56	120	140	2	64	0.0312500
NODE_304799_length_145_cov_880.369565	56	120	144	2	64	0.0312500
NODE_304799_length_145_cov_880.369565	56	120	148	3	64	0.0468750
NODE_304799_length_145_cov_880.369565	56	120	150	1	64	0.0156250
NODE_304799_length_145_cov_880.369565	56	120	158	2	64	0.0312500
NODE_304799_length_145_cov_880.369565	56	120	172	2	64	0.0312500
NODE_304799_length_145_cov_880.369565	56	120	174	2	64	0.0312500
NODE_304799_length_145_cov_880.369565	56	120	178	4	64	0.0625000
NODE_304799_length_145_cov_880.369565	56	120	188	44	64	0.6875000
NODE_304799_length_145_cov_880.369565	56	120	134	2	64	0.0312500
NODE_304799_length_145_cov_880.369565	56	120	140	2	64	0.0312500
NODE_304799_length_145_cov_880.369565	56	120	144	2	64	0.0312500
NODE_304799_length_145_cov_880.369565	56	120	148	3	64	0.0468750
NODE_304799_length_145_cov_880.369565	56	120	150	1	64	0.0156250
NODE_304799_length_145_cov_880.369565	56	120	158	2	64	0.0312500
NODE_304799_length_145_cov_880.369565	56	120	172	2	64	0.0312500
NODE_304799_length_145_cov_880.369565	56	120	174	2	64	0.0312500
NODE_304799_length_145_cov_880.369565	56	120	178	4	64	0.0625000
NODE_304799_length_145_cov_880.369565	56	120	188	44	64	0.6875000
NODE_304799_length_145_cov_880.369565	93	142	28	1	49	0.0204082
NODE_304799_length_145_cov_880.369565	93	142	37	1	49	0.0204082
NODE_304799_length_145_cov_880.369565	93	142	41	1	49	0.0204082
NODE_304799_length_145_cov_880.369565	93	142	49	2	49	0.0408163
NODE_304799_length_145_cov_880.369565	93	142	55	1	49	0.0204082
NODE_304799_length_145_cov_880.369565	93	142	62	2	49	0.0408163
NODE_304799_length_145_cov_880.369565	93	142	80	3	49	0.0612245
NODE_304799_length_145_cov_880.369565	93	142	88	1	49	0.0204082
NODE_304799_length_145_cov_880.369565	93	142	90	1	49	0.0204082
NODE_304799_length_145_cov_880.369565	93	142	98	4	49	0.0816327
NODE_304799_length_145_cov_880.369565	93	142	110	1	49	0.0204082
NODE_304799_length_145_cov_880.369565	93	142	118	1	49	0.0204082
NODE_304799_length_145_cov_880.369565	93	142	120	3	49	0.0612245
NODE_304799_length_145_cov_880.369565	93	142	134	2	49	0.0408163
NODE_304799_length_145_cov_880.369565	93	142	140	2	49	0.0408163
NODE_304799_length_145_cov_880.369565	93	142	144	2	49	0.0408163
NODE_304799_length_145_cov_880.369565	93	142	148	3	49	0.0612245
NODE_304799_length_145_cov_880.369565	93	142	150	1	49	0.0204082
NODE_304799_length_145_cov_880.369565	93	142	158	2	49	0.0408163
NODE_304799_length_145_cov_880.369565	93	142	172	2	49	0.0408163
NODE_304799_length_145_cov_880.369565	93	142	174	2	49	0.0408163
NODE_304799_length_145_cov_880.369565	93	142	178	4	49	0.0816327
NODE_304799_length_145_cov_880.369565	93	142	188	7	49	0.1428571
NODE_304923_length_144_cov_46.155556	1	81	2	3	80	0.0375000
NODE_304923_length_144_cov_46.155556	1	81	8	3	80	0.0375000
NODE_304923_length_144_cov_46.155556	1	81	10	5	80	0.0625000
NODE_304923_length_144_cov_46.155556	1	81	12	4	80	0.0500000
NODE_304923_length_144_cov_46.155556	1	81	14	1	80	0.0125000
NODE_304923_length_144_cov_46.155556	1	81	16	3	80	0.0375000
NODE_304923_length_144_cov_46.155556	1	81	18	3	80	0.0375000
NODE_304923_length_144_cov_46.155556	1	81	20	7	80	0.0875000
NODE_304923_length_144_cov_46.155556	1	81	21	12	80	0.1500000
NODE_304923_length_144_cov_46.155556	1	81	22	39	80	0.4875000
NODE_305208_length_142_cov_244.488372	0	52	0	1	52	0.0192308
NODE_305208_length_142_cov_244.488372	0	52	4	6	52	0.1153846
NODE_305208_length_142_cov_244.488372	0	52	8	7	52	0.1346154
NODE_305208_length_142_cov_244.488372	0	52	10	8	52	0.1538462
NODE_305208_length_142_cov_244.488372	0	52	12	9	52	0.1730769
NODE_305208_length_142_cov_244.488372	0	52	14	5	52	0.0961538
NODE_305208_length_142_cov_244.488372	0	52	16	2	52	0.0384615
NODE_305208_length_142_cov_244.488372	0	52	18	14	52	0.2692308
NODE_305229_length_142_cov_46.976744	1	65	14	7	64	0.1093750
NODE_305229_length_142_cov_46.976744	1	65	19	1	64	0.0156250
NODE_305229_length_142_cov_46.976744	1	65	20	1	64	0.0156250
NODE_305229_length_142_cov_46.976744	1	65	24	4	64	0.0625000
NODE_305229_length_142_cov_46.976744	1	65	28	1	64	0.0156250
NODE_305229_length_142_cov_46.976744	1	65	32	3	64	0.0468750
NODE_305229_length_142_cov_46.976744	1	65	36	1	64	0.0156250
NODE_305229_length_142_cov_46.976744	1	65	37	1	64	0.0156250
NODE_305229_length_142_cov_46.976744	1	65	39	16	64	0.2500000
NODE_305229_length_142_cov_46.976744	1	65	41	29	64	0.4531250
NODE_305229_length_142_cov_46.976744	1	65	14	7	64	0.1093750
NODE_305229_length_142_cov_46.976744	1	65	19	1	64	0.0156250
NODE_305229_length_142_cov_46.976744	1	65	20	1	64	0.0156250
NODE_305229_length_142_cov_46.976744	1	65	24	4	64	0.0625000
NODE_305229_length_142_cov_46.976744	1	65	28	1	64	0.0156250
NODE_305229_length_142_cov_46.976744	1	65	32	3	64	0.0468750
NODE_305229_length_142_cov_46.976744	1	65	36	1	64	0.0156250
NODE_305229_length_142_cov_46.976744	1	65	37	1	64	0.0156250
NODE_305229_length_142_cov_46.976744	1	65	39	16	64	0.2500000
NODE_305229_length_142_cov_46.976744	1	65	41	29	64	0.4531250
NODE_305229_length_142_cov_46.976744	1	65	14	7	64	0.1093750
NODE_305229_length_142_cov_46.976744	1	65	19	1	64	0.0156250
NODE_305229_length_142_cov_46.976744	1	65	20	1	64	0.0156250
NODE_305229_length_142_cov_46.976744	1	65	24	4	64	0.0625000
NODE_305229_length_142_cov_46.976744	1	65	28	1	64	0.0156250
NODE_305229_length_142_cov_46.976744	1	65	32	3	64	0.0468750
NODE_305229_length_142_cov_46.976744	1	65	36	1	64	0.0156250
NODE_305229_length_142_cov_46.976744	1	65	37	1	64	0.0156250
NODE_305229_length_142_cov_46.976744	1	65	39	16	64	0.2500000
NODE_305229_length_142_cov_46.976744	1	65	41	29	64	0.4531250
NODE_305230_length_142_cov_45.000000	0	69	0	14	69	0.2028985
NODE_305230_length_142_cov_45.000000	0	69	2	10	69	0.1449275
NODE_305230_length_142_cov_45.000000	0	69	4	45	69	0.6521739
NODE_305385_length_141_cov_178.785714	58	118	104	1	60	0.0166667
NODE_305385_length_141_cov_178.785714	58	118	106	3	60	0.0500000
NODE_305385_length_141_cov_178.785714	58	118	108	2	60	0.0333333
NODE_305385_length_141_cov_178.785714	58	118	112	1	60	0.0166667
NODE_305385_length_141_cov_178.785714	58	118	114	6	60	0.1000000
NODE_305385_length_141_cov_178.785714	58	118	116	47	60	0.7833334
NODE_305398_length_141_cov_62.285714	26	106	2	80	80	1.0000000
NODE_305398_length_141_cov_62.285714	26	106	2	80	80	1.0000000
NODE_305398_length_141_cov_62.285714	26	97	2	71	71	1.0000000
NODE_305402_length_141_cov_41.142857	26	97	0	71	71	1.0000000
NODE_305600_length_140_cov_60.439024	8	88	0	80	80	1.0000000
NODE_305600_length_140_cov_60.439024	8	88	0	80	80	1.0000000
NODE_305600_length_140_cov_60.439024	8	88	0	80	80	1.0000000
NODE_305600_length_140_cov_60.439024	8	88	0	80	80	1.0000000
NODE_305600_length_140_cov_60.439024	8	88	0	80	80	1.0000000
NODE_305616_length_140_cov_35.146341	22	102	0	80	80	1.0000000
NODE_305616_length_140_cov_35.146341	75	105	0	30	30	1.0000000
NODE_305618_length_140_cov_34.048780	0	77	0	77	77	1.0000000
NODE_305618_length_140_cov_34.048780	0	77	0	77	77	1.0000000
NODE_305618_length_140_cov_34.048780	50	130	0	80	80	1.0000000
NODE_305618_length_140_cov_34.048780	50	130	0	80	80	1.0000000
NODE_305618_length_140_cov_34.048780	55	130	0	75	75	1.0000000
NODE_305619_length_140_cov_19.926829	44	118	0	74	74	1.0000000
NODE_305783_length_139_cov_29.700000	0	40	8	7	40	0.1750000
NODE_305783_length_139_cov_29.700000	0	40	28	9	40	0.2250000
NODE_305783_length_139_cov_29.700000	0	40	32	24	40	0.6000000
NODE_305783_length_139_cov_29.700000	0	40	8	7	40	0.1750000
NODE_305783_length_139_cov_29.700000	0	40	28	9	40	0.2250000
NODE_305783_length_139_cov_29.700000	0	40	32	24	40	0.6000000
NODE_305783_length_139_cov_29.700000	13	93	28	3	80	0.0375000
NODE_305783_length_139_cov_29.700000	13	93	32	77	80	0.9625000
NODE_305783_length_139_cov_29.700000	13	93	28	3	80	0.0375000
NODE_305783_length_139_cov_29.700000	13	93	32	77	80	0.9625000
NODE_305783_length_139_cov_29.700000	13	93	28	3	80	0.0375000
NODE_305783_length_139_cov_29.700000	13	93	32	77	80	0.9625000
NODE_305783_length_139_cov_29.700000	13	93	28	3	80	0.0375000
NODE_305783_length_139_cov_29.700000	13	93	32	77	80	0.9625000
NODE_305783_length_139_cov_29.700000	13	93	28	3	80	0.0375000
NODE_305783_length_139_cov_29.700000	13	93	32	77	80	0.9625000
NODE_305783_length_139_cov_29.700000	13	84	28	3	71	0.0422535
NODE_305783_length_139_cov_29.700000	13	84	32	68	71	0.9577465
NODE_305936_length_138_cov_1475.615385	30	97	65	4	67	0.0597015
NODE_305936_length_138_cov_1475.615385	30	97	67	30	67	0.4477612
NODE_305936_length_138_cov_1475.615385	30	97	68	33	67	0.4925373
NODE_305936_length_138_cov_1475.615385	70	138	27	2	68	0.0294118
NODE_305936_length_138_cov_1475.615385	70	138	29	2	68	0.0294118
NODE_305936_length_138_cov_1475.615385	70	138	37	1	68	0.0147059
NODE_305936_length_138_cov_1475.615385	70	138	38	1	68	0.0147059
NODE_305936_length_138_cov_1475.615385	70	138	41	1	68	0.0147059
NODE_305936_length_138_cov_1475.615385	70	138	42	1	68	0.0147059
NODE_305936_length_138_cov_1475.615385	70	138	44	1	68	0.0147059
NODE_305936_length_138_cov_1475.615385	70	138	50	2	68	0.0294118
NODE_305936_length_138_cov_1475.615385	70	138	55	1	68	0.0147059
NODE_305936_length_138_cov_1475.615385	70	138	56	4	68	0.0588235
NODE_305936_length_138_cov_1475.615385	70	138	57	5	68	0.0735294
NODE_305936_length_138_cov_1475.615385	70	138	59	9	68	0.1323529
NODE_305936_length_138_cov_1475.615385	70	138	63	5	68	0.0735294
NODE_305936_length_138_cov_1475.615385	70	138	67	13	68	0.1911765
NODE_305936_length_138_cov_1475.615385	70	138	68	20	68	0.2941177
NODE_305963_length_138_cov_29.564103	11	91	0	80	80	1.0000000
NODE_305963_length_138_cov_29.564103	11	91	0	80	80	1.0000000
NODE_305963_length_138_cov_29.564103	64	128	0	64	64	1.0000000
NODE_305963_length_138_cov_29.564103	64	128	0	64	64	1.0000000
NODE_306081_length_137_cov_185.684211	20	104	2	13	84	0.1547619
NODE_306081_length_137_cov_185.684211	20	104	6	71	84	0.8452381
NODE_306092_length_137_cov_58.289474	76	106	12	30	30	1.0000000
NODE_306099_length_137_cov_36.473684	31	111	12	80	80	1.0000000
NODE_306208_length_136_cov_1257.621622	27	107	20	2	80	0.0250000
NODE_306208_length_136_cov_1257.621622	27	107	22	1	80	0.0125000
NODE_306208_length_136_cov_1257.621622	27	107	24	3	80	0.0375000
NODE_306208_length_136_cov_1257.621622	27	107	28	74	80	0.9250000
NODE_306209_length_136_cov_769.594595	0	69	0	1	69	0.0144928
NODE_306209_length_136_cov_769.594595	0	69	6	9	69	0.1304348
NODE_306209_length_136_cov_769.594595	0	69	10	59	69	0.8550724
NODE_306222_length_136_cov_128.324324	39	119	2	3	80	0.0375000
NODE_306222_length_136_cov_128.324324	39	119	8	77	80	0.9625000
NODE_306227_length_136_cov_90.783784	10	86	0	76	76	1.0000000
NODE_306227_length_136_cov_90.783784	59	136	0	77	77	1.0000000
NODE_306368_length_135_cov_2144.166667	0	73	35	1	73	0.0136986
NODE_306368_length_135_cov_2144.166667	0	73	37	1	73	0.0136986
NODE_306368_length_135_cov_2144.166667	0	73	43	1	73	0.0136986
NODE_306368_length_135_cov_2144.166667	0	73	61	1	73	0.0136986
NODE_306368_length_135_cov_2144.166667	0	73	65	1	73	0.0136986
NODE_306368_length_135_cov_2144.166667	0	73	79	1	73	0.0136986
NODE_306368_length_135_cov_2144.166667	0	73	84	2	73	0.0273973
NODE_306368_length_135_cov_2144.166667	0	73	90	1	73	0.0136986
NODE_306368_length_135_cov_2144.166667	0	73	92	1	73	0.0136986
NODE_306368_length_135_cov_2144.166667	0	73	94	1	73	0.0136986
NODE_306368_length_135_cov_2144.166667	0	73	100	3	73	0.0410959
NODE_306368_length_135_cov_2144.166667	0	73	106	1	73	0.0136986
NODE_306368_length_135_cov_2144.166667	0	73	108	1	73	0.0136986
NODE_306368_length_135_cov_2144.166667	0	73	114	1	73	0.0136986
NODE_306368_length_135_cov_2144.166667	0	73	116	1	73	0.0136986
NODE_306368_length_135_cov_2144.166667	0	73	118	1	73	0.0136986
NODE_306368_length_135_cov_2144.166667	0	73	124	3	73	0.0410959
NODE_306368_length_135_cov_2144.166667	0	73	126	2	73	0.0273973
NODE_306368_length_135_cov_2144.166667	0	73	130	1	73	0.0136986
NODE_306368_length_135_cov_2144.166667	0	73	132	3	73	0.0410959
NODE_306368_length_135_cov_2144.166667	0	73	140	2	73	0.0273973
NODE_306368_length_135_cov_2144.166667	0	73	142	2	73	0.0273973
NODE_306368_length_135_cov_2144.166667	0	73	146	1	73	0.0136986
NODE_306368_length_135_cov_2144.166667	0	73	152	40	73	0.5479452
NODE_306368_length_135_cov_2144.166667	46	126	56	2	80	0.0250000
NODE_306368_length_135_cov_2144.166667	46	126	60	1	80	0.0125000
NODE_306368_length_135_cov_2144.166667	46	126	62	3	80	0.0375000
NODE_306368_length_135_cov_2144.166667	46	126	74	1	80	0.0125000
NODE_306368_length_135_cov_2144.166667	46	126	76	1	80	0.0125000
NODE_306368_length_135_cov_2144.166667	46	126	97	1	80	0.0125000
NODE_306368_length_135_cov_2144.166667	46	126	103	1	80	0.0125000
NODE_306368_length_135_cov_2144.166667	46	126	110	1	80	0.0125000
NODE_306368_length_135_cov_2144.166667	46	126	114	1	80	0.0125000
NODE_306368_length_135_cov_2144.166667	46	126	119	1	80	0.0125000
NODE_306368_length_135_cov_2144.166667	46	126	123	1	80	0.0125000
NODE_306368_length_135_cov_2144.166667	46	126	129	1	80	0.0125000
NODE_306368_length_135_cov_2144.166667	46	126	133	1	80	0.0125000
NODE_306368_length_135_cov_2144.166667	46	126	135	1	80	0.0125000
NODE_306368_length_135_cov_2144.166667	46	126	137	1	80	0.0125000
NODE_306368_length_135_cov_2144.166667	46	126	139	2	80	0.0250000
NODE_306368_length_135_cov_2144.166667	46	126	141	1	80	0.0125000
NODE_306368_length_135_cov_2144.166667	46	126	143	1	80	0.0125000
NODE_306368_length_135_cov_2144.166667	46	126	147	1	80	0.0125000
NODE_306368_length_135_cov_2144.166667	46	126	151	10	80	0.1250000
NODE_306368_length_135_cov_2144.166667	46	126	152	47	80	0.5875000
NODE_306368_length_135_cov_2144.166667	83	135	2	1	52	0.0192308
NODE_306368_length_135_cov_2144.166667	83	135	4	1	52	0.0192308
NODE_306368_length_135_cov_2144.166667	83	135	16	2	52	0.0384615
NODE_306368_length_135_cov_2144.166667	83	135	22	1	52	0.0192308
NODE_306368_length_135_cov_2144.166667	83	135	24	1	52	0.0192308
NODE_306368_length_135_cov_2144.166667	83	135	32	1	52	0.0192308
NODE_306368_length_135_cov_2144.166667	83	135	37	1	52	0.0192308
NODE_306368_length_135_cov_2144.166667	83	135	50	1	52	0.0192308
NODE_306368_length_135_cov_2144.166667	83	135	56	2	52	0.0384615
NODE_306368_length_135_cov_2144.166667	83	135	60	1	52	0.0192308
NODE_306368_length_135_cov_2144.166667	83	135	62	3	52	0.0576923
NODE_306368_length_135_cov_2144.166667	83	135	74	1	52	0.0192308
NODE_306368_length_135_cov_2144.166667	83	135	76	1	52	0.0192308
NODE_306368_length_135_cov_2144.166667	83	135	97	1	52	0.0192308
NODE_306368_length_135_cov_2144.166667	83	135	103	1	52	0.0192308
NODE_306368_length_135_cov_2144.166667	83	135	110	1	52	0.0192308
NODE_306368_length_135_cov_2144.166667	83	135	114	1	52	0.0192308
NODE_306368_length_135_cov_2144.166667	83	135	119	1	52	0.0192308
NODE_306368_length_135_cov_2144.166667	83	135	123	1	52	0.0192308
NODE_306368_length_135_cov_2144.166667	83	135	129	1	52	0.0192308
NODE_306368_length_135_cov_2144.166667	83	135	133	1	52	0.0192308
NODE_306368_length_135_cov_2144.166667	83	135	135	1	52	0.0192308
NODE_306368_length_135_cov_2144.166667	83	135	137	1	52	0.0192308
NODE_306368_length_135_cov_2144.166667	83	135	139	2	52	0.0384615
NODE_306368_length_135_cov_2144.166667	83	135	141	1	52	0.0192308
NODE_306368_length_135_cov_2144.166667	83	135	143	1	52	0.0192308
NODE_306368_length_135_cov_2144.166667	83	135	147	1	52	0.0192308
NODE_306368_length_135_cov_2144.166667	83	135	151	10	52	0.1923077
NODE_306368_length_135_cov_2144.166667	83	135	152	10	52	0.1923077
NODE_306370_length_135_cov_630.194444	0	76	8	3	76	0.0394737
NODE_306370_length_135_cov_630.194444	0	76	10	1	76	0.0131579
NODE_306370_length_135_cov_630.194444	0	76	14	3	76	0.0394737
NODE_306370_length_135_cov_630.194444	0	76	16	6	76	0.0789474
NODE_306370_length_135_cov_630.194444	0	76	20	3	76	0.0394737
NODE_306370_length_135_cov_630.194444	0	76	22	1	76	0.0131579
NODE_306370_length_135_cov_630.194444	0	76	24	5	76	0.0657895
NODE_306370_length_135_cov_630.194444	0	76	30	4	76	0.0526316
NODE_306370_length_135_cov_630.194444	0	76	32	50	76	0.6578947
NODE_306371_length_135_cov_540.611111	0	76	6	1	76	0.0131579
NODE_306371_length_135_cov_540.611111	0	76	16	2	76	0.0263158
NODE_306371_length_135_cov_540.611111	0	76	18	1	76	0.0131579
NODE_306371_length_135_cov_540.611111	0	76	22	3	76	0.0394737
NODE_306371_length_135_cov_540.611111	0	76	26	2	76	0.0263158
NODE_306371_length_135_cov_540.611111	0	76	32	2	76	0.0263158
NODE_306371_length_135_cov_540.611111	0	76	38	1	76	0.0131579
NODE_306371_length_135_cov_540.611111	0	76	39	1	76	0.0131579
NODE_306371_length_135_cov_540.611111	0	76	41	1	76	0.0131579
NODE_306371_length_135_cov_540.611111	0	76	42	1	76	0.0131579
NODE_306371_length_135_cov_540.611111	0	76	44	1	76	0.0131579
NODE_306371_length_135_cov_540.611111	0	76	46	5	76	0.0657895
NODE_306371_length_135_cov_540.611111	0	76	50	1	76	0.0131579
NODE_306371_length_135_cov_540.611111	0	76	54	54	76	0.7105263
NODE_306373_length_135_cov_257.416667	36	88	10	52	52	1.0000000
NODE_306374_length_135_cov_239.638889	97	135	0	5	38	0.1315790
NODE_306374_length_135_cov_239.638889	97	135	10	2	38	0.0526316
NODE_306374_length_135_cov_239.638889	97	135	20	1	38	0.0263158
NODE_306374_length_135_cov_239.638889	97	135	22	5	38	0.1315790
NODE_306374_length_135_cov_239.638889	97	135	24	15	38	0.3947369
NODE_306374_length_135_cov_239.638889	97	135	26	5	38	0.1315790
NODE_306374_length_135_cov_239.638889	97	135	30	5	38	0.1315790
NODE_306400_length_135_cov_35.055556	8	88	0	80	80	1.0000000
NODE_306400_length_135_cov_35.055556	61	125	0	64	64	1.0000000
NODE_306400_length_135_cov_35.055556	61	125	0	64	64	1.0000000
NODE_306402_length_135_cov_31.805556	0	76	0	76	76	1.0000000
NODE_306658_length_133_cov_140.411765	8	43	2	7	35	0.2000000
NODE_306658_length_133_cov_140.411765	8	43	3	3	35	0.0857143
NODE_306658_length_133_cov_140.411765	8	43	4	2	35	0.0571429
NODE_306658_length_133_cov_140.411765	8	43	6	8	35	0.2285714
NODE_306658_length_133_cov_140.411765	8	43	8	15	35	0.4285714
NODE_306658_length_133_cov_140.411765	53	88	8	35	35	1.0000000
NODE_306658_length_133_cov_140.411765	98	133	4	4	35	0.1142857
NODE_306658_length_133_cov_140.411765	98	133	7	1	35	0.0285714
NODE_306658_length_133_cov_140.411765	98	133	8	30	35	0.8571429
NODE_306661_length_133_cov_109.441176	63	129	2	66	66	1.0000000
NODE_306812_length_132_cov_114.151515	2	44	0	5	42	0.1190476
NODE_306812_length_132_cov_114.151515	2	44	8	2	42	0.0476190
NODE_306812_length_132_cov_114.151515	2	44	10	35	42	0.8333333
NODE_306812_length_132_cov_114.151515	4	44	0	3	40	0.0750000
NODE_306812_length_132_cov_114.151515	4	44	8	2	40	0.0500000
NODE_306812_length_132_cov_114.151515	4	44	10	35	40	0.8750000
NODE_306812_length_132_cov_114.151515	17	83	10	66	66	1.0000000
NODE_306812_length_132_cov_114.151515	17	88	10	71	71	1.0000000
NODE_306824_length_132_cov_61.636364	3	76	8	73	73	1.0000000
NODE_306824_length_132_cov_61.636364	49	130	4	5	81	0.0617284
NODE_306824_length_132_cov_61.636364	49	130	6	13	81	0.1604938
NODE_306824_length_132_cov_61.636364	49	130	8	63	81	0.7777778
NODE_306824_length_132_cov_61.636364	103	125	6	13	22	0.5909091
NODE_306824_length_132_cov_61.636364	103	125	8	9	22	0.4090909
NODE_306834_length_132_cov_33.393939	2	83	0	81	81	1.0000000
NODE_306834_length_132_cov_33.393939	7	29	0	22	22	1.0000000
NODE_306834_length_132_cov_33.393939	56	129	0	73	73	1.0000000
NODE_306965_length_131_cov_810.000000	0	60	21	2	60	0.0333333
NODE_306965_length_131_cov_810.000000	0	60	33	5	60	0.0833333
NODE_306965_length_131_cov_810.000000	0	60	37	5	60	0.0833333
NODE_306965_length_131_cov_810.000000	0	60	44	1	60	0.0166667
NODE_306965_length_131_cov_810.000000	0	60	50	1	60	0.0166667
NODE_306965_length_131_cov_810.000000	0	60	52	3	60	0.0500000
NODE_306965_length_131_cov_810.000000	0	60	59	1	60	0.0166667
NODE_306965_length_131_cov_810.000000	0	60	62	1	60	0.0166667
NODE_306965_length_131_cov_810.000000	0	60	64	3	60	0.0500000
NODE_306965_length_131_cov_810.000000	0	60	66	1	60	0.0166667
NODE_306965_length_131_cov_810.000000	0	60	70	1	60	0.0166667
NODE_306965_length_131_cov_810.000000	0	60	78	2	60	0.0333333
NODE_306965_length_131_cov_810.000000	0	60	80	1	60	0.0166667
NODE_306965_length_131_cov_810.000000	0	60	86	33	60	0.5500000
NODE_306965_length_131_cov_810.000000	33	97	86	64	64	1.0000000
NODE_306965_length_131_cov_810.000000	33	97	86	64	64	1.0000000
NODE_306965_length_131_cov_810.000000	33	97	86	64	64	1.0000000
NODE_306985_length_131_cov_149.187500	25	105	56	2	80	0.0250000
NODE_306985_length_131_cov_149.187500	25	105	61	1	80	0.0125000
NODE_306985_length_131_cov_149.187500	25	105	62	1	80	0.0125000
NODE_306985_length_131_cov_149.187500	25	105	64	1	80	0.0125000
NODE_306985_length_131_cov_149.187500	25	105	66	2	80	0.0250000
NODE_306985_length_131_cov_149.187500	25	105	67	3	80	0.0375000
NODE_306985_length_131_cov_149.187500	25	105	68	70	80	0.8750000
NODE_306985_length_131_cov_149.187500	78	131	6	1	53	0.0188679
NODE_306985_length_131_cov_149.187500	78	131	9	3	53	0.0566038
NODE_306985_length_131_cov_149.187500	78	131	13	2	53	0.0377358
NODE_306985_length_131_cov_149.187500	78	131	15	3	53	0.0566038
NODE_306985_length_131_cov_149.187500	78	131	19	1	53	0.0188679
NODE_306985_length_131_cov_149.187500	78	131	25	1	53	0.0188679
NODE_306985_length_131_cov_149.187500	78	131	35	1	53	0.0188679
NODE_306985_length_131_cov_149.187500	78	131	37	1	53	0.0188679
NODE_306985_length_131_cov_149.187500	78	131	45	3	53	0.0566038
NODE_306985_length_131_cov_149.187500	78	131	51	1	53	0.0188679
NODE_306985_length_131_cov_149.187500	78	131	53	1	53	0.0188679
NODE_306985_length_131_cov_149.187500	78	131	57	6	53	0.1132075
NODE_306985_length_131_cov_149.187500	78	131	59	1	53	0.0188679
NODE_306985_length_131_cov_149.187500	78	131	61	2	53	0.0377358
NODE_306985_length_131_cov_149.187500	78	131	64	1	53	0.0188679
NODE_306985_length_131_cov_149.187500	78	131	66	2	53	0.0377358
NODE_306985_length_131_cov_149.187500	78	131	67	3	53	0.0566038
NODE_306985_length_131_cov_149.187500	78	131	68	20	53	0.3773585
NODE_307121_length_130_cov_319.806452	54	126	2	3	72	0.0416667
NODE_307121_length_130_cov_319.806452	54	126	4	6	72	0.0833333
NODE_307121_length_130_cov_319.806452	54	126	6	2	72	0.0277778
NODE_307121_length_130_cov_319.806452	54	126	8	1	72	0.0138889
NODE_307121_length_130_cov_319.806452	54	126	10	1	72	0.0138889
NODE_307121_length_130_cov_319.806452	54	126	12	2	72	0.0277778
NODE_307121_length_130_cov_319.806452	54	126	14	2	72	0.0277778
NODE_307121_length_130_cov_319.806452	54	126	16	4	72	0.0555556
NODE_307121_length_130_cov_319.806452	54	126	20	1	72	0.0138889
NODE_307121_length_130_cov_319.806452	54	126	22	1	72	0.0138889
NODE_307121_length_130_cov_319.806452	54	126	24	49	72	0.6805556
NODE_307132_length_130_cov_153.516129	82	113	0	8	31	0.2580645
NODE_307132_length_130_cov_153.516129	82	113	2	23	31	0.7419355
NODE_307140_length_130_cov_79.064516	0	53	2	7	53	0.1320755
NODE_307140_length_130_cov_79.064516	0	53	8	2	53	0.0377358
NODE_307140_length_130_cov_79.064516	0	53	12	8	53	0.1509434
NODE_307140_length_130_cov_79.064516	0	53	14	1	53	0.0188679
NODE_307140_length_130_cov_79.064516	0	53	20	3	53	0.0566038
NODE_307140_length_130_cov_79.064516	0	53	26	5	53	0.0943396
NODE_307140_length_130_cov_79.064516	0	53	30	1	53	0.0188679
NODE_307140_length_130_cov_79.064516	0	53	36	1	53	0.0188679
NODE_307140_length_130_cov_79.064516	0	53	38	25	53	0.4716981
NODE_307140_length_130_cov_79.064516	26	56	30	1	30	0.0333333
NODE_307140_length_130_cov_79.064516	26	56	36	1	30	0.0333333
NODE_307140_length_130_cov_79.064516	26	56	38	28	30	0.9333333
NODE_307270_length_129_cov_1851.133333	0	45	0	5	45	0.1111111
NODE_307270_length_129_cov_1851.133333	0	45	2	3	45	0.0666667
NODE_307270_length_129_cov_1851.133333	0	45	4	5	45	0.1111111
NODE_307270_length_129_cov_1851.133333	0	45	6	1	45	0.0222222
NODE_307270_length_129_cov_1851.133333	0	45	8	1	45	0.0222222
NODE_307270_length_129_cov_1851.133333	0	45	10	8	45	0.1777778
NODE_307270_length_129_cov_1851.133333	0	45	12	2	45	0.0444444
NODE_307270_length_129_cov_1851.133333	0	45	14	20	45	0.4444444
NODE_307270_length_129_cov_1851.133333	18	98	10	5	80	0.0625000
NODE_307270_length_129_cov_1851.133333	18	98	12	2	80	0.0250000
NODE_307270_length_129_cov_1851.133333	18	98	14	73	80	0.9125000
NODE_307285_length_129_cov_186.500000	0	78	0	8	78	0.1025641
NODE_307285_length_129_cov_186.500000	0	78	3	1	78	0.0128205
NODE_307285_length_129_cov_186.500000	0	78	4	69	78	0.8846154
NODE_307285_length_129_cov_186.500000	53	129	0	4	76	0.0526316
NODE_307285_length_129_cov_186.500000	53	129	3	1	76	0.0131579
NODE_307285_length_129_cov_186.500000	53	129	4	71	76	0.9342105
NODE_307287_length_129_cov_165.466667	36	111	4	75	75	1.0000000
NODE_307287_length_129_cov_165.466667	84	113	4	29	29	1.0000000
NODE_307292_length_129_cov_90.366667	0	48	22	48	48	1.0000000
NODE_307292_length_129_cov_90.366667	0	48	22	48	48	1.0000000
NODE_307292_length_129_cov_90.366667	0	48	22	48	48	1.0000000
NODE_307292_length_129_cov_90.366667	21	101	22	80	80	1.0000000
NODE_307442_length_128_cov_2621.517241	3	83	19	1	80	0.0125000
NODE_307442_length_128_cov_2621.517241	3	83	26	1	80	0.0125000
NODE_307442_length_128_cov_2621.517241	3	83	32	2	80	0.0250000
NODE_307442_length_128_cov_2621.517241	3	83	34	1	80	0.0125000
NODE_307442_length_128_cov_2621.517241	3	83	48	1	80	0.0125000
NODE_307442_length_128_cov_2621.517241	3	83	50	1	80	0.0125000
NODE_307442_length_128_cov_2621.517241	3	83	54	1	80	0.0125000
NODE_307442_length_128_cov_2621.517241	3	83	62	1	80	0.0125000
NODE_307442_length_128_cov_2621.517241	3	83	64	2	80	0.0250000
NODE_307442_length_128_cov_2621.517241	3	83	66	7	80	0.0875000
NODE_307442_length_128_cov_2621.517241	3	83	68	2	80	0.0250000
NODE_307442_length_128_cov_2621.517241	3	83	70	1	80	0.0125000
NODE_307442_length_128_cov_2621.517241	3	83	72	59	80	0.7375000
NODE_307442_length_128_cov_2621.517241	8	30	48	1	22	0.0454545
NODE_307442_length_128_cov_2621.517241	8	30	50	1	22	0.0454545
NODE_307442_length_128_cov_2621.517241	8	30	54	1	22	0.0454545
NODE_307442_length_128_cov_2621.517241	8	30	62	1	22	0.0454545
NODE_307442_length_128_cov_2621.517241	8	30	64	2	22	0.0909091
NODE_307442_length_128_cov_2621.517241	8	30	66	7	22	0.3181818
NODE_307442_length_128_cov_2621.517241	8	30	68	2	22	0.0909091
NODE_307442_length_128_cov_2621.517241	8	30	70	1	22	0.0454545
NODE_307442_length_128_cov_2621.517241	8	30	72	6	22	0.2727273
NODE_307442_length_128_cov_2621.517241	56	128	11	1	72	0.0138889
NODE_307442_length_128_cov_2621.517241	56	128	20	8	72	0.1111111
NODE_307442_length_128_cov_2621.517241	56	128	24	1	72	0.0138889
NODE_307442_length_128_cov_2621.517241	56	128	26	1	72	0.0138889
NODE_307442_length_128_cov_2621.517241	56	128	30	2	72	0.0277778
NODE_307442_length_128_cov_2621.517241	56	128	36	3	72	0.0416667
NODE_307442_length_128_cov_2621.517241	56	128	38	1	72	0.0138889
NODE_307442_length_128_cov_2621.517241	56	128	42	1	72	0.0138889
NODE_307442_length_128_cov_2621.517241	56	128	54	1	72	0.0138889
NODE_307442_length_128_cov_2621.517241	56	128	56	1	72	0.0138889
NODE_307442_length_128_cov_2621.517241	56	128	62	1	72	0.0138889
NODE_307442_length_128_cov_2621.517241	56	128	66	1	72	0.0138889
NODE_307442_length_128_cov_2621.517241	56	128	68	2	72	0.0277778
NODE_307442_length_128_cov_2621.517241	56	128	70	1	72	0.0138889
NODE_307442_length_128_cov_2621.517241	56	128	72	47	72	0.6527778
NODE_307443_length_128_cov_1604.275862	58	127	6	1	69	0.0144928
NODE_307443_length_128_cov_1604.275862	58	127	8	5	69	0.0724638
NODE_307443_length_128_cov_1604.275862	58	127	10	4	69	0.0579710
NODE_307443_length_128_cov_1604.275862	58	127	12	6	69	0.0869565
NODE_307443_length_128_cov_1604.275862	58	127	16	2	69	0.0289855
NODE_307443_length_128_cov_1604.275862	58	127	18	4	69	0.0579710
NODE_307443_length_128_cov_1604.275862	58	127	20	1	69	0.0144928
NODE_307443_length_128_cov_1604.275862	58	127	22	46	69	0.6666667
NODE_307458_length_128_cov_79.034483	43	123	0	2	80	0.0250000
NODE_307458_length_128_cov_79.034483	43	123	4	1	80	0.0125000
NODE_307458_length_128_cov_79.034483	43	123	6	3	80	0.0375000
NODE_307458_length_128_cov_79.034483	43	123	24	1	80	0.0125000
NODE_307458_length_128_cov_79.034483	43	123	28	12	80	0.1500000
NODE_307458_length_128_cov_79.034483	43	123	30	3	80	0.0375000
NODE_307458_length_128_cov_79.034483	43	123	32	1	80	0.0125000
NODE_307458_length_128_cov_79.034483	43	123	36	57	80	0.7125000
NODE_307464_length_128_cov_61.793103	5	85	14	7	80	0.0875000
NODE_307464_length_128_cov_61.793103	5	85	16	6	80	0.0750000
NODE_307464_length_128_cov_61.793103	5	85	20	67	80	0.8375000
NODE_307549_length_127_cov_1879.785714	21	101	85	1	80	0.0125000
NODE_307549_length_127_cov_1879.785714	21	101	86	2	80	0.0250000
NODE_307549_length_127_cov_1879.785714	21	101	88	77	80	0.9625000
NODE_307549_length_127_cov_1879.785714	74	127	18	1	53	0.0188679
NODE_307549_length_127_cov_1879.785714	74	127	20	1	53	0.0188679
NODE_307549_length_127_cov_1879.785714	74	127	24	2	53	0.0377358
NODE_307549_length_127_cov_1879.785714	74	127	35	1	53	0.0188679
NODE_307549_length_127_cov_1879.785714	74	127	38	4	53	0.0754717
NODE_307549_length_127_cov_1879.785714	74	127	44	1	53	0.0188679
NODE_307549_length_127_cov_1879.785714	74	127	54	1	53	0.0188679
NODE_307549_length_127_cov_1879.785714	74	127	64	1	53	0.0188679
NODE_307549_length_127_cov_1879.785714	74	127	76	2	53	0.0377358
NODE_307549_length_127_cov_1879.785714	74	127	78	3	53	0.0566038
NODE_307549_length_127_cov_1879.785714	74	127	80	2	53	0.0377358
NODE_307549_length_127_cov_1879.785714	74	127	88	34	53	0.6415094
NODE_307583_length_127_cov_66.142857	38	118	0	80	80	1.0000000
NODE_307583_length_127_cov_66.142857	47	118	0	71	71	1.0000000
NODE_307590_length_127_cov_38.285714	12	86	2	74	74	1.0000000
NODE_307596_length_127_cov_30.607143	21	93	0	72	72	1.0000000
NODE_307662_length_126_cov_936.777778	24	96	6	72	72	1.0000000
NODE_307675_length_126_cov_147.185185	2	66	2	3	64	0.0468750
NODE_307675_length_126_cov_147.185185	2	66	4	3	64	0.0468750
NODE_307675_length_126_cov_147.185185	2	66	7	1	64	0.0156250
NODE_307675_length_126_cov_147.185185	2	66	8	57	64	0.8906250
NODE_307675_length_126_cov_147.185185	2	66	2	3	64	0.0468750
NODE_307675_length_126_cov_147.185185	2	66	4	3	64	0.0468750
NODE_307675_length_126_cov_147.185185	2	66	7	1	64	0.0156250
NODE_307675_length_126_cov_147.185185	2	66	8	57	64	0.8906250
NODE_307675_length_126_cov_147.185185	2	66	2	3	64	0.0468750
NODE_307675_length_126_cov_147.185185	2	66	4	3	64	0.0468750
NODE_307675_length_126_cov_147.185185	2	66	7	1	64	0.0156250
NODE_307675_length_126_cov_147.185185	2	66	8	57	64	0.8906250
NODE_307675_length_126_cov_147.185185	39	99	8	60	60	1.0000000
NODE_307675_length_126_cov_147.185185	55	99	8	44	44	1.0000000
NODE_307684_length_126_cov_82.518519	44	75	0	31	31	1.0000000
NODE_307793_length_125_cov_656.807692	19	99	22	80	80	1.0000000
NODE_307806_length_125_cov_143.615385	52	125	0	1	73	0.0136986
NODE_307806_length_125_cov_143.615385	52	125	2	2	73	0.0273973
NODE_307806_length_125_cov_143.615385	52	125	6	2	73	0.0273973
NODE_307806_length_125_cov_143.615385	52	125	8	2	73	0.0273973
NODE_307806_length_125_cov_143.615385	52	125	12	11	73	0.1506849
NODE_307806_length_125_cov_143.615385	52	125	14	55	73	0.7534246
NODE_307810_length_125_cov_131.923077	3	52	6	1	49	0.0204082
NODE_307810_length_125_cov_131.923077	3	52	8	10	49	0.2040816
NODE_307810_length_125_cov_131.923077	3	52	12	9	49	0.1836735
NODE_307810_length_125_cov_131.923077	3	52	14	29	49	0.5918368
NODE_307810_length_125_cov_131.923077	25	89	14	64	64	1.0000000
NODE_307810_length_125_cov_131.923077	25	89	14	64	64	1.0000000
NODE_307816_length_125_cov_102.500000	0	56	0	8	56	0.1428571
NODE_307816_length_125_cov_102.500000	0	56	2	48	56	0.8571429
NODE_307816_length_125_cov_102.500000	7	56	0	1	49	0.0204082
NODE_307816_length_125_cov_102.500000	7	56	2	48	49	0.9795918
NODE_307816_length_125_cov_102.500000	29	114	0	8	85	0.0941176
NODE_307816_length_125_cov_102.500000	29	114	2	77	85	0.9058824
NODE_307816_length_125_cov_102.500000	29	114	0	8	85	0.0941176
NODE_307816_length_125_cov_102.500000	29	114	2	77	85	0.9058824
NODE_307816_length_125_cov_102.500000	29	114	0	8	85	0.0941176
NODE_307816_length_125_cov_102.500000	29	114	2	77	85	0.9058824
NODE_307839_length_125_cov_28.115385	17	90	28	1	73	0.0136986
NODE_307839_length_125_cov_28.115385	17	90	32	1	73	0.0136986
NODE_307839_length_125_cov_28.115385	17	90	40	71	73	0.9726027
NODE_307839_length_125_cov_28.115385	57	98	40	41	41	1.0000000
NODE_307906_length_124_cov_945.680000	0	73	10	5	73	0.0684932
NODE_307906_length_124_cov_945.680000	0	73	12	3	73	0.0410959
NODE_307906_length_124_cov_945.680000	0	73	14	10	73	0.1369863
NODE_307906_length_124_cov_945.680000	0	73	16	55	73	0.7534246
NODE_307906_length_124_cov_945.680000	53	124	0	1	71	0.0140845
NODE_307906_length_124_cov_945.680000	53	124	4	5	71	0.0704225
NODE_307906_length_124_cov_945.680000	53	124	8	2	71	0.0281690
NODE_307906_length_124_cov_945.680000	53	124	10	3	71	0.0422535
NODE_307906_length_124_cov_945.680000	53	124	12	1	71	0.0140845
NODE_307906_length_124_cov_945.680000	53	124	14	7	71	0.0985916
NODE_307906_length_124_cov_945.680000	53	124	16	52	71	0.7323943
NODE_308023_length_123_cov_1186.083333	0	76	0	6	76	0.0789474
NODE_308023_length_123_cov_1186.083333	0	76	4	14	76	0.1842105
NODE_308023_length_123_cov_1186.083333	0	76	6	56	76	0.7368421
NODE_308023_length_123_cov_1186.083333	0	76	0	6	76	0.0789474
NODE_308023_length_123_cov_1186.083333	0	76	4	14	76	0.1842105
NODE_308023_length_123_cov_1186.083333	0	76	6	56	76	0.7368421
NODE_308023_length_123_cov_1186.083333	0	76	0	6	76	0.0789474
NODE_308023_length_123_cov_1186.083333	0	76	4	14	76	0.1842105
NODE_308023_length_123_cov_1186.083333	0	76	6	56	76	0.7368421
NODE_308023_length_123_cov_1186.083333	0	76	0	6	76	0.0789474
NODE_308023_length_123_cov_1186.083333	0	76	4	14	76	0.1842105
NODE_308023_length_123_cov_1186.083333	0	76	6	56	76	0.7368421
NODE_308023_length_123_cov_1186.083333	49	123	2	16	74	0.2162162
NODE_308023_length_123_cov_1186.083333	49	123	6	58	74	0.7837838
NODE_308023_length_123_cov_1186.083333	49	123	2	16	74	0.2162162
NODE_308023_length_123_cov_1186.083333	49	123	6	58	74	0.7837838
NODE_308023_length_123_cov_1186.083333	49	123	2	16	74	0.2162162
NODE_308023_length_123_cov_1186.083333	49	123	6	58	74	0.7837838
NODE_308024_length_123_cov_963.500000	19	88	8	69	69	1.0000000
NODE_308037_length_123_cov_181.291667	0	47	0	47	47	1.0000000
NODE_308037_length_123_cov_181.291667	24	100	0	76	76	1.0000000
NODE_308057_length_123_cov_55.375000	52	123	2	1	71	0.0140845
NODE_308057_length_123_cov_55.375000	52	123	6	3	71	0.0422535
NODE_308057_length_123_cov_55.375000	52	123	10	67	71	0.9436620
NODE_308057_length_123_cov_55.375000	52	123	2	1	71	0.0140845
NODE_308057_length_123_cov_55.375000	52	123	6	3	71	0.0422535
NODE_308057_length_123_cov_55.375000	52	123	10	67	71	0.9436620
NODE_308057_length_123_cov_55.375000	61	123	2	1	62	0.0161290
NODE_308057_length_123_cov_55.375000	61	123	6	3	62	0.0483871
NODE_308057_length_123_cov_55.375000	61	123	10	58	62	0.9354839
NODE_308068_length_123_cov_40.958333	9	89	8	10	80	0.1250000
NODE_308068_length_123_cov_40.958333	9	89	10	70	80	0.8750000
NODE_308068_length_123_cov_40.958333	9	89	8	10	80	0.1250000
NODE_308068_length_123_cov_40.958333	9	89	10	70	80	0.8750000
NODE_308068_length_123_cov_40.958333	9	89	8	10	80	0.1250000
NODE_308068_length_123_cov_40.958333	9	89	10	70	80	0.8750000
NODE_308068_length_123_cov_40.958333	9	89	8	10	80	0.1250000
NODE_308068_length_123_cov_40.958333	9	89	10	70	80	0.8750000
NODE_308068_length_123_cov_40.958333	9	89	8	10	80	0.1250000
NODE_308068_length_123_cov_40.958333	9	89	10	70	80	0.8750000
NODE_308068_length_123_cov_40.958333	9	80	8	10	71	0.1408451
NODE_308068_length_123_cov_40.958333	9	80	10	61	71	0.8591549
NODE_308180_length_122_cov_111.043478	8	88	6	80	80	1.0000000
NODE_308180_length_122_cov_111.043478	8	88	6	80	80	1.0000000
NODE_308184_length_122_cov_67.565217	0	50	0	18	50	0.3600000
NODE_308184_length_122_cov_67.565217	0	50	2	32	50	0.6400000
NODE_308184_length_122_cov_67.565217	0	50	0	18	50	0.3600000
NODE_308184_length_122_cov_67.565217	0	50	2	32	50	0.6400000
NODE_308184_length_122_cov_67.565217	23	103	2	80	80	1.0000000
NODE_308184_length_122_cov_67.565217	23	103	2	80	80	1.0000000
NODE_308184_length_122_cov_67.565217	23	103	2	80	80	1.0000000
NODE_308184_length_122_cov_67.565217	23	103	2	80	80	1.0000000
NODE_308184_length_122_cov_67.565217	23	103	2	80	80	1.0000000
NODE_308184_length_122_cov_67.565217	23	94	2	71	71	1.0000000
NODE_308188_length_122_cov_58.826087	28	99	0	71	71	1.0000000
NODE_308188_length_122_cov_58.826087	33	99	0	66	66	1.0000000
NODE_308188_length_122_cov_58.826087	72	122	0	50	50	1.0000000
NODE_308188_length_122_cov_58.826087	72	122	0	50	50	1.0000000
NODE_308198_length_122_cov_38.173913	12	93	2	81	81	1.0000000
NODE_308257_length_121_cov_159.318182	24	55	0	31	31	1.0000000
NODE_308260_length_121_cov_120.181818	20	100	0	80	80	1.0000000
NODE_308260_length_121_cov_120.181818	20	95	0	75	75	1.0000000
NODE_308260_length_121_cov_120.181818	20	100	0	80	80	1.0000000
NODE_308260_length_121_cov_120.181818	29	100	0	71	71	1.0000000
NODE_308273_length_121_cov_54.181818	7	70	0	63	63	1.0000000
NODE_308273_length_121_cov_54.181818	7	70	0	63	63	1.0000000
NODE_308273_length_121_cov_54.181818	7	70	0	63	63	1.0000000
NODE_308273_length_121_cov_54.181818	9	70	0	61	61	1.0000000
NODE_308273_length_121_cov_54.181818	43	109	0	66	66	1.0000000
NODE_308273_length_121_cov_54.181818	43	121	0	78	78	1.0000000
NODE_308273_length_121_cov_54.181818	64	117	0	53	53	1.0000000
NODE_308317_length_120_cov_1404.619048	0	64	15	2	64	0.0312500
NODE_308317_length_120_cov_1404.619048	0	64	20	1	64	0.0156250
NODE_308317_length_120_cov_1404.619048	0	64	35	2	64	0.0312500
NODE_308317_length_120_cov_1404.619048	0	64	40	2	64	0.0312500
NODE_308317_length_120_cov_1404.619048	0	64	42	2	64	0.0312500
NODE_308317_length_120_cov_1404.619048	0	64	47	1	64	0.0156250
NODE_308317_length_120_cov_1404.619048	0	64	50	1	64	0.0156250
NODE_308317_length_120_cov_1404.619048	0	64	52	2	64	0.0312500
NODE_308317_length_120_cov_1404.619048	0	64	54	1	64	0.0156250
NODE_308317_length_120_cov_1404.619048	0	64	56	1	64	0.0156250
NODE_308317_length_120_cov_1404.619048	0	64	58	2	64	0.0312500
NODE_308317_length_120_cov_1404.619048	0	64	60	47	64	0.7343750
NODE_308317_length_120_cov_1404.619048	45	117	26	2	72	0.0277778
NODE_308317_length_120_cov_1404.619048	45	117	30	3	72	0.0416667
NODE_308317_length_120_cov_1404.619048	45	117	34	1	72	0.0138889
NODE_308317_length_120_cov_1404.619048	45	117	36	1	72	0.0138889
NODE_308317_length_120_cov_1404.619048	45	117	38	1	72	0.0138889
NODE_308317_length_120_cov_1404.619048	45	117	44	1	72	0.0138889
NODE_308317_length_120_cov_1404.619048	45	117	53	1	72	0.0138889
NODE_308317_length_120_cov_1404.619048	45	117	54	1	72	0.0138889
NODE_308317_length_120_cov_1404.619048	45	117	58	1	72	0.0138889
NODE_308317_length_120_cov_1404.619048	45	117	60	60	72	0.8333333
NODE_308318_length_120_cov_1138.428571	19	99	2	80	80	1.0000000
NODE_308318_length_120_cov_1138.428571	72	120	0	1	48	0.0208333
NODE_308318_length_120_cov_1138.428571	72	120	2	47	48	0.9791667
NODE_308357_length_120_cov_54.666667	0	69	0	11	69	0.1594203
NODE_308357_length_120_cov_54.666667	0	69	2	1	69	0.0144928
NODE_308357_length_120_cov_54.666667	0	69	26	5	69	0.0724638
NODE_308357_length_120_cov_54.666667	0	69	28	52	69	0.7536232
NODE_308357_length_120_cov_54.666667	0	69	0	11	69	0.1594203
NODE_308357_length_120_cov_54.666667	0	69	2	1	69	0.0144928
NODE_308357_length_120_cov_54.666667	0	69	26	5	69	0.0724638
NODE_308357_length_120_cov_54.666667	0	69	28	52	69	0.7536232
NODE_308357_length_120_cov_54.666667	0	69	0	11	69	0.1594203
NODE_308357_length_120_cov_54.666667	0	69	2	1	69	0.0144928
NODE_308357_length_120_cov_54.666667	0	69	26	5	69	0.0724638
NODE_308357_length_120_cov_54.666667	0	69	28	52	69	0.7536232
NODE_308357_length_120_cov_54.666667	42	108	24	2	66	0.0303030
NODE_308357_length_120_cov_54.666667	42	108	26	3	66	0.0454545
NODE_308357_length_120_cov_54.666667	42	108	28	61	66	0.9242424
NODE_308357_length_120_cov_54.666667	53	120	0	2	67	0.0298507
NODE_308357_length_120_cov_54.666667	53	120	22	8	67	0.1194030
NODE_308357_length_120_cov_54.666667	53	120	24	4	67	0.0597015
NODE_308357_length_120_cov_54.666667	53	120	26	3	67	0.0447761
NODE_308357_length_120_cov_54.666667	53	120	28	50	67	0.7462686
NODE_308357_length_120_cov_54.666667	53	120	0	2	67	0.0298507
NODE_308357_length_120_cov_54.666667	53	120	22	8	67	0.1194030
NODE_308357_length_120_cov_54.666667	53	120	24	4	67	0.0597015
NODE_308357_length_120_cov_54.666667	53	120	26	3	67	0.0447761
NODE_308357_length_120_cov_54.666667	53	120	28	50	67	0.7462686
NODE_308487_length_118_cov_1211.578947	49	116	0	67	67	1.0000000
NODE_308488_length_118_cov_1157.157895	4	70	0	9	66	0.1363636
NODE_308488_length_118_cov_1157.157895	4	70	5	1	66	0.0151515
NODE_308488_length_118_cov_1157.157895	4	70	6	56	66	0.8484849
NODE_308500_length_118_cov_218.210526	0	63	0	2	63	0.0317460
NODE_308500_length_118_cov_218.210526	0	63	2	1	63	0.0158730
NODE_308500_length_118_cov_218.210526	0	63	10	1	63	0.0158730
NODE_308500_length_118_cov_218.210526	0	63	12	5	63	0.0793651
NODE_308500_length_118_cov_218.210526	0	63	16	54	63	0.8571429
NODE_308500_length_118_cov_218.210526	35	115	4	7	80	0.0875000
NODE_308500_length_118_cov_218.210526	35	115	8	3	80	0.0375000
NODE_308500_length_118_cov_218.210526	35	115	15	1	80	0.0125000
NODE_308500_length_118_cov_218.210526	35	115	16	69	80	0.8625000
NODE_308504_length_118_cov_161.052632	4	70	0	66	66	1.0000000
NODE_308572_length_117_cov_338.555556	7	70	30	6	63	0.0952381
NODE_308572_length_117_cov_338.555556	7	70	32	57	63	0.9047619
NODE_308572_length_117_cov_338.555556	7	70	30	6	63	0.0952381
NODE_308572_length_117_cov_338.555556	7	70	32	57	63	0.9047619
NODE_308572_length_117_cov_338.555556	7	70	30	6	63	0.0952381
NODE_308572_length_117_cov_338.555556	7	70	32	57	63	0.9047619
NODE_308572_length_117_cov_338.555556	9	70	30	4	61	0.0655738
NODE_308572_length_117_cov_338.555556	9	70	32	57	61	0.9344262
NODE_308572_length_117_cov_338.555556	43	109	24	4	66	0.0606061
NODE_308572_length_117_cov_338.555556	43	109	30	1	66	0.0151515
NODE_308572_length_117_cov_338.555556	43	109	32	61	66	0.9242424
NODE_308572_length_117_cov_338.555556	43	114	16	1	71	0.0140845
NODE_308572_length_117_cov_338.555556	43	114	18	4	71	0.0563380
NODE_308572_length_117_cov_338.555556	43	114	24	4	71	0.0563380
NODE_308572_length_117_cov_338.555556	43	114	30	1	71	0.0140845
NODE_308572_length_117_cov_338.555556	43	114	32	61	71	0.8591549
NODE_308572_length_117_cov_338.555556	64	117	0	1	53	0.0188679
NODE_308572_length_117_cov_338.555556	64	117	16	3	53	0.0566038
NODE_308572_length_117_cov_338.555556	64	117	18	4	53	0.0754717
NODE_308572_length_117_cov_338.555556	64	117	24	4	53	0.0754717
NODE_308572_length_117_cov_338.555556	64	117	30	1	53	0.0188679
NODE_308572_length_117_cov_338.555556	64	117	32	40	53	0.7547170
NODE_308654_length_116_cov_1897.470588	0	77	8	4	77	0.0519481
NODE_308654_length_116_cov_1897.470588	0	77	10	1	77	0.0129870
NODE_308654_length_116_cov_1897.470588	0	77	12	2	77	0.0259740
NODE_308654_length_116_cov_1897.470588	0	77	14	6	77	0.0779221
NODE_308654_length_116_cov_1897.470588	0	77	16	64	77	0.8311688
NODE_308654_length_116_cov_1897.470588	34	111	8	2	77	0.0259740
NODE_308654_length_116_cov_1897.470588	34	111	11	1	77	0.0129870
NODE_308654_length_116_cov_1897.470588	34	111	12	1	77	0.0129870
NODE_308654_length_116_cov_1897.470588	34	111	14	5	77	0.0649351
NODE_308654_length_116_cov_1897.470588	34	111	16	68	77	0.8831169
NODE_308668_length_116_cov_438.529412	15	95	0	80	80	1.0000000
NODE_308668_length_116_cov_438.529412	68	116	0	48	48	1.0000000
NODE_308701_length_116_cov_93.235294	52	116	0	64	64	1.0000000
NODE_308722_length_116_cov_46.882353	6	66	12	2	60	0.0333333
NODE_308722_length_116_cov_46.882353	6	66	22	6	60	0.1000000
NODE_308722_length_116_cov_46.882353	6	66	28	52	60	0.8666667
NODE_308727_length_116_cov_38.352941	20	100	0	80	80	1.0000000
NODE_308746_length_115_cov_1012.625000	31	114	12	3	83	0.0361446
NODE_308746_length_115_cov_1012.625000	31	114	16	80	83	0.9638554
NODE_308750_length_115_cov_776.625000	9	92	0	83	83	1.0000000
NODE_308752_length_115_cov_623.937500	0	74	0	74	74	1.0000000
NODE_308782_length_115_cov_144.812500	4	73	0	7	69	0.1014493
NODE_308782_length_115_cov_144.812500	4	73	2	62	69	0.8985507
NODE_308806_length_115_cov_65.187500	16	76	6	60	60	1.0000000
NODE_308846_length_114_cov_819.466667	40	114	0	2	74	0.0270270
NODE_308846_length_114_cov_819.466667	40	114	4	1	74	0.0135135
NODE_308846_length_114_cov_819.466667	40	114	6	6	74	0.0810811
NODE_308846_length_114_cov_819.466667	40	114	12	4	74	0.0540541
NODE_308846_length_114_cov_819.466667	40	114	14	61	74	0.8243243
NODE_308846_length_114_cov_819.466667	40	114	0	2	74	0.0270270
NODE_308846_length_114_cov_819.466667	40	114	4	1	74	0.0135135
NODE_308846_length_114_cov_819.466667	40	114	6	6	74	0.0810811
NODE_308846_length_114_cov_819.466667	40	114	12	4	74	0.0540541
NODE_308846_length_114_cov_819.466667	40	114	14	61	74	0.8243243
NODE_308846_length_114_cov_819.466667	49	114	0	2	65	0.0307692
NODE_308846_length_114_cov_819.466667	49	114	4	1	65	0.0153846
NODE_308846_length_114_cov_819.466667	49	114	6	6	65	0.0923077
NODE_308846_length_114_cov_819.466667	49	114	12	4	65	0.0615385
NODE_308846_length_114_cov_819.466667	49	114	14	52	65	0.8000000
NODE_308866_length_114_cov_285.666667	0	78	0	8	78	0.1025641
NODE_308866_length_114_cov_285.666667	0	78	2	70	78	0.8974359
NODE_308866_length_114_cov_285.666667	51	114	0	7	63	0.1111111
NODE_308866_length_114_cov_285.666667	51	114	2	56	63	0.8888889
NODE_308886_length_114_cov_83.600000	51	82	0	31	31	1.0000000
NODE_308891_length_114_cov_67.666667	40	90	0	50	50	1.0000000
NODE_308939_length_113_cov_446.214286	5	82	0	77	77	1.0000000
NODE_308939_length_113_cov_446.214286	5	82	0	77	77	1.0000000
NODE_308967_length_113_cov_160.071429	0	64	4	2	64	0.0312500
NODE_308967_length_113_cov_160.071429	0	64	9	12	64	0.1875000
NODE_308967_length_113_cov_160.071429	0	64	10	50	64	0.7812500
NODE_308967_length_113_cov_160.071429	0	64	4	2	64	0.0312500
NODE_308967_length_113_cov_160.071429	0	64	9	12	64	0.1875000
NODE_308967_length_113_cov_160.071429	0	64	10	50	64	0.7812500
NODE_308967_length_113_cov_160.071429	37	103	9	51	66	0.7727273
NODE_308967_length_113_cov_160.071429	37	103	10	15	66	0.2272727
NODE_308967_length_113_cov_160.071429	37	108	9	56	71	0.7887324
NODE_308967_length_113_cov_160.071429	37	108	10	15	71	0.2112676
NODE_309037_length_112_cov_963.384615	43	112	0	69	69	1.0000000
NODE_309044_length_112_cov_653.615385	7	78	2	71	71	1.0000000
NODE_309044_length_112_cov_653.615385	12	78	2	66	66	1.0000000
NODE_309044_length_112_cov_653.615385	51	112	0	3	61	0.0491803
NODE_309044_length_112_cov_653.615385	51	112	2	58	61	0.9508197
NODE_309044_length_112_cov_653.615385	51	112	0	3	61	0.0491803
NODE_309044_length_112_cov_653.615385	51	112	2	58	61	0.9508197
NODE_309067_length_112_cov_219.538462	0	62	0	62	62	1.0000000
NODE_309067_length_112_cov_219.538462	0	57	0	57	57	1.0000000
NODE_309067_length_112_cov_219.538462	0	62	0	62	62	1.0000000
NODE_309067_length_112_cov_219.538462	0	59	0	59	59	1.0000000
NODE_309067_length_112_cov_219.538462	35	112	0	77	77	1.0000000
NODE_309067_length_112_cov_219.538462	35	112	0	77	77	1.0000000
NODE_309067_length_112_cov_219.538462	35	112	0	77	77	1.0000000
NODE_309078_length_112_cov_160.307692	0	69	0	69	69	1.0000000
NODE_309079_length_112_cov_134.846154	11	91	0	80	80	1.0000000
NODE_309079_length_112_cov_134.846154	11	91	0	80	80	1.0000000
NODE_309079_length_112_cov_134.846154	64	112	0	48	48	1.0000000
NODE_309079_length_112_cov_134.846154	64	112	0	48	48	1.0000000
NODE_309079_length_112_cov_134.846154	64	112	0	48	48	1.0000000
NODE_309092_length_112_cov_84.384615	10	90	2	80	80	1.0000000
NODE_309097_length_112_cov_72.769231	36	100	4	64	64	1.0000000
NODE_309106_length_112_cov_35.307692	13	76	0	63	63	1.0000000
NODE_309123_length_111_cov_1107.833333	0	52	0	52	52	1.0000000
NODE_309123_length_111_cov_1107.833333	0	52	0	52	52	1.0000000
NODE_309123_length_111_cov_1107.833333	0	52	0	52	52	1.0000000
NODE_309123_length_111_cov_1107.833333	0	52	0	52	52	1.0000000
NODE_309123_length_111_cov_1107.833333	25	105	0	80	80	1.0000000
NODE_309123_length_111_cov_1107.833333	25	105	0	80	80	1.0000000
NODE_309123_length_111_cov_1107.833333	25	105	0	80	80	1.0000000
NODE_309123_length_111_cov_1107.833333	25	105	0	80	80	1.0000000
NODE_309123_length_111_cov_1107.833333	25	105	0	80	80	1.0000000
NODE_309123_length_111_cov_1107.833333	25	105	0	80	80	1.0000000
NODE_309126_length_111_cov_827.500000	3	74	11	4	71	0.0563380
NODE_309126_length_111_cov_827.500000	3	74	12	67	71	0.9436620
NODE_309126_length_111_cov_827.500000	8	74	12	66	66	1.0000000
NODE_309126_length_111_cov_827.500000	47	111	2	3	64	0.0468750
NODE_309126_length_111_cov_827.500000	47	111	4	1	64	0.0156250
NODE_309126_length_111_cov_827.500000	47	111	10	2	64	0.0312500
NODE_309126_length_111_cov_827.500000	47	111	12	58	64	0.9062500
NODE_309126_length_111_cov_827.500000	47	111	2	3	64	0.0468750
NODE_309126_length_111_cov_827.500000	47	111	4	1	64	0.0156250
NODE_309126_length_111_cov_827.500000	47	111	10	2	64	0.0312500
NODE_309126_length_111_cov_827.500000	47	111	12	58	64	0.9062500
NODE_309126_length_111_cov_827.500000	47	111	2	3	64	0.0468750
NODE_309126_length_111_cov_827.500000	47	111	4	1	64	0.0156250
NODE_309126_length_111_cov_827.500000	47	111	10	2	64	0.0312500
NODE_309126_length_111_cov_827.500000	47	111	12	58	64	0.9062500
NODE_309129_length_111_cov_726.833333	12	89	0	77	77	1.0000000
NODE_309129_length_111_cov_726.833333	12	89	0	77	77	1.0000000
NODE_309129_length_111_cov_726.833333	62	111	0	49	49	1.0000000
NODE_309129_length_111_cov_726.833333	67	111	0	44	44	1.0000000
NODE_309131_length_111_cov_692.416667	31	111	3	1	80	0.0125000
NODE_309131_length_111_cov_692.416667	31	111	8	5	80	0.0625000
NODE_309131_length_111_cov_692.416667	31	111	10	74	80	0.9250000
NODE_309149_length_111_cov_241.750000	30	97	0	67	67	1.0000000
NODE_309160_length_111_cov_169.416667	21	102	0	81	81	1.0000000
NODE_309200_length_110_cov_554.909091	1	28	8	1	27	0.0370370
NODE_309200_length_110_cov_554.909091	1	28	16	5	27	0.1851852
NODE_309200_length_110_cov_554.909091	1	28	18	21	27	0.7777778
NODE_309200_length_110_cov_554.909091	1	81	8	1	80	0.0125000
NODE_309200_length_110_cov_554.909091	1	81	16	5	80	0.0625000
NODE_309200_length_110_cov_554.909091	1	81	18	74	80	0.9250000
NODE_309202_length_110_cov_537.545455	0	75	0	75	75	1.0000000
NODE_309202_length_110_cov_537.545455	53	107	0	54	54	1.0000000
NODE_309235_length_110_cov_91.636364	19	54	0	35	35	1.0000000
NODE_309235_length_110_cov_91.636364	64	107	0	43	43	1.0000000
NODE_309239_length_110_cov_80.272727	19	54	0	35	35	1.0000000
NODE_309239_length_110_cov_80.272727	64	99	0	35	35	1.0000000
NODE_309241_length_110_cov_78.363636	19	54	0	35	35	1.0000000
NODE_309241_length_110_cov_78.363636	64	107	0	43	43	1.0000000
NODE_309245_length_110_cov_68.727273	11	46	0	35	35	1.0000000
NODE_309245_length_110_cov_68.727273	56	91	0	35	35	1.0000000
NODE_309252_length_110_cov_44.545455	5	57	0	52	52	1.0000000
NODE_309263_length_109_cov_1364.100000	29	98	2	69	69	1.0000000
NODE_309275_length_109_cov_689.800000	12	86	2	74	74	1.0000000
NODE_309309_length_109_cov_250.800000	4	66	0	3	62	0.0483871
NODE_309309_length_109_cov_250.800000	4	66	6	59	62	0.9516129
NODE_309311_length_109_cov_242.000000	29	98	0	69	69	1.0000000
NODE_309326_length_109_cov_139.000000	26	106	0	80	80	1.0000000
NODE_309345_length_109_cov_84.500000	33	93	2	60	60	1.0000000
NODE_309349_length_109_cov_75.300000	0	65	0	4	65	0.0615385
NODE_309349_length_109_cov_75.300000	0	65	2	61	65	0.9384615
NODE_309384_length_108_cov_1542.666667	28	108	0	5	80	0.0625000
NODE_309384_length_108_cov_1542.666667	28	108	2	75	80	0.9375000
NODE_309391_length_108_cov_987.666667	5	85	0	80	80	1.0000000
NODE_309391_length_108_cov_987.666667	5	85	0	80	80	1.0000000
NODE_309391_length_108_cov_987.666667	5	85	0	80	80	1.0000000
NODE_309391_length_108_cov_987.666667	5	85	0	80	80	1.0000000
NODE_309391_length_108_cov_987.666667	5	85	0	80	80	1.0000000
NODE_309391_length_108_cov_987.666667	58	108	0	50	50	1.0000000
NODE_309391_length_108_cov_987.666667	58	108	0	50	50	1.0000000
NODE_309395_length_108_cov_841.666667	1	65	27	1	64	0.0156250
NODE_309395_length_108_cov_841.666667	1	65	28	63	64	0.9843750
NODE_309395_length_108_cov_841.666667	1	65	27	1	64	0.0156250
NODE_309395_length_108_cov_841.666667	1	65	28	63	64	0.9843750
NODE_309395_length_108_cov_841.666667	1	65	27	1	64	0.0156250
NODE_309395_length_108_cov_841.666667	1	65	28	63	64	0.9843750
NODE_309433_length_108_cov_213.333333	22	81	4	59	59	1.0000000
NODE_309433_length_108_cov_213.333333	55	81	4	26	26	1.0000000
NODE_309464_length_108_cov_107.888889	11	82	0	71	71	1.0000000
NODE_309464_length_108_cov_107.888889	16	82	0	66	66	1.0000000
NODE_309464_length_108_cov_107.888889	55	108	0	53	53	1.0000000
NODE_309464_length_108_cov_107.888889	55	108	0	53	53	1.0000000
NODE_309464_length_108_cov_107.888889	55	108	0	53	53	1.0000000
NODE_309472_length_108_cov_76.444444	13	76	0	63	63	1.0000000
NODE_309479_length_108_cov_51.000000	0	53	0	53	53	1.0000000
NODE_309479_length_108_cov_51.000000	0	53	0	53	53	1.0000000
NODE_309479_length_108_cov_51.000000	0	53	0	53	53	1.0000000
NODE_309479_length_108_cov_51.000000	26	106	0	80	80	1.0000000
NODE_309479_length_108_cov_51.000000	26	106	0	80	80	1.0000000
NODE_309479_length_108_cov_51.000000	26	106	0	80	80	1.0000000
NODE_309479_length_108_cov_51.000000	26	106	0	80	80	1.0000000
NODE_309479_length_108_cov_51.000000	26	106	0	80	80	1.0000000
NODE_309479_length_108_cov_51.000000	26	97	0	71	71	1.0000000
NODE_309490_length_108_cov_31.111111	11	82	0	71	71	1.0000000
NODE_309490_length_108_cov_31.111111	16	82	0	66	66	1.0000000
NODE_309490_length_108_cov_31.111111	55	108	0	53	53	1.0000000
NODE_309490_length_108_cov_31.111111	55	108	0	53	53	1.0000000
NODE_309490_length_108_cov_31.111111	55	108	0	53	53	1.0000000
NODE_309530_length_107_cov_608.250000	0	64	0	64	64	1.0000000
NODE_309530_length_107_cov_608.250000	53	103	0	50	50	1.0000000
NODE_309551_length_107_cov_303.250000	0	56	0	56	56	1.0000000
NODE_309551_length_107_cov_303.250000	29	99	0	70	70	1.0000000
NODE_309657_length_106_cov_522.571429	10	90	0	80	80	1.0000000
NODE_309657_length_106_cov_522.571429	10	90	0	80	80	1.0000000
NODE_309657_length_106_cov_522.571429	10	90	0	80	80	1.0000000
NODE_309657_length_106_cov_522.571429	10	90	0	80	80	1.0000000
NODE_309657_length_106_cov_522.571429	10	90	0	80	80	1.0000000
NODE_309657_length_106_cov_522.571429	19	90	0	71	71	1.0000000
NODE_309696_length_106_cov_161.857143	7	78	2	71	71	1.0000000
NODE_309696_length_106_cov_161.857143	51	106	0	2	55	0.0363636
NODE_309696_length_106_cov_161.857143	51	106	2	53	55	0.9636363
NODE_309707_length_106_cov_130.714286	0	76	0	76	76	1.0000000
NODE_309714_length_106_cov_108.000000	0	76	0	76	76	1.0000000
NODE_309717_length_106_cov_102.142857	0	62	0	62	62	1.0000000
NODE_309717_length_106_cov_102.142857	35	106	0	71	71	1.0000000
NODE_309717_length_106_cov_102.142857	35	106	0	71	71	1.0000000
NODE_309747_length_106_cov_39.428571	0	76	0	76	76	1.0000000
NODE_309761_length_106_cov_30.857143	0	70	0	70	70	1.0000000
NODE_309761_length_106_cov_30.857143	0	70	0	70	70	1.0000000
NODE_309761_length_106_cov_30.857143	0	70	0	70	70	1.0000000
NODE_309761_length_106_cov_30.857143	43	92	0	49	49	1.0000000
NODE_309761_length_106_cov_30.857143	53	106	0	53	53	1.0000000
NODE_309761_length_106_cov_30.857143	53	106	0	53	53	1.0000000
NODE_309775_length_105_cov_2054.666667	31	105	0	74	74	1.0000000
NODE_309775_length_105_cov_2054.666667	31	105	0	74	74	1.0000000
NODE_309775_length_105_cov_2054.666667	31	105	0	74	74	1.0000000
NODE_309775_length_105_cov_2054.666667	31	105	0	74	74	1.0000000
NODE_309788_length_105_cov_830.833333	30	105	0	75	75	1.0000000
NODE_309789_length_105_cov_825.500000	0	77	0	77	77	1.0000000
NODE_309789_length_105_cov_825.500000	0	77	0	77	77	1.0000000
NODE_309789_length_105_cov_825.500000	50	99	0	49	49	1.0000000
NODE_309789_length_105_cov_825.500000	55	105	0	50	50	1.0000000
NODE_309815_length_105_cov_231.333333	0	54	0	54	54	1.0000000
NODE_309815_length_105_cov_231.333333	27	99	0	72	72	1.0000000
NODE_309842_length_105_cov_85.333333	14	94	18	80	80	1.0000000
NODE_309842_length_105_cov_85.333333	67	89	18	22	22	1.0000000
NODE_309855_length_105_cov_61.833333	23	103	0	80	80	1.0000000
NODE_309867_length_105_cov_40.666667	6	66	0	60	60	1.0000000
NODE_309925_length_104_cov_1016.000000	0	78	0	78	78	1.0000000
NODE_309925_length_104_cov_1016.000000	53	99	0	46	46	1.0000000
NODE_309935_length_104_cov_791.200000	0	67	0	67	67	1.0000000
NODE_309935_length_104_cov_791.200000	0	67	0	67	67	1.0000000
NODE_309935_length_104_cov_791.200000	40	104	0	64	64	1.0000000
NODE_309938_length_104_cov_574.200000	21	101	0	80	80	1.0000000
NODE_309938_length_104_cov_574.200000	21	101	0	80	80	1.0000000
NODE_309938_length_104_cov_574.200000	21	101	0	80	80	1.0000000
NODE_309938_length_104_cov_574.200000	21	101	0	80	80	1.0000000
NODE_309938_length_104_cov_574.200000	21	101	0	80	80	1.0000000
NODE_309938_length_104_cov_574.200000	21	92	0	71	71	1.0000000
NODE_309940_length_104_cov_547.400000	10	87	0	77	77	1.0000000
NODE_309940_length_104_cov_547.400000	10	87	0	77	77	1.0000000
NODE_310020_length_104_cov_46.800000	42	104	0	62	62	1.0000000
NODE_310054_length_103_cov_2267.000000	0	54	0	54	54	1.0000000
NODE_310054_length_103_cov_2267.000000	27	100	0	73	73	1.0000000
NODE_310082_length_103_cov_890.000000	6	70	0	64	64	1.0000000
NODE_310082_length_103_cov_890.000000	6	70	0	64	64	1.0000000
NODE_310082_length_103_cov_890.000000	6	70	0	64	64	1.0000000
NODE_310082_length_103_cov_890.000000	43	103	0	60	60	1.0000000
NODE_310082_length_103_cov_890.000000	59	103	0	44	44	1.0000000
NODE_310090_length_103_cov_768.500000	7	78	0	71	71	1.0000000
NODE_310090_length_103_cov_768.500000	12	78	0	66	66	1.0000000
NODE_310090_length_103_cov_768.500000	51	99	0	48	48	1.0000000
NODE_310090_length_103_cov_768.500000	51	99	0	48	48	1.0000000
NODE_310090_length_103_cov_768.500000	51	99	0	48	48	1.0000000
NODE_310091_length_103_cov_751.000000	0	71	0	71	71	1.0000000
NODE_310091_length_103_cov_751.000000	0	71	0	71	71	1.0000000
NODE_310091_length_103_cov_751.000000	44	93	0	49	49	1.0000000
NODE_310094_length_103_cov_678.000000	10	74	0	64	64	1.0000000
NODE_310094_length_103_cov_678.000000	10	74	0	64	64	1.0000000
NODE_310094_length_103_cov_678.000000	10	74	0	64	64	1.0000000
NODE_310094_length_103_cov_678.000000	47	96	0	49	49	1.0000000
NODE_310103_length_103_cov_462.750000	19	99	2	80	80	1.0000000
NODE_310116_length_103_cov_300.250000	0	63	0	63	63	1.0000000
NODE_310147_length_103_cov_103.250000	4	47	0	43	43	1.0000000
NODE_310152_length_103_cov_80.250000	36	99	0	63	63	1.0000000
NODE_310153_length_103_cov_76.500000	4	63	0	59	59	1.0000000
NODE_310160_length_103_cov_42.000000	0	78	0	78	78	1.0000000
NODE_310160_length_103_cov_42.000000	7	78	0	71	71	1.0000000
NODE_310160_length_103_cov_42.000000	12	78	0	66	66	1.0000000
NODE_310160_length_103_cov_42.000000	51	99	0	48	48	1.0000000
NODE_310160_length_103_cov_42.000000	51	99	0	48	48	1.0000000
NODE_310160_length_103_cov_42.000000	51	99	0	48	48	1.0000000
NODE_310211_length_102_cov_2033.666667	0	48	0	48	48	1.0000000
NODE_310211_length_102_cov_2033.666667	21	101	0	80	80	1.0000000
NODE_310227_length_102_cov_1028.333333	52	102	0	50	50	1.0000000
NODE_310230_length_102_cov_987.666667	15	98	0	83	83	1.0000000
NODE_310231_length_102_cov_934.000000	12	95	0	83	83	1.0000000
NODE_310246_length_102_cov_685.666667	0	73	0	73	73	1.0000000
NODE_310247_length_102_cov_646.666667	15	89	0	74	74	1.0000000
NODE_310269_length_102_cov_250.000000	12	72	0	60	60	1.0000000
NODE_310273_length_102_cov_216.333333	4	70	0	66	66	1.0000000
NODE_310273_length_102_cov_216.333333	4	70	0	66	66	1.0000000
NODE_310273_length_102_cov_216.333333	4	70	0	66	66	1.0000000
NODE_310273_length_102_cov_216.333333	43	92	0	49	49	1.0000000
NODE_310273_length_102_cov_216.333333	57	102	0	45	45	1.0000000
NODE_310287_length_102_cov_152.333333	0	63	0	63	63	1.0000000
NODE_310295_length_102_cov_124.333333	0	70	0	70	70	1.0000000
NODE_310302_length_102_cov_106.333333	0	78	0	78	78	1.0000000
NODE_310302_length_102_cov_106.333333	7	78	0	71	71	1.0000000
NODE_310302_length_102_cov_106.333333	12	78	0	66	66	1.0000000
NODE_310302_length_102_cov_106.333333	51	102	0	51	51	1.0000000
NODE_310302_length_102_cov_106.333333	51	102	0	51	51	1.0000000
NODE_310302_length_102_cov_106.333333	51	102	0	51	51	1.0000000
NODE_310316_length_102_cov_74.333333	31	99	0	68	68	1.0000000
NODE_310321_length_102_cov_71.000000	11	91	0	80	80	1.0000000
NODE_310336_length_102_cov_32.666667	0	65	0	65	65	1.0000000
NODE_310336_length_102_cov_32.666667	38	99	0	61	61	1.0000000
NODE_310405_length_101_cov_2217.000000	0	43	0	43	43	1.0000000
NODE_310405_length_101_cov_2217.000000	23	96	0	73	73	1.0000000
NODE_310464_length_101_cov_740.500000	2	66	0	64	64	1.0000000
NODE_310464_length_101_cov_740.500000	2	66	0	64	64	1.0000000
NODE_310464_length_101_cov_740.500000	2	66	0	64	64	1.0000000
NODE_310464_length_101_cov_740.500000	39	101	0	62	62	1.0000000
NODE_310464_length_101_cov_740.500000	55	101	0	46	46	1.0000000
NODE_310469_length_101_cov_701.000000	0	62	0	62	62	1.0000000
NODE_310469_length_101_cov_701.000000	35	99	0	64	64	1.0000000
NODE_310469_length_101_cov_701.000000	35	99	0	64	64	1.0000000
NODE_310469_length_101_cov_701.000000	35	99	0	64	64	1.0000000
NODE_310471_length_101_cov_679.000000	2	76	0	74	74	1.0000000
NODE_310500_length_101_cov_374.500000	2	50	0	48	48	1.0000000
NODE_310500_length_101_cov_374.500000	2	50	0	48	48	1.0000000
NODE_310500_length_101_cov_374.500000	2	50	0	48	48	1.0000000
NODE_310500_length_101_cov_374.500000	23	89	0	66	66	1.0000000
NODE_310500_length_101_cov_374.500000	23	94	0	71	71	1.0000000
NODE_310516_length_101_cov_294.000000	4	52	0	48	48	1.0000000
NODE_310516_length_101_cov_294.000000	4	52	0	48	48	1.0000000
NODE_310516_length_101_cov_294.000000	4	52	0	48	48	1.0000000
NODE_310516_length_101_cov_294.000000	25	91	0	66	66	1.0000000
NODE_310516_length_101_cov_294.000000	25	96	0	71	71	1.0000000
NODE_310529_length_101_cov_230.500000	2	76	0	74	74	1.0000000
NODE_310529_length_101_cov_230.500000	2	76	0	74	74	1.0000000
NODE_310529_length_101_cov_230.500000	2	76	0	74	74	1.0000000
NODE_310529_length_101_cov_230.500000	49	101	0	52	52	1.0000000
NODE_310529_length_101_cov_230.500000	55	101	0	46	46	1.0000000
NODE_310550_length_101_cov_157.000000	13	72	0	59	59	1.0000000
NODE_310550_length_101_cov_157.000000	46	72	0	26	26	1.0000000
NODE_310565_length_101_cov_134.500000	2	37	0	35	35	1.0000000
NODE_310685_length_100_cov_1883.000000	32	100	0	68	68	1.0000000
NODE_310685_length_100_cov_1883.000000	32	100	0	68	68	1.0000000
NODE_310685_length_100_cov_1883.000000	32	99	0	67	67	1.0000000
NODE_310685_length_100_cov_1883.000000	32	100	0	68	68	1.0000000
NODE_310704_length_100_cov_1310.000000	0	42	0	42	42	1.0000000
NODE_310704_length_100_cov_1310.000000	1	42	0	41	41	1.0000000
NODE_310704_length_100_cov_1310.000000	38	100	0	62	62	1.0000000
NODE_310704_length_100_cov_1310.000000	38	95	0	57	57	1.0000000
NODE_310704_length_100_cov_1310.000000	38	100	0	62	62	1.0000000
NODE_310704_length_100_cov_1310.000000	38	100	0	62	62	1.0000000
NODE_310708_length_100_cov_1239.000000	1	48	0	47	47	1.0000000
NODE_310740_length_100_cov_694.000000	0	62	0	62	62	1.0000000
NODE_310740_length_100_cov_694.000000	0	62	0	62	62	1.0000000
NODE_310740_length_100_cov_694.000000	35	100	0	65	65	1.0000000
NODE_310748_length_100_cov_602.000000	0	57	0	57	57	1.0000000
NODE_310750_length_100_cov_590.000000	0	58	0	58	58	1.0000000
NODE_310798_length_100_cov_274.000000	1	67	0	66	66	1.0000000
NODE_310798_length_100_cov_274.000000	1	67	0	66	66	1.0000000
NODE_310798_length_100_cov_274.000000	1	67	0	66	66	1.0000000
NODE_310798_length_100_cov_274.000000	40	100	0	60	60	1.0000000
NODE_310798_length_100_cov_274.000000	54	100	0	46	46	1.0000000
NODE_310808_length_100_cov_217.000000	4	75	0	71	71	1.0000000
NODE_310808_length_100_cov_217.000000	9	75	0	66	66	1.0000000
NODE_310808_length_100_cov_217.000000	48	99	0	51	51	1.0000000
NODE_310808_length_100_cov_217.000000	48	99	0	51	51	1.0000000
NODE_310808_length_100_cov_217.000000	48	99	0	51	51	1.0000000
NODE_310810_length_100_cov_209.000000	1	44	0	43	43	1.0000000
NODE_310810_length_100_cov_209.000000	40	100	0	60	60	1.0000000
NODE_310810_length_100_cov_209.000000	40	100	0	60	60	1.0000000
NODE_310819_length_100_cov_185.000000	0	46	0	46	46	1.0000000
NODE_310819_length_100_cov_185.000000	9	58	0	49	49	1.0000000
NODE_310819_length_100_cov_185.000000	31	99	0	68	68	1.0000000
NODE_310819_length_100_cov_185.000000	31	99	0	68	68	1.0000000
NODE_310819_length_100_cov_185.000000	31	99	0	68	68	1.0000000
NODE_310828_length_100_cov_164.000000	9	92	0	83	83	1.0000000
NODE_310837_length_100_cov_152.000000	11	91	0	80	80	1.0000000
NODE_310837_length_100_cov_152.000000	11	91	0	80	80	1.0000000
NODE_310837_length_100_cov_152.000000	11	91	0	80	80	1.0000000
NODE_310837_length_100_cov_152.000000	11	91	0	80	80	1.0000000
NODE_310837_length_100_cov_152.000000	11	91	0	80	80	1.0000000
NODE_310839_length_100_cov_150.000000	0	54	0	54	54	1.0000000
NODE_310839_length_100_cov_150.000000	0	54	0	54	54	1.0000000
NODE_310839_length_100_cov_150.000000	27	100	0	73	73	1.0000000
NODE_310839_length_100_cov_150.000000	27	100	0	73	73	1.0000000
NODE_310840_length_100_cov_148.000000	2	82	0	80	80	1.0000000
NODE_310841_length_100_cov_148.000000	0	71	0	71	71	1.0000000
NODE_310841_length_100_cov_148.000000	0	71	0	71	71	1.0000000
NODE_310841_length_100_cov_148.000000	0	62	0	62	62	1.0000000
NODE_310876_length_100_cov_71.000000	0	75	0	75	75	1.0000000
NODE_310876_length_100_cov_71.000000	4	75	0	71	71	1.0000000
NODE_310876_length_100_cov_71.000000	9	75	0	66	66	1.0000000
NODE_310876_length_100_cov_71.000000	48	100	0	52	52	1.0000000
NODE_310876_length_100_cov_71.000000	48	100	0	52	52	1.0000000
NODE_310876_length_100_cov_71.000000	48	100	0	52	52	1.0000000
NODE_310896_length_100_cov_41.000000	0	75	0	75	75	1.0000000
NODE_310896_length_100_cov_41.000000	4	75	0	71	71	1.0000000
NODE_310896_length_100_cov_41.000000	9	75	0	66	66	1.0000000
NODE_310896_length_100_cov_41.000000	48	99	0	51	51	1.0000000
NODE_310896_length_100_cov_41.000000	48	99	0	51	51	1.0000000
NODE_310896_length_100_cov_41.000000	48	99	0	51	51	1.0000000
NODE_310904_length_100_cov_30.000000	1	42	0	41	41	1.0000000
